season,gametype,gameid,gamedate,off_teamid,off_team,off_home,off_win,def_teamid,def_team,def_home,def_win,fg2made,fg2missed,fg2attempted,fg3made,fg3missed,fg3attempted,fgmade,fgmissed,fgattempted,ftmade,ftmissed,ftattempted,offreb,defreb,assists,stealsagainst,turnovers,possessions,points
2016,2,21600495,12/30/2016,1610612740,New Orleans Pelicans,1,1,1610612752,New York Knicks,0,0,26,30,56,12,17,29,38,47,85,16,1,17,6,42,22,7,13,101,104
2016,2,21600495,12/30/2016,1610612752,New York Knicks,0,0,1610612740,New Orleans Pelicans,1,1,28,42,70,7,16,23,35,58,93,15,1,16,15,43,18,4,14,99,92
2021,2,22100943,3/3/2022,1610612742,Dallas Mavericks,1,1,1610612744,Golden State Warriors,0,0,28,20,48,17,20,37,45,40,85,15,5,20,12,30,29,7,10,90,122
2021,2,22100943,3/3/2022,1610612744,Golden State Warriors,0,0,1610612742,Dallas Mavericks,1,1,29,22,51,15,15,30,44,37,81,10,3,13,12,27,26,7,15,90,113
2016,2,21601032,3/18/2017,1610612741,Chicago Bulls,1,1,1610612762,Utah Jazz,0,0,31,30,61,7,12,19,38,42,80,12,2,14,10,33,24,6,11,88,95
2016,2,21601032,3/18/2017,1610612762,Utah Jazz,0,0,1610612741,Chicago Bulls,1,1,24,32,56,7,18,25,31,50,81,17,8,25,20,34,15,7,15,88,86
2021,2,22100942,3/3/2022,1610612761,Toronto Raptors,1,0,1610612765,Detroit Pistons,0,1,29,28,57,7,19,26,36,47,83,27,9,36,18,33,12,4,10,92,106
2022,2,22200482,12/23/2022,1610612750,Minnesota Timberwolves,0,0,1610612738,Boston Celtics,1,1,34,25,59,10,22,32,44,47,91,11,4,15,14,36,25,9,17,101,109
2016,2,21600494,12/30/2016,1610612738,Boston Celtics,1,1,1610612748,Miami Heat,0,0,21,21,42,17,15,32,38,36,74,24,5,29,9,31,28,7,14,93,117
2016,2,21600494,12/30/2016,1610612748,Miami Heat,0,0,1610612738,Boston Celtics,1,1,37,25,62,11,17,28,48,42,90,7,3,10,13,29,35,6,12,95,114
2022,2,22200495,12/25/2022,1610612738,Boston Celtics,1,1,1610612749,Milwaukee Bucks,0,0,31,15,46,19,20,39,50,35,85,20,5,25,5,32,29,8,11,103,139
2022,2,22200495,12/25/2022,1610612749,Milwaukee Bucks,0,0,1610612738,Boston Celtics,1,1,29,19,48,13,23,36,42,42,84,21,6,27,12,33,22,9,16,102,118
2017,2,21700768,2/2/2018,1610612747,Los Angeles Lakers,0,1,1610612751,Brooklyn Nets,1,0,29,37,66,10,16,26,39,53,92,14,6,20,22,34,21,7,16,94,102
2017,2,21700768,2/2/2018,1610612751,Brooklyn Nets,1,0,1610612747,Los Angeles Lakers,0,1,28,25,53,9,20,29,37,45,82,16,7,23,10,40,20,5,12,96,99
2023,2,22300197,11/15/2023,1610612750,Minnesota Timberwolves,0,0,1610612756,Phoenix Suns,1,1,37,28,65,5,22,27,42,50,92,26,2,28,21,31,18,1,6,90,115
2016,2,21600493,12/30/2016,1610612751,Brooklyn Nets,0,0,1610612764,Washington Wizards,1,1,22,27,49,10,15,25,32,42,74,21,4,25,6,39,18,12,21,100,95
2016,2,21600493,12/30/2016,1610612764,Washington Wizards,1,1,1610612751,Brooklyn Nets,0,0,36,25,61,11,11,22,47,36,83,13,1,14,9,28,28,9,20,98,118
2016,2,21600078,11/4/2016,1610612744,Golden State Warriors,0,0,1610612747,Los Angeles Lakers,1,1,34,20,54,5,27,32,39,47,86,14,6,20,13,37,26,9,20,104,97
2021,2,22100942,3/3/2022,1610612765,Detroit Pistons,0,1,1610612761,Toronto Raptors,1,0,27,20,47,11,26,37,38,46,84,21,7,28,15,33,25,5,10,92,108
2022,2,22200548,1/1/2023,1610612749,Milwaukee Bucks,1,0,1610612764,Washington Wizards,0,1,21,26,47,13,36,49,34,62,96,14,1,15,18,45,22,9,16,102,95
2022,2,22200548,1/1/2023,1610612764,Washington Wizards,0,1,1610612749,Milwaukee Bucks,1,0,43,24,67,7,20,27,50,44,94,11,5,16,17,31,29,11,18,103,118
2016,2,21601031,3/18/2017,1610612739,Cleveland Cavaliers,0,0,1610612746,LA Clippers,1,1,27,29,56,5,22,27,32,51,83,9,4,13,5,48,15,4,12,96,78
2016,2,21601031,3/18/2017,1610612746,LA Clippers,1,1,1610612739,Cleveland Cavaliers,0,0,32,20,52,8,18,26,40,38,78,20,9,29,9,37,27,5,15,96,108
2020,2,22000558,3/4/2021,1610612757,Portland Trail Blazers,1,1,1610612758,Sacramento Kings,0,0,27,23,50,15,23,38,42,46,88,24,1,25,12,35,20,3,9,96,123
2020,2,22000558,3/4/2021,1610612758,Sacramento Kings,0,0,1610612757,Portland Trail Blazers,1,1,38,36,74,11,18,29,49,54,103,10,6,16,22,35,25,6,7,97,119
2016,2,21600078,11/4/2016,1610612747,Los Angeles Lakers,1,1,1610612744,Golden State Warriors,0,0,37,28,65,8,22,30,45,50,95,19,2,21,17,33,26,13,16,103,117
2014,2,21400658,1/25/2015,1610612739,Cleveland Cavaliers,1,1,1610612760,Oklahoma City Thunder,0,0,20,26,46,16,20,36,36,46,82,20,9,29,16,32,17,6,12,93,108
2014,2,21400658,1/25/2015,1610612760,Oklahoma City Thunder,0,0,1610612739,Cleveland Cavaliers,1,1,27,37,64,10,20,30,37,57,94,14,4,18,18,40,26,5,8,94,98
2017,2,21700767,2/2/2018,1610612737,Atlanta Hawks,0,0,1610612738,Boston Celtics,1,1,23,26,49,11,20,31,34,46,80,31,3,34,9,38,21,8,12,102,110
2017,2,21700767,2/2/2018,1610612738,Boston Celtics,1,1,1610612737,Atlanta Hawks,0,0,34,31,65,11,13,24,45,44,89,18,2,20,10,34,26,6,11,100,119
2022,2,22200549,1/1/2023,1610612738,Boston Celtics,0,0,1610612743,Denver Nuggets,1,1,31,23,54,9,24,33,40,47,87,22,5,27,12,36,30,5,13,100,111
2022,2,22200549,1/1/2023,1610612743,Denver Nuggets,1,1,1610612738,Boston Celtics,0,0,28,21,49,17,13,30,45,34,79,16,2,18,4,31,31,8,17,100,123
2016,2,21600491,12/29/2016,1610612742,Dallas Mavericks,0,1,1610612747,Los Angeles Lakers,1,0,24,22,46,14,17,31,38,39,77,11,3,14,13,28,24,8,17,87,101
2016,2,21600491,12/29/2016,1610612747,Los Angeles Lakers,1,0,1610612742,Dallas Mavericks,0,1,25,24,49,7,12,19,32,36,68,18,7,25,7,33,15,8,15,87,89
2023,2,22300764,2/12/2024,1610612761,Toronto Raptors,1,0,1610612759,San Antonio Spurs,0,1,31,36,67,8,23,31,39,59,98,13,3,16,17,43,25,12,19,107,99
2020,2,22000816,4/12/2021,1610612753,Orlando Magic,1,0,1610612759,San Antonio Spurs,0,1,31,29,60,5,15,20,36,44,80,20,12,32,13,36,15,6,14,97,97
2020,2,22000816,4/12/2021,1610612759,San Antonio Spurs,0,1,1610612753,Orlando Magic,1,0,38,30,68,10,15,25,48,45,93,14,4,18,14,34,30,6,10,95,120
2021,2,22100941,3/3/2022,1610612748,Miami Heat,0,1,1610612751,Brooklyn Nets,1,0,30,17,47,10,20,30,40,37,77,23,5,28,11,27,27,5,15,95,113
2021,2,22100941,3/3/2022,1610612751,Brooklyn Nets,1,0,1610612748,Miami Heat,0,1,27,25,52,12,19,31,39,44,83,17,5,22,13,33,24,8,13,94,107
2021,2,22100071,10/29/2021,1610612753,Orlando Magic,0,0,1610612761,Toronto Raptors,1,1,25,28,53,16,18,34,41,46,87,11,5,16,18,32,24,11,17,93,109
2021,2,22100071,10/29/2021,1610612761,Toronto Raptors,1,1,1610612753,Orlando Magic,0,0,34,22,56,9,21,30,43,43,86,15,7,22,11,35,18,1,8,92,110
2022,2,22200540,12/31/2022,1610612739,Cleveland Cavaliers,0,1,1610612741,Chicago Bulls,1,0,26,21,47,13,25,38,39,46,85,12,7,19,17,34,20,15,21,98,103
2022,2,22200540,12/31/2022,1610612741,Chicago Bulls,1,0,1610612739,Cleveland Cavaliers,0,1,32,28,60,7,14,21,39,42,81,17,7,24,9,35,14,9,15,98,102
2017,2,21700766,2/2/2018,1610612754,Indiana Pacers,0,0,1610612766,Charlotte Hornets,1,1,32,26,58,12,17,29,44,43,87,26,2,28,11,33,21,5,11,100,126
2017,2,21700766,2/2/2018,1610612766,Charlotte Hornets,1,1,1610612754,Indiana Pacers,0,0,29,21,50,15,18,33,44,39,83,30,4,34,14,25,27,10,15,100,133
2016,2,21601030,3/18/2017,1610612764,Washington Wizards,0,0,1610612766,Charlotte Hornets,1,1,18,28,46,11,22,33,29,50,79,24,7,31,14,38,21,8,13,94,93
2020,2,22000557,3/4/2021,1610612740,New Orleans Pelicans,1,0,1610612748,Miami Heat,0,1,22,19,41,11,32,43,33,51,84,16,4,20,17,37,28,6,14,90,93
2020,2,22000557,3/4/2021,1610612748,Miami Heat,0,1,1610612740,New Orleans Pelicans,1,0,26,17,43,10,20,30,36,37,73,21,4,25,8,30,27,5,11,89,103
2021,2,22100070,10/28/2021,1610612744,Golden State Warriors,1,0,1610612763,Memphis Grizzlies,0,1,25,25,50,14,26,40,39,51,90,9,3,12,11,42,29,17,23,109,101
2021,2,22100070,10/28/2021,1610612763,Memphis Grizzlies,0,1,1610612744,Golden State Warriors,1,0,27,22,49,12,36,48,39,58,97,14,0,14,16,42,25,8,18,109,104
2016,2,21601030,3/18/2017,1610612766,Charlotte Hornets,1,1,1610612764,Washington Wizards,0,0,26,32,58,9,15,24,35,47,82,19,8,27,10,42,23,6,8,93,98
2016,2,21600492,12/30/2016,1610612741,Chicago Bulls,0,0,1610612754,Indiana Pacers,1,1,29,32,61,6,17,23,35,49,84,25,6,31,17,35,17,7,13,95,101
2022,2,22200539,12/31/2022,1610612751,Brooklyn Nets,0,1,1610612766,Charlotte Hornets,1,0,35,11,46,13,21,34,48,32,80,14,5,19,2,32,26,7,14,100,123
2022,2,22200539,12/31/2022,1610612766,Charlotte Hornets,1,0,1610612751,Brooklyn Nets,0,1,27,28,55,11,30,41,38,58,96,19,2,21,17,42,28,7,12,100,106
2021,2,22100940,3/3/2022,1610612738,Boston Celtics,1,1,1610612763,Memphis Grizzlies,0,0,30,22,52,16,21,37,46,43,89,12,3,15,17,28,33,10,14,92,120
2014,2,21400374,12/17/2014,1610612751,Brooklyn Nets,0,0,1610612761,Toronto Raptors,1,1,26,28,54,9,18,27,35,46,81,10,12,22,18,35,20,6,15,89,89
2016,2,21600492,12/30/2016,1610612754,Indiana Pacers,1,1,1610612741,Chicago Bulls,0,0,32,30,62,7,12,19,39,42,81,26,4,30,10,34,26,8,11,94,111
2021,2,22100940,3/3/2022,1610612763,Memphis Grizzlies,0,0,1610612738,Boston Celtics,1,1,29,30,59,13,27,40,42,57,99,10,3,13,21,37,24,4,7,91,107
2021,2,22100069,10/28/2021,1610612742,Dallas Mavericks,1,1,1610612759,San Antonio Spurs,0,0,23,21,44,18,27,45,41,48,89,4,9,13,14,38,18,6,13,95,104
2022,2,22200607,1/9/2023,1610612749,Milwaukee Bucks,0,1,1610612752,New York Knicks,1,0,20,20,40,19,30,49,39,50,89,14,4,18,17,35,27,8,14,94,111
2022,2,22200607,1/9/2023,1610612752,New York Knicks,1,0,1610612749,Milwaukee Bucks,0,1,27,32,59,11,30,41,38,62,100,20,2,22,23,40,16,3,7,95,107
2021,2,22100069,10/28/2021,1610612759,San Antonio Spurs,0,0,1610612742,Dallas Mavericks,1,1,27,31,58,12,18,30,39,49,88,9,6,15,15,38,21,4,15,95,99
2020,2,22000556,3/4/2021,1610612759,San Antonio Spurs,1,0,1610612760,Oklahoma City Thunder,0,1,30,24,54,10,21,31,40,45,85,12,0,12,7,38,23,9,19,103,102
2020,2,22000556,3/4/2021,1610612760,Oklahoma City Thunder,0,1,1610612759,San Antonio Spurs,1,0,25,20,45,12,28,40,37,48,85,21,5,26,10,42,20,9,17,104,107
2017,2,21700765,2/1/2018,1610612743,Denver Nuggets,1,1,1610612760,Oklahoma City Thunder,0,0,35,24,59,15,23,38,50,47,97,12,5,17,14,36,32,5,11,104,127
2017,2,21700765,2/1/2018,1610612760,Oklahoma City Thunder,0,0,1610612743,Denver Nuggets,1,1,42,28,70,9,19,28,51,47,98,13,4,17,11,39,34,3,7,103,124
2016,2,21601029,3/18/2017,1610612737,Atlanta Hawks,1,0,1610612757,Portland Trail Blazers,0,1,25,37,62,7,19,26,32,56,88,26,6,32,16,43,22,9,13,99,97
2021,2,22100939,3/2/2022,1610612756,Phoenix Suns,1,1,1610612757,Portland Trail Blazers,0,0,26,18,44,14,22,36,40,40,80,26,5,31,11,33,32,10,16,100,120
2022,2,22200545,12/31/2022,1610612755,Philadelphia 76ers,0,1,1610612760,Oklahoma City Thunder,1,0,35,30,65,11,23,34,46,53,99,12,5,17,19,37,29,7,13,101,115
2022,2,22200545,12/31/2022,1610612760,Oklahoma City Thunder,1,0,1610612755,Philadelphia 76ers,0,1,23,33,56,12,24,36,35,57,92,14,8,22,17,44,16,7,16,101,96
2021,2,22100939,3/2/2022,1610612757,Portland Trail Blazers,0,0,1610612756,Phoenix Suns,1,1,19,28,47,11,20,31,30,48,78,19,6,25,10,41,22,14,19,99,90
2021,2,22100068,10/28/2021,1610612745,Houston Rockets,1,0,1610612762,Utah Jazz,0,1,22,29,51,9,35,44,31,64,95,20,3,23,14,52,15,8,11,104,91
2021,2,22100068,10/28/2021,1610612762,Utah Jazz,0,1,1610612745,Houston Rockets,1,0,25,14,39,16,30,46,41,44,85,24,6,30,16,29,24,8,20,103,122
2016,2,21601029,3/18/2017,1610612757,Portland Trail Blazers,0,1,1610612737,Atlanta Hawks,1,0,36,33,69,8,10,18,44,43,87,17,2,19,17,26,23,13,22,100,113
2022,2,22200542,12/31/2022,1610612742,Dallas Mavericks,0,1,1610612759,San Antonio Spurs,1,0,36,16,52,14,20,34,50,36,86,12,9,21,8,33,21,1,5,96,126
2017,2,21700764,2/1/2018,1610612745,Houston Rockets,0,1,1610612759,San Antonio Spurs,1,0,23,18,41,14,28,42,37,46,83,14,3,17,9,38,20,7,9,89,102
2017,2,21700764,2/1/2018,1610612759,San Antonio Spurs,1,0,1610612745,Houston Rockets,0,1,29,30,59,6,18,24,35,48,83,15,2,17,16,33,21,10,16,91,91
2022,2,22200542,12/31/2022,1610612759,San Antonio Spurs,1,0,1610612742,Dallas Mavericks,0,1,39,27,66,8,11,19,47,38,85,23,9,32,19,25,28,5,13,94,125
2014,2,21400374,12/17/2014,1610612761,Toronto Raptors,1,1,1610612751,Brooklyn Nets,0,0,31,29,60,10,10,20,41,39,80,13,6,19,13,30,24,3,12,89,105
2021,2,22100938,3/2/2022,1610612743,Denver Nuggets,1,0,1610612760,Oklahoma City Thunder,0,1,28,16,44,12,34,46,40,50,90,15,2,17,10,42,25,11,16,102,107
2021,2,22100938,3/2/2022,1610612760,Oklahoma City Thunder,0,1,1610612743,Denver Nuggets,1,0,28,30,58,16,13,29,44,43,87,15,6,21,10,37,24,11,15,102,119
2014,2,21400657,1/25/2015,1610612741,Chicago Bulls,1,0,1610612748,Miami Heat,0,1,24,39,63,7,17,24,31,56,87,15,4,19,14,43,15,6,11,92,84
2014,2,21400657,1/25/2015,1610612748,Miami Heat,0,1,1610612741,Chicago Bulls,1,0,37,34,71,1,12,13,38,46,84,19,4,23,16,31,19,5,11,92,96
2022,2,22200544,12/31/2022,1610612750,Minnesota Timberwolves,1,0,1610612765,Detroit Pistons,0,1,26,23,49,10,24,34,36,47,83,22,4,26,10,38,17,6,15,100,104
2022,2,22200544,12/31/2022,1610612765,Detroit Pistons,0,1,1610612750,Minnesota Timberwolves,1,0,33,29,62,10,17,27,43,46,89,20,8,28,17,34,21,6,14,99,116
2022,2,22200477,12/22/2022,1610612740,New Orleans Pelicans,1,1,1610612759,San Antonio Spurs,0,0,31,26,57,13,21,34,44,47,91,25,2,27,18,30,25,8,17,101,126
2016,2,21601028,3/18/2017,1610612758,Sacramento Kings,0,0,1610612760,Oklahoma City Thunder,1,1,30,34,64,5,16,21,35,50,85,19,4,23,14,37,16,7,14,94,94
2016,2,21601028,3/18/2017,1610612760,Oklahoma City Thunder,1,1,1610612758,Sacramento Kings,0,0,31,25,56,10,16,26,41,41,82,18,7,25,16,29,23,9,16,94,110
2016,2,21600490,12/29/2016,1610612756,Phoenix Suns,1,1,1610612761,Toronto Raptors,0,0,28,34,62,9,12,21,37,46,83,16,7,23,16,35,20,12,20,97,99
2022,2,22200541,12/31/2022,1610612745,Houston Rockets,1,0,1610612752,New York Knicks,0,1,15,16,31,14,32,46,29,48,77,16,7,23,17,35,20,10,25,97,88
2022,2,22200541,12/31/2022,1610612752,New York Knicks,0,1,1610612745,Houston Rockets,1,0,20,19,39,15,36,51,35,55,90,23,9,32,19,41,20,4,10,96,108
2020,2,22000555,3/4/2021,1610612749,Milwaukee Bucks,0,1,1610612763,Memphis Grizzlies,1,0,32,29,61,10,24,34,42,53,95,18,4,22,15,40,21,13,16,105,112
2020,2,22000555,3/4/2021,1610612763,Memphis Grizzlies,1,0,1610612749,Milwaukee Bucks,0,1,32,35,67,8,26,34,40,61,101,23,1,24,20,42,21,11,12,104,111
2016,2,21600490,12/29/2016,1610612761,Toronto Raptors,0,0,1610612756,Phoenix Suns,1,1,23,25,48,7,20,27,30,45,75,24,5,29,10,38,10,10,19,98,91
2021,2,22100937,3/2/2022,1610612740,New Orleans Pelicans,1,1,1610612758,Sacramento Kings,0,0,41,18,59,11,18,29,52,36,88,10,2,12,11,26,30,9,16,99,125
2021,2,22100937,3/2/2022,1610612758,Sacramento Kings,0,0,1610612740,New Orleans Pelicans,1,1,27,27,54,8,27,35,35,54,89,17,8,25,14,44,20,5,11,99,95
2021,2,22100067,10/28/2021,1610612741,Chicago Bulls,1,0,1610612752,New York Knicks,0,1,25,27,52,11,21,32,36,48,84,20,2,22,8,41,25,5,7,93,103
2021,2,22100067,10/28/2021,1610612752,New York Knicks,0,1,1610612741,Chicago Bulls,1,0,28,28,56,11,18,29,39,46,85,15,5,20,13,35,16,6,13,94,104
2016,2,21600077,11/4/2016,1610612759,San Antonio Spurs,0,1,1610612762,Utah Jazz,1,0,31,32,63,6,14,20,37,46,83,20,2,22,13,34,17,7,11,92,100
2014,2,21400656,1/24/2015,1610612757,Portland Trail Blazers,1,1,1610612764,Washington Wizards,0,0,22,34,56,13,18,31,35,52,87,20,0,20,12,40,22,8,12,97,103
2014,2,21400656,1/24/2015,1610612764,Washington Wizards,0,0,1610612757,Portland Trail Blazers,1,1,35,32,67,5,10,15,40,42,82,11,3,14,5,39,24,8,13,98,96
2022,2,22200547,1/1/2023,1610612758,Sacramento Kings,0,0,1610612763,Memphis Grizzlies,1,1,24,29,53,15,28,43,39,57,96,15,0,15,19,38,24,11,16,100,108
2022,2,22200547,1/1/2023,1610612763,Memphis Grizzlies,1,1,1610612758,Sacramento Kings,0,0,36,32,68,10,22,32,46,54,100,16,8,24,24,34,25,7,12,100,118
2022,2,22200613,1/10/2023,1610612761,Toronto Raptors,1,1,1610612766,Charlotte Hornets,0,0,25,22,47,20,24,44,45,46,91,22,5,27,19,29,32,6,11,95,132
2022,2,22200613,1/10/2023,1610612766,Charlotte Hornets,0,0,1610612761,Toronto Raptors,1,1,32,19,51,15,20,35,47,39,86,11,4,15,9,33,33,4,10,95,120
2017,2,21700763,2/1/2018,1610612749,Milwaukee Bucks,0,0,1610612750,Minnesota Timberwolves,1,1,26,30,56,6,23,29,32,53,85,19,6,25,19,36,19,8,15,93,89
2017,2,21700763,2/1/2018,1610612750,Minnesota Timberwolves,1,1,1610612749,Milwaukee Bucks,0,0,35,24,59,7,12,19,42,36,78,17,3,20,8,30,27,6,14,93,108
2021,2,22100936,3/2/2022,1610612748,Miami Heat,0,0,1610612749,Milwaukee Bucks,1,1,23,30,53,21,23,44,44,53,97,10,2,12,12,42,28,7,12,104,119
2021,2,22100936,3/2/2022,1610612749,Milwaukee Bucks,1,1,1610612748,Miami Heat,0,0,27,28,55,14,22,36,41,50,91,24,3,27,13,39,22,9,12,103,120
2020,2,22000815,4/12/2021,1610612747,Los Angeles Lakers,0,0,1610612752,New York Knicks,1,1,23,21,44,12,24,36,35,45,80,14,4,18,14,34,22,14,25,100,96
2020,2,22000815,4/12/2021,1610612752,New York Knicks,1,1,1610612747,Los Angeles Lakers,0,0,37,25,62,5,22,27,42,47,89,22,5,27,17,32,18,5,15,99,111
2017,2,21700762,2/1/2018,1610612761,Toronto Raptors,0,0,1610612764,Washington Wizards,1,1,32,22,54,12,17,29,44,39,83,19,5,24,11,32,20,10,18,100,119
2022,2,22200537,12/30/2022,1610612758,Sacramento Kings,1,1,1610612762,Utah Jazz,0,0,38,22,60,12,18,30,50,40,90,14,5,19,14,30,32,7,15,99,126
2022,2,22200537,12/30/2022,1610612762,Utah Jazz,0,0,1610612758,Sacramento Kings,1,1,38,14,52,8,24,32,46,38,84,25,5,30,9,30,30,5,13,100,125
2017,2,21700762,2/1/2018,1610612764,Washington Wizards,1,1,1610612761,Toronto Raptors,0,0,34,21,55,10,20,30,44,41,85,24,2,26,16,25,30,7,16,100,122
2021,2,22100066,10/28/2021,1610612737,Atlanta Hawks,0,0,1610612764,Washington Wizards,1,1,42,25,67,6,15,21,48,40,88,9,5,14,6,38,26,6,13,100,111
2021,2,22100066,10/28/2021,1610612764,Washington Wizards,1,1,1610612737,Atlanta Hawks,0,0,33,32,65,13,21,34,46,53,99,17,4,21,17,38,26,4,9,101,122
2022,2,22200477,12/22/2022,1610612759,San Antonio Spurs,0,0,1610612740,New Orleans Pelicans,1,1,34,28,62,9,19,28,43,47,90,22,5,27,17,32,23,10,17,102,117
2014,2,21400373,12/17/2014,1610612748,Miami Heat,1,0,1610612762,Utah Jazz,0,1,23,30,53,4,13,17,27,43,70,29,11,40,12,36,10,4,11,88,87
2022,2,22200533,12/30/2022,1610612749,Milwaukee Bucks,1,1,1610612750,Minnesota Timberwolves,0,0,29,25,54,14,25,39,43,50,93,23,10,33,23,31,25,10,21,107,123
2014,2,21400373,12/17/2014,1610612762,Utah Jazz,0,1,1610612748,Miami Heat,1,0,21,20,41,14,11,25,35,31,66,21,3,24,10,24,23,10,20,88,105
2022,2,22200533,12/30/2022,1610612750,Minnesota Timberwolves,0,0,1610612749,Milwaukee Bucks,1,1,32,30,62,8,22,30,40,52,92,26,8,34,9,50,18,5,8,107,114
2016,2,21600077,11/4/2016,1610612762,Utah Jazz,1,0,1610612759,San Antonio Spurs,0,1,19,35,54,11,15,26,30,50,80,15,9,24,13,42,15,9,12,93,86
2014,2,21400655,1/24/2015,1610612751,Brooklyn Nets,0,0,1610612762,Utah Jazz,1,1,24,36,60,5,10,15,29,46,75,10,6,16,9,39,17,9,18,91,73
2014,2,21400655,1/24/2015,1610612762,Utah Jazz,1,1,1610612751,Brooklyn Nets,0,0,29,21,50,13,16,29,42,37,79,11,3,14,10,27,23,10,17,92,108
2021,2,22100935,3/2/2022,1610612745,Houston Rockets,1,0,1610612762,Utah Jazz,0,1,22,13,35,21,30,51,43,43,86,20,10,30,5,41,27,12,17,110,127
2021,2,22100935,3/2/2022,1610612762,Utah Jazz,0,1,1610612745,Houston Rockets,1,0,35,14,49,15,27,42,50,41,91,17,7,24,13,32,32,12,19,107,132
2016,2,21601027,3/17/2017,1610612747,Los Angeles Lakers,1,0,1610612749,Milwaukee Bucks,0,1,27,28,55,11,18,29,38,46,84,16,10,26,17,36,24,7,15,96,103
2016,2,21601027,3/17/2017,1610612749,Milwaukee Bucks,0,1,1610612747,Los Angeles Lakers,1,0,36,22,58,4,20,24,40,42,82,23,7,30,14,32,22,7,15,96,107
2016,2,21600489,12/29/2016,1610612755,Philadelphia 76ers,0,0,1610612762,Utah Jazz,1,1,29,34,63,6,18,24,35,52,87,7,1,8,19,34,16,9,16,89,83
2016,2,21600489,12/29/2016,1610612762,Utah Jazz,1,1,1610612755,Philadelphia 76ers,0,0,20,27,47,15,11,26,35,38,73,15,13,28,13,32,21,6,15,88,100
2017,2,21700761,2/1/2018,1610612763,Memphis Grizzlies,0,0,1610612765,Detroit Pistons,1,1,32,33,65,8,23,31,40,56,96,14,0,14,17,39,22,8,12,97,102
2017,2,21700761,2/1/2018,1610612765,Detroit Pistons,1,1,1610612763,Memphis Grizzlies,0,0,28,23,51,7,18,25,35,41,76,27,10,37,6,40,20,3,9,96,104
2021,2,22100065,10/28/2021,1610612755,Philadelphia 76ers,1,1,1610612765,Detroit Pistons,0,0,26,23,49,12,15,27,38,38,76,22,2,24,11,28,22,11,21,97,110
2021,2,22100065,10/28/2021,1610612765,Detroit Pistons,0,0,1610612755,Philadelphia 76ers,1,1,22,25,47,13,26,39,35,51,86,19,8,27,15,40,22,7,14,99,102
2014,2,21400372,12/17/2014,1610612742,Dallas Mavericks,0,1,1610612765,Detroit Pistons,1,0,30,27,57,10,12,22,40,39,79,27,8,35,11,33,29,9,14,97,117
2014,2,21400372,12/17/2014,1610612765,Detroit Pistons,1,0,1610612742,Dallas Mavericks,0,1,27,29,56,13,20,33,40,49,89,13,6,19,12,40,22,9,11,99,106
2023,2,22300324,12/14/2023,1610612760,Oklahoma City Thunder,0,0,1610612758,Sacramento Kings,1,1,33,33,66,11,25,36,44,58,102,24,3,27,21,38,26,6,14,107,123
2023,2,22300002,11/3/2023,1610612749,Milwaukee Bucks,1,1,1610612752,New York Knicks,0,0,15,28,43,20,19,39,35,47,82,20,8,28,9,41,24,6,14,99,110
2021,2,22100934,3/2/2022,1610612752,New York Knicks,0,0,1610612755,Philadelphia 76ers,1,1,31,32,63,8,20,28,39,52,91,22,10,32,18,40,20,2,10,96,108
2021,2,22100934,3/2/2022,1610612755,Philadelphia 76ers,1,1,1610612752,New York Knicks,0,0,22,17,39,17,19,36,39,36,75,28,5,33,8,30,24,9,14,97,123
2022,2,22200588,1/6/2023,1610612739,Cleveland Cavaliers,0,0,1610612743,Denver Nuggets,1,1,30,32,62,10,16,26,40,48,88,18,14,32,20,36,30,5,7,89,108
2022,2,22200588,1/6/2023,1610612743,Denver Nuggets,1,1,1610612739,Cleveland Cavaliers,0,0,26,20,46,17,18,35,43,38,81,18,5,23,17,24,28,7,14,90,121
2014,2,21401156,4/7/2015,1610612740,New Orleans Pelicans,1,1,1610612744,Golden State Warriors,0,0,27,37,64,9,10,19,36,47,83,22,8,30,10,42,25,6,12,99,103
2014,2,21401156,4/7/2015,1610612744,Golden State Warriors,0,0,1610612740,New Orleans Pelicans,1,1,33,40,73,9,13,22,42,53,95,7,3,10,14,40,25,8,12,99,100
2016,2,21600488,12/29/2016,1610612738,Boston Celtics,0,0,1610612739,Cleveland Cavaliers,1,1,31,17,48,12,25,37,43,42,85,20,1,21,8,34,26,7,11,98,118
2016,2,21600488,12/29/2016,1610612739,Cleveland Cavaliers,1,1,1610612738,Boston Celtics,0,0,29,16,45,14,24,38,43,40,83,24,9,33,18,26,29,15,18,99,124
2020,2,22000814,4/11/2021,1610612748,Miami Heat,0,1,1610612757,Portland Trail Blazers,1,0,29,25,54,12,17,29,41,42,83,13,7,20,8,37,21,5,8,93,107
2020,2,22000814,4/11/2021,1610612757,Portland Trail Blazers,1,0,1610612748,Miami Heat,0,1,26,16,42,11,24,35,37,40,77,13,6,19,11,30,21,12,17,94,98
2020,2,22000554,3/4/2021,1610612746,LA Clippers,0,0,1610612764,Washington Wizards,1,1,22,25,47,16,19,35,38,44,82,25,2,27,13,32,24,12,19,103,117
2020,2,22000554,3/4/2021,1610612764,Washington Wizards,1,1,1610612746,LA Clippers,0,0,31,34,65,9,14,23,40,48,88,30,12,42,14,40,20,4,9,103,119
2022,2,22200632,1/13/2023,1610612740,New Orleans Pelicans,0,1,1610612765,Detroit Pistons,1,0,31,24,55,11,20,31,42,44,86,21,9,30,12,36,29,7,17,106,116
2022,2,22200632,1/13/2023,1610612765,Detroit Pistons,1,0,1610612740,New Orleans Pelicans,0,1,36,24,60,7,23,30,43,47,90,17,7,24,8,43,20,7,13,105,110
2021,2,22100064,10/27/2021,1610612739,Cleveland Cavaliers,0,1,1610612746,LA Clippers,1,0,30,31,61,3,17,20,33,48,81,23,4,27,19,31,12,13,21,96,92
2021,2,22100064,10/27/2021,1610612746,LA Clippers,1,0,1610612739,Cleveland Cavaliers,0,1,22,24,46,9,32,41,31,56,87,8,5,13,12,48,19,9,14,94,79
2020,2,22000813,4/11/2021,1610612746,LA Clippers,1,1,1610612765,Detroit Pistons,0,0,35,18,53,15,12,27,50,30,80,16,5,21,12,19,35,12,17,95,131
2020,2,22000813,4/11/2021,1610612765,Detroit Pistons,0,0,1610612746,LA Clippers,1,1,31,24,55,15,17,32,46,41,87,17,2,19,13,30,33,4,13,95,124
2016,2,21601026,3/17/2017,1610612753,Orlando Magic,0,1,1610612756,Phoenix Suns,1,0,35,38,73,7,16,23,42,54,96,18,3,21,18,37,21,9,13,102,109
2016,2,21601026,3/17/2017,1610612756,Phoenix Suns,1,0,1610612753,Orlando Magic,0,1,36,37,73,2,12,14,38,49,87,25,5,30,16,35,18,10,16,102,103
2021,2,22100933,3/2/2022,1610612753,Orlando Magic,1,0,1610612754,Indiana Pacers,0,1,34,31,65,10,22,32,44,53,97,16,4,20,15,41,22,12,20,110,114
2021,2,22100933,3/2/2022,1610612754,Indiana Pacers,0,1,1610612753,Orlando Magic,1,0,29,28,57,12,25,37,41,53,94,28,7,35,17,40,23,12,18,112,122
2021,2,22100063,10/27/2021,1610612757,Portland Trail Blazers,1,1,1610612763,Memphis Grizzlies,0,0,24,24,48,15,21,36,39,45,84,23,8,31,15,35,22,9,14,99,116
2016,2,21601025,3/17/2017,1610612748,Miami Heat,1,1,1610612750,Minnesota Timberwolves,0,0,42,17,59,8,18,26,50,35,85,15,4,19,17,20,29,6,15,93,123
2016,2,21601025,3/17/2017,1610612750,Minnesota Timberwolves,0,0,1610612748,Miami Heat,1,1,39,31,70,2,10,12,41,41,82,21,1,22,10,31,14,6,11,93,105
2023,2,22301216,12/8/2023,1610612761,Toronto Raptors,0,0,1610612766,Charlotte Hornets,1,1,41,20,61,6,26,32,47,46,93,16,5,21,18,29,32,7,14,99,116
2017,2,21700760,1/31/2018,1610612742,Dallas Mavericks,0,0,1610612756,Phoenix Suns,1,1,22,30,52,10,26,36,32,56,88,14,12,26,19,43,18,9,12,93,88
2017,2,21700760,1/31/2018,1610612756,Phoenix Suns,1,1,1610612742,Dallas Mavericks,0,0,29,24,53,11,19,30,40,43,83,11,4,15,12,34,23,11,18,93,102
2023,2,22300027,11/17/2023,1610612749,Milwaukee Bucks,0,1,1610612766,Charlotte Hornets,1,0,27,17,44,22,23,45,49,40,89,10,3,13,6,36,32,5,13,102,130
2020,2,22000553,3/4/2021,1610612743,Denver Nuggets,0,1,1610612754,Indiana Pacers,1,0,33,16,49,12,16,28,45,32,77,11,5,16,10,25,27,12,19,96,113
2020,2,22000553,3/4/2021,1610612754,Indiana Pacers,1,0,1610612743,Denver Nuggets,0,1,27,24,51,14,25,39,41,49,90,7,5,12,15,38,27,6,15,96,103
2021,2,22100063,10/27/2021,1610612763,Memphis Grizzlies,0,0,1610612757,Portland Trail Blazers,1,1,18,28,46,17,33,50,35,61,96,9,10,19,29,38,27,11,22,99,96
2014,2,21400371,12/17/2014,1610612738,Boston Celtics,1,1,1610612753,Orlando Magic,0,0,37,24,61,7,12,19,44,36,80,14,4,18,10,28,25,8,14,94,109
2021,2,22100932,3/2/2022,1610612739,Cleveland Cavaliers,1,0,1610612766,Charlotte Hornets,0,1,27,21,48,10,21,31,37,42,79,14,7,21,8,37,21,10,14,97,98
2022,2,22200619,1/11/2023,1610612741,Chicago Bulls,0,0,1610612764,Washington Wizards,1,1,32,27,59,9,20,29,41,47,88,6,3,9,9,41,16,5,12,94,97
2022,2,22200619,1/11/2023,1610612764,Washington Wizards,1,1,1610612741,Chicago Bulls,0,0,31,28,59,7,16,23,38,44,82,17,4,21,13,34,21,7,18,94,100
2021,2,22100932,3/2/2022,1610612766,Charlotte Hornets,0,1,1610612739,Cleveland Cavaliers,1,0,26,21,47,17,21,38,43,42,85,16,6,22,11,34,32,6,12,95,119
2021,2,22100062,10/27/2021,1610612756,Phoenix Suns,1,0,1610612758,Sacramento Kings,0,1,36,35,71,6,16,22,42,51,93,17,7,24,17,35,23,7,11,100,107
2016,2,21600076,11/4/2016,1610612742,Dallas Mavericks,1,0,1610612757,Portland Trail Blazers,0,1,24,31,55,10,18,28,34,49,83,17,3,20,11,39,18,9,13,95,95
2016,2,21600076,11/4/2016,1610612757,Portland Trail Blazers,0,1,1610612742,Dallas Mavericks,1,0,24,25,49,12,19,31,36,44,80,21,5,26,9,38,21,5,14,96,105
2017,2,21700759,1/31/2018,1610612741,Chicago Bulls,0,0,1610612757,Portland Trail Blazers,1,1,28,37,65,13,21,34,41,58,99,13,9,22,16,44,19,3,6,99,108
2017,2,21700759,1/31/2018,1610612757,Portland Trail Blazers,1,1,1610612741,Chicago Bulls,0,0,31,19,50,15,17,32,46,36,82,17,3,20,10,26,21,10,17,100,124
2016,2,21601024,3/17/2017,1610612740,New Orleans Pelicans,1,1,1610612745,Houston Rockets,0,0,37,21,58,12,22,34,49,43,92,18,6,24,9,36,29,6,13,106,128
2016,2,21601024,3/17/2017,1610612745,Houston Rockets,0,0,1610612740,New Orleans Pelicans,1,1,24,27,51,13,27,40,37,54,91,25,7,32,11,47,18,8,13,106,112
2016,2,21600487,12/29/2016,1610612760,Oklahoma City Thunder,0,0,1610612763,Memphis Grizzlies,1,1,21,31,52,4,18,22,25,49,74,26,11,37,23,32,9,8,19,90,80
2016,2,21600487,12/29/2016,1610612763,Memphis Grizzlies,1,1,1610612760,Oklahoma City Thunder,0,0,30,30,60,13,9,22,43,39,82,15,5,20,14,26,24,5,14,89,114
2022,2,22200591,1/7/2023,1610612738,Boston Celtics,0,1,1610612759,San Antonio Spurs,1,0,32,29,61,15,19,34,47,48,95,12,6,18,12,40,30,6,14,104,121
2016,2,21600486,12/29/2016,1610612748,Miami Heat,0,0,1610612766,Charlotte Hornets,1,1,23,31,54,10,18,28,33,49,82,6,7,13,7,45,26,9,17,98,82
2022,2,22200591,1/7/2023,1610612759,San Antonio Spurs,1,0,1610612738,Boston Celtics,0,1,42,33,75,7,18,25,49,51,100,11,3,14,16,37,25,6,13,104,116
2016,2,21600486,12/29/2016,1610612766,Charlotte Hornets,1,1,1610612748,Miami Heat,0,0,31,36,67,5,21,26,36,57,93,14,4,18,13,45,18,6,9,97,91
2023,2,22300028,11/17/2023,1610612752,New York Knicks,0,1,1610612764,Washington Wizards,1,0,29,24,53,16,22,38,45,46,91,14,6,20,18,30,26,4,11,93,120
2021,2,22100931,3/1/2022,1610612742,Dallas Mavericks,0,1,1610612747,Los Angeles Lakers,1,0,31,16,47,10,25,35,41,41,82,17,10,27,12,34,24,8,14,95,109
2016,2,21600485,12/28/2016,1610612744,Golden State Warriors,1,1,1610612761,Toronto Raptors,0,0,32,26,58,14,9,23,46,35,81,15,3,18,11,26,33,13,20,98,121
2016,2,21600485,12/28/2016,1610612761,Toronto Raptors,0,0,1610612744,Golden State Warriors,1,1,27,41,68,13,22,35,40,63,103,18,4,22,22,44,24,4,7,100,111
2019,2,21900013,10/23/2019,1610612743,Denver Nuggets,0,1,1610612757,Portland Trail Blazers,1,0,16,33,49,18,14,32,34,47,81,22,5,27,13,37,24,9,20,103,108
2019,2,21900013,10/23/2019,1610612757,Portland Trail Blazers,1,0,1610612743,Denver Nuggets,0,1,29,30,59,7,21,28,36,51,87,21,2,23,16,35,13,11,20,102,100
2014,2,21401157,4/7/2015,1610612759,San Antonio Spurs,0,1,1610612760,Oklahoma City Thunder,1,0,37,28,65,10,14,24,47,42,89,9,4,13,13,30,27,13,15,97,113
2016,2,21601023,3/17/2017,1610612761,Toronto Raptors,0,1,1610612765,Detroit Pistons,1,0,21,30,51,9,18,27,30,48,78,18,2,20,9,40,19,5,12,91,87
2016,2,21601023,3/17/2017,1610612765,Detroit Pistons,1,0,1610612761,Toronto Raptors,0,1,26,37,63,3,17,20,29,54,83,14,7,21,14,45,14,5,13,92,75
2014,2,21401157,4/7/2015,1610612760,Oklahoma City Thunder,1,0,1610612759,San Antonio Spurs,0,1,29,36,65,5,14,19,34,50,84,15,13,28,15,40,14,7,15,97,88
2014,2,21400654,1/24/2015,1610612755,Philadelphia 76ers,0,0,1610612763,Memphis Grizzlies,1,1,22,35,57,9,15,24,31,50,81,12,10,22,16,40,18,10,24,99,83
2014,2,21400654,1/24/2015,1610612763,Memphis Grizzlies,1,1,1610612755,Philadelphia 76ers,0,0,31,34,65,6,8,14,37,42,79,21,4,25,11,33,24,7,18,99,101
2017,2,21700758,1/31/2018,1610612738,Boston Celtics,1,1,1610612752,New York Knicks,0,0,29,28,57,11,15,26,40,43,83,12,8,20,8,36,27,4,10,96,103
2017,2,21700758,1/31/2018,1610612752,New York Knicks,0,0,1610612738,Boston Celtics,1,1,25,45,70,3,14,17,28,59,87,14,7,21,13,49,16,8,14,96,73
2014,2,21400371,12/17/2014,1610612753,Orlando Magic,0,0,1610612738,Boston Celtics,1,1,32,34,66,5,14,19,37,48,85,13,2,15,12,37,17,9,12,93,92
2022,2,22200443,12/17/2022,1610612760,Oklahoma City Thunder,1,1,1610612763,Memphis Grizzlies,0,0,19,28,47,19,26,45,38,54,92,20,11,31,13,46,29,5,10,103,115
2022,2,22200443,12/17/2022,1610612763,Memphis Grizzlies,0,0,1610612760,Oklahoma City Thunder,1,1,22,23,45,12,33,45,34,56,90,29,8,37,13,47,15,7,10,104,109
2016,2,21601022,3/17/2017,1610612738,Boston Celtics,0,1,1610612751,Brooklyn Nets,1,0,27,29,56,7,22,29,34,51,85,23,6,29,13,40,20,7,13,97,98
2016,2,21601022,3/17/2017,1610612751,Brooklyn Nets,1,0,1610612738,Boston Celtics,0,1,19,29,48,11,24,35,30,53,83,24,6,30,12,44,23,7,10,99,95
2016,2,21600484,12/28/2016,1610612757,Portland Trail Blazers,1,1,1610612758,Sacramento Kings,0,0,23,26,49,12,13,25,35,39,74,20,2,22,8,33,19,8,16,93,102
2016,2,21600484,12/28/2016,1610612758,Sacramento Kings,0,0,1610612757,Portland Trail Blazers,1,1,22,29,51,9,19,28,31,48,79,18,5,23,10,40,20,6,11,93,89
2014,2,21400370,12/17/2014,1610612737,Atlanta Hawks,0,1,1610612739,Cleveland Cavaliers,1,0,33,15,48,16,12,28,49,27,76,13,3,16,6,23,36,3,9,87,127
2022,2,22200442,12/17/2022,1610612749,Milwaukee Bucks,1,1,1610612762,Utah Jazz,0,0,30,22,52,18,20,38,48,42,90,9,2,11,17,26,30,5,15,95,123
2022,2,22200442,12/17/2022,1610612762,Utah Jazz,0,0,1610612749,Milwaukee Bucks,1,1,23,16,39,16,31,47,39,47,86,3,3,6,8,41,24,5,14,94,97
2021,2,22100931,3/1/2022,1610612747,Los Angeles Lakers,1,0,1610612742,Dallas Mavericks,0,1,23,25,48,14,20,34,37,45,82,16,4,20,7,39,22,8,12,96,104
2021,2,22100062,10/27/2021,1610612758,Sacramento Kings,0,1,1610612756,Phoenix Suns,1,0,27,30,57,15,23,38,42,53,95,11,4,15,13,43,28,6,12,100,110
2014,2,21400370,12/17/2014,1610612739,Cleveland Cavaliers,1,0,1610612737,Atlanta Hawks,0,1,29,23,52,8,22,30,37,45,82,16,5,21,13,34,24,3,9,87,98
2016,2,21600483,12/28/2016,1610612743,Denver Nuggets,1,1,1610612750,Minnesota Timberwolves,0,0,32,21,53,10,18,28,42,39,81,11,3,14,12,29,29,8,15,92,105
2016,2,21600483,12/28/2016,1610612750,Minnesota Timberwolves,0,0,1610612743,Denver Nuggets,1,1,35,34,69,7,18,25,42,52,94,12,5,17,19,34,29,6,8,92,103
2014,2,21401155,4/7/2015,1610612748,Miami Heat,1,1,1610612766,Charlotte Hornets,0,0,37,29,66,3,12,15,40,41,81,22,6,28,13,30,20,8,11,92,105
2017,2,21700757,1/31/2018,1610612739,Cleveland Cavaliers,1,1,1610612748,Miami Heat,0,0,22,32,54,6,20,26,28,52,80,29,9,38,12,46,18,8,16,105,91
2017,2,21700757,1/31/2018,1610612748,Miami Heat,0,0,1610612739,Cleveland Cavaliers,1,1,33,22,55,3,25,28,36,47,83,14,11,25,12,42,17,9,20,104,89
2016,2,21601021,3/17/2017,1610612741,Chicago Bulls,0,0,1610612764,Washington Wizards,1,1,37,24,61,7,20,27,44,44,88,12,6,18,18,29,28,5,19,98,107
2016,2,21601021,3/17/2017,1610612764,Washington Wizards,1,1,1610612741,Chicago Bulls,0,0,36,39,75,10,16,26,46,55,101,10,2,12,18,39,34,5,10,98,112
2021,2,22100930,3/1/2022,1610612744,Golden State Warriors,0,0,1610612750,Minnesota Timberwolves,1,1,28,17,45,13,32,45,41,49,90,19,3,22,11,41,26,10,17,104,114
2021,2,22100930,3/1/2022,1610612750,Minnesota Timberwolves,1,1,1610612744,Golden State Warriors,0,0,31,18,49,16,24,40,47,42,89,19,4,23,11,33,27,11,16,104,129
2017,2,21700756,1/31/2018,1610612751,Brooklyn Nets,1,1,1610612755,Philadelphia 76ers,0,0,26,19,45,13,19,32,39,38,77,25,3,28,12,29,19,7,14,91,116
2017,2,21700756,1/31/2018,1610612755,Philadelphia 76ers,0,0,1610612751,Brooklyn Nets,1,1,29,29,58,7,11,18,36,40,76,29,5,34,11,32,17,3,8,90,108
2022,2,22200441,12/17/2022,1610612745,Houston Rockets,1,0,1610612757,Portland Trail Blazers,0,1,33,28,61,3,26,29,36,54,90,20,9,29,28,27,19,8,17,96,95
2016,2,21600482,12/28/2016,1610612756,Phoenix Suns,0,0,1610612759,San Antonio Spurs,1,1,29,29,58,7,9,16,36,38,74,19,5,24,9,33,20,11,22,99,98
2016,2,21600482,12/28/2016,1610612759,San Antonio Spurs,1,1,1610612756,Phoenix Suns,0,0,42,28,70,5,12,17,47,40,87,20,5,25,16,27,20,11,16,99,119
2016,2,21600075,11/4/2016,1610612740,New Orleans Pelicans,1,0,1610612756,Phoenix Suns,0,1,33,31,64,10,20,30,43,51,94,15,13,28,11,49,28,7,9,106,111
2016,2,21600075,11/4/2016,1610612756,Phoenix Suns,0,1,1610612740,New Orleans Pelicans,1,0,32,37,69,8,16,24,40,53,93,24,4,28,16,39,18,7,16,106,112
2022,2,22200441,12/17/2022,1610612757,Portland Trail Blazers,0,1,1610612745,Houston Rockets,1,0,27,22,49,13,23,36,40,45,85,14,5,19,11,35,20,7,14,95,107
2022,2,22200445,12/18/2022,1610612738,Boston Celtics,1,0,1610612753,Orlando Magic,0,1,19,23,42,12,35,47,31,58,89,18,3,21,17,43,22,9,17,102,92
2016,2,21601020,3/17/2017,1610612742,Dallas Mavericks,0,0,1610612755,Philadelphia 76ers,1,1,25,39,64,5,18,23,30,57,87,9,8,17,13,47,21,8,13,98,74
2016,2,21601020,3/17/2017,1610612755,Philadelphia 76ers,1,1,1610612742,Dallas Mavericks,0,0,30,21,51,12,17,29,42,38,80,20,3,23,10,29,32,6,16,97,116
2022,2,22200445,12/18/2022,1610612753,Orlando Magic,0,1,1610612738,Boston Celtics,1,0,21,36,57,12,17,29,33,53,86,17,2,19,7,46,20,7,13,100,95
2022,2,22200475,12/21/2022,1610612747,Los Angeles Lakers,0,0,1610612758,Sacramento Kings,1,1,31,29,60,11,13,24,42,42,84,25,5,30,5,39,25,6,15,105,120
2022,2,22200475,12/21/2022,1610612758,Sacramento Kings,1,1,1610612747,Los Angeles Lakers,0,0,31,17,48,17,30,47,48,47,95,21,7,28,15,36,29,6,12,105,134
2014,2,21400369,12/17/2014,1610612756,Phoenix Suns,0,1,1610612766,Charlotte Hornets,1,0,34,23,57,9,16,25,43,39,82,16,5,21,12,28,22,6,8,89,111
2014,2,21400369,12/17/2014,1610612766,Charlotte Hornets,1,0,1610612756,Phoenix Suns,0,1,30,32,62,10,14,24,40,46,86,16,6,22,14,36,22,4,7,89,106
2014,2,21401155,4/7/2015,1610612766,Charlotte Hornets,0,0,1610612748,Miami Heat,1,1,34,39,73,5,13,18,39,52,91,17,4,21,18,36,12,4,9,92,100
2014,2,21400653,1/24/2015,1610612749,Milwaukee Bucks,1,1,1610612765,Detroit Pistons,0,0,30,34,64,11,6,17,41,40,81,8,2,10,10,31,33,11,21,96,101
2022,2,22200440,12/17/2022,1610612739,Cleveland Cavaliers,1,1,1610612742,Dallas Mavericks,0,0,33,25,58,7,29,36,40,54,94,13,9,22,17,42,23,5,13,100,100
2017,2,21700755,1/31/2018,1610612737,Atlanta Hawks,1,0,1610612766,Charlotte Hornets,0,1,27,18,45,12,20,32,39,38,77,20,2,22,7,31,26,6,10,92,110
2017,2,21700755,1/31/2018,1610612766,Charlotte Hornets,0,1,1610612737,Atlanta Hawks,1,0,29,29,58,17,15,32,46,44,90,14,4,18,20,26,29,5,12,93,123
2022,2,22200440,12/17/2022,1610612742,Dallas Mavericks,0,0,1610612739,Cleveland Cavaliers,1,1,21,18,39,15,34,49,36,52,88,12,7,19,11,44,19,6,12,100,99
2021,2,22100929,3/1/2022,1610612745,Houston Rockets,1,0,1610612746,LA Clippers,0,1,25,32,57,13,26,39,38,58,96,11,6,17,18,42,21,7,14,101,100
2021,2,22100929,3/1/2022,1610612746,LA Clippers,0,1,1610612745,Houston Rockets,1,0,29,36,65,13,18,31,42,54,96,16,1,17,19,35,24,8,16,100,113
2021,2,22100061,10/27/2021,1610612747,Los Angeles Lakers,0,0,1610612760,Oklahoma City Thunder,1,1,35,22,57,11,24,35,46,46,92,12,2,14,12,36,29,8,17,104,115
2021,2,22100061,10/27/2021,1610612760,Oklahoma City Thunder,1,1,1610612747,Los Angeles Lakers,0,0,28,21,49,15,22,37,43,43,86,22,7,29,12,34,21,8,16,105,123
2020,2,22000552,3/4/2021,1610612738,Boston Celtics,1,1,1610612761,Toronto Raptors,0,0,32,13,45,13,16,29,45,29,74,29,11,40,11,21,25,6,16,99,132
2016,2,21601019,3/16/2017,1610612744,Golden State Warriors,1,1,1610612753,Orlando Magic,0,0,40,21,61,10,16,26,50,37,87,12,11,23,10,33,36,7,13,102,122
2016,2,21601019,3/16/2017,1610612753,Orlando Magic,0,0,1610612744,Golden State Warriors,1,1,28,39,67,7,20,27,35,59,94,15,6,21,22,40,15,14,21,102,92
2017,2,21700754,1/31/2018,1610612747,Los Angeles Lakers,0,0,1610612753,Orlando Magic,1,1,35,28,63,4,16,20,39,44,83,23,7,30,12,34,18,13,17,102,105
2017,2,21700754,1/31/2018,1610612753,Orlando Magic,1,1,1610612747,Los Angeles Lakers,0,0,26,23,49,18,14,32,44,37,81,21,8,29,7,33,28,7,15,104,127
2014,2,21400368,12/16/2014,1610612758,Sacramento Kings,1,0,1610612760,Oklahoma City Thunder,0,1,31,35,66,5,13,18,36,48,84,15,2,17,18,31,21,9,19,94,92
2014,2,21400368,12/16/2014,1610612760,Oklahoma City Thunder,0,1,1610612758,Sacramento Kings,1,0,35,32,67,6,14,20,41,46,87,16,8,24,15,37,18,7,12,93,104
2016,2,21600481,12/28/2016,1610612740,New Orleans Pelicans,1,1,1610612746,LA Clippers,0,0,30,28,58,10,19,29,40,47,87,12,9,21,9,45,23,6,7,94,102
2021,2,22100928,3/1/2022,1610612751,Brooklyn Nets,0,0,1610612761,Toronto Raptors,1,1,32,27,59,10,15,25,42,42,84,14,5,19,9,34,21,5,12,94,108
2021,2,22100928,3/1/2022,1610612761,Toronto Raptors,1,1,1610612751,Brooklyn Nets,0,0,34,33,67,7,16,23,41,49,90,20,3,23,19,31,27,3,13,94,109
2016,2,21600481,12/28/2016,1610612746,LA Clippers,0,0,1610612740,New Orleans Pelicans,1,1,26,31,57,11,26,37,37,57,94,13,5,18,19,39,15,11,13,95,98
2022,2,22200439,12/17/2022,1610612748,Miami Heat,0,1,1610612759,San Antonio Spurs,1,0,31,21,52,11,19,30,42,40,82,16,7,23,10,34,25,8,14,95,111
2022,2,22200439,12/17/2022,1610612759,San Antonio Spurs,1,0,1610612748,Miami Heat,0,1,23,27,50,10,17,27,33,44,77,25,8,33,14,34,29,14,17,97,101
2020,2,22000552,3/4/2021,1610612761,Toronto Raptors,0,0,1610612738,Boston Celtics,1,1,24,17,41,21,29,50,45,46,91,14,3,17,14,33,36,6,14,99,125
2016,2,21601018,3/16/2017,1610612743,Denver Nuggets,1,1,1610612746,LA Clippers,0,0,31,27,58,15,13,28,46,40,86,22,4,26,12,31,31,5,11,96,129
2016,2,21601018,3/16/2017,1610612746,LA Clippers,0,0,1610612743,Denver Nuggets,1,1,28,24,52,16,16,32,44,40,84,10,5,15,5,37,26,7,9,95,114
2016,2,21600074,11/4/2016,1610612746,LA Clippers,0,1,1610612763,Memphis Grizzlies,1,0,24,34,58,8,19,27,32,53,85,27,6,33,18,37,19,4,12,97,99
2016,2,21600074,11/4/2016,1610612763,Memphis Grizzlies,1,0,1610612746,LA Clippers,0,1,22,36,58,9,17,26,31,53,84,17,5,22,18,36,26,17,19,95,88
2020,2,22000551,3/3/2021,1610612747,Los Angeles Lakers,0,0,1610612758,Sacramento Kings,1,1,37,29,66,12,15,27,49,44,93,10,4,14,17,28,27,5,12,95,120
2020,2,22000551,3/3/2021,1610612758,Sacramento Kings,1,1,1610612747,Los Angeles Lakers,0,0,36,19,55,12,13,25,48,32,80,15,4,19,7,29,32,7,14,94,123
2014,2,21400367,12/16/2014,1610612742,Dallas Mavericks,0,1,1610612752,New York Knicks,1,0,27,23,50,15,18,33,42,41,83,8,0,8,14,27,30,11,17,90,107
2014,2,21400367,12/16/2014,1610612752,New York Knicks,1,0,1610612742,Dallas Mavericks,0,1,32,31,63,5,16,21,37,47,84,8,2,10,14,34,23,9,15,91,87
2022,2,22200496,12/25/2022,1610612744,Golden State Warriors,1,1,1610612763,Memphis Grizzlies,0,0,25,22,47,18,26,44,43,48,91,19,7,26,13,39,31,5,12,109,123
2021,2,22100060,10/27/2021,1610612749,Milwaukee Bucks,1,0,1610612750,Minnesota Timberwolves,0,1,25,19,44,14,37,51,39,56,95,16,5,21,16,42,22,5,9,100,108
2021,2,22100060,10/27/2021,1610612750,Minnesota Timberwolves,0,1,1610612749,Milwaukee Bucks,1,0,30,16,46,13,32,45,43,48,91,14,3,17,16,33,29,10,17,99,113
2022,2,22200496,12/25/2022,1610612763,Memphis Grizzlies,0,0,1610612744,Golden State Warriors,1,1,30,25,55,9,30,39,39,55,94,22,8,30,14,44,19,6,13,108,109
2019,2,21900230,11/23/2019,1610612748,Miami Heat,0,0,1610612755,Philadelphia 76ers,1,1,24,27,51,6,18,24,30,45,75,20,7,27,12,38,12,11,18,94,86
2019,2,21900230,11/23/2019,1610612755,Philadelphia 76ers,1,1,1610612748,Miami Heat,0,0,28,26,54,14,15,29,42,41,83,15,2,17,12,30,28,6,15,94,113
2017,2,21700753,1/31/2018,1610612754,Indiana Pacers,1,1,1610612763,Memphis Grizzlies,0,0,27,17,44,10,16,26,37,33,70,21,10,31,9,28,20,10,14,90,105
2017,2,21700753,1/31/2018,1610612763,Memphis Grizzlies,0,0,1610612754,Indiana Pacers,1,1,27,29,56,12,14,26,39,43,82,11,4,15,19,26,20,16,18,90,101
2016,2,21601017,3/16/2017,1610612737,Atlanta Hawks,1,0,1610612763,Memphis Grizzlies,0,1,21,23,44,8,19,27,29,42,71,25,9,34,13,34,19,7,18,94,91
2016,2,21601017,3/16/2017,1610612763,Memphis Grizzlies,0,1,1610612737,Atlanta Hawks,1,0,29,35,64,10,18,28,39,53,92,15,3,18,21,32,29,6,12,94,103
2016,2,21600480,12/28/2016,1610612741,Chicago Bulls,1,1,1610612751,Brooklyn Nets,0,0,32,43,75,3,10,13,35,53,88,28,1,29,24,30,20,9,18,98,101
2017,2,21700752,1/30/2018,1610612746,LA Clippers,1,0,1610612757,Portland Trail Blazers,0,1,29,34,63,6,16,22,35,50,85,20,6,26,11,42,22,12,13,99,96
2022,2,22200565,1/4/2023,1610612739,Cleveland Cavaliers,1,1,1610612756,Phoenix Suns,0,0,19,22,41,11,25,36,30,47,77,19,4,23,10,41,15,8,15,92,90
2022,2,22200565,1/4/2023,1610612756,Phoenix Suns,0,0,1610612739,Cleveland Cavaliers,1,1,22,31,53,10,18,28,32,49,81,14,4,18,11,41,24,9,15,94,88
2017,2,21700752,1/30/2018,1610612757,Portland Trail Blazers,0,1,1610612746,LA Clippers,1,0,23,45,68,13,17,30,36,62,98,19,3,22,21,42,21,5,13,99,104
2021,2,22100927,3/1/2022,1610612737,Atlanta Hawks,0,0,1610612738,Boston Celtics,1,1,29,23,52,7,24,31,36,47,83,19,5,24,11,38,15,4,10,93,98
2021,2,22100927,3/1/2022,1610612738,Boston Celtics,1,1,1610612737,Atlanta Hawks,0,0,28,20,48,11,24,35,39,44,83,18,1,19,12,32,27,8,14,93,107
2016,2,21600480,12/28/2016,1610612751,Brooklyn Nets,0,0,1610612741,Chicago Bulls,1,1,24,30,54,13,19,32,37,49,86,12,4,16,12,39,21,8,16,96,99
2022,2,22200611,1/10/2023,1610612748,Miami Heat,1,1,1610612760,Oklahoma City Thunder,0,0,21,25,46,10,23,33,31,48,79,40,0,40,17,31,18,8,20,99,112
2016,2,21601016,3/16/2017,1610612751,Brooklyn Nets,0,1,1610612752,New York Knicks,1,0,31,23,54,10,22,32,41,45,86,29,6,35,19,30,19,6,15,98,121
2016,2,21601016,3/16/2017,1610612752,New York Knicks,1,0,1610612751,Brooklyn Nets,0,1,38,32,70,3,15,18,41,47,88,25,1,26,7,41,20,5,7,98,110
2020,2,22000550,3/3/2021,1610612744,Golden State Warriors,0,0,1610612757,Portland Trail Blazers,1,1,26,29,55,15,27,42,41,56,97,9,5,14,20,39,27,5,11,95,106
2020,2,22000550,3/3/2021,1610612757,Portland Trail Blazers,1,1,1610612744,Golden State Warriors,0,0,22,15,37,14,35,49,36,50,86,22,4,26,12,40,15,8,10,94,108
2017,2,21700751,1/30/2018,1610612744,Golden State Warriors,0,0,1610612762,Utah Jazz,1,1,34,26,60,5,20,25,39,46,85,16,5,21,13,38,27,16,20,102,99
2017,2,21700751,1/30/2018,1610612762,Utah Jazz,1,1,1610612744,Golden State Warriors,0,0,39,24,63,14,14,28,53,38,91,9,5,14,10,29,25,10,12,103,129
2022,2,22200436,12/16/2022,1610612742,Dallas Mavericks,1,1,1610612757,Portland Trail Blazers,0,0,27,11,38,18,25,43,45,36,81,22,4,26,6,33,25,4,13,99,130
2022,2,22200436,12/16/2022,1610612757,Portland Trail Blazers,0,0,1610612742,Dallas Mavericks,1,1,26,26,52,13,24,37,39,50,89,19,6,25,14,40,21,4,12,98,110
2022,2,22200478,12/22/2022,1610612762,Utah Jazz,1,1,1610612764,Washington Wizards,0,0,26,25,51,16,19,35,42,44,86,20,1,21,9,36,16,5,11,97,120
2020,2,22000812,4/11/2021,1610612741,Chicago Bulls,0,0,1610612750,Minnesota Timberwolves,1,1,32,22,54,15,23,38,47,45,92,8,5,13,14,36,30,7,14,98,117
2020,2,22000812,4/11/2021,1610612750,Minnesota Timberwolves,1,1,1610612741,Chicago Bulls,0,0,24,21,45,16,20,36,40,41,81,25,0,25,10,31,27,10,15,97,121
2022,2,22200478,12/22/2022,1610612764,Washington Wizards,0,0,1610612762,Utah Jazz,1,1,39,22,61,7,14,21,46,36,82,13,4,17,3,35,20,5,11,97,112
2016,2,21600479,12/28/2016,1610612749,Milwaukee Bucks,0,1,1610612765,Detroit Pistons,1,0,37,25,62,11,11,22,48,36,84,12,4,16,4,34,36,4,7,93,119
2016,2,21600479,12/28/2016,1610612765,Detroit Pistons,1,0,1610612749,Milwaukee Bucks,0,1,33,31,64,6,18,24,39,49,88,10,6,16,14,36,28,8,11,94,94
2016,2,21600073,11/4/2016,1610612741,Chicago Bulls,1,0,1610612752,New York Knicks,0,1,29,32,61,8,15,23,37,47,84,22,5,27,18,30,15,7,13,90,104
2016,2,21600073,11/4/2016,1610612752,New York Knicks,0,1,1610612741,Chicago Bulls,1,0,37,31,68,9,12,21,46,43,89,16,5,21,16,30,32,4,5,89,117
2022,2,22200435,12/16/2022,1610612750,Minnesota Timberwolves,0,1,1610612760,Oklahoma City Thunder,1,0,31,31,62,12,13,25,43,44,87,14,11,25,13,37,23,7,16,101,112
2022,2,22200435,12/16/2022,1610612760,Oklahoma City Thunder,1,0,1610612750,Minnesota Timberwolves,0,1,30,21,51,11,26,37,41,47,88,17,4,21,16,33,29,16,22,103,110
2021,2,22100926,3/1/2022,1610612764,Washington Wizards,1,1,1610612765,Detroit Pistons,0,0,28,28,56,13,13,26,41,41,82,21,5,26,14,30,29,9,15,96,116
2016,2,21601015,3/16/2017,1610612760,Oklahoma City Thunder,0,1,1610612761,Toronto Raptors,1,0,33,30,63,14,11,25,47,41,88,15,4,19,15,27,33,10,18,98,123
2016,2,21601015,3/16/2017,1610612761,Toronto Raptors,1,0,1610612760,Oklahoma City Thunder,0,1,32,29,61,5,15,20,37,44,81,23,7,30,9,39,15,10,14,100,102
2017,2,21700750,1/30/2018,1610612743,Denver Nuggets,0,0,1610612759,San Antonio Spurs,1,1,30,33,63,10,13,23,40,46,86,14,0,14,14,32,22,4,14,94,104
2017,2,21700750,1/30/2018,1610612759,San Antonio Spurs,1,1,1610612743,Denver Nuggets,0,0,37,31,68,9,15,24,46,46,92,5,0,5,17,29,33,11,16,94,106
2022,2,22200434,12/16/2022,1610612741,Chicago Bulls,1,0,1610612752,New York Knicks,0,1,24,23,47,12,18,30,36,41,77,7,1,8,4,37,26,13,20,99,91
2022,2,22200434,12/16/2022,1610612752,New York Knicks,0,1,1610612741,Chicago Bulls,1,0,20,28,48,17,27,44,37,55,92,23,9,32,21,40,19,3,12,98,114
2021,2,22100926,3/1/2022,1610612765,Detroit Pistons,0,0,1610612764,Washington Wizards,1,1,35,28,63,8,19,27,43,47,90,19,4,23,15,34,23,6,12,95,113
2021,2,22100059,10/27/2021,1610612737,Atlanta Hawks,0,1,1610612740,New Orleans Pelicans,1,0,32,34,66,8,22,30,40,56,96,14,3,17,21,37,21,5,11,93,102
2021,2,22100059,10/27/2021,1610612740,New Orleans Pelicans,1,0,1610612737,Atlanta Hawks,0,1,29,28,57,11,25,36,40,53,93,8,1,9,14,40,24,4,10,94,99
2020,2,22000549,3/3/2021,1610612742,Dallas Mavericks,1,1,1610612760,Oklahoma City Thunder,0,0,24,19,43,8,32,40,32,51,83,15,4,19,13,39,18,6,15,95,87
2017,2,21700749,1/30/2018,1610612740,New Orleans Pelicans,1,0,1610612758,Sacramento Kings,0,1,30,22,52,9,16,25,39,38,77,16,6,22,3,38,26,7,15,101,103
2017,2,21700749,1/30/2018,1610612758,Sacramento Kings,0,1,1610612740,New Orleans Pelicans,1,0,36,35,71,10,16,26,46,51,97,12,2,14,17,36,22,7,14,102,114
2021,2,22100925,2/28/2022,1610612758,Sacramento Kings,0,1,1610612760,Oklahoma City Thunder,1,0,39,17,56,10,21,31,49,38,87,23,7,30,11,32,30,12,17,105,131
2021,2,22100925,2/28/2022,1610612760,Oklahoma City Thunder,1,0,1610612758,Sacramento Kings,0,1,29,22,51,11,24,35,40,46,86,19,8,27,13,38,28,10,17,104,110
2020,2,22000549,3/3/2021,1610612760,Oklahoma City Thunder,0,0,1610612742,Dallas Mavericks,1,1,20,28,48,9,30,39,29,58,87,11,6,17,14,47,13,8,13,95,78
2016,2,21601014,3/16/2017,1610612739,Cleveland Cavaliers,1,1,1610612762,Utah Jazz,0,0,27,26,53,9,24,33,36,50,86,10,9,19,15,40,14,6,12,94,91
2016,2,21601014,3/16/2017,1610612762,Utah Jazz,0,0,1610612739,Cleveland Cavaliers,1,1,29,32,61,5,16,21,34,48,82,10,4,14,11,41,18,6,17,93,83
2019,2,21900012,10/23/2019,1610612756,Phoenix Suns,1,1,1610612758,Sacramento Kings,0,0,38,27,65,11,22,33,49,49,98,15,3,18,13,37,31,5,14,108,124
2019,2,21900012,10/23/2019,1610612758,Sacramento Kings,0,0,1610612756,Phoenix Suns,1,1,24,34,58,10,19,29,34,53,87,17,9,26,17,42,17,13,27,109,95
2016,2,21600478,12/28/2016,1610612737,Atlanta Hawks,1,1,1610612752,New York Knicks,0,0,30,44,74,7,20,27,37,64,101,21,6,27,24,43,19,8,15,104,102
2016,2,21600478,12/28/2016,1610612752,New York Knicks,0,0,1610612737,Atlanta Hawks,1,1,28,38,66,7,20,27,35,58,93,21,4,25,19,41,20,8,18,103,98
2014,2,21400366,12/16/2014,1610612740,New Orleans Pelicans,1,1,1610612762,Utah Jazz,0,0,39,24,63,8,8,16,47,32,79,17,1,18,11,22,24,6,16,92,119
2014,2,21400366,12/16/2014,1610612762,Utah Jazz,0,0,1610612740,New Orleans Pelicans,1,1,40,35,75,5,10,15,45,45,90,16,3,19,22,25,19,9,15,92,111
2016,2,21601013,3/15/2017,1610612746,LA Clippers,1,0,1610612749,Milwaukee Bucks,0,1,30,21,51,5,19,24,35,40,75,21,8,29,12,33,23,8,16,93,96
2022,2,22200433,12/16/2022,1610612751,Brooklyn Nets,0,1,1610612761,Toronto Raptors,1,0,37,13,50,9,17,26,46,30,76,18,5,23,6,26,22,5,15,95,119
2022,2,22200433,12/16/2022,1610612761,Toronto Raptors,1,0,1610612751,Brooklyn Nets,0,1,32,28,60,9,15,24,41,43,84,25,4,29,11,35,17,5,9,96,116
2021,2,22100924,2/28/2022,1610612749,Milwaukee Bucks,1,1,1610612766,Charlotte Hornets,0,0,22,24,46,18,27,45,40,51,91,32,5,37,21,32,25,6,13,102,130
2021,2,22100924,2/28/2022,1610612766,Charlotte Hornets,0,0,1610612749,Milwaukee Bucks,1,1,22,32,54,14,25,39,36,57,93,20,12,32,14,48,22,4,9,102,106
2021,2,22100058,10/27/2021,1610612754,Indiana Pacers,0,0,1610612761,Toronto Raptors,1,1,28,22,50,10,19,29,38,41,79,14,3,17,15,27,19,18,23,96,100
2022,2,22200611,1/10/2023,1610612760,Oklahoma City Thunder,0,0,1610612748,Miami Heat,1,1,35,21,56,9,26,35,44,47,91,14,7,21,20,29,27,10,19,101,111
2023,2,22300027,11/17/2023,1610612766,Charlotte Hornets,1,0,1610612749,Milwaukee Bucks,0,1,31,34,65,6,20,26,37,54,91,19,3,22,11,46,18,4,12,102,99
2016,2,21601013,3/15/2017,1610612749,Milwaukee Bucks,0,1,1610612746,LA Clippers,1,0,24,23,47,10,19,29,34,42,76,19,6,25,7,38,22,3,11,92,97
2020,2,22000548,3/3/2021,1610612740,New Orleans Pelicans,1,0,1610612741,Chicago Bulls,0,1,40,21,61,6,16,22,46,37,83,26,12,38,9,35,29,6,11,102,124
2020,2,22000548,3/3/2021,1610612741,Chicago Bulls,0,1,1610612740,New Orleans Pelicans,1,0,36,30,66,12,16,28,48,46,94,20,2,22,17,29,28,10,16,103,128
2021,2,22100923,2/28/2022,1610612759,San Antonio Spurs,0,0,1610612763,Memphis Grizzlies,1,1,32,35,67,9,23,32,41,58,99,14,5,19,16,44,30,5,9,101,105
2021,2,22100923,2/28/2022,1610612763,Memphis Grizzlies,1,1,1610612759,San Antonio Spurs,0,0,37,26,63,11,15,26,48,41,89,11,8,19,13,32,24,13,18,102,118
2021,2,22100058,10/27/2021,1610612761,Toronto Raptors,1,1,1610612754,Indiana Pacers,0,0,32,38,70,14,16,30,46,54,100,12,7,19,25,33,22,6,12,95,118
2017,2,21700748,1/30/2018,1610612745,Houston Rockets,1,1,1610612753,Orlando Magic,0,0,26,16,42,13,22,35,39,38,77,23,5,28,12,28,17,6,12,91,114
2017,2,21700748,1/30/2018,1610612753,Orlando Magic,0,0,1610612745,Houston Rockets,1,1,27,25,52,15,16,31,42,41,83,8,2,10,8,33,26,5,12,91,107
2016,2,21600477,12/28/2016,1610612753,Orlando Magic,1,0,1610612766,Charlotte Hornets,0,1,33,19,52,9,25,34,42,44,86,8,2,10,10,36,25,7,13,94,101
2016,2,21600477,12/28/2016,1610612766,Charlotte Hornets,0,1,1610612753,Orlando Magic,1,0,36,24,60,10,14,24,46,38,84,18,1,19,13,25,25,7,14,94,120
2017,2,21700747,1/30/2018,1610612739,Cleveland Cavaliers,0,0,1610612765,Detroit Pistons,1,1,25,24,49,13,22,35,38,46,84,25,7,32,10,39,24,12,15,104,114
2017,2,21700747,1/30/2018,1610612765,Detroit Pistons,1,1,1610612739,Cleveland Cavaliers,0,0,40,30,70,9,14,23,49,44,93,18,10,28,12,36,30,2,11,103,125
2016,2,21601012,3/15/2017,1610612756,Phoenix Suns,1,0,1610612758,Sacramento Kings,0,1,37,45,82,6,19,25,43,64,107,9,5,14,25,42,24,8,13,102,101
2016,2,21601012,3/15/2017,1610612758,Sacramento Kings,0,1,1610612756,Phoenix Suns,1,0,32,33,65,6,8,14,38,41,79,25,9,34,13,32,22,9,18,100,107
2014,2,21400653,1/24/2015,1610612765,Detroit Pistons,0,0,1610612749,Milwaukee Bucks,1,1,25,36,61,6,19,25,31,55,86,18,7,25,21,37,14,6,20,98,86
2017,2,21700746,1/30/2018,1610612750,Minnesota Timberwolves,0,0,1610612761,Toronto Raptors,1,1,37,36,73,5,7,12,42,43,85,15,9,24,14,32,21,3,8,90,104
2017,2,21700746,1/30/2018,1610612761,Toronto Raptors,1,1,1610612750,Minnesota Timberwolves,0,0,30,22,52,9,20,29,39,42,81,22,4,26,12,31,28,4,9,90,109
2016,2,21601011,3/15/2017,1610612757,Portland Trail Blazers,0,1,1610612759,San Antonio Spurs,1,0,29,29,58,9,13,22,38,42,80,25,3,28,10,34,21,7,11,94,110
2016,2,21601011,3/15/2017,1610612759,San Antonio Spurs,1,0,1610612757,Portland Trail Blazers,0,1,31,31,62,11,15,26,42,46,88,11,4,15,15,32,28,10,14,95,106
2022,2,22200432,12/16/2022,1610612744,Golden State Warriors,0,0,1610612755,Philadelphia 76ers,1,1,22,29,51,17,26,43,39,55,94,11,2,13,15,41,31,11,17,102,106
2022,2,22200432,12/16/2022,1610612755,Philadelphia 76ers,1,1,1610612744,Golden State Warriors,0,0,24,23,47,15,23,38,39,46,85,25,6,31,13,36,23,8,15,101,118
2016,2,21601010,3/15/2017,1610612745,Houston Rockets,1,1,1610612747,Los Angeles Lakers,0,0,32,16,48,18,25,43,50,41,91,21,11,32,17,31,37,10,21,110,139
2016,2,21601010,3/15/2017,1610612747,Los Angeles Lakers,0,0,1610612745,Houston Rockets,1,1,39,27,66,3,22,25,42,49,91,13,5,18,12,39,16,13,23,108,100
2016,2,21600476,12/28/2016,1610612754,Indiana Pacers,0,0,1610612764,Washington Wizards,1,1,24,27,51,11,17,28,35,44,79,24,5,29,7,40,24,8,13,99,105
2016,2,21600476,12/28/2016,1610612764,Washington Wizards,1,1,1610612754,Indiana Pacers,0,0,30,26,56,8,14,22,38,40,78,27,10,37,16,31,21,10,18,98,111
2016,2,21600072,11/4/2016,1610612751,Brooklyn Nets,1,0,1610612766,Charlotte Hornets,0,1,26,25,51,9,27,36,35,52,87,16,5,21,14,42,20,7,16,102,95
2016,2,21600072,11/4/2016,1610612766,Charlotte Hornets,0,1,1610612751,Brooklyn Nets,1,0,26,30,56,10,20,30,36,50,86,17,7,24,12,41,24,12,16,101,99
2022,2,22200574,1/4/2023,1610612747,Los Angeles Lakers,1,1,1610612748,Miami Heat,0,0,32,22,54,8,19,27,40,41,81,24,6,30,12,31,20,9,17,100,112
2017,2,21700745,1/30/2018,1610612751,Brooklyn Nets,0,0,1610612752,New York Knicks,1,1,27,23,50,9,28,37,36,51,87,14,2,16,14,37,15,6,18,98,95
2017,2,21700745,1/30/2018,1610612752,New York Knicks,1,1,1610612751,Brooklyn Nets,0,0,26,37,63,13,13,26,39,50,89,20,5,25,15,39,22,6,11,97,111
2022,2,22200431,12/16/2022,1610612739,Cleveland Cavaliers,1,1,1610612754,Indiana Pacers,0,0,24,21,45,14,17,31,38,38,76,28,4,32,10,31,23,6,10,91,118
2022,2,22200431,12/16/2022,1610612754,Indiana Pacers,0,0,1610612739,Cleveland Cavaliers,1,1,31,13,44,11,25,36,42,38,80,17,2,19,7,31,34,6,10,92,112
2021,2,22100922,2/28/2022,1610612741,Chicago Bulls,0,0,1610612748,Miami Heat,1,1,34,21,55,7,22,29,41,43,84,10,5,15,12,32,23,8,16,98,99
2021,2,22100922,2/28/2022,1610612748,Miami Heat,1,1,1610612741,Chicago Bulls,0,0,28,22,50,12,19,31,40,41,81,20,6,26,10,35,28,9,14,96,112
2020,2,22000547,3/3/2021,1610612750,Minnesota Timberwolves,1,0,1610612766,Charlotte Hornets,0,1,30,26,56,9,31,40,39,57,96,15,3,18,16,43,25,14,21,109,102
2020,2,22000547,3/3/2021,1610612766,Charlotte Hornets,0,1,1610612750,Minnesota Timberwolves,1,0,34,25,59,17,22,39,51,47,98,16,5,21,14,34,33,11,17,109,135
2020,2,22000811,4/11/2021,1610612754,Indiana Pacers,0,1,1610612763,Memphis Grizzlies,1,0,39,23,62,13,24,37,52,47,99,15,2,17,17,30,35,11,12,103,132
2020,2,22000811,4/11/2021,1610612763,Memphis Grizzlies,1,0,1610612754,Indiana Pacers,0,1,47,48,95,6,14,20,53,62,115,13,6,19,27,39,27,5,6,103,125
2022,2,22200634,1/13/2023,1610612752,New York Knicks,0,1,1610612764,Washington Wizards,1,0,33,30,63,8,21,29,41,51,92,22,9,31,17,38,15,3,7,95,112
2016,2,21601009,3/15/2017,1610612741,Chicago Bulls,1,0,1610612763,Memphis Grizzlies,0,1,23,40,63,11,17,28,34,57,91,12,3,15,19,40,22,2,6,86,91
2016,2,21601009,3/15/2017,1610612763,Memphis Grizzlies,0,1,1610612741,Chicago Bulls,1,0,25,29,54,11,20,31,36,49,85,15,3,18,19,31,26,6,11,86,98
2022,2,22200634,1/13/2023,1610612764,Washington Wizards,1,0,1610612752,New York Knicks,0,1,23,28,51,13,29,42,36,57,93,23,3,26,17,42,18,3,8,94,108
2014,2,21400365,12/16/2014,1610612744,Golden State Warriors,0,0,1610612763,Memphis Grizzlies,1,1,30,34,64,9,22,31,39,56,95,11,1,12,16,40,18,9,14,101,98
2014,2,21400365,12/16/2014,1610612763,Memphis Grizzlies,1,1,1610612744,Golden State Warriors,0,0,37,41,78,5,9,14,42,50,92,16,3,19,13,39,24,9,13,101,105
2014,2,21400652,1/24/2015,1610612752,New York Knicks,0,0,1610612766,Charlotte Hornets,1,1,22,42,64,6,9,15,28,51,79,9,9,18,19,34,20,7,18,89,71
2014,2,21400652,1/24/2015,1610612766,Charlotte Hornets,1,1,1610612752,New York Knicks,0,0,23,46,69,2,5,7,25,51,76,24,13,37,14,44,9,4,9,88,76
2017,2,21700744,1/30/2018,1610612760,Oklahoma City Thunder,0,0,1610612764,Washington Wizards,1,1,21,27,48,9,23,32,30,50,80,27,7,34,17,37,19,8,21,101,96
2017,2,21700744,1/30/2018,1610612764,Washington Wizards,1,1,1610612760,Oklahoma City Thunder,0,0,27,37,64,7,18,25,34,55,89,27,2,29,14,41,27,7,12,101,102
2016,2,21601008,3/15/2017,1610612762,Utah Jazz,0,1,1610612765,Detroit Pistons,1,0,23,26,49,13,15,28,36,41,77,12,4,16,11,34,28,6,17,91,97
2016,2,21601008,3/15/2017,1610612765,Detroit Pistons,1,0,1610612762,Utah Jazz,0,1,33,40,73,3,10,13,36,50,86,8,4,12,10,42,14,6,9,90,83
2021,2,22100057,10/27/2021,1610612748,Miami Heat,0,1,1610612751,Brooklyn Nets,1,0,30,37,67,8,21,29,38,58,96,22,4,26,21,39,21,7,15,102,106
2021,2,22100057,10/27/2021,1610612751,Brooklyn Nets,1,0,1610612748,Miami Heat,0,1,19,23,42,14,29,43,33,52,85,13,1,14,6,47,21,6,16,102,93
2014,2,21400364,12/16/2014,1610612748,Miami Heat,0,1,1610612751,Brooklyn Nets,1,0,24,24,48,9,15,24,33,39,72,20,6,26,10,30,20,9,18,94,95
2014,2,21400364,12/16/2014,1610612751,Brooklyn Nets,1,0,1610612748,Miami Heat,0,1,22,27,49,8,20,28,30,47,77,23,9,32,16,35,25,9,17,94,91
2022,2,22200574,1/4/2023,1610612748,Miami Heat,0,0,1610612747,Los Angeles Lakers,1,1,35,31,66,8,21,29,43,52,95,15,6,21,19,36,24,10,13,100,109
2016,2,21600475,12/27/2016,1610612747,Los Angeles Lakers,1,0,1610612762,Utah Jazz,0,1,35,32,67,4,12,16,39,44,83,18,4,22,20,26,19,6,16,92,100
2016,2,21600475,12/27/2016,1610612762,Utah Jazz,0,1,1610612747,Los Angeles Lakers,1,0,29,20,49,9,17,26,38,37,75,17,7,24,16,26,19,8,20,92,102
2021,2,22100921,2/28/2022,1610612753,Orlando Magic,1,1,1610612754,Indiana Pacers,0,0,33,26,59,12,25,37,45,51,96,17,5,22,16,37,29,4,11,101,119
2021,2,22100921,2/28/2022,1610612754,Indiana Pacers,0,0,1610612753,Orlando Magic,1,1,20,16,36,15,21,36,35,37,72,18,7,25,7,32,22,10,22,99,103
2021,2,22100056,10/27/2021,1610612738,Boston Celtics,1,0,1610612764,Washington Wizards,0,1,27,29,56,10,19,29,37,48,85,23,5,28,14,37,18,8,13,99,107
2021,2,22100056,10/27/2021,1610612764,Washington Wizards,0,1,1610612738,Boston Celtics,1,0,34,25,59,9,16,25,43,41,84,21,8,29,16,28,18,9,16,99,116
2022,2,22200479,12/23/2022,1610612753,Orlando Magic,1,1,1610612759,San Antonio Spurs,0,0,33,22,55,17,15,32,50,37,87,16,4,20,13,27,30,10,19,102,133
2022,2,22200479,12/23/2022,1610612759,San Antonio Spurs,0,0,1610612753,Orlando Magic,1,1,32,27,59,12,26,38,44,53,97,13,5,18,16,39,28,8,13,102,113
2017,2,21700743,1/29/2018,1610612738,Boston Celtics,0,1,1610612743,Denver Nuggets,1,0,26,29,55,17,19,36,43,48,91,8,2,10,15,34,28,4,11,93,111
2017,2,21700743,1/29/2018,1610612743,Denver Nuggets,1,0,1610612738,Boston Celtics,0,1,32,28,60,10,23,33,42,51,93,16,5,21,22,32,31,4,11,93,110
2016,2,21601007,3/15/2017,1610612740,New Orleans Pelicans,0,0,1610612748,Miami Heat,1,1,33,33,66,9,13,22,42,46,88,19,9,28,14,37,21,9,15,103,112
2016,2,21601007,3/15/2017,1610612748,Miami Heat,1,1,1610612740,New Orleans Pelicans,0,0,28,24,52,16,19,35,44,43,87,16,3,19,12,32,23,9,16,101,120
2016,2,21600474,12/27/2016,1610612742,Dallas Mavericks,1,0,1610612745,Houston Rockets,0,1,21,28,49,15,23,38,36,51,87,20,5,25,15,38,22,7,10,96,107
2022,2,22200428,12/16/2022,1610612737,Atlanta Hawks,0,1,1610612766,Charlotte Hornets,1,0,26,20,46,15,14,29,41,34,75,28,6,34,5,32,25,8,14,98,125
2022,2,22200428,12/16/2022,1610612766,Charlotte Hornets,1,0,1610612737,Atlanta Hawks,0,1,24,31,55,15,28,43,39,59,98,13,6,19,23,39,26,3,13,97,106
2021,2,22100055,10/27/2021,1610612753,Orlando Magic,1,0,1610612766,Charlotte Hornets,0,1,28,20,48,15,25,40,43,45,88,10,3,13,13,32,22,14,19,100,111
2021,2,22100055,10/27/2021,1610612766,Charlotte Hornets,0,1,1610612753,Orlando Magic,1,0,29,24,53,14,16,30,43,40,83,20,4,24,12,29,22,6,17,100,120
2016,2,21600474,12/27/2016,1610612745,Houston Rockets,0,1,1610612742,Dallas Mavericks,1,0,24,22,46,17,15,32,41,37,78,24,4,28,13,27,23,6,17,95,123
2016,2,21600071,11/4/2016,1610612748,Miami Heat,0,0,1610612761,Toronto Raptors,1,1,25,35,60,9,19,28,34,54,88,10,5,15,15,41,19,8,14,93,87
2016,2,21600071,11/4/2016,1610612761,Toronto Raptors,1,1,1610612748,Miami Heat,0,0,31,28,59,6,19,25,37,47,84,16,2,18,16,32,14,9,15,92,96
2021,2,22100920,2/28/2022,1610612739,Cleveland Cavaliers,1,0,1610612750,Minnesota Timberwolves,0,1,24,13,37,15,22,37,39,35,74,29,5,34,14,24,29,12,22,99,122
2016,2,21601006,3/15/2017,1610612738,Boston Celtics,1,1,1610612750,Minnesota Timberwolves,0,0,30,16,46,13,20,33,43,36,79,18,3,21,9,28,34,4,10,92,117
2021,2,22100920,2/28/2022,1610612750,Minnesota Timberwolves,0,1,1610612739,Cleveland Cavaliers,1,0,29,15,44,18,24,42,47,39,86,15,4,19,10,31,30,5,13,99,127
2021,2,22100054,10/26/2021,1610612743,Denver Nuggets,0,0,1610612762,Utah Jazz,1,1,32,23,55,10,18,28,42,41,83,16,8,24,8,36,19,5,13,101,110
2021,2,22100054,10/26/2021,1610612762,Utah Jazz,1,1,1610612743,Denver Nuggets,0,0,32,14,46,12,27,39,44,41,85,22,7,29,13,32,20,9,14,101,122
2016,2,21601006,3/15/2017,1610612750,Minnesota Timberwolves,0,0,1610612738,Boston Celtics,1,1,32,32,64,8,19,27,40,51,91,16,4,20,19,33,26,2,8,91,104
2016,2,21600473,12/27/2016,1610612748,Miami Heat,1,0,1610612760,Oklahoma City Thunder,0,1,29,31,60,7,15,22,36,46,82,15,6,21,14,34,14,3,13,93,94
2016,2,21600473,12/27/2016,1610612760,Oklahoma City Thunder,0,1,1610612748,Miami Heat,1,0,37,26,63,5,14,19,42,40,82,17,8,25,18,26,21,10,17,92,106
2020,2,22000810,4/11/2021,1610612742,Dallas Mavericks,1,0,1610612759,San Antonio Spurs,0,1,32,20,52,13,29,42,45,49,94,14,1,15,17,33,25,10,12,97,117
2020,2,22000810,4/11/2021,1610612759,San Antonio Spurs,0,1,1610612742,Dallas Mavericks,1,0,37,25,62,8,13,21,45,38,83,21,6,27,13,28,20,5,15,96,119
2017,2,21700742,1/29/2018,1610612742,Dallas Mavericks,1,0,1610612748,Miami Heat,0,1,25,32,57,8,21,29,33,53,86,14,2,16,18,35,20,9,12,88,88
2017,2,21700742,1/29/2018,1610612748,Miami Heat,0,1,1610612742,Dallas Mavericks,1,0,22,22,44,12,19,31,34,41,75,15,4,19,13,30,23,10,17,88,95
2022,2,22200427,12/15/2022,1610612746,LA Clippers,1,0,1610612756,Phoenix Suns,0,1,22,35,57,12,21,33,34,56,90,15,6,21,24,38,21,8,18,92,95
2022,2,22200427,12/15/2022,1610612756,Phoenix Suns,0,1,1610612746,LA Clippers,1,0,35,28,63,9,23,32,44,51,95,14,4,18,19,34,27,4,9,92,111
2016,2,21600472,12/27/2016,1610612738,Boston Celtics,1,1,1610612763,Memphis Grizzlies,0,0,29,25,54,12,19,31,41,44,85,19,2,21,18,27,30,14,18,96,113
2016,2,21600472,12/27/2016,1610612763,Memphis Grizzlies,0,0,1610612738,Boston Celtics,1,1,28,30,58,9,21,30,37,51,88,20,9,29,19,35,22,6,11,95,103
2021,2,22100053,10/26/2021,1610612747,Los Angeles Lakers,0,1,1610612759,San Antonio Spurs,1,0,42,33,75,8,22,30,50,55,105,17,5,22,13,43,20,10,13,116,125
2021,2,22100053,10/26/2021,1610612759,San Antonio Spurs,1,0,1610612747,Los Angeles Lakers,0,1,35,37,72,13,23,36,48,60,108,12,10,22,18,49,33,8,16,116,121
2021,2,22100919,2/27/2022,1610612740,New Orleans Pelicans,0,1,1610612747,Los Angeles Lakers,1,0,34,28,62,13,17,30,47,45,92,16,9,25,14,35,29,8,15,105,123
2021,2,22100919,2/27/2022,1610612747,Los Angeles Lakers,1,0,1610612740,New Orleans Pelicans,0,1,28,22,50,7,27,34,35,49,84,18,2,20,11,39,15,16,23,104,95
2021,2,22100052,10/26/2021,1610612742,Dallas Mavericks,1,1,1610612745,Houston Rockets,0,0,31,19,50,12,31,43,43,50,93,18,7,25,14,38,25,7,15,104,116
2021,2,22100052,10/26/2021,1610612745,Houston Rockets,0,0,1610612742,Dallas Mavericks,1,1,20,27,47,16,23,39,36,50,86,18,8,26,13,41,24,9,17,104,106
2017,2,21700741,1/29/2018,1610612749,Milwaukee Bucks,1,1,1610612755,Philadelphia 76ers,0,0,27,25,52,11,17,28,38,42,80,20,2,22,9,33,26,5,9,92,107
2017,2,21700741,1/29/2018,1610612755,Philadelphia 76ers,0,0,1610612749,Milwaukee Bucks,1,1,34,22,56,2,24,26,36,46,82,21,2,23,13,34,22,6,14,93,95
2020,2,22000809,4/11/2021,1610612752,New York Knicks,1,1,1610612761,Toronto Raptors,0,0,26,27,53,9,26,35,35,53,88,23,4,27,18,38,19,8,13,96,102
2020,2,22000809,4/11/2021,1610612761,Toronto Raptors,0,0,1610612752,New York Knicks,1,1,22,23,45,11,23,34,33,46,79,19,4,23,11,37,19,9,17,96,96
2022,2,22200426,12/15/2022,1610612740,New Orleans Pelicans,0,0,1610612762,Utah Jazz,1,1,35,34,69,12,18,30,47,52,99,23,5,28,21,35,24,8,18,106,129
2022,2,22200426,12/15/2022,1610612762,Utah Jazz,1,1,1610612740,New Orleans Pelicans,0,0,24,21,45,18,29,47,42,50,92,30,7,37,21,32,24,8,16,107,132
2016,2,21601005,3/15/2017,1610612754,Indiana Pacers,1,1,1610612766,Charlotte Hornets,0,0,27,18,45,12,16,28,39,34,73,8,1,9,6,28,26,9,15,87,98
2016,2,21601005,3/15/2017,1610612766,Charlotte Hornets,0,0,1610612754,Indiana Pacers,1,1,29,28,57,3,20,23,32,48,80,10,3,13,9,39,15,8,10,87,77
2014,2,21401154,4/7/2015,1610612737,Atlanta Hawks,1,1,1610612756,Phoenix Suns,0,0,37,21,58,4,21,25,41,42,83,10,4,14,13,31,21,5,15,94,96
2014,2,21401154,4/7/2015,1610612756,Phoenix Suns,0,0,1610612737,Atlanta Hawks,1,1,22,41,63,4,16,20,26,57,83,13,5,18,13,46,16,9,16,94,69
2014,2,21400651,1/23/2015,1610612744,Golden State Warriors,1,1,1610612758,Sacramento Kings,0,0,28,26,54,17,23,40,45,49,94,19,3,22,16,34,32,12,18,105,126
2014,2,21400651,1/23/2015,1610612758,Sacramento Kings,0,0,1610612744,Golden State Warriors,1,1,30,35,65,4,13,17,34,48,82,29,5,34,15,36,19,13,22,106,101
2016,2,21601004,3/15/2017,1610612742,Dallas Mavericks,0,1,1610612764,Washington Wizards,1,0,26,21,47,14,18,32,40,39,79,18,7,25,5,37,24,4,10,96,112
2016,2,21601004,3/15/2017,1610612764,Washington Wizards,1,0,1610612742,Dallas Mavericks,0,1,28,24,52,12,18,30,40,42,82,15,6,21,9,36,30,5,12,97,107
2016,2,21600471,12/26/2016,1610612755,Philadelphia 76ers,0,0,1610612758,Sacramento Kings,1,1,30,24,54,9,16,25,39,40,79,13,5,18,12,30,20,11,22,99,100
2016,2,21600471,12/26/2016,1610612758,Sacramento Kings,1,1,1610612755,Philadelphia 76ers,0,0,32,30,62,7,18,25,39,48,87,17,4,21,19,30,24,13,19,99,102
2021,2,22100918,2/27/2022,1610612743,Denver Nuggets,0,1,1610612757,Portland Trail Blazers,1,0,32,17,49,12,25,37,44,42,86,24,7,31,13,32,28,12,15,105,124
2021,2,22100918,2/27/2022,1610612757,Portland Trail Blazers,1,0,1610612743,Denver Nuggets,0,1,28,27,55,6,30,36,34,57,91,18,8,26,13,49,22,9,15,105,92
2014,2,21400363,12/16/2014,1610612750,Minnesota Timberwolves,0,0,1610612764,Washington Wizards,1,1,33,40,73,3,5,8,36,45,81,20,15,35,15,36,17,7,10,94,95
2014,2,21400363,12/16/2014,1610612764,Washington Wizards,1,1,1610612750,Minnesota Timberwolves,0,0,33,36,69,10,7,17,43,43,86,13,5,18,11,34,29,7,10,92,109
2014,2,21400650,1/23/2015,1610612745,Houston Rockets,0,1,1610612756,Phoenix Suns,1,0,34,23,57,10,17,27,44,40,84,15,5,20,9,33,24,4,16,100,113
2014,2,21400650,1/23/2015,1610612756,Phoenix Suns,1,0,1610612745,Houston Rockets,0,1,32,29,61,10,20,30,42,49,91,17,7,24,14,39,21,7,12,99,111
2017,2,21700740,1/29/2018,1610612756,Phoenix Suns,0,0,1610612763,Memphis Grizzlies,1,1,31,28,59,7,16,23,38,44,82,26,10,36,20,29,20,7,20,98,109
2022,2,22200425,12/15/2022,1610612749,Milwaukee Bucks,0,0,1610612763,Memphis Grizzlies,1,1,22,22,44,13,37,50,35,59,94,18,9,27,15,46,22,5,9,100,101
2022,2,22200425,12/15/2022,1610612763,Memphis Grizzlies,1,1,1610612749,Milwaukee Bucks,0,0,44,26,70,12,20,32,56,46,102,18,5,23,16,31,30,5,8,102,142
2021,2,22100917,2/27/2022,1610612742,Dallas Mavericks,0,1,1610612744,Golden State Warriors,1,0,26,18,44,13,21,34,39,39,78,16,4,20,8,35,16,15,18,98,107
2021,2,22100917,2/27/2022,1610612744,Golden State Warriors,1,0,1610612742,Dallas Mavericks,0,1,28,24,52,11,28,39,39,52,91,12,8,20,14,40,27,5,11,99,101
2021,2,22100051,10/26/2021,1610612744,Golden State Warriors,0,1,1610612760,Oklahoma City Thunder,1,0,25,18,43,14,26,40,39,44,83,14,4,18,10,35,30,7,15,97,106
2021,2,22100051,10/26/2021,1610612760,Oklahoma City Thunder,1,0,1610612744,Golden State Warriors,0,1,24,28,52,12,22,34,36,50,86,14,3,17,11,40,19,9,14,98,98
2017,2,21700740,1/29/2018,1610612763,Memphis Grizzlies,1,1,1610612756,Phoenix Suns,0,0,36,25,61,11,11,22,47,36,83,15,3,18,15,23,29,11,20,97,120
2016,2,21600070,11/4/2016,1610612737,Atlanta Hawks,0,0,1610612764,Washington Wizards,1,1,27,31,58,5,20,25,32,51,83,23,13,36,16,40,22,7,18,103,92
2016,2,21600070,11/4/2016,1610612764,Washington Wizards,1,1,1610612737,Atlanta Hawks,0,0,26,34,60,5,15,20,31,49,80,28,7,35,12,40,13,12,19,105,95
2014,2,21400362,12/15/2014,1610612746,LA Clippers,1,1,1610612765,Detroit Pistons,0,0,31,25,56,12,12,24,43,37,80,15,5,20,14,25,35,10,15,91,113
2014,2,21400362,12/15/2014,1610612765,Detroit Pistons,0,0,1610612746,LA Clippers,1,1,27,29,56,8,19,27,35,48,83,13,9,22,22,31,23,9,18,92,91
2022,2,22200424,12/15/2022,1610612745,Houston Rockets,1,0,1610612748,Miami Heat,0,1,35,26,61,9,24,33,44,50,94,11,6,17,21,30,22,10,15,96,108
2022,2,22200424,12/15/2022,1610612748,Miami Heat,0,1,1610612745,Houston Rockets,1,0,23,18,41,16,31,47,39,49,88,17,6,23,17,35,21,10,14,95,111
2021,2,22100916,2/27/2022,1610612745,Houston Rockets,1,0,1610612746,LA Clippers,0,1,18,32,50,17,25,42,35,57,92,11,7,18,12,49,26,4,7,98,98
2021,2,22100916,2/27/2022,1610612746,LA Clippers,0,1,1610612745,Houston Rockets,1,0,23,20,43,11,23,34,34,43,77,20,8,28,12,33,18,8,18,96,99
2017,2,21700739,1/29/2018,1610612737,Atlanta Hawks,1,1,1610612750,Minnesota Timberwolves,0,0,26,19,45,13,21,34,39,40,79,14,2,16,11,30,27,15,21,96,105
2022,2,22200423,12/14/2022,1610612746,LA Clippers,1,1,1610612750,Minnesota Timberwolves,0,0,20,23,43,14,32,46,34,55,89,17,4,21,19,36,21,9,15,98,99
2022,2,22200423,12/14/2022,1610612750,Minnesota Timberwolves,0,0,1610612746,LA Clippers,1,1,27,25,52,4,18,22,31,43,74,22,8,30,9,39,15,8,17,97,88
2021,2,22100915,2/27/2022,1610612765,Detroit Pistons,0,1,1610612766,Charlotte Hornets,1,0,36,34,70,14,26,40,50,60,110,13,5,18,25,37,30,8,15,108,127
2021,2,22100915,2/27/2022,1610612766,Charlotte Hornets,1,0,1610612765,Detroit Pistons,0,1,32,26,58,13,18,31,45,44,89,23,11,34,15,34,25,10,17,108,126
2017,2,21700739,1/29/2018,1610612750,Minnesota Timberwolves,0,0,1610612737,Atlanta Hawks,1,1,32,32,64,7,12,19,39,44,83,15,3,18,8,37,24,8,14,95,100
2016,2,21601003,3/14/2017,1610612744,Golden State Warriors,1,1,1610612755,Philadelphia 76ers,0,0,18,38,56,14,18,32,32,56,88,28,7,35,18,42,24,10,18,105,106
2016,2,21601003,3/14/2017,1610612755,Philadelphia 76ers,0,0,1610612744,Golden State Warriors,1,1,31,31,62,8,19,27,39,50,89,18,9,27,19,34,28,12,23,106,104
2016,2,21600470,12/26/2016,1610612743,Denver Nuggets,0,1,1610612746,LA Clippers,1,0,25,26,51,11,20,31,36,46,82,23,5,28,13,36,22,6,16,99,106
2018,2,21800965,3/6/2019,1610612748,Miami Heat,0,1,1610612766,Charlotte Hornets,1,0,29,35,64,9,17,26,38,52,90,6,5,11,20,35,19,7,18,93,91
2016,2,21600470,12/26/2016,1610612746,LA Clippers,1,0,1610612743,Denver Nuggets,0,1,30,29,59,9,16,25,39,45,84,15,5,20,7,41,22,10,13,100,102
2022,2,22200422,12/14/2022,1610612743,Denver Nuggets,1,1,1610612764,Washington Wizards,0,0,50,17,67,4,12,16,54,29,83,29,6,35,9,21,31,10,19,109,141
2022,2,22200422,12/14/2022,1610612764,Washington Wizards,0,0,1610612743,Denver Nuggets,1,1,29,23,52,19,20,39,48,43,91,13,10,23,8,40,40,8,14,108,128
2021,2,22100914,2/27/2022,1610612738,Boston Celtics,0,0,1610612754,Indiana Pacers,1,1,27,21,48,12,31,43,39,52,91,17,3,20,14,40,25,7,10,97,107
2016,2,21600069,11/3/2016,1610612744,Golden State Warriors,1,1,1610612760,Oklahoma City Thunder,0,0,32,27,59,14,16,30,46,43,89,16,4,20,16,30,27,8,16,97,122
2021,2,22100914,2/27/2022,1610612754,Indiana Pacers,1,1,1610612738,Boston Celtics,0,0,30,27,57,17,16,33,47,43,90,17,3,20,15,30,25,5,14,98,128
2016,2,21600069,11/3/2016,1610612760,Oklahoma City Thunder,0,0,1610612744,Golden State Warriors,1,1,25,35,60,10,17,27,35,52,87,16,12,28,20,38,20,9,16,98,96
2019,2,21900229,11/23/2019,1610612752,New York Knicks,1,0,1610612759,San Antonio Spurs,0,1,25,28,53,15,25,40,40,53,93,9,6,15,11,44,30,7,11,99,104
2019,2,21900229,11/23/2019,1610612759,San Antonio Spurs,0,1,1610612752,New York Knicks,1,0,28,24,52,12,11,23,40,35,75,19,9,28,10,31,26,12,22,99,111
2016,2,21601002,3/14/2017,1610612740,New Orleans Pelicans,1,1,1610612757,Portland Trail Blazers,0,0,32,27,59,6,15,21,38,42,80,18,12,30,5,41,19,3,5,94,100
2016,2,21601002,3/14/2017,1610612757,Portland Trail Blazers,0,0,1610612740,New Orleans Pelicans,1,1,12,32,44,11,21,32,23,53,76,20,6,26,10,47,13,10,16,94,77
2016,2,21600469,12/26/2016,1610612757,Portland Trail Blazers,1,0,1610612761,Toronto Raptors,0,1,27,33,60,8,15,23,35,48,83,13,5,18,11,38,22,11,18,97,91
2015,2,21500379,12/16/2015,1610612759,San Antonio Spurs,1,1,1610612764,Washington Wizards,0,0,36,25,61,8,14,22,44,39,83,18,5,23,12,28,29,6,13,97,114
2015,2,21500379,12/16/2015,1610612764,Washington Wizards,0,0,1610612759,San Antonio Spurs,1,1,32,37,69,3,12,15,35,49,84,22,3,25,14,37,22,10,12,96,95
2020,2,22000808,4/11/2021,1610612749,Milwaukee Bucks,0,1,1610612753,Orlando Magic,1,0,27,27,54,19,21,40,46,48,94,13,2,15,15,34,28,8,12,100,124
2020,2,22000808,4/11/2021,1610612753,Orlando Magic,1,0,1610612749,Milwaukee Bucks,0,1,24,26,50,8,28,36,32,54,86,15,4,19,11,45,19,8,14,99,87
2017,2,21700738,1/29/2018,1610612754,Indiana Pacers,1,1,1610612766,Charlotte Hornets,0,0,39,23,62,6,15,21,45,38,83,9,2,11,7,32,28,5,13,95,105
2022,2,22200421,12/14/2022,1610612739,Cleveland Cavaliers,0,1,1610612742,Dallas Mavericks,1,0,33,21,54,8,16,24,41,37,78,15,4,19,10,28,26,2,9,87,105
2022,2,22200421,12/14/2022,1610612742,Dallas Mavericks,1,0,1610612739,Cleveland Cavaliers,0,1,16,20,36,13,25,38,29,45,74,19,7,26,11,39,17,5,13,87,90
2017,2,21700738,1/29/2018,1610612766,Charlotte Hornets,0,0,1610612754,Indiana Pacers,1,1,28,24,52,9,22,31,37,46,83,13,7,20,14,37,18,7,16,96,96
2016,2,21600469,12/26/2016,1610612761,Toronto Raptors,0,1,1610612757,Portland Trail Blazers,1,0,20,41,61,12,22,34,32,63,95,19,5,24,21,43,17,8,12,97,95
2020,2,22000545,3/3/2021,1610612755,Philadelphia 76ers,1,1,1610612762,Utah Jazz,0,0,40,28,68,8,17,25,48,45,93,27,8,35,8,40,22,7,11,110,131
2020,2,22000545,3/3/2021,1610612762,Utah Jazz,0,0,1610612755,Philadelphia 76ers,1,1,23,33,56,21,23,44,44,56,100,14,5,19,13,44,22,9,16,112,123
2021,2,22100050,10/26/2021,1610612752,New York Knicks,1,1,1610612755,Philadelphia 76ers,0,0,25,25,50,16,21,37,41,46,87,14,1,15,16,31,24,9,15,92,112
2021,2,22100050,10/26/2021,1610612755,Philadelphia 76ers,0,0,1610612752,New York Knicks,1,1,24,17,41,12,29,41,36,46,82,15,2,17,12,34,24,7,15,92,99
2017,2,21700737,1/28/2018,1610612758,Sacramento Kings,0,0,1610612759,San Antonio Spurs,1,1,17,31,48,18,16,34,35,47,82,10,1,11,7,40,21,4,9,90,98
2017,2,21700737,1/28/2018,1610612759,San Antonio Spurs,1,1,1610612758,Sacramento Kings,0,0,34,31,65,11,14,25,45,45,90,12,5,17,16,31,33,5,7,90,113
2016,2,21601001,3/14/2017,1610612752,New York Knicks,1,1,1610612754,Indiana Pacers,0,0,26,29,55,9,19,28,35,48,83,8,5,13,12,40,21,6,15,92,87
2016,2,21601001,3/14/2017,1610612754,Indiana Pacers,0,0,1610612752,New York Knicks,1,1,24,34,58,8,21,29,32,55,87,9,6,15,18,42,16,8,16,93,81
2014,2,21400649,1/23/2015,1610612738,Boston Celtics,0,1,1610612743,Denver Nuggets,1,0,28,26,54,9,12,21,37,38,75,17,10,27,9,32,20,8,15,95,100
2014,2,21400649,1/23/2015,1610612743,Denver Nuggets,1,0,1610612738,Boston Celtics,0,1,31,37,68,6,15,21,37,52,89,19,7,26,21,37,20,8,13,95,99
2020,2,22000544,3/3/2021,1610612737,Atlanta Hawks,0,1,1610612753,Orlando Magic,1,0,17,23,40,21,24,45,38,47,85,18,1,19,9,38,26,6,12,97,115
2015,2,21500543,1/8/2016,1610612739,Cleveland Cavaliers,0,1,1610612750,Minnesota Timberwolves,1,0,30,24,54,13,14,27,43,38,81,26,3,29,12,28,23,8,12,96,125
2015,2,21500543,1/8/2016,1610612750,Minnesota Timberwolves,1,0,1610612739,Cleveland Cavaliers,0,1,29,34,63,7,9,16,36,43,79,20,6,26,11,34,24,8,13,95,99
2021,2,22100912,2/27/2022,1610612752,New York Knicks,1,0,1610612755,Philadelphia 76ers,0,1,27,25,52,11,22,33,38,47,85,22,13,35,15,38,21,13,18,103,109
2014,2,21400361,12/15/2014,1610612757,Portland Trail Blazers,1,1,1610612759,San Antonio Spurs,0,0,34,37,71,7,11,18,41,48,89,19,3,22,15,34,18,5,11,95,108
2016,2,21600468,12/26/2016,1610612737,Atlanta Hawks,0,0,1610612750,Minnesota Timberwolves,1,1,27,24,51,8,24,32,35,48,83,12,5,17,18,34,20,11,19,93,90
2016,2,21600468,12/26/2016,1610612750,Minnesota Timberwolves,1,1,1610612737,Atlanta Hawks,0,0,22,29,51,15,16,31,37,45,82,15,3,18,14,32,26,8,15,92,104
2014,2,21400361,12/15/2014,1610612759,San Antonio Spurs,0,0,1610612757,Portland Trail Blazers,1,1,34,33,67,4,7,11,38,40,78,15,7,22,9,36,19,8,15,95,95
2016,2,21601000,3/14/2017,1610612751,Brooklyn Nets,1,0,1610612760,Oklahoma City Thunder,0,1,21,26,47,12,12,24,33,38,71,26,4,30,6,33,20,13,20,99,104
2016,2,21601000,3/14/2017,1610612760,Oklahoma City Thunder,0,1,1610612751,Brooklyn Nets,1,0,34,33,67,10,12,22,44,45,89,24,10,34,19,31,30,6,13,99,122
2022,2,22200419,12/14/2022,1610612748,Miami Heat,0,1,1610612760,Oklahoma City Thunder,1,0,13,17,30,24,32,56,37,49,86,12,3,15,11,40,25,7,14,99,110
2022,2,22200419,12/14/2022,1610612760,Oklahoma City Thunder,1,0,1610612748,Miami Heat,0,1,32,26,58,9,15,24,41,41,82,17,6,23,9,35,26,9,14,98,108
2021,2,22100912,2/27/2022,1610612755,Philadelphia 76ers,0,1,1610612752,New York Knicks,1,0,28,17,45,10,23,33,38,40,78,39,5,44,6,37,28,6,10,103,125
2020,2,22000544,3/3/2021,1610612753,Orlando Magic,1,0,1610612737,Atlanta Hawks,0,1,23,26,49,13,22,35,36,48,84,27,0,27,10,38,24,7,10,96,112
2014,2,21401153,4/5/2015,1610612746,LA Clippers,0,1,1610612747,Los Angeles Lakers,1,0,25,23,48,15,12,27,40,35,75,11,7,18,9,29,27,3,10,86,106
2020,2,22000807,4/11/2021,1610612739,Cleveland Cavaliers,1,0,1610612740,New Orleans Pelicans,0,1,28,17,45,13,27,40,41,44,85,14,3,17,9,37,29,9,17,99,109
2020,2,22000807,4/11/2021,1610612740,New Orleans Pelicans,0,1,1610612739,Cleveland Cavaliers,1,0,37,25,62,7,17,24,44,42,86,21,5,26,15,30,30,7,16,100,116
2022,2,22200418,12/14/2022,1610612741,Chicago Bulls,1,0,1610612752,New York Knicks,0,1,37,19,56,9,19,28,46,38,84,19,3,22,4,36,25,7,12,101,120
2022,2,22200418,12/14/2022,1610612752,New York Knicks,0,1,1610612741,Chicago Bulls,1,0,27,30,57,18,16,34,45,46,91,20,5,25,19,31,25,6,18,103,128
2021,2,22100049,10/25/2021,1610612746,LA Clippers,1,1,1610612757,Portland Trail Blazers,0,0,30,20,50,14,29,43,44,49,93,14,5,19,7,43,37,11,17,114,116
2021,2,22100049,10/25/2021,1610612757,Portland Trail Blazers,0,0,1610612746,LA Clippers,1,1,24,24,48,8,29,37,32,53,85,14,4,18,10,44,15,21,30,113,86
2018,2,21801113,3/26/2019,1610612737,Atlanta Hawks,0,1,1610612740,New Orleans Pelicans,1,0,25,21,46,19,32,51,44,53,97,23,3,26,14,40,30,10,16,113,130
2018,2,21801113,3/26/2019,1610612740,New Orleans Pelicans,1,0,1610612737,Atlanta Hawks,0,1,27,22,49,12,22,34,39,44,83,30,10,40,13,32,28,13,24,114,120
2018,2,21800965,3/6/2019,1610612766,Charlotte Hornets,1,0,1610612748,Miami Heat,0,1,16,30,46,14,22,36,30,52,82,10,5,15,17,37,22,10,21,94,84
2018,2,21800842,2/11/2019,1610612751,Brooklyn Nets,0,0,1610612761,Toronto Raptors,1,1,26,21,47,20,21,41,46,42,88,13,5,18,7,36,33,12,15,103,125
2018,2,21800842,2/11/2019,1610612761,Toronto Raptors,1,1,1610612751,Brooklyn Nets,0,0,41,20,61,9,22,31,50,42,92,18,2,20,14,28,32,6,14,103,127
2022,2,22200417,12/14/2022,1610612758,Sacramento Kings,0,1,1610612761,Toronto Raptors,1,0,28,19,47,17,29,46,45,48,93,17,3,20,18,31,29,8,15,101,124
2022,2,22200417,12/14/2022,1610612761,Toronto Raptors,1,0,1610612758,Sacramento Kings,0,1,41,32,73,6,15,21,47,47,94,23,4,27,12,38,25,3,7,101,123
2021,2,22100911,2/26/2022,1610612743,Denver Nuggets,1,1,1610612758,Sacramento Kings,0,0,22,17,39,16,27,43,38,44,82,23,6,29,9,39,29,4,15,104,115
2021,2,22100911,2/26/2022,1610612758,Sacramento Kings,0,0,1610612743,Denver Nuggets,1,1,29,30,59,9,21,30,38,51,89,25,8,33,13,43,24,5,13,105,110
2020,2,22000543,3/3/2021,1610612739,Cleveland Cavaliers,1,0,1610612754,Indiana Pacers,0,1,32,23,55,11,17,28,43,40,83,14,1,15,16,25,29,18,26,99,111
2020,2,22000543,3/3/2021,1610612754,Indiana Pacers,0,1,1610612739,Cleveland Cavaliers,1,0,39,19,58,8,17,25,47,36,83,12,4,16,5,33,27,8,14,100,114
2016,2,21600999,3/14/2017,1610612739,Cleveland Cavaliers,1,1,1610612765,Detroit Pistons,0,0,27,20,47,19,11,30,46,31,77,17,6,23,3,31,29,6,9,93,128
2016,2,21600999,3/14/2017,1610612765,Detroit Pistons,0,0,1610612739,Cleveland Cavaliers,1,1,33,47,80,4,15,19,37,62,99,18,1,19,24,39,20,4,8,95,96
2016,2,21600467,12/26/2016,1610612745,Houston Rockets,1,1,1610612756,Phoenix Suns,0,0,31,18,49,15,28,43,46,46,92,24,6,30,11,39,28,14,20,113,131
2016,2,21600467,12/26/2016,1610612756,Phoenix Suns,0,0,1610612745,Houston Rockets,1,1,36,35,71,7,23,30,43,58,101,22,5,27,20,41,17,11,19,113,115
2022,2,22200416,12/14/2022,1610612737,Atlanta Hawks,0,0,1610612753,Orlando Magic,1,1,32,21,53,12,23,35,44,44,88,24,3,27,12,34,30,10,13,100,124
2022,2,22200416,12/14/2022,1610612753,Orlando Magic,1,1,1610612737,Atlanta Hawks,0,0,31,26,57,16,20,36,47,46,93,25,5,30,18,31,28,2,14,101,135
2021,2,22100910,2/26/2022,1610612749,Milwaukee Bucks,1,0,1610612751,Brooklyn Nets,0,1,25,15,40,16,22,38,41,37,78,25,13,38,10,33,24,7,15,103,123
2021,2,22100910,2/26/2022,1610612751,Brooklyn Nets,0,1,1610612749,Milwaukee Bucks,1,0,31,27,58,13,21,34,44,48,92,25,8,33,14,39,24,4,9,101,126
2021,2,22100048,10/25/2021,1610612739,Cleveland Cavaliers,0,1,1610612743,Denver Nuggets,1,0,31,26,57,7,18,25,38,44,82,16,4,20,11,36,26,10,16,96,99
2017,2,21700736,1/28/2018,1610612755,Philadelphia 76ers,0,0,1610612760,Oklahoma City Thunder,1,1,27,20,47,11,18,29,38,38,76,25,6,31,14,27,19,7,18,94,112
2017,2,21700736,1/28/2018,1610612760,Oklahoma City Thunder,1,1,1610612755,Philadelphia 76ers,0,0,35,24,59,10,23,33,45,47,92,22,8,30,22,28,21,7,11,96,122
2014,2,21400360,12/15/2014,1610612749,Milwaukee Bucks,0,1,1610612756,Phoenix Suns,1,0,27,30,57,8,8,16,35,38,73,18,4,22,11,28,23,12,21,93,96
2021,2,22100048,10/25/2021,1610612743,Denver Nuggets,1,0,1610612739,Cleveland Cavaliers,0,1,26,22,48,9,29,38,35,51,86,8,4,12,17,38,21,8,22,98,87
2020,2,22000542,3/2/2021,1610612747,Los Angeles Lakers,1,0,1610612756,Phoenix Suns,0,1,29,19,48,11,20,31,40,39,79,13,4,17,7,32,18,5,12,94,104
2020,2,22000542,3/2/2021,1610612756,Phoenix Suns,0,1,1610612747,Los Angeles Lakers,1,0,22,26,48,16,13,29,38,39,77,22,3,25,10,31,30,6,14,95,114
2020,2,22000806,4/11/2021,1610612738,Boston Celtics,0,1,1610612743,Denver Nuggets,1,0,32,22,54,7,26,33,39,48,87,20,3,23,14,35,20,5,11,94,105
2020,2,22000806,4/11/2021,1610612743,Denver Nuggets,1,0,1610612738,Boston Celtics,0,1,24,30,54,8,26,34,32,56,88,15,3,18,13,44,23,4,9,92,87
2021,2,22100909,2/26/2022,1610612741,Chicago Bulls,1,0,1610612763,Memphis Grizzlies,0,1,30,43,73,9,11,20,39,54,93,23,7,30,13,44,17,5,10,104,110
2021,2,22100909,2/26/2022,1610612763,Memphis Grizzlies,0,1,1610612741,Chicago Bulls,1,0,37,40,77,7,16,23,44,56,100,21,5,26,22,36,23,9,14,104,116
2021,2,22100047,10/25/2021,1610612740,New Orleans Pelicans,0,1,1610612750,Minnesota Timberwolves,1,0,29,28,57,10,20,30,39,48,87,19,4,23,17,33,19,10,20,101,107
2021,2,22100047,10/25/2021,1610612750,Minnesota Timberwolves,1,0,1610612740,New Orleans Pelicans,0,1,16,24,40,15,35,50,31,59,90,21,6,27,15,48,20,5,11,101,98
2016,2,21600998,3/13/2017,1610612743,Denver Nuggets,1,1,1610612747,Los Angeles Lakers,0,0,28,18,46,17,21,38,45,39,84,22,3,25,9,31,36,10,16,102,129
2016,2,21600998,3/13/2017,1610612747,Los Angeles Lakers,0,0,1610612743,Denver Nuggets,1,1,36,41,77,6,14,20,42,55,97,11,8,19,18,39,17,9,16,104,101
2016,2,21600466,12/26/2016,1610612740,New Orleans Pelicans,1,1,1610612742,Dallas Mavericks,0,0,25,20,45,12,13,25,37,33,70,25,5,30,7,28,24,4,11,90,111
2016,2,21600466,12/26/2016,1610612742,Dallas Mavericks,0,0,1610612740,New Orleans Pelicans,1,1,24,19,43,13,19,32,37,38,75,17,5,22,5,36,27,6,11,90,104
2020,2,22000805,4/11/2021,1610612737,Atlanta Hawks,0,1,1610612766,Charlotte Hornets,1,0,21,24,45,17,22,39,38,46,84,12,4,16,14,33,27,5,12,90,105
2020,2,22000805,4/11/2021,1610612766,Charlotte Hornets,1,0,1610612737,Atlanta Hawks,0,1,22,15,37,15,28,43,37,43,80,12,2,14,9,35,28,7,12,90,101
2016,2,21600997,3/13/2017,1610612753,Orlando Magic,0,0,1610612758,Sacramento Kings,1,1,32,32,64,13,21,34,45,53,98,12,0,12,13,40,32,8,12,102,115
2022,2,22200415,12/14/2022,1610612744,Golden State Warriors,0,0,1610612754,Indiana Pacers,1,1,26,27,53,14,19,33,40,46,86,25,4,29,15,31,27,10,24,108,119
2022,2,22200415,12/14/2022,1610612754,Indiana Pacers,1,1,1610612744,Golden State Warriors,0,0,28,20,48,16,23,39,44,43,87,21,4,25,8,37,30,5,18,108,125
2021,2,22100908,2/26/2022,1610612748,Miami Heat,1,1,1610612759,San Antonio Spurs,0,0,35,20,55,12,16,28,47,36,83,27,11,38,6,34,25,5,12,104,133
2021,2,22100908,2/26/2022,1610612759,San Antonio Spurs,0,0,1610612748,Miami Heat,1,1,36,23,59,14,17,31,50,40,90,15,4,19,16,28,33,8,22,104,129
2021,2,22100046,10/25/2021,1610612741,Chicago Bulls,0,1,1610612761,Toronto Raptors,1,0,27,27,54,12,15,27,39,42,81,21,1,22,6,36,24,8,13,97,111
2021,2,22100046,10/25/2021,1610612761,Toronto Raptors,1,0,1610612741,Chicago Bulls,0,1,28,25,53,12,18,30,40,43,83,16,4,20,19,26,27,11,21,98,108
2016,2,21600997,3/13/2017,1610612758,Sacramento Kings,1,1,1610612753,Orlando Magic,0,0,28,24,52,16,14,30,44,38,82,16,5,21,5,36,24,10,15,101,120
2016,2,21600068,11/3/2016,1610612738,Boston Celtics,0,0,1610612739,Cleveland Cavaliers,1,1,35,29,64,11,21,32,46,50,96,19,3,22,14,39,25,6,8,100,122
2016,2,21600068,11/3/2016,1610612739,Cleveland Cavaliers,1,1,1610612738,Boston Celtics,0,0,27,23,50,14,20,34,41,43,84,32,5,37,10,34,24,4,8,99,128
2019,2,21900011,10/23/2019,1610612760,Oklahoma City Thunder,0,0,1610612762,Utah Jazz,1,1,22,34,56,10,17,27,32,51,83,21,10,31,13,43,15,4,16,99,95
2019,2,21900011,10/23/2019,1610612762,Utah Jazz,1,1,1610612760,Oklahoma City Thunder,0,0,34,32,66,6,18,24,40,50,90,14,6,20,11,43,15,5,11,99,100
2021,2,22100907,2/26/2022,1610612739,Cleveland Cavaliers,1,1,1610612764,Washington Wizards,0,0,24,34,58,8,17,25,32,51,83,20,4,24,16,37,22,8,14,94,92
2021,2,22100907,2/26/2022,1610612764,Washington Wizards,0,0,1610612739,Cleveland Cavaliers,1,1,24,34,58,11,12,23,35,46,81,5,1,6,9,38,19,9,18,95,86
2017,2,21700735,1/28/2018,1610612747,Los Angeles Lakers,0,0,1610612761,Toronto Raptors,1,1,32,34,66,8,17,25,40,51,91,23,10,33,15,41,22,4,14,103,111
2017,2,21700735,1/28/2018,1610612761,Toronto Raptors,1,1,1610612747,Los Angeles Lakers,0,0,34,27,61,12,19,31,46,46,92,19,6,25,15,34,23,9,15,103,123
2021,2,22100045,10/25/2021,1610612748,Miami Heat,1,1,1610612753,Orlando Magic,0,0,35,25,60,6,21,27,41,46,87,19,0,19,10,36,28,7,11,97,107
2021,2,22100045,10/25/2021,1610612753,Orlando Magic,0,0,1610612748,Miami Heat,1,1,21,16,37,12,32,44,33,48,81,12,7,19,13,38,21,10,18,97,90
2022,2,22200612,1/10/2023,1610612755,Philadelphia 76ers,1,1,1610612765,Detroit Pistons,0,0,43,15,58,11,20,31,54,35,89,28,2,30,13,23,36,9,19,109,147
2022,2,22200612,1/10/2023,1610612765,Detroit Pistons,0,0,1610612755,Philadelphia 76ers,1,1,22,28,50,14,25,39,36,53,89,30,6,36,9,46,23,7,11,108,116
2022,2,22200414,12/14/2022,1610612765,Detroit Pistons,0,1,1610612766,Charlotte Hornets,1,0,30,23,53,18,22,40,48,45,93,27,9,36,15,39,25,7,16,110,141
2022,2,22200414,12/14/2022,1610612766,Charlotte Hornets,1,0,1610612765,Detroit Pistons,0,1,30,33,63,17,34,51,47,67,114,23,6,29,22,47,21,0,5,111,134
2020,2,22000541,3/2/2021,1610612752,New York Knicks,0,0,1610612759,San Antonio Spurs,1,1,18,27,45,15,21,36,33,48,81,12,3,15,13,36,18,12,16,92,93
2020,2,22000541,3/2/2021,1610612759,San Antonio Spurs,1,1,1610612752,New York Knicks,0,0,25,22,47,18,24,42,43,46,89,15,6,21,16,34,31,2,9,93,119
2021,2,22100044,10/25/2021,1610612751,Brooklyn Nets,1,1,1610612764,Washington Wizards,0,0,30,29,59,10,25,35,40,54,94,14,3,17,8,46,23,5,9,102,104
2021,2,22100044,10/25/2021,1610612764,Washington Wizards,0,0,1610612751,Brooklyn Nets,1,1,24,32,56,9,30,39,33,62,95,15,5,20,15,48,16,6,12,104,90
2014,2,21401153,4/5/2015,1610612747,Los Angeles Lakers,1,0,1610612746,LA Clippers,0,1,22,36,58,7,10,17,29,46,75,13,9,22,17,34,17,10,19,87,78
2014,2,21400648,1/23/2015,1610612747,Los Angeles Lakers,0,0,1610612759,San Antonio Spurs,1,1,28,42,70,5,8,13,33,50,83,14,6,20,9,43,18,5,9,92,85
2014,2,21400648,1/23/2015,1610612759,San Antonio Spurs,1,1,1610612747,Los Angeles Lakers,0,0,29,31,60,7,17,24,36,48,84,20,7,27,15,37,19,4,11,93,99
2020,2,22000804,4/10/2021,1610612757,Portland Trail Blazers,1,1,1610612765,Detroit Pistons,0,0,30,31,61,13,16,29,43,47,90,19,5,24,20,31,18,9,16,99,118
2020,2,22000804,4/10/2021,1610612765,Detroit Pistons,0,0,1610612757,Portland Trail Blazers,1,1,28,29,57,9,17,26,37,46,83,20,8,28,11,37,25,5,12,99,103
2017,2,21700734,1/28/2018,1610612739,Cleveland Cavaliers,1,1,1610612765,Detroit Pistons,0,0,27,21,48,15,20,35,42,41,83,22,4,26,5,37,27,5,10,99,121
2021,2,22100906,2/26/2022,1610612737,Atlanta Hawks,1,1,1610612761,Toronto Raptors,0,0,35,17,52,13,18,31,48,35,83,18,4,22,5,31,27,5,12,98,127
2021,2,22100906,2/26/2022,1610612761,Toronto Raptors,0,0,1610612737,Atlanta Hawks,1,1,28,35,63,10,22,32,38,57,95,14,5,19,17,44,25,8,13,100,100
2017,2,21700734,1/28/2018,1610612765,Detroit Pistons,0,0,1610612739,Cleveland Cavaliers,1,1,26,33,59,14,22,36,40,55,95,10,3,13,9,47,31,2,6,99,104
2016,2,21600996,3/13/2017,1610612746,LA Clippers,0,0,1610612762,Utah Jazz,1,1,27,21,48,12,18,30,39,39,78,18,5,23,6,36,16,1,6,88,108
2016,2,21600996,3/13/2017,1610612762,Utah Jazz,1,1,1610612746,LA Clippers,0,0,27,30,57,14,7,21,41,37,78,18,4,22,11,27,22,4,9,87,114
2021,2,22100043,10/25/2021,1610612737,Atlanta Hawks,1,1,1610612765,Detroit Pistons,0,0,34,24,58,12,20,32,46,44,90,18,3,21,15,30,24,7,16,102,122
2021,2,22100043,10/25/2021,1610612765,Detroit Pistons,0,0,1610612737,Atlanta Hawks,1,1,31,27,58,9,24,33,40,51,91,15,3,18,11,41,26,11,14,102,104
2016,2,21600465,12/26/2016,1610612741,Chicago Bulls,1,1,1610612754,Indiana Pacers,0,0,26,32,58,6,19,25,32,51,83,20,8,28,19,33,17,5,14,92,90
2016,2,21600465,12/26/2016,1610612754,Indiana Pacers,0,0,1610612741,Chicago Bulls,1,1,25,31,56,9,16,25,34,47,81,8,2,10,10,38,26,10,16,91,85
2022,2,22200413,12/13/2022,1610612738,Boston Celtics,0,1,1610612747,Los Angeles Lakers,1,0,27,29,56,19,29,48,46,58,104,11,5,16,16,44,27,7,14,110,122
2022,2,22200413,12/13/2022,1610612747,Los Angeles Lakers,1,0,1610612738,Boston Celtics,0,1,36,28,64,8,21,29,44,49,93,22,8,30,10,42,23,6,12,111,118
2020,2,22000540,3/2/2021,1610612743,Denver Nuggets,0,1,1610612749,Milwaukee Bucks,1,0,42,23,65,11,19,30,53,42,95,11,1,12,13,30,28,4,10,96,128
2020,2,22000540,3/2/2021,1610612749,Milwaukee Bucks,1,0,1610612743,Denver Nuggets,0,1,21,18,39,11,29,40,32,47,79,22,9,31,13,36,22,10,13,94,97
2020,2,22000803,4/10/2021,1610612756,Phoenix Suns,1,1,1610612764,Washington Wizards,0,0,38,26,64,17,26,43,55,52,107,7,0,7,9,43,36,2,3,106,134
2020,2,22000803,4/10/2021,1610612764,Washington Wizards,0,0,1610612756,Phoenix Suns,1,1,30,29,59,9,16,25,39,45,84,19,9,28,7,40,27,8,16,106,106
2022,2,22200412,12/13/2022,1610612740,New Orleans Pelicans,0,0,1610612762,Utah Jazz,1,1,33,33,66,4,23,27,37,56,93,22,11,33,20,41,25,4,17,103,100
2016,2,21600995,3/13/2017,1610612750,Minnesota Timberwolves,1,1,1610612764,Washington Wizards,0,0,35,30,65,10,11,21,45,41,86,19,3,22,10,31,27,10,15,103,119
2016,2,21600995,3/13/2017,1610612764,Washington Wizards,0,0,1610612750,Minnesota Timberwolves,1,1,29,29,58,7,19,26,36,48,84,25,6,31,11,40,15,8,15,102,104
2022,2,22200412,12/13/2022,1610612762,Utah Jazz,1,1,1610612740,New Orleans Pelicans,0,0,34,22,56,15,32,47,49,54,103,8,4,12,25,32,31,12,22,104,121
2021,2,22100905,2/26/2022,1610612738,Boston Celtics,0,1,1610612765,Detroit Pistons,1,0,32,30,62,10,16,26,42,46,88,19,2,21,12,34,31,4,10,96,113
2021,2,22100905,2/26/2022,1610612765,Detroit Pistons,1,0,1610612738,Boston Celtics,0,1,32,28,60,7,20,27,39,48,87,19,3,22,16,33,18,5,14,97,104
2021,2,22100042,10/25/2021,1610612749,Milwaukee Bucks,0,1,1610612754,Indiana Pacers,1,0,30,23,53,11,21,32,41,44,85,26,5,31,7,39,24,6,14,107,119
2016,2,21600464,12/26/2016,1610612739,Cleveland Cavaliers,0,0,1610612765,Detroit Pistons,1,1,19,32,51,11,17,28,30,49,79,19,4,23,14,37,19,12,22,100,90
2016,2,21600464,12/26/2016,1610612765,Detroit Pistons,1,1,1610612739,Cleveland Cavaliers,0,0,25,39,64,16,12,28,41,51,92,8,7,15,12,42,25,8,12,100,106
2014,2,21400360,12/15/2014,1610612756,Phoenix Suns,1,0,1610612749,Milwaukee Bucks,0,1,18,19,37,12,26,38,30,45,75,22,5,27,18,29,17,10,23,92,94
2021,2,22100042,10/25/2021,1610612754,Indiana Pacers,1,0,1610612749,Milwaukee Bucks,0,1,26,28,54,14,22,36,40,50,90,15,2,17,14,36,23,13,19,106,109
2014,2,21400647,1/23/2015,1610612740,New Orleans Pelicans,0,1,1610612750,Minnesota Timberwolves,1,0,37,39,76,3,1,4,40,40,80,9,5,14,10,33,17,3,13,90,92
2014,2,21400647,1/23/2015,1610612750,Minnesota Timberwolves,1,0,1610612740,New Orleans Pelicans,0,1,33,42,75,2,7,9,35,49,84,12,5,17,17,34,27,7,15,91,84
2022,2,22200411,12/13/2022,1610612745,Houston Rockets,1,1,1610612756,Phoenix Suns,0,0,22,24,46,12,23,35,34,47,81,31,3,34,20,29,16,13,23,99,111
2022,2,22200411,12/13/2022,1610612756,Phoenix Suns,0,0,1610612745,Houston Rockets,1,1,20,32,52,13,38,51,33,70,103,18,1,19,21,50,22,6,10,99,97
2021,2,22100904,2/25/2022,1610612746,LA Clippers,0,1,1610612747,Los Angeles Lakers,1,0,31,26,57,10,16,26,41,42,83,13,6,19,10,35,25,8,17,101,105
2021,2,22100904,2/25/2022,1610612747,Los Angeles Lakers,1,0,1610612746,LA Clippers,0,1,31,31,62,8,23,31,39,54,93,16,5,21,14,43,18,8,12,101,102
2017,2,21700733,1/28/2018,1610612740,New Orleans Pelicans,1,0,1610612746,LA Clippers,0,1,29,21,50,9,26,35,38,47,85,18,7,25,10,41,23,7,15,103,103
2017,2,21700733,1/28/2018,1610612746,LA Clippers,0,1,1610612740,New Orleans Pelicans,1,0,36,32,68,9,19,28,45,51,96,13,5,18,13,43,29,9,12,101,112
2019,2,21900010,10/23/2019,1610612752,New York Knicks,0,0,1610612759,San Antonio Spurs,1,1,34,30,64,10,20,30,44,50,94,13,5,18,7,44,24,6,14,109,111
2019,2,21900010,10/23/2019,1610612759,San Antonio Spurs,1,1,1610612752,New York Knicks,0,0,35,27,62,7,14,21,42,41,83,29,7,36,10,35,22,16,21,108,120
2016,2,21600067,11/3/2016,1610612743,Denver Nuggets,0,1,1610612750,Minnesota Timberwolves,1,0,33,26,59,6,16,22,39,42,81,18,7,25,15,30,24,8,22,100,102
2016,2,21600067,11/3/2016,1610612750,Minnesota Timberwolves,1,0,1610612743,Denver Nuggets,0,1,26,40,66,9,13,22,35,53,88,20,5,25,16,40,20,10,16,99,99
2022,2,22200410,12/13/2022,1610612744,Golden State Warriors,0,0,1610612749,Milwaukee Bucks,1,1,18,27,45,20,30,50,38,57,95,15,4,19,14,46,25,8,18,109,111
2016,2,21600994,3/13/2017,1610612737,Atlanta Hawks,0,0,1610612759,San Antonio Spurs,1,1,31,28,59,6,16,22,37,44,81,19,11,30,10,40,27,6,16,101,99
2016,2,21600994,3/13/2017,1610612759,San Antonio Spurs,1,1,1610612737,Atlanta Hawks,0,0,23,24,47,16,18,34,39,42,81,13,4,17,10,34,31,13,23,101,107
2022,2,22200410,12/13/2022,1610612749,Milwaukee Bucks,1,1,1610612744,Golden State Warriors,0,0,33,20,53,12,17,29,45,37,82,26,6,32,12,27,22,7,23,108,128
2021,2,22100903,2/25/2022,1610612742,Dallas Mavericks,0,0,1610612762,Utah Jazz,1,1,25,24,49,17,22,39,42,46,88,8,0,8,11,35,22,9,12,92,109
2016,2,21600463,12/26/2016,1610612751,Brooklyn Nets,1,1,1610612766,Charlotte Hornets,0,0,25,19,44,15,16,31,40,35,75,25,6,31,5,34,26,11,15,100,120
2016,2,21600463,12/26/2016,1610612766,Charlotte Hornets,0,0,1610612751,Brooklyn Nets,1,1,36,32,68,8,18,26,44,50,94,22,3,25,17,35,23,4,11,100,118
2022,2,22200409,12/13/2022,1610612755,Philadelphia 76ers,1,1,1610612758,Sacramento Kings,0,0,27,22,49,16,19,35,43,41,84,21,6,27,4,39,34,5,12,102,123
2022,2,22200409,12/13/2022,1610612758,Sacramento Kings,0,0,1610612755,Philadelphia 76ers,1,1,28,22,50,10,32,42,38,54,92,17,3,20,16,39,21,10,17,102,103
2021,2,22100903,2/25/2022,1610612762,Utah Jazz,1,1,1610612742,Dallas Mavericks,0,0,24,12,36,16,22,38,40,34,74,18,4,22,11,25,22,9,18,92,114
2021,2,22100041,10/25/2021,1610612738,Boston Celtics,0,1,1610612766,Charlotte Hornets,1,0,31,20,51,19,31,50,50,51,101,21,4,25,13,40,33,4,12,114,140
2021,2,22100041,10/25/2021,1610612766,Charlotte Hornets,1,0,1610612738,Boston Celtics,0,1,27,32,59,19,25,44,46,57,103,18,10,28,17,45,26,8,14,113,129
2020,2,22000539,3/3/2021,1610612761,Toronto Raptors,1,0,1610612765,Detroit Pistons,0,1,22,19,41,12,24,36,34,43,77,25,5,30,9,38,17,11,14,97,105
2020,2,22000539,3/3/2021,1610612765,Detroit Pistons,0,1,1610612761,Toronto Raptors,1,0,28,22,50,20,21,41,48,43,91,13,8,21,17,29,39,6,14,96,129
2014,2,21400359,12/15/2014,1610612753,Orlando Magic,0,0,1610612761,Toronto Raptors,1,1,32,27,59,4,11,15,36,38,74,6,2,8,10,29,13,8,19,88,82
2014,2,21400359,12/15/2014,1610612761,Toronto Raptors,1,1,1610612753,Orlando Magic,0,0,26,27,53,11,19,30,37,46,83,10,5,15,15,32,25,5,13,88,95
2019,2,21900228,11/23/2019,1610612737,Atlanta Hawks,1,0,1610612761,Toronto Raptors,0,1,33,23,56,14,20,34,47,43,90,8,3,11,10,34,32,5,15,100,116
2019,2,21900228,11/23/2019,1610612761,Toronto Raptors,0,1,1610612737,Atlanta Hawks,1,0,27,24,51,13,24,37,40,48,88,26,4,30,18,32,22,9,17,100,119
2020,2,22000802,4/10/2021,1610612744,Golden State Warriors,1,1,1610612745,Houston Rockets,0,0,35,21,56,14,21,35,49,42,91,13,3,16,12,32,31,8,16,102,125
2020,2,22000802,4/10/2021,1610612745,Houston Rockets,0,0,1610612744,Golden State Warriors,1,1,28,23,51,13,24,37,41,47,88,14,6,20,15,36,25,13,18,103,109
2021,2,22100902,2/25/2022,1610612740,New Orleans Pelicans,0,1,1610612756,Phoenix Suns,1,0,30,28,58,8,21,29,38,49,87,33,8,41,21,31,21,6,11,97,117
2021,2,22100902,2/25/2022,1610612756,Phoenix Suns,1,0,1610612740,New Orleans Pelicans,0,1,24,18,42,12,28,40,36,46,82,18,6,24,11,38,23,10,14,98,102
2020,2,22000538,3/2/2021,1610612737,Atlanta Hawks,0,1,1610612748,Miami Heat,1,0,21,14,35,13,23,36,34,37,71,13,2,15,16,23,26,16,23,85,94
2020,2,22000538,3/2/2021,1610612748,Miami Heat,1,0,1610612737,Atlanta Hawks,0,1,19,23,42,9,24,33,28,47,75,15,7,22,11,40,15,5,9,85,80
2016,2,21600993,3/13/2017,1610612749,Milwaukee Bucks,0,0,1610612763,Memphis Grizzlies,1,1,17,24,41,14,12,26,31,36,67,17,3,20,9,29,21,11,17,83,93
2016,2,21600993,3/13/2017,1610612763,Memphis Grizzlies,1,1,1610612749,Milwaukee Bucks,0,0,27,25,52,14,13,27,41,38,79,17,6,23,16,25,30,6,12,85,113
2019,2,21900227,11/23/2019,1610612753,Orlando Magic,0,0,1610612754,Indiana Pacers,1,1,30,31,61,13,18,31,43,49,92,7,2,9,13,37,24,6,14,98,106
2019,2,21900227,11/23/2019,1610612754,Indiana Pacers,1,1,1610612753,Orlando Magic,0,0,33,22,55,10,14,24,43,36,79,15,1,16,10,26,26,11,19,98,111
2022,2,22200601,1/8/2023,1610612745,Houston Rockets,1,0,1610612750,Minnesota Timberwolves,0,1,27,26,53,11,25,36,38,51,89,9,6,15,18,39,26,8,20,97,96
2016,2,21600462,12/26/2016,1610612753,Orlando Magic,1,1,1610612763,Memphis Grizzlies,0,0,31,29,60,13,13,26,44,42,86,11,5,16,11,33,23,7,9,92,112
2016,2,21600462,12/26/2016,1610612763,Memphis Grizzlies,0,0,1610612753,Orlando Magic,1,1,25,26,51,10,15,25,35,41,76,22,6,28,4,38,17,5,6,92,102
2022,2,22200408,12/12/2022,1610612738,Boston Celtics,0,0,1610612746,LA Clippers,1,1,24,13,37,9,30,39,33,43,76,18,8,26,7,40,27,10,15,98,93
2022,2,22200408,12/12/2022,1610612746,LA Clippers,1,1,1610612738,Boston Celtics,0,0,34,31,65,10,15,25,44,46,90,15,6,21,14,35,18,5,10,96,113
2021,2,22100901,2/25/2022,1610612750,Minnesota Timberwolves,1,0,1610612755,Philadelphia 76ers,0,1,27,20,47,9,30,39,36,50,86,21,4,25,12,40,23,10,16,100,102
2017,2,21700732,1/28/2018,1610612745,Houston Rockets,1,1,1610612756,Phoenix Suns,0,0,21,14,35,11,26,37,32,40,72,38,11,49,9,36,17,7,13,101,113
2017,2,21700732,1/28/2018,1610612756,Phoenix Suns,0,0,1610612745,Houston Rockets,1,1,28,24,52,8,25,33,36,49,85,22,4,26,10,41,17,8,13,101,102
2021,2,22100901,2/25/2022,1610612755,Philadelphia 76ers,0,1,1610612750,Minnesota Timberwolves,1,0,23,20,43,19,20,39,42,40,82,30,6,36,9,35,30,4,12,100,133
2021,2,22100040,10/24/2021,1610612747,Los Angeles Lakers,1,1,1610612763,Memphis Grizzlies,0,0,29,25,54,16,14,30,45,39,84,15,7,22,11,31,29,13,17,102,121
2021,2,22100040,10/24/2021,1610612763,Memphis Grizzlies,0,0,1610612747,Los Angeles Lakers,1,1,32,33,65,13,22,35,45,55,100,15,3,18,25,32,25,10,17,101,118
2014,2,21400358,12/15/2014,1610612737,Atlanta Hawks,1,1,1610612741,Chicago Bulls,0,0,29,33,62,7,14,21,36,47,83,14,3,17,7,42,26,3,10,94,93
2014,2,21401151,4/5/2015,1610612752,New York Knicks,1,1,1610612755,Philadelphia 76ers,0,0,34,25,59,3,10,13,37,35,72,24,5,29,18,19,24,8,19,88,101
2020,2,22000537,3/2/2021,1610612738,Boston Celtics,1,1,1610612746,LA Clippers,0,0,26,28,54,16,16,32,42,44,86,17,6,23,18,27,25,3,9,89,117
2020,2,22000537,3/2/2021,1610612746,LA Clippers,0,0,1610612738,Boston Celtics,1,1,25,24,49,18,20,38,43,44,87,8,1,9,12,32,28,6,9,88,112
2021,2,22100039,10/24/2021,1610612744,Golden State Warriors,0,1,1610612758,Sacramento Kings,1,0,30,30,60,13,24,37,43,54,97,20,4,24,16,39,26,0,7,100,119
2014,2,21400358,12/15/2014,1610612741,Chicago Bulls,0,0,1610612737,Atlanta Hawks,1,1,29,35,64,6,23,29,35,58,93,10,4,14,22,36,18,10,16,95,86
2014,2,21401151,4/5/2015,1610612755,Philadelphia 76ers,0,0,1610612752,New York Knicks,1,1,28,39,67,10,22,32,38,61,99,5,3,8,26,37,22,6,10,88,91
2014,2,21400646,1/23/2015,1610612741,Chicago Bulls,0,1,1610612742,Dallas Mavericks,1,0,29,33,62,9,7,16,38,40,78,17,3,20,19,22,22,12,24,92,102
2021,2,22100039,10/24/2021,1610612758,Sacramento Kings,1,0,1610612744,Golden State Warriors,0,1,27,13,40,15,31,46,42,44,86,8,5,13,13,34,26,12,19,99,107
2014,2,21400646,1/23/2015,1610612742,Dallas Mavericks,1,0,1610612741,Chicago Bulls,0,1,31,33,64,6,12,18,37,45,82,18,0,18,12,33,16,8,12,91,98
2020,2,22000801,4/10/2021,1610612758,Sacramento Kings,0,0,1610612762,Utah Jazz,1,1,28,18,46,14,28,42,42,46,88,14,8,22,7,42,23,8,10,102,112
2020,2,22000801,4/10/2021,1610612762,Utah Jazz,1,1,1610612758,Sacramento Kings,0,0,22,16,38,18,32,50,40,48,88,30,5,35,14,36,22,8,10,102,128
2022,2,22200407,12/12/2022,1610612750,Minnesota Timberwolves,0,0,1610612757,Portland Trail Blazers,1,1,36,30,66,10,17,27,46,47,93,10,9,19,8,44,25,4,10,103,112
2017,2,21700731,1/28/2018,1610612741,Chicago Bulls,1,0,1610612749,Milwaukee Bucks,0,1,24,29,53,12,22,34,36,51,87,12,3,15,15,37,25,11,16,98,96
2017,2,21700731,1/28/2018,1610612749,Milwaukee Bucks,0,1,1610612741,Chicago Bulls,1,0,28,21,49,13,15,28,41,36,77,15,10,25,7,34,28,8,15,97,110
2022,2,22200556,1/2/2023,1610612742,Dallas Mavericks,0,1,1610612745,Houston Rockets,1,0,21,17,38,13,30,43,34,47,81,30,4,34,10,40,19,4,8,94,111
2022,2,22200407,12/12/2022,1610612757,Portland Trail Blazers,1,1,1610612750,Minnesota Timberwolves,0,0,27,16,43,21,25,46,48,41,89,16,5,21,13,32,32,12,19,104,133
2021,2,22100900,2/25/2022,1610612748,Miami Heat,0,1,1610612752,New York Knicks,1,0,28,23,51,11,21,32,39,44,83,26,9,35,6,41,22,4,10,103,115
2021,2,22100900,2/25/2022,1610612752,New York Knicks,1,0,1610612748,Miami Heat,0,1,16,19,35,14,26,40,30,45,75,26,10,36,9,41,19,13,18,102,100
2021,2,22100038,10/24/2021,1610612755,Philadelphia 76ers,0,1,1610612760,Oklahoma City Thunder,1,0,24,23,47,17,24,41,41,47,88,16,4,20,13,36,25,9,12,95,115
2021,2,22100038,10/24/2021,1610612760,Oklahoma City Thunder,1,0,1610612755,Philadelphia 76ers,0,1,32,21,53,8,23,31,40,44,84,15,4,19,9,37,24,4,11,96,103
2016,2,21600992,3/13/2017,1610612742,Dallas Mavericks,0,0,1610612761,Toronto Raptors,1,1,24,36,60,7,18,25,31,54,85,9,4,13,8,49,21,7,7,89,78
2016,2,21600992,3/13/2017,1610612761,Toronto Raptors,1,1,1610612742,Dallas Mavericks,0,0,28,25,53,9,16,25,37,41,78,17,1,18,11,30,19,4,14,88,100
2022,2,22200556,1/2/2023,1610612745,Houston Rockets,1,0,1610612742,Dallas Mavericks,0,1,29,24,53,9,20,29,38,44,82,21,8,29,10,38,21,8,10,96,106
2022,2,22200406,12/12/2022,1610612739,Cleveland Cavaliers,0,0,1610612759,San Antonio Spurs,1,1,40,29,69,5,18,23,45,47,92,16,1,17,19,28,21,6,15,97,111
2022,2,22200406,12/12/2022,1610612759,San Antonio Spurs,1,1,1610612739,Cleveland Cavaliers,0,0,37,33,70,9,18,27,46,51,97,11,5,16,20,33,25,7,13,97,112
2020,2,22000536,3/2/2021,1610612763,Memphis Grizzlies,0,1,1610612764,Washington Wizards,1,0,34,32,66,13,16,29,47,48,95,18,5,23,11,39,26,8,13,108,125
2020,2,22000536,3/2/2021,1610612764,Washington Wizards,1,0,1610612763,Memphis Grizzlies,0,1,30,20,50,11,20,31,41,40,81,18,7,25,5,40,29,15,22,107,111
2016,2,21600461,12/26/2016,1610612749,Milwaukee Bucks,0,0,1610612764,Washington Wizards,1,1,34,33,67,6,14,20,40,47,87,16,7,23,16,35,27,7,14,95,102
2021,2,22100037,10/24/2021,1610612738,Boston Celtics,0,1,1610612745,Houston Rockets,1,0,23,16,39,15,32,47,38,48,86,16,4,20,10,39,22,7,12,99,107
2021,2,22100037,10/24/2021,1610612745,Houston Rockets,1,0,1610612738,Boston Celtics,0,1,18,25,43,14,18,32,32,43,75,19,5,24,8,38,20,10,20,99,97
2016,2,21600461,12/26/2016,1610612764,Washington Wizards,1,1,1610612749,Milwaukee Bucks,0,0,28,22,50,12,17,29,40,39,79,15,5,20,10,30,29,8,17,96,107
2016,2,21600066,11/3/2016,1610612749,Milwaukee Bucks,1,1,1610612754,Indiana Pacers,0,0,35,20,55,12,15,27,47,35,82,19,5,24,12,25,32,14,21,102,125
2016,2,21600066,11/3/2016,1610612754,Indiana Pacers,0,0,1610612749,Milwaukee Bucks,1,1,28,30,58,10,13,23,38,43,81,21,6,27,14,31,29,10,21,102,107
2022,2,22200405,12/12/2022,1610612742,Dallas Mavericks,1,1,1610612760,Oklahoma City Thunder,0,0,17,22,39,22,32,54,39,54,93,21,4,25,20,35,24,4,14,100,121
2022,2,22200405,12/12/2022,1610612760,Oklahoma City Thunder,0,0,1610612742,Dallas Mavericks,1,1,32,25,57,10,21,31,42,46,88,20,1,21,11,35,21,4,13,98,114
2017,2,21700730,1/27/2018,1610612742,Dallas Mavericks,0,0,1610612743,Denver Nuggets,1,1,23,31,54,11,20,31,34,51,85,10,9,19,11,45,17,6,8,91,89
2021,2,22100899,2/25/2022,1610612759,San Antonio Spurs,0,1,1610612764,Washington Wizards,1,0,48,28,76,9,20,29,57,48,105,34,9,43,20,34,35,10,17,122,157
2021,2,22100899,2/25/2022,1610612764,Washington Wizards,1,0,1610612759,San Antonio Spurs,0,1,43,27,70,16,22,38,59,49,108,19,5,24,15,37,36,6,16,123,153
2017,2,21700730,1/27/2018,1610612743,Denver Nuggets,1,1,1610612742,Dallas Mavericks,0,0,22,26,48,12,21,33,34,47,81,11,4,15,14,35,23,8,16,91,91
2016,2,21600991,3/13/2017,1610612741,Chicago Bulls,0,1,1610612766,Charlotte Hornets,1,0,27,25,52,14,26,40,41,51,92,19,3,22,16,36,29,4,10,98,115
2016,2,21600991,3/13/2017,1610612766,Charlotte Hornets,1,0,1610612741,Chicago Bulls,0,1,36,28,64,7,22,29,43,50,93,16,3,19,11,40,25,6,6,97,109
2022,2,22200404,12/12/2022,1610612737,Atlanta Hawks,0,0,1610612763,Memphis Grizzlies,1,1,25,42,67,12,25,37,37,67,104,17,5,22,27,45,20,8,16,102,103
2022,2,22200404,12/12/2022,1610612763,Memphis Grizzlies,1,1,1610612737,Atlanta Hawks,0,0,37,14,51,13,19,32,50,33,83,15,3,18,14,21,36,13,23,101,128
2020,2,22000535,3/1/2021,1610612757,Portland Trail Blazers,1,1,1610612766,Charlotte Hornets,0,0,22,18,40,24,22,46,46,40,86,7,3,10,11,29,26,12,17,96,123
2020,2,22000535,3/1/2021,1610612766,Charlotte Hornets,0,0,1610612757,Portland Trail Blazers,1,1,28,26,54,15,19,34,43,45,88,10,7,17,15,34,25,12,16,97,111
2021,2,22100036,10/24/2021,1610612752,New York Knicks,1,0,1610612753,Orlando Magic,0,1,24,28,52,13,35,48,37,63,100,17,8,25,20,48,20,7,12,102,104
2021,2,22100036,10/24/2021,1610612753,Orlando Magic,0,1,1610612752,New York Knicks,1,0,24,21,45,12,31,43,36,52,88,26,8,34,14,41,22,8,13,102,110
2022,2,22200403,12/12/2022,1610612751,Brooklyn Nets,0,1,1610612764,Washington Wizards,1,0,36,26,62,8,19,27,44,45,89,16,2,18,8,38,25,6,13,101,112
2022,2,22200403,12/12/2022,1610612764,Washington Wizards,1,0,1610612751,Brooklyn Nets,0,1,26,22,48,11,20,31,37,42,79,15,7,22,10,35,21,8,20,100,100
2021,2,22100898,2/25/2022,1610612745,Houston Rockets,0,0,1610612753,Orlando Magic,1,1,30,17,47,14,33,47,44,50,94,9,11,20,12,45,22,7,13,104,111
2022,2,22200601,1/8/2023,1610612750,Minnesota Timberwolves,0,1,1610612745,Houston Rockets,1,0,28,24,52,10,18,28,38,42,80,18,4,22,12,32,23,8,19,98,104
2021,2,22100898,2/25/2022,1610612753,Orlando Magic,1,1,1610612745,Houston Rockets,0,0,29,18,47,13,23,36,42,41,83,22,7,29,11,32,20,12,19,103,119
2021,2,22100035,10/24/2021,1610612751,Brooklyn Nets,1,0,1610612766,Charlotte Hornets,0,1,29,23,52,9,26,35,38,49,87,10,2,12,10,40,18,10,17,100,95
2021,2,22100035,10/24/2021,1610612766,Charlotte Hornets,0,1,1610612751,Brooklyn Nets,1,0,33,31,64,10,20,30,43,51,94,15,4,19,14,38,26,10,12,101,111
2014,2,21401152,4/5/2015,1610612758,Sacramento Kings,1,0,1610612762,Utah Jazz,0,1,33,31,64,5,10,15,38,41,79,14,10,24,14,33,20,11,20,96,95
2014,2,21401152,4/5/2015,1610612762,Utah Jazz,0,1,1610612758,Sacramento Kings,1,0,32,31,63,8,16,24,40,47,87,13,5,18,17,33,18,13,20,95,101
2020,2,22000800,4/10/2021,1610612747,Los Angeles Lakers,0,1,1610612751,Brooklyn Nets,1,0,28,31,59,19,15,34,47,46,93,13,7,20,15,34,30,6,15,101,126
2020,2,22000800,4/10/2021,1610612751,Brooklyn Nets,1,0,1610612747,Los Angeles Lakers,0,1,30,23,53,5,22,27,35,45,80,26,4,30,13,36,19,12,19,100,101
2016,2,21600990,3/12/2017,1610612747,Los Angeles Lakers,1,0,1610612755,Philadelphia 76ers,0,1,40,28,68,4,16,20,44,44,88,24,4,28,12,35,24,8,15,104,116
2020,2,22000534,3/1/2021,1610612751,Brooklyn Nets,0,1,1610612759,San Antonio Spurs,1,0,30,29,59,17,24,41,47,53,100,13,4,17,15,40,35,2,5,99,124
2020,2,22000534,3/1/2021,1610612759,San Antonio Spurs,1,0,1610612751,Brooklyn Nets,0,1,29,33,62,15,20,35,44,53,97,10,5,15,14,42,30,6,9,100,113
2016,2,21600990,3/12/2017,1610612755,Philadelphia 76ers,0,1,1610612747,Los Angeles Lakers,1,0,31,24,55,10,14,24,41,38,79,26,6,32,8,34,28,10,16,104,118
2014,2,21400645,1/23/2015,1610612752,New York Knicks,1,1,1610612753,Orlando Magic,0,0,33,33,66,10,15,25,43,48,91,17,4,21,16,34,29,10,14,101,113
2014,2,21400645,1/23/2015,1610612753,Orlando Magic,0,0,1610612752,New York Knicks,1,1,37,23,60,7,20,27,44,43,87,11,8,19,9,38,27,6,14,100,106
2022,2,22200402,12/12/2022,1610612748,Miami Heat,0,1,1610612754,Indiana Pacers,1,0,23,26,49,9,25,34,32,51,83,14,4,18,13,40,23,7,14,93,87
2022,2,22200402,12/12/2022,1610612754,Indiana Pacers,1,0,1610612748,Miami Heat,0,1,17,23,40,11,28,39,28,51,79,15,5,20,15,40,16,7,18,93,82
2021,2,22100897,2/25/2022,1610612754,Indiana Pacers,1,0,1610612760,Oklahoma City Thunder,0,1,35,29,64,14,23,37,49,52,101,13,9,22,12,45,31,8,14,110,125
2021,2,22100897,2/25/2022,1610612760,Oklahoma City Thunder,0,1,1610612754,Indiana Pacers,1,0,39,31,70,11,20,31,50,51,101,18,6,24,13,41,23,8,11,111,129
2021,2,22100034,10/23/2021,1610612746,LA Clippers,1,0,1610612763,Memphis Grizzlies,0,1,30,30,60,13,26,39,43,56,99,15,2,17,18,40,23,5,7,97,114
2021,2,22100034,10/23/2021,1610612763,Memphis Grizzlies,0,1,1610612746,LA Clippers,1,0,27,27,54,15,21,36,42,48,90,21,4,25,16,33,26,7,11,96,120
2022,2,22200463,12/20/2022,1610612744,Golden State Warriors,0,0,1610612752,New York Knicks,1,1,23,16,39,12,23,35,35,39,74,12,1,13,5,34,23,8,20,95,94
2016,2,21600460,12/25/2016,1610612746,LA Clippers,0,0,1610612747,Los Angeles Lakers,1,1,27,29,56,10,19,29,37,48,85,18,4,22,13,37,24,7,16,99,102
2016,2,21600460,12/25/2016,1610612747,Los Angeles Lakers,1,1,1610612746,LA Clippers,0,0,32,27,59,8,17,25,40,44,84,23,7,30,14,33,18,9,14,99,111
2016,2,21600065,11/3/2016,1610612753,Orlando Magic,1,1,1610612758,Sacramento Kings,0,0,28,26,54,10,20,30,38,46,84,16,7,23,20,31,24,8,14,90,102
2016,2,21600065,11/3/2016,1610612758,Sacramento Kings,0,0,1610612753,Orlando Magic,1,1,31,31,62,7,11,18,38,42,80,11,6,17,11,35,17,5,14,89,94
2014,2,21400357,12/15/2014,1610612738,Boston Celtics,0,1,1610612755,Philadelphia 76ers,1,0,32,29,61,6,19,25,38,48,86,23,12,35,19,34,26,11,22,103,105
2016,2,21600989,3/12/2017,1610612739,Cleveland Cavaliers,0,0,1610612745,Houston Rockets,1,1,25,12,37,17,26,43,42,38,80,11,2,13,7,32,24,10,15,94,112
2021,2,22100896,2/25/2022,1610612761,Toronto Raptors,0,0,1610612766,Charlotte Hornets,1,1,31,30,61,6,17,23,37,47,84,13,10,23,11,39,18,10,17,102,93
2016,2,21600989,3/12/2017,1610612745,Houston Rockets,1,1,1610612739,Cleveland Cavaliers,0,0,25,26,51,16,29,45,41,55,96,19,9,28,22,36,25,3,6,94,117
2021,2,22100896,2/25/2022,1610612766,Charlotte Hornets,1,1,1610612761,Toronto Raptors,0,0,37,17,54,15,25,40,52,42,94,6,3,9,15,29,34,6,18,103,125
2020,2,22000533,3/1/2021,1610612740,New Orleans Pelicans,1,1,1610612762,Utah Jazz,0,0,45,36,81,7,4,11,52,40,92,18,5,23,11,32,27,11,13,103,129
2020,2,22000533,3/1/2021,1610612762,Utah Jazz,0,0,1610612740,New Orleans Pelicans,1,1,29,29,58,17,26,43,46,55,101,15,3,18,13,45,26,5,9,105,124
2016,2,21600459,12/25/2016,1610612750,Minnesota Timberwolves,0,0,1610612760,Oklahoma City Thunder,1,1,35,36,71,4,8,12,39,44,83,18,5,23,13,34,19,8,13,92,100
2016,2,21600459,12/25/2016,1610612760,Oklahoma City Thunder,1,1,1610612750,Minnesota Timberwolves,0,0,34,24,58,8,16,24,42,40,82,20,4,24,14,27,26,11,15,93,112
2020,2,22000799,4/9/2021,1610612745,Houston Rockets,0,0,1610612746,LA Clippers,1,1,27,19,46,12,25,37,39,44,83,19,8,27,13,35,28,10,14,95,109
2020,2,22000799,4/9/2021,1610612746,LA Clippers,1,1,1610612745,Houston Rockets,0,0,29,22,51,19,18,37,48,40,88,11,2,13,10,32,31,3,10,96,126
2022,2,22200401,12/11/2022,1610612745,Houston Rockets,1,1,1610612749,Milwaukee Bucks,0,0,34,30,64,6,21,27,40,51,91,11,1,12,13,39,23,5,12,97,97
2022,2,22200401,12/11/2022,1610612749,Milwaukee Bucks,0,0,1610612745,Houston Rockets,1,1,21,26,47,12,31,43,33,57,90,14,4,18,17,43,18,11,16,97,92
2021,2,22100895,2/24/2022,1610612743,Denver Nuggets,0,1,1610612758,Sacramento Kings,1,0,33,18,51,15,20,35,48,38,86,17,3,20,10,29,30,5,17,102,128
2021,2,22100895,2/24/2022,1610612758,Sacramento Kings,1,0,1610612743,Denver Nuggets,0,1,34,23,57,9,20,29,43,43,86,15,3,18,7,37,25,12,15,103,110
2017,2,21700729,1/27/2018,1610612750,Minnesota Timberwolves,1,1,1610612751,Brooklyn Nets,0,0,38,37,75,4,17,21,42,54,96,23,3,26,22,33,20,3,6,93,111
2017,2,21700729,1/27/2018,1610612751,Brooklyn Nets,0,0,1610612750,Minnesota Timberwolves,1,1,29,23,52,9,21,30,38,44,82,12,3,15,11,35,22,9,16,93,97
2014,2,21400357,12/15/2014,1610612755,Philadelphia 76ers,1,0,1610612738,Boston Celtics,0,1,29,36,65,4,24,28,33,60,93,17,4,21,23,37,19,15,23,102,87
2021,2,22100033,10/23/2021,1610612756,Phoenix Suns,0,0,1610612757,Portland Trail Blazers,1,1,34,27,61,9,19,28,43,46,89,10,5,15,8,41,27,8,14,102,105
2021,2,22100033,10/23/2021,1610612757,Portland Trail Blazers,1,1,1610612756,Phoenix Suns,0,0,30,14,44,21,29,50,51,43,94,11,6,17,10,35,24,6,9,102,134
2019,2,21900226,11/23/2019,1610612741,Chicago Bulls,0,1,1610612766,Charlotte Hornets,1,0,21,27,48,22,25,47,43,52,95,8,4,12,17,37,27,5,13,98,116
2019,2,21900226,11/23/2019,1610612766,Charlotte Hornets,1,0,1610612741,Chicago Bulls,0,1,32,20,52,12,16,28,44,36,80,15,7,22,12,28,26,12,20,97,115
2019,2,21900009,10/23/2019,1610612742,Dallas Mavericks,1,1,1610612764,Washington Wizards,0,0,24,16,40,11,25,36,35,41,76,27,6,33,8,36,17,6,20,102,108
2019,2,21900009,10/23/2019,1610612764,Washington Wizards,0,0,1610612742,Dallas Mavericks,1,1,26,26,52,11,30,41,37,56,93,15,3,18,15,43,26,6,17,103,100
2017,2,21700728,1/27/2018,1610612738,Boston Celtics,0,0,1610612744,Golden State Warriors,1,1,23,34,57,14,14,28,37,48,85,17,7,24,15,36,17,9,16,97,105
2017,2,21700728,1/27/2018,1610612744,Golden State Warriors,1,1,1610612738,Boston Celtics,0,0,28,29,57,10,17,27,38,46,84,23,3,26,12,35,19,6,12,97,109
2016,2,21600988,3/12/2017,1610612756,Phoenix Suns,1,0,1610612757,Portland Trail Blazers,0,1,36,43,79,5,9,14,41,52,93,14,6,20,11,44,20,7,10,102,101
2016,2,21600988,3/12/2017,1610612757,Portland Trail Blazers,0,1,1610612756,Phoenix Suns,1,0,36,28,64,7,15,22,43,43,86,17,8,25,10,37,14,5,14,100,110
2021,2,22100894,2/24/2022,1610612744,Golden State Warriors,0,1,1610612757,Portland Trail Blazers,1,0,30,17,47,15,26,41,45,43,88,27,5,32,18,27,36,5,12,99,132
2021,2,22100894,2/24/2022,1610612757,Portland Trail Blazers,1,0,1610612744,Golden State Warriors,0,1,22,22,44,9,26,35,31,48,79,24,5,29,12,39,16,10,18,98,95
2021,2,22100032,10/23/2021,1610612749,Milwaukee Bucks,0,1,1610612759,San Antonio Spurs,1,0,29,19,48,15,20,35,44,39,83,18,4,22,10,29,21,10,22,101,121
2021,2,22100032,10/23/2021,1610612759,San Antonio Spurs,1,0,1610612749,Milwaukee Bucks,0,1,38,22,60,10,29,39,48,51,99,5,1,6,14,38,29,6,13,102,111
2020,2,22000532,3/1/2021,1610612739,Cleveland Cavaliers,0,1,1610612745,Houston Rockets,1,0,26,17,43,10,20,30,36,37,73,19,5,24,10,29,23,13,21,95,101
2020,2,22000532,3/1/2021,1610612745,Houston Rockets,1,0,1610612739,Cleveland Cavaliers,0,1,21,24,45,10,21,31,31,45,76,18,6,24,6,44,13,7,14,95,90
2016,2,21600458,12/25/2016,1610612741,Chicago Bulls,0,0,1610612759,San Antonio Spurs,1,1,32,36,68,7,11,18,39,47,86,15,5,20,18,32,20,7,14,93,100
2016,2,21600458,12/25/2016,1610612759,San Antonio Spurs,1,1,1610612741,Chicago Bulls,0,0,39,28,67,9,9,18,48,37,85,14,5,19,14,26,30,9,13,91,119
2020,2,22000798,4/9/2021,1610612744,Golden State Warriors,1,0,1610612764,Washington Wizards,0,1,30,22,52,11,25,36,41,47,88,14,7,21,11,38,27,6,13,102,107
2020,2,22000798,4/9/2021,1610612764,Washington Wizards,0,1,1610612744,Golden State Warriors,1,0,38,32,70,5,14,19,43,46,89,19,5,24,14,35,30,15,18,102,110
2022,2,22200400,12/11/2022,1610612737,Atlanta Hawks,1,1,1610612741,Chicago Bulls,0,0,34,25,59,13,26,39,47,51,98,16,5,21,11,42,28,11,15,111,123
2022,2,22200400,12/11/2022,1610612741,Chicago Bulls,0,0,1610612737,Atlanta Hawks,1,1,41,32,73,7,20,27,48,52,100,19,4,23,17,39,28,3,19,112,122
2021,2,22100893,2/24/2022,1610612756,Phoenix Suns,0,1,1610612760,Oklahoma City Thunder,1,0,33,19,52,13,21,34,46,40,86,19,2,21,5,36,32,10,16,106,124
2021,2,22100893,2/24/2022,1610612760,Oklahoma City Thunder,1,0,1610612756,Phoenix Suns,0,1,38,24,62,6,25,31,44,49,93,10,1,11,9,40,22,14,16,104,104
2023,2,22300233,11/22/2023,1610612758,Sacramento Kings,0,0,1610612740,New Orleans Pelicans,1,1,19,13,32,15,29,44,34,42,76,29,6,35,9,37,22,10,16,100,112
2021,2,22100031,10/23/2021,1610612740,New Orleans Pelicans,0,0,1610612750,Minnesota Timberwolves,1,1,22,27,49,9,31,40,31,58,89,18,5,23,25,36,15,13,30,104,89
2021,2,22100031,10/23/2021,1610612750,Minnesota Timberwolves,1,1,1610612740,New Orleans Pelicans,0,0,27,31,58,12,26,38,39,57,96,6,4,10,17,42,22,10,20,105,96
2020,2,22000531,3/1/2021,1610612741,Chicago Bulls,1,0,1610612743,Denver Nuggets,0,1,30,26,56,12,26,38,42,52,94,16,6,22,16,41,25,4,10,97,112
2014,2,21400356,12/15/2014,1610612747,Los Angeles Lakers,0,0,1610612754,Indiana Pacers,1,1,19,43,62,10,16,26,29,59,88,23,6,29,15,47,14,7,9,97,91
2014,2,21400356,12/15/2014,1610612754,Indiana Pacers,1,1,1610612747,Los Angeles Lakers,0,0,33,33,66,7,10,17,40,43,83,23,4,27,15,30,21,10,14,95,110
2022,2,22200399,12/11/2022,1610612755,Philadelphia 76ers,1,1,1610612766,Charlotte Hornets,0,0,33,23,56,13,14,27,46,37,83,26,6,32,11,30,31,12,16,101,131
2022,2,22200399,12/11/2022,1610612766,Charlotte Hornets,0,0,1610612755,Philadelphia 76ers,1,1,27,36,63,11,19,30,38,55,93,26,4,30,22,35,21,6,16,100,113
2020,2,22000531,3/1/2021,1610612743,Denver Nuggets,0,1,1610612741,Chicago Bulls,1,0,36,24,60,10,17,27,46,41,87,16,4,20,11,32,22,7,13,98,118
2021,2,22100030,10/23/2021,1610612741,Chicago Bulls,1,1,1610612765,Detroit Pistons,0,0,24,34,58,11,15,26,35,49,84,16,3,19,7,43,24,9,13,100,97
2021,2,22100030,10/23/2021,1610612765,Detroit Pistons,0,0,1610612741,Chicago Bulls,1,1,29,31,60,5,23,28,34,54,88,9,6,15,16,40,14,13,23,100,82
2018,2,21800964,3/5/2019,1610612738,Boston Celtics,0,1,1610612744,Golden State Warriors,1,0,35,27,62,14,20,34,49,47,96,16,1,17,10,37,38,5,11,104,128
2018,2,21800964,3/5/2019,1610612744,Golden State Warriors,1,0,1610612738,Boston Celtics,0,1,26,24,50,8,27,35,34,51,85,19,4,23,13,40,26,12,22,105,95
2017,2,21701103,3/26/2018,1610612752,New York Knicks,0,0,1610612766,Charlotte Hornets,1,1,45,30,75,9,21,30,54,51,105,11,0,11,16,35,25,5,11,106,128
2017,2,21701103,3/26/2018,1610612766,Charlotte Hornets,1,1,1610612752,New York Knicks,0,0,40,25,65,11,17,28,51,42,93,24,4,28,14,31,25,6,15,106,137
2022,2,22200398,12/11/2022,1610612753,Orlando Magic,1,1,1610612761,Toronto Raptors,0,0,22,24,46,14,17,31,36,41,77,25,6,31,18,26,25,9,18,90,111
2022,2,22200398,12/11/2022,1610612761,Toronto Raptors,0,0,1610612753,Orlando Magic,1,1,24,26,50,6,19,25,30,45,75,33,5,38,11,37,18,3,9,90,99
2021,2,22100892,2/24/2022,1610612750,Minnesota Timberwolves,1,1,1610612763,Memphis Grizzlies,0,0,27,24,51,16,26,42,43,50,93,17,8,25,18,35,26,9,12,99,119
2021,2,22100892,2/24/2022,1610612763,Memphis Grizzlies,0,0,1610612750,Minnesota Timberwolves,1,1,29,38,67,9,22,31,38,60,98,29,11,40,33,34,25,6,16,101,114
2021,2,22100029,10/23/2021,1610612742,Dallas Mavericks,0,1,1610612761,Toronto Raptors,1,0,24,25,49,14,28,42,38,53,91,13,5,18,17,41,24,7,9,92,103
2021,2,22100029,10/23/2021,1610612761,Toronto Raptors,1,0,1610612742,Dallas Mavericks,0,1,23,25,48,11,26,37,34,51,85,16,7,23,16,39,17,6,12,93,95
2020,2,22000530,3/1/2021,1610612754,Indiana Pacers,0,0,1610612755,Philadelphia 76ers,1,1,36,26,62,8,21,29,44,47,91,18,3,21,12,36,27,10,19,106,114
2016,2,21600987,3/12/2017,1610612748,Miami Heat,0,0,1610612754,Indiana Pacers,1,1,30,32,62,9,23,32,39,55,94,11,5,16,22,37,18,2,12,91,98
2016,2,21600987,3/12/2017,1610612754,Indiana Pacers,1,1,1610612748,Miami Heat,0,0,30,37,67,5,10,15,35,47,82,27,5,32,15,35,12,4,9,90,102
2022,2,22200397,12/11/2022,1610612752,New York Knicks,1,1,1610612758,Sacramento Kings,0,0,32,22,54,8,27,35,40,49,89,24,3,27,17,33,19,7,17,104,112
2014,2,21400355,12/15/2014,1610612739,Cleveland Cavaliers,1,1,1610612766,Charlotte Hornets,0,0,29,30,59,9,15,24,38,45,83,12,5,17,12,33,28,4,11,92,97
2014,2,21400355,12/15/2014,1610612766,Charlotte Hornets,0,0,1610612739,Cleveland Cavaliers,1,1,33,34,67,5,11,16,38,45,83,7,7,14,9,40,22,10,10,91,88
2022,2,22200397,12/11/2022,1610612758,Sacramento Kings,0,0,1610612752,New York Knicks,1,1,23,21,44,10,29,39,33,50,83,23,12,35,13,42,20,8,17,105,99
2020,2,22000530,3/1/2021,1610612755,Philadelphia 76ers,1,1,1610612754,Indiana Pacers,0,0,35,18,53,15,20,35,50,38,88,15,1,16,10,28,27,8,19,106,130
2021,2,22100028,10/23/2021,1610612748,Miami Heat,0,0,1610612754,Indiana Pacers,1,1,26,32,58,9,24,33,35,56,91,12,2,14,15,42,18,10,22,105,91
2021,2,22100028,10/23/2021,1610612754,Indiana Pacers,1,1,1610612748,Miami Heat,0,0,28,30,58,10,29,39,38,59,97,16,5,21,16,45,18,4,16,106,102
2018,2,21801112,3/26/2019,1610612746,LA Clippers,0,1,1610612750,Minnesota Timberwolves,1,0,30,23,53,16,16,32,46,39,85,14,0,14,5,34,30,13,18,105,122
2018,2,21801112,3/26/2019,1610612750,Minnesota Timberwolves,1,0,1610612746,LA Clippers,0,1,32,35,67,9,18,27,41,53,94,20,13,33,12,48,22,8,10,105,111
2017,2,21700727,1/27/2018,1610612748,Miami Heat,1,1,1610612766,Charlotte Hornets,0,0,30,29,59,8,18,26,38,47,85,11,7,18,14,35,25,6,14,92,95
2017,2,21700727,1/27/2018,1610612766,Charlotte Hornets,0,0,1610612748,Miami Heat,1,1,24,36,60,5,19,24,29,55,84,28,7,35,17,42,12,4,8,94,91
2016,2,21600986,3/12/2017,1610612751,Brooklyn Nets,1,1,1610612752,New York Knicks,0,0,21,28,49,19,19,38,40,47,87,21,8,29,17,34,23,5,16,101,120
2022,2,22200396,12/11/2022,1610612747,Los Angeles Lakers,0,1,1610612765,Detroit Pistons,1,0,35,23,58,11,15,26,46,38,84,21,6,27,7,33,31,9,11,99,124
2016,2,21600986,3/12/2017,1610612752,New York Knicks,0,0,1610612751,Brooklyn Nets,1,1,31,40,71,8,15,23,39,55,94,26,6,32,15,42,22,7,9,101,112
2016,2,21600457,12/25/2016,1610612739,Cleveland Cavaliers,1,1,1610612744,Golden State Warriors,0,0,25,35,60,12,23,35,37,58,95,23,9,32,22,39,20,8,12,100,109
2022,2,22200396,12/11/2022,1610612765,Detroit Pistons,1,0,1610612747,Los Angeles Lakers,0,1,26,22,48,17,28,45,43,50,93,14,3,17,14,37,28,8,12,99,117
2021,2,22100891,2/24/2022,1610612737,Atlanta Hawks,0,0,1610612741,Chicago Bulls,1,1,33,36,69,8,20,28,41,56,97,18,9,27,22,38,20,5,10,99,108
2021,2,22100891,2/24/2022,1610612741,Chicago Bulls,1,1,1610612737,Atlanta Hawks,0,0,33,24,57,8,19,27,41,43,84,22,5,27,9,35,16,2,9,98,112
2021,2,22100027,10/23/2021,1610612737,Atlanta Hawks,0,0,1610612739,Cleveland Cavaliers,1,1,28,37,65,10,24,34,38,61,99,9,6,15,20,43,20,6,9,95,95
2021,2,22100027,10/23/2021,1610612739,Cleveland Cavaliers,1,1,1610612737,Atlanta Hawks,0,0,30,31,61,7,21,28,37,52,89,20,7,27,15,41,23,5,10,96,101
2020,2,22000529,3/1/2021,1610612742,Dallas Mavericks,0,1,1610612753,Orlando Magic,1,0,30,14,44,17,29,46,47,43,90,19,4,23,8,37,29,5,8,102,130
2016,2,21600457,12/25/2016,1610612744,Golden State Warriors,0,0,1610612739,Cleveland Cavaliers,1,1,28,19,47,9,21,30,37,40,77,25,4,29,11,32,25,14,20,101,108
2016,2,21600064,11/2/2016,1610612746,LA Clippers,1,0,1610612760,Oklahoma City Thunder,0,1,27,38,65,7,15,22,34,53,87,8,10,18,15,43,22,8,19,99,83
2022,2,22200395,12/11/2022,1610612740,New Orleans Pelicans,1,1,1610612756,Phoenix Suns,0,0,42,19,61,8,17,25,50,36,86,21,7,28,11,29,31,7,17,106,129
2022,2,22200395,12/11/2022,1610612756,Phoenix Suns,0,0,1610612740,New Orleans Pelicans,1,1,36,31,67,13,25,38,49,56,105,13,4,17,23,36,34,10,15,105,124
2017,2,21700726,1/27/2018,1610612737,Atlanta Hawks,1,0,1610612764,Washington Wizards,0,1,26,19,45,12,31,43,38,50,88,16,5,21,18,34,24,7,13,94,104
2017,2,21700726,1/27/2018,1610612764,Washington Wizards,0,1,1610612737,Atlanta Hawks,1,0,31,22,53,18,14,32,49,36,85,13,1,14,12,25,40,2,13,93,129
2021,2,22100890,2/24/2022,1610612738,Boston Celtics,0,1,1610612751,Brooklyn Nets,1,0,29,14,43,17,25,42,46,39,85,20,7,27,8,33,28,8,14,103,129
2021,2,22100890,2/24/2022,1610612751,Brooklyn Nets,1,0,1610612738,Boston Celtics,0,1,32,33,65,7,22,29,39,55,94,21,7,28,16,41,25,9,11,104,106
2021,2,22100026,10/22/2021,1610612758,Sacramento Kings,1,0,1610612762,Utah Jazz,0,1,31,32,63,8,28,36,39,60,99,15,6,21,21,40,20,14,15,102,101
2021,2,22100026,10/22/2021,1610612762,Utah Jazz,0,1,1610612758,Sacramento Kings,1,0,21,27,48,16,26,42,37,53,90,20,3,23,18,36,16,15,19,102,110
2020,2,22000529,3/1/2021,1610612753,Orlando Magic,1,0,1610612742,Dallas Mavericks,0,1,27,27,54,20,21,41,47,48,95,10,4,14,7,43,25,6,8,103,124
2016,2,21600456,12/25/2016,1610612738,Boston Celtics,0,1,1610612752,New York Knicks,1,0,31,26,57,14,22,36,45,48,93,15,5,20,16,35,25,5,7,93,119
2016,2,21600456,12/25/2016,1610612752,New York Knicks,1,0,1610612738,Boston Celtics,0,1,33,31,64,8,15,23,41,46,87,24,3,27,20,28,11,10,17,94,114
2020,2,22000528,2/28/2021,1610612758,Sacramento Kings,1,0,1610612766,Charlotte Hornets,0,1,34,22,56,16,20,36,50,42,92,10,7,17,11,34,32,3,10,98,126
2021,2,22100889,2/24/2022,1610612739,Cleveland Cavaliers,0,0,1610612765,Detroit Pistons,1,1,22,20,42,12,23,35,34,43,77,23,11,34,10,39,20,8,12,95,103
2021,2,22100889,2/24/2022,1610612765,Detroit Pistons,1,1,1610612739,Cleveland Cavaliers,0,0,24,28,52,11,23,34,35,51,86,25,3,28,17,36,23,3,11,95,106
2016,2,21600985,3/12/2017,1610612738,Boston Celtics,1,1,1610612741,Chicago Bulls,0,0,24,25,49,16,21,37,40,46,86,4,0,4,15,31,22,13,21,96,100
2016,2,21600985,3/12/2017,1610612741,Chicago Bulls,0,0,1610612738,Boston Celtics,1,1,26,36,62,7,18,25,33,54,87,7,2,9,14,41,18,14,19,95,80
2022,2,22200394,12/10/2022,1610612750,Minnesota Timberwolves,0,0,1610612757,Portland Trail Blazers,1,1,35,25,60,10,13,23,45,38,83,18,6,24,7,35,22,5,13,99,118
2022,2,22200394,12/10/2022,1610612757,Portland Trail Blazers,1,1,1610612750,Minnesota Timberwolves,0,0,30,19,49,13,21,34,43,40,83,25,3,28,15,27,20,11,16,97,124
2021,2,22100888,2/17/2022,1610612745,Houston Rockets,0,0,1610612746,LA Clippers,1,1,29,25,54,13,24,37,42,49,91,14,5,19,12,41,29,12,19,106,111
2016,2,21600984,3/11/2017,1610612743,Denver Nuggets,0,1,1610612758,Sacramento Kings,1,0,31,20,51,9,25,34,40,45,85,16,2,18,12,34,21,4,9,91,105
2021,2,22100888,2/17/2022,1610612746,LA Clippers,1,1,1610612745,Houston Rockets,0,0,33,24,57,18,17,35,51,41,92,22,4,26,16,26,34,8,18,104,142
2020,2,22000528,2/28/2021,1610612766,Charlotte Hornets,0,1,1610612758,Sacramento Kings,1,0,34,19,53,11,19,30,45,38,83,26,1,27,13,26,30,6,16,99,127
2016,2,21600984,3/11/2017,1610612758,Sacramento Kings,1,0,1610612743,Denver Nuggets,0,1,28,31,59,8,15,23,36,46,82,12,8,20,13,38,24,8,13,91,92
2014,2,21400644,1/23/2015,1610612748,Miami Heat,1,1,1610612754,Indiana Pacers,0,0,32,26,58,4,13,17,36,39,75,13,2,15,8,31,20,9,18,92,89
2014,2,21400644,1/23/2015,1610612754,Indiana Pacers,0,0,1610612748,Miami Heat,1,1,29,34,63,3,12,15,32,46,78,20,3,23,15,33,14,8,18,92,87
2019,2,21900008,10/23/2019,1610612738,Boston Celtics,0,0,1610612755,Philadelphia 76ers,1,1,26,38,64,7,19,26,33,57,90,20,14,34,14,51,18,6,11,102,93
2019,2,21900008,10/23/2019,1610612755,Philadelphia 76ers,1,1,1610612738,Boston Celtics,0,0,30,26,56,7,22,29,37,48,85,26,10,36,18,34,24,4,17,103,107
2020,2,22000797,4/9/2021,1610612743,Denver Nuggets,1,1,1610612759,San Antonio Spurs,0,0,29,23,52,14,13,27,43,36,79,21,2,23,10,28,32,10,18,98,121
2020,2,22000797,4/9/2021,1610612759,San Antonio Spurs,0,0,1610612743,Denver Nuggets,1,1,34,32,66,9,18,27,43,50,93,24,4,28,15,39,33,5,9,100,119
2017,2,21700725,1/27/2018,1610612753,Orlando Magic,0,0,1610612754,Indiana Pacers,1,1,34,18,52,8,17,25,42,35,77,20,12,32,14,30,21,9,16,93,112
2017,2,21700725,1/27/2018,1610612754,Indiana Pacers,1,1,1610612753,Orlando Magic,0,0,42,27,69,5,13,18,47,40,87,15,4,19,13,29,25,6,10,94,114
2021,2,22100887,2/17/2022,1610612749,Milwaukee Bucks,1,0,1610612755,Philadelphia 76ers,0,1,28,23,51,14,30,44,42,53,95,22,6,28,14,39,20,2,7,103,120
2021,2,22100887,2/17/2022,1610612755,Philadelphia 76ers,0,1,1610612749,Milwaukee Bucks,1,0,32,22,54,12,22,34,44,44,88,23,4,27,10,34,21,5,12,104,123
2021,2,22100025,10/22/2021,1610612747,Los Angeles Lakers,1,0,1610612756,Phoenix Suns,0,1,19,33,52,15,19,34,34,52,86,22,7,29,15,41,25,8,16,101,105
2021,2,22100025,10/22/2021,1610612756,Phoenix Suns,0,1,1610612747,Los Angeles Lakers,1,0,32,22,54,10,22,32,42,44,86,21,7,28,11,36,31,7,12,101,115
2014,2,21400354,12/14/2014,1610612743,Denver Nuggets,1,0,1610612759,San Antonio Spurs,0,1,26,41,67,8,8,16,34,49,83,15,6,21,20,34,20,9,21,94,91
2014,2,21400354,12/14/2014,1610612759,San Antonio Spurs,0,1,1610612743,Denver Nuggets,1,0,29,29,58,5,11,16,34,40,74,26,9,35,12,31,26,10,13,93,99
2016,2,21600064,11/2/2016,1610612760,Oklahoma City Thunder,0,1,1610612746,LA Clippers,1,0,29,35,64,5,15,20,34,50,84,12,8,20,16,36,14,13,22,99,85
2014,2,21400643,1/23/2015,1610612739,Cleveland Cavaliers,1,1,1610612766,Charlotte Hornets,0,0,31,30,61,15,13,28,46,43,89,22,6,28,14,33,29,6,11,97,129
2014,2,21400643,1/23/2015,1610612766,Charlotte Hornets,0,0,1610612739,Cleveland Cavaliers,1,1,34,39,73,2,14,16,36,53,89,16,8,24,13,46,27,7,12,97,90
2017,2,21700724,1/27/2018,1610612760,Oklahoma City Thunder,0,1,1610612765,Detroit Pistons,1,0,31,29,60,14,19,33,45,48,93,17,6,23,19,32,23,4,10,96,121
2022,2,22200393,12/10/2022,1610612743,Denver Nuggets,1,1,1610612762,Utah Jazz,0,0,39,21,60,8,18,26,47,39,86,13,3,16,7,34,28,5,9,95,115
2017,2,21700724,1/27/2018,1610612765,Detroit Pistons,1,0,1610612760,Oklahoma City Thunder,0,1,27,24,51,12,21,33,39,45,84,18,6,24,17,30,24,9,17,95,108
2014,2,21401150,4/5/2015,1610612744,Golden State Warriors,0,0,1610612759,San Antonio Spurs,1,1,30,33,63,9,19,28,39,52,91,5,5,10,13,41,25,8,11,96,92
2014,2,21401150,4/5/2015,1610612759,San Antonio Spurs,1,1,1610612744,Golden State Warriors,0,0,37,25,62,7,14,21,44,39,83,12,3,15,9,30,27,4,14,94,107
2016,2,21600455,12/23/2016,1610612742,Dallas Mavericks,0,1,1610612746,LA Clippers,1,0,30,28,58,7,22,29,37,50,87,9,6,15,16,38,21,9,12,89,90
2016,2,21600455,12/23/2016,1610612746,LA Clippers,1,0,1610612742,Dallas Mavericks,0,1,21,24,45,13,16,29,34,40,74,7,4,11,8,34,17,13,20,91,88
2014,2,21400353,12/14/2014,1610612752,New York Knicks,1,0,1610612761,Toronto Raptors,0,1,20,29,49,9,20,29,29,49,78,23,5,28,17,35,15,14,25,100,90
2014,2,21400353,12/14/2014,1610612761,Toronto Raptors,0,1,1610612752,New York Knicks,1,0,27,27,54,9,15,24,36,42,78,14,4,18,12,31,24,11,24,99,95
2022,2,22200393,12/10/2022,1610612762,Utah Jazz,0,0,1610612743,Denver Nuggets,1,1,24,20,44,15,26,41,39,46,85,17,4,21,12,37,20,5,14,96,110
2020,2,22000527,2/28/2021,1610612744,Golden State Warriors,0,0,1610612747,Los Angeles Lakers,1,1,27,25,52,8,26,34,35,51,86,13,6,19,6,49,26,14,20,106,91
2014,2,21400642,1/23/2015,1610612737,Atlanta Hawks,1,1,1610612760,Oklahoma City Thunder,0,0,30,28,58,10,15,25,40,43,83,13,0,13,14,29,27,11,19,93,103
2016,2,21600983,3/11/2017,1610612757,Portland Trail Blazers,1,0,1610612764,Washington Wizards,0,1,32,30,62,16,16,32,48,46,94,12,4,16,11,37,26,5,15,105,124
2016,2,21600983,3/11/2017,1610612764,Washington Wizards,0,1,1610612757,Portland Trail Blazers,1,0,35,30,65,12,13,25,47,43,90,19,9,28,12,37,27,4,13,104,125
2016,2,21600454,12/23/2016,1610612757,Portland Trail Blazers,1,0,1610612759,San Antonio Spurs,0,1,23,26,49,12,18,30,35,44,79,8,8,16,16,34,21,9,17,88,90
2016,2,21600454,12/23/2016,1610612759,San Antonio Spurs,0,1,1610612757,Portland Trail Blazers,1,0,27,31,58,12,8,20,39,39,78,20,1,21,14,25,19,8,12,88,110
2014,2,21400642,1/23/2015,1610612760,Oklahoma City Thunder,0,0,1610612737,Atlanta Hawks,1,1,26,35,61,10,16,26,36,51,87,11,7,18,16,40,23,6,13,94,93
2020,2,22000796,4/9/2021,1610612749,Milwaukee Bucks,1,0,1610612766,Charlotte Hornets,0,1,30,30,60,14,24,38,44,54,98,17,6,23,18,38,23,4,17,108,119
2020,2,22000796,4/9/2021,1610612766,Charlotte Hornets,0,1,1610612749,Milwaukee Bucks,1,0,25,16,41,19,31,50,44,47,91,20,2,22,13,35,35,10,20,108,127
2014,2,21400352,12/14/2014,1610612756,Phoenix Suns,0,0,1610612760,Oklahoma City Thunder,1,1,27,41,68,7,24,31,34,65,99,13,5,18,18,51,21,7,11,99,88
2022,2,22200392,12/10/2022,1610612738,Boston Celtics,0,0,1610612744,Golden State Warriors,1,1,26,21,47,12,28,40,38,49,87,19,7,26,8,43,17,3,10,102,107
2022,2,22200392,12/10/2022,1610612744,Golden State Warriors,1,1,1610612738,Boston Celtics,0,0,34,19,53,13,26,39,47,45,92,16,4,20,13,34,26,8,15,103,123
2014,2,21400352,12/14/2014,1610612760,Oklahoma City Thunder,1,1,1610612756,Phoenix Suns,0,0,35,27,62,4,14,18,39,41,80,30,4,34,16,27,20,11,19,98,112
2022,2,22200584,1/6/2023,1610612760,Oklahoma City Thunder,1,1,1610612764,Washington Wizards,0,0,33,28,61,17,20,37,50,48,98,10,4,14,13,37,30,6,10,103,127
2014,2,21400641,1/23/2015,1610612755,Philadelphia 76ers,1,0,1610612761,Toronto Raptors,0,1,22,30,52,9,20,29,31,50,81,15,3,18,16,36,21,11,18,92,86
2014,2,21400641,1/23/2015,1610612761,Toronto Raptors,0,1,1610612755,Philadelphia 76ers,1,0,27,29,56,6,18,24,33,47,80,19,5,24,15,34,19,9,16,92,91
2021,2,22100886,2/17/2022,1610612740,New Orleans Pelicans,1,0,1610612742,Dallas Mavericks,0,1,34,30,64,12,16,28,46,46,92,14,7,21,18,33,22,5,13,94,118
2021,2,22100886,2/17/2022,1610612742,Dallas Mavericks,0,1,1610612740,New Orleans Pelicans,1,0,25,17,42,19,21,40,44,38,82,18,7,25,8,32,18,7,9,94,125
2023,2,22300010,11/10/2023,1610612751,Brooklyn Nets,0,0,1610612738,Boston Celtics,1,1,23,25,48,15,22,37,38,47,85,16,2,18,11,36,26,5,12,96,107
2014,2,21400351,12/14/2014,1610612747,Los Angeles Lakers,0,1,1610612750,Minnesota Timberwolves,1,0,29,35,64,5,12,17,34,47,81,27,7,34,15,34,22,6,11,94,100
2016,2,21600982,3/11/2017,1610612742,Dallas Mavericks,1,0,1610612756,Phoenix Suns,0,1,19,29,48,9,17,26,28,46,74,33,3,36,11,36,17,5,13,94,98
2016,2,21600982,3/11/2017,1610612756,Phoenix Suns,0,1,1610612742,Dallas Mavericks,1,0,32,30,62,6,15,21,38,45,83,18,2,20,6,41,18,2,11,95,100
2016,2,21600453,12/23/2016,1610612755,Philadelphia 76ers,0,0,1610612756,Phoenix Suns,1,1,29,23,52,13,18,31,42,41,83,19,3,22,9,33,23,7,20,102,116
2016,2,21600453,12/23/2016,1610612756,Phoenix Suns,1,1,1610612755,Philadelphia 76ers,0,0,30,23,53,12,14,26,42,37,79,27,10,37,16,24,25,7,20,102,123
2021,2,22100024,10/22/2021,1610612743,Denver Nuggets,1,1,1610612759,San Antonio Spurs,0,0,35,21,56,9,21,30,44,42,86,5,3,8,10,34,26,11,21,101,102
2021,2,22100024,10/22/2021,1610612759,San Antonio Spurs,0,0,1610612743,Denver Nuggets,1,1,34,26,60,6,18,24,40,44,84,10,4,14,9,35,24,10,20,102,96
2022,2,22200584,1/6/2023,1610612764,Washington Wizards,0,0,1610612760,Oklahoma City Thunder,1,1,31,24,55,7,17,24,38,41,79,27,9,36,14,32,21,9,20,102,110
2014,2,21400351,12/14/2014,1610612750,Minnesota Timberwolves,1,0,1610612747,Los Angeles Lakers,0,1,35,45,80,3,7,10,38,52,90,15,5,20,18,37,25,10,14,95,94
2014,2,21401149,4/5/2015,1610612748,Miami Heat,0,0,1610612754,Indiana Pacers,1,1,35,27,62,2,18,20,37,45,82,13,6,19,12,36,15,6,14,91,89
2017,2,21700723,1/26/2018,1610612752,New York Knicks,0,1,1610612756,Phoenix Suns,1,0,32,28,60,9,16,25,41,44,85,16,6,22,13,33,25,6,16,99,107
2017,2,21700723,1/26/2018,1610612756,Phoenix Suns,1,0,1610612752,New York Knicks,0,1,22,39,61,11,22,33,33,61,94,8,5,13,20,43,15,7,15,99,85
2014,2,21401149,4/5/2015,1610612754,Indiana Pacers,1,1,1610612748,Miami Heat,0,0,23,32,55,14,16,30,37,48,85,24,12,36,22,32,23,7,11,91,112
2022,2,22200390,12/10/2022,1610612739,Cleveland Cavaliers,1,1,1610612760,Oklahoma City Thunder,0,0,28,25,53,12,20,32,40,45,85,18,8,26,15,35,25,8,13,95,110
2022,2,22200390,12/10/2022,1610612760,Oklahoma City Thunder,0,0,1610612739,Cleveland Cavaliers,1,1,28,26,54,10,19,29,38,45,83,16,4,20,10,37,25,6,11,95,102
2020,2,22000527,2/28/2021,1610612747,Los Angeles Lakers,1,1,1610612744,Golden State Warriors,0,0,29,25,54,11,20,31,40,45,85,26,12,38,15,36,22,10,20,106,117
2016,2,21600063,11/2/2016,1610612756,Phoenix Suns,1,1,1610612757,Portland Trail Blazers,0,0,39,48,87,5,11,16,44,59,103,25,5,30,17,46,15,8,12,111,118
2019,2,21900225,11/23/2019,1610612750,Minnesota Timberwolves,1,0,1610612756,Phoenix Suns,0,1,26,23,49,12,30,42,38,53,91,10,7,17,13,44,26,9,14,100,98
2019,2,21900225,11/23/2019,1610612756,Phoenix Suns,0,1,1610612750,Minnesota Timberwolves,1,0,23,38,61,10,25,35,33,63,96,24,2,26,14,49,22,2,7,100,100
2016,2,21600063,11/2/2016,1610612757,Portland Trail Blazers,0,0,1610612756,Phoenix Suns,1,1,30,38,68,12,21,33,42,59,101,19,2,21,14,47,25,10,15,112,115
2022,2,22200389,12/10/2022,1610612746,LA Clippers,0,1,1610612764,Washington Wizards,1,0,21,25,46,19,29,48,40,54,94,15,1,16,12,43,22,8,10,100,114
2022,2,22200389,12/10/2022,1610612764,Washington Wizards,1,0,1610612746,LA Clippers,0,1,21,30,51,16,18,34,37,48,85,17,2,19,11,38,24,9,15,99,107
2021,2,22100885,2/17/2022,1610612748,Miami Heat,0,1,1610612766,Charlotte Hornets,1,0,27,27,54,14,34,48,41,61,102,15,8,23,22,43,31,6,15,110,111
2021,2,22100885,2/17/2022,1610612766,Charlotte Hornets,1,0,1610612748,Miami Heat,0,1,28,25,53,10,32,42,38,57,95,21,9,30,18,43,27,4,18,108,107
2016,2,21600981,3/11/2017,1610612737,Atlanta Hawks,0,1,1610612763,Memphis Grizzlies,1,0,21,21,42,15,15,30,36,36,72,20,6,26,6,32,22,11,18,96,107
2016,2,21600981,3/11/2017,1610612763,Memphis Grizzlies,1,0,1610612737,Atlanta Hawks,0,1,29,32,61,5,24,29,34,56,90,17,6,23,17,42,22,9,13,98,90
2017,2,21700722,1/26/2018,1610612755,Philadelphia 76ers,0,1,1610612759,San Antonio Spurs,1,0,29,29,58,9,12,21,38,41,79,12,6,18,13,31,23,6,10,85,97
2017,2,21700722,1/26/2018,1610612759,San Antonio Spurs,1,0,1610612755,Philadelphia 76ers,0,1,27,24,51,3,21,24,30,45,75,15,3,18,8,40,20,5,10,86,78
2014,2,21400350,12/14/2014,1610612762,Utah Jazz,0,0,1610612764,Washington Wizards,1,1,25,36,61,5,12,17,30,48,78,19,9,28,16,36,13,11,17,92,84
2014,2,21400350,12/14/2014,1610612764,Washington Wizards,1,1,1610612762,Utah Jazz,0,0,37,34,71,4,9,13,41,43,84,7,5,12,13,34,20,8,15,92,93
2021,2,22100023,10/22/2021,1610612745,Houston Rockets,1,1,1610612760,Oklahoma City Thunder,0,0,31,26,57,17,21,38,48,47,95,11,3,14,16,34,29,9,17,104,124
2021,2,22100023,10/22/2021,1610612760,Oklahoma City Thunder,0,0,1610612745,Houston Rockets,1,1,20,28,48,14,29,43,34,57,91,9,7,16,14,48,22,12,19,103,91
2014,2,21400640,1/22/2015,1610612746,LA Clippers,1,1,1610612751,Brooklyn Nets,0,0,38,20,58,11,14,25,49,34,83,14,7,21,12,26,41,11,14,95,123
2014,2,21400640,1/22/2015,1610612751,Brooklyn Nets,0,0,1610612746,LA Clippers,1,1,29,38,67,4,17,21,33,55,88,14,11,25,18,42,17,8,13,96,84
2020,2,22000795,4/9/2021,1610612740,New Orleans Pelicans,1,1,1610612755,Philadelphia 76ers,0,0,35,33,68,4,18,22,39,51,90,19,11,30,13,45,22,8,14,104,101
2020,2,22000795,4/9/2021,1610612755,Philadelphia 76ers,0,0,1610612740,New Orleans Pelicans,1,1,22,26,48,11,20,31,33,46,79,17,7,24,5,46,20,11,19,104,94
2022,2,22200388,12/10/2022,1610612751,Brooklyn Nets,0,1,1610612754,Indiana Pacers,1,0,43,29,72,9,19,28,52,48,100,23,9,32,29,24,19,10,18,103,136
2021,2,22100884,2/16/2022,1610612747,Los Angeles Lakers,1,1,1610612762,Utah Jazz,0,0,31,19,50,10,26,36,41,45,86,14,8,22,15,35,24,11,12,93,106
2021,2,22100884,2/16/2022,1610612762,Utah Jazz,0,0,1610612747,Los Angeles Lakers,1,1,26,20,46,11,22,33,37,42,79,16,3,19,10,33,17,9,13,92,101
2021,2,22100022,10/22/2021,1610612740,New Orleans Pelicans,0,0,1610612741,Chicago Bulls,1,1,27,31,58,15,14,29,42,45,87,13,3,16,10,37,26,9,17,102,112
2021,2,22100022,10/22/2021,1610612741,Chicago Bulls,1,1,1610612740,New Orleans Pelicans,0,0,33,28,61,14,14,28,47,42,89,20,5,25,12,33,32,7,14,102,128
2020,2,22000526,2/28/2021,1610612750,Minnesota Timberwolves,1,0,1610612756,Phoenix Suns,0,1,27,31,58,8,27,35,35,58,93,21,3,24,17,42,21,7,16,105,99
2020,2,22000526,2/28/2021,1610612756,Phoenix Suns,0,1,1610612750,Minnesota Timberwolves,1,0,37,25,62,7,20,27,44,45,89,23,1,24,10,35,27,12,16,104,118
2016,2,21600452,12/23/2016,1610612761,Toronto Raptors,0,1,1610612762,Utah Jazz,1,0,35,25,60,8,13,21,43,38,81,10,5,15,6,34,12,7,10,92,104
2016,2,21600452,12/23/2016,1610612762,Utah Jazz,1,0,1610612761,Toronto Raptors,0,1,25,27,52,10,17,27,35,44,79,18,3,21,14,31,21,12,18,93,98
2021,2,22100021,10/22/2021,1610612751,Brooklyn Nets,0,1,1610612755,Philadelphia 76ers,1,0,29,21,50,12,26,38,41,47,88,20,4,24,16,31,26,8,13,97,114
2021,2,22100021,10/22/2021,1610612755,Philadelphia 76ers,1,0,1610612751,Brooklyn Nets,0,1,29,26,55,14,22,36,43,48,91,9,2,11,11,38,17,6,10,98,109
2014,2,21400349,12/14/2014,1610612741,Chicago Bulls,0,1,1610612748,Miami Heat,1,0,24,29,53,9,9,18,33,38,71,18,3,21,12,27,21,13,20,89,93
2014,2,21400349,12/14/2014,1610612748,Miami Heat,1,0,1610612741,Chicago Bulls,0,1,24,34,58,4,18,22,28,52,80,15,3,18,17,37,12,4,15,89,75
2021,2,22100883,2/16/2022,1610612743,Denver Nuggets,0,1,1610612744,Golden State Warriors,1,0,29,26,55,14,22,36,43,48,91,17,4,21,17,31,27,13,19,103,117
2022,2,22200387,12/10/2022,1610612748,Miami Heat,1,0,1610612759,San Antonio Spurs,0,1,26,21,47,13,21,34,39,42,81,20,8,28,8,39,26,8,10,93,111
2022,2,22200387,12/10/2022,1610612759,San Antonio Spurs,0,1,1610612748,Miami Heat,1,0,35,22,57,7,14,21,42,36,78,24,7,31,14,27,24,5,18,94,115
2021,2,22100883,2/16/2022,1610612744,Golden State Warriors,1,0,1610612743,Denver Nuggets,0,1,35,18,53,10,24,34,45,42,87,16,8,24,8,37,26,5,11,102,116
2021,2,22100020,10/22/2021,1610612738,Boston Celtics,1,0,1610612761,Toronto Raptors,0,1,21,27,48,11,23,34,32,50,82,8,3,11,12,40,19,16,25,101,83
2016,2,21600980,3/11/2017,1610612744,Golden State Warriors,0,0,1610612759,San Antonio Spurs,1,1,28,47,75,5,12,17,33,59,92,14,9,23,22,42,19,6,15,95,85
2016,2,21600980,3/11/2017,1610612759,San Antonio Spurs,1,1,1610612744,Golden State Warriors,0,0,28,22,50,12,15,27,40,37,77,15,3,18,10,29,27,10,20,97,107
2022,2,22200386,12/9/2022,1610612742,Dallas Mavericks,1,0,1610612749,Milwaukee Bucks,0,1,28,20,48,13,27,40,41,47,88,10,14,24,15,42,21,5,11,96,105
2022,2,22200386,12/9/2022,1610612749,Milwaukee Bucks,0,1,1610612742,Dallas Mavericks,1,0,27,28,55,11,21,32,38,49,87,19,4,23,17,34,27,8,17,96,106
2020,2,22000525,2/28/2021,1610612745,Houston Rockets,1,0,1610612763,Memphis Grizzlies,0,1,19,19,38,4,41,45,23,60,83,34,7,41,14,51,10,16,23,110,84
2020,2,22000525,2/28/2021,1610612763,Memphis Grizzlies,0,1,1610612745,Houston Rockets,1,0,40,24,64,10,20,30,50,44,94,23,5,28,16,30,27,7,18,110,133
2021,2,22100020,10/22/2021,1610612761,Toronto Raptors,0,1,1610612738,Boston Celtics,1,0,32,33,65,10,25,35,42,58,100,21,0,21,23,35,22,6,12,100,115
2017,2,21700721,1/26/2018,1610612742,Dallas Mavericks,1,0,1610612757,Portland Trail Blazers,0,1,25,34,59,10,20,30,35,54,89,13,4,17,11,45,17,4,5,92,93
2014,2,21401148,4/5/2015,1610612739,Cleveland Cavaliers,1,1,1610612741,Chicago Bulls,0,0,19,27,46,16,21,37,35,48,83,13,9,22,13,41,24,7,11,91,99
2014,2,21401148,4/5/2015,1610612741,Chicago Bulls,0,0,1610612739,Cleveland Cavaliers,1,1,23,26,49,11,16,27,34,42,76,15,6,21,10,34,28,9,16,91,94
2014,2,21400639,1/22/2015,1610612738,Boston Celtics,0,1,1610612757,Portland Trail Blazers,1,0,32,36,68,7,12,19,39,48,87,5,2,7,14,34,23,8,16,93,90
2019,2,21900007,10/23/2019,1610612748,Miami Heat,1,1,1610612763,Memphis Grizzlies,0,0,33,34,67,7,11,18,40,45,85,33,6,39,12,35,18,9,21,111,120
2019,2,21900007,10/23/2019,1610612763,Memphis Grizzlies,0,0,1610612748,Miami Heat,1,1,33,24,57,5,27,32,38,51,89,20,10,30,14,42,22,9,24,113,101
2020,2,22000794,4/10/2021,1610612739,Cleveland Cavaliers,1,0,1610612761,Toronto Raptors,0,1,24,27,51,15,20,35,39,47,86,22,4,26,11,36,27,12,17,103,115
2020,2,22000794,4/10/2021,1610612761,Toronto Raptors,0,1,1610612739,Cleveland Cavaliers,1,0,36,18,54,17,15,32,53,33,86,12,2,14,8,25,29,11,19,103,135
2022,2,22200385,12/9/2022,1610612750,Minnesota Timberwolves,0,1,1610612762,Utah Jazz,1,0,28,16,44,14,21,35,42,37,79,20,6,26,10,29,30,9,17,100,118
2022,2,22200385,12/9/2022,1610612762,Utah Jazz,1,0,1610612750,Minnesota Timberwolves,0,1,26,20,46,13,31,44,39,51,90,17,7,24,12,41,22,7,11,99,108
2021,2,22100882,2/16/2022,1610612745,Houston Rockets,0,0,1610612756,Phoenix Suns,1,1,29,24,53,13,31,44,42,55,97,24,4,28,20,37,23,10,16,106,121
2021,2,22100882,2/16/2022,1610612756,Phoenix Suns,1,1,1610612745,Houston Rockets,0,0,37,25,62,7,17,24,44,42,86,29,7,36,9,36,27,5,11,105,124
2017,2,21700721,1/26/2018,1610612757,Portland Trail Blazers,0,1,1610612742,Dallas Mavericks,1,0,29,20,49,10,20,30,39,40,79,19,4,23,12,30,20,9,15,91,107
2021,2,22100019,10/22/2021,1610612754,Indiana Pacers,0,0,1610612764,Washington Wizards,1,1,37,26,63,15,19,34,52,45,97,15,5,20,14,35,28,5,12,103,134
2021,2,22100019,10/22/2021,1610612764,Washington Wizards,1,1,1610612754,Indiana Pacers,0,0,30,26,56,19,19,38,49,45,94,18,1,19,8,37,24,5,9,103,135
2020,2,22000524,2/28/2021,1610612738,Boston Celtics,1,1,1610612764,Washington Wizards,0,0,32,27,59,10,20,30,42,47,89,17,7,24,19,31,25,10,19,103,111
2020,2,22000524,2/28/2021,1610612764,Washington Wizards,0,0,1610612738,Boston Celtics,1,1,29,23,52,9,23,32,38,46,84,25,4,29,9,38,16,7,14,102,110
2022,2,22200384,12/9/2022,1610612740,New Orleans Pelicans,1,1,1610612756,Phoenix Suns,0,0,38,25,63,8,19,27,46,44,90,28,7,35,17,31,27,6,11,99,128
2017,2,21700720,1/26/2018,1610612740,New Orleans Pelicans,1,1,1610612745,Houston Rockets,0,0,33,22,55,11,16,27,44,38,82,16,5,21,8,34,36,10,16,101,115
2017,2,21700720,1/26/2018,1610612745,Houston Rockets,0,0,1610612740,New Orleans Pelicans,1,1,24,18,42,12,24,36,36,42,78,29,6,35,5,41,22,8,13,101,113
2016,2,21600451,12/23/2016,1610612737,Atlanta Hawks,0,1,1610612743,Denver Nuggets,1,0,29,32,61,8,17,25,37,49,86,27,6,33,11,42,26,3,8,97,109
2022,2,22200384,12/9/2022,1610612756,Phoenix Suns,0,0,1610612740,New Orleans Pelicans,1,1,21,21,42,22,22,44,43,43,86,9,4,13,12,32,30,10,17,99,117
2021,2,22100881,2/16/2022,1610612759,San Antonio Spurs,0,1,1610612760,Oklahoma City Thunder,1,0,33,31,64,10,24,34,43,55,98,18,4,22,19,39,29,6,14,103,114
2021,2,22100881,2/16/2022,1610612760,Oklahoma City Thunder,1,0,1610612759,San Antonio Spurs,0,1,30,43,73,11,21,32,41,64,105,13,6,19,20,47,25,3,8,102,106
2021,2,22100018,10/22/2021,1610612752,New York Knicks,0,1,1610612753,Orlando Magic,1,0,20,14,34,24,30,54,44,44,88,9,8,17,10,40,34,5,11,98,121
2021,2,22100018,10/22/2021,1610612753,Orlando Magic,1,0,1610612752,New York Knicks,0,1,16,24,40,17,26,43,33,50,83,13,2,15,12,38,24,10,19,98,96
2020,2,22000523,4/8/2021,1610612741,Chicago Bulls,0,1,1610612761,Toronto Raptors,1,0,35,22,57,12,18,30,47,40,87,16,2,18,14,27,35,10,16,98,122
2023,2,22300698,2/3/2024,1610612751,Brooklyn Nets,0,1,1610612755,Philadelphia 76ers,1,0,29,15,44,20,31,51,49,46,95,18,5,23,16,34,35,7,12,103,136
2020,2,22000523,4/8/2021,1610612761,Toronto Raptors,1,0,1610612741,Chicago Bulls,0,1,31,32,63,11,23,34,42,55,97,18,4,22,18,39,19,5,10,98,113
2016,2,21600451,12/23/2016,1610612743,Denver Nuggets,1,0,1610612737,Atlanta Hawks,0,1,29,24,53,8,17,25,37,41,78,26,9,35,12,33,27,10,15,98,108
2016,2,21600062,11/2/2016,1610612742,Dallas Mavericks,0,0,1610612762,Utah Jazz,1,1,26,25,51,7,19,26,33,44,77,8,2,10,8,36,18,6,13,87,81
2014,2,21400639,1/22/2015,1610612757,Portland Trail Blazers,1,0,1610612738,Boston Celtics,0,1,24,37,61,9,19,28,33,56,89,14,5,19,15,43,16,8,11,93,89
2016,2,21600979,3/11/2017,1610612748,Miami Heat,1,1,1610612761,Toronto Raptors,0,0,24,20,44,11,17,28,35,37,72,23,10,33,9,32,21,6,12,89,104
2016,2,21600979,3/11/2017,1610612761,Toronto Raptors,0,0,1610612748,Miami Heat,1,1,31,42,73,2,13,15,33,55,88,21,4,25,22,35,7,8,13,91,89
2022,2,22200383,12/9/2022,1610612763,Memphis Grizzlies,1,1,1610612765,Detroit Pistons,0,0,35,24,59,9,23,32,44,47,91,17,15,32,17,40,30,6,14,105,114
2022,2,22200383,12/9/2022,1610612765,Detroit Pistons,0,0,1610612763,Memphis Grizzlies,1,1,25,30,55,11,24,35,36,54,90,20,7,27,17,39,23,11,19,105,103
2021,2,22100880,2/16/2022,1610612750,Minnesota Timberwolves,1,0,1610612761,Toronto Raptors,0,1,20,15,35,10,32,42,30,47,77,21,8,29,8,42,23,7,17,97,91
2021,2,22100880,2/16/2022,1610612761,Toronto Raptors,0,1,1610612750,Minnesota Timberwolves,1,0,32,31,63,8,17,25,40,48,88,15,4,19,13,38,21,6,13,98,103
2016,2,21600450,12/23/2016,1610612750,Minnesota Timberwolves,1,0,1610612758,Sacramento Kings,0,1,24,23,47,12,20,32,36,43,79,21,5,26,14,31,18,7,13,91,105
2016,2,21600450,12/23/2016,1610612758,Sacramento Kings,0,1,1610612750,Minnesota Timberwolves,1,0,27,24,51,15,14,29,42,38,80,10,4,14,8,31,27,5,11,89,109
2020,2,22000793,4/9/2021,1610612752,New York Knicks,1,1,1610612763,Memphis Grizzlies,0,0,31,33,64,14,18,32,45,51,96,29,4,33,16,36,24,7,14,108,133
2020,2,22000793,4/9/2021,1610612763,Memphis Grizzlies,0,0,1610612752,New York Knicks,1,1,33,31,64,14,16,30,47,47,94,21,13,34,15,39,33,7,14,110,129
2014,2,21400348,12/14/2014,1610612740,New Orleans Pelicans,1,0,1610612744,Golden State Warriors,0,1,39,35,74,8,19,27,47,54,101,20,5,25,14,42,22,7,14,113,122
2014,2,21400348,12/14/2014,1610612744,Golden State Warriors,0,1,1610612740,New Orleans Pelicans,1,0,33,29,62,11,13,24,44,42,86,29,6,35,10,35,22,14,20,113,128
2021,2,22100879,2/16/2022,1610612757,Portland Trail Blazers,0,1,1610612763,Memphis Grizzlies,1,0,30,23,53,13,19,32,43,42,85,24,8,32,16,29,23,10,12,98,123
2021,2,22100879,2/16/2022,1610612763,Memphis Grizzlies,1,0,1610612757,Portland Trail Blazers,0,1,26,29,55,11,19,30,37,48,85,34,8,42,18,33,20,6,10,98,119
2021,2,22100017,10/22/2021,1610612739,Cleveland Cavaliers,1,0,1610612766,Charlotte Hornets,0,1,34,19,53,9,22,31,43,41,84,17,3,20,8,35,26,13,19,104,112
2021,2,22100017,10/22/2021,1610612766,Charlotte Hornets,0,1,1610612739,Cleveland Cavaliers,1,0,35,24,59,13,19,32,48,43,91,14,3,17,13,31,32,9,18,104,123
2020,2,22000522,2/28/2021,1610612737,Atlanta Hawks,0,0,1610612748,Miami Heat,1,1,28,24,52,8,27,35,36,51,87,19,3,22,19,35,22,8,17,95,99
2020,2,22000522,2/28/2021,1610612748,Miami Heat,1,1,1610612737,Atlanta Hawks,0,0,28,21,49,11,26,37,39,47,86,20,2,22,15,33,27,12,14,95,109
2016,2,21600062,11/2/2016,1610612762,Utah Jazz,1,1,1610612742,Dallas Mavericks,0,0,23,29,52,12,13,25,35,42,77,15,11,26,13,35,18,4,12,88,97
2014,2,21400638,1/22/2015,1610612749,Milwaukee Bucks,1,0,1610612762,Utah Jazz,0,1,37,42,79,5,8,13,42,50,92,10,2,12,17,34,26,9,12,92,99
2014,2,21400638,1/22/2015,1610612762,Utah Jazz,0,1,1610612749,Milwaukee Bucks,1,0,18,22,40,14,17,31,32,39,71,23,5,28,16,25,25,11,22,93,101
2014,2,21401147,4/5/2015,1610612745,Houston Rockets,0,1,1610612760,Oklahoma City Thunder,1,0,30,23,53,8,20,28,38,43,81,31,19,50,14,37,18,4,10,102,115
2014,2,21401147,4/5/2015,1610612760,Oklahoma City Thunder,1,0,1610612745,Houston Rockets,0,1,26,36,62,14,16,30,40,52,92,18,8,26,22,33,21,14,18,102,112
2022,2,22200382,12/9/2022,1610612747,Los Angeles Lakers,0,0,1610612755,Philadelphia 76ers,1,1,33,24,57,11,20,31,44,44,88,23,7,30,11,37,29,14,21,111,122
2022,2,22200382,12/9/2022,1610612755,Philadelphia 76ers,1,1,1610612747,Los Angeles Lakers,0,0,30,20,50,18,22,40,48,42,90,19,3,22,12,31,30,12,23,112,133
2014,2,21400637,1/22/2015,1610612741,Chicago Bulls,1,1,1610612759,San Antonio Spurs,0,0,30,27,57,6,13,19,36,40,76,26,6,32,12,32,19,4,11,88,104
2014,2,21400637,1/22/2015,1610612759,San Antonio Spurs,0,0,1610612741,Chicago Bulls,1,1,24,36,60,6,15,21,30,51,81,15,3,18,13,39,17,7,12,89,81
2021,2,22100878,2/16/2022,1610612741,Chicago Bulls,1,1,1610612758,Sacramento Kings,0,0,35,30,65,12,17,29,47,47,94,19,1,20,16,31,25,9,13,100,125
2021,2,22100878,2/16/2022,1610612758,Sacramento Kings,0,0,1610612741,Chicago Bulls,1,1,31,23,54,12,18,30,43,41,84,20,2,22,7,35,24,8,13,101,118
2016,2,21600978,3/11/2017,1610612749,Milwaukee Bucks,1,1,1610612750,Minnesota Timberwolves,0,0,29,31,60,8,12,20,37,43,80,20,3,23,15,29,19,4,13,89,102
2016,2,21600978,3/11/2017,1610612750,Minnesota Timberwolves,0,0,1610612749,Milwaukee Bucks,1,1,32,36,68,5,8,13,37,44,81,16,5,21,13,34,21,5,13,91,95
2016,2,21600449,12/23/2016,1610612740,New Orleans Pelicans,1,1,1610612748,Miami Heat,0,0,22,39,61,11,17,28,33,56,89,14,7,21,12,48,17,4,10,97,91
2021,2,22100877,2/16/2022,1610612751,Brooklyn Nets,0,1,1610612752,New York Knicks,1,0,32,32,64,11,23,34,43,55,98,14,9,23,23,36,21,7,9,94,111
2014,2,21400347,12/13/2014,1610612758,Sacramento Kings,1,0,1610612765,Detroit Pistons,0,1,22,42,64,11,18,29,33,60,93,13,6,19,27,37,21,10,17,93,90
2014,2,21400347,12/13/2014,1610612765,Detroit Pistons,0,1,1610612758,Sacramento Kings,1,0,29,30,59,6,14,20,35,44,79,19,4,23,10,38,22,4,15,93,95
2021,2,22100877,2/16/2022,1610612752,New York Knicks,1,0,1610612751,Brooklyn Nets,0,1,21,21,42,16,27,43,37,48,85,16,2,18,11,38,22,5,10,94,106
2016,2,21600449,12/23/2016,1610612748,Miami Heat,0,0,1610612740,New Orleans Pelicans,1,1,28,39,67,8,12,20,36,51,87,7,6,13,14,41,19,9,17,97,87
2017,2,21700719,1/26/2018,1610612749,Milwaukee Bucks,1,1,1610612751,Brooklyn Nets,0,0,31,29,60,12,11,23,43,40,83,18,2,20,6,36,28,5,10,96,116
2017,2,21700719,1/26/2018,1610612751,Brooklyn Nets,0,0,1610612749,Milwaukee Bucks,1,1,25,30,55,8,26,34,33,56,89,17,3,20,15,43,18,9,14,97,91
2014,2,21400346,12/13/2014,1610612743,Denver Nuggets,0,0,1610612745,Houston Rockets,1,1,29,39,68,7,21,28,36,60,96,17,9,26,22,44,24,8,16,104,96
2014,2,21400346,12/13/2014,1610612745,Houston Rockets,1,1,1610612743,Denver Nuggets,0,0,29,25,54,10,24,34,39,49,88,20,14,34,17,39,20,7,15,103,108
2014,2,21401146,4/4/2015,1610612740,New Orleans Pelicans,0,0,1610612757,Portland Trail Blazers,1,1,32,37,69,7,9,16,39,46,85,5,5,10,13,35,18,4,9,87,90
2014,2,21401146,4/4/2015,1610612757,Portland Trail Blazers,1,1,1610612740,New Orleans Pelicans,0,0,30,38,68,6,10,16,36,48,84,21,2,23,21,29,17,8,11,87,99
2014,2,21400636,1/21/2015,1610612744,Golden State Warriors,1,1,1610612745,Houston Rockets,0,0,36,33,69,13,16,29,49,49,98,15,3,18,21,29,26,9,18,105,126
2022,2,22200381,12/9/2022,1610612739,Cleveland Cavaliers,1,0,1610612758,Sacramento Kings,0,1,24,25,49,10,20,30,34,45,79,17,5,22,14,33,20,11,20,97,95
2022,2,22200381,12/9/2022,1610612758,Sacramento Kings,0,1,1610612739,Cleveland Cavaliers,1,0,19,14,33,16,17,33,35,31,66,20,12,32,5,31,21,7,19,95,106
2014,2,21400636,1/21/2015,1610612745,Houston Rockets,0,0,1610612744,Golden State Warriors,1,1,24,31,55,13,19,32,37,50,87,26,5,31,18,33,23,13,20,104,113
2020,2,22000521,2/28/2021,1610612752,New York Knicks,0,1,1610612765,Detroit Pistons,1,0,31,29,60,13,13,26,44,42,86,8,2,10,8,35,23,8,12,94,109
2020,2,22000521,2/28/2021,1610612765,Detroit Pistons,1,0,1610612752,New York Knicks,0,1,19,21,40,9,23,32,28,44,72,25,6,31,9,38,16,9,16,95,90
2022,2,22200559,1/2/2023,1610612757,Portland Trail Blazers,1,1,1610612765,Detroit Pistons,0,0,34,19,53,14,17,31,48,36,84,25,10,35,7,38,29,8,18,108,135
2022,2,22200559,1/2/2023,1610612765,Detroit Pistons,0,0,1610612757,Portland Trail Blazers,1,1,28,36,64,6,12,18,34,48,82,32,9,41,12,39,16,16,21,109,106
2016,2,21600977,3/11/2017,1610612739,Cleveland Cavaliers,0,1,1610612753,Orlando Magic,1,0,28,19,47,15,24,39,43,43,86,15,10,25,10,39,30,6,9,96,116
2016,2,21600977,3/11/2017,1610612753,Orlando Magic,1,0,1610612739,Cleveland Cavaliers,0,1,34,41,75,4,17,21,38,58,96,24,4,28,17,45,17,1,5,98,104
2018,2,21801111,3/26/2019,1610612745,Houston Rockets,0,0,1610612749,Milwaukee Bucks,1,1,20,27,47,16,36,52,36,63,99,6,1,7,12,52,17,10,13,102,94
2018,2,21801111,3/26/2019,1610612749,Milwaukee Bucks,1,1,1610612745,Houston Rockets,0,0,28,32,60,14,20,34,42,52,94,10,3,13,15,38,24,7,16,103,108
2017,2,21700718,1/26/2018,1610612746,LA Clippers,0,1,1610612763,Memphis Grizzlies,1,0,29,24,53,10,17,27,39,41,80,21,8,29,6,39,23,1,10,99,109
2017,2,21700718,1/26/2018,1610612763,Memphis Grizzlies,1,0,1610612746,LA Clippers,0,1,31,23,54,8,19,27,39,42,81,14,4,18,10,34,31,15,20,99,100
2022,2,22200380,12/9/2022,1610612737,Atlanta Hawks,0,0,1610612751,Brooklyn Nets,1,1,36,28,64,10,19,29,46,47,93,14,2,16,16,31,21,10,18,103,116
2022,2,22200380,12/9/2022,1610612751,Brooklyn Nets,1,1,1610612737,Atlanta Hawks,0,0,32,21,53,13,17,30,45,38,83,17,4,21,12,27,30,12,21,102,120
2014,2,21400345,12/13/2014,1610612755,Philadelphia 76ers,1,0,1610612763,Memphis Grizzlies,0,1,29,25,54,11,17,28,40,42,82,24,10,34,13,36,22,9,17,105,115
2014,2,21400345,12/13/2014,1610612763,Memphis Grizzlies,0,1,1610612755,Philadelphia 76ers,1,0,34,33,67,11,15,26,45,48,93,19,8,27,14,38,33,11,15,104,120
2016,2,21600448,12/23/2016,1610612745,Houston Rockets,0,0,1610612763,Memphis Grizzlies,1,1,18,19,37,20,32,52,38,51,89,13,2,15,19,32,27,8,14,94,109
2016,2,21600448,12/23/2016,1610612763,Memphis Grizzlies,1,1,1610612745,Houston Rockets,0,0,28,28,56,13,12,25,41,40,81,20,5,25,12,31,23,5,12,92,115
2016,2,21600061,11/2/2016,1610612738,Boston Celtics,1,1,1610612741,Chicago Bulls,0,0,27,28,55,14,18,32,41,46,87,11,6,17,12,37,28,7,12,96,107
2016,2,21600061,11/2/2016,1610612741,Chicago Bulls,0,0,1610612738,Boston Celtics,1,1,28,33,61,7,13,20,35,46,81,23,8,31,18,31,21,10,19,97,100
2022,2,22200379,12/9/2022,1610612753,Orlando Magic,1,1,1610612761,Toronto Raptors,0,0,32,13,45,10,16,26,42,29,71,19,2,21,4,26,24,10,20,97,113
2022,2,22200379,12/9/2022,1610612761,Toronto Raptors,0,0,1610612753,Orlando Magic,1,1,26,24,50,10,25,35,36,49,85,27,6,33,11,40,23,3,7,99,109
2014,2,21400344,12/13/2014,1610612746,LA Clippers,0,0,1610612749,Milwaukee Bucks,1,1,25,37,62,14,15,29,39,52,91,14,5,19,17,37,24,3,13,98,106
2014,2,21400344,12/13/2014,1610612749,Milwaukee Bucks,1,1,1610612746,LA Clippers,0,0,36,29,65,7,4,11,43,33,76,18,6,24,8,28,25,8,16,97,111
2017,2,21700717,1/26/2018,1610612741,Chicago Bulls,1,0,1610612747,Los Angeles Lakers,0,1,18,39,57,17,19,36,35,58,93,16,8,24,21,41,21,6,14,100,103
2017,2,21700717,1/26/2018,1610612747,Los Angeles Lakers,0,1,1610612741,Chicago Bulls,1,0,36,31,67,5,19,24,41,50,91,21,7,28,12,42,23,3,9,99,108
2021,2,22100876,2/16/2022,1610612754,Indiana Pacers,1,1,1610612764,Washington Wizards,0,0,41,22,63,4,16,20,45,38,83,19,10,29,10,35,30,7,10,98,113
2021,2,22100876,2/16/2022,1610612764,Washington Wizards,0,0,1610612754,Indiana Pacers,1,1,22,32,54,17,20,37,39,52,91,13,3,16,15,38,25,9,14,97,108
2021,2,22100016,10/21/2021,1610612744,Golden State Warriors,1,1,1610612746,LA Clippers,0,0,28,24,52,15,16,31,43,40,83,14,8,22,12,32,27,9,21,102,115
2021,2,22100016,10/21/2021,1610612746,LA Clippers,0,0,1610612744,Golden State Warriors,1,1,28,28,56,14,26,40,42,54,96,15,6,21,12,46,24,5,7,104,113
2016,2,21600447,12/23/2016,1610612749,Milwaukee Bucks,1,1,1610612764,Washington Wizards,0,0,36,19,55,9,16,25,45,35,80,24,3,27,11,26,29,2,12,95,123
2016,2,21600447,12/23/2016,1610612764,Washington Wizards,0,0,1610612749,Milwaukee Bucks,1,1,30,25,55,7,17,24,37,42,79,15,3,18,8,35,24,8,15,96,96
2020,2,22000792,4/9/2021,1610612738,Boston Celtics,1,1,1610612750,Minnesota Timberwolves,0,0,28,17,45,19,23,42,47,40,87,32,2,34,11,29,32,14,21,113,145
2020,2,22000792,4/9/2021,1610612750,Minnesota Timberwolves,0,0,1610612738,Boston Celtics,1,1,32,22,54,15,27,42,47,49,96,27,3,30,14,37,30,9,15,114,136
2016,2,21600976,3/11/2017,1610612740,New Orleans Pelicans,0,1,1610612766,Charlotte Hornets,1,0,36,29,65,14,20,34,50,49,99,11,5,16,11,40,33,5,10,105,125
2016,2,21600976,3/11/2017,1610612766,Charlotte Hornets,1,0,1610612740,New Orleans Pelicans,0,1,33,23,56,13,33,46,46,56,102,17,3,20,17,40,32,4,10,106,122
2014,2,21400343,12/13/2014,1610612737,Atlanta Hawks,0,0,1610612753,Orlando Magic,1,1,27,30,57,8,19,27,35,49,84,21,3,24,16,34,24,6,11,91,99
2014,2,21400343,12/13/2014,1610612753,Orlando Magic,1,1,1610612737,Atlanta Hawks,0,0,27,26,53,10,11,21,37,37,74,16,5,21,8,33,26,4,15,91,100
2014,2,21400635,1/21/2015,1610612751,Brooklyn Nets,0,1,1610612758,Sacramento Kings,1,0,32,27,59,5,15,20,37,42,79,24,6,30,12,34,22,5,15,95,103
2022,2,22200485,12/23/2022,1610612741,Chicago Bulls,0,1,1610612752,New York Knicks,1,0,31,31,62,14,17,31,45,48,93,14,4,18,13,38,24,2,4,92,118
2022,2,22200485,12/23/2022,1610612752,New York Knicks,1,0,1610612741,Chicago Bulls,0,1,27,24,51,16,19,35,43,43,86,15,11,26,17,33,23,6,10,92,117
2014,2,21400635,1/21/2015,1610612758,Sacramento Kings,1,0,1610612751,Brooklyn Nets,0,1,34,32,66,5,13,18,39,45,84,17,7,24,13,35,22,7,14,95,100
2022,2,22200377,12/9/2022,1610612752,New York Knicks,0,1,1610612766,Charlotte Hornets,1,0,28,31,59,13,21,34,41,52,93,26,4,30,23,33,25,8,14,97,121
2022,2,22200377,12/9/2022,1610612766,Charlotte Hornets,1,0,1610612752,New York Knicks,0,1,31,27,58,6,20,26,37,47,84,22,6,28,14,36,16,6,13,96,102
2014,2,21400342,12/13/2014,1610612754,Indiana Pacers,1,0,1610612757,Portland Trail Blazers,0,1,28,39,67,4,10,14,32,49,81,10,3,13,16,35,14,9,13,85,78
2021,2,22100875,2/16/2022,1610612738,Boston Celtics,1,0,1610612765,Detroit Pistons,0,1,29,16,45,13,19,32,42,35,77,14,4,18,5,30,29,9,17,98,111
2021,2,22100875,2/16/2022,1610612765,Detroit Pistons,0,1,1610612738,Boston Celtics,1,0,27,36,63,16,14,30,43,50,93,10,3,13,19,32,28,8,17,98,112
2021,2,22100015,10/21/2021,1610612748,Miami Heat,1,1,1610612749,Milwaukee Bucks,0,0,36,25,61,15,20,35,51,45,96,20,11,31,16,37,28,6,11,105,137
2014,2,21400342,12/13/2014,1610612757,Portland Trail Blazers,0,1,1610612754,Indiana Pacers,1,0,33,35,68,4,11,15,37,46,83,8,2,10,13,35,19,9,13,84,86
2014,2,21401145,4/4/2015,1610612756,Phoenix Suns,1,1,1610612762,Utah Jazz,0,0,25,30,55,5,9,14,30,39,69,22,7,29,8,36,12,10,16,90,87
2022,2,22200376,12/8/2022,1610612743,Denver Nuggets,0,1,1610612757,Portland Trail Blazers,1,0,35,26,61,12,18,30,47,44,91,15,7,22,18,29,28,10,16,95,121
2022,2,22200376,12/8/2022,1610612757,Portland Trail Blazers,1,0,1610612743,Denver Nuggets,0,1,28,23,51,16,24,40,44,47,91,16,0,16,15,32,30,6,13,96,120
2020,2,22000519,2/27/2021,1610612742,Dallas Mavericks,0,1,1610612751,Brooklyn Nets,1,0,31,19,50,14,22,36,45,41,86,11,6,17,7,36,23,5,9,94,115
2022,2,22200576,1/5/2023,1610612753,Orlando Magic,1,0,1610612763,Memphis Grizzlies,0,1,28,20,48,11,25,36,39,45,84,26,4,30,9,40,23,5,11,99,115
2020,2,22000519,2/27/2021,1610612751,Brooklyn Nets,1,0,1610612742,Dallas Mavericks,0,1,21,21,42,14,30,44,35,51,86,14,5,19,20,34,21,12,19,95,98
2021,2,22100015,10/21/2021,1610612749,Milwaukee Bucks,0,0,1610612748,Miami Heat,1,1,20,22,42,12,30,42,32,52,84,19,10,29,6,50,19,8,15,105,95
2016,2,21600446,12/23/2016,1610612744,Golden State Warriors,0,1,1610612765,Detroit Pistons,1,0,32,18,50,11,16,27,43,34,77,22,2,24,4,32,35,12,23,106,119
2016,2,21600446,12/23/2016,1610612765,Detroit Pistons,1,0,1610612744,Golden State Warriors,0,1,33,23,56,10,19,29,43,42,85,17,11,28,9,40,22,9,14,107,113
2022,2,22200576,1/5/2023,1610612763,Memphis Grizzlies,0,1,1610612753,Orlando Magic,1,0,36,20,56,12,24,36,48,44,92,15,8,23,14,34,24,6,13,101,123
2020,2,22000791,4/9/2021,1610612737,Atlanta Hawks,1,1,1610612741,Chicago Bulls,0,0,40,17,57,7,20,27,47,37,84,19,4,23,7,31,25,6,9,97,120
2020,2,22000791,4/9/2021,1610612741,Chicago Bulls,0,0,1610612737,Atlanta Hawks,1,1,28,25,53,13,20,33,41,45,86,13,1,14,9,36,25,7,13,98,108
2021,2,22100874,2/16/2022,1610612737,Atlanta Hawks,0,1,1610612753,Orlando Magic,1,0,27,30,57,18,15,33,45,45,90,22,6,28,15,33,23,3,11,99,130
2021,2,22100874,2/16/2022,1610612753,Orlando Magic,1,0,1610612737,Atlanta Hawks,0,1,29,28,57,13,28,41,42,56,98,12,1,13,17,40,23,7,13,101,109
2021,2,22100014,10/21/2021,1610612737,Atlanta Hawks,1,1,1610612742,Dallas Mavericks,0,0,30,29,59,15,20,35,45,49,94,8,1,9,8,42,31,7,13,102,113
2021,2,22100014,10/21/2021,1610612742,Dallas Mavericks,0,0,1610612737,Atlanta Hawks,1,1,18,32,50,13,30,43,31,62,93,12,1,13,12,51,16,8,15,104,87
2014,2,21401145,4/4/2015,1610612762,Utah Jazz,0,0,1610612756,Phoenix Suns,1,1,22,31,53,7,14,21,29,45,74,20,4,24,15,32,17,11,18,90,85
2014,2,21400634,1/21/2015,1610612756,Phoenix Suns,1,1,1610612757,Portland Trail Blazers,0,0,38,27,65,9,18,27,47,45,92,15,9,24,14,38,24,8,13,103,118
2014,2,21400634,1/21/2015,1610612757,Portland Trail Blazers,0,0,1610612756,Phoenix Suns,1,1,26,29,55,13,19,32,39,48,87,22,6,28,14,39,21,11,15,103,113
2020,2,22000518,2/27/2021,1610612743,Denver Nuggets,0,1,1610612760,Oklahoma City Thunder,1,0,34,24,58,15,16,31,49,40,89,13,3,16,10,32,30,7,13,100,126
2020,2,22000518,2/27/2021,1610612760,Oklahoma City Thunder,1,0,1610612743,Denver Nuggets,0,1,26,15,41,11,36,47,37,51,88,11,4,15,10,44,24,6,14,101,96
2016,2,21600060,11/2/2016,1610612740,New Orleans Pelicans,0,0,1610612763,Memphis Grizzlies,1,1,19,28,47,11,23,34,30,51,81,12,4,16,10,42,17,12,22,102,83
2019,2,21900224,11/22/2019,1610612745,Houston Rockets,0,0,1610612746,LA Clippers,1,1,24,17,41,15,28,43,39,45,84,26,12,38,11,41,22,9,15,105,119
2016,2,21600060,11/2/2016,1610612763,Memphis Grizzlies,1,1,1610612740,New Orleans Pelicans,0,0,25,42,67,8,19,27,33,61,94,15,5,20,24,40,20,8,20,101,89
2020,2,22000790,4/9/2021,1610612753,Orlando Magic,1,0,1610612754,Indiana Pacers,0,1,32,34,66,6,18,24,38,52,90,24,7,31,15,40,23,8,15,103,106
2020,2,22000790,4/9/2021,1610612754,Indiana Pacers,0,1,1610612753,Orlando Magic,1,0,27,32,59,11,22,33,38,54,92,24,4,28,14,40,26,3,14,104,111
2014,2,21400341,12/13/2014,1610612751,Brooklyn Nets,0,1,1610612766,Charlotte Hornets,1,0,26,23,49,16,7,23,42,30,72,14,6,20,7,27,29,3,14,86,114
2017,2,21700716,1/26/2018,1610612761,Toronto Raptors,1,0,1610612762,Utah Jazz,0,1,30,38,68,7,20,27,37,58,95,12,5,17,19,40,23,7,11,93,93
2017,2,21700716,1/26/2018,1610612762,Utah Jazz,0,1,1610612761,Toronto Raptors,1,0,26,40,66,10,11,21,36,51,87,15,6,21,18,36,20,10,13,94,97
2014,2,21400633,1/21/2015,1610612760,Oklahoma City Thunder,0,1,1610612764,Washington Wizards,1,0,34,39,73,6,23,29,40,62,102,19,4,23,15,50,21,8,10,107,105
2014,2,21400633,1/21/2015,1610612764,Washington Wizards,1,0,1610612760,Oklahoma City Thunder,0,1,31,39,70,7,23,30,38,62,100,20,6,26,18,47,23,5,12,109,103
2022,2,22200375,12/8/2022,1610612745,Houston Rockets,0,0,1610612759,San Antonio Spurs,1,1,34,35,69,10,19,29,44,54,98,11,4,15,21,36,23,5,14,100,109
2022,2,22200375,12/8/2022,1610612759,San Antonio Spurs,1,1,1610612745,Houston Rockets,0,0,33,14,47,13,23,36,46,37,83,13,2,15,9,29,25,3,17,98,118
2020,2,22000517,2/27/2021,1610612750,Minnesota Timberwolves,0,0,1610612764,Washington Wizards,1,1,30,30,60,11,24,35,41,54,95,19,10,29,14,47,23,6,18,113,112
2016,2,21600975,3/11/2017,1610612752,New York Knicks,0,0,1610612765,Detroit Pistons,1,1,23,29,52,13,17,30,36,46,82,7,4,11,9,39,26,14,18,96,92
2014,2,21400341,12/13/2014,1610612766,Charlotte Hornets,1,0,1610612751,Brooklyn Nets,0,1,23,34,57,8,14,22,31,48,79,17,10,27,13,42,16,4,6,86,87
2016,2,21600975,3/11/2017,1610612765,Detroit Pistons,1,1,1610612752,New York Knicks,0,0,37,32,69,9,18,27,46,50,96,11,8,19,16,40,27,4,7,96,112
2021,2,22100013,10/20/2021,1610612757,Portland Trail Blazers,1,0,1610612758,Sacramento Kings,0,1,33,25,58,12,23,35,45,48,93,19,3,22,12,37,25,6,13,106,121
2021,2,22100013,10/20/2021,1610612758,Sacramento Kings,0,1,1610612757,Portland Trail Blazers,1,0,25,26,51,17,24,41,42,50,92,23,6,29,11,43,24,5,10,105,124
2021,2,22100873,2/15/2022,1610612746,LA Clippers,0,0,1610612756,Phoenix Suns,1,1,30,32,62,10,25,35,40,57,97,6,3,9,18,41,26,9,14,98,96
2017,2,21700715,1/26/2018,1610612739,Cleveland Cavaliers,1,1,1610612754,Indiana Pacers,0,0,33,12,45,13,24,37,46,36,82,10,3,13,9,30,27,13,21,100,115
2017,2,21700715,1/26/2018,1610612754,Indiana Pacers,0,0,1610612739,Cleveland Cavaliers,1,1,30,30,60,13,18,31,43,48,91,9,2,11,11,38,27,13,16,101,108
2014,2,21400340,12/13/2014,1610612742,Dallas Mavericks,1,0,1610612744,Golden State Warriors,0,1,31,33,64,5,20,25,36,53,89,21,9,30,20,38,14,7,15,99,98
2021,2,22100873,2/15/2022,1610612756,Phoenix Suns,1,1,1610612746,LA Clippers,0,0,36,29,65,8,17,25,44,46,90,7,3,10,14,34,30,11,17,98,103
2021,2,22100012,10/20/2021,1610612743,Denver Nuggets,0,1,1610612756,Phoenix Suns,1,0,27,17,44,17,22,39,44,39,83,5,4,9,7,34,25,9,19,101,110
2021,2,22100012,10/20/2021,1610612756,Phoenix Suns,1,0,1610612743,Denver Nuggets,0,1,22,28,50,14,23,37,36,51,87,12,5,17,14,40,23,9,18,99,98
2020,2,22000517,2/27/2021,1610612764,Washington Wizards,1,1,1610612750,Minnesota Timberwolves,0,0,31,34,65,13,20,33,44,54,98,27,7,34,19,39,27,9,16,112,128
2016,2,21600445,12/23/2016,1610612738,Boston Celtics,1,0,1610612760,Oklahoma City Thunder,0,1,32,33,65,9,19,28,41,52,93,21,5,26,18,36,29,5,13,98,112
2016,2,21600445,12/23/2016,1610612760,Oklahoma City Thunder,0,1,1610612738,Boston Celtics,1,0,30,24,54,11,15,26,41,39,80,24,12,36,13,32,27,8,13,98,117
2019,2,21900224,11/22/2019,1610612746,LA Clippers,1,1,1610612745,Houston Rockets,0,0,32,22,54,13,20,33,45,42,87,19,5,24,11,33,27,11,19,106,122
2016,2,21600059,11/2/2016,1610612737,Atlanta Hawks,1,0,1610612747,Los Angeles Lakers,0,1,30,23,53,11,21,32,41,44,85,23,6,29,16,32,30,11,18,101,116
2016,2,21600059,11/2/2016,1610612747,Los Angeles Lakers,0,1,1610612737,Atlanta Hawks,1,0,39,29,68,9,13,22,48,42,90,18,2,20,13,30,24,10,15,101,123
2014,2,21400632,1/21/2015,1610612740,New Orleans Pelicans,1,1,1610612747,Los Angeles Lakers,0,0,35,32,67,3,13,16,38,45,83,17,4,21,14,33,21,12,15,92,96
2014,2,21400632,1/21/2015,1610612747,Los Angeles Lakers,0,0,1610612740,New Orleans Pelicans,1,1,22,35,57,6,14,20,28,49,77,18,3,21,12,38,16,8,18,92,80
2022,2,22200374,12/8/2022,1610612746,LA Clippers,0,0,1610612748,Miami Heat,1,1,20,24,44,17,19,36,37,43,80,19,2,21,9,36,24,11,16,96,110
2022,2,22200374,12/8/2022,1610612748,Miami Heat,1,1,1610612746,LA Clippers,0,0,34,24,58,12,20,32,46,44,90,11,3,14,8,37,24,3,8,95,115
2014,2,21400340,12/13/2014,1610612744,Golden State Warriors,0,1,1610612742,Dallas Mavericks,1,0,27,24,51,10,22,32,37,46,83,21,6,27,13,37,21,11,14,99,105
2021,2,22100872,2/15/2022,1610612740,New Orleans Pelicans,1,0,1610612763,Memphis Grizzlies,0,1,40,22,62,4,22,26,44,44,88,17,3,20,14,32,20,10,15,94,109
2021,2,22100872,2/15/2022,1610612763,Memphis Grizzlies,0,1,1610612740,New Orleans Pelicans,1,0,37,23,60,10,24,34,47,47,94,17,10,27,24,27,29,7,13,95,121
2021,2,22100011,10/20/2021,1610612760,Oklahoma City Thunder,0,0,1610612762,Utah Jazz,1,1,27,29,56,7,28,35,34,57,91,11,7,18,18,43,19,6,15,95,86
2021,2,22100011,10/20/2021,1610612762,Utah Jazz,1,1,1610612760,Oklahoma City Thunder,0,0,26,18,44,14,33,47,40,51,91,13,2,15,14,37,18,4,10,94,107
2020,2,22000516,2/27/2021,1610612753,Orlando Magic,1,0,1610612762,Utah Jazz,0,1,30,32,62,14,20,34,44,52,96,7,1,8,8,45,27,2,4,95,109
2020,2,22000516,2/27/2021,1610612762,Utah Jazz,0,1,1610612753,Orlando Magic,1,0,28,12,40,17,28,45,45,40,85,17,7,24,13,31,29,6,12,94,124
2014,2,21401144,4/4/2015,1610612743,Denver Nuggets,1,0,1610612746,LA Clippers,0,1,26,37,63,6,16,22,32,53,85,22,9,31,21,37,21,9,16,97,92
2014,2,21401144,4/4/2015,1610612746,LA Clippers,0,1,1610612743,Denver Nuggets,1,0,21,24,45,13,21,34,34,45,79,26,16,42,18,33,24,7,15,96,107
2019,2,21900223,11/22/2019,1610612744,Golden State Warriors,0,0,1610612762,Utah Jazz,1,1,31,35,66,12,16,28,43,51,94,11,1,12,9,42,28,4,9,100,109
2019,2,21900223,11/22/2019,1610612762,Utah Jazz,1,1,1610612744,Golden State Warriors,0,0,29,24,53,14,18,32,43,42,85,13,3,16,13,31,23,11,21,100,113
2021,2,22100871,2/15/2022,1610612750,Minnesota Timberwolves,1,1,1610612766,Charlotte Hornets,0,0,30,24,54,13,42,55,43,66,109,27,16,43,26,48,29,9,14,121,126
2021,2,22100871,2/15/2022,1610612766,Charlotte Hornets,0,0,1610612750,Minnesota Timberwolves,1,1,34,35,69,8,25,33,42,60,102,28,9,37,17,46,31,10,14,119,120
2014,2,21400339,12/12/2014,1610612747,Los Angeles Lakers,0,1,1610612759,San Antonio Spurs,1,0,32,40,72,12,12,24,44,52,96,12,3,15,17,36,27,10,15,101,112
2014,2,21400339,12/12/2014,1610612759,San Antonio Spurs,1,0,1610612747,Los Angeles Lakers,0,1,30,29,59,12,19,31,42,48,90,14,7,21,16,35,23,11,19,104,110
2021,2,22100010,10/20/2021,1610612753,Orlando Magic,0,0,1610612759,San Antonio Spurs,1,1,26,31,57,9,20,29,35,51,86,18,5,23,18,35,17,8,16,95,97
2021,2,22100010,10/20/2021,1610612759,San Antonio Spurs,1,1,1610612753,Orlando Magic,0,0,36,32,68,13,17,30,49,49,98,12,6,18,20,32,32,6,8,95,123
2016,2,21600444,12/23/2016,1610612739,Cleveland Cavaliers,1,1,1610612751,Brooklyn Nets,0,0,37,27,64,8,27,35,45,54,99,21,3,24,16,38,28,6,11,104,119
2016,2,21600444,12/23/2016,1610612751,Brooklyn Nets,0,0,1610612739,Cleveland Cavaliers,1,1,30,25,55,8,22,30,38,47,85,15,3,18,8,41,22,12,19,106,99
2020,2,22000789,4/8/2021,1610612758,Sacramento Kings,1,0,1610612765,Detroit Pistons,0,1,31,25,56,7,23,30,38,48,86,18,8,26,10,40,20,7,12,100,101
2020,2,22000789,4/8/2021,1610612765,Detroit Pistons,0,1,1610612758,Sacramento Kings,1,0,36,25,61,8,15,23,44,40,84,17,3,20,8,34,24,9,16,100,113
2019,2,21900006,10/23/2019,1610612750,Minnesota Timberwolves,0,1,1610612751,Brooklyn Nets,1,0,33,32,65,13,30,43,46,62,108,22,6,28,17,45,23,8,13,117,127
2019,2,21900006,10/23/2019,1610612751,Brooklyn Nets,1,0,1610612750,Minnesota Timberwolves,0,1,33,34,67,15,19,34,48,53,101,15,11,26,13,46,19,9,16,117,126
2017,2,21700714,1/26/2018,1610612737,Atlanta Hawks,0,0,1610612766,Charlotte Hornets,1,1,22,27,49,15,15,30,37,42,79,21,4,25,9,35,23,13,22,99,110
2017,2,21700714,1/26/2018,1610612766,Charlotte Hornets,1,1,1610612737,Atlanta Hawks,0,0,27,27,54,13,21,34,40,48,88,28,4,32,13,36,25,6,10,99,121
2016,2,21600974,3/11/2017,1610612746,LA Clippers,1,1,1610612755,Philadelphia 76ers,0,0,32,24,56,8,17,25,40,41,81,24,5,29,10,34,25,11,13,100,112
2016,2,21600974,3/11/2017,1610612755,Philadelphia 76ers,0,0,1610612746,LA Clippers,1,1,30,24,54,10,20,30,40,44,84,10,4,14,11,36,28,13,16,99,100
2014,2,21401143,4/4/2015,1610612749,Milwaukee Bucks,1,0,1610612753,Orlando Magic,0,1,34,39,73,5,11,16,39,50,89,7,6,13,17,36,26,7,13,87,90
2022,2,22200373,12/7/2022,1610612738,Boston Celtics,0,1,1610612756,Phoenix Suns,1,0,33,23,56,16,29,45,49,52,101,11,2,13,15,38,29,5,13,104,125
2022,2,22200373,12/7/2022,1610612756,Phoenix Suns,1,0,1610612738,Boston Celtics,0,1,29,32,61,8,24,32,37,56,93,16,3,19,16,42,19,14,18,105,98
2021,2,22100870,2/15/2022,1610612749,Milwaukee Bucks,1,1,1610612754,Indiana Pacers,0,0,38,19,57,10,19,29,48,38,86,22,8,30,10,32,28,8,15,102,128
2021,2,22100870,2/15/2022,1610612754,Indiana Pacers,0,0,1610612749,Milwaukee Bucks,1,1,30,22,52,17,24,41,47,46,93,8,11,19,12,40,32,7,12,102,119
2021,2,22100009,10/20/2021,1610612740,New Orleans Pelicans,1,0,1610612755,Philadelphia 76ers,0,1,26,37,63,13,17,30,39,54,93,6,3,9,13,42,28,9,14,97,97
2021,2,22100009,10/20/2021,1610612755,Philadelphia 76ers,0,1,1610612740,New Orleans Pelicans,1,0,31,29,60,13,12,25,44,41,85,16,4,20,9,35,24,5,13,98,117
2020,2,22000515,2/27/2021,1610612752,New York Knicks,1,1,1610612754,Indiana Pacers,0,0,28,29,57,12,12,24,40,41,81,18,4,22,10,32,26,5,21,102,110
2014,2,21401143,4/4/2015,1610612753,Orlando Magic,0,1,1610612749,Milwaukee Bucks,1,0,32,33,65,8,13,21,40,46,86,9,4,13,15,33,23,8,12,87,97
2014,2,21400631,1/21/2015,1610612742,Dallas Mavericks,0,1,1610612750,Minnesota Timberwolves,1,0,28,21,49,11,16,27,39,37,76,9,5,14,8,30,26,6,11,86,98
2014,2,21400631,1/21/2015,1610612750,Minnesota Timberwolves,1,0,1610612742,Dallas Mavericks,0,1,29,45,74,2,13,15,31,58,89,11,4,15,23,37,22,6,12,87,75
2020,2,22000788,4/8/2021,1610612746,LA Clippers,1,1,1610612756,Phoenix Suns,0,0,24,23,47,18,19,37,42,42,84,11,1,12,12,31,26,6,11,90,113
2020,2,22000788,4/8/2021,1610612756,Phoenix Suns,0,0,1610612746,LA Clippers,1,1,30,17,47,6,18,24,36,35,71,25,5,30,10,27,20,5,15,89,103
2022,2,22200633,1/13/2023,1610612737,Atlanta Hawks,0,1,1610612754,Indiana Pacers,1,0,25,36,61,16,17,33,41,53,94,15,6,21,20,35,26,8,14,97,113
2022,2,22200633,1/13/2023,1610612754,Indiana Pacers,1,0,1610612737,Atlanta Hawks,0,1,33,38,71,7,23,30,40,61,101,24,5,29,26,38,24,6,12,98,111
2021,2,22100869,2/15/2022,1610612738,Boston Celtics,0,1,1610612755,Philadelphia 76ers,1,0,21,16,37,25,20,45,46,36,82,18,4,22,10,29,28,7,11,92,135
2021,2,22100869,2/15/2022,1610612755,Philadelphia 76ers,1,0,1610612738,Boston Celtics,0,1,15,33,48,8,24,32,23,57,80,33,6,39,16,45,17,2,9,91,87
2020,2,22000515,2/27/2021,1610612754,Indiana Pacers,0,0,1610612752,New York Knicks,1,1,27,29,56,11,17,28,38,46,84,20,5,25,11,39,27,12,16,103,107
2016,2,21600973,3/11/2017,1610612760,Oklahoma City Thunder,1,1,1610612762,Utah Jazz,0,0,35,28,63,8,15,23,43,43,86,18,6,24,15,32,23,9,12,95,112
2016,2,21600973,3/11/2017,1610612762,Utah Jazz,0,0,1610612760,Oklahoma City Thunder,1,1,27,28,55,9,11,20,36,39,75,23,5,28,7,34,15,7,13,93,104
2016,2,21600058,11/2/2016,1610612745,Houston Rockets,0,1,1610612752,New York Knicks,1,0,27,22,49,15,25,40,42,47,89,19,8,27,22,28,25,10,20,99,118
2016,2,21600058,11/2/2016,1610612752,New York Knicks,1,0,1610612745,Houston Rockets,0,1,29,36,65,8,12,20,37,48,85,17,8,25,13,39,18,12,16,100,99
2020,2,22000787,4/8/2021,1610612757,Portland Trail Blazers,0,0,1610612762,Utah Jazz,1,1,25,23,48,13,35,48,38,58,96,14,4,18,11,48,18,4,6,100,103
2020,2,22000787,4/8/2021,1610612762,Utah Jazz,1,1,1610612757,Portland Trail Blazers,0,0,31,22,53,12,30,42,43,52,95,24,3,27,17,35,21,3,7,100,122
2017,2,21700713,1/25/2018,1610612744,Golden State Warriors,1,1,1610612750,Minnesota Timberwolves,0,0,27,25,52,21,16,37,48,41,89,9,6,15,13,31,37,9,16,101,126
2014,2,21400338,12/12/2014,1610612748,Miami Heat,0,1,1610612762,Utah Jazz,1,0,29,23,52,7,13,20,36,36,72,21,10,31,11,32,19,4,9,86,100
2014,2,21400338,12/12/2014,1610612762,Utah Jazz,1,0,1610612748,Miami Heat,0,1,26,23,49,8,20,28,34,43,77,19,3,22,15,29,16,6,14,87,95
2022,2,22200371,12/7/2022,1610612740,New Orleans Pelicans,1,1,1610612765,Detroit Pistons,0,0,31,27,58,8,19,27,39,46,85,18,5,23,14,35,21,5,19,102,104
2017,2,21700713,1/25/2018,1610612750,Minnesota Timberwolves,0,0,1610612744,Golden State Warriors,1,1,40,41,81,6,14,20,46,55,101,15,3,18,19,38,25,9,10,101,113
2022,2,22200371,12/7/2022,1610612765,Detroit Pistons,0,0,1610612740,New Orleans Pelicans,1,1,20,28,48,15,27,42,35,55,90,13,3,16,13,44,17,8,13,103,98
2021,2,22100008,10/20/2021,1610612745,Houston Rockets,0,0,1610612750,Minnesota Timberwolves,1,1,29,26,55,11,22,33,40,48,88,15,7,22,16,35,21,18,24,108,106
2014,2,21400630,1/21/2015,1610612761,Toronto Raptors,0,0,1610612763,Memphis Grizzlies,1,1,22,35,57,5,23,28,27,58,85,27,5,32,25,36,14,6,14,89,86
2014,2,21400630,1/21/2015,1610612763,Memphis Grizzlies,1,1,1610612761,Toronto Raptors,0,0,33,34,67,1,6,7,34,40,74,23,6,29,14,29,15,6,13,89,92
2021,2,22100008,10/20/2021,1610612750,Minnesota Timberwolves,1,1,1610612745,Houston Rockets,0,0,26,23,49,16,22,38,42,45,87,24,7,31,14,34,26,13,18,107,124
2022,2,22200370,12/7/2022,1610612750,Minnesota Timberwolves,1,1,1610612754,Indiana Pacers,0,0,36,34,70,8,15,23,44,49,93,25,2,27,22,27,25,10,23,105,121
2022,2,22200370,12/7/2022,1610612754,Indiana Pacers,0,0,1610612750,Minnesota Timberwolves,1,1,20,19,39,19,23,42,39,42,81,18,6,24,7,38,22,15,19,104,115
2021,2,22100868,2/15/2022,1610612742,Dallas Mavericks,0,1,1610612748,Miami Heat,1,0,16,19,35,18,23,41,34,42,76,21,12,33,12,35,27,1,9,88,107
2021,2,22100868,2/15/2022,1610612748,Miami Heat,1,0,1610612742,Dallas Mavericks,0,1,28,29,57,7,20,27,35,49,84,22,5,27,21,28,19,5,12,89,99
2014,2,21400629,1/21/2015,1610612753,Orlando Magic,0,0,1610612765,Detroit Pistons,1,1,42,40,82,6,9,15,48,49,97,16,0,16,14,35,29,10,14,104,118
2014,2,21400629,1/21/2015,1610612765,Detroit Pistons,1,1,1610612753,Orlando Magic,0,0,39,31,70,10,14,24,49,45,94,20,4,24,16,31,35,9,15,104,128
2018,2,21800841,2/11/2019,1610612754,Indiana Pacers,1,1,1610612766,Charlotte Hornets,0,0,30,19,49,8,17,25,38,36,74,15,2,17,7,31,25,7,12,87,99
2018,2,21800841,2/11/2019,1610612766,Charlotte Hornets,0,0,1610612754,Indiana Pacers,1,1,22,28,50,7,33,40,29,61,90,25,8,33,25,39,15,3,7,88,90
2022,2,22200369,12/7/2022,1610612749,Milwaukee Bucks,1,1,1610612758,Sacramento Kings,0,0,32,31,63,14,19,33,46,50,96,20,4,24,20,33,34,2,7,94,126
2022,2,22200369,12/7/2022,1610612758,Sacramento Kings,0,0,1610612749,Milwaukee Bucks,1,1,31,22,53,12,26,38,43,48,91,15,1,16,10,39,19,3,8,95,113
2020,2,22000514,2/27/2021,1610612740,New Orleans Pelicans,0,0,1610612759,San Antonio Spurs,1,1,31,28,59,9,23,32,40,51,91,25,6,31,19,35,27,7,10,96,114
2020,2,22000514,2/27/2021,1610612759,San Antonio Spurs,1,1,1610612740,New Orleans Pelicans,0,0,29,25,54,12,20,32,41,45,86,23,5,28,11,36,24,3,9,95,117
2014,2,21401142,4/4/2015,1610612742,Dallas Mavericks,1,0,1610612744,Golden State Warriors,0,1,31,33,64,3,13,16,34,46,80,39,15,54,12,41,14,12,16,107,110
2014,2,21401142,4/4/2015,1610612744,Golden State Warriors,0,1,1610612742,Dallas Mavericks,1,0,29,30,59,14,22,36,43,52,95,23,9,32,19,36,28,6,14,108,123
2021,2,22100007,10/20/2021,1610612739,Cleveland Cavaliers,0,0,1610612763,Memphis Grizzlies,1,1,33,22,55,14,24,38,47,46,93,13,5,18,8,41,38,8,11,104,121
2021,2,22100007,10/20/2021,1610612763,Memphis Grizzlies,1,1,1610612739,Cleveland Cavaliers,0,0,39,28,67,14,19,33,53,47,100,12,0,12,16,31,28,6,12,102,132
2016,2,21600443,12/23/2016,1610612747,Los Angeles Lakers,0,0,1610612753,Orlando Magic,1,1,23,41,64,8,15,23,31,56,87,20,4,24,17,42,16,10,18,99,90
2016,2,21600443,12/23/2016,1610612753,Orlando Magic,1,1,1610612747,Los Angeles Lakers,0,0,34,28,62,11,16,27,45,44,89,8,6,14,12,35,25,8,14,98,109
2020,2,22000786,4/8/2021,1610612742,Dallas Mavericks,1,1,1610612749,Milwaukee Bucks,0,0,26,26,52,17,28,45,43,54,97,13,5,18,17,39,23,8,11,100,116
2020,2,22000786,4/8/2021,1610612749,Milwaukee Bucks,0,0,1610612742,Dallas Mavericks,1,1,26,41,67,12,21,33,38,62,100,13,3,16,17,45,16,6,9,100,101
2017,2,21700712,1/25/2018,1610612743,Denver Nuggets,1,1,1610612752,New York Knicks,0,0,34,18,52,14,14,28,48,32,80,20,4,24,3,32,36,9,13,99,130
2017,2,21700712,1/25/2018,1610612752,New York Knicks,0,0,1610612743,Denver Nuggets,1,1,37,24,61,8,13,21,45,37,82,20,4,24,5,34,32,3,10,99,118
2021,2,22100867,2/15/2022,1610612737,Atlanta Hawks,1,1,1610612739,Cleveland Cavaliers,0,0,29,18,47,14,19,33,43,37,80,24,3,27,12,26,25,8,11,93,124
2021,2,22100867,2/15/2022,1610612739,Cleveland Cavaliers,0,0,1610612737,Atlanta Hawks,1,1,29,18,47,16,25,41,45,43,88,10,2,12,14,29,30,9,13,92,116
2016,2,21600972,3/10/2017,1610612758,Sacramento Kings,1,0,1610612764,Washington Wizards,0,1,32,37,69,12,11,23,44,48,92,22,6,28,8,41,27,7,11,109,122
2016,2,21600972,3/10/2017,1610612764,Washington Wizards,0,1,1610612758,Sacramento Kings,1,0,43,35,78,9,17,26,52,52,104,17,2,19,19,33,29,5,11,110,130
2016,2,21600442,12/23/2016,1610612741,Chicago Bulls,0,0,1610612766,Charlotte Hornets,1,1,31,43,74,7,15,22,38,58,96,8,2,10,21,38,20,6,9,92,91
2016,2,21600442,12/23/2016,1610612766,Charlotte Hornets,1,1,1610612741,Chicago Bulls,0,0,32,34,66,5,13,18,37,47,84,24,4,28,15,36,25,5,10,91,103
2014,2,21400337,12/12/2014,1610612756,Phoenix Suns,1,0,1610612765,Detroit Pistons,0,1,29,23,52,10,21,31,39,44,83,15,4,19,11,35,16,11,17,97,103
2014,2,21400337,12/12/2014,1610612765,Detroit Pistons,0,1,1610612756,Phoenix Suns,1,0,36,33,69,4,11,15,40,44,84,21,6,27,18,28,17,11,18,98,105
2022,2,22200368,12/7/2022,1610612760,Oklahoma City Thunder,0,0,1610612763,Memphis Grizzlies,1,1,20,34,54,14,24,38,34,58,92,20,3,23,19,42,25,13,19,104,102
2022,2,22200368,12/7/2022,1610612763,Memphis Grizzlies,1,1,1610612760,Oklahoma City Thunder,0,0,34,22,56,14,24,38,48,46,94,13,3,16,13,35,32,9,17,104,123
2014,2,21400628,1/21/2015,1610612737,Atlanta Hawks,1,1,1610612754,Indiana Pacers,0,0,26,23,49,13,16,29,39,39,78,19,7,26,11,33,30,7,16,95,110
2014,2,21400628,1/21/2015,1610612754,Indiana Pacers,0,0,1610612737,Atlanta Hawks,1,1,26,27,53,5,20,25,31,47,78,24,2,26,12,36,22,12,18,96,91
2016,2,21600057,11/2/2016,1610612751,Brooklyn Nets,1,1,1610612765,Detroit Pistons,0,0,28,21,49,13,14,27,41,35,76,14,3,17,6,30,27,11,19,97,109
2016,2,21600057,11/2/2016,1610612765,Detroit Pistons,0,0,1610612751,Brooklyn Nets,1,1,28,35,63,9,16,25,37,51,88,18,3,21,13,40,21,10,13,97,101
2017,2,21700711,1/25/2018,1610612760,Oklahoma City Thunder,1,1,1610612764,Washington Wizards,0,0,36,24,60,9,18,27,45,42,87,22,7,29,17,28,18,10,14,99,121
2017,2,21700711,1/25/2018,1610612764,Washington Wizards,0,0,1610612760,Oklahoma City Thunder,1,1,26,25,51,16,19,35,42,44,86,12,4,16,17,29,25,16,23,100,112
2014,2,21400336,12/12/2014,1610612739,Cleveland Cavaliers,0,0,1610612740,New Orleans Pelicans,1,1,36,31,67,8,14,22,44,45,89,18,5,23,14,34,22,5,6,90,114
2014,2,21400336,12/12/2014,1610612740,New Orleans Pelicans,1,1,1610612739,Cleveland Cavaliers,0,0,32,19,51,12,16,28,44,35,79,19,6,25,9,31,21,6,8,90,119
2016,2,21600441,12/22/2016,1610612746,LA Clippers,1,1,1610612759,San Antonio Spurs,0,0,28,27,55,11,17,28,39,44,83,17,5,22,8,38,18,8,12,97,106
2016,2,21600441,12/22/2016,1610612759,San Antonio Spurs,0,0,1610612746,LA Clippers,1,1,31,42,73,6,13,19,37,55,92,21,4,25,19,38,19,8,13,98,101
2019,2,21900005,10/23/2019,1610612739,Cleveland Cavaliers,0,0,1610612753,Orlando Magic,1,1,24,30,54,9,25,34,33,55,88,10,5,15,13,45,20,12,16,98,85
2019,2,21900005,10/23/2019,1610612753,Orlando Magic,1,1,1610612739,Cleveland Cavaliers,0,0,28,28,56,9,21,30,37,49,86,11,8,19,9,45,24,8,13,98,94
2020,2,22000785,4/8/2021,1610612739,Cleveland Cavaliers,0,1,1610612760,Oklahoma City Thunder,1,0,35,22,57,13,24,37,48,46,94,20,4,24,12,35,35,5,7,99,129
2020,2,22000785,4/8/2021,1610612760,Oklahoma City Thunder,1,0,1610612739,Cleveland Cavaliers,0,1,27,30,57,13,19,32,40,49,89,9,4,13,12,40,28,8,18,100,102
2022,2,22200367,12/7/2022,1610612741,Chicago Bulls,1,1,1610612764,Washington Wizards,0,0,35,32,67,10,13,23,45,45,90,15,2,17,11,35,29,12,19,106,115
2022,2,22200367,12/7/2022,1610612764,Washington Wizards,0,0,1610612741,Chicago Bulls,1,1,32,21,53,9,22,31,41,43,84,20,9,29,10,36,22,11,18,106,111
2016,2,21600971,3/10/2017,1610612742,Dallas Mavericks,1,1,1610612751,Brooklyn Nets,0,0,19,26,45,14,19,33,33,45,78,25,3,28,14,32,16,9,16,95,105
2016,2,21600971,3/10/2017,1610612751,Brooklyn Nets,0,0,1610612742,Dallas Mavericks,1,1,25,22,47,9,22,31,34,44,78,19,4,23,5,42,23,5,12,94,96
2021,2,22100866,2/14/2022,1610612744,Golden State Warriors,0,0,1610612746,LA Clippers,1,1,23,22,45,16,25,41,39,47,86,10,3,13,10,38,23,6,14,97,104
2021,2,22100866,2/14/2022,1610612746,LA Clippers,1,1,1610612744,Golden State Warriors,0,0,33,18,51,15,19,34,48,37,85,8,7,15,8,33,25,7,12,96,119
2014,2,21400335,12/12/2014,1610612750,Minnesota Timberwolves,1,0,1610612760,Oklahoma City Thunder,0,1,35,36,71,1,6,7,36,42,78,19,10,29,11,36,21,11,16,96,92
2014,2,21400335,12/12/2014,1610612760,Oklahoma City Thunder,0,1,1610612750,Minnesota Timberwolves,1,0,39,25,64,6,18,24,45,43,88,15,5,20,21,24,23,11,19,95,111
2021,2,22100006,10/20/2021,1610612761,Toronto Raptors,1,0,1610612764,Washington Wizards,0,1,23,40,63,7,27,34,30,67,97,16,6,22,21,48,14,14,19,106,83
2021,2,22100006,10/20/2021,1610612764,Washington Wizards,0,1,1610612761,Toronto Raptors,1,0,31,23,54,5,22,27,36,45,81,21,5,26,9,36,20,10,22,105,98
2020,2,22000513,2/27/2021,1610612739,Cleveland Cavaliers,0,1,1610612755,Philadelphia 76ers,1,0,33,40,73,8,16,24,41,56,97,22,7,29,20,40,24,9,17,109,112
2020,2,22000513,2/27/2021,1610612755,Philadelphia 76ers,1,0,1610612739,Cleveland Cavaliers,0,1,28,27,55,10,18,28,38,45,83,23,12,35,12,39,25,12,19,109,109
2016,2,21600440,12/22/2016,1610612738,Boston Celtics,0,1,1610612754,Indiana Pacers,1,0,28,25,53,10,29,39,38,54,92,23,4,27,11,45,19,5,10,104,109
2016,2,21600440,12/22/2016,1610612754,Indiana Pacers,1,0,1610612738,Boston Celtics,0,1,28,31,59,7,16,23,35,47,82,25,4,29,11,38,20,10,19,103,102
2014,2,21400627,1/21/2015,1610612752,New York Knicks,0,1,1610612755,Philadelphia 76ers,1,0,30,41,71,7,13,20,37,54,91,17,3,20,22,34,26,7,12,91,98
2014,2,21400627,1/21/2015,1610612755,Philadelphia 76ers,1,0,1610612752,New York Knicks,0,1,21,35,56,8,15,23,29,50,79,25,7,32,18,36,20,6,14,92,91
2016,2,21600056,11/2/2016,1610612755,Philadelphia 76ers,0,0,1610612766,Charlotte Hornets,1,1,22,26,48,12,26,38,34,52,86,13,2,15,17,37,23,8,19,96,93
2016,2,21600056,11/2/2016,1610612766,Charlotte Hornets,1,1,1610612755,Philadelphia 76ers,0,0,26,19,45,13,21,34,39,40,79,18,8,26,12,31,25,8,15,96,109
2020,2,22000784,4/8/2021,1610612747,Los Angeles Lakers,0,0,1610612748,Miami Heat,1,1,23,21,44,12,23,35,35,44,79,22,3,25,15,30,26,12,22,99,104
2020,2,22000784,4/8/2021,1610612748,Miami Heat,1,1,1610612747,Los Angeles Lakers,0,0,24,22,46,10,15,25,34,37,71,32,8,40,11,31,22,9,21,98,110
2022,2,22200366,12/7/2022,1610612747,Los Angeles Lakers,0,0,1610612761,Toronto Raptors,1,1,30,24,54,7,26,33,37,50,87,32,3,35,12,39,16,10,15,107,113
2022,2,22200366,12/7/2022,1610612761,Toronto Raptors,1,1,1610612747,Los Angeles Lakers,0,0,35,28,63,12,31,43,47,59,106,20,4,24,23,39,25,6,11,106,126
2020,2,22000512,2/26/2021,1610612747,Los Angeles Lakers,1,1,1610612757,Portland Trail Blazers,0,0,30,31,61,7,20,27,37,51,88,21,7,28,18,37,25,5,10,92,102
2020,2,22000512,2/26/2021,1610612757,Portland Trail Blazers,0,0,1610612747,Los Angeles Lakers,1,1,21,25,46,11,26,37,32,51,83,18,2,20,14,38,19,9,16,93,93
2017,2,21700710,1/25/2018,1610612748,Miami Heat,1,0,1610612758,Sacramento Kings,0,1,19,29,48,12,22,34,31,51,82,14,4,18,16,37,19,3,17,93,88
2017,2,21700710,1/25/2018,1610612758,Sacramento Kings,0,1,1610612748,Miami Heat,1,0,33,36,69,5,7,12,38,43,81,8,6,14,8,39,17,8,13,93,89
2016,2,21600970,3/10/2017,1610612738,Boston Celtics,0,0,1610612743,Denver Nuggets,1,1,22,26,48,12,21,33,34,47,81,19,4,23,9,41,19,11,18,100,99
2016,2,21600970,3/10/2017,1610612743,Denver Nuggets,1,1,1610612738,Boston Celtics,0,0,33,21,54,12,19,31,45,40,85,17,5,22,14,29,24,11,19,101,119
2016,2,21600439,12/22/2016,1610612747,Los Angeles Lakers,0,0,1610612748,Miami Heat,1,1,26,26,52,14,24,38,40,50,90,13,2,15,13,38,18,7,14,98,107
2022,2,22200614,1/10/2023,1610612739,Cleveland Cavaliers,0,0,1610612762,Utah Jazz,1,1,32,21,53,10,27,37,42,48,90,20,4,24,9,41,18,3,5,97,114
2014,2,21400334,12/12/2014,1610612763,Memphis Grizzlies,1,1,1610612766,Charlotte Hornets,0,0,33,39,72,6,7,13,39,46,85,29,9,38,11,38,21,8,20,111,113
2014,2,21400334,12/12/2014,1610612766,Charlotte Hornets,0,0,1610612763,Memphis Grizzlies,1,1,35,46,81,6,11,17,41,57,98,19,8,27,14,44,16,7,15,111,107
2022,2,22200365,12/7/2022,1610612737,Atlanta Hawks,0,0,1610612752,New York Knicks,1,1,26,23,49,6,30,36,32,53,85,19,5,24,14,44,16,6,11,93,89
2016,2,21600439,12/22/2016,1610612748,Miami Heat,1,1,1610612747,Los Angeles Lakers,0,0,34,28,62,11,11,22,45,39,84,14,7,21,11,33,25,7,13,96,115
2022,2,22200365,12/7/2022,1610612752,New York Knicks,1,1,1610612737,Atlanta Hawks,0,0,20,27,47,17,19,36,37,46,83,22,2,24,16,32,26,4,14,92,113
2021,2,22100865,2/14/2022,1610612745,Houston Rockets,0,0,1610612762,Utah Jazz,1,1,23,23,46,12,25,37,35,48,83,19,9,28,12,42,23,6,12,97,101
2021,2,22100865,2/14/2022,1610612762,Utah Jazz,1,1,1610612745,Houston Rockets,0,0,31,18,49,18,22,40,49,40,89,19,3,22,18,24,34,5,13,96,135
2021,2,22100005,10/20/2021,1610612738,Boston Celtics,0,0,1610612752,New York Knicks,1,1,27,33,60,21,36,57,48,69,117,17,6,23,21,50,34,9,18,124,134
2021,2,22100005,10/20/2021,1610612752,New York Knicks,1,1,1610612738,Boston Celtics,0,0,34,26,60,17,28,45,51,54,105,19,8,27,16,41,27,13,19,123,138
2020,2,22000511,2/26/2021,1610612744,Golden State Warriors,1,1,1610612766,Charlotte Hornets,0,0,37,18,55,11,13,24,48,31,79,23,2,25,6,27,38,11,25,111,130
2020,2,22000511,2/26/2021,1610612766,Charlotte Hornets,0,0,1610612744,Golden State Warriors,1,1,24,24,48,17,24,41,41,48,89,22,10,32,16,36,27,10,21,110,121
2014,2,21401141,4/4/2015,1610612763,Memphis Grizzlies,1,0,1610612764,Washington Wizards,0,1,33,33,66,1,14,15,34,47,81,14,4,18,13,36,23,9,15,93,83
2014,2,21401141,4/4/2015,1610612764,Washington Wizards,0,1,1610612763,Memphis Grizzlies,1,0,30,27,57,8,14,22,38,41,79,8,2,10,8,34,24,2,17,92,92
2014,2,21400626,1/21/2015,1610612739,Cleveland Cavaliers,1,1,1610612762,Utah Jazz,0,0,37,20,57,5,19,24,42,39,81,17,8,25,17,28,24,9,14,91,106
2020,2,22000783,4/7/2021,1610612756,Phoenix Suns,1,1,1610612762,Utah Jazz,0,0,34,33,67,11,23,34,45,56,101,16,4,20,18,39,20,6,14,108,117
2020,2,22000783,4/7/2021,1610612762,Utah Jazz,0,0,1610612756,Phoenix Suns,1,1,35,24,59,11,33,44,46,57,103,10,5,15,12,48,14,7,13,109,113
2017,2,21700709,1/24/2018,1610612738,Boston Celtics,0,1,1610612746,LA Clippers,1,0,25,28,53,14,26,40,39,54,93,21,1,22,15,39,25,6,13,104,113
2022,2,22200364,12/7/2022,1610612751,Brooklyn Nets,1,1,1610612766,Charlotte Hornets,0,0,37,18,55,12,19,31,49,37,86,12,4,16,8,31,33,4,11,97,122
2017,2,21700709,1/24/2018,1610612746,LA Clippers,1,0,1610612738,Boston Celtics,0,1,30,28,58,5,16,21,35,44,79,27,12,39,14,37,26,10,19,103,102
2016,2,21600969,3/10/2017,1610612737,Atlanta Hawks,1,1,1610612761,Toronto Raptors,0,0,31,22,53,8,14,22,39,36,75,19,10,29,11,30,24,17,21,99,105
2016,2,21600969,3/10/2017,1610612761,Toronto Raptors,0,0,1610612737,Atlanta Hawks,1,1,33,34,67,4,21,25,37,55,92,21,6,27,19,39,19,8,12,100,99
2016,2,21600438,12/22/2016,1610612752,New York Knicks,1,1,1610612753,Orlando Magic,0,0,32,44,76,9,11,20,41,55,96,15,2,17,21,35,26,7,15,99,106
2016,2,21600438,12/22/2016,1610612753,Orlando Magic,0,0,1610612752,New York Knicks,1,1,34,29,63,5,22,27,39,51,90,12,4,16,14,38,21,9,16,100,95
2022,2,22200364,12/7/2022,1610612766,Charlotte Hornets,0,0,1610612751,Brooklyn Nets,1,1,37,27,64,10,14,24,47,41,88,12,11,23,12,34,25,3,11,96,116
2014,2,21400626,1/21/2015,1610612762,Utah Jazz,0,0,1610612739,Cleveland Cavaliers,1,1,27,35,62,8,14,22,35,49,84,14,4,18,21,30,24,15,20,91,92
2022,2,22200363,12/7/2022,1610612746,LA Clippers,0,0,1610612753,Orlando Magic,1,1,24,30,54,15,26,41,39,56,95,18,8,26,23,39,26,8,17,103,111
2022,2,22200363,12/7/2022,1610612753,Orlando Magic,1,1,1610612746,LA Clippers,0,0,32,35,67,8,20,28,40,55,95,28,3,31,19,38,20,3,13,103,116
2021,2,22100864,2/14/2022,1610612743,Denver Nuggets,1,1,1610612753,Orlando Magic,0,0,26,22,48,16,24,40,42,46,88,21,2,23,15,32,25,16,23,107,121
2016,2,21600968,3/10/2017,1610612744,Golden State Warriors,0,0,1610612750,Minnesota Timberwolves,1,1,34,30,64,7,17,24,41,47,88,13,4,17,15,33,25,6,12,93,102
2016,2,21600968,3/10/2017,1610612750,Minnesota Timberwolves,1,1,1610612744,Golden State Warriors,0,0,35,39,74,4,10,14,39,49,88,21,6,27,18,34,21,9,11,94,103
2021,2,22100864,2/14/2022,1610612753,Orlando Magic,0,0,1610612743,Denver Nuggets,1,1,29,23,52,11,28,39,40,51,91,20,3,23,11,41,24,7,15,107,111
2021,2,22100004,10/20/2021,1610612741,Chicago Bulls,0,1,1610612765,Detroit Pistons,1,0,30,33,63,7,16,23,37,49,86,13,2,15,13,37,18,7,17,97,94
2021,2,22100004,10/20/2021,1610612765,Detroit Pistons,1,0,1610612741,Chicago Bulls,0,1,30,32,62,6,22,28,36,54,90,10,3,13,15,42,17,8,17,98,88
2020,2,22000510,2/26/2021,1610612737,Atlanta Hawks,0,0,1610612760,Oklahoma City Thunder,1,1,31,26,57,12,28,40,43,54,97,11,6,17,21,36,21,6,11,95,109
2020,2,22000510,2/26/2021,1610612760,Oklahoma City Thunder,1,1,1610612737,Atlanta Hawks,0,0,30,16,46,16,26,42,46,42,88,10,6,16,10,36,31,6,10,95,118
2019,2,21900222,11/22/2019,1610612738,Boston Celtics,0,0,1610612743,Denver Nuggets,1,1,26,28,54,7,20,27,33,48,81,19,4,23,9,41,21,7,13,96,92
2014,2,21401140,4/4/2015,1610612738,Boston Celtics,0,1,1610612761,Toronto Raptors,1,0,39,32,71,8,18,26,47,50,97,15,7,22,17,39,26,7,15,107,117
2019,2,21900222,11/22/2019,1610612743,Denver Nuggets,1,1,1610612738,Boston Celtics,0,0,32,28,60,7,21,28,39,49,88,11,2,13,16,35,24,11,18,96,96
2014,2,21401140,4/4/2015,1610612761,Toronto Raptors,1,0,1610612738,Boston Celtics,0,1,34,26,60,6,17,23,40,43,83,30,8,38,12,33,15,10,16,104,116
2014,2,21400333,12/12/2014,1610612754,Indiana Pacers,0,0,1610612761,Toronto Raptors,1,1,25,33,58,8,14,22,33,47,80,20,3,23,12,37,24,2,12,92,94
2014,2,21400333,12/12/2014,1610612761,Toronto Raptors,1,1,1610612754,Indiana Pacers,0,0,28,37,65,10,16,26,38,53,91,20,2,22,20,34,21,4,10,92,106
2022,2,22200614,1/10/2023,1610612762,Utah Jazz,1,1,1610612739,Cleveland Cavaliers,0,0,28,23,51,10,26,36,38,49,87,30,7,37,20,32,21,7,16,98,116
2022,2,22200362,12/6/2022,1610612742,Dallas Mavericks,0,1,1610612743,Denver Nuggets,1,0,19,17,36,17,19,36,36,36,72,27,4,31,7,31,27,8,17,97,116
2022,2,22200362,12/6/2022,1610612743,Denver Nuggets,1,0,1610612742,Dallas Mavericks,0,1,27,19,46,13,19,32,40,38,78,22,6,28,10,32,30,10,17,98,115
2021,2,22100863,2/14/2022,1610612740,New Orleans Pelicans,1,1,1610612761,Toronto Raptors,0,0,29,13,42,16,19,35,45,32,77,14,2,16,5,27,36,7,14,93,120
2021,2,22100863,2/14/2022,1610612761,Toronto Raptors,0,0,1610612740,New Orleans Pelicans,1,1,21,40,61,8,26,34,29,66,95,24,7,31,26,45,8,4,8,93,90
2022,2,22200451,12/18/2022,1610612747,Los Angeles Lakers,1,1,1610612764,Washington Wizards,0,0,35,30,65,11,16,27,46,46,92,16,6,22,9,40,29,5,9,102,119
2022,2,22200451,12/18/2022,1610612764,Washington Wizards,0,0,1610612747,Los Angeles Lakers,1,1,34,22,56,10,29,39,44,51,95,19,5,24,14,40,24,4,10,102,117
2016,2,21600055,11/2/2016,1610612761,Toronto Raptors,0,1,1610612764,Washington Wizards,1,0,33,19,52,10,15,25,43,34,77,17,8,25,7,30,21,8,13,94,113
2016,2,21600055,11/2/2016,1610612764,Washington Wizards,1,0,1610612761,Toronto Raptors,0,1,39,23,62,3,7,10,42,30,72,16,8,24,7,28,21,16,21,96,103
2014,2,21400625,1/21/2015,1610612748,Miami Heat,0,0,1610612766,Charlotte Hornets,1,1,24,42,66,5,13,18,29,55,84,13,2,15,16,40,14,3,7,84,76
2014,2,21400625,1/21/2015,1610612766,Charlotte Hornets,1,1,1610612748,Miami Heat,0,0,23,38,61,4,15,19,27,53,80,20,10,30,26,31,19,7,14,83,78
2014,2,21400332,12/12/2014,1610612751,Brooklyn Nets,1,1,1610612755,Philadelphia 76ers,0,0,31,30,61,5,15,20,36,45,81,11,6,17,16,31,25,10,17,91,88
2014,2,21400332,12/12/2014,1610612755,Philadelphia 76ers,0,0,1610612751,Brooklyn Nets,1,1,11,30,41,11,17,28,22,47,69,15,5,20,12,36,18,16,24,91,70
2022,2,22200361,12/6/2022,1610612748,Miami Heat,1,0,1610612765,Detroit Pistons,0,1,23,22,45,10,22,32,33,44,77,20,6,26,11,35,21,8,15,93,96
2022,2,22200361,12/6/2022,1610612765,Detroit Pistons,0,1,1610612748,Miami Heat,1,0,24,22,46,19,22,41,43,44,87,11,4,15,12,34,27,7,13,95,116
2021,2,22100862,2/14/2022,1610612749,Milwaukee Bucks,1,0,1610612757,Portland Trail Blazers,0,1,25,23,48,13,28,41,38,51,89,18,6,24,9,46,18,8,13,105,107
2021,2,22100862,2/14/2022,1610612757,Portland Trail Blazers,0,1,1610612749,Milwaukee Bucks,1,0,27,29,56,18,25,43,45,54,99,14,5,19,16,40,30,8,14,105,122
2021,2,22101230,4/10/2022,1610612757,Portland Trail Blazers,1,0,1610612762,Utah Jazz,0,1,22,27,49,9,25,34,31,52,83,9,3,12,7,46,21,8,16,98,80
2021,2,22101230,4/10/2022,1610612762,Utah Jazz,0,1,1610612757,Portland Trail Blazers,1,0,28,18,46,9,27,36,37,45,82,28,10,38,21,29,23,11,17,97,111
2021,2,22100003,10/20/2021,1610612754,Indiana Pacers,0,0,1610612766,Charlotte Hornets,1,1,25,18,43,17,30,47,42,48,90,21,3,24,13,38,29,9,17,107,122
2021,2,22100003,10/20/2021,1610612766,Charlotte Hornets,1,1,1610612754,Indiana Pacers,0,0,33,43,76,13,18,31,46,61,107,18,9,27,22,44,29,2,8,106,123
2016,2,21600437,12/22/2016,1610612744,Golden State Warriors,0,1,1610612751,Brooklyn Nets,1,0,35,32,67,12,25,37,47,57,104,11,3,14,16,43,29,6,13,109,117
2016,2,21600437,12/22/2016,1610612751,Brooklyn Nets,1,0,1610612744,Golden State Warriors,0,1,25,26,51,13,22,35,38,48,86,12,4,16,10,41,22,19,26,109,101
2014,2,21400624,1/20/2015,1610612743,Denver Nuggets,1,0,1610612759,San Antonio Spurs,0,1,32,33,65,5,9,14,37,42,79,20,9,29,14,32,26,10,16,95,99
2014,2,21400624,1/20/2015,1610612759,San Antonio Spurs,0,1,1610612743,Denver Nuggets,1,0,27,30,57,11,16,27,38,46,84,22,5,27,17,31,27,7,16,95,109
2023,2,22300234,11/22/2023,1610612760,Oklahoma City Thunder,1,1,1610612741,Chicago Bulls,0,0,26,20,46,11,18,29,37,38,75,31,7,38,13,28,24,7,14,93,116
2021,2,22100861,2/14/2022,1610612741,Chicago Bulls,1,1,1610612759,San Antonio Spurs,0,0,36,28,64,10,14,24,46,42,88,18,3,21,13,31,25,9,16,102,120
2021,2,22100861,2/14/2022,1610612759,San Antonio Spurs,0,0,1610612741,Chicago Bulls,1,1,38,34,72,6,14,20,44,48,92,15,6,21,7,44,28,3,7,101,109
2017,2,21700708,1/24/2018,1610612750,Minnesota Timberwolves,0,0,1610612757,Portland Trail Blazers,1,1,39,29,68,6,10,16,45,39,84,18,4,22,9,31,20,4,9,94,114
2017,2,21700708,1/24/2018,1610612757,Portland Trail Blazers,1,1,1610612750,Minnesota Timberwolves,0,0,28,23,51,17,14,31,45,37,82,16,5,21,8,30,24,7,11,94,123
2016,2,21600436,12/21/2016,1610612742,Dallas Mavericks,0,1,1610612757,Portland Trail Blazers,1,0,28,24,52,7,24,31,35,48,83,19,4,23,14,35,14,6,11,91,96
2021,2,22100002,10/19/2021,1610612744,Golden State Warriors,0,1,1610612747,Los Angeles Lakers,1,0,27,27,54,14,25,39,41,52,93,25,5,30,13,41,30,7,17,112,121
2021,2,22100002,10/19/2021,1610612747,Los Angeles Lakers,1,0,1610612744,Golden State Warriors,0,1,30,23,53,15,27,42,45,50,95,9,10,19,10,43,21,9,18,112,114
2016,2,21600436,12/21/2016,1610612757,Portland Trail Blazers,1,0,1610612742,Dallas Mavericks,0,1,22,23,45,10,17,27,32,40,72,21,7,28,13,30,15,12,17,90,95
2016,2,21600054,11/1/2016,1610612744,Golden State Warriors,0,1,1610612757,Portland Trail Blazers,1,0,40,23,63,10,16,26,50,39,89,17,6,23,12,29,36,12,16,104,127
2017,2,21700707,1/24/2018,1610612759,San Antonio Spurs,0,1,1610612763,Memphis Grizzlies,1,0,28,30,58,10,14,24,38,44,82,22,3,25,12,35,29,7,14,95,108
2022,2,22200360,12/6/2022,1610612739,Cleveland Cavaliers,1,1,1610612747,Los Angeles Lakers,0,0,41,25,66,7,20,27,48,45,93,13,4,17,12,33,25,4,8,98,116
2022,2,22200360,12/6/2022,1610612747,Los Angeles Lakers,0,0,1610612739,Cleveland Cavaliers,1,1,32,21,53,6,30,36,38,51,89,20,4,24,17,37,16,11,16,98,102
2017,2,21700707,1/24/2018,1610612763,Memphis Grizzlies,1,0,1610612759,San Antonio Spurs,0,1,34,31,65,2,16,18,36,47,83,11,3,14,14,34,19,9,18,97,85
2016,2,21600967,3/10/2017,1610612749,Milwaukee Bucks,1,1,1610612754,Indiana Pacers,0,0,26,21,47,7,10,17,33,31,64,26,4,30,6,28,17,14,22,94,99
2016,2,21600967,3/10/2017,1610612754,Indiana Pacers,0,0,1610612749,Milwaukee Bucks,1,1,31,26,57,2,16,18,33,42,75,17,5,22,12,32,15,13,20,94,85
2014,2,21400331,12/12/2014,1610612738,Boston Celtics,1,0,1610612752,New York Knicks,0,1,30,33,63,7,15,22,37,48,85,14,4,18,20,29,28,13,18,91,95
2014,2,21400331,12/12/2014,1610612752,New York Knicks,0,1,1610612738,Boston Celtics,1,0,34,31,65,6,10,16,40,41,81,15,3,18,13,30,26,3,13,90,101
2016,2,21600054,11/1/2016,1610612757,Portland Trail Blazers,1,0,1610612744,Golden State Warriors,0,1,23,24,47,14,25,39,37,49,86,16,5,21,9,40,23,14,18,104,104
2022,2,22200610,1/9/2023,1610612753,Orlando Magic,0,0,1610612758,Sacramento Kings,1,1,27,19,46,14,30,44,41,49,90,15,5,20,12,39,24,4,13,102,111
2021,2,22101229,4/10/2022,1610612756,Phoenix Suns,1,0,1610612758,Sacramento Kings,0,1,28,28,56,14,33,47,42,61,103,11,4,15,23,40,27,9,11,99,109
2021,2,22101229,4/10/2022,1610612758,Sacramento Kings,0,1,1610612756,Phoenix Suns,1,0,26,24,50,14,12,26,40,36,76,22,8,30,7,32,26,9,15,99,116
2014,2,21400330,12/12/2014,1610612737,Atlanta Hawks,1,1,1610612753,Orlando Magic,0,0,20,29,49,9,20,29,29,49,78,20,7,27,12,40,24,3,12,93,87
2014,2,21400330,12/12/2014,1610612753,Orlando Magic,0,0,1610612737,Atlanta Hawks,1,1,21,30,51,9,17,26,30,47,77,12,4,16,12,37,14,12,19,92,81
2022,2,22200610,1/9/2023,1610612758,Sacramento Kings,1,1,1610612753,Orlando Magic,0,0,29,22,51,23,23,46,52,45,97,9,3,12,12,34,39,7,11,101,136
2022,2,22200618,1/11/2023,1610612750,Minnesota Timberwolves,0,0,1610612765,Detroit Pistons,1,1,27,28,55,16,17,33,43,45,88,16,5,21,17,32,22,10,19,100,118
2016,2,21600966,3/10/2017,1610612741,Chicago Bulls,1,0,1610612745,Houston Rockets,0,1,29,30,59,9,30,39,38,60,98,9,3,12,16,45,24,11,18,107,94
2016,2,21600966,3/10/2017,1610612745,Houston Rockets,0,1,1610612741,Chicago Bulls,1,0,22,20,42,15,32,47,37,52,89,26,6,32,13,42,26,9,17,106,115
2014,2,21401139,4/4/2015,1610612748,Miami Heat,0,0,1610612765,Detroit Pistons,1,1,32,25,57,5,15,20,37,40,77,19,7,26,13,29,19,6,14,90,98
2014,2,21401139,4/4/2015,1610612765,Detroit Pistons,1,1,1610612748,Miami Heat,0,0,24,23,47,12,14,26,36,37,73,15,8,23,10,30,20,6,16,90,99
2021,2,22100001,10/19/2021,1610612749,Milwaukee Bucks,1,1,1610612751,Brooklyn Nets,0,0,31,29,60,17,28,45,48,57,105,14,4,18,18,41,25,3,8,101,127
2021,2,22100001,10/19/2021,1610612751,Brooklyn Nets,0,0,1610612749,Milwaukee Bucks,1,1,20,32,52,17,15,32,37,47,84,13,10,23,9,42,19,8,13,101,104
2023,2,22300004,11/3/2023,1610612741,Chicago Bulls,1,0,1610612751,Brooklyn Nets,0,1,32,29,61,11,17,28,43,46,89,10,4,14,13,36,21,4,10,94,107
2020,2,22000782,4/7/2021,1610612743,Denver Nuggets,1,1,1610612759,San Antonio Spurs,0,0,32,33,65,8,18,26,40,51,91,18,6,24,20,35,26,11,19,101,106
2020,2,22000782,4/7/2021,1610612759,San Antonio Spurs,0,0,1610612743,Denver Nuggets,1,1,32,35,67,6,18,24,38,53,91,14,7,21,14,42,23,10,15,101,96
2022,2,22200359,12/5/2022,1610612744,Golden State Warriors,1,0,1610612754,Indiana Pacers,0,1,25,25,50,13,31,44,38,56,94,15,4,19,16,44,26,3,12,99,104
2022,2,22200359,12/5/2022,1610612754,Indiana Pacers,0,1,1610612744,Golden State Warriors,1,0,28,23,51,15,24,39,43,47,90,11,7,18,16,36,26,6,17,99,112
2022,2,22200609,1/9/2023,1610612743,Denver Nuggets,1,1,1610612747,Los Angeles Lakers,0,0,31,26,57,15,27,42,46,53,99,15,2,17,17,37,29,12,17,108,122
2021,2,22100860,2/14/2022,1610612752,New York Knicks,1,0,1610612760,Oklahoma City Thunder,0,1,30,28,58,15,35,50,45,63,108,18,4,22,23,42,28,9,14,109,123
2016,2,21600435,12/21/2016,1610612745,Houston Rockets,0,1,1610612756,Phoenix Suns,1,0,28,20,48,18,20,38,46,40,86,15,11,26,12,33,30,7,12,97,125
2016,2,21600435,12/21/2016,1610612756,Phoenix Suns,1,0,1610612745,Houston Rockets,0,1,35,33,68,9,16,25,44,49,93,14,6,20,17,33,20,4,9,98,111
2021,2,22100860,2/14/2022,1610612760,Oklahoma City Thunder,0,1,1610612752,New York Knicks,1,0,35,27,62,13,21,34,48,48,96,18,9,27,12,40,28,8,11,108,127
2021,2,22101228,4/10/2022,1610612755,Philadelphia 76ers,1,1,1610612765,Detroit Pistons,0,0,41,22,63,5,20,25,46,42,88,21,2,23,13,30,25,4,11,95,118
2021,2,22101228,4/10/2022,1610612765,Detroit Pistons,0,0,1610612755,Philadelphia 76ers,1,1,27,22,49,11,23,34,38,45,83,19,10,29,19,32,26,13,20,96,106
2014,2,21400623,1/20/2015,1610612748,Miami Heat,1,0,1610612760,Oklahoma City Thunder,0,1,24,22,46,8,14,22,32,36,68,14,5,19,7,32,20,11,21,92,86
2014,2,21400623,1/20/2015,1610612760,Oklahoma City Thunder,0,1,1610612748,Miami Heat,1,0,35,31,66,6,20,26,41,51,92,6,4,10,15,36,15,4,11,92,94
2022,2,22200358,12/5/2022,1610612742,Dallas Mavericks,1,1,1610612756,Phoenix Suns,0,0,24,19,43,20,21,41,44,40,84,22,4,26,11,29,23,5,13,96,130
2022,2,22200358,12/5/2022,1610612756,Phoenix Suns,0,0,1610612742,Dallas Mavericks,1,1,27,27,54,13,24,37,40,51,91,18,8,26,21,33,28,7,13,97,111
2014,2,21400329,12/12/2014,1610612746,LA Clippers,0,0,1610612764,Washington Wizards,1,1,26,29,55,6,14,20,32,43,75,26,5,31,15,30,14,10,18,91,96
2014,2,21400329,12/12/2014,1610612764,Washington Wizards,1,1,1610612746,LA Clippers,0,0,30,34,64,9,7,16,39,41,80,17,4,21,14,29,28,7,16,91,104
2021,2,22101227,4/10/2022,1610612748,Miami Heat,0,0,1610612753,Orlando Magic,1,1,21,23,44,19,31,50,40,54,94,12,4,16,13,44,20,4,10,99,111
2021,2,22101227,4/10/2022,1610612753,Orlando Magic,1,1,1610612748,Miami Heat,0,0,22,11,33,23,35,58,45,46,91,12,2,14,9,38,33,5,10,98,125
2016,2,21600053,11/1/2016,1610612759,San Antonio Spurs,1,0,1610612762,Utah Jazz,0,1,27,29,56,6,14,20,33,43,76,19,2,21,6,37,19,5,10,90,91
2016,2,21600053,11/1/2016,1610612762,Utah Jazz,0,1,1610612759,San Antonio Spurs,1,0,23,22,45,15,16,31,38,38,76,15,3,18,5,33,22,6,11,90,106
2018,2,21801110,3/26/2019,1610612741,Chicago Bulls,0,0,1610612761,Toronto Raptors,1,1,31,32,63,8,15,23,39,47,86,17,3,20,9,39,20,13,18,104,103
2018,2,21801110,3/26/2019,1610612761,Toronto Raptors,1,1,1610612741,Chicago Bulls,0,0,30,28,58,12,16,28,42,44,86,16,0,16,5,39,28,12,15,105,112
2022,2,22200357,12/5/2022,1610612748,Miami Heat,0,0,1610612763,Memphis Grizzlies,1,1,17,22,39,14,26,40,31,48,79,17,5,22,12,38,23,10,17,93,93
2020,2,22000509,2/26/2021,1610612746,LA Clippers,0,1,1610612763,Memphis Grizzlies,1,0,30,15,45,14,21,35,44,36,80,17,1,18,6,30,34,10,17,99,119
2020,2,22000509,2/26/2021,1610612763,Memphis Grizzlies,1,0,1610612746,LA Clippers,0,1,30,39,69,9,19,28,39,58,97,12,4,16,14,45,24,6,9,99,99
2022,2,22200357,12/5/2022,1610612763,Memphis Grizzlies,1,1,1610612748,Miami Heat,0,0,34,24,58,8,24,32,42,48,90,9,0,9,10,38,23,7,12,94,101
2021,2,22100859,2/14/2022,1610612751,Brooklyn Nets,1,1,1610612758,Sacramento Kings,0,0,34,24,58,9,17,26,43,41,84,14,1,15,7,34,25,8,18,102,109
2021,2,22100859,2/14/2022,1610612758,Sacramento Kings,0,0,1610612751,Brooklyn Nets,1,1,22,33,55,9,26,35,31,59,90,14,4,18,14,47,12,7,18,102,85
2021,2,22101226,4/10/2022,1610612752,New York Knicks,1,1,1610612761,Toronto Raptors,0,0,25,19,44,15,28,43,40,47,87,10,2,12,13,35,32,10,17,94,105
2021,2,22101226,4/10/2022,1610612761,Toronto Raptors,0,0,1610612752,New York Knicks,1,1,24,26,50,12,30,42,36,56,92,10,1,11,16,40,27,6,14,96,94
2022,2,22200356,12/5/2022,1610612745,Houston Rockets,1,1,1610612755,Philadelphia 76ers,0,0,28,27,55,14,25,39,42,52,94,34,10,44,26,30,19,10,21,109,132
2022,2,22200356,12/5/2022,1610612755,Philadelphia 76ers,0,0,1610612745,Houston Rockets,1,1,22,29,51,17,19,36,39,48,87,28,8,36,15,38,23,9,20,109,123
2016,2,21600965,3/10/2017,1610612753,Orlando Magic,0,0,1610612766,Charlotte Hornets,1,1,26,23,49,5,22,27,31,45,76,14,8,22,10,39,19,6,11,86,81
2016,2,21600965,3/10/2017,1610612766,Charlotte Hornets,1,1,1610612753,Orlando Magic,0,0,37,21,58,10,11,21,47,32,79,17,3,20,8,26,34,4,7,87,121
2021,2,22101225,4/10/2022,1610612740,New Orleans Pelicans,1,0,1610612744,Golden State Warriors,0,1,28,31,59,14,26,40,42,57,99,9,3,12,22,36,24,5,12,95,107
2021,2,22101225,4/10/2022,1610612744,Golden State Warriors,0,1,1610612740,New Orleans Pelicans,1,0,30,18,48,19,14,33,49,32,81,11,2,13,9,24,33,10,17,94,128
2016,2,21600434,12/21/2016,1610612758,Sacramento Kings,0,1,1610612762,Utah Jazz,1,0,24,29,53,10,11,21,34,40,74,16,8,24,11,36,13,7,11,87,94
2016,2,21600434,12/21/2016,1610612762,Utah Jazz,1,0,1610612758,Sacramento Kings,0,1,24,23,47,9,18,27,33,41,74,18,4,22,9,34,19,5,11,86,93
2022,2,22200355,12/5/2022,1610612738,Boston Celtics,0,1,1610612761,Toronto Raptors,1,0,31,23,54,13,23,36,44,46,90,15,6,21,13,36,27,6,11,96,116
2014,2,21400328,12/12/2014,1610612741,Chicago Bulls,1,1,1610612757,Portland Trail Blazers,0,0,39,34,73,5,10,15,44,44,88,22,6,28,19,27,18,3,8,90,115
2014,2,21400328,12/12/2014,1610612757,Portland Trail Blazers,0,0,1610612741,Chicago Bulls,1,1,31,33,64,12,12,24,43,45,88,8,3,11,13,33,20,5,11,90,106
2022,2,22200355,12/5/2022,1610612761,Toronto Raptors,1,0,1610612738,Boston Celtics,0,1,29,28,57,10,18,28,39,46,85,22,8,30,15,36,19,6,13,96,110
2021,2,22100858,2/14/2022,1610612764,Washington Wizards,1,1,1610612765,Detroit Pistons,0,0,31,25,56,9,20,29,40,45,85,14,4,18,13,33,21,7,15,94,103
2021,2,22100858,2/14/2022,1610612765,Detroit Pistons,0,0,1610612764,Washington Wizards,1,1,24,38,62,8,15,23,32,53,85,22,5,27,15,39,19,8,12,96,94
2021,2,22101224,4/10/2022,1610612741,Chicago Bulls,0,1,1610612750,Minnesota Timberwolves,1,0,34,28,62,10,11,21,44,39,83,26,7,33,19,23,22,7,23,101,124
2021,2,22101224,4/10/2022,1610612750,Minnesota Timberwolves,1,0,1610612741,Chicago Bulls,0,1,35,25,60,11,20,31,46,45,91,17,5,22,12,34,30,9,13,103,120
2016,2,21600433,12/21/2016,1610612740,New Orleans Pelicans,1,0,1610612760,Oklahoma City Thunder,0,1,34,34,68,8,12,20,42,46,88,18,5,23,12,37,25,8,9,97,110
2016,2,21600433,12/21/2016,1610612760,Oklahoma City Thunder,0,1,1610612740,New Orleans Pelicans,1,0,34,26,60,11,17,28,45,43,88,20,4,24,14,29,22,4,10,96,121
2014,2,21400622,1/19/2015,1610612747,Los Angeles Lakers,0,0,1610612756,Phoenix Suns,1,1,26,32,58,8,9,17,34,41,75,24,11,35,15,32,24,16,23,99,100
2014,2,21400622,1/19/2015,1610612756,Phoenix Suns,1,1,1610612747,Los Angeles Lakers,0,0,30,24,54,13,19,32,43,43,86,16,6,22,14,33,23,9,15,99,115
2014,2,21400327,12/11/2014,1610612745,Houston Rockets,0,1,1610612758,Sacramento Kings,1,0,23,28,51,15,29,44,38,57,95,22,9,31,22,38,18,8,14,103,113
2014,2,21400327,12/11/2014,1610612758,Sacramento Kings,1,0,1610612745,Houston Rockets,0,1,31,35,66,8,10,18,39,45,84,23,11,34,20,30,22,13,22,104,109
2022,2,22200354,12/5/2022,1610612737,Atlanta Hawks,1,0,1610612760,Oklahoma City Thunder,0,1,31,33,64,13,25,38,44,58,102,13,4,17,21,38,24,8,18,109,114
2022,2,22200354,12/5/2022,1610612760,Oklahoma City Thunder,0,1,1610612737,Atlanta Hawks,1,0,31,30,61,12,22,34,43,52,95,23,1,24,15,37,25,7,16,107,121
2014,2,21400621,1/19/2015,1610612757,Portland Trail Blazers,1,1,1610612758,Sacramento Kings,0,0,24,28,52,11,25,36,35,53,88,17,9,26,14,45,21,8,13,99,98
2014,2,21400621,1/19/2015,1610612758,Sacramento Kings,0,0,1610612757,Portland Trail Blazers,1,1,30,34,64,4,8,12,34,42,76,22,8,30,15,30,13,16,23,100,94
2020,2,22000781,4/7/2021,1610612760,Oklahoma City Thunder,1,0,1610612766,Charlotte Hornets,0,1,21,23,44,16,25,41,37,48,85,12,5,17,14,36,29,12,22,102,102
2020,2,22000781,4/7/2021,1610612766,Charlotte Hornets,0,1,1610612760,Oklahoma City Thunder,1,0,28,25,53,15,29,44,43,54,97,12,1,13,15,40,27,4,12,100,113
2017,2,21700706,1/24/2018,1610612742,Dallas Mavericks,1,0,1610612745,Houston Rockets,0,1,20,27,47,15,20,35,35,47,82,12,6,18,11,38,24,8,14,94,97
2017,2,21700706,1/24/2018,1610612745,Houston Rockets,0,1,1610612742,Dallas Mavericks,1,0,15,16,31,21,30,51,36,46,82,11,12,23,10,41,20,5,10,95,104
2016,2,21600964,3/9/2017,1610612747,Los Angeles Lakers,0,1,1610612756,Phoenix Suns,1,0,35,36,71,12,15,27,47,51,98,16,8,24,17,39,21,7,9,101,122
2016,2,21600964,3/9/2017,1610612756,Phoenix Suns,1,0,1610612747,Los Angeles Lakers,0,1,36,36,72,6,13,19,42,49,91,20,5,25,23,30,20,11,20,100,110
2021,2,22100857,2/13/2022,1610612750,Minnesota Timberwolves,0,1,1610612754,Indiana Pacers,1,0,25,25,50,18,16,34,43,41,84,25,3,28,10,33,23,5,14,101,129
2021,2,22100857,2/13/2022,1610612754,Indiana Pacers,1,0,1610612750,Minnesota Timberwolves,0,1,32,25,57,13,32,45,45,57,102,17,5,22,27,31,28,8,13,99,120
2021,2,22101223,4/10/2022,1610612738,Boston Celtics,0,1,1610612763,Memphis Grizzlies,1,0,36,15,51,18,30,48,54,45,99,13,0,13,19,26,34,11,15,102,139
2021,2,22101223,4/10/2022,1610612763,Memphis Grizzlies,1,0,1610612738,Boston Celtics,0,1,24,31,55,15,32,47,39,63,102,17,10,27,22,46,27,5,10,101,110
2016,2,21600432,12/21/2016,1610612741,Chicago Bulls,1,0,1610612764,Washington Wizards,0,1,32,42,74,6,15,21,38,57,95,15,4,19,21,38,25,7,15,97,97
2016,2,21600432,12/21/2016,1610612764,Washington Wizards,0,1,1610612741,Chicago Bulls,1,0,40,24,64,3,15,18,43,39,82,18,7,25,8,35,23,4,10,95,107
2014,2,21401138,4/4/2015,1610612737,Atlanta Hawks,1,1,1610612751,Brooklyn Nets,0,0,32,17,49,17,16,33,49,33,82,16,3,19,8,27,40,7,13,96,131
2014,2,21401138,4/4/2015,1610612751,Brooklyn Nets,0,0,1610612737,Atlanta Hawks,1,1,29,28,57,10,13,23,39,41,80,11,6,17,13,30,22,15,21,97,99
2014,2,21400620,1/19/2015,1610612739,Cleveland Cavaliers,1,1,1610612741,Chicago Bulls,0,0,33,39,72,8,10,18,41,49,90,18,7,25,23,30,20,5,12,88,108
2014,2,21400620,1/19/2015,1610612741,Chicago Bulls,0,0,1610612739,Cleveland Cavaliers,1,1,22,42,64,8,8,16,30,50,80,26,6,32,14,39,12,5,8,90,94
2014,2,21400326,12/11/2014,1610612739,Cleveland Cavaliers,0,0,1610612760,Oklahoma City Thunder,1,1,22,35,57,9,19,28,31,54,85,23,7,30,17,40,20,9,15,97,94
2014,2,21400326,12/11/2014,1610612760,Oklahoma City Thunder,1,1,1610612739,Cleveland Cavaliers,0,0,31,30,61,7,19,26,38,49,87,20,2,22,12,39,22,5,11,97,103
2022,2,22200609,1/9/2023,1610612747,Los Angeles Lakers,0,0,1610612743,Denver Nuggets,1,1,33,32,65,8,20,28,41,52,93,19,6,25,11,44,20,7,14,108,109
2023,2,22300004,11/3/2023,1610612751,Brooklyn Nets,0,1,1610612741,Chicago Bulls,1,0,26,25,51,18,27,45,44,52,96,3,2,5,16,38,32,4,11,93,109
2016,2,21600052,11/1/2016,1610612750,Minnesota Timberwolves,1,1,1610612763,Memphis Grizzlies,0,0,31,27,58,12,8,20,43,35,78,18,5,23,12,27,29,17,21,97,116
2016,2,21600052,11/1/2016,1610612763,Memphis Grizzlies,0,0,1610612750,Minnesota Timberwolves,1,1,23,28,51,4,20,24,27,48,75,22,7,29,13,39,10,10,21,98,80
2017,2,21700705,1/24/2018,1610612737,Atlanta Hawks,1,0,1610612761,Toronto Raptors,0,1,30,43,73,7,14,21,37,57,94,12,5,17,16,44,19,10,17,103,93
2017,2,21700705,1/24/2018,1610612761,Toronto Raptors,0,1,1610612737,Atlanta Hawks,1,0,25,28,53,14,22,36,39,50,89,16,9,25,16,37,25,8,17,104,108
2014,2,21401137,4/4/2015,1610612755,Philadelphia 76ers,0,0,1610612766,Charlotte Hornets,1,1,17,33,50,11,15,26,28,48,76,24,9,33,18,34,13,5,15,91,91
2022,2,22200353,12/5/2022,1610612749,Milwaukee Bucks,0,1,1610612753,Orlando Magic,1,0,25,20,45,13,27,40,38,47,85,20,6,26,11,42,31,8,17,102,109
2022,2,22200353,12/5/2022,1610612753,Orlando Magic,1,0,1610612749,Milwaukee Bucks,0,1,26,35,61,8,24,32,34,59,93,26,3,29,18,42,21,9,14,102,102
2021,2,22100856,2/13/2022,1610612737,Atlanta Hawks,0,0,1610612738,Boston Celtics,1,1,22,33,55,12,26,38,34,59,93,15,0,15,16,43,18,5,13,98,95
2021,2,22100856,2/13/2022,1610612738,Boston Celtics,1,1,1610612737,Atlanta Hawks,0,0,25,22,47,11,27,38,36,49,85,22,5,27,12,40,21,6,12,97,105
2020,2,22000508,2/26/2021,1610612741,Chicago Bulls,1,0,1610612756,Phoenix Suns,0,1,27,20,47,12,19,31,39,39,78,7,3,10,7,32,25,11,19,96,97
2020,2,22000508,2/26/2021,1610612756,Phoenix Suns,0,1,1610612741,Chicago Bulls,1,0,38,28,66,6,16,22,44,44,88,12,3,15,7,39,35,2,7,97,106
2014,2,21401137,4/4/2015,1610612766,Charlotte Hornets,1,1,1610612755,Philadelphia 76ers,0,0,34,39,73,1,12,13,35,51,86,21,2,23,18,34,13,4,12,90,92
2016,2,21600431,12/21/2016,1610612763,Memphis Grizzlies,0,1,1610612765,Detroit Pistons,1,0,23,29,52,12,18,30,35,47,82,16,3,19,9,40,25,2,9,92,98
2016,2,21600431,12/21/2016,1610612765,Detroit Pistons,1,0,1610612763,Memphis Grizzlies,0,1,20,29,49,6,17,23,26,46,72,28,9,37,16,33,17,9,17,92,86
2019,2,21900004,10/23/2019,1610612754,Indiana Pacers,1,0,1610612765,Detroit Pistons,0,1,33,35,68,8,13,21,41,48,89,20,4,24,13,37,26,5,15,100,110
2019,2,21900004,10/23/2019,1610612765,Detroit Pistons,0,1,1610612754,Indiana Pacers,1,0,30,24,54,11,13,24,41,37,78,26,7,33,11,29,26,8,18,101,119
2022,2,22200618,1/11/2023,1610612765,Detroit Pistons,1,1,1610612750,Minnesota Timberwolves,0,0,31,17,48,17,15,32,48,32,80,22,6,28,9,25,30,7,17,101,135
2023,2,22300979,3/17/2024,1610612753,Orlando Magic,1,1,1610612761,Toronto Raptors,0,0,32,17,49,11,25,36,43,42,85,14,6,20,12,31,22,7,15,97,111
2014,2,21400619,1/19/2015,1610612749,Milwaukee Bucks,1,0,1610612761,Toronto Raptors,0,1,29,29,58,5,13,18,34,42,76,16,9,25,13,34,22,9,17,93,89
2016,2,21600430,12/21/2016,1610612737,Atlanta Hawks,1,0,1610612750,Minnesota Timberwolves,0,1,27,29,56,7,19,26,34,48,82,9,4,13,10,40,19,6,10,89,84
2016,2,21600430,12/21/2016,1610612750,Minnesota Timberwolves,0,1,1610612737,Atlanta Hawks,1,0,26,28,54,9,20,29,35,48,83,13,1,14,19,29,21,9,17,87,92
2014,2,21400619,1/19/2015,1610612761,Toronto Raptors,0,1,1610612749,Milwaukee Bucks,1,0,30,36,66,6,18,24,36,54,90,14,10,24,24,34,17,12,16,93,92
2022,2,22200629,1/12/2023,1610612761,Toronto Raptors,1,1,1610612766,Charlotte Hornets,0,0,33,22,55,10,18,28,43,40,83,28,8,36,10,33,30,6,9,97,124
2023,2,22300031,11/17/2023,1610612761,Toronto Raptors,1,0,1610612738,Boston Celtics,0,1,30,24,54,12,21,33,42,45,87,9,5,14,9,37,29,5,13,97,105
2023,2,22300005,11/3/2023,1610612744,Golden State Warriors,0,1,1610612760,Oklahoma City Thunder,1,0,31,21,52,18,22,40,49,43,92,25,5,30,18,28,36,3,15,103,141
2021,2,22100855,2/12/2022,1610612753,Orlando Magic,0,0,1610612756,Phoenix Suns,1,1,22,24,46,15,26,41,37,50,87,16,8,24,8,47,25,8,15,107,105
2021,2,22100855,2/12/2022,1610612756,Phoenix Suns,1,1,1610612753,Orlando Magic,0,0,40,31,71,15,19,34,55,50,105,7,3,10,11,41,40,2,7,107,132
2016,2,21600963,3/9/2017,1610612755,Philadelphia 76ers,0,0,1610612757,Portland Trail Blazers,1,1,30,35,65,11,18,29,41,53,94,15,5,20,14,42,18,8,17,106,108
2016,2,21600963,3/9/2017,1610612757,Portland Trail Blazers,1,1,1610612755,Philadelphia 76ers,0,0,34,33,67,6,15,21,40,48,88,28,5,33,18,33,25,10,19,104,114
2021,2,22101222,4/10/2022,1610612746,LA Clippers,1,1,1610612760,Oklahoma City Thunder,0,0,36,26,62,18,17,35,54,43,97,12,2,14,15,29,34,6,9,98,138
2021,2,22101222,4/10/2022,1610612760,Oklahoma City Thunder,0,0,1610612746,LA Clippers,1,1,28,36,64,9,25,34,37,61,98,5,4,9,15,48,17,4,10,97,88
2020,2,22000780,4/7/2021,1610612737,Atlanta Hawks,1,0,1610612763,Memphis Grizzlies,0,1,35,38,73,10,18,28,45,56,101,13,2,15,13,43,26,5,7,100,113
2020,2,22000780,4/7/2021,1610612763,Memphis Grizzlies,0,1,1610612737,Atlanta Hawks,1,0,31,18,49,17,23,40,48,41,89,18,3,21,11,33,30,5,14,100,131
2014,2,21400325,12/10/2014,1610612743,Denver Nuggets,1,1,1610612748,Miami Heat,0,0,30,32,62,8,15,23,38,47,85,18,9,27,21,28,21,1,10,86,102
2014,2,21400325,12/10/2014,1610612748,Miami Heat,0,0,1610612743,Denver Nuggets,1,1,23,37,60,7,15,22,30,52,82,15,6,21,17,37,18,7,11,87,82
2016,2,21600962,3/9/2017,1610612759,San Antonio Spurs,0,0,1610612760,Oklahoma City Thunder,1,1,29,36,65,6,13,19,35,49,84,16,4,20,16,37,15,10,15,91,92
2022,2,22200352,12/5/2022,1610612746,LA Clippers,0,1,1610612766,Charlotte Hornets,1,0,30,27,57,15,21,36,45,48,93,14,7,21,17,35,30,8,12,98,119
2022,2,22200352,12/5/2022,1610612766,Charlotte Hornets,1,0,1610612746,LA Clippers,0,1,35,29,64,12,22,34,47,51,98,11,6,17,16,38,29,4,10,99,117
2021,2,22100854,2/12/2022,1610612744,Golden State Warriors,1,1,1610612747,Los Angeles Lakers,0,0,28,24,52,12,26,38,40,50,90,25,9,34,14,38,24,5,9,100,117
2021,2,22100854,2/12/2022,1610612747,Los Angeles Lakers,0,0,1610612744,Golden State Warriors,1,1,30,31,61,11,16,27,41,47,88,22,11,33,13,41,25,4,9,99,115
2021,2,22101221,4/10/2022,1610612737,Atlanta Hawks,0,1,1610612745,Houston Rockets,1,0,24,25,49,21,17,38,45,42,87,19,5,24,15,31,29,4,13,96,130
2021,2,22101221,4/10/2022,1610612745,Houston Rockets,1,0,1610612737,Atlanta Hawks,0,1,24,19,43,17,29,46,41,48,89,15,5,20,11,40,24,4,8,96,114
2014,2,21401136,4/3/2015,1610612747,Los Angeles Lakers,1,0,1610612757,Portland Trail Blazers,0,1,26,42,68,5,9,14,31,51,82,10,7,17,9,48,13,7,13,94,77
2014,2,21401136,4/3/2015,1610612757,Portland Trail Blazers,0,1,1610612747,Los Angeles Lakers,1,0,33,29,62,10,16,26,43,45,88,11,0,11,7,38,21,4,8,95,107
2016,2,21600962,3/9/2017,1610612760,Oklahoma City Thunder,1,1,1610612759,San Antonio Spurs,0,0,35,34,69,6,14,20,41,48,89,14,7,21,20,31,23,8,11,91,102
2014,2,21400618,1/19/2015,1610612740,New Orleans Pelicans,0,0,1610612752,New York Knicks,1,1,27,30,57,8,19,27,35,49,84,14,6,20,24,27,13,2,11,80,92
2014,2,21400618,1/19/2015,1610612752,New York Knicks,1,1,1610612740,New Orleans Pelicans,0,0,28,27,55,10,13,23,38,40,78,13,4,17,12,30,22,1,4,80,99
2014,2,21400324,12/10/2014,1610612744,Golden State Warriors,1,1,1610612745,Houston Rockets,0,0,32,26,58,8,15,23,40,41,81,17,3,20,9,35,21,9,15,95,105
2014,2,21400324,12/10/2014,1610612745,Houston Rockets,0,0,1610612744,Golden State Warriors,1,1,28,27,55,9,26,35,37,53,90,10,5,15,16,40,15,9,15,97,93
2017,2,21700704,1/24/2018,1610612741,Chicago Bulls,0,0,1610612755,Philadelphia 76ers,1,1,25,32,57,11,26,37,36,58,94,18,4,22,16,43,20,6,11,100,101
2022,2,22200351,12/4/2022,1610612754,Indiana Pacers,0,0,1610612757,Portland Trail Blazers,1,1,30,28,58,10,23,33,40,51,91,10,2,12,14,38,22,10,15,98,100
2022,2,22200351,12/4/2022,1610612757,Portland Trail Blazers,1,1,1610612754,Indiana Pacers,0,0,25,21,46,17,23,40,42,44,86,15,7,22,14,33,32,10,15,97,116
2021,2,22101220,4/10/2022,1610612743,Denver Nuggets,1,0,1610612747,Los Angeles Lakers,0,1,34,19,53,15,32,47,49,51,100,28,8,36,16,38,33,4,14,113,141
2021,2,22101220,4/10/2022,1610612747,Los Angeles Lakers,0,1,1610612743,Denver Nuggets,1,0,28,23,51,16,27,43,44,50,94,42,5,47,17,35,26,10,13,113,146
2022,2,22200350,12/4/2022,1610612741,Chicago Bulls,0,0,1610612758,Sacramento Kings,1,1,29,32,61,9,16,25,38,48,86,16,3,19,8,42,17,10,16,102,101
2022,2,22200350,12/4/2022,1610612758,Sacramento Kings,1,1,1610612741,Chicago Bulls,0,0,27,16,43,13,30,43,40,46,86,17,2,19,11,36,30,9,19,103,110
2017,2,21700704,1/24/2018,1610612755,Philadelphia 76ers,1,1,1610612741,Chicago Bulls,0,0,26,23,49,16,16,32,42,39,81,15,5,20,7,34,31,8,15,98,115
2014,2,21400323,12/10/2014,1610612740,New Orleans Pelicans,0,0,1610612742,Dallas Mavericks,1,1,33,37,70,7,11,18,40,48,88,20,4,24,19,30,16,5,12,92,107
2016,2,21600429,12/21/2016,1610612739,Cleveland Cavaliers,1,1,1610612749,Milwaukee Bucks,0,0,28,32,60,15,12,27,43,44,87,12,7,19,14,34,30,7,12,92,113
2016,2,21600429,12/21/2016,1610612749,Milwaukee Bucks,0,0,1610612739,Cleveland Cavaliers,1,1,27,28,55,9,13,22,36,41,77,21,8,29,8,36,24,3,9,91,102
2016,2,21600051,11/1/2016,1610612740,New Orleans Pelicans,1,0,1610612749,Milwaukee Bucks,0,1,27,29,56,9,17,26,36,46,82,32,9,41,12,39,23,9,13,102,113
2016,2,21600051,11/1/2016,1610612749,Milwaukee Bucks,0,1,1610612740,New Orleans Pelicans,1,0,34,25,59,10,22,32,44,47,91,19,2,21,15,33,30,13,16,103,117
2021,2,22101219,4/10/2022,1610612742,Dallas Mavericks,1,1,1610612759,San Antonio Spurs,0,0,26,23,49,20,16,36,46,39,85,18,5,23,13,29,34,15,16,100,130
2021,2,22101219,4/10/2022,1610612759,San Antonio Spurs,0,0,1610612742,Dallas Mavericks,1,1,32,26,58,11,20,31,43,46,89,23,0,23,10,36,26,5,8,99,120
2014,2,21400617,1/19/2015,1610612745,Houston Rockets,1,1,1610612754,Indiana Pacers,0,0,25,16,41,12,19,31,37,35,72,24,9,33,9,33,26,12,20,97,110
2023,2,22300979,3/17/2024,1610612761,Toronto Raptors,0,0,1610612753,Orlando Magic,1,1,29,24,53,8,23,31,37,47,84,14,1,15,13,34,23,7,18,96,96
2014,2,21400617,1/19/2015,1610612754,Indiana Pacers,0,0,1610612745,Houston Rockets,1,1,33,25,58,6,21,27,39,46,85,14,4,18,15,34,21,13,19,97,98
2022,2,22200349,12/4/2022,1610612747,Los Angeles Lakers,0,1,1610612764,Washington Wizards,1,0,42,28,70,10,16,26,52,44,96,16,6,22,12,36,34,10,15,106,130
2022,2,22200349,12/4/2022,1610612764,Washington Wizards,1,0,1610612747,Los Angeles Lakers,0,1,39,27,66,10,29,39,49,56,105,11,4,15,15,43,24,5,10,107,119
2021,2,22100853,2/12/2022,1610612742,Dallas Mavericks,1,0,1610612746,LA Clippers,0,1,20,26,46,15,24,39,35,50,85,12,7,19,15,38,16,7,14,93,97
2016,2,21600961,3/9/2017,1610612746,LA Clippers,0,1,1610612763,Memphis Grizzlies,1,0,29,19,48,11,19,30,40,38,78,23,5,28,9,29,24,6,14,96,114
2016,2,21600961,3/9/2017,1610612763,Memphis Grizzlies,1,0,1610612746,LA Clippers,0,1,30,33,63,7,13,20,37,46,83,17,5,22,6,43,26,2,9,95,98
2014,2,21401135,4/3/2015,1610612740,New Orleans Pelicans,0,1,1610612758,Sacramento Kings,1,0,20,38,58,14,15,29,34,53,87,19,9,28,22,34,20,4,12,91,101
2014,2,21401135,4/3/2015,1610612758,Sacramento Kings,1,0,1610612740,New Orleans Pelicans,0,1,31,30,61,6,11,17,37,41,78,15,10,25,8,39,21,4,10,91,95
2022,2,22200348,12/4/2022,1610612739,Cleveland Cavaliers,0,0,1610612752,New York Knicks,1,1,21,27,48,8,27,35,29,54,83,15,5,20,14,42,17,6,19,99,81
2022,2,22200348,12/4/2022,1610612752,New York Knicks,1,1,1610612739,Cleveland Cavaliers,0,0,30,27,57,5,24,29,35,51,86,17,4,21,19,34,17,7,21,99,92
2014,2,21400323,12/10/2014,1610612742,Dallas Mavericks,1,1,1610612740,New Orleans Pelicans,0,0,35,27,62,9,12,21,44,39,83,15,2,17,8,31,17,5,9,91,112
2017,2,21700703,1/24/2018,1610612754,Indiana Pacers,1,1,1610612756,Phoenix Suns,0,0,36,20,56,9,15,24,45,35,80,17,8,25,5,34,32,3,12,100,116
2017,2,21700703,1/24/2018,1610612756,Phoenix Suns,0,0,1610612754,Indiana Pacers,1,1,26,23,49,9,26,35,35,49,84,22,7,29,14,38,22,11,16,99,101
2021,2,22100853,2/12/2022,1610612746,LA Clippers,0,1,1610612742,Dallas Mavericks,1,0,36,24,60,7,15,22,43,39,82,6,5,11,9,32,23,4,14,94,99
2021,2,22101218,4/10/2022,1610612739,Cleveland Cavaliers,1,1,1610612749,Milwaukee Bucks,0,0,32,24,56,19,19,38,51,43,94,12,5,17,10,35,39,7,12,103,133
2021,2,22101218,4/10/2022,1610612749,Milwaukee Bucks,0,0,1610612739,Cleveland Cavaliers,1,1,27,31,58,12,18,30,39,49,88,25,7,32,12,40,27,5,12,103,115
2014,2,21400322,12/10/2014,1610612752,New York Knicks,0,0,1610612759,San Antonio Spurs,1,1,31,30,61,6,9,15,37,39,76,15,2,17,13,27,22,10,17,86,95
2022,2,22200603,1/8/2023,1610612739,Cleveland Cavaliers,0,1,1610612756,Phoenix Suns,1,0,34,15,49,11,18,29,45,33,78,11,6,17,6,31,29,7,14,95,112
2014,2,21400322,12/10/2014,1610612759,San Antonio Spurs,1,1,1610612752,New York Knicks,0,0,27,27,54,10,9,19,37,36,73,25,5,30,10,28,22,4,10,87,109
2022,2,22200603,1/8/2023,1610612756,Phoenix Suns,1,0,1610612739,Cleveland Cavaliers,0,1,23,35,58,14,12,26,37,47,84,10,1,11,10,38,22,8,16,95,98
2014,2,21400616,1/19/2015,1610612742,Dallas Mavericks,0,1,1610612763,Memphis Grizzlies,1,0,24,27,51,10,15,25,34,42,76,25,8,33,13,34,17,8,13,90,103
2021,2,22101217,4/10/2022,1610612764,Washington Wizards,0,0,1610612766,Charlotte Hornets,1,1,34,37,71,8,15,23,42,52,94,16,10,26,19,38,25,6,11,100,108
2021,2,22101217,4/10/2022,1610612766,Charlotte Hornets,1,1,1610612764,Washington Wizards,0,0,30,26,56,18,15,33,48,41,89,10,4,14,16,27,34,12,20,100,124
2019,2,21900221,11/22/2019,1610612739,Cleveland Cavaliers,0,0,1610612742,Dallas Mavericks,1,1,25,32,57,12,17,29,37,49,86,15,2,17,10,41,23,8,10,96,101
2019,2,21900221,11/22/2019,1610612742,Dallas Mavericks,1,1,1610612739,Cleveland Cavaliers,0,0,38,25,63,20,17,37,58,42,100,7,2,9,14,29,31,3,5,95,143
2014,2,21400616,1/19/2015,1610612763,Memphis Grizzlies,1,0,1610612742,Dallas Mavericks,0,1,33,30,63,3,19,22,36,49,85,20,2,22,18,32,17,6,13,91,95
2018,2,21800963,3/5/2019,1610612750,Minnesota Timberwolves,1,1,1610612760,Oklahoma City Thunder,0,0,36,31,67,11,11,22,47,42,89,26,9,35,13,32,28,4,10,103,131
2018,2,21800963,3/5/2019,1610612760,Oklahoma City Thunder,0,0,1610612750,Minnesota Timberwolves,1,1,24,24,48,18,28,46,42,52,94,18,13,31,17,43,20,6,12,104,120
2018,2,21800744,1/28/2019,1610612752,New York Knicks,0,0,1610612766,Charlotte Hornets,1,1,27,35,62,7,16,23,34,51,85,17,9,26,12,41,19,4,10,94,92
2018,2,21800744,1/28/2019,1610612766,Charlotte Hornets,1,1,1610612752,New York Knicks,0,0,28,32,60,11,23,34,39,55,94,12,4,16,19,38,25,6,10,94,101
2022,2,22200347,12/4/2022,1610612763,Memphis Grizzlies,0,1,1610612765,Detroit Pistons,1,0,28,29,57,15,20,35,43,49,92,21,8,29,16,35,28,7,14,101,122
2022,2,22200347,12/4/2022,1610612765,Detroit Pistons,1,0,1610612763,Memphis Grizzlies,0,1,24,25,49,13,22,35,37,47,84,25,5,30,13,37,26,9,15,101,112
2017,2,21700702,1/24/2018,1610612762,Utah Jazz,0,1,1610612765,Detroit Pistons,1,0,28,37,65,10,21,31,38,58,96,12,4,16,14,46,24,10,15,105,98
2017,2,21700702,1/24/2018,1610612765,Detroit Pistons,1,0,1610612762,Utah Jazz,0,1,31,35,66,7,24,31,38,59,97,12,6,18,20,43,23,11,20,107,95
2021,2,22100852,2/12/2022,1610612741,Chicago Bulls,1,1,1610612760,Oklahoma City Thunder,0,0,33,31,64,7,18,25,40,49,89,19,4,23,13,37,20,8,13,101,106
2021,2,22100852,2/12/2022,1610612760,Oklahoma City Thunder,0,0,1610612741,Chicago Bulls,1,1,23,29,52,11,25,36,34,54,88,22,8,30,10,49,22,6,8,101,101
2016,2,21600428,12/20/2016,1610612757,Portland Trail Blazers,0,0,1610612758,Sacramento Kings,1,1,40,18,58,4,24,28,44,42,86,29,11,40,18,29,30,3,9,96,121
2016,2,21600428,12/20/2016,1610612758,Sacramento Kings,1,1,1610612757,Portland Trail Blazers,0,0,30,19,49,10,13,23,40,32,72,36,7,43,5,29,20,5,10,95,126
2020,2,22000507,2/26/2021,1610612748,Miami Heat,1,1,1610612762,Utah Jazz,0,0,30,25,55,14,17,31,44,42,86,22,3,25,12,31,24,9,15,101,124
2020,2,22000507,2/26/2021,1610612762,Utah Jazz,0,0,1610612748,Miami Heat,1,1,25,23,48,15,31,46,40,54,94,21,2,23,14,41,24,5,9,102,116
2021,2,22101216,4/10/2022,1610612751,Brooklyn Nets,1,1,1610612754,Indiana Pacers,0,0,44,15,59,8,14,22,52,29,81,22,3,25,10,20,30,16,21,104,134
2021,2,22101216,4/10/2022,1610612754,Indiana Pacers,0,0,1610612751,Brooklyn Nets,1,1,28,30,58,19,27,46,47,57,104,13,6,19,17,43,32,5,7,105,126
2016,2,21600960,3/9/2017,1610612739,Cleveland Cavaliers,0,0,1610612765,Detroit Pistons,1,1,28,17,45,11,28,39,39,45,84,12,7,19,10,38,24,6,10,91,101
2016,2,21600960,3/9/2017,1610612765,Detroit Pistons,1,1,1610612739,Cleveland Cavaliers,0,0,32,30,62,9,17,26,41,47,88,15,4,19,13,36,22,4,8,91,106
2016,2,21600427,12/20/2016,1610612744,Golden State Warriors,1,1,1610612762,Utah Jazz,0,0,31,36,67,9,14,23,40,50,90,15,2,17,13,38,24,5,10,98,104
2014,2,21400615,1/19/2015,1610612743,Denver Nuggets,0,0,1610612744,Golden State Warriors,1,1,23,40,63,7,17,24,30,57,87,12,6,18,13,49,17,10,16,100,79
2014,2,21400615,1/19/2015,1610612744,Golden State Warriors,1,1,1610612743,Denver Nuggets,0,0,31,23,54,13,14,27,44,37,81,21,6,27,8,31,30,9,13,99,122
2020,2,22000779,4/7/2021,1610612740,New Orleans Pelicans,0,0,1610612751,Brooklyn Nets,1,1,32,30,62,6,21,27,38,51,89,29,10,39,19,39,23,10,15,104,111
2020,2,22000779,4/7/2021,1610612751,Brooklyn Nets,1,1,1610612740,New Orleans Pelicans,0,0,32,19,51,19,22,41,51,41,92,18,4,22,16,27,37,9,17,105,139
2022,2,22200599,1/8/2023,1610612748,Miami Heat,1,0,1610612751,Brooklyn Nets,0,1,25,32,57,13,22,35,38,54,92,12,5,17,20,37,22,8,12,92,101
2017,2,21700701,1/24/2018,1610612740,New Orleans Pelicans,0,1,1610612766,Charlotte Hornets,1,0,30,31,61,9,17,26,39,48,87,14,4,18,11,39,26,5,16,99,101
2017,2,21700701,1/24/2018,1610612766,Charlotte Hornets,1,0,1610612740,New Orleans Pelicans,0,1,30,34,64,6,15,21,36,49,85,18,13,31,14,39,16,6,14,100,96
2022,2,22200599,1/8/2023,1610612751,Brooklyn Nets,0,1,1610612748,Miami Heat,1,0,27,16,43,12,21,33,39,37,76,12,3,15,11,28,22,8,19,91,102
2022,2,22200346,12/4/2022,1610612738,Boston Celtics,0,1,1610612751,Brooklyn Nets,1,0,20,23,43,15,23,38,35,46,81,18,2,20,12,35,18,6,17,97,103
2022,2,22200346,12/4/2022,1610612751,Brooklyn Nets,1,0,1610612738,Boston Celtics,0,1,25,33,58,9,17,26,34,50,84,15,7,22,13,41,17,11,15,97,92
2021,2,22100851,2/12/2022,1610612748,Miami Heat,1,1,1610612751,Brooklyn Nets,0,0,31,22,53,10,19,29,41,41,82,23,6,29,13,33,20,12,15,99,115
2021,2,22100851,2/12/2022,1610612751,Brooklyn Nets,0,0,1610612748,Miami Heat,1,1,30,23,53,12,28,40,42,51,93,15,7,22,11,45,16,6,8,98,111
2020,2,22000506,2/26/2021,1610612745,Houston Rockets,0,0,1610612761,Toronto Raptors,1,1,23,21,44,16,31,47,39,52,91,17,3,20,13,40,23,6,11,99,111
2020,2,22000506,2/26/2021,1610612761,Toronto Raptors,1,1,1610612745,Houston Rockets,0,0,24,24,48,16,25,41,40,49,89,26,1,27,16,33,29,4,13,99,122
2016,2,21600427,12/20/2016,1610612762,Utah Jazz,0,0,1610612744,Golden State Warriors,1,1,18,28,46,9,21,30,27,49,76,11,9,20,12,42,13,13,23,96,74
2022,2,22200597,1/8/2023,1610612757,Portland Trail Blazers,0,0,1610612761,Toronto Raptors,1,1,25,21,46,9,21,30,34,42,76,28,9,37,14,30,19,12,24,102,105
2022,2,22200597,1/8/2023,1610612761,Toronto Raptors,1,1,1610612757,Portland Trail Blazers,0,0,28,32,60,12,19,31,40,51,91,25,4,29,16,37,26,5,10,101,117
2022,2,22200345,12/4/2022,1610612756,Phoenix Suns,0,1,1610612759,San Antonio Spurs,1,0,30,27,57,19,18,37,49,45,94,16,4,20,17,31,38,5,11,98,133
2023,2,22300325,12/14/2023,1610612746,LA Clippers,1,1,1610612744,Golden State Warriors,0,0,28,21,49,13,19,32,41,40,81,26,4,30,12,29,27,8,14,94,121
2016,2,21600959,3/8/2017,1610612738,Boston Celtics,0,1,1610612744,Golden State Warriors,1,0,27,28,55,10,19,29,37,47,84,15,4,19,13,36,28,8,14,93,99
2016,2,21600959,3/8/2017,1610612744,Golden State Warriors,1,0,1610612738,Boston Celtics,0,1,31,23,54,6,24,30,37,47,84,6,3,9,12,36,23,12,18,94,86
2014,2,21400321,12/10/2014,1610612750,Minnesota Timberwolves,1,1,1610612757,Portland Trail Blazers,0,0,31,38,69,1,11,12,32,49,81,25,8,33,23,29,22,7,18,92,90
2014,2,21400321,12/10/2014,1610612757,Portland Trail Blazers,0,0,1610612750,Minnesota Timberwolves,1,1,21,24,45,10,25,35,31,49,80,10,2,12,13,37,20,13,20,93,82
2022,2,22200345,12/4/2022,1610612759,San Antonio Spurs,1,0,1610612756,Phoenix Suns,0,1,32,24,56,6,25,31,38,49,87,13,5,18,16,34,19,5,19,99,95
2020,2,22000505,2/26/2021,1610612738,Boston Celtics,1,1,1610612754,Indiana Pacers,0,0,33,27,60,9,13,22,42,40,82,25,4,29,10,32,24,8,12,99,118
2020,2,22000505,2/26/2021,1610612754,Indiana Pacers,0,0,1610612738,Boston Celtics,1,1,20,23,43,15,31,46,35,54,89,27,2,29,14,40,26,3,9,99,112
2014,2,21400614,1/19/2015,1610612738,Boston Celtics,0,0,1610612746,LA Clippers,1,1,21,34,55,12,17,29,33,51,84,15,6,21,17,36,24,6,14,91,93
2021,2,22101215,4/9/2022,1610612744,Golden State Warriors,0,1,1610612759,San Antonio Spurs,1,0,25,24,49,8,24,32,33,48,81,26,7,33,13,38,23,5,12,96,100
2021,2,22101215,4/9/2022,1610612759,San Antonio Spurs,1,0,1610612744,Golden State Warriors,0,1,22,27,49,10,21,31,32,48,80,20,7,27,9,42,19,8,12,98,94
2014,2,21400614,1/19/2015,1610612746,LA Clippers,1,1,1610612738,Boston Celtics,0,0,30,31,61,9,12,21,39,43,82,15,4,19,13,32,27,6,11,91,102
2017,2,21700700,1/23/2018,1610612738,Boston Celtics,0,0,1610612747,Los Angeles Lakers,1,1,27,19,46,15,29,44,42,48,90,8,2,10,10,39,22,6,11,98,107
2017,2,21700700,1/23/2018,1610612747,Los Angeles Lakers,1,1,1610612738,Boston Celtics,0,0,33,32,65,7,19,26,40,51,91,21,15,36,21,37,18,3,10,97,108
2022,2,22200344,12/4/2022,1610612740,New Orleans Pelicans,1,1,1610612743,Denver Nuggets,0,0,30,25,55,11,15,26,41,40,81,28,8,36,7,39,29,5,11,101,121
2022,2,22200600,1/8/2023,1610612762,Utah Jazz,0,0,1610612763,Memphis Grizzlies,1,1,35,21,56,10,22,32,45,43,88,18,4,22,13,32,29,16,21,105,118
2022,2,22200600,1/8/2023,1610612763,Memphis Grizzlies,1,1,1610612762,Utah Jazz,0,0,31,33,64,15,23,38,46,56,102,16,6,22,18,41,28,7,10,105,123
2014,2,21400320,12/10/2014,1610612741,Chicago Bulls,1,1,1610612751,Brooklyn Nets,0,0,29,28,57,8,14,22,37,42,79,23,9,32,19,29,21,9,16,93,105
2014,2,21400320,12/10/2014,1610612751,Brooklyn Nets,0,0,1610612741,Chicago Bulls,1,1,26,48,74,3,11,14,29,59,88,19,5,24,17,45,16,6,11,92,80
2014,2,21401134,4/3/2015,1610612743,Denver Nuggets,0,0,1610612759,San Antonio Spurs,1,1,34,36,70,6,11,17,40,47,87,7,4,11,14,34,17,11,18,95,93
2014,2,21401134,4/3/2015,1610612759,San Antonio Spurs,1,1,1610612743,Denver Nuggets,0,0,33,18,51,14,20,34,47,38,85,15,2,17,15,24,33,8,18,95,123
2022,2,22200344,12/4/2022,1610612743,Denver Nuggets,0,0,1610612740,New Orleans Pelicans,1,1,33,17,50,8,23,31,41,40,81,16,8,24,12,31,24,10,19,103,106
2021,2,22100850,2/12/2022,1610612743,Denver Nuggets,0,1,1610612761,Toronto Raptors,1,0,25,22,47,14,23,37,39,45,84,18,3,21,17,29,28,11,18,93,110
2021,2,22100850,2/12/2022,1610612761,Toronto Raptors,1,0,1610612743,Denver Nuggets,0,1,31,23,54,12,22,34,43,45,88,11,6,17,10,39,22,5,7,94,109
2022,2,22200598,1/8/2023,1610612754,Indiana Pacers,1,1,1610612766,Charlotte Hornets,0,0,25,24,49,13,25,38,38,49,87,27,6,33,14,39,27,8,16,104,116
2022,2,22200598,1/8/2023,1610612766,Charlotte Hornets,0,0,1610612754,Indiana Pacers,1,1,27,28,55,11,22,33,38,50,88,24,3,27,17,36,25,14,18,104,111
2022,2,22200343,12/3/2022,1610612757,Portland Trail Blazers,0,1,1610612762,Utah Jazz,1,0,31,29,60,10,15,25,41,44,85,24,7,31,13,36,19,8,13,99,116
2022,2,22200343,12/3/2022,1610612762,Utah Jazz,1,0,1610612757,Portland Trail Blazers,0,1,25,23,48,13,23,36,38,46,84,22,6,28,11,38,20,5,13,98,111
2021,2,22100849,2/12/2022,1610612739,Cleveland Cavaliers,0,0,1610612755,Philadelphia 76ers,1,1,28,25,53,8,16,24,36,41,77,13,2,15,9,34,21,13,17,92,93
2021,2,22100849,2/12/2022,1610612755,Philadelphia 76ers,1,1,1610612739,Cleveland Cavaliers,0,0,28,29,57,10,12,22,38,41,79,17,4,21,10,33,24,3,13,91,103
2021,2,22101214,4/9/2022,1610612754,Indiana Pacers,0,0,1610612755,Philadelphia 76ers,1,1,31,24,55,10,13,23,41,37,78,28,8,36,10,31,28,14,17,102,120
2021,2,22101214,4/9/2022,1610612755,Philadelphia 76ers,1,1,1610612754,Indiana Pacers,0,0,38,18,56,12,22,34,50,40,90,21,6,27,16,26,37,8,15,101,133
2016,2,21600426,12/20/2016,1610612743,Denver Nuggets,0,0,1610612746,LA Clippers,1,1,28,23,51,11,28,39,39,51,90,13,7,20,18,34,22,7,13,97,102
2016,2,21600426,12/20/2016,1610612746,LA Clippers,1,1,1610612743,Denver Nuggets,0,0,31,19,50,16,20,36,47,39,86,9,4,13,8,33,32,5,13,95,119
2022,2,22200596,1/8/2023,1610612755,Philadelphia 76ers,0,1,1610612765,Detroit Pistons,1,0,35,22,57,11,26,37,46,48,94,20,3,23,16,34,24,9,14,104,123
2014,2,21400613,1/19/2015,1610612737,Atlanta Hawks,1,1,1610612765,Detroit Pistons,0,0,28,26,54,9,21,30,37,47,84,10,4,14,8,42,31,6,11,94,93
2014,2,21400613,1/19/2015,1610612765,Detroit Pistons,0,0,1610612737,Atlanta Hawks,1,1,20,27,47,9,26,35,29,53,82,15,11,26,21,39,17,8,19,93,82
2022,2,22200596,1/8/2023,1610612765,Detroit Pistons,1,0,1610612755,Philadelphia 76ers,0,1,36,28,64,8,15,23,44,43,87,15,3,18,14,31,25,12,23,102,111
2022,2,22200342,12/3/2022,1610612744,Golden State Warriors,1,1,1610612745,Houston Rockets,0,0,20,13,33,25,27,52,45,40,85,5,5,10,7,36,34,6,14,96,120
2022,2,22200342,12/3/2022,1610612745,Houston Rockets,0,0,1610612744,Golden State Warriors,1,1,37,26,63,3,25,28,40,51,91,18,2,20,18,34,17,8,15,96,101
2021,2,22100848,2/12/2022,1610612740,New Orleans Pelicans,1,0,1610612759,San Antonio Spurs,0,1,32,23,55,11,21,32,43,44,87,17,3,20,14,31,22,9,15,97,114
2021,2,22100848,2/12/2022,1610612759,San Antonio Spurs,0,1,1610612740,New Orleans Pelicans,1,0,33,23,56,14,23,37,47,46,93,16,3,19,9,38,26,2,5,96,124
2021,2,22101213,4/9/2022,1610612740,New Orleans Pelicans,0,0,1610612763,Memphis Grizzlies,1,1,35,26,61,6,24,30,41,50,91,26,9,35,17,38,23,6,16,106,114
2017,2,21700699,1/23/2018,1610612744,Golden State Warriors,1,1,1610612752,New York Knicks,0,0,33,20,53,13,17,30,46,37,83,18,2,20,5,32,40,4,12,99,123
2017,2,21700699,1/23/2018,1610612752,New York Knicks,0,0,1610612744,Golden State Warriors,1,1,34,27,61,9,13,22,43,40,83,17,2,19,8,33,28,6,14,100,112
2022,2,22200471,12/21/2022,1610612752,New York Knicks,1,0,1610612761,Toronto Raptors,0,1,31,19,50,11,15,26,42,34,76,11,7,18,13,26,25,7,17,88,106
2022,2,22200471,12/21/2022,1610612761,Toronto Raptors,0,1,1610612752,New York Knicks,1,0,33,27,60,9,25,34,42,52,94,20,2,22,21,32,17,2,5,88,113
2021,2,22101213,4/9/2022,1610612763,Memphis Grizzlies,1,1,1610612740,New Orleans Pelicans,0,0,35,20,55,18,17,35,53,37,90,17,6,23,13,26,41,10,19,106,141
2022,2,22200519,12/28/2022,1610612741,Chicago Bulls,1,1,1610612749,Milwaukee Bucks,0,0,33,36,69,9,14,23,42,50,92,26,4,30,12,41,21,7,14,108,119
2022,2,22200480,12/23/2022,1610612746,LA Clippers,0,0,1610612755,Philadelphia 76ers,1,1,27,16,43,14,24,38,41,40,81,18,5,23,8,34,25,7,11,94,114
2017,2,21700698,1/23/2018,1610612739,Cleveland Cavaliers,0,0,1610612759,San Antonio Spurs,1,1,29,22,51,6,15,21,35,37,72,26,5,31,6,33,19,11,18,97,102
2017,2,21700698,1/23/2018,1610612759,San Antonio Spurs,1,1,1610612739,Cleveland Cavaliers,0,0,39,27,66,8,20,28,47,47,94,12,4,16,15,35,23,6,10,98,114
2022,2,22200480,12/23/2022,1610612755,Philadelphia 76ers,1,1,1610612746,LA Clippers,0,0,35,24,59,12,17,29,47,41,88,13,1,14,10,31,31,5,9,92,119
2023,2,22300312,12/13/2023,1610612766,Charlotte Hornets,0,0,1610612748,Miami Heat,1,1,29,17,46,12,19,31,41,36,77,10,1,11,6,31,27,10,21,97,104
2023,2,22300791,2/15/2024,1610612757,Portland Trail Blazers,1,0,1610612750,Minnesota Timberwolves,0,1,23,31,54,8,21,29,31,52,83,21,9,30,12,43,18,8,15,103,91
2014,2,21401133,4/3/2015,1610612750,Minnesota Timberwolves,1,0,1610612753,Orlando Magic,0,1,28,25,53,1,10,11,29,35,64,25,7,32,4,35,15,12,20,94,84
2021,2,22100847,2/12/2022,1610612758,Sacramento Kings,0,1,1610612764,Washington Wizards,1,0,31,17,48,12,16,28,43,33,76,25,4,29,8,27,27,11,14,96,123
2021,2,22100847,2/12/2022,1610612764,Washington Wizards,1,0,1610612758,Sacramento Kings,0,1,28,22,50,13,25,38,41,47,88,15,6,21,14,37,26,4,10,97,110
2016,2,21600958,3/8/2017,1610612743,Denver Nuggets,1,0,1610612764,Washington Wizards,0,1,33,26,59,13,15,28,46,41,87,8,9,17,11,36,31,10,16,98,113
2016,2,21600958,3/8/2017,1610612764,Washington Wizards,0,1,1610612743,Denver Nuggets,1,0,39,23,62,11,15,26,50,38,88,12,7,19,12,29,31,6,12,99,123
2021,2,22101212,4/9/2022,1610612746,LA Clippers,1,1,1610612758,Sacramento Kings,0,0,21,22,43,21,22,43,42,44,86,12,3,15,11,35,29,12,17,98,117
2021,2,22101212,4/9/2022,1610612758,Sacramento Kings,0,0,1610612746,LA Clippers,1,1,31,27,58,7,21,28,38,48,86,15,9,24,12,40,24,7,13,98,98
2014,2,21401133,4/3/2015,1610612753,Orlando Magic,0,1,1610612750,Minnesota Timberwolves,1,0,34,37,71,6,15,21,40,52,92,11,6,17,26,30,23,8,19,94,97
2014,2,21400612,1/19/2015,1610612755,Philadelphia 76ers,0,0,1610612764,Washington Wizards,1,1,22,39,61,6,18,24,28,57,85,14,9,23,14,50,19,8,16,97,76
2016,2,21600050,11/1/2016,1610612752,New York Knicks,0,0,1610612765,Detroit Pistons,1,1,28,36,64,7,15,22,35,51,86,12,3,15,11,42,18,7,12,94,89
2016,2,21600050,11/1/2016,1610612765,Detroit Pistons,1,1,1610612752,New York Knicks,0,0,33,43,76,8,5,13,41,48,89,12,9,21,15,36,19,6,11,95,102
2020,2,22000778,4/7/2021,1610612738,Boston Celtics,1,1,1610612752,New York Knicks,0,0,21,25,46,15,25,40,36,50,86,14,6,20,20,35,22,7,20,95,101
2020,2,22000778,4/7/2021,1610612752,New York Knicks,0,0,1610612738,Boston Celtics,1,1,19,32,51,16,17,33,35,49,84,13,3,16,11,40,22,6,14,96,99
2022,2,22200341,12/3/2022,1610612760,Oklahoma City Thunder,0,1,1610612750,Minnesota Timberwolves,1,0,37,30,67,11,15,26,48,45,93,28,7,35,16,33,26,13,21,114,135
2021,2,22100846,2/12/2022,1610612763,Memphis Grizzlies,0,1,1610612766,Charlotte Hornets,1,0,36,27,63,11,22,33,47,49,96,20,13,33,19,37,31,7,17,108,125
2021,2,22100846,2/12/2022,1610612766,Charlotte Hornets,1,0,1610612763,Memphis Grizzlies,0,1,25,27,52,14,31,45,39,58,97,26,7,33,21,43,28,11,17,109,118
2021,2,22101211,4/8/2022,1610612747,Los Angeles Lakers,1,1,1610612760,Oklahoma City Thunder,0,0,32,19,51,9,22,31,41,41,82,29,10,39,10,36,23,5,10,100,120
2021,2,22101211,4/8/2022,1610612760,Oklahoma City Thunder,0,0,1610612747,Los Angeles Lakers,1,1,34,25,59,6,23,29,40,48,88,15,4,19,12,40,21,8,14,98,101
2014,2,21400319,12/10/2014,1610612737,Atlanta Hawks,1,1,1610612755,Philadelphia 76ers,0,0,28,33,61,10,20,30,38,53,91,9,4,13,23,32,26,10,18,93,95
2020,2,22000504,2/26/2021,1610612758,Sacramento Kings,0,1,1610612765,Detroit Pistons,1,0,30,27,57,7,25,32,37,52,89,29,12,41,21,37,24,6,11,99,110
2020,2,22000504,2/26/2021,1610612765,Detroit Pistons,1,0,1610612758,Sacramento Kings,0,1,25,24,49,12,21,33,37,45,82,21,11,32,11,41,20,5,11,99,107
2016,2,21600957,3/8/2017,1610612758,Sacramento Kings,0,0,1610612759,San Antonio Spurs,1,1,35,32,67,7,12,19,42,44,86,13,3,16,8,38,20,9,14,98,104
2016,2,21600957,3/8/2017,1610612759,San Antonio Spurs,1,1,1610612758,Sacramento Kings,0,0,28,27,55,14,15,29,42,42,84,16,5,21,8,37,33,7,12,97,114
2017,2,21700697,1/23/2018,1610612751,Brooklyn Nets,0,0,1610612760,Oklahoma City Thunder,1,1,21,20,41,16,22,38,37,42,79,18,7,25,11,34,27,7,14,95,108
2023,2,22300791,2/15/2024,1610612750,Minnesota Timberwolves,0,1,1610612757,Portland Trail Blazers,1,0,35,24,59,11,19,30,46,43,89,25,2,27,13,31,24,8,14,102,128
2014,2,21401132,4/3/2015,1610612760,Oklahoma City Thunder,0,0,1610612763,Memphis Grizzlies,1,1,32,39,71,4,13,17,36,52,88,16,10,26,15,42,18,7,12,97,92
2021,2,22100845,2/12/2022,1610612752,New York Knicks,0,0,1610612757,Portland Trail Blazers,1,1,19,23,42,12,27,39,31,50,81,29,5,34,10,43,19,3,13,98,103
2021,2,22100845,2/12/2022,1610612757,Portland Trail Blazers,1,1,1610612752,New York Knicks,0,0,25,19,44,15,25,40,40,44,84,17,3,20,12,34,29,6,17,99,112
2017,2,21700697,1/23/2018,1610612760,Oklahoma City Thunder,1,1,1610612751,Brooklyn Nets,0,0,33,36,69,7,18,25,40,54,94,22,10,32,18,42,12,1,4,96,109
2021,2,22101210,4/8/2022,1610612756,Phoenix Suns,0,1,1610612762,Utah Jazz,1,0,40,33,73,6,13,19,46,46,92,13,2,15,14,32,27,8,13,98,111
2021,2,22101210,4/8/2022,1610612762,Utah Jazz,1,0,1610612756,Phoenix Suns,0,1,24,26,50,11,27,38,35,53,88,24,9,33,17,39,20,7,11,99,105
2023,2,22300003,11/3/2023,1610612764,Washington Wizards,0,0,1610612748,Miami Heat,1,1,33,20,53,13,15,28,46,35,81,9,8,17,7,32,33,9,20,102,114
2014,2,21401132,4/3/2015,1610612763,Memphis Grizzlies,1,1,1610612760,Oklahoma City Thunder,0,0,34,25,59,4,17,21,38,42,80,20,8,28,10,36,16,7,13,97,100
2016,2,21600425,12/20/2016,1610612745,Houston Rockets,1,0,1610612759,San Antonio Spurs,0,1,29,25,54,6,32,38,35,57,92,24,3,27,24,35,22,13,17,97,100
2016,2,21600425,12/20/2016,1610612759,San Antonio Spurs,0,1,1610612745,Houston Rockets,1,0,24,30,54,12,11,23,36,41,77,18,7,25,11,32,21,10,19,97,102
2020,2,22000777,4/7/2021,1610612753,Orlando Magic,1,0,1610612764,Washington Wizards,0,1,32,30,62,12,19,31,44,49,93,16,7,23,16,36,22,7,11,96,116
2020,2,22000777,4/7/2021,1610612764,Washington Wizards,0,1,1610612753,Orlando Magic,1,0,30,19,49,19,17,36,49,36,85,14,2,16,7,31,35,11,13,96,131
2022,2,22200340,12/3/2022,1610612753,Orlando Magic,0,0,1610612761,Toronto Raptors,1,1,27,23,50,11,17,28,38,40,78,21,5,26,9,31,23,12,16,98,108
2022,2,22200340,12/3/2022,1610612761,Toronto Raptors,1,1,1610612753,Orlando Magic,0,0,38,17,55,9,20,29,47,37,84,18,7,25,15,26,31,9,17,98,121
2020,2,22000503,2/25/2021,1610612740,New Orleans Pelicans,0,0,1610612749,Milwaukee Bucks,1,1,38,25,63,13,26,39,51,51,102,10,4,14,16,37,32,4,9,102,125
2020,2,22000503,2/25/2021,1610612749,Milwaukee Bucks,1,1,1610612740,New Orleans Pelicans,0,0,39,26,65,13,18,31,52,44,96,12,4,16,11,36,21,5,9,103,129
2014,2,21400319,12/10/2014,1610612755,Philadelphia 76ers,0,0,1610612737,Atlanta Hawks,1,1,24,23,47,6,19,25,30,42,72,13,9,22,8,40,21,15,18,92,79
2017,2,21700696,1/23/2018,1610612753,Orlando Magic,1,0,1610612758,Sacramento Kings,0,1,25,27,52,11,20,31,36,47,83,16,3,19,15,34,23,9,17,93,99
2017,2,21700696,1/23/2018,1610612758,Sacramento Kings,0,1,1610612753,Orlando Magic,1,0,35,26,61,8,18,26,43,44,87,11,2,13,15,30,24,9,14,94,105
2022,2,22200339,12/3/2022,1610612749,Milwaukee Bucks,0,1,1610612766,Charlotte Hornets,1,0,27,24,51,12,20,32,39,44,83,15,4,19,10,36,24,9,22,104,105
2022,2,22200339,12/3/2022,1610612766,Charlotte Hornets,1,0,1610612749,Milwaukee Bucks,0,1,29,34,63,5,19,24,34,53,87,23,3,26,11,43,15,5,14,103,96
2021,2,22100844,2/11/2022,1610612753,Orlando Magic,0,0,1610612762,Utah Jazz,1,1,24,25,49,13,22,35,37,47,84,12,4,16,9,39,23,15,18,99,99
2016,2,21600956,3/8/2017,1610612754,Indiana Pacers,1,1,1610612765,Detroit Pistons,0,0,33,32,65,11,12,23,44,44,88,16,3,19,10,35,27,4,5,91,115
2021,2,22101209,4/8/2022,1610612742,Dallas Mavericks,1,1,1610612757,Portland Trail Blazers,0,0,22,12,34,20,25,45,42,37,79,24,7,31,13,27,25,9,15,96,128
2021,2,22101209,4/8/2022,1610612757,Portland Trail Blazers,0,0,1610612742,Dallas Mavericks,1,1,24,27,51,7,25,32,31,52,83,9,3,12,9,45,20,9,17,96,78
2022,2,22200452,12/19/2022,1610612739,Cleveland Cavaliers,1,1,1610612762,Utah Jazz,0,0,28,16,44,15,11,26,43,27,70,21,5,26,6,22,24,9,23,99,122
2022,2,22200452,12/19/2022,1610612762,Utah Jazz,0,0,1610612739,Cleveland Cavaliers,1,1,26,33,59,10,24,34,36,57,93,17,6,23,19,42,19,5,14,101,99
2016,2,21600956,3/8/2017,1610612765,Detroit Pistons,0,0,1610612754,Indiana Pacers,1,1,32,31,63,7,19,26,39,50,89,13,9,22,17,38,20,3,10,92,98
2022,2,22200499,12/26/2022,1610612746,LA Clippers,0,1,1610612765,Detroit Pistons,1,0,30,17,47,19,25,44,49,42,91,25,4,29,11,31,25,10,19,112,142
2022,2,22200499,12/26/2022,1610612765,Detroit Pistons,1,0,1610612746,LA Clippers,0,1,28,38,66,16,18,34,44,56,100,27,7,34,20,40,32,13,18,112,131
2014,2,21400612,1/19/2015,1610612764,Washington Wizards,1,1,1610612755,Philadelphia 76ers,0,0,38,30,68,7,6,13,45,36,81,14,4,18,16,22,26,11,23,96,111
2022,2,22200338,12/3/2022,1610612746,LA Clippers,1,0,1610612758,Sacramento Kings,0,1,24,36,60,9,24,33,33,60,93,21,5,26,23,39,15,7,18,101,96
2014,2,21400318,12/10/2014,1610612753,Orlando Magic,1,0,1610612764,Washington Wizards,0,1,31,38,69,7,8,15,38,46,84,6,3,9,12,34,13,5,10,86,89
2022,2,22200338,12/3/2022,1610612758,Sacramento Kings,0,1,1610612746,LA Clippers,1,0,35,22,57,11,21,32,46,43,89,20,10,30,10,39,31,4,9,100,123
2021,2,22100844,2/11/2022,1610612762,Utah Jazz,1,1,1610612753,Orlando Magic,0,0,27,21,48,13,28,41,40,49,89,21,3,24,15,35,22,12,16,101,114
2014,2,21400611,1/19/2015,1610612750,Minnesota Timberwolves,0,0,1610612766,Charlotte Hornets,1,1,23,38,61,6,13,19,29,51,80,16,4,20,13,40,16,8,17,93,80
2016,2,21600955,3/8/2017,1610612746,LA Clippers,0,0,1610612750,Minnesota Timberwolves,1,1,26,33,59,9,15,24,35,48,83,12,6,18,14,36,18,10,17,93,91
2016,2,21600955,3/8/2017,1610612750,Minnesota Timberwolves,1,1,1610612746,LA Clippers,0,0,37,29,66,5,15,20,42,44,86,18,2,20,18,28,26,9,14,91,107
2014,2,21400611,1/19/2015,1610612766,Charlotte Hornets,1,1,1610612750,Minnesota Timberwolves,0,0,28,39,67,12,10,22,40,49,89,13,6,19,17,36,27,7,11,93,105
2022,2,22200519,12/28/2022,1610612749,Milwaukee Bucks,0,0,1610612741,Chicago Bulls,1,1,32,34,66,9,35,44,41,69,110,22,10,32,26,50,18,5,14,109,113
2017,2,21700695,1/22/2018,1610612746,LA Clippers,1,0,1610612750,Minnesota Timberwolves,0,1,38,19,57,9,18,27,47,37,84,15,7,22,10,29,31,5,17,105,118
2017,2,21700695,1/22/2018,1610612750,Minnesota Timberwolves,0,1,1610612746,LA Clippers,1,0,36,33,69,7,15,22,43,48,91,33,6,39,20,33,20,4,15,105,126
2014,2,21400318,12/10/2014,1610612764,Washington Wizards,0,1,1610612753,Orlando Magic,1,0,36,33,69,5,7,12,41,40,81,4,5,9,10,31,26,7,10,86,91
2022,2,22200337,12/3/2022,1610612742,Dallas Mavericks,0,1,1610612752,New York Knicks,1,0,19,20,39,24,37,61,43,57,100,11,3,14,17,42,27,7,11,100,121
2022,2,22200337,12/3/2022,1610612752,New York Knicks,1,0,1610612742,Dallas Mavericks,0,1,25,21,46,10,21,31,35,42,77,20,8,28,9,38,18,7,20,101,100
2016,2,21600049,11/1/2016,1610612748,Miami Heat,1,1,1610612758,Sacramento Kings,0,0,24,33,57,13,16,29,37,49,86,21,8,29,10,45,24,4,17,103,108
2016,2,21600049,11/1/2016,1610612758,Sacramento Kings,0,0,1610612748,Miami Heat,1,1,29,37,66,5,18,23,34,55,89,23,4,27,15,42,12,10,15,104,96
2020,2,22000776,4/7/2021,1610612750,Minnesota Timberwolves,0,0,1610612754,Indiana Pacers,1,1,38,25,63,10,18,28,48,43,91,31,9,40,17,28,30,6,13,105,137
2020,2,22000776,4/7/2021,1610612754,Indiana Pacers,1,1,1610612750,Minnesota Timberwolves,0,0,41,24,65,14,14,28,55,38,93,17,2,19,9,30,32,7,13,105,141
2017,2,21700694,1/22/2018,1610612743,Denver Nuggets,1,1,1610612757,Portland Trail Blazers,0,0,24,29,53,10,20,30,34,49,83,26,7,33,17,35,23,11,15,95,104
2017,2,21700694,1/22/2018,1610612757,Portland Trail Blazers,0,0,1610612743,Denver Nuggets,1,1,28,32,60,8,17,25,36,49,85,21,5,26,15,38,19,7,12,95,101
2016,2,21600424,12/20/2016,1610612738,Boston Celtics,0,1,1610612763,Memphis Grizzlies,1,0,21,23,44,12,25,37,33,48,81,34,4,38,11,38,22,10,13,101,112
2016,2,21600424,12/20/2016,1610612763,Memphis Grizzlies,1,0,1610612738,Boston Celtics,0,1,26,38,64,12,18,30,38,56,94,21,5,26,20,37,23,7,13,99,109
2014,2,21400610,1/18/2015,1610612759,San Antonio Spurs,1,1,1610612762,Utah Jazz,0,0,23,40,63,8,9,17,31,49,80,19,4,23,12,40,23,7,10,89,89
2014,2,21400610,1/18/2015,1610612762,Utah Jazz,0,0,1610612759,San Antonio Spurs,1,1,25,49,74,3,7,10,28,56,84,10,6,16,18,41,23,8,15,88,69
2022,2,22200336,12/2/2022,1610612741,Chicago Bulls,0,0,1610612744,Golden State Warriors,1,1,34,32,66,9,18,27,43,50,93,16,8,24,8,47,28,2,12,107,111
2022,2,22200524,12/29/2022,1610612739,Cleveland Cavaliers,0,0,1610612754,Indiana Pacers,1,1,38,30,68,12,16,28,50,46,96,14,6,20,18,30,29,6,11,98,126
2022,2,22200524,12/29/2022,1610612754,Indiana Pacers,1,1,1610612739,Cleveland Cavaliers,0,0,29,25,54,19,12,31,48,37,85,20,1,21,6,31,28,7,9,98,135
2017,2,21700693,1/22/2018,1610612742,Dallas Mavericks,1,1,1610612764,Washington Wizards,0,0,28,28,56,10,21,31,38,49,87,12,5,17,14,36,20,7,11,93,98
2022,2,22200586,1/6/2023,1610612740,New Orleans Pelicans,1,0,1610612751,Brooklyn Nets,0,1,23,36,59,12,17,29,35,53,88,20,5,25,20,35,16,8,16,93,102
2022,2,22200336,12/2/2022,1610612744,Golden State Warriors,1,1,1610612741,Chicago Bulls,0,0,22,15,37,20,30,50,42,45,87,15,8,23,11,39,32,7,20,107,119
2017,2,21700693,1/22/2018,1610612764,Washington Wizards,0,0,1610612742,Dallas Mavericks,1,1,19,35,54,7,25,32,26,60,86,16,11,27,18,47,15,9,12,92,75
2016,2,21600954,3/8/2017,1610612745,Houston Rockets,1,0,1610612762,Utah Jazz,0,1,27,20,47,8,24,32,35,44,79,30,10,40,11,36,22,2,8,94,108
2016,2,21600954,3/8/2017,1610612762,Utah Jazz,0,1,1610612745,Houston Rockets,1,0,29,16,45,12,19,31,41,35,76,21,3,24,14,22,21,9,19,92,115
2016,2,21600423,12/20/2016,1610612739,Cleveland Cavaliers,0,1,1610612749,Milwaukee Bucks,1,0,20,31,51,17,23,40,37,54,91,23,4,27,14,42,19,6,10,102,114
2016,2,21600423,12/20/2016,1610612749,Milwaukee Bucks,1,0,1610612739,Cleveland Cavaliers,0,1,33,27,60,7,20,27,40,47,87,21,8,29,14,37,22,5,15,102,108
2014,2,21401131,4/3/2015,1610612741,Chicago Bulls,1,1,1610612765,Detroit Pistons,0,0,29,39,68,4,13,17,33,52,85,18,3,21,22,31,18,9,12,87,88
2014,2,21401131,4/3/2015,1610612765,Detroit Pistons,0,0,1610612741,Chicago Bulls,1,1,26,29,55,6,13,19,32,42,74,12,3,15,14,30,14,9,18,87,82
2014,2,21400609,1/18/2015,1610612753,Orlando Magic,1,0,1610612760,Oklahoma City Thunder,0,1,27,38,65,8,15,23,35,53,88,21,6,27,12,46,18,12,18,105,99
2014,2,21400609,1/18/2015,1610612760,Oklahoma City Thunder,0,1,1610612753,Orlando Magic,1,0,39,19,58,9,16,25,48,35,83,22,10,32,12,28,28,9,20,104,127
2021,2,22100842,2/11/2022,1610612738,Boston Celtics,1,1,1610612743,Denver Nuggets,0,0,28,31,59,10,27,37,38,58,96,22,8,30,19,41,24,7,12,103,108
2021,2,22100842,2/11/2022,1610612743,Denver Nuggets,0,0,1610612738,Boston Celtics,1,1,28,18,46,11,33,44,39,51,90,13,5,18,17,37,23,13,21,104,102
2020,2,22000502,2/25/2021,1610612743,Denver Nuggets,1,0,1610612764,Washington Wizards,0,1,22,25,47,15,23,38,37,48,85,21,3,24,16,33,23,9,18,100,110
2020,2,22000502,2/25/2021,1610612764,Washington Wizards,0,1,1610612743,Denver Nuggets,1,0,33,27,60,8,18,26,41,45,86,22,3,25,11,35,24,6,11,99,112
2021,2,22101207,4/8/2022,1610612737,Atlanta Hawks,0,0,1610612748,Miami Heat,1,1,34,20,54,8,26,34,42,46,88,17,2,19,17,31,17,9,15,96,109
2021,2,22101207,4/8/2022,1610612748,Miami Heat,1,1,1610612737,Atlanta Hawks,0,0,29,17,46,11,15,26,40,32,72,22,6,28,6,30,20,9,17,96,113
2014,2,21400317,12/10/2014,1610612746,LA Clippers,0,1,1610612754,Indiana Pacers,1,0,35,29,64,7,17,24,42,46,88,12,2,14,12,34,25,6,13,95,103
2014,2,21400317,12/10/2014,1610612754,Indiana Pacers,1,0,1610612746,LA Clippers,0,1,26,36,62,9,18,27,35,54,89,17,5,22,17,40,27,7,12,96,96
2022,2,22200466,12/21/2022,1610612739,Cleveland Cavaliers,1,1,1610612749,Milwaukee Bucks,0,0,31,22,53,10,22,32,41,44,85,22,6,28,12,34,22,7,11,96,114
2022,2,22200466,12/21/2022,1610612749,Milwaukee Bucks,0,0,1610612739,Cleveland Cavaliers,1,1,26,27,53,13,17,30,39,44,83,15,7,22,16,32,20,8,20,97,106
2022,2,22200335,12/2/2022,1610612754,Indiana Pacers,0,0,1610612762,Utah Jazz,1,1,28,30,58,12,22,34,40,52,92,27,6,33,13,44,25,7,19,115,119
2022,2,22200335,12/2/2022,1610612762,Utah Jazz,1,1,1610612754,Indiana Pacers,0,0,31,18,49,15,19,34,46,37,83,32,5,37,12,29,29,12,26,114,139
2021,2,22100841,2/11/2022,1610612737,Atlanta Hawks,1,0,1610612759,San Antonio Spurs,0,1,33,27,60,14,29,43,47,56,103,13,2,15,20,37,28,11,14,106,121
2021,2,22100841,2/11/2022,1610612759,San Antonio Spurs,0,1,1610612737,Atlanta Hawks,1,0,32,26,58,18,14,32,50,40,90,18,3,21,8,34,37,10,14,106,136
2022,2,22200586,1/6/2023,1610612751,Brooklyn Nets,0,1,1610612740,New Orleans Pelicans,1,0,22,30,52,15,18,33,37,48,85,19,1,20,12,37,26,7,13,95,108
2021,2,22101206,4/8/2022,1610612745,Houston Rockets,0,0,1610612761,Toronto Raptors,1,1,33,19,52,10,19,29,43,38,81,19,5,24,9,31,24,13,19,102,115
2021,2,22101206,4/8/2022,1610612761,Toronto Raptors,1,1,1610612745,Houston Rockets,0,0,37,30,67,7,22,29,44,52,96,22,1,23,14,38,20,6,10,101,117
2014,2,21400608,1/18/2015,1610612740,New Orleans Pelicans,0,1,1610612761,Toronto Raptors,1,0,34,31,65,5,12,17,39,43,82,12,8,20,16,32,19,9,18,93,95
2014,2,21400608,1/18/2015,1610612761,Toronto Raptors,1,0,1610612740,New Orleans Pelicans,0,1,24,23,47,7,18,25,31,41,72,24,5,29,8,34,18,8,15,93,93
2022,2,22200590,1/6/2023,1610612737,Atlanta Hawks,0,0,1610612747,Los Angeles Lakers,1,1,35,30,65,9,22,31,44,52,96,17,5,22,10,45,24,6,12,108,114
2022,2,22200590,1/6/2023,1610612747,Los Angeles Lakers,1,1,1610612737,Atlanta Hawks,0,0,35,23,58,16,19,35,51,42,93,12,4,16,10,34,33,8,18,108,130
2014,2,21400316,12/10/2014,1610612738,Boston Celtics,0,0,1610612766,Charlotte Hornets,1,1,33,31,64,5,18,23,38,49,87,6,4,10,11,40,26,5,15,97,87
2014,2,21400316,12/10/2014,1610612766,Charlotte Hornets,1,1,1610612738,Boston Celtics,0,0,32,38,70,3,11,14,35,49,84,23,6,29,10,42,18,3,11,96,96
2022,2,22200334,12/2/2022,1610612745,Houston Rockets,0,1,1610612756,Phoenix Suns,1,0,32,25,57,8,16,24,40,41,81,34,9,43,17,29,19,9,17,98,122
2022,2,22200334,12/2/2022,1610612756,Phoenix Suns,1,0,1610612745,Houston Rockets,0,1,28,20,48,17,20,37,45,40,85,14,5,19,13,29,30,12,18,100,121
2017,2,21700692,1/22/2018,1610612740,New Orleans Pelicans,1,1,1610612741,Chicago Bulls,0,0,31,38,69,16,28,44,47,66,113,22,4,26,18,50,32,8,13,122,132
2017,2,21700692,1/22/2018,1610612741,Chicago Bulls,0,0,1610612740,New Orleans Pelicans,1,1,37,24,61,8,23,31,45,47,92,30,4,34,9,42,31,14,24,121,128
2021,2,22101205,4/8/2022,1610612739,Cleveland Cavaliers,0,0,1610612751,Brooklyn Nets,1,1,32,23,55,8,19,27,40,42,82,19,5,24,11,34,19,5,9,92,107
2021,2,22101205,4/8/2022,1610612751,Brooklyn Nets,1,1,1610612739,Cleveland Cavaliers,0,0,31,29,60,12,20,32,43,49,92,20,1,21,21,28,30,4,11,91,118
2014,2,21400607,1/17/2015,1610612746,LA Clippers,0,1,1610612758,Sacramento Kings,1,0,35,29,64,9,19,28,44,48,92,20,11,31,18,35,24,3,5,96,117
2014,2,21400607,1/17/2015,1610612758,Sacramento Kings,1,0,1610612746,LA Clippers,0,1,36,35,71,5,13,18,41,48,89,21,5,26,25,25,18,7,18,96,108
2023,2,22300235,11/22/2023,1610612759,San Antonio Spurs,1,0,1610612746,LA Clippers,0,1,24,29,53,11,27,38,35,56,91,21,2,23,14,42,26,10,14,103,102
2017,2,21700691,1/22/2018,1610612749,Milwaukee Bucks,1,1,1610612756,Phoenix Suns,0,0,33,21,54,5,12,17,38,33,71,28,9,37,10,27,20,12,18,95,109
2017,2,21700691,1/22/2018,1610612756,Phoenix Suns,0,0,1610612749,Milwaukee Bucks,1,1,30,23,53,9,17,26,39,40,79,18,2,20,14,26,31,14,22,96,105
2023,2,22300198,11/15/2023,1610612747,Los Angeles Lakers,1,0,1610612758,Sacramento Kings,0,1,31,23,54,11,18,29,42,41,83,15,4,19,7,36,25,20,23,107,110
2016,2,21600422,12/20/2016,1610612748,Miami Heat,1,0,1610612753,Orlando Magic,0,1,38,40,78,12,18,30,50,58,108,18,8,26,17,43,22,3,12,117,130
2016,2,21600422,12/20/2016,1610612753,Orlando Magic,0,1,1610612748,Miami Heat,1,0,41,42,83,11,11,22,52,53,105,21,10,31,16,44,24,4,11,115,136
2022,2,22200333,12/2/2022,1610612740,New Orleans Pelicans,0,1,1610612759,San Antonio Spurs,1,0,28,22,50,12,30,42,40,52,92,25,1,26,10,43,25,4,9,102,117
2014,2,21400315,12/9/2014,1610612747,Los Angeles Lakers,1,1,1610612758,Sacramento Kings,0,0,33,38,71,5,20,25,38,58,96,17,8,25,20,42,27,3,5,93,98
2016,2,21600953,3/8/2017,1610612740,New Orleans Pelicans,1,0,1610612761,Toronto Raptors,0,1,25,26,51,9,20,29,34,46,80,10,3,13,11,35,22,6,14,88,87
2014,2,21401130,4/3/2015,1610612751,Brooklyn Nets,1,1,1610612761,Toronto Raptors,0,0,41,31,72,5,11,16,46,42,88,17,6,23,19,27,21,5,9,89,114
2022,2,22200333,12/2/2022,1610612759,San Antonio Spurs,1,0,1610612740,New Orleans Pelicans,0,1,27,32,59,11,28,39,38,60,98,12,4,16,16,46,26,9,12,103,99
2016,2,21600953,3/8/2017,1610612761,Toronto Raptors,0,1,1610612740,New Orleans Pelicans,1,0,28,27,55,8,13,21,36,40,76,14,9,23,10,34,21,6,12,88,94
2014,2,21401130,4/3/2015,1610612761,Toronto Raptors,0,0,1610612751,Brooklyn Nets,1,1,34,22,56,8,18,26,42,40,82,17,6,23,17,25,24,10,16,89,109
2021,2,22101204,4/8/2022,1610612752,New York Knicks,0,1,1610612764,Washington Wizards,1,0,25,24,49,16,23,39,41,47,88,16,4,20,11,37,27,5,10,97,114
2021,2,22101204,4/8/2022,1610612764,Washington Wizards,1,0,1610612752,New York Knicks,0,1,26,15,41,9,19,28,35,34,69,13,4,17,2,33,21,13,22,96,92
2022,2,22200621,1/11/2023,1610612738,Boston Celtics,1,1,1610612740,New Orleans Pelicans,0,0,29,18,47,15,29,44,44,47,91,22,3,25,13,35,24,5,9,100,125
2023,2,22300003,11/3/2023,1610612748,Miami Heat,1,1,1610612764,Washington Wizards,0,0,35,18,53,13,14,27,48,32,80,12,2,14,7,26,35,7,21,100,121
2017,2,21700690,1/22/2018,1610612755,Philadelphia 76ers,0,0,1610612763,Memphis Grizzlies,1,1,18,22,40,14,17,31,32,39,71,23,8,31,19,24,21,14,24,94,101
2017,2,21700690,1/22/2018,1610612763,Memphis Grizzlies,1,1,1610612755,Philadelphia 76ers,0,0,23,29,52,10,16,26,33,45,78,29,6,35,14,33,14,2,12,92,105
2022,2,22200332,12/2/2022,1610612755,Philadelphia 76ers,0,0,1610612763,Memphis Grizzlies,1,1,26,32,58,14,19,33,40,51,91,15,2,17,13,39,23,8,13,100,109
2022,2,22200332,12/2/2022,1610612763,Memphis Grizzlies,1,1,1610612755,Philadelphia 76ers,0,0,31,36,67,11,19,30,42,55,97,22,6,28,22,36,22,7,12,99,117
2021,2,22100840,2/11/2022,1610612755,Philadelphia 76ers,1,1,1610612760,Oklahoma City Thunder,0,0,29,38,67,7,19,26,36,57,93,21,5,26,18,42,19,6,11,97,100
2021,2,22100840,2/11/2022,1610612760,Oklahoma City Thunder,0,0,1610612755,Philadelphia 76ers,1,1,29,26,55,6,29,35,35,55,90,11,1,12,16,40,21,7,16,98,87
2014,2,21400315,12/9/2014,1610612758,Sacramento Kings,0,0,1610612747,Los Angeles Lakers,1,1,25,30,55,7,8,15,32,38,70,24,13,37,11,34,20,9,16,94,95
2016,2,21600952,3/8/2017,1610612749,Milwaukee Bucks,1,1,1610612752,New York Knicks,0,0,29,31,60,8,18,26,37,49,86,22,6,28,15,37,26,4,8,93,104
2016,2,21600952,3/8/2017,1610612752,New York Knicks,0,0,1610612749,Milwaukee Bucks,1,1,32,31,63,7,14,21,39,45,84,8,4,12,12,37,22,9,16,93,93
2021,2,22101203,4/8/2022,1610612749,Milwaukee Bucks,0,1,1610612765,Detroit Pistons,1,0,39,25,64,11,26,37,50,51,101,20,3,23,14,39,29,6,8,104,131
2021,2,22101203,4/8/2022,1610612765,Detroit Pistons,1,0,1610612749,Milwaukee Bucks,0,1,25,17,42,10,38,48,35,55,90,21,2,23,12,44,27,7,14,103,101
2019,2,21900220,11/22/2019,1610612747,Los Angeles Lakers,0,1,1610612760,Oklahoma City Thunder,1,0,28,29,57,17,14,31,45,43,88,23,6,29,14,33,32,7,15,102,130
2019,2,21900220,11/22/2019,1610612760,Oklahoma City Thunder,1,0,1610612747,Los Angeles Lakers,0,1,38,24,62,11,20,31,49,44,93,18,2,20,10,35,28,8,13,102,127
2021,2,22100839,2/11/2022,1610612739,Cleveland Cavaliers,0,1,1610612754,Indiana Pacers,1,0,34,23,57,9,15,24,43,38,81,25,5,30,9,31,20,9,13,98,120
2021,2,22100839,2/11/2022,1610612754,Indiana Pacers,1,0,1610612739,Cleveland Cavaliers,0,1,24,27,51,18,20,38,42,47,89,11,5,16,21,28,25,12,23,99,113
2014,2,21401129,4/3/2015,1610612738,Boston Celtics,1,0,1610612749,Milwaukee Bucks,0,1,31,33,64,8,16,24,39,49,88,15,1,16,11,38,19,10,17,101,101
2014,2,21401129,4/3/2015,1610612749,Milwaukee Bucks,0,1,1610612738,Boston Celtics,1,0,36,25,61,9,15,24,45,40,85,11,7,18,12,33,31,7,18,99,110
2021,2,22101202,4/7/2022,1610612744,Golden State Warriors,1,1,1610612747,Los Angeles Lakers,0,0,35,30,65,16,16,32,51,46,97,10,0,10,12,34,39,8,15,105,128
2021,2,22101202,4/7/2022,1610612747,Los Angeles Lakers,0,0,1610612744,Golden State Warriors,1,1,28,23,51,9,23,32,37,46,83,29,9,38,12,36,14,10,19,106,112
2016,2,21600421,12/20/2016,1610612752,New York Knicks,1,1,1610612754,Indiana Pacers,0,0,31,34,65,13,10,23,44,44,88,17,4,21,10,34,24,10,15,104,118
2016,2,21600421,12/20/2016,1610612754,Indiana Pacers,0,0,1610612752,New York Knicks,1,1,33,35,68,6,17,23,39,52,91,27,6,33,13,43,22,6,9,103,111
2017,2,21700689,1/22/2018,1610612745,Houston Rockets,1,1,1610612748,Miami Heat,0,0,21,23,44,15,22,37,36,45,81,12,6,18,11,37,20,7,14,92,99
2017,2,21700689,1/22/2018,1610612748,Miami Heat,0,0,1610612745,Houston Rockets,1,1,32,20,52,7,23,30,39,43,82,5,4,9,12,33,18,10,18,92,90
2014,2,21400314,12/9/2014,1610612759,San Antonio Spurs,0,0,1610612762,Utah Jazz,1,1,35,29,64,4,16,20,39,45,84,14,9,23,14,37,23,5,13,94,96
2014,2,21400314,12/9/2014,1610612762,Utah Jazz,1,1,1610612759,San Antonio Spurs,0,0,36,30,66,4,10,14,40,40,80,16,6,22,16,27,18,12,19,93,100
2022,2,22200331,12/2/2022,1610612747,Los Angeles Lakers,0,1,1610612749,Milwaukee Bucks,1,0,41,29,70,11,15,26,52,44,96,18,6,24,14,33,32,2,4,99,133
2022,2,22200331,12/2/2022,1610612749,Milwaukee Bucks,1,0,1610612747,Los Angeles Lakers,0,1,33,18,51,17,26,43,50,44,94,12,3,15,12,35,29,6,10,98,129
2021,2,22100838,2/11/2022,1610612765,Detroit Pistons,1,0,1610612766,Charlotte Hornets,0,1,36,31,67,12,23,35,48,54,102,11,7,18,21,37,32,13,18,108,119
2021,2,22100838,2/11/2022,1610612766,Charlotte Hornets,0,1,1610612765,Detroit Pistons,1,0,36,19,55,18,24,42,54,43,97,15,8,23,17,30,36,10,18,108,141
2020,2,22000501,2/25/2021,1610612746,LA Clippers,0,0,1610612763,Memphis Grizzlies,1,1,22,28,50,12,22,34,34,50,84,14,2,16,9,41,19,7,14,97,94
2017,2,21700688,1/22/2018,1610612737,Atlanta Hawks,1,1,1610612762,Utah Jazz,0,0,28,29,57,12,14,26,40,43,83,12,0,12,11,32,24,8,18,95,104
2014,2,21400313,12/9/2014,1610612748,Miami Heat,0,1,1610612756,Phoenix Suns,1,0,34,29,63,9,8,17,43,37,80,8,4,12,11,29,25,7,12,87,103
2017,2,21700688,1/22/2018,1610612762,Utah Jazz,0,0,1610612737,Atlanta Hawks,1,1,29,32,61,4,11,15,33,43,76,20,8,28,11,36,20,8,17,94,90
2014,2,21400606,1/17/2015,1610612743,Denver Nuggets,1,0,1610612750,Minnesota Timberwolves,0,1,28,33,61,10,21,31,38,54,92,19,3,22,17,39,21,6,10,95,105
2014,2,21400606,1/17/2015,1610612750,Minnesota Timberwolves,0,1,1610612743,Denver Nuggets,1,0,35,26,61,8,11,19,43,37,80,19,2,21,10,28,24,10,15,94,113
2021,2,22101201,4/7/2022,1610612743,Denver Nuggets,1,1,1610612763,Memphis Grizzlies,0,0,32,18,50,12,18,30,44,36,80,22,3,25,11,25,27,8,19,99,122
2021,2,22101201,4/7/2022,1610612763,Memphis Grizzlies,0,0,1610612743,Denver Nuggets,1,1,31,30,61,11,17,28,42,47,89,14,5,19,10,39,30,7,13,100,109
2022,2,22200330,12/2/2022,1610612739,Cleveland Cavaliers,1,1,1610612753,Orlando Magic,0,0,25,17,42,16,26,42,41,43,84,9,0,9,10,33,22,6,13,92,107
2022,2,22200330,12/2/2022,1610612753,Orlando Magic,0,0,1610612739,Cleveland Cavaliers,1,1,32,26,58,8,15,23,40,41,81,8,4,12,13,30,19,7,18,91,96
2020,2,22000501,2/25/2021,1610612763,Memphis Grizzlies,1,1,1610612746,LA Clippers,0,0,39,34,73,11,8,19,50,42,92,11,5,16,9,37,27,4,7,98,122
2017,2,21700687,1/22/2018,1610612758,Sacramento Kings,0,0,1610612766,Charlotte Hornets,1,1,33,42,75,10,12,22,43,54,97,11,4,15,13,41,27,4,9,100,107
2019,2,21900003,10/23/2019,1610612741,Chicago Bulls,0,0,1610612766,Charlotte Hornets,1,1,40,35,75,9,21,30,49,56,105,18,4,22,23,34,25,3,12,103,125
2017,2,21700687,1/22/2018,1610612766,Charlotte Hornets,1,1,1610612758,Sacramento Kings,0,0,22,24,46,16,24,40,38,48,86,20,5,25,16,33,22,8,17,99,112
2014,2,21400313,12/9/2014,1610612756,Phoenix Suns,1,0,1610612748,Miami Heat,0,1,20,22,42,17,18,35,37,40,77,6,3,9,16,25,24,14,23,88,97
2019,2,21900003,10/23/2019,1610612766,Charlotte Hornets,1,1,1610612741,Chicago Bulls,0,0,22,22,44,23,21,44,45,43,88,13,3,16,12,32,28,11,19,104,126
2020,2,22000775,4/6/2021,1610612746,LA Clippers,1,1,1610612757,Portland Trail Blazers,0,0,30,18,48,16,25,41,46,43,89,25,5,30,10,35,24,4,8,101,133
2020,2,22000775,4/6/2021,1610612757,Portland Trail Blazers,0,0,1610612746,LA Clippers,1,1,26,30,56,11,25,36,37,55,92,31,6,37,17,41,18,5,7,102,116
2017,2,21700686,1/21/2018,1610612754,Indiana Pacers,0,1,1610612759,San Antonio Spurs,1,0,33,32,65,4,15,19,37,47,84,16,1,17,10,38,14,8,10,92,94
2017,2,21700686,1/21/2018,1610612759,San Antonio Spurs,1,0,1610612754,Indiana Pacers,0,1,26,22,48,9,25,34,35,47,82,7,5,12,14,35,24,14,20,94,86
2023,2,22300367,12/20/2023,1610612755,Philadelphia 76ers,1,1,1610612750,Minnesota Timberwolves,0,0,37,25,62,8,14,22,45,39,84,29,3,32,11,30,20,4,12,101,127
2021,2,22100837,2/10/2022,1610612744,Golden State Warriors,1,0,1610612752,New York Knicks,0,1,27,19,46,15,30,45,42,49,91,15,2,17,10,39,27,3,8,99,114
2021,2,22100837,2/10/2022,1610612752,New York Knicks,0,1,1610612744,Golden State Warriors,1,0,25,29,54,14,22,36,39,51,90,24,9,33,22,33,24,4,15,97,116
2014,2,21400312,12/9/2014,1610612749,Milwaukee Bucks,0,0,1610612760,Oklahoma City Thunder,1,1,30,33,63,4,17,21,34,50,84,29,6,35,11,42,19,10,14,102,101
2014,2,21400312,12/9/2014,1610612760,Oklahoma City Thunder,1,1,1610612749,Milwaukee Bucks,0,0,37,24,61,4,17,21,41,41,82,28,6,34,18,25,23,8,20,101,114
2021,2,22101200,4/7/2022,1610612740,New Orleans Pelicans,1,1,1610612757,Portland Trail Blazers,0,0,31,25,56,13,24,37,44,49,93,26,5,31,27,24,31,10,12,91,127
2021,2,22101200,4/7/2022,1610612757,Portland Trail Blazers,0,0,1610612740,New Orleans Pelicans,1,1,25,13,38,11,20,31,36,33,69,11,2,13,5,28,28,15,22,92,94
2014,2,21400605,1/17/2015,1610612751,Brooklyn Nets,1,0,1610612764,Washington Wizards,0,1,32,33,65,4,13,17,36,46,82,14,4,18,13,36,17,7,10,87,90
2014,2,21400605,1/17/2015,1610612764,Washington Wizards,0,1,1610612751,Brooklyn Nets,1,0,35,26,61,5,11,16,40,37,77,14,13,27,14,30,23,6,13,88,99
2014,2,21400311,12/9/2014,1610612740,New Orleans Pelicans,1,1,1610612752,New York Knicks,0,0,36,29,65,4,11,15,40,40,80,20,6,26,17,27,22,8,11,86,104
2022,2,22200329,12/2/2022,1610612751,Brooklyn Nets,1,1,1610612761,Toronto Raptors,0,0,33,17,50,11,21,32,44,38,82,15,7,22,10,32,27,7,18,99,114
2022,2,22200329,12/2/2022,1610612761,Toronto Raptors,0,0,1610612751,Brooklyn Nets,1,1,31,32,63,7,17,24,38,49,87,22,8,30,14,39,16,7,14,100,105
2020,2,22000500,2/25/2021,1610612752,New York Knicks,1,1,1610612758,Sacramento Kings,0,0,32,19,51,19,17,36,51,36,87,19,2,21,9,27,24,12,16,102,140
2020,2,22000500,2/25/2021,1610612758,Sacramento Kings,0,0,1610612752,New York Knicks,1,1,30,20,50,12,23,35,42,43,85,25,8,33,10,36,25,8,16,103,121
2014,2,21400311,12/9/2014,1610612752,New York Knicks,0,0,1610612740,New Orleans Pelicans,1,1,28,31,59,9,10,19,37,41,78,10,3,13,9,32,19,7,13,87,93
2016,2,21600951,3/8/2017,1610612748,Miami Heat,1,1,1610612766,Charlotte Hornets,0,0,20,24,44,17,24,41,37,48,85,17,7,24,16,35,22,7,13,92,108
2016,2,21600951,3/8/2017,1610612766,Charlotte Hornets,0,0,1610612748,Miami Heat,1,1,30,29,59,7,14,21,37,43,80,20,1,21,8,35,14,8,12,93,101
2016,2,21600420,12/20/2016,1610612751,Brooklyn Nets,0,0,1610612761,Toronto Raptors,1,1,26,30,56,10,25,35,36,55,91,22,6,28,19,38,20,13,17,103,104
2016,2,21600420,12/20/2016,1610612761,Toronto Raptors,1,1,1610612751,Brooklyn Nets,0,0,34,39,73,8,10,18,42,49,91,24,7,31,15,38,19,9,13,103,116
2017,2,21700685,1/21/2018,1610612751,Brooklyn Nets,0,1,1610612765,Detroit Pistons,1,0,24,25,49,13,18,31,37,43,80,14,6,20,9,38,23,3,15,94,101
2017,2,21700685,1/21/2018,1610612765,Detroit Pistons,1,0,1610612751,Brooklyn Nets,0,1,29,32,61,9,20,29,38,52,90,15,2,17,12,41,21,1,7,95,100
2022,2,22200328,12/2/2022,1610612738,Boston Celtics,1,0,1610612748,Miami Heat,0,1,25,17,42,15,30,45,40,47,87,21,7,28,10,41,26,11,20,111,116
2022,2,22200328,12/2/2022,1610612748,Miami Heat,0,1,1610612738,Boston Celtics,1,0,37,29,66,11,24,35,48,53,101,13,5,18,15,42,19,6,17,110,120
2021,2,22100836,2/10/2022,1610612749,Milwaukee Bucks,0,0,1610612756,Phoenix Suns,1,1,30,20,50,10,28,38,40,48,88,17,8,25,15,38,18,10,14,99,107
2021,2,22100836,2/10/2022,1610612756,Phoenix Suns,1,1,1610612749,Milwaukee Bucks,0,0,42,18,60,9,21,30,51,39,90,20,9,29,12,30,35,6,8,99,131
2021,2,22101199,4/7/2022,1610612750,Minnesota Timberwolves,1,1,1610612759,San Antonio Spurs,0,0,21,22,43,20,33,53,41,55,96,25,6,31,18,40,25,5,11,105,127
2021,2,22101199,4/7/2022,1610612759,San Antonio Spurs,0,0,1610612750,Minnesota Timberwolves,1,1,33,28,61,10,18,28,43,46,89,25,9,34,11,36,31,8,12,104,121
2017,2,21700684,1/21/2018,1610612747,Los Angeles Lakers,1,1,1610612752,New York Knicks,0,0,41,24,65,10,16,26,51,40,91,15,6,21,14,29,31,3,6,94,127
2017,2,21700684,1/21/2018,1610612752,New York Knicks,0,0,1610612747,Los Angeles Lakers,1,1,32,24,56,12,13,25,44,37,81,7,3,10,10,29,32,10,17,93,107
2022,2,22200327,12/2/2022,1610612737,Atlanta Hawks,1,1,1610612743,Denver Nuggets,0,0,39,21,60,10,18,28,49,39,88,9,5,14,13,27,24,8,12,95,117
2022,2,22200327,12/2/2022,1610612743,Denver Nuggets,0,0,1610612737,Atlanta Hawks,1,1,33,20,53,12,20,32,45,40,85,7,6,13,12,33,31,7,16,95,109
2022,2,22200621,1/11/2023,1610612740,New Orleans Pelicans,0,0,1610612738,Boston Celtics,1,1,34,23,57,11,19,30,45,42,87,13,4,17,4,41,22,7,9,99,114
2022,2,22200629,1/12/2023,1610612766,Charlotte Hornets,0,0,1610612761,Toronto Raptors,1,1,28,16,44,13,20,33,41,36,77,19,8,27,14,27,27,15,22,99,114
2021,2,22100835,2/10/2022,1610612742,Dallas Mavericks,1,1,1610612746,LA Clippers,0,0,25,14,39,13,26,39,38,40,78,23,4,27,13,29,19,9,14,94,112
2021,2,22100835,2/10/2022,1610612746,LA Clippers,0,0,1610612742,Dallas Mavericks,1,1,30,28,58,9,14,23,39,42,81,18,7,25,8,36,24,4,10,93,105
2023,2,22300199,11/15/2023,1610612757,Portland Trail Blazers,1,0,1610612739,Cleveland Cavaliers,0,1,21,32,53,13,25,38,34,57,91,14,2,16,18,41,24,5,14,93,95
2017,2,21700683,1/21/2018,1610612738,Boston Celtics,1,0,1610612753,Orlando Magic,0,1,29,29,58,8,19,27,37,48,85,13,1,14,14,34,22,7,15,93,95
2017,2,21700683,1/21/2018,1610612753,Orlando Magic,0,1,1610612738,Boston Celtics,1,0,37,34,71,6,15,21,43,49,92,11,5,16,18,34,20,6,10,94,103
2022,2,22200602,1/8/2023,1610612742,Dallas Mavericks,0,0,1610612760,Oklahoma City Thunder,1,1,17,17,34,14,25,39,31,42,73,33,9,42,11,36,21,5,13,96,109
2022,2,22200602,1/8/2023,1610612760,Oklahoma City Thunder,1,1,1610612742,Dallas Mavericks,0,0,34,33,67,12,16,28,46,49,95,16,4,20,16,35,27,3,8,96,120
2022,2,22200326,12/2/2022,1610612764,Washington Wizards,0,0,1610612766,Charlotte Hornets,1,1,27,26,53,12,21,33,39,47,86,26,9,35,23,27,23,6,14,93,116
2022,2,22200326,12/2/2022,1610612766,Charlotte Hornets,1,1,1610612764,Washington Wizards,0,0,28,38,66,12,17,29,40,55,95,25,6,31,21,38,25,3,4,94,117
2021,2,22100834,2/10/2022,1610612745,Houston Rockets,1,0,1610612761,Toronto Raptors,0,1,27,17,44,16,22,38,43,39,82,18,12,30,15,26,25,12,21,101,120
2021,2,22101198,4/7/2022,1610612738,Boston Celtics,0,0,1610612749,Milwaukee Bucks,1,1,22,15,37,21,29,50,43,44,87,14,5,19,9,36,30,13,16,102,121
2021,2,22101198,4/7/2022,1610612749,Milwaukee Bucks,1,1,1610612738,Boston Celtics,0,0,35,24,59,14,24,38,49,48,97,15,6,21,16,36,27,8,11,102,127
2016,2,21600048,11/1/2016,1610612747,Los Angeles Lakers,0,0,1610612754,Indiana Pacers,1,1,34,27,61,6,22,28,40,49,89,22,3,25,16,34,14,10,20,104,108
2016,2,21600048,11/1/2016,1610612754,Indiana Pacers,1,1,1610612747,Los Angeles Lakers,0,0,31,28,59,10,18,28,41,46,87,23,6,29,15,34,19,8,17,104,115
2017,2,21700682,1/20/2018,1610612742,Dallas Mavericks,0,0,1610612757,Portland Trail Blazers,1,1,28,30,58,10,15,25,38,45,83,22,6,28,13,33,19,3,9,93,108
2017,2,21700682,1/20/2018,1610612757,Portland Trail Blazers,1,1,1610612742,Dallas Mavericks,0,0,27,23,50,18,18,36,45,41,86,9,1,10,12,30,19,9,14,93,117
2022,2,22200620,1/11/2023,1610612737,Atlanta Hawks,1,0,1610612749,Milwaukee Bucks,0,1,28,29,57,11,19,30,39,48,87,16,2,18,6,44,25,6,11,99,105
2014,2,21400310,12/9/2014,1610612742,Dallas Mavericks,0,0,1610612763,Memphis Grizzlies,1,1,20,25,45,18,22,40,38,47,85,11,3,14,17,30,19,10,16,93,105
2014,2,21400310,12/9/2014,1610612763,Memphis Grizzlies,1,1,1610612742,Dallas Mavericks,0,0,34,37,71,7,7,14,41,44,85,25,4,29,14,32,20,4,5,92,114
2022,2,22200620,1/11/2023,1610612749,Milwaukee Bucks,0,1,1610612737,Atlanta Hawks,1,0,27,23,50,18,30,48,45,53,98,6,5,11,16,40,28,5,11,99,114
2016,2,21600419,12/20/2016,1610612747,Los Angeles Lakers,0,0,1610612766,Charlotte Hornets,1,1,28,29,57,16,17,33,44,46,90,9,2,11,14,33,29,5,12,95,113
2016,2,21600419,12/20/2016,1610612766,Charlotte Hornets,1,1,1610612747,Los Angeles Lakers,0,0,32,37,69,11,14,25,43,51,94,20,4,24,22,32,30,5,10,93,117
2022,2,22200325,12/1/2022,1610612742,Dallas Mavericks,0,0,1610612765,Detroit Pistons,1,1,27,13,40,19,27,46,46,40,86,14,15,29,6,41,25,9,13,105,125
2022,2,22200325,12/1/2022,1610612765,Detroit Pistons,1,1,1610612742,Dallas Mavericks,0,0,36,23,59,15,20,35,51,43,94,14,10,24,16,30,29,8,13,106,131
2021,2,22101197,4/7/2022,1610612755,Philadelphia 76ers,0,0,1610612761,Toronto Raptors,1,1,18,21,39,19,17,36,37,38,75,21,4,25,9,31,26,7,17,94,114
2021,2,22101197,4/7/2022,1610612761,Toronto Raptors,1,1,1610612755,Philadelphia 76ers,0,0,30,28,58,15,18,33,45,46,91,14,4,18,17,32,22,7,11,93,119
2014,2,21400309,12/9/2014,1610612757,Portland Trail Blazers,0,1,1610612765,Detroit Pistons,1,0,32,31,63,9,12,21,41,43,84,7,1,8,12,32,25,7,13,89,98
2014,2,21401127,4/3/2015,1610612754,Indiana Pacers,1,1,1610612766,Charlotte Hornets,0,0,28,39,67,8,8,16,36,47,83,13,5,18,17,33,20,10,20,94,93
2014,2,21401127,4/3/2015,1610612766,Charlotte Hornets,0,0,1610612754,Indiana Pacers,1,1,24,38,62,4,14,18,28,52,80,14,6,20,13,41,15,13,18,94,74
2021,2,22100834,2/10/2022,1610612761,Toronto Raptors,0,1,1610612745,Houston Rockets,1,0,38,20,58,15,24,39,53,44,97,18,4,22,17,29,25,5,12,103,139
2017,2,21700681,1/20/2018,1610612746,LA Clippers,0,0,1610612762,Utah Jazz,1,1,25,21,46,11,25,36,36,46,82,30,8,38,7,45,18,9,14,106,113
2021,2,22101196,4/7/2022,1610612753,Orlando Magic,0,0,1610612766,Charlotte Hornets,1,1,23,24,47,15,33,48,38,57,95,10,3,13,11,49,27,9,16,106,101
2017,2,21700681,1/20/2018,1610612762,Utah Jazz,1,1,1610612746,LA Clippers,0,0,34,20,54,11,17,28,45,37,82,24,8,32,13,28,21,17,21,107,125
2021,2,22101196,4/7/2022,1610612766,Charlotte Hornets,1,1,1610612753,Orlando Magic,0,0,36,22,58,12,22,34,48,44,92,20,7,27,11,36,29,6,12,106,128
2020,2,22000774,4/6/2021,1610612744,Golden State Warriors,1,1,1610612749,Milwaukee Bucks,0,0,31,25,56,15,25,40,46,50,96,15,2,17,15,36,28,7,11,101,122
2020,2,22000774,4/6/2021,1610612749,Milwaukee Bucks,0,0,1610612744,Golden State Warriors,1,1,30,24,54,14,18,32,44,42,86,19,3,22,10,33,25,6,14,101,121
2022,2,22200324,11/30/2022,1610612747,Los Angeles Lakers,1,1,1610612757,Portland Trail Blazers,0,0,34,26,60,14,23,37,48,49,97,18,8,26,16,36,28,4,8,99,128
2022,2,22200324,11/30/2022,1610612757,Portland Trail Blazers,0,0,1610612747,Los Angeles Lakers,1,1,34,32,66,8,16,24,42,48,90,17,4,21,14,37,21,5,12,97,109
2020,2,22000499,2/25/2021,1610612751,Brooklyn Nets,1,1,1610612753,Orlando Magic,0,0,29,18,47,20,25,45,49,43,92,11,3,14,9,34,30,8,13,103,129
2020,2,22000499,2/25/2021,1610612753,Orlando Magic,0,0,1610612751,Brooklyn Nets,1,1,26,25,51,9,27,36,35,52,87,13,2,15,7,46,19,11,18,103,92
2021,2,22101195,4/6/2022,1610612746,LA Clippers,1,1,1610612756,Phoenix Suns,0,0,21,20,41,12,22,34,33,42,75,35,9,44,10,36,20,11,17,103,113
2021,2,22101195,4/6/2022,1610612756,Phoenix Suns,0,0,1610612746,LA Clippers,1,1,25,35,60,17,31,48,42,66,108,8,4,12,22,47,29,7,12,104,109
2014,2,21400309,12/9/2014,1610612765,Detroit Pistons,1,0,1610612757,Portland Trail Blazers,0,1,29,46,75,5,17,22,34,63,97,13,3,16,23,41,23,4,9,89,86
2014,2,21401128,4/3/2015,1610612752,New York Knicks,0,0,1610612764,Washington Wizards,1,1,24,39,63,7,14,21,31,53,84,18,2,20,12,41,17,8,11,94,87
2014,2,21401128,4/3/2015,1610612764,Washington Wizards,1,1,1610612752,New York Knicks,0,0,36,41,77,7,9,16,43,50,93,8,4,12,16,35,32,6,11,95,101
2020,2,22000773,4/6/2021,1610612748,Miami Heat,1,0,1610612763,Memphis Grizzlies,0,1,31,18,49,13,20,33,44,38,82,11,7,18,10,33,34,11,14,95,112
2020,2,22000773,4/6/2021,1610612763,Memphis Grizzlies,0,1,1610612748,Miami Heat,1,0,29,14,43,17,24,41,46,38,84,15,5,20,11,30,30,9,14,95,124
2021,2,22100833,2/10/2022,1610612740,New Orleans Pelicans,1,0,1610612748,Miami Heat,0,1,25,19,44,11,30,41,36,49,85,14,2,16,16,34,19,12,17,93,97
2014,2,21400604,1/17/2015,1610612757,Portland Trail Blazers,0,0,1610612763,Memphis Grizzlies,1,1,23,34,57,13,23,36,36,57,93,13,2,15,19,40,20,4,7,90,98
2014,2,21400604,1/17/2015,1610612763,Memphis Grizzlies,1,1,1610612757,Portland Trail Blazers,0,0,31,31,62,8,7,15,39,38,77,16,8,24,14,27,21,7,14,89,102
2017,2,21700680,1/20/2018,1610612750,Minnesota Timberwolves,1,1,1610612761,Toronto Raptors,0,0,31,34,65,7,9,16,38,43,81,32,10,42,17,28,21,7,11,94,115
2017,2,21700680,1/20/2018,1610612761,Toronto Raptors,0,0,1610612750,Minnesota Timberwolves,1,1,27,23,50,12,21,33,39,44,83,19,2,21,12,33,23,4,15,95,109
2016,2,21600950,3/8/2017,1610612737,Atlanta Hawks,1,1,1610612751,Brooklyn Nets,0,0,37,38,75,4,16,20,41,54,95,24,8,32,19,40,19,7,16,109,110
2016,2,21600950,3/8/2017,1610612751,Brooklyn Nets,0,0,1610612737,Atlanta Hawks,1,1,26,21,47,11,22,33,37,43,80,20,5,25,7,40,28,12,23,108,105
2016,2,21600418,12/20/2016,1610612740,New Orleans Pelicans,0,1,1610612755,Philadelphia 76ers,1,0,30,46,76,10,7,17,40,53,93,18,8,26,20,39,28,6,12,97,108
2016,2,21600418,12/20/2016,1610612755,Philadelphia 76ers,1,0,1610612740,New Orleans Pelicans,0,1,22,27,49,11,22,33,33,49,82,16,5,21,9,42,18,2,13,97,93
2021,2,22100833,2/10/2022,1610612748,Miami Heat,0,1,1610612740,New Orleans Pelicans,1,0,29,20,49,10,22,32,39,42,81,24,4,28,15,29,25,8,14,95,112
2020,2,22000498,2/25/2021,1610612742,Dallas Mavericks,0,0,1610612755,Philadelphia 76ers,1,1,19,25,44,13,21,34,32,46,78,20,3,23,11,35,17,11,22,97,97
2017,2,21700679,1/20/2018,1610612744,Golden State Warriors,0,0,1610612745,Houston Rockets,1,1,23,23,46,17,19,36,40,42,82,11,4,15,8,36,31,14,19,99,108
2014,2,21400308,12/9/2014,1610612739,Cleveland Cavaliers,1,1,1610612761,Toronto Raptors,0,0,30,23,53,9,17,26,39,40,79,18,3,21,15,26,27,4,12,86,105
2014,2,21400308,12/9/2014,1610612761,Toronto Raptors,0,0,1610612739,Cleveland Cavaliers,1,1,35,24,59,7,16,23,42,40,82,10,0,10,17,23,26,4,15,88,101
2017,2,21700679,1/20/2018,1610612745,Houston Rockets,1,1,1610612744,Golden State Warriors,0,0,27,23,50,14,23,37,41,46,87,20,9,29,18,32,19,8,16,99,116
2022,2,22200323,11/30/2022,1610612754,Indiana Pacers,0,0,1610612758,Sacramento Kings,1,1,28,35,63,12,25,37,40,60,100,22,8,30,15,50,28,8,16,113,114
2022,2,22200323,11/30/2022,1610612758,Sacramento Kings,1,1,1610612754,Indiana Pacers,0,0,32,20,52,16,27,43,48,47,95,25,4,29,13,35,28,8,18,113,137
2021,2,22100832,2/10/2022,1610612751,Brooklyn Nets,0,0,1610612764,Washington Wizards,1,1,29,26,55,10,19,29,39,45,84,24,4,28,14,32,19,7,10,94,112
2016,2,21600047,11/1/2016,1610612739,Cleveland Cavaliers,1,1,1610612745,Houston Rockets,0,0,27,24,51,16,16,32,43,40,83,26,5,31,15,25,22,5,11,96,128
2016,2,21600047,11/1/2016,1610612745,Houston Rockets,0,0,1610612739,Cleveland Cavaliers,1,1,26,20,46,17,27,44,43,47,90,17,8,25,13,37,30,4,7,96,120
2014,2,21400603,1/17/2015,1610612744,Golden State Warriors,0,1,1610612745,Houston Rockets,1,0,41,28,69,9,13,22,50,41,91,22,11,33,15,31,32,10,14,104,131
2014,2,21400603,1/17/2015,1610612745,Houston Rockets,1,0,1610612744,Golden State Warriors,0,1,30,35,65,7,16,23,37,51,88,25,9,34,15,41,22,11,18,103,106
2022,2,22200622,1/11/2023,1610612752,New York Knicks,1,1,1610612754,Indiana Pacers,0,0,23,19,42,15,27,42,38,46,84,28,5,33,14,34,21,8,15,102,119
2022,2,22200622,1/11/2023,1610612754,Indiana Pacers,0,0,1610612752,New York Knicks,1,1,31,20,51,12,27,39,43,47,90,15,6,21,9,41,27,9,13,102,113
2017,2,21700678,1/20/2018,1610612749,Milwaukee Bucks,0,0,1610612755,Philadelphia 76ers,1,1,23,27,50,10,22,32,33,49,82,18,4,22,13,38,20,9,18,98,94
2017,2,21700678,1/20/2018,1610612755,Philadelphia 76ers,1,1,1610612749,Milwaukee Bucks,0,0,35,25,60,10,15,25,45,40,85,15,3,18,13,29,32,10,18,97,115
2022,2,22200322,11/30/2022,1610612746,LA Clippers,0,0,1610612762,Utah Jazz,1,1,27,36,63,10,20,30,37,56,93,28,8,36,24,35,16,4,11,97,112
2022,2,22200322,11/30/2022,1610612762,Utah Jazz,1,1,1610612746,LA Clippers,0,0,31,18,49,14,18,32,45,36,81,21,7,28,16,23,24,9,18,97,125
2021,2,22101194,4/6/2022,1610612760,Oklahoma City Thunder,0,0,1610612762,Utah Jazz,1,1,21,32,53,16,21,37,37,53,90,11,6,17,13,42,27,7,10,93,101
2022,2,22200616,1/10/2023,1610612753,Orlando Magic,0,1,1610612757,Portland Trail Blazers,1,0,31,23,54,9,15,24,40,38,78,20,5,25,10,30,19,10,16,97,109
2022,2,22200616,1/10/2023,1610612757,Portland Trail Blazers,1,0,1610612753,Orlando Magic,0,1,36,16,52,6,29,35,42,45,87,16,3,19,16,29,22,10,17,98,106
2022,2,22200321,11/30/2022,1610612741,Chicago Bulls,0,0,1610612756,Phoenix Suns,1,1,37,20,57,4,21,25,41,41,82,27,6,33,6,39,21,3,12,102,113
2017,2,21700677,1/20/2018,1610612740,New Orleans Pelicans,1,1,1610612763,Memphis Grizzlies,0,0,32,19,51,7,20,27,39,39,78,26,6,32,7,35,23,2,11,96,111
2017,2,21700677,1/20/2018,1610612763,Memphis Grizzlies,0,0,1610612740,New Orleans Pelicans,1,1,22,25,47,15,20,35,37,45,82,15,1,16,11,35,22,6,14,96,104
2022,2,22200321,11/30/2022,1610612756,Phoenix Suns,1,1,1610612741,Chicago Bulls,0,0,34,26,60,15,18,33,49,44,93,19,2,21,12,33,22,5,14,104,132
2021,2,22100832,2/10/2022,1610612764,Washington Wizards,1,1,1610612751,Brooklyn Nets,0,0,32,22,54,11,20,31,43,42,85,16,2,18,11,32,29,6,12,94,113
2020,2,22000498,2/25/2021,1610612755,Philadelphia 76ers,1,1,1610612742,Dallas Mavericks,0,0,27,34,61,12,17,29,39,51,90,21,4,25,13,41,26,2,8,96,111
2021,2,22101194,4/6/2022,1610612762,Utah Jazz,1,1,1610612760,Oklahoma City Thunder,0,0,34,14,48,15,21,36,49,35,84,24,8,32,18,21,29,9,13,92,137
2016,2,21600949,3/8/2017,1610612741,Chicago Bulls,0,0,1610612753,Orlando Magic,1,1,24,29,53,12,16,28,36,45,81,7,4,11,12,34,24,10,18,92,91
2016,2,21600949,3/8/2017,1610612753,Orlando Magic,1,1,1610612741,Chicago Bulls,0,0,30,34,64,7,18,25,37,52,89,17,4,21,18,35,21,3,10,91,98
2022,2,22200320,11/30/2022,1610612743,Denver Nuggets,1,1,1610612745,Houston Rockets,0,0,27,24,51,17,15,32,44,39,83,15,5,20,11,29,30,5,12,93,120
2022,2,22200320,11/30/2022,1610612745,Houston Rockets,0,0,1610612743,Denver Nuggets,1,1,25,22,47,12,29,41,37,51,88,14,4,18,17,36,18,6,14,94,100
2021,2,22100831,2/10/2022,1610612763,Memphis Grizzlies,0,1,1610612765,Detroit Pistons,1,0,29,33,62,15,15,30,44,48,92,29,13,42,24,32,32,4,13,103,132
2021,2,22100831,2/10/2022,1610612765,Detroit Pistons,1,0,1610612763,Memphis Grizzlies,0,1,34,25,59,7,28,35,41,53,94,18,3,21,12,43,27,6,10,101,107
2020,2,22000497,2/24/2021,1610612747,Los Angeles Lakers,0,0,1610612762,Utah Jazz,1,1,26,26,52,8,25,33,34,51,85,13,7,20,16,40,17,7,14,92,89
2014,2,21401125,4/2/2015,1610612742,Dallas Mavericks,1,0,1610612745,Houston Rockets,0,1,29,29,58,8,18,26,37,47,84,19,8,27,10,41,23,9,13,100,101
2014,2,21401125,4/2/2015,1610612745,Houston Rockets,0,1,1610612742,Dallas Mavericks,1,0,23,23,46,11,20,31,34,43,77,29,11,40,18,32,24,6,20,99,108
2016,2,21600417,12/19/2016,1610612742,Dallas Mavericks,0,0,1610612743,Denver Nuggets,1,1,29,26,55,14,11,25,43,37,80,7,2,9,5,34,21,7,12,91,107
2016,2,21600417,12/19/2016,1610612743,Denver Nuggets,1,1,1610612742,Dallas Mavericks,0,0,32,23,55,13,12,25,45,35,80,14,4,18,9,28,32,4,12,91,117
2020,2,22000772,4/6/2021,1610612747,Los Angeles Lakers,0,1,1610612761,Toronto Raptors,1,0,21,18,39,18,22,40,39,40,79,14,8,22,14,29,29,13,22,100,110
2020,2,22000772,4/6/2021,1610612761,Toronto Raptors,1,0,1610612747,Los Angeles Lakers,0,1,31,27,58,5,28,33,36,55,91,24,6,30,18,40,17,8,12,100,101
2014,2,21400307,12/8/2014,1610612746,LA Clippers,1,1,1610612756,Phoenix Suns,0,0,35,30,65,9,22,31,44,52,96,24,6,30,14,40,27,9,11,106,121
2014,2,21400307,12/8/2014,1610612756,Phoenix Suns,0,0,1610612746,LA Clippers,1,1,28,26,54,16,21,37,44,47,91,16,4,20,10,39,32,7,17,106,120
2017,2,21700676,1/20/2018,1610612748,Miami Heat,0,1,1610612766,Charlotte Hornets,1,0,30,29,59,13,15,28,43,44,87,7,5,12,11,36,28,9,14,96,106
2017,2,21700676,1/20/2018,1610612766,Charlotte Hornets,1,0,1610612748,Miami Heat,0,1,34,29,63,7,20,27,41,49,90,16,5,21,11,39,22,5,8,95,105
2022,2,22200319,11/30/2022,1610612759,San Antonio Spurs,0,0,1610612760,Oklahoma City Thunder,1,1,31,24,55,10,27,37,41,51,92,19,6,25,16,40,27,4,11,100,111
2022,2,22200319,11/30/2022,1610612760,Oklahoma City Thunder,1,1,1610612759,San Antonio Spurs,0,0,39,28,67,9,18,27,48,46,94,14,7,21,16,33,17,5,12,100,119
2014,2,21401126,4/2/2015,1610612744,Golden State Warriors,1,1,1610612756,Phoenix Suns,0,0,33,34,67,10,16,26,43,50,93,11,6,17,16,40,29,6,13,97,107
2014,2,21401126,4/2/2015,1610612756,Phoenix Suns,0,0,1610612744,Golden State Warriors,1,1,37,34,71,5,14,19,42,48,90,17,9,26,16,37,25,6,11,98,106
2022,2,22200623,1/11/2023,1610612759,San Antonio Spurs,0,0,1610612763,Memphis Grizzlies,1,1,39,34,73,11,23,34,50,57,107,18,5,23,19,40,33,6,12,107,129
2022,2,22200623,1/11/2023,1610612763,Memphis Grizzlies,1,1,1610612759,San Antonio Spurs,0,0,38,41,79,14,8,22,52,49,101,17,8,25,20,33,19,7,14,106,135
2014,2,21400602,1/17/2015,1610612737,Atlanta Hawks,0,1,1610612741,Chicago Bulls,1,0,29,29,58,11,15,26,40,44,84,16,5,21,11,36,31,5,10,92,107
2021,2,22100830,2/9/2022,1610612750,Minnesota Timberwolves,0,0,1610612758,Sacramento Kings,1,1,28,24,52,16,30,46,44,54,98,15,3,18,12,43,28,4,10,104,119
2014,2,21400602,1/17/2015,1610612741,Chicago Bulls,1,0,1610612737,Atlanta Hawks,0,1,28,26,54,9,17,26,37,43,80,16,4,20,11,34,25,10,13,92,99
2017,2,21700675,1/20/2018,1610612737,Atlanta Hawks,1,0,1610612741,Chicago Bulls,0,1,24,20,44,11,37,48,35,57,92,16,7,23,15,46,27,8,14,103,97
2017,2,21700675,1/20/2018,1610612741,Chicago Bulls,0,1,1610612737,Atlanta Hawks,1,0,26,22,48,14,18,32,40,40,80,19,2,21,4,38,31,5,16,101,113
2021,2,22100830,2/9/2022,1610612758,Sacramento Kings,1,1,1610612750,Minnesota Timberwolves,0,0,36,27,63,12,18,30,48,45,93,24,3,27,17,29,32,4,14,106,132
2020,2,22000497,2/24/2021,1610612762,Utah Jazz,1,1,1610612747,Los Angeles Lakers,0,0,19,20,39,22,26,48,41,46,87,10,5,15,16,34,28,5,12,91,114
2022,2,22200625,1/11/2023,1610612745,Houston Rockets,0,0,1610612758,Sacramento Kings,1,1,28,27,55,16,25,41,44,52,96,11,6,17,14,40,30,4,14,105,115
2021,2,22101193,4/6/2022,1610612738,Boston Celtics,0,1,1610612741,Chicago Bulls,1,0,26,25,51,17,20,37,43,45,88,14,8,22,14,34,29,7,13,97,117
2021,2,22101193,4/6/2022,1610612741,Chicago Bulls,1,0,1610612738,Boston Celtics,0,1,28,29,57,7,16,23,35,45,80,17,6,23,12,37,19,11,17,95,94
2022,2,22200625,1/11/2023,1610612758,Sacramento Kings,1,1,1610612745,Houston Rockets,0,0,26,20,46,19,29,48,45,49,94,26,5,31,13,40,28,7,9,105,135
2016,2,21600416,12/19/2016,1610612750,Minnesota Timberwolves,1,1,1610612756,Phoenix Suns,0,0,35,32,67,7,12,19,42,44,86,24,1,25,16,28,26,11,19,99,115
2016,2,21600416,12/19/2016,1610612756,Phoenix Suns,0,0,1610612750,Minnesota Timberwolves,1,1,28,33,61,9,12,21,37,45,82,25,10,35,16,32,16,8,17,100,108
2016,2,21600046,11/1/2016,1610612753,Orlando Magic,0,1,1610612755,Philadelphia 76ers,1,0,36,32,68,6,19,25,42,51,93,13,4,17,17,37,29,5,10,94,103
2016,2,21600046,11/1/2016,1610612755,Philadelphia 76ers,1,0,1610612753,Orlando Magic,0,1,31,30,61,9,11,20,40,41,81,12,4,16,13,30,28,7,16,93,101
2014,2,21400601,1/17/2015,1610612755,Philadelphia 76ers,0,0,1610612765,Detroit Pistons,1,1,31,23,54,7,21,28,38,44,82,6,1,7,13,31,24,16,22,95,89
2014,2,21400601,1/17/2015,1610612765,Detroit Pistons,1,1,1610612755,Philadelphia 76ers,0,0,23,30,53,15,20,35,38,50,88,16,3,19,20,32,27,10,16,93,107
2022,2,22200318,11/30/2022,1610612740,New Orleans Pelicans,1,1,1610612761,Toronto Raptors,0,0,31,22,53,14,19,33,45,41,86,22,4,26,12,32,28,12,20,106,126
2017,2,21700674,1/20/2018,1610612739,Cleveland Cavaliers,1,0,1610612760,Oklahoma City Thunder,0,1,36,16,52,10,27,37,46,43,89,22,5,27,7,38,32,9,15,109,124
2017,2,21700674,1/20/2018,1610612760,Oklahoma City Thunder,0,1,1610612739,Cleveland Cavaliers,1,0,44,26,70,14,16,30,58,42,100,18,10,28,19,27,37,7,14,110,148
2022,2,22200318,11/30/2022,1610612761,Toronto Raptors,0,0,1610612740,New Orleans Pelicans,1,1,31,19,50,11,27,38,42,46,88,13,6,19,9,40,29,10,16,107,108
2021,2,22100829,2/9/2022,1610612747,Los Angeles Lakers,0,0,1610612757,Portland Trail Blazers,1,1,24,13,37,17,20,37,41,33,74,6,7,13,6,30,29,15,21,96,105
2016,2,21600948,3/7/2017,1610612756,Phoenix Suns,1,0,1610612764,Washington Wizards,0,1,31,30,61,13,14,27,44,44,88,26,7,33,10,37,23,15,19,111,127
2021,2,22100829,2/9/2022,1610612757,Portland Trail Blazers,1,1,1610612747,Los Angeles Lakers,0,0,32,25,57,10,22,32,42,47,89,13,3,16,12,36,26,7,11,96,107
2014,2,21400306,12/8/2014,1610612758,Sacramento Kings,1,1,1610612762,Utah Jazz,0,0,32,34,66,3,5,8,35,39,74,28,8,36,15,29,18,7,17,93,101
2014,2,21400306,12/8/2014,1610612762,Utah Jazz,0,0,1610612758,Sacramento Kings,1,1,29,33,62,3,14,17,32,47,79,25,12,37,17,37,20,8,13,94,92
2016,2,21600948,3/7/2017,1610612764,Washington Wizards,0,1,1610612756,Phoenix Suns,1,0,34,38,72,7,11,18,41,49,90,42,11,53,13,41,19,5,11,110,131
2022,2,22200624,1/11/2023,1610612743,Denver Nuggets,1,1,1610612756,Phoenix Suns,0,0,33,18,51,15,19,34,48,37,85,15,6,21,12,30,30,4,11,96,126
2022,2,22200624,1/11/2023,1610612756,Phoenix Suns,0,0,1610612743,Denver Nuggets,1,1,30,28,58,9,23,32,39,51,90,10,4,14,20,32,28,9,20,96,97
2014,2,21401124,4/2/2015,1610612739,Cleveland Cavaliers,1,1,1610612748,Miami Heat,0,0,25,20,45,15,20,35,40,40,80,19,6,25,14,29,23,8,15,92,114
2014,2,21401124,4/2/2015,1610612748,Miami Heat,0,0,1610612739,Cleveland Cavaliers,1,1,25,29,54,7,14,21,32,43,75,17,4,21,10,35,25,12,16,91,88
2021,2,22100828,2/9/2022,1610612744,Golden State Warriors,0,0,1610612762,Utah Jazz,1,1,12,23,35,16,27,43,28,50,78,13,4,17,9,42,17,3,13,92,85
2021,2,22100828,2/9/2022,1610612762,Utah Jazz,1,1,1610612744,Golden State Warriors,0,0,24,14,38,17,34,51,41,48,89,12,5,17,16,34,26,8,12,91,111
2017,2,21700673,1/19/2018,1610612747,Los Angeles Lakers,1,1,1610612754,Indiana Pacers,0,0,35,17,52,9,19,28,44,36,80,2,12,14,8,34,26,9,15,93,99
2014,2,21400305,12/8/2014,1610612744,Golden State Warriors,0,1,1610612750,Minnesota Timberwolves,1,0,37,32,69,5,17,22,42,49,91,13,1,14,17,33,24,12,17,99,102
2014,2,21400305,12/8/2014,1610612750,Minnesota Timberwolves,1,0,1610612744,Golden State Warriors,0,1,30,47,77,2,9,11,32,56,88,20,9,29,22,37,22,15,19,100,86
2021,2,22101192,4/6/2022,1610612737,Atlanta Hawks,1,1,1610612764,Washington Wizards,0,0,27,26,53,16,23,39,43,49,92,16,3,19,10,40,26,4,6,97,118
2021,2,22101192,4/6/2022,1610612764,Washington Wizards,0,0,1610612737,Atlanta Hawks,1,1,32,19,51,10,25,35,42,44,86,9,2,11,10,34,26,11,14,98,103
2019,2,21900219,11/22/2019,1610612741,Chicago Bulls,1,0,1610612748,Miami Heat,0,1,31,29,60,10,20,30,41,49,90,16,4,20,14,37,23,10,13,99,108
2019,2,21900219,11/22/2019,1610612748,Miami Heat,0,1,1610612741,Chicago Bulls,1,0,25,16,41,14,24,38,39,40,79,24,4,28,13,28,33,11,19,97,116
2014,2,21400304,12/8/2014,1610612743,Denver Nuggets,0,0,1610612761,Toronto Raptors,1,1,33,41,74,10,20,30,43,61,104,11,4,15,24,39,21,4,15,102,107
2014,2,21400304,12/8/2014,1610612761,Toronto Raptors,1,1,1610612743,Denver Nuggets,0,0,32,16,48,9,24,33,41,40,81,21,8,29,11,34,21,7,16,103,112
2017,2,21700673,1/19/2018,1610612754,Indiana Pacers,0,0,1610612747,Los Angeles Lakers,1,1,35,37,72,2,23,25,37,60,97,10,3,13,17,44,15,7,9,94,86
2022,2,22200317,11/30/2022,1610612750,Minnesota Timberwolves,1,1,1610612763,Memphis Grizzlies,0,0,29,21,50,12,27,39,41,48,89,15,4,19,10,40,26,7,13,101,109
2022,2,22200317,11/30/2022,1610612763,Memphis Grizzlies,0,0,1610612750,Minnesota Timberwolves,1,1,28,33,61,9,17,26,37,50,87,18,12,30,27,28,17,13,27,101,101
2016,2,21600947,3/7/2017,1610612742,Dallas Mavericks,1,1,1610612747,Los Angeles Lakers,0,0,28,24,52,17,14,31,45,38,83,15,4,19,7,33,25,9,14,97,122
2016,2,21600947,3/7/2017,1610612747,Los Angeles Lakers,0,0,1610612742,Dallas Mavericks,1,1,31,29,60,11,19,30,42,48,90,16,6,22,13,38,25,5,11,98,111
2014,2,21401123,4/1/2015,1610612740,New Orleans Pelicans,0,1,1610612747,Los Angeles Lakers,1,0,35,27,62,9,7,16,44,34,78,16,5,21,12,25,31,4,7,83,113
2014,2,21401123,4/1/2015,1610612747,Los Angeles Lakers,1,0,1610612740,New Orleans Pelicans,0,1,32,35,67,5,11,16,37,46,83,13,8,21,16,34,22,3,7,84,92
2014,2,21400600,1/17/2015,1610612754,Indiana Pacers,0,0,1610612766,Charlotte Hornets,1,1,28,35,63,2,19,21,30,54,84,9,4,13,8,48,18,7,20,101,71
2014,2,21400600,1/17/2015,1610612766,Charlotte Hornets,1,1,1610612754,Indiana Pacers,0,0,29,57,86,2,13,15,31,70,101,16,9,25,19,55,16,5,7,102,80
2021,2,22101191,4/6/2022,1610612751,Brooklyn Nets,0,1,1610612752,New York Knicks,1,0,27,25,52,14,27,41,41,52,93,14,4,18,16,37,28,4,14,99,110
2021,2,22101191,4/6/2022,1610612752,New York Knicks,1,0,1610612751,Brooklyn Nets,0,1,19,26,45,13,25,38,32,51,83,21,15,36,12,44,22,7,11,99,98
2022,2,22200316,11/30/2022,1610612749,Milwaukee Bucks,0,1,1610612752,New York Knicks,1,0,29,26,55,10,25,35,39,51,90,21,5,26,15,38,23,2,6,95,109
2022,2,22200316,11/30/2022,1610612752,New York Knicks,1,0,1610612749,Milwaukee Bucks,0,1,36,34,70,6,24,30,42,58,100,13,7,20,23,39,18,3,8,95,103
2021,2,22100827,2/9/2022,1610612760,Oklahoma City Thunder,1,0,1610612761,Toronto Raptors,0,1,22,18,40,14,33,47,36,51,87,12,2,14,16,37,28,9,18,97,98
2021,2,22100827,2/9/2022,1610612761,Toronto Raptors,0,1,1610612760,Oklahoma City Thunder,1,0,32,21,53,13,22,35,45,43,88,14,0,14,12,31,22,11,16,97,117
2021,2,22101190,4/6/2022,1610612742,Dallas Mavericks,0,1,1610612765,Detroit Pistons,1,0,30,17,47,15,18,33,45,35,80,26,8,34,10,31,28,7,10,95,131
2021,2,22101190,4/6/2022,1610612765,Detroit Pistons,1,0,1610612742,Dallas Mavericks,0,1,24,28,52,11,19,30,35,47,82,32,3,35,13,36,26,8,11,96,113
2016,2,21600415,12/19/2016,1610612737,Atlanta Hawks,0,1,1610612760,Oklahoma City Thunder,1,0,32,20,52,9,14,23,41,34,75,19,5,24,7,30,24,8,15,95,110
2016,2,21600415,12/19/2016,1610612760,Oklahoma City Thunder,1,0,1610612737,Atlanta Hawks,0,1,29,23,52,10,25,35,39,48,87,20,6,26,17,33,13,5,12,95,108
2014,2,21400599,1/16/2015,1610612739,Cleveland Cavaliers,0,1,1610612746,LA Clippers,1,0,36,24,60,10,13,23,46,37,83,24,7,31,16,26,23,9,20,100,126
2014,2,21400599,1/16/2015,1610612746,LA Clippers,1,0,1610612739,Cleveland Cavaliers,0,1,33,29,62,10,19,29,43,48,91,25,11,36,21,35,26,9,13,100,121
2017,2,21700672,1/19/2018,1610612752,New York Knicks,0,1,1610612762,Utah Jazz,1,0,33,36,69,11,9,20,44,45,89,18,5,23,9,39,23,4,12,103,117
2023,2,22300249,11/26/2023,1610612750,Minnesota Timberwolves,0,1,1610612763,Memphis Grizzlies,1,0,28,19,47,15,19,34,43,38,81,18,5,23,11,29,30,4,16,97,119
2017,2,21700672,1/19/2018,1610612762,Utah Jazz,1,0,1610612752,New York Knicks,0,1,31,29,60,11,20,31,42,49,91,20,10,30,18,34,19,6,17,104,115
2021,2,22101189,4/5/2022,1610612747,Los Angeles Lakers,0,0,1610612756,Phoenix Suns,1,1,30,27,57,9,20,29,39,47,86,23,7,30,8,42,22,10,16,109,110
2021,2,22101189,4/5/2022,1610612756,Phoenix Suns,1,1,1610612747,Los Angeles Lakers,0,0,36,27,63,14,25,39,50,52,102,7,2,9,12,42,38,7,14,108,121
2014,2,21400598,1/16/2015,1610612748,Miami Heat,0,1,1610612758,Sacramento Kings,1,0,27,30,57,8,9,17,35,39,74,17,4,21,9,32,26,3,10,86,95
2014,2,21400598,1/16/2015,1610612758,Sacramento Kings,1,0,1610612748,Miami Heat,0,1,25,34,59,7,9,16,32,43,75,12,2,14,10,35,20,9,15,87,83
2020,2,22000496,2/24/2021,1610612756,Phoenix Suns,1,0,1610612766,Charlotte Hornets,0,1,30,19,49,14,24,38,44,43,87,19,8,27,10,38,26,8,14,105,121
2017,2,21700671,1/19/2018,1610612743,Denver Nuggets,1,0,1610612756,Phoenix Suns,0,1,21,21,42,14,22,36,35,43,78,16,5,21,11,34,23,9,16,93,100
2014,2,21400303,12/8/2014,1610612739,Cleveland Cavaliers,0,1,1610612751,Brooklyn Nets,1,0,34,31,65,9,16,25,43,47,90,15,7,22,24,27,25,6,14,90,110
2014,2,21400303,12/8/2014,1610612751,Brooklyn Nets,1,0,1610612739,Cleveland Cavaliers,0,1,32,30,62,4,15,19,36,45,81,12,7,19,12,35,25,10,12,90,88
2021,2,22101188,4/5/2022,1610612740,New Orleans Pelicans,0,1,1610612758,Sacramento Kings,1,0,33,30,63,12,13,25,45,43,88,21,5,26,15,31,26,4,13,97,123
2021,2,22101188,4/5/2022,1610612758,Sacramento Kings,1,0,1610612740,New Orleans Pelicans,0,1,28,18,46,11,19,30,39,37,76,20,2,22,4,34,28,13,15,98,109
2017,2,21700671,1/19/2018,1610612756,Phoenix Suns,0,1,1610612743,Denver Nuggets,1,0,26,22,48,14,19,33,40,41,81,14,6,20,7,37,28,7,12,93,108
2014,2,21401122,4/1/2015,1610612746,LA Clippers,0,1,1610612757,Portland Trail Blazers,1,0,31,27,58,15,13,28,46,40,86,19,5,24,11,32,30,4,6,92,126
2014,2,21401122,4/1/2015,1610612757,Portland Trail Blazers,1,0,1610612746,LA Clippers,0,1,32,32,64,13,12,25,45,44,89,19,6,25,16,33,25,6,9,94,122
2023,2,22300028,11/17/2023,1610612764,Washington Wizards,1,0,1610612752,New York Knicks,0,1,27,23,50,10,22,32,37,45,82,15,1,16,11,35,25,5,14,92,99
2020,2,22000496,2/24/2021,1610612766,Charlotte Hornets,0,1,1610612756,Phoenix Suns,1,0,30,22,52,13,23,36,43,45,88,25,2,27,10,37,24,9,14,104,124
2021,2,22101187,4/5/2022,1610612762,Utah Jazz,1,1,1610612763,Memphis Grizzlies,0,0,28,30,58,12,26,38,40,56,96,29,14,43,18,44,23,13,17,116,121
2021,2,22101187,4/5/2022,1610612763,Memphis Grizzlies,0,0,1610612762,Utah Jazz,1,1,26,44,70,13,18,31,39,62,101,24,5,29,13,51,26,8,13,116,115
2022,2,22200527,12/29/2022,1610612752,New York Knicks,0,0,1610612759,San Antonio Spurs,1,1,23,26,49,15,26,41,38,52,90,24,7,31,19,36,20,5,12,97,115
2022,2,22200527,12/29/2022,1610612759,San Antonio Spurs,1,1,1610612752,New York Knicks,0,0,34,26,60,11,17,28,45,43,88,21,8,29,18,27,25,7,14,96,122
2016,2,21600045,10/31/2016,1610612746,LA Clippers,1,1,1610612756,Phoenix Suns,0,0,34,30,64,6,10,16,40,40,80,30,8,38,8,36,21,11,16,106,116
2016,2,21600045,10/31/2016,1610612756,Phoenix Suns,0,0,1610612746,LA Clippers,1,1,30,39,69,5,10,15,35,49,84,23,8,31,13,41,19,8,21,107,98
2014,2,21400302,12/8/2014,1610612738,Boston Celtics,0,0,1610612764,Washington Wizards,1,1,38,42,80,9,13,22,47,55,102,29,3,32,14,43,27,10,17,119,132
2014,2,21400302,12/8/2014,1610612764,Washington Wizards,1,1,1610612738,Boston Celtics,0,0,42,36,78,7,9,16,49,45,94,28,6,34,15,34,32,17,23,117,133
2021,2,22100826,2/9/2022,1610612741,Chicago Bulls,0,1,1610612766,Charlotte Hornets,1,0,30,19,49,16,17,33,46,36,82,13,6,19,6,33,27,7,14,98,121
2021,2,22100826,2/9/2022,1610612766,Charlotte Hornets,1,0,1610612741,Chicago Bulls,0,1,27,23,50,13,30,43,40,53,93,16,7,23,17,39,26,4,9,99,109
2017,2,21700670,1/19/2018,1610612758,Sacramento Kings,0,0,1610612763,Memphis Grizzlies,1,1,21,32,53,11,16,27,32,48,80,13,5,18,14,37,18,12,21,95,88
2017,2,21700670,1/19/2018,1610612763,Memphis Grizzlies,1,1,1610612758,Sacramento Kings,0,0,29,25,54,10,24,34,39,49,88,18,5,23,17,34,24,10,13,95,106
2021,2,22101186,4/5/2022,1610612743,Denver Nuggets,1,0,1610612759,San Antonio Spurs,0,1,34,31,65,7,26,33,41,57,98,8,4,12,14,45,22,6,11,101,97
2021,2,22101186,4/5/2022,1610612759,San Antonio Spurs,0,1,1610612743,Denver Nuggets,1,0,32,31,63,12,14,26,44,45,89,16,8,24,9,41,31,4,11,102,116
2014,2,21400597,1/16/2015,1610612747,Los Angeles Lakers,0,0,1610612762,Utah Jazz,1,1,28,30,58,3,4,7,31,34,65,20,7,27,10,27,7,11,21,87,85
2014,2,21400597,1/16/2015,1610612762,Utah Jazz,1,1,1610612747,Los Angeles Lakers,0,0,24,30,54,12,19,31,36,49,85,10,0,10,14,35,24,6,13,88,94
2017,2,21700669,1/19/2018,1610612764,Washington Wizards,0,1,1610612765,Detroit Pistons,1,0,25,22,47,16,19,35,41,41,82,24,3,27,13,29,28,8,13,96,122
2017,2,21700669,1/19/2018,1610612765,Detroit Pistons,1,0,1610612764,Washington Wizards,0,1,30,20,50,10,20,30,40,40,80,22,4,26,12,30,25,10,14,96,112
2016,2,21600946,3/7/2017,1610612757,Portland Trail Blazers,0,1,1610612760,Oklahoma City Thunder,1,0,36,26,62,11,12,23,47,38,85,21,6,27,13,28,24,4,12,97,126
2016,2,21600946,3/7/2017,1610612760,Oklahoma City Thunder,1,0,1610612757,Portland Trail Blazers,0,1,34,26,60,10,15,25,44,41,85,23,7,30,19,27,16,7,17,97,121
2023,2,22300199,11/15/2023,1610612739,Cleveland Cavaliers,0,1,1610612757,Portland Trail Blazers,1,0,33,12,45,9,21,30,42,33,75,16,5,21,11,23,23,9,18,94,109
2022,2,22200636,1/13/2023,1610612741,Chicago Bulls,1,0,1610612760,Oklahoma City Thunder,0,1,26,21,47,12,26,38,38,47,85,22,2,24,13,35,30,12,16,99,110
2022,2,22200636,1/13/2023,1610612760,Oklahoma City Thunder,0,1,1610612741,Chicago Bulls,1,0,36,23,59,11,22,33,47,45,92,19,3,22,15,32,22,7,11,100,124
2023,2,22300203,11/18/2023,1610612750,Minnesota Timberwolves,0,1,1610612740,New Orleans Pelicans,1,0,30,19,49,13,18,31,43,37,80,22,5,27,9,30,29,9,14,97,121
2017,2,21700668,1/19/2018,1610612748,Miami Heat,0,0,1610612751,Brooklyn Nets,1,1,28,34,62,7,15,22,35,49,84,18,7,25,17,36,22,5,13,92,95
2017,2,21700668,1/19/2018,1610612751,Brooklyn Nets,1,1,1610612748,Miami Heat,0,0,27,17,44,9,23,32,36,40,76,20,6,26,11,32,20,7,14,92,101
2022,2,22200631,1/12/2023,1610612739,Cleveland Cavaliers,0,1,1610612757,Portland Trail Blazers,1,0,37,30,67,7,15,22,44,45,89,24,7,31,14,35,28,6,11,101,119
2022,2,22200585,1/6/2023,1610612759,San Antonio Spurs,1,1,1610612765,Detroit Pistons,0,0,36,21,57,9,15,24,45,36,81,22,4,26,11,27,27,11,18,102,121
2014,2,21400301,12/8/2014,1610612737,Atlanta Hawks,0,1,1610612754,Indiana Pacers,1,0,31,25,56,9,12,21,40,37,77,19,8,27,6,35,27,6,16,98,108
2014,2,21400301,12/8/2014,1610612754,Indiana Pacers,1,0,1610612737,Atlanta Hawks,0,1,28,29,57,9,18,27,37,47,84,9,8,17,11,42,23,11,17,100,92
2016,2,21600414,12/19/2016,1610612741,Chicago Bulls,1,1,1610612765,Detroit Pistons,0,0,41,25,66,8,8,16,49,33,82,7,0,7,10,23,34,8,13,89,113
2021,2,22100825,2/9/2022,1610612739,Cleveland Cavaliers,1,1,1610612759,San Antonio Spurs,0,0,30,31,61,9,12,21,39,43,82,18,6,24,11,34,18,8,15,98,105
2021,2,22100825,2/9/2022,1610612759,San Antonio Spurs,0,0,1610612739,Cleveland Cavaliers,1,1,30,36,66,8,25,33,38,61,99,8,3,11,20,43,24,8,13,98,92
2021,2,22101185,4/5/2022,1610612757,Portland Trail Blazers,0,0,1610612760,Oklahoma City Thunder,1,1,24,27,51,11,21,32,35,48,83,13,3,16,13,36,24,12,17,97,94
2021,2,22101185,4/5/2022,1610612760,Oklahoma City Thunder,1,1,1610612757,Portland Trail Blazers,0,0,30,22,52,9,20,29,39,42,81,11,11,22,14,33,15,10,17,95,98
2016,2,21600414,12/19/2016,1610612765,Detroit Pistons,0,0,1610612741,Chicago Bulls,1,1,31,29,60,3,20,23,34,49,83,11,2,13,12,38,19,9,11,89,82
2020,2,22000771,4/6/2021,1610612738,Boston Celtics,1,0,1610612755,Philadelphia 76ers,0,1,19,17,36,14,20,34,33,37,70,16,2,18,8,30,19,11,22,93,96
2022,2,22200585,1/6/2023,1610612765,Detroit Pistons,0,0,1610612759,San Antonio Spurs,1,1,33,29,62,11,20,31,44,49,93,10,7,17,16,37,23,8,16,101,109
2023,2,22301218,12/8/2023,1610612755,Philadelphia 76ers,1,1,1610612737,Atlanta Hawks,0,0,31,26,57,11,19,30,42,45,87,30,7,37,16,32,24,3,11,99,125
2017,2,21700667,1/19/2018,1610612759,San Antonio Spurs,0,0,1610612761,Toronto Raptors,1,1,26,45,71,5,15,20,31,60,91,16,4,20,19,44,18,8,12,93,83
2017,2,21700667,1/19/2018,1610612761,Toronto Raptors,1,1,1610612759,San Antonio Spurs,0,0,25,34,59,9,17,26,34,51,85,9,5,14,11,41,16,9,14,95,86
2023,2,22300198,11/15/2023,1610612758,Sacramento Kings,0,1,1610612747,Los Angeles Lakers,1,0,32,20,52,16,28,44,48,48,96,13,4,17,12,38,31,12,16,107,125
2017,2,21700666,1/18/2018,1610612754,Indiana Pacers,0,0,1610612757,Portland Trail Blazers,1,1,29,36,65,7,19,26,36,55,91,7,6,13,11,46,17,6,8,92,86
2017,2,21700666,1/18/2018,1610612757,Portland Trail Blazers,1,1,1610612754,Indiana Pacers,0,0,27,35,62,10,22,32,37,57,94,16,0,16,18,39,17,4,11,94,100
2022,2,22200631,1/12/2023,1610612757,Portland Trail Blazers,1,0,1610612739,Cleveland Cavaliers,0,1,29,16,45,11,22,33,40,38,78,22,7,29,7,34,17,6,17,100,113
2022,2,22200637,1/13/2023,1610612750,Minnesota Timberwolves,1,1,1610612756,Phoenix Suns,0,0,37,25,62,10,18,28,47,43,90,17,3,20,11,34,24,10,15,105,121
2014,2,21400300,12/7/2014,1610612740,New Orleans Pelicans,0,1,1610612747,Los Angeles Lakers,1,0,35,30,65,8,10,18,43,40,83,10,5,15,12,29,28,4,16,96,104
2021,2,22100824,2/8/2022,1610612750,Minnesota Timberwolves,0,1,1610612758,Sacramento Kings,1,0,28,32,60,22,22,44,50,54,104,12,5,17,20,35,34,4,14,106,134
2021,2,22100824,2/8/2022,1610612758,Sacramento Kings,1,0,1610612750,Minnesota Timberwolves,0,1,32,26,58,9,16,25,41,42,83,23,3,26,8,34,29,10,19,106,114
2014,2,21400300,12/7/2014,1610612747,Los Angeles Lakers,1,0,1610612740,New Orleans Pelicans,0,1,31,40,71,5,14,19,36,54,90,10,5,15,10,45,18,2,7,95,87
2022,2,22200637,1/13/2023,1610612756,Phoenix Suns,0,0,1610612750,Minnesota Timberwolves,1,1,27,36,63,14,9,23,41,45,86,20,4,24,11,34,28,13,19,104,116
2023,2,22300203,11/18/2023,1610612740,New Orleans Pelicans,1,0,1610612750,Minnesota Timberwolves,0,1,32,25,57,12,17,29,44,42,86,20,3,23,14,30,27,6,17,99,120
2014,2,21400596,1/16/2015,1610612750,Minnesota Timberwolves,0,0,1610612756,Phoenix Suns,1,1,34,35,69,8,14,22,42,49,91,7,5,12,20,33,26,5,12,91,99
2014,2,21400596,1/16/2015,1610612756,Phoenix Suns,1,1,1610612750,Minnesota Timberwolves,0,0,43,29,72,5,10,15,48,39,87,9,2,11,16,25,18,6,16,90,110
2020,2,22000771,4/6/2021,1610612755,Philadelphia 76ers,0,1,1610612738,Boston Celtics,1,0,25,24,49,9,15,24,34,39,73,29,10,39,13,30,16,5,13,92,106
2014,2,21400299,12/7/2014,1610612752,New York Knicks,1,0,1610612757,Portland Trail Blazers,0,1,36,24,60,5,14,19,41,38,79,12,2,14,8,31,20,8,14,91,99
2016,2,21600945,3/6/2017,1610612738,Boston Celtics,0,0,1610612746,LA Clippers,1,1,24,24,48,10,25,35,34,49,83,24,5,29,9,42,22,7,11,99,102
2016,2,21600945,3/6/2017,1610612746,LA Clippers,1,1,1610612738,Boston Celtics,0,0,30,23,53,9,11,20,39,34,73,29,18,47,10,31,23,9,13,99,116
2016,2,21600413,12/19/2016,1610612754,Indiana Pacers,1,1,1610612764,Washington Wizards,0,0,34,32,66,7,14,21,41,46,87,18,3,21,13,36,18,5,15,97,107
2016,2,21600413,12/19/2016,1610612764,Washington Wizards,0,0,1610612754,Indiana Pacers,1,1,30,25,55,8,25,33,38,50,88,21,5,26,19,34,19,6,15,98,105
2022,2,22200372,12/7/2022,1610612744,Golden State Warriors,0,0,1610612762,Utah Jazz,1,1,31,25,56,14,28,42,45,53,98,19,6,25,20,35,26,6,14,103,123
2022,2,22200372,12/7/2022,1610612762,Utah Jazz,1,1,1610612744,Golden State Warriors,0,0,31,20,51,15,20,35,46,40,86,17,4,21,11,30,26,8,17,103,124
2017,2,21700665,1/18/2018,1610612745,Houston Rockets,1,1,1610612750,Minnesota Timberwolves,0,0,25,24,49,17,22,39,42,46,88,15,2,17,12,35,24,8,10,92,116
2017,2,21700665,1/18/2018,1610612750,Minnesota Timberwolves,0,0,1610612745,Houston Rockets,1,1,30,27,57,8,16,24,38,43,81,14,7,21,10,37,24,11,11,91,98
2014,2,21401121,4/1/2015,1610612743,Denver Nuggets,0,0,1610612762,Utah Jazz,1,1,26,36,62,7,26,33,33,62,95,11,1,12,19,44,13,5,6,88,84
2021,2,22101184,4/5/2022,1610612750,Minnesota Timberwolves,1,0,1610612764,Washington Wizards,0,1,27,23,50,14,27,41,41,50,91,18,7,25,8,45,27,4,10,105,114
2021,2,22101184,4/5/2022,1610612764,Washington Wizards,0,1,1610612750,Minnesota Timberwolves,1,0,43,28,71,13,17,30,56,45,101,7,7,14,12,36,38,6,10,105,132
2014,2,21400299,12/7/2014,1610612757,Portland Trail Blazers,0,1,1610612752,New York Knicks,1,0,26,31,57,10,18,28,36,49,85,21,8,29,17,35,21,6,10,91,103
2017,2,21700664,1/18/2018,1610612739,Cleveland Cavaliers,1,1,1610612753,Orlando Magic,0,0,28,23,51,10,24,34,38,47,85,18,9,27,19,35,22,12,20,99,104
2017,2,21700664,1/18/2018,1610612753,Orlando Magic,0,0,1610612739,Cleveland Cavaliers,1,1,36,30,66,5,17,22,41,47,88,16,5,21,14,34,25,8,15,100,103
2022,2,22200605,1/9/2023,1610612740,New Orleans Pelicans,0,1,1610612764,Washington Wizards,1,0,39,28,67,10,16,26,49,44,93,24,7,31,16,31,24,5,10,101,132
2022,2,22200605,1/9/2023,1610612764,Washington Wizards,1,0,1610612740,New Orleans Pelicans,0,1,28,20,48,14,20,34,42,40,82,14,4,18,9,33,26,9,20,100,112
2021,2,22100823,2/8/2022,1610612753,Orlando Magic,0,1,1610612757,Portland Trail Blazers,1,0,25,27,52,19,19,38,44,46,90,6,2,8,12,36,34,9,15,98,113
2014,2,21401121,4/1/2015,1610612762,Utah Jazz,1,1,1610612743,Denver Nuggets,0,0,28,26,54,9,14,23,37,40,77,15,9,24,16,28,24,7,15,87,98
2021,2,22100823,2/8/2022,1610612757,Portland Trail Blazers,1,0,1610612753,Orlando Magic,0,1,21,32,53,11,27,38,32,59,91,20,6,26,19,43,21,8,13,97,95
2020,2,22000495,2/24/2021,1610612759,San Antonio Spurs,0,0,1610612760,Oklahoma City Thunder,1,1,31,30,61,9,16,25,40,46,86,10,5,15,9,42,20,6,13,98,99
2020,2,22000495,2/24/2021,1610612760,Oklahoma City Thunder,1,1,1610612759,San Antonio Spurs,0,0,19,26,45,18,26,44,37,52,89,10,1,11,13,40,21,10,17,99,102
2023,2,22300213,11/19/2023,1610612763,Memphis Grizzlies,1,0,1610612738,Boston Celtics,0,1,20,31,51,17,27,44,37,58,95,9,1,10,18,40,28,6,11,94,100
2021,2,22100822,2/8/2022,1610612747,Los Angeles Lakers,1,0,1610612749,Milwaukee Bucks,0,1,34,19,53,10,22,32,44,41,85,18,12,30,13,34,28,10,16,100,116
2021,2,22100822,2/8/2022,1610612749,Milwaukee Bucks,0,1,1610612747,Los Angeles Lakers,1,0,37,23,60,15,21,36,52,44,96,12,8,20,16,30,31,7,12,100,131
2021,2,22101183,4/5/2022,1610612741,Chicago Bulls,1,0,1610612749,Milwaukee Bucks,0,1,33,32,65,9,24,33,42,56,98,13,0,13,16,40,22,8,15,102,106
2021,2,22101183,4/5/2022,1610612749,Milwaukee Bucks,0,1,1610612741,Chicago Bulls,1,0,34,18,52,12,23,35,46,41,87,23,2,25,12,30,32,8,14,101,127
2023,2,22300005,11/3/2023,1610612760,Oklahoma City Thunder,1,0,1610612744,Golden State Warriors,0,1,35,19,54,15,14,29,50,33,83,24,6,30,10,25,26,9,19,104,139
2022,2,22200638,1/13/2023,1610612753,Orlando Magic,0,0,1610612762,Utah Jazz,1,1,28,32,60,14,22,36,42,54,96,10,6,16,14,45,23,9,15,105,108
2022,2,22200638,1/13/2023,1610612762,Utah Jazz,1,1,1610612753,Orlando Magic,0,0,25,23,48,11,24,35,36,47,83,29,11,40,19,31,15,13,24,105,112
2014,2,21400595,1/16/2015,1610612757,Portland Trail Blazers,0,0,1610612759,San Antonio Spurs,1,1,31,24,55,6,13,19,37,37,74,16,4,20,4,35,20,12,16,96,96
2014,2,21400595,1/16/2015,1610612759,San Antonio Spurs,1,1,1610612757,Portland Trail Blazers,0,0,31,34,65,11,18,29,42,52,94,15,2,17,20,33,34,6,13,95,110
2023,2,22300392,12/23/2023,1610612745,Houston Rockets,0,1,1610612740,New Orleans Pelicans,1,0,26,27,53,9,20,29,35,47,82,27,8,35,17,34,21,9,12,93,106
2021,2,22100821,2/8/2022,1610612743,Denver Nuggets,1,1,1610612752,New York Knicks,0,0,30,16,46,16,23,39,46,39,85,24,7,31,14,28,31,9,13,97,132
2021,2,22100821,2/8/2022,1610612752,New York Knicks,0,0,1610612743,Denver Nuggets,1,1,30,28,58,15,28,43,45,56,101,10,2,12,17,41,25,5,9,98,115
2017,2,21700663,1/18/2018,1610612738,Boston Celtics,1,0,1610612755,Philadelphia 76ers,0,1,23,22,45,7,22,29,30,44,74,13,4,17,6,39,13,10,19,97,80
2014,2,21400298,12/7/2014,1610612742,Dallas Mavericks,1,1,1610612749,Milwaukee Bucks,0,0,37,16,53,12,19,31,49,35,84,15,4,19,10,27,29,7,11,96,125
2020,2,22000494,2/24/2021,1610612740,New Orleans Pelicans,1,1,1610612765,Detroit Pistons,0,0,40,27,67,10,13,23,50,40,90,18,11,29,17,30,31,8,13,100,128
2021,2,22101182,4/5/2022,1610612737,Atlanta Hawks,0,0,1610612761,Toronto Raptors,1,1,29,28,57,14,23,37,43,51,94,8,4,12,11,43,31,6,7,96,108
2021,2,22101182,4/5/2022,1610612761,Toronto Raptors,1,1,1610612737,Atlanta Hawks,0,0,35,31,66,9,26,35,44,57,101,21,10,31,25,36,20,5,8,96,118
2023,2,22300174,11/11/2023,1610612738,Boston Celtics,1,1,1610612761,Toronto Raptors,0,0,32,10,42,15,29,44,47,39,86,8,5,13,8,35,30,8,13,96,117
2020,2,22000494,2/24/2021,1610612765,Detroit Pistons,0,0,1610612740,New Orleans Pelicans,1,1,34,19,53,13,23,36,47,42,89,11,5,16,10,34,31,10,13,100,118
2017,2,21700663,1/18/2018,1610612755,Philadelphia 76ers,0,1,1610612738,Boston Celtics,1,0,28,28,56,6,11,17,34,39,73,15,2,17,11,29,18,7,25,96,89
2021,2,22101181,4/5/2022,1610612748,Miami Heat,1,1,1610612766,Charlotte Hornets,0,0,25,17,42,23,19,42,48,36,84,25,4,29,12,26,29,8,15,100,144
2021,2,22101181,4/5/2022,1610612766,Charlotte Hornets,0,0,1610612748,Miami Heat,1,1,33,14,47,12,26,38,45,40,85,13,5,18,9,34,34,10,15,100,115
2016,2,21600412,12/18/2016,1610612740,New Orleans Pelicans,0,0,1610612759,San Antonio Spurs,1,1,31,32,63,10,16,26,41,48,89,8,6,14,13,37,29,6,12,96,100
2016,2,21600412,12/18/2016,1610612759,San Antonio Spurs,1,1,1610612740,New Orleans Pelicans,0,0,31,33,64,11,11,22,42,44,86,18,4,22,14,32,31,8,14,95,113
2014,2,21401120,4/1/2015,1610612742,Dallas Mavericks,0,1,1610612760,Oklahoma City Thunder,1,0,52,24,76,4,11,15,56,35,91,19,5,24,7,33,35,4,6,101,135
2023,2,22300067,10/25/2023,1610612751,Brooklyn Nets,1,0,1610612739,Cleveland Cavaliers,0,1,33,24,57,9,18,27,42,42,84,20,6,26,16,30,30,10,18,100,113
2023,2,22300235,11/22/2023,1610612746,LA Clippers,0,1,1610612759,San Antonio Spurs,1,0,30,27,57,9,19,28,39,46,85,22,7,29,14,34,29,8,16,102,109
2023,2,22300247,11/26/2023,1610612752,New York Knicks,1,0,1610612756,Phoenix Suns,0,1,27,30,57,12,17,29,39,47,86,23,9,32,20,32,18,4,7,89,113
2023,2,22300676,1/31/2024,1610612764,Washington Wizards,1,0,1610612746,LA Clippers,0,1,36,32,68,9,20,29,45,52,97,10,5,15,18,37,19,9,13,98,109
2021,2,22100820,2/8/2022,1610612742,Dallas Mavericks,1,1,1610612765,Detroit Pistons,0,0,22,21,43,18,18,36,40,39,79,18,5,23,9,33,24,5,13,95,116
2014,2,21400298,12/7/2014,1610612749,Milwaukee Bucks,0,0,1610612742,Dallas Mavericks,1,1,38,31,69,4,11,15,42,42,84,14,3,17,16,29,17,14,19,95,102
2017,2,21700662,1/17/2018,1610612743,Denver Nuggets,0,0,1610612746,LA Clippers,1,1,37,35,72,5,20,25,42,55,97,15,3,18,25,33,23,10,21,102,104
2022,2,22200557,1/2/2023,1610612743,Denver Nuggets,0,0,1610612750,Minnesota Timberwolves,1,1,31,31,62,11,18,29,42,49,91,16,4,20,18,33,27,7,15,97,111
2014,2,21401120,4/1/2015,1610612760,Oklahoma City Thunder,1,0,1610612742,Dallas Mavericks,0,1,31,31,62,14,17,31,45,48,93,27,6,33,17,34,23,8,11,102,131
2014,2,21400594,1/16/2015,1610612742,Dallas Mavericks,1,1,1610612743,Denver Nuggets,0,0,25,29,54,8,17,25,33,46,79,23,6,29,12,39,22,6,15,96,97
2022,2,22200557,1/2/2023,1610612750,Minnesota Timberwolves,1,1,1610612743,Denver Nuggets,0,0,32,19,51,13,23,36,45,42,87,21,6,27,15,29,29,8,12,99,124
2023,2,22300213,11/19/2023,1610612738,Boston Celtics,0,1,1610612763,Memphis Grizzlies,1,0,23,23,46,12,19,31,35,42,77,20,5,25,14,32,20,7,17,94,102
2021,2,22101180,4/5/2022,1610612745,Houston Rockets,0,0,1610612751,Brooklyn Nets,1,1,29,27,56,11,32,43,40,59,99,14,11,25,20,43,18,6,11,102,105
2021,2,22101180,4/5/2022,1610612751,Brooklyn Nets,1,1,1610612745,Houston Rockets,0,0,24,25,49,15,22,37,39,47,86,25,2,27,14,33,22,8,17,102,118
2017,2,21700662,1/17/2018,1610612746,LA Clippers,1,1,1610612743,Denver Nuggets,0,0,30,27,57,10,20,30,40,47,87,19,12,31,20,36,22,13,20,101,109
2016,2,21600944,3/6/2017,1610612740,New Orleans Pelicans,0,0,1610612762,Utah Jazz,1,1,20,31,51,10,23,33,30,54,84,13,5,18,20,35,16,10,20,95,83
2023,2,22300248,11/26/2023,1610612766,Charlotte Hornets,0,0,1610612753,Orlando Magic,1,1,31,22,53,13,17,30,44,39,83,16,9,25,8,37,27,10,18,104,117
2016,2,21600944,3/6/2017,1610612762,Utah Jazz,1,1,1610612740,New Orleans Pelicans,0,0,23,31,54,10,17,27,33,48,81,12,3,15,14,36,16,11,19,94,88
2016,2,21600044,10/31/2016,1610612737,Atlanta Hawks,1,1,1610612758,Sacramento Kings,0,0,22,27,49,11,19,30,33,46,79,29,18,47,22,34,24,10,13,92,106
2016,2,21600044,10/31/2016,1610612758,Sacramento Kings,0,0,1610612737,Atlanta Hawks,1,1,26,26,52,10,13,23,36,39,75,13,6,19,11,32,26,11,19,91,95
2021,2,22101179,4/5/2022,1610612739,Cleveland Cavaliers,0,0,1610612753,Orlando Magic,1,1,26,24,50,16,20,36,42,44,86,15,7,22,10,38,25,9,12,99,115
2021,2,22101179,4/5/2022,1610612753,Orlando Magic,1,1,1610612739,Cleveland Cavaliers,0,0,31,27,58,16,19,35,47,46,93,10,5,15,10,39,31,6,7,97,120
2014,2,21400297,12/7/2014,1610612760,Oklahoma City Thunder,0,1,1610612765,Detroit Pistons,1,0,33,33,66,6,15,21,39,48,87,12,5,17,18,32,20,5,15,92,96
2023,2,22300001,11/3/2023,1610612739,Cleveland Cavaliers,0,0,1610612754,Indiana Pacers,1,1,36,20,56,8,20,28,44,40,84,20,5,25,8,37,27,7,13,102,116
2014,2,21400297,12/7/2014,1610612765,Detroit Pistons,1,0,1610612760,Oklahoma City Thunder,0,1,27,26,53,7,16,23,34,42,76,19,9,28,11,36,25,5,14,91,94
2021,2,22100820,2/8/2022,1610612765,Detroit Pistons,0,0,1610612742,Dallas Mavericks,1,1,28,29,57,5,25,30,33,54,87,15,7,22,17,42,20,10,15,96,86
2014,2,21400296,12/7/2014,1610612748,Miami Heat,0,0,1610612763,Memphis Grizzlies,1,1,34,30,64,5,11,16,39,41,80,4,4,8,12,31,21,7,11,83,87
2017,2,21700661,1/17/2018,1610612758,Sacramento Kings,1,0,1610612762,Utah Jazz,0,1,25,26,51,13,8,21,38,34,72,16,4,20,9,25,19,15,19,91,105
2017,2,21700661,1/17/2018,1610612762,Utah Jazz,0,1,1610612758,Sacramento Kings,1,0,34,18,52,12,17,29,46,35,81,16,4,20,8,30,26,9,10,91,120
2023,2,22300174,11/11/2023,1610612761,Toronto Raptors,0,0,1610612738,Boston Celtics,1,1,25,29,54,10,27,37,35,56,91,14,2,16,13,45,25,1,9,97,94
2023,2,22300231,11/22/2023,1610612763,Memphis Grizzlies,0,0,1610612745,Houston Rockets,1,1,20,30,50,7,25,32,27,55,82,30,5,35,12,43,17,6,9,96,91
2014,2,21400594,1/16/2015,1610612743,Denver Nuggets,0,0,1610612742,Dallas Mavericks,1,1,25,33,58,9,16,25,34,49,83,12,13,25,13,43,23,7,15,97,89
2014,2,21400296,12/7/2014,1610612763,Memphis Grizzlies,1,1,1610612748,Miami Heat,0,0,35,25,60,8,5,13,43,30,73,9,2,11,9,21,24,10,14,83,103
2023,2,22300248,11/26/2023,1610612753,Orlando Magic,1,1,1610612766,Charlotte Hornets,0,0,37,23,60,10,17,27,47,40,87,26,7,33,11,33,33,6,15,105,130
2014,2,21400295,12/7/2014,1610612737,Atlanta Hawks,1,1,1610612743,Denver Nuggets,0,0,26,34,60,10,17,27,36,51,87,14,5,19,17,38,26,9,12,91,96
2023,2,22300231,11/22/2023,1610612745,Houston Rockets,1,1,1610612763,Memphis Grizzlies,0,0,26,23,49,14,29,43,40,52,92,17,3,20,11,43,22,3,7,97,111
2021,2,22100819,2/8/2022,1610612740,New Orleans Pelicans,1,1,1610612745,Houston Rockets,0,0,34,14,48,8,24,32,42,38,80,18,2,20,9,30,27,8,19,98,110
2014,2,21400295,12/7/2014,1610612743,Denver Nuggets,0,0,1610612737,Atlanta Hawks,1,1,28,30,58,6,29,35,34,59,93,10,3,13,22,38,25,9,14,91,84
2021,2,22101178,4/5/2022,1610612754,Indiana Pacers,1,0,1610612755,Philadelphia 76ers,0,1,33,22,55,12,28,40,45,50,95,20,1,21,18,32,29,8,16,101,122
2016,2,21600411,12/18/2016,1610612742,Dallas Mavericks,1,1,1610612758,Sacramento Kings,0,0,21,23,44,13,20,33,34,43,77,18,4,22,7,37,20,7,11,91,99
2021,2,22101178,4/5/2022,1610612755,Philadelphia 76ers,0,1,1610612754,Indiana Pacers,1,0,24,23,47,23,17,40,47,40,87,14,4,18,10,34,34,8,16,100,131
2016,2,21600411,12/18/2016,1610612758,Sacramento Kings,0,0,1610612742,Dallas Mavericks,1,1,22,23,45,8,23,31,30,46,76,11,6,17,10,39,16,10,16,90,79
2023,2,22300009,11/10/2023,1610612764,Washington Wizards,1,0,1610612766,Charlotte Hornets,0,1,29,21,50,14,24,38,43,45,88,17,3,20,9,39,28,10,15,101,117
2017,2,21700660,1/17/2018,1610612747,Los Angeles Lakers,0,0,1610612760,Oklahoma City Thunder,1,1,28,27,55,10,16,26,38,43,81,4,0,4,9,34,25,10,18,92,90
2017,2,21700660,1/17/2018,1610612760,Oklahoma City Thunder,1,1,1610612747,Los Angeles Lakers,0,0,34,26,60,12,23,35,46,49,95,10,2,12,25,26,22,9,17,93,114
2016,2,21600943,3/6/2017,1610612743,Denver Nuggets,1,1,1610612758,Sacramento Kings,0,0,24,20,44,13,17,30,37,37,74,21,7,28,11,30,28,9,19,95,108
2016,2,21600943,3/6/2017,1610612758,Sacramento Kings,0,0,1610612743,Denver Nuggets,1,1,30,37,67,6,10,16,36,47,83,18,3,21,14,34,20,11,16,95,96
2021,2,22100819,2/8/2022,1610612745,Houston Rockets,0,0,1610612740,New Orleans Pelicans,1,1,19,25,44,13,29,42,32,54,86,20,11,31,23,38,19,10,21,98,97
2020,2,22000493,2/24/2021,1610612741,Chicago Bulls,1,1,1610612750,Minnesota Timberwolves,0,0,45,23,68,10,15,25,55,38,93,13,3,16,10,30,28,11,21,114,133
2014,2,21400593,1/16/2015,1610612744,Golden State Warriors,0,0,1610612760,Oklahoma City Thunder,1,1,33,35,68,9,15,24,42,50,92,22,6,28,15,39,24,8,14,105,115
2014,2,21400593,1/16/2015,1610612760,Oklahoma City Thunder,1,1,1610612744,Golden State Warriors,0,0,41,34,75,10,12,22,51,46,97,15,4,19,16,32,27,10,14,105,127
2017,2,21700659,1/17/2018,1610612748,Miami Heat,0,1,1610612749,Milwaukee Bucks,1,0,28,30,58,10,14,24,38,44,82,20,7,27,14,34,28,6,15,94,106
2017,2,21700659,1/17/2018,1610612749,Milwaukee Bucks,1,0,1610612748,Miami Heat,0,1,22,26,48,11,17,28,33,43,76,24,8,32,8,38,23,4,10,94,101
2014,2,21401119,4/1/2015,1610612750,Minnesota Timberwolves,1,0,1610612761,Toronto Raptors,0,1,36,27,63,5,9,14,41,36,77,12,7,19,10,30,21,8,13,90,99
2014,2,21401119,4/1/2015,1610612761,Toronto Raptors,0,1,1610612750,Minnesota Timberwolves,1,0,29,17,46,13,17,30,42,34,76,16,7,23,12,25,25,7,13,88,113
2014,2,21400592,1/16/2015,1610612737,Atlanta Hawks,0,1,1610612761,Toronto Raptors,1,0,30,16,46,12,11,23,42,27,69,14,2,16,4,25,30,7,17,89,110
2014,2,21400592,1/16/2015,1610612761,Toronto Raptors,1,0,1610612737,Atlanta Hawks,0,1,29,28,57,6,19,25,35,47,82,13,4,17,21,29,20,7,19,91,89
2022,2,22200635,1/13/2023,1610612744,Golden State Warriors,0,1,1610612759,San Antonio Spurs,1,0,37,16,53,18,30,48,55,46,101,16,4,20,13,34,33,6,13,109,144
2022,2,22200635,1/13/2023,1610612759,San Antonio Spurs,1,0,1610612744,Golden State Warriors,0,1,32,34,66,8,14,22,40,48,88,25,9,34,10,43,26,9,15,109,113
2023,2,22300370,12/20/2023,1610612747,Los Angeles Lakers,0,0,1610612741,Chicago Bulls,1,1,30,27,57,12,25,37,42,52,94,12,3,15,11,41,27,7,14,102,108
2017,2,21700658,1/17/2018,1610612752,New York Knicks,0,0,1610612763,Memphis Grizzlies,1,1,28,27,55,7,20,27,35,47,82,22,1,23,16,31,22,9,14,93,99
2017,2,21700658,1/17/2018,1610612763,Memphis Grizzlies,1,1,1610612752,New York Knicks,0,0,31,32,63,10,18,28,41,50,91,13,4,17,19,33,23,5,12,92,105
2014,2,21400294,12/7/2014,1610612738,Boston Celtics,1,1,1610612764,Washington Wizards,0,0,28,43,71,8,9,17,36,52,88,21,5,26,14,40,20,5,16,102,101
2014,2,21400294,12/7/2014,1610612764,Washington Wizards,0,0,1610612738,Boston Celtics,1,1,23,43,66,11,16,27,34,59,93,14,7,21,20,41,21,10,19,103,93
2016,2,21600410,12/18/2016,1610612738,Boston Celtics,0,1,1610612748,Miami Heat,1,0,32,30,62,9,19,28,41,49,90,14,5,19,14,36,21,7,13,98,105
2023,2,22300175,11/11/2023,1610612737,Atlanta Hawks,1,0,1610612748,Miami Heat,0,1,20,21,41,18,28,46,38,49,87,15,3,18,16,35,23,10,22,102,109
2020,2,22000493,2/24/2021,1610612750,Minnesota Timberwolves,0,0,1610612741,Chicago Bulls,1,1,35,31,66,12,26,38,47,57,104,20,1,21,17,41,28,11,17,112,126
2016,2,21600410,12/18/2016,1610612748,Miami Heat,1,0,1610612738,Boston Celtics,0,1,27,18,45,9,15,24,36,33,69,14,11,25,7,32,23,13,23,98,95
2016,2,21600043,10/31/2016,1610612741,Chicago Bulls,0,1,1610612751,Brooklyn Nets,1,0,34,28,62,11,16,27,45,44,89,17,1,18,15,29,26,12,20,101,118
2023,2,22300233,11/22/2023,1610612740,New Orleans Pelicans,1,1,1610612758,Sacramento Kings,0,0,34,23,57,7,23,30,41,46,87,28,9,37,15,34,23,3,10,99,117
2017,2,21700657,1/17/2018,1610612741,Chicago Bulls,1,0,1610612744,Golden State Warriors,0,1,35,32,67,10,29,39,45,61,106,12,1,13,17,45,24,5,11,105,112
2017,2,21700657,1/17/2018,1610612744,Golden State Warriors,0,1,1610612741,Chicago Bulls,1,0,29,22,51,13,20,33,42,42,84,22,3,25,7,37,24,10,15,104,119
2016,2,21600942,3/6/2017,1610612745,Houston Rockets,0,0,1610612759,San Antonio Spurs,1,1,27,22,49,14,25,39,41,47,88,14,3,17,8,40,19,6,12,98,110
2014,2,21400591,1/16/2015,1610612738,Boston Celtics,1,0,1610612741,Chicago Bulls,0,1,37,32,69,5,11,16,42,43,85,14,2,16,14,30,29,12,14,92,103
2014,2,21400591,1/16/2015,1610612741,Chicago Bulls,0,1,1610612738,Boston Celtics,1,0,35,29,64,13,12,25,48,41,89,10,2,12,9,34,28,5,7,92,119
2016,2,21600942,3/6/2017,1610612759,San Antonio Spurs,1,1,1610612745,Houston Rockets,0,0,29,31,60,11,17,28,40,48,88,21,2,23,13,37,24,3,10,98,112
2016,2,21600409,12/18/2016,1610612753,Orlando Magic,1,0,1610612761,Toronto Raptors,0,1,31,31,62,3,18,21,34,49,83,8,1,9,12,38,13,10,20,93,79
2023,2,22300395,12/23/2023,1610612761,Toronto Raptors,1,0,1610612762,Utah Jazz,0,1,32,30,62,13,19,32,45,49,94,16,3,19,17,35,35,7,11,98,119
2014,2,21400590,1/16/2015,1610612751,Brooklyn Nets,0,1,1610612764,Washington Wizards,1,0,33,36,69,4,8,12,37,44,81,24,7,31,13,35,18,6,10,90,102
2014,2,21400590,1/16/2015,1610612764,Washington Wizards,1,0,1610612751,Brooklyn Nets,0,1,27,29,56,4,13,17,31,42,73,14,2,16,9,34,23,12,19,91,80
2017,2,21700656,1/17/2018,1610612761,Toronto Raptors,1,1,1610612765,Detroit Pistons,0,0,23,26,49,11,20,31,34,46,80,17,6,23,16,35,24,14,21,95,96
2017,2,21700656,1/17/2018,1610612765,Detroit Pistons,0,0,1610612761,Toronto Raptors,1,1,27,33,60,10,18,28,37,51,88,7,8,15,16,39,22,6,15,95,91
2022,2,22200642,1/14/2023,1610612766,Charlotte Hornets,1,0,1610612738,Boston Celtics,0,1,33,28,61,8,19,27,41,47,88,16,3,19,11,36,21,8,11,94,106
2023,2,22300031,11/17/2023,1610612738,Boston Celtics,0,1,1610612761,Toronto Raptors,1,0,26,20,46,16,30,46,42,50,92,8,1,9,10,40,29,4,11,97,108
2016,2,21600409,12/18/2016,1610612761,Toronto Raptors,0,1,1610612753,Orlando Magic,1,0,36,24,60,7,20,27,43,44,87,16,5,21,14,33,20,5,11,94,109
2016,2,21600043,10/31/2016,1610612751,Brooklyn Nets,1,0,1610612741,Chicago Bulls,0,1,28,37,65,5,26,31,33,63,96,17,4,21,20,45,14,9,15,100,88
2022,2,22200642,1/14/2023,1610612738,Boston Celtics,0,1,1610612766,Charlotte Hornets,1,0,28,18,46,19,34,53,47,52,99,9,1,10,15,38,35,3,7,94,122
2023,2,22300214,11/19/2023,1610612756,Phoenix Suns,0,1,1610612762,Utah Jazz,1,0,32,25,57,18,27,45,50,52,102,22,4,26,17,38,36,11,18,116,140
2022,2,22200645,1/14/2023,1610612739,Cleveland Cavaliers,0,0,1610612750,Minnesota Timberwolves,1,1,29,19,48,8,20,28,37,39,76,20,3,23,9,31,24,10,18,95,102
2022,2,22200645,1/14/2023,1610612750,Minnesota Timberwolves,1,1,1610612739,Cleveland Cavaliers,0,0,36,16,52,9,19,28,45,35,80,11,4,15,6,32,22,5,15,95,110
2017,2,21700655,1/17/2018,1610612751,Brooklyn Nets,1,0,1610612759,San Antonio Spurs,0,1,22,25,47,13,23,36,35,48,83,12,6,18,9,41,23,8,14,95,95
2021,2,22100818,2/8/2022,1610612746,LA Clippers,0,0,1610612763,Memphis Grizzlies,1,1,29,29,58,11,20,31,40,49,89,18,6,24,15,36,25,12,17,105,109
2021,2,22100818,2/8/2022,1610612763,Memphis Grizzlies,1,1,1610612746,LA Clippers,0,0,44,33,77,9,17,26,53,50,103,20,5,25,22,30,26,8,13,104,135
2021,2,22101177,4/3/2022,1610612740,New Orleans Pelicans,0,0,1610612746,LA Clippers,1,1,26,37,63,9,15,24,35,52,87,21,6,27,24,33,22,10,16,94,100
2021,2,22101177,4/3/2022,1610612746,LA Clippers,1,1,1610612740,New Orleans Pelicans,0,0,24,27,51,21,23,44,45,50,95,8,2,10,16,35,33,4,10,94,119
2020,2,22000492,2/24/2021,1610612748,Miami Heat,1,1,1610612761,Toronto Raptors,0,0,20,22,42,17,21,38,37,43,80,25,4,29,14,30,31,5,11,91,116
2020,2,22000492,2/24/2021,1610612761,Toronto Raptors,0,0,1610612748,Miami Heat,1,1,17,13,30,20,24,44,37,37,74,14,3,17,6,33,30,6,16,92,108
2017,2,21700655,1/17/2018,1610612759,San Antonio Spurs,0,1,1610612751,Brooklyn Nets,1,0,25,38,63,9,10,19,34,48,82,23,8,31,8,45,24,3,9,95,100
2014,2,21400589,1/16/2015,1610612740,New Orleans Pelicans,0,0,1610612755,Philadelphia 76ers,1,1,25,33,58,4,13,17,29,46,75,19,10,29,17,33,17,12,20,91,81
2014,2,21400589,1/16/2015,1610612755,Philadelphia 76ers,1,1,1610612740,New Orleans Pelicans,0,0,29,29,58,7,15,22,36,44,80,17,10,27,10,40,22,5,10,92,96
2017,2,21700654,1/17/2018,1610612737,Atlanta Hawks,1,1,1610612740,New Orleans Pelicans,0,0,27,22,49,10,30,40,37,52,89,10,3,13,18,36,32,5,11,88,94
2022,2,22200644,1/14/2023,1610612737,Atlanta Hawks,0,1,1610612761,Toronto Raptors,1,0,32,25,57,11,16,27,43,41,84,17,1,18,7,35,19,9,12,98,114
2017,2,21700654,1/17/2018,1610612740,New Orleans Pelicans,0,0,1610612737,Atlanta Hawks,1,1,25,28,53,10,17,27,35,45,80,13,6,19,16,31,27,5,14,89,93
2023,2,22300217,11/20/2023,1610612766,Charlotte Hornets,1,1,1610612738,Boston Celtics,0,0,33,32,65,13,26,39,46,58,104,16,1,17,20,38,29,6,13,106,121
2014,2,21400293,12/6/2014,1610612740,New Orleans Pelicans,0,0,1610612746,LA Clippers,1,1,30,27,57,8,15,23,38,42,80,16,9,25,14,33,26,7,11,90,100
2014,2,21400293,12/6/2014,1610612746,LA Clippers,1,1,1610612740,New Orleans Pelicans,0,0,26,20,46,17,15,32,43,35,78,17,7,24,6,34,34,4,7,90,120
2020,2,22000491,2/24/2021,1610612739,Cleveland Cavaliers,1,1,1610612745,Houston Rockets,0,0,27,22,49,16,20,36,43,42,85,10,5,15,18,27,24,8,18,94,112
2020,2,22000491,2/24/2021,1610612745,Houston Rockets,0,0,1610612739,Cleveland Cavaliers,1,1,26,31,57,10,23,33,36,54,90,14,3,17,10,46,18,4,7,94,96
2014,2,21400292,12/6/2014,1610612753,Orlando Magic,0,1,1610612758,Sacramento Kings,1,0,33,24,57,9,17,26,42,41,83,12,2,14,13,29,26,5,11,88,105
2017,2,21700653,1/17/2018,1610612764,Washington Wizards,0,0,1610612766,Charlotte Hornets,1,1,27,32,59,13,10,23,40,42,82,16,7,23,8,37,31,10,16,101,109
2017,2,21700653,1/17/2018,1610612766,Charlotte Hornets,1,1,1610612764,Washington Wizards,0,0,33,34,67,15,16,31,48,50,98,22,4,26,17,35,27,3,10,102,133
2019,2,21900218,11/22/2019,1610612755,Philadelphia 76ers,1,1,1610612759,San Antonio Spurs,0,0,36,27,63,10,16,26,46,43,89,13,6,19,16,31,32,6,15,98,115
2019,2,21900218,11/22/2019,1610612759,San Antonio Spurs,0,0,1610612755,Philadelphia 76ers,1,1,37,30,67,6,12,18,43,42,85,12,4,16,5,40,21,8,11,97,104
2019,2,21900002,10/22/2019,1610612746,LA Clippers,1,1,1610612747,Los Angeles Lakers,0,0,31,19,50,11,20,31,42,39,81,17,7,24,11,32,24,4,14,95,112
2019,2,21900002,10/22/2019,1610612747,Los Angeles Lakers,0,0,1610612746,LA Clippers,1,1,24,28,52,13,20,33,37,48,85,15,6,21,14,36,20,8,15,96,102
2017,2,21700652,1/16/2018,1610612756,Phoenix Suns,0,0,1610612757,Portland Trail Blazers,1,1,21,27,48,16,25,41,37,52,89,21,1,22,18,35,21,7,13,95,111
2017,2,21700652,1/16/2018,1610612757,Portland Trail Blazers,1,1,1610612756,Phoenix Suns,0,0,29,27,56,17,18,35,46,45,91,9,1,10,12,33,21,6,10,94,118
2016,2,21600941,3/6/2017,1610612754,Indiana Pacers,0,0,1610612766,Charlotte Hornets,1,1,25,26,51,12,18,30,37,44,81,2,1,3,8,37,29,10,16,91,88
2016,2,21600941,3/6/2017,1610612766,Charlotte Hornets,1,1,1610612754,Indiana Pacers,0,0,24,31,55,11,20,31,35,51,86,19,2,21,16,37,21,3,12,91,100
2016,2,21600408,12/18/2016,1610612751,Brooklyn Nets,0,0,1610612755,Philadelphia 76ers,1,1,24,23,47,12,22,34,36,45,81,23,8,31,11,36,26,5,16,103,107
2016,2,21600408,12/18/2016,1610612755,Philadelphia 76ers,1,1,1610612751,Brooklyn Nets,0,0,26,34,60,12,16,28,38,50,88,20,3,23,15,36,23,8,17,102,108
2014,2,21401118,4/1/2015,1610612741,Chicago Bulls,0,0,1610612749,Milwaukee Bucks,1,1,26,22,48,5,21,26,31,43,74,24,13,37,19,29,18,11,22,95,91
2021,2,22101176,4/3/2022,1610612744,Golden State Warriors,0,1,1610612758,Sacramento Kings,1,0,25,20,45,16,18,34,41,38,79,11,4,15,10,30,29,5,17,95,109
2021,2,22101176,4/3/2022,1610612758,Sacramento Kings,1,0,1610612744,Golden State Warriors,0,1,24,24,48,7,26,33,31,50,81,21,3,24,9,43,19,8,13,95,90
2022,2,22200644,1/14/2023,1610612761,Toronto Raptors,1,0,1610612737,Atlanta Hawks,0,1,29,29,58,7,22,29,36,51,87,24,6,30,18,35,19,6,14,99,103
2022,2,22200650,1/15/2023,1610612741,Chicago Bulls,1,1,1610612744,Golden State Warriors,0,0,33,23,56,15,24,39,48,47,95,21,3,24,10,37,29,6,10,106,132
2022,2,22200501,12/26/2022,1610612741,Chicago Bulls,1,0,1610612745,Houston Rockets,0,1,32,25,57,13,22,35,45,47,92,15,6,21,9,40,27,7,8,99,118
2022,2,22200501,12/26/2022,1610612745,Houston Rockets,0,1,1610612741,Chicago Bulls,1,0,33,13,46,17,27,44,50,40,90,16,6,22,13,30,28,6,13,100,133
2022,2,22200650,1/15/2023,1610612744,Golden State Warriors,0,0,1610612741,Chicago Bulls,1,1,20,12,32,21,30,51,41,42,83,15,7,22,10,36,35,12,23,108,118
2016,2,21600042,10/31/2016,1610612743,Denver Nuggets,0,0,1610612761,Toronto Raptors,1,1,24,35,59,9,13,22,33,48,81,27,8,35,15,36,14,7,8,92,102
2016,2,21600042,10/31/2016,1610612761,Toronto Raptors,1,1,1610612743,Denver Nuggets,0,0,37,35,72,4,12,16,41,47,88,19,6,25,16,36,16,2,8,92,105
2022,2,22200641,1/14/2023,1610612748,Miami Heat,1,1,1610612749,Milwaukee Bucks,0,0,34,31,65,11,11,22,45,42,87,10,2,12,14,29,17,7,11,89,111
2014,2,21400292,12/6/2014,1610612758,Sacramento Kings,1,0,1610612753,Orlando Magic,0,1,31,33,64,4,11,15,35,44,79,22,6,28,13,33,22,4,11,89,96
2017,2,21700651,1/16/2018,1610612742,Dallas Mavericks,0,0,1610612743,Denver Nuggets,1,1,30,21,51,8,19,27,38,40,78,18,4,22,7,35,17,9,16,98,102
2022,2,22200641,1/14/2023,1610612749,Milwaukee Bucks,0,0,1610612748,Miami Heat,1,1,15,21,36,19,29,48,34,50,84,8,4,12,11,40,26,9,10,90,95
2017,2,21700651,1/16/2018,1610612743,Denver Nuggets,1,1,1610612742,Dallas Mavericks,0,0,32,28,60,8,18,26,40,46,86,17,9,26,18,32,23,10,19,99,105
2021,2,22101175,4/3/2022,1610612757,Portland Trail Blazers,0,0,1610612759,San Antonio Spurs,1,1,17,22,39,16,29,45,33,51,84,10,5,15,11,42,22,9,14,95,92
2021,2,22101175,4/3/2022,1610612759,San Antonio Spurs,1,1,1610612757,Portland Trail Blazers,0,0,24,18,42,14,28,42,38,46,84,23,7,30,16,33,25,7,13,94,113
2023,2,22300249,11/26/2023,1610612763,Memphis Grizzlies,1,0,1610612750,Minnesota Timberwolves,0,1,24,27,51,10,27,37,34,54,88,19,8,27,18,38,24,5,14,97,97
2016,2,21600940,4/3/2017,1610612750,Minnesota Timberwolves,1,1,1610612757,Portland Trail Blazers,0,0,37,38,75,4,5,9,41,43,84,24,4,28,19,27,26,7,11,89,110
2016,2,21600940,4/3/2017,1610612757,Portland Trail Blazers,0,0,1610612750,Minnesota Timberwolves,1,1,27,27,54,11,21,32,38,48,86,22,3,25,14,36,24,3,5,91,109
2023,2,22300393,12/23/2023,1610612763,Memphis Grizzlies,0,1,1610612737,Atlanta Hawks,1,0,39,25,64,11,22,33,50,47,97,14,8,22,19,30,29,8,12,98,125
2017,2,21700650,1/16/2018,1610612738,Boston Celtics,1,0,1610612740,New Orleans Pelicans,0,1,21,30,51,19,31,50,40,61,101,14,2,16,17,45,27,11,19,111,113
2017,2,21700650,1/16/2018,1610612740,New Orleans Pelicans,0,1,1610612738,Boston Celtics,1,0,38,35,73,7,20,27,45,55,100,18,6,24,17,42,28,7,15,111,115
2023,2,22300029,11/17/2023,1610612737,Atlanta Hawks,1,0,1610612755,Philadelphia 76ers,0,1,28,28,56,12,21,33,40,49,89,24,6,30,19,31,24,9,13,97,116
2014,2,21400291,12/6/2014,1610612750,Minnesota Timberwolves,0,0,1610612759,San Antonio Spurs,1,1,29,38,67,6,10,16,35,48,83,25,7,32,10,40,20,5,8,97,101
2014,2,21401118,4/1/2015,1610612749,Milwaukee Bucks,1,1,1610612741,Chicago Bulls,0,0,29,39,68,8,13,21,37,52,89,13,5,18,23,31,15,11,18,95,95
2023,2,22300833,2/27/2024,1610612751,Brooklyn Nets,0,0,1610612753,Orlando Magic,1,1,23,25,48,8,23,31,31,48,79,11,3,14,14,36,18,14,22,95,81
2022,2,22200678,1/19/2023,1610612741,Chicago Bulls,0,1,1610612765,Detroit Pistons,1,0,43,26,69,7,16,23,50,42,92,19,2,21,11,33,23,7,14,104,126
2017,2,21700649,1/16/2018,1610612750,Minnesota Timberwolves,0,0,1610612753,Orlando Magic,1,1,36,46,82,7,9,16,43,55,98,9,1,10,17,39,19,4,8,95,102
2017,2,21700649,1/16/2018,1610612753,Orlando Magic,1,1,1610612750,Minnesota Timberwolves,0,0,29,30,59,11,20,31,40,50,90,17,2,19,23,29,24,10,18,95,108
2014,2,21400291,12/6/2014,1610612759,San Antonio Spurs,1,1,1610612750,Minnesota Timberwolves,0,0,40,24,64,7,11,18,47,35,82,22,3,25,11,26,30,10,17,97,123
2016,2,21600407,12/18/2016,1610612762,Utah Jazz,0,1,1610612763,Memphis Grizzlies,1,0,22,17,39,8,19,27,30,36,66,14,11,25,7,35,18,8,15,86,82
2016,2,21600407,12/18/2016,1610612763,Memphis Grizzlies,1,0,1610612762,Utah Jazz,0,1,26,44,70,2,21,23,28,65,93,15,3,18,26,40,12,4,11,87,73
2023,2,22300311,12/13/2023,1610612764,Washington Wizards,1,0,1610612740,New Orleans Pelicans,0,1,23,15,38,19,25,44,42,40,82,19,5,24,4,38,28,11,15,104,122
2023,2,22300068,10/25/2023,1610612748,Miami Heat,1,1,1610612765,Detroit Pistons,0,0,29,41,70,8,14,22,37,55,92,21,5,26,17,40,22,3,7,95,103
2023,2,22300006,11/3/2023,1610612743,Denver Nuggets,1,1,1610612742,Dallas Mavericks,0,0,36,27,63,13,17,30,49,44,93,14,5,19,23,25,33,12,20,97,125
2020,2,22000520,2/28/2021,1610612746,LA Clippers,0,0,1610612749,Milwaukee Bucks,1,1,26,27,53,14,30,44,40,57,97,6,1,7,16,41,20,6,9,94,100
2023,2,22300030,11/17/2023,1610612765,Detroit Pistons,0,0,1610612739,Cleveland Cavaliers,1,1,30,26,56,9,26,35,39,52,91,13,2,15,19,34,20,9,17,97,100
2023,2,22300242,11/25/2023,1610612739,Cleveland Cavaliers,1,0,1610612747,Los Angeles Lakers,0,1,34,29,63,9,19,28,43,48,91,20,3,23,10,40,30,9,14,106,115
2023,2,22300007,11/3/2023,1610612763,Memphis Grizzlies,0,0,1610612757,Portland Trail Blazers,1,1,37,24,61,10,25,35,47,49,96,9,4,13,14,37,29,12,18,107,113
2021,2,22100817,2/8/2022,1610612738,Boston Celtics,0,1,1610612751,Brooklyn Nets,1,0,36,15,51,14,26,40,50,41,91,12,4,16,15,28,32,6,14,97,126
2021,2,22100817,2/8/2022,1610612751,Brooklyn Nets,1,0,1610612738,Boston Celtics,0,1,28,35,63,10,26,36,38,61,99,5,8,13,23,43,22,6,14,98,91
2017,2,21700648,1/15/2018,1610612745,Houston Rockets,0,0,1610612746,LA Clippers,1,1,25,25,50,13,31,44,38,56,94,13,3,16,18,39,21,6,14,100,102
2017,2,21700648,1/15/2018,1610612746,LA Clippers,1,1,1610612745,Houston Rockets,0,0,34,20,54,10,15,25,44,35,79,15,5,20,7,29,30,9,19,101,113
2021,2,22101174,4/3/2022,1610612756,Phoenix Suns,0,0,1610612760,Oklahoma City Thunder,1,1,30,21,51,7,31,38,37,52,89,15,2,17,8,45,22,7,11,99,96
2021,2,22101174,4/3/2022,1610612760,Oklahoma City Thunder,1,1,1610612756,Phoenix Suns,0,0,26,20,46,17,24,41,43,44,87,14,4,18,13,32,33,14,18,101,117
2020,2,22000520,2/28/2021,1610612749,Milwaukee Bucks,1,1,1610612746,LA Clippers,0,0,26,21,47,12,26,38,38,47,85,17,5,22,11,38,21,8,13,96,105
2014,2,21400290,12/6/2014,1610612745,Houston Rockets,1,1,1610612756,Phoenix Suns,0,0,22,32,54,11,16,27,33,48,81,23,8,31,24,27,16,14,24,98,100
2014,2,21401117,4/1/2015,1610612745,Houston Rockets,1,1,1610612758,Sacramento Kings,0,0,23,26,49,18,22,40,41,48,89,15,10,25,17,38,24,9,17,101,115
2014,2,21401117,4/1/2015,1610612758,Sacramento Kings,0,0,1610612745,Houston Rockets,1,1,41,41,82,7,7,14,48,48,96,8,8,16,23,29,30,14,21,102,111
2014,2,21400290,12/6/2014,1610612756,Phoenix Suns,0,0,1610612745,Houston Rockets,1,1,27,38,65,7,21,28,34,59,93,20,6,26,22,39,16,7,13,99,95
2023,2,22300007,11/3/2023,1610612757,Portland Trail Blazers,1,1,1610612763,Memphis Grizzlies,0,0,30,34,64,9,23,32,39,57,96,28,8,36,18,44,19,8,13,106,115
2021,2,22100816,2/8/2022,1610612737,Atlanta Hawks,1,1,1610612754,Indiana Pacers,0,0,35,22,57,17,16,33,52,38,90,12,4,16,16,25,36,10,16,98,133
2021,2,22100816,2/8/2022,1610612754,Indiana Pacers,0,0,1610612737,Atlanta Hawks,1,1,27,35,62,10,21,31,37,56,93,28,5,33,24,34,22,8,13,98,112
2021,2,22101173,4/3/2022,1610612745,Houston Rockets,1,0,1610612750,Minnesota Timberwolves,0,1,32,13,45,16,24,40,48,37,85,20,9,29,13,30,28,13,24,107,132
2021,2,22101173,4/3/2022,1610612750,Minnesota Timberwolves,0,1,1610612745,Houston Rockets,1,0,34,11,45,17,24,41,51,35,86,20,5,25,8,31,32,8,19,107,139
2022,2,22200646,1/14/2023,1610612755,Philadelphia 76ers,0,1,1610612762,Utah Jazz,1,0,23,27,50,17,22,39,40,49,89,21,5,26,11,40,23,5,9,97,118
2022,2,22200646,1/14/2023,1610612762,Utah Jazz,1,0,1610612755,Philadelphia 76ers,0,1,31,19,50,12,28,40,43,47,90,19,4,23,16,32,20,5,11,98,117
2017,2,21700647,1/15/2018,1610612754,Indiana Pacers,0,1,1610612762,Utah Jazz,1,0,27,24,51,14,12,26,41,36,77,13,2,15,8,29,26,11,14,89,109
2017,2,21700647,1/15/2018,1610612762,Utah Jazz,1,0,1610612754,Indiana Pacers,0,1,27,21,48,9,24,33,36,45,81,13,4,17,11,36,11,7,13,90,94
2021,2,22100815,2/8/2022,1610612755,Philadelphia 76ers,1,0,1610612756,Phoenix Suns,0,1,31,26,57,10,22,32,41,48,89,17,1,18,10,38,24,7,15,103,109
2014,2,21400588,1/16/2015,1610612753,Orlando Magic,1,0,1610612763,Memphis Grizzlies,0,1,27,28,55,9,15,24,36,43,79,15,5,20,7,39,22,8,15,97,96
2014,2,21400588,1/16/2015,1610612763,Memphis Grizzlies,0,1,1610612753,Orlando Magic,1,0,37,36,73,3,11,14,40,47,87,23,6,29,13,37,27,5,11,98,106
2021,2,22100815,2/8/2022,1610612756,Phoenix Suns,0,1,1610612755,Philadelphia 76ers,1,0,37,32,69,6,20,26,43,52,95,22,2,24,12,41,27,7,8,102,114
2017,2,21700646,1/15/2018,1610612739,Cleveland Cavaliers,1,0,1610612744,Golden State Warriors,0,1,36,30,66,7,21,28,43,51,94,15,7,22,17,39,26,8,15,101,108
2021,2,22101172,4/3/2022,1610612748,Miami Heat,0,1,1610612761,Toronto Raptors,1,0,23,18,41,18,20,38,41,38,79,14,8,22,11,30,30,12,17,96,114
2017,2,21700646,1/15/2018,1610612744,Golden State Warriors,0,1,1610612739,Cleveland Cavaliers,1,0,29,24,53,12,20,32,41,44,85,24,6,30,16,32,33,9,17,103,118
2022,2,22200494,12/25/2022,1610612742,Dallas Mavericks,1,1,1610612747,Los Angeles Lakers,0,0,26,14,40,18,26,44,44,40,84,18,7,25,13,32,31,5,11,93,124
2021,2,22101172,4/3/2022,1610612761,Toronto Raptors,1,0,1610612748,Miami Heat,0,1,23,21,44,12,27,39,35,48,83,27,7,34,19,32,19,9,17,97,109
2022,2,22200494,12/25/2022,1610612747,Los Angeles Lakers,0,0,1610612742,Dallas Mavericks,1,1,30,22,52,9,19,28,39,41,80,28,4,32,11,32,18,6,10,94,115
2022,2,22200643,1/14/2023,1610612754,Indiana Pacers,1,0,1610612763,Memphis Grizzlies,0,1,27,29,56,11,36,47,38,65,103,25,3,28,24,41,26,11,19,110,112
2022,2,22200643,1/14/2023,1610612763,Memphis Grizzlies,0,1,1610612754,Indiana Pacers,1,0,36,19,55,12,20,32,48,39,87,22,6,28,8,34,32,5,17,110,130
2014,2,21400289,12/6/2014,1610612741,Chicago Bulls,1,0,1610612744,Golden State Warriors,0,1,29,33,62,7,14,21,36,47,83,23,4,27,22,26,24,14,23,97,102
2014,2,21400289,12/6/2014,1610612744,Golden State Warriors,0,1,1610612741,Chicago Bulls,1,0,28,31,59,12,18,30,40,49,89,20,5,25,17,35,27,6,11,96,112
2017,2,21700645,1/15/2018,1610612747,Los Angeles Lakers,0,0,1610612763,Memphis Grizzlies,1,1,26,35,61,12,23,35,38,58,96,26,5,31,17,43,25,8,14,108,114
2017,2,21700645,1/15/2018,1610612763,Memphis Grizzlies,1,1,1610612747,Los Angeles Lakers,0,0,32,28,60,10,12,22,42,40,82,29,5,34,7,34,24,11,19,108,123
2014,2,21401116,4/1/2015,1610612751,Brooklyn Nets,0,1,1610612752,New York Knicks,1,0,32,33,65,9,7,16,41,40,81,9,3,12,7,34,24,6,10,90,100
2014,2,21401116,4/1/2015,1610612752,New York Knicks,1,0,1610612751,Brooklyn Nets,0,1,26,32,58,11,12,23,37,44,81,13,2,15,15,31,20,8,16,91,98
2023,2,22300006,11/3/2023,1610612742,Dallas Mavericks,0,0,1610612743,Denver Nuggets,1,1,24,20,44,17,25,42,41,45,86,15,2,17,11,34,27,11,15,96,114
2023,2,22300311,12/13/2023,1610612740,New Orleans Pelicans,0,1,1610612764,Washington Wizards,1,0,34,28,62,16,18,34,50,46,96,26,4,30,16,32,30,7,10,104,142
2021,2,22100814,2/7/2022,1610612752,New York Knicks,0,0,1610612762,Utah Jazz,1,1,28,34,62,8,25,33,36,59,95,24,11,35,29,36,18,6,16,99,104
2021,2,22100814,2/7/2022,1610612762,Utah Jazz,1,1,1610612752,New York Knicks,0,0,27,18,45,12,36,48,39,54,93,23,4,27,20,37,19,8,12,100,113
2014,2,21400288,12/6/2014,1610612755,Philadelphia 76ers,0,1,1610612765,Detroit Pistons,1,0,33,31,64,7,16,23,40,47,87,21,9,30,15,39,27,11,19,105,108
2014,2,21400288,12/6/2014,1610612765,Detroit Pistons,1,0,1610612755,Philadelphia 76ers,0,1,28,36,64,6,17,23,34,53,87,27,8,35,14,46,22,12,19,105,101
2020,2,22000490,2/24/2021,1610612737,Atlanta Hawks,1,1,1610612738,Boston Celtics,0,0,22,21,43,23,19,42,45,40,85,14,3,17,14,26,27,10,17,95,127
2021,2,22101171,4/3/2022,1610612752,New York Knicks,0,1,1610612753,Orlando Magic,1,0,30,19,49,15,29,44,45,48,93,13,3,16,14,36,29,5,10,96,118
2021,2,22101171,4/3/2022,1610612753,Orlando Magic,1,0,1610612752,New York Knicks,0,1,18,23,41,12,32,44,30,55,85,16,11,27,13,48,18,9,11,96,88
2014,2,21400587,1/16/2015,1610612754,Indiana Pacers,1,0,1610612765,Detroit Pistons,0,1,34,37,71,6,12,18,40,49,89,10,2,12,15,35,22,6,12,91,96
2014,2,21400587,1/16/2015,1610612765,Detroit Pistons,0,1,1610612754,Indiana Pacers,1,0,19,35,54,13,18,31,32,53,85,21,3,24,20,35,17,8,18,92,98
2017,2,21700644,1/15/2018,1610612741,Chicago Bulls,1,1,1610612748,Miami Heat,0,0,26,23,49,16,23,39,42,46,88,19,3,22,8,38,27,5,10,99,119
2022,2,22200647,1/14/2023,1610612742,Dallas Mavericks,0,0,1610612757,Portland Trail Blazers,1,1,21,15,36,22,24,46,43,39,82,11,8,19,4,40,28,7,11,97,119
2014,2,21400287,12/5/2014,1610612754,Indiana Pacers,0,0,1610612758,Sacramento Kings,1,1,30,40,70,6,20,26,36,60,96,23,6,29,17,45,18,6,9,104,101
2014,2,21400287,12/5/2014,1610612758,Sacramento Kings,1,1,1610612754,Indiana Pacers,0,0,34,39,73,2,8,10,36,47,83,28,12,40,16,37,16,10,15,101,102
2023,2,22300393,12/23/2023,1610612737,Atlanta Hawks,1,0,1610612763,Memphis Grizzlies,0,1,32,21,53,13,30,43,45,51,96,16,4,20,17,37,28,6,11,99,119
2017,2,21700644,1/15/2018,1610612748,Miami Heat,0,0,1610612741,Chicago Bulls,1,1,28,20,48,12,24,36,40,44,84,19,5,24,9,38,35,6,14,99,111
2022,2,22200647,1/14/2023,1610612757,Portland Trail Blazers,1,1,1610612742,Dallas Mavericks,0,0,32,15,47,17,24,41,49,39,88,21,1,22,13,27,34,4,12,97,136
2014,2,21400286,12/5/2014,1610612753,Orlando Magic,0,1,1610612762,Utah Jazz,1,0,30,27,57,7,10,17,37,37,74,17,3,20,10,30,15,4,9,83,98
2014,2,21400286,12/5/2014,1610612762,Utah Jazz,1,0,1610612753,Orlando Magic,0,1,28,35,63,8,8,16,36,43,79,13,8,21,17,31,23,6,12,84,93
2023,2,22300371,12/20/2023,1610612745,Houston Rockets,1,0,1610612737,Atlanta Hawks,0,1,28,27,55,16,18,34,44,45,89,23,0,23,11,34,25,4,9,98,127
2021,2,22100813,2/7/2022,1610612744,Golden State Warriors,0,1,1610612760,Oklahoma City Thunder,1,0,26,13,39,15,28,43,41,41,82,13,4,17,9,34,30,8,15,97,110
2021,2,22100813,2/7/2022,1610612760,Oklahoma City Thunder,1,0,1610612744,Golden State Warriors,0,1,26,28,54,11,25,36,37,53,90,13,4,17,19,36,21,12,18,98,98
2023,2,22300208,11/19/2023,1610612751,Brooklyn Nets,1,0,1610612755,Philadelphia 76ers,0,1,27,26,53,11,17,28,38,43,81,12,4,16,10,36,24,8,15,94,99
2017,2,21700643,1/15/2018,1610612758,Sacramento Kings,0,0,1610612760,Oklahoma City Thunder,1,1,26,28,54,7,23,30,33,51,84,15,10,25,11,44,22,10,14,99,88
2017,2,21700643,1/15/2018,1610612760,Oklahoma City Thunder,1,1,1610612758,Sacramento Kings,0,0,27,29,56,9,21,30,36,50,86,14,15,29,22,35,20,13,20,98,95
2023,2,22300675,1/31/2024,1610612739,Cleveland Cavaliers,1,1,1610612765,Detroit Pistons,0,0,35,19,54,12,23,35,47,42,89,22,1,23,12,30,26,8,9,97,128
2016,2,21600939,3/6/2017,1610612751,Brooklyn Nets,0,1,1610612763,Memphis Grizzlies,1,0,25,18,43,14,16,30,39,34,73,30,8,38,8,29,16,7,17,100,122
2021,2,22101170,4/3/2022,1610612739,Cleveland Cavaliers,1,0,1610612755,Philadelphia 76ers,0,1,20,25,45,15,18,33,35,43,78,23,8,31,8,38,24,7,12,97,108
2021,2,22101170,4/3/2022,1610612755,Philadelphia 76ers,0,1,1610612739,Cleveland Cavaliers,1,0,22,27,49,11,20,31,33,47,80,35,7,42,15,35,23,10,14,99,112
2020,2,22000770,4/6/2021,1610612737,Atlanta Hawks,1,1,1610612740,New Orleans Pelicans,0,0,24,33,57,20,11,31,44,44,88,15,7,22,11,37,24,7,11,98,123
2020,2,22000770,4/6/2021,1610612740,New Orleans Pelicans,0,0,1610612737,Atlanta Hawks,1,1,25,28,53,12,26,38,37,54,91,21,7,28,21,35,24,7,14,99,107
2023,2,22300008,11/10/2023,1610612755,Philadelphia 76ers,0,1,1610612765,Detroit Pistons,1,0,26,29,55,9,19,28,35,48,83,35,6,41,14,39,23,3,9,97,114
2017,2,21700642,1/15/2018,1610612751,Brooklyn Nets,1,0,1610612752,New York Knicks,0,1,21,34,55,11,21,32,32,55,87,29,7,36,14,45,16,5,11,100,104
2017,2,21700642,1/15/2018,1610612752,New York Knicks,0,1,1610612751,Brooklyn Nets,1,0,33,33,66,9,7,16,42,40,82,26,11,37,11,34,27,5,9,100,119
2016,2,21600939,3/6/2017,1610612763,Memphis Grizzlies,1,0,1610612751,Brooklyn Nets,0,1,24,28,52,10,15,25,34,43,77,31,8,39,11,37,23,12,16,100,109
2014,2,21400285,12/5/2014,1610612748,Miami Heat,0,0,1610612749,Milwaukee Bucks,1,1,23,27,50,7,11,18,30,38,68,18,9,27,6,36,21,11,18,91,85
2014,2,21400285,12/5/2014,1610612749,Milwaukee Bucks,1,1,1610612748,Miami Heat,0,0,30,23,53,9,7,16,39,30,69,22,4,26,14,18,21,16,25,93,109
2016,2,21600406,12/18/2016,1610612746,LA Clippers,0,0,1610612764,Washington Wizards,1,1,36,27,63,7,17,24,43,44,87,17,7,24,17,29,28,10,15,98,110
2016,2,21600406,12/18/2016,1610612764,Washington Wizards,1,1,1610612746,LA Clippers,0,0,33,29,62,10,9,19,43,38,81,21,9,30,11,31,24,7,15,98,117
2016,2,21600041,10/30/2016,1610612742,Dallas Mavericks,0,0,1610612745,Houston Rockets,1,1,21,34,55,11,20,31,32,54,86,17,3,20,16,39,17,5,13,92,92
2014,2,21400284,12/5/2014,1610612742,Dallas Mavericks,1,0,1610612756,Phoenix Suns,0,1,36,33,69,4,15,19,40,48,88,22,8,30,18,35,13,5,11,94,106
2014,2,21400284,12/5/2014,1610612756,Phoenix Suns,0,1,1610612742,Dallas Mavericks,1,0,32,22,54,13,13,26,45,35,80,15,2,17,8,28,27,5,13,94,118
2023,2,22301201,12/5/2023,1610612749,Milwaukee Bucks,1,1,1610612752,New York Knicks,0,0,32,21,53,23,15,38,55,36,91,13,6,19,12,26,32,8,12,100,146
2017,2,21700641,1/15/2018,1610612737,Atlanta Hawks,1,1,1610612759,San Antonio Spurs,0,0,31,30,61,9,16,25,40,46,86,13,1,14,14,33,23,12,15,95,102
2017,2,21700641,1/15/2018,1610612759,San Antonio Spurs,0,0,1610612737,Atlanta Hawks,1,1,29,36,65,8,14,22,37,50,87,17,3,20,12,40,24,8,9,95,99
2022,2,22200678,1/19/2023,1610612765,Detroit Pistons,1,0,1610612741,Chicago Bulls,0,1,31,32,63,8,26,34,39,58,97,22,5,27,23,37,25,11,17,106,108
2014,2,21400283,12/5/2014,1610612745,Houston Rockets,0,1,1610612750,Minnesota Timberwolves,1,0,26,20,46,12,20,32,38,40,78,26,5,31,9,35,19,12,23,107,114
2014,2,21400283,12/5/2014,1610612750,Minnesota Timberwolves,1,0,1610612745,Houston Rockets,0,1,42,45,87,3,7,10,45,52,97,19,8,27,16,39,23,3,14,107,112
2023,2,22300063,10/25/2023,1610612737,Atlanta Hawks,0,0,1610612766,Charlotte Hornets,1,1,34,30,64,5,24,29,39,54,93,27,6,33,16,42,24,5,12,103,110
2021,2,22100812,2/7/2022,1610612741,Chicago Bulls,1,0,1610612756,Phoenix Suns,0,1,33,31,64,10,16,26,43,47,90,28,3,31,13,35,18,5,9,96,124
2014,2,21400586,1/15/2015,1610612739,Cleveland Cavaliers,0,1,1610612747,Los Angeles Lakers,1,0,28,20,48,9,21,30,37,41,78,26,10,36,15,29,14,4,9,90,109
2014,2,21400586,1/15/2015,1610612747,Los Angeles Lakers,1,0,1610612739,Cleveland Cavaliers,0,1,31,21,52,8,16,24,39,37,76,16,7,23,11,29,26,8,12,88,102
2016,2,21600405,12/17/2016,1610612744,Golden State Warriors,1,1,1610612757,Portland Trail Blazers,0,0,37,22,59,14,14,28,51,36,87,19,7,26,15,26,36,7,15,98,135
2016,2,21600405,12/17/2016,1610612757,Portland Trail Blazers,0,0,1610612744,Golden State Warriors,1,1,26,32,58,8,20,28,34,52,86,14,6,20,7,49,16,7,11,97,90
2017,2,21700640,1/15/2018,1610612749,Milwaukee Bucks,0,1,1610612764,Washington Wizards,1,0,30,35,65,8,8,16,38,43,81,20,9,29,16,31,21,10,19,98,104
2017,2,21700640,1/15/2018,1610612764,Washington Wizards,1,0,1610612749,Milwaukee Bucks,0,1,26,29,55,6,15,21,32,44,76,25,6,31,15,32,19,14,24,99,95
2016,2,21600938,3/6/2017,1610612741,Chicago Bulls,0,0,1610612765,Detroit Pistons,1,1,26,29,55,8,20,28,34,49,83,19,2,21,9,41,21,7,10,94,95
2016,2,21600938,3/6/2017,1610612765,Detroit Pistons,1,1,1610612741,Chicago Bulls,0,0,39,32,71,6,15,21,45,47,92,13,7,20,15,34,26,3,7,95,109
2022,2,22201113,3/26/2023,1610612766,Charlotte Hornets,1,1,1610612742,Dallas Mavericks,0,0,27,32,59,12,17,29,39,49,88,20,4,24,15,35,27,8,14,97,110
2014,2,21400282,12/5/2014,1610612759,San Antonio Spurs,0,1,1610612763,Memphis Grizzlies,1,0,26,33,59,14,11,25,40,44,84,13,3,16,14,31,25,4,14,93,107
2016,2,21600041,10/30/2016,1610612745,Houston Rockets,1,1,1610612742,Dallas Mavericks,0,0,23,27,50,11,20,31,34,47,81,14,7,21,13,37,16,8,17,93,93
2023,2,22300065,10/25/2023,1610612738,Boston Celtics,0,1,1610612752,New York Knicks,1,0,25,13,38,12,27,39,37,40,77,22,4,26,7,34,18,9,13,95,108
2017,2,21700639,1/15/2018,1610612755,Philadelphia 76ers,1,1,1610612761,Toronto Raptors,0,0,34,22,56,6,19,25,40,41,81,31,7,38,11,34,22,8,22,110,117
2017,2,21700639,1/15/2018,1610612761,Toronto Raptors,0,0,1610612755,Philadelphia 76ers,1,1,29,34,63,9,23,32,38,57,95,26,4,30,15,44,20,8,15,111,111
2021,2,22100812,2/7/2022,1610612756,Phoenix Suns,0,1,1610612741,Chicago Bulls,1,0,37,21,58,12,20,32,49,41,90,17,2,19,13,29,31,7,11,97,127
2020,2,22000490,2/24/2021,1610612738,Boston Celtics,0,0,1610612737,Atlanta Hawks,1,1,34,30,64,8,23,31,42,53,95,20,3,23,16,39,20,4,6,96,112
2014,2,21400282,12/5/2014,1610612763,Memphis Grizzlies,1,0,1610612759,San Antonio Spurs,0,1,32,36,68,5,7,12,37,43,80,22,4,26,10,35,19,5,10,93,101
2016,2,21600404,12/17/2016,1610612743,Denver Nuggets,1,1,1610612752,New York Knicks,0,0,40,23,63,10,17,27,50,40,90,17,12,29,15,28,26,6,10,99,127
2016,2,21600404,12/17/2016,1610612752,New York Knicks,0,0,1610612743,Denver Nuggets,1,1,27,30,57,8,15,23,35,45,80,36,3,39,13,33,18,6,13,100,114
2020,2,22000769,4/6/2021,1610612741,Chicago Bulls,0,1,1610612754,Indiana Pacers,1,0,30,31,61,14,19,33,44,50,94,11,3,14,21,29,28,15,21,103,113
2014,2,21401115,4/1/2015,1610612738,Boston Celtics,1,1,1610612754,Indiana Pacers,0,0,33,26,59,6,21,27,39,47,86,16,2,18,12,35,29,5,10,93,100
2020,2,22000769,4/6/2021,1610612754,Indiana Pacers,1,0,1610612741,Chicago Bulls,0,1,29,29,58,9,21,30,38,50,88,12,4,16,9,43,20,9,15,102,97
2014,2,21401115,4/1/2015,1610612754,Indiana Pacers,0,0,1610612738,Boston Celtics,1,1,28,38,66,6,9,15,34,47,81,13,10,23,10,41,17,9,12,93,87
2023,2,22300066,10/25/2023,1610612745,Houston Rockets,0,0,1610612753,Orlando Magic,1,1,20,25,45,12,22,34,32,47,79,10,6,16,11,41,19,8,19,95,86
2023,2,22300394,12/23/2023,1610612751,Brooklyn Nets,1,1,1610612765,Detroit Pistons,0,0,35,27,62,10,14,24,45,41,86,26,6,32,13,30,32,5,12,99,126
2023,2,22300622,1/24/2024,1610612760,Oklahoma City Thunder,0,1,1610612759,San Antonio Spurs,1,0,36,20,56,18,22,40,54,42,96,14,2,16,17,27,36,7,16,101,140
2014,2,21400585,1/15/2015,1610612749,Milwaukee Bucks,1,1,1610612752,New York Knicks,0,0,20,34,54,8,10,18,28,44,72,31,11,42,16,35,21,5,15,93,95
2014,2,21400585,1/15/2015,1610612752,New York Knicks,0,0,1610612749,Milwaukee Bucks,1,1,20,26,46,8,14,22,28,40,68,15,5,20,6,36,22,13,21,91,79
2016,2,21600403,12/17/2016,1610612745,Houston Rockets,0,1,1610612750,Minnesota Timberwolves,1,0,22,23,45,17,34,51,39,57,96,16,4,20,14,46,25,9,17,110,111
2016,2,21600403,12/17/2016,1610612750,Minnesota Timberwolves,1,0,1610612745,Houston Rockets,0,1,34,37,71,7,14,21,41,51,92,20,7,27,17,38,29,14,22,110,109
2021,2,22101169,4/3/2022,1610612754,Indiana Pacers,1,0,1610612765,Detroit Pistons,0,1,33,23,56,12,26,38,45,49,94,15,4,19,22,31,33,11,19,102,117
2021,2,22101169,4/3/2022,1610612765,Detroit Pistons,0,1,1610612754,Indiana Pacers,1,0,22,36,58,21,20,41,43,56,99,14,4,18,18,41,31,6,12,100,121
2017,2,21700638,1/15/2018,1610612765,Detroit Pistons,1,0,1610612766,Charlotte Hornets,0,1,27,30,57,15,14,29,42,44,86,8,3,11,5,41,27,9,16,103,107
2017,2,21700638,1/15/2018,1610612766,Charlotte Hornets,0,1,1610612765,Detroit Pistons,1,0,33,30,63,10,11,21,43,41,84,22,11,33,11,37,21,10,15,103,118
2014,2,21400281,12/5/2014,1610612739,Cleveland Cavaliers,0,1,1610612761,Toronto Raptors,1,0,32,32,64,9,11,20,41,43,84,14,7,21,17,29,28,4,13,89,105
2014,2,21400281,12/5/2014,1610612761,Toronto Raptors,1,0,1610612739,Cleveland Cavaliers,0,1,27,35,62,8,16,24,35,51,86,13,7,20,18,36,25,7,11,89,91
2016,2,21600937,3/6/2017,1610612737,Atlanta Hawks,1,0,1610612744,Golden State Warriors,0,1,25,29,54,13,15,28,38,44,82,22,9,31,18,31,19,10,19,100,111
2016,2,21600937,3/6/2017,1610612744,Golden State Warriors,0,1,1610612737,Atlanta Hawks,1,0,21,22,43,20,24,44,41,46,87,17,5,22,14,36,33,6,16,99,119
2014,2,21401114,4/1/2015,1610612755,Philadelphia 76ers,0,0,1610612764,Washington Wizards,1,1,26,31,57,10,24,34,36,55,91,11,6,17,17,41,18,7,11,93,93
2014,2,21401114,4/1/2015,1610612764,Washington Wizards,1,1,1610612755,Philadelphia 76ers,0,0,40,24,64,4,8,12,44,32,76,14,8,22,12,24,33,10,18,91,106
2021,2,22100811,2/7/2022,1610612748,Miami Heat,0,1,1610612764,Washington Wizards,1,0,25,19,44,18,14,32,43,33,76,17,4,21,6,27,29,10,19,99,121
2021,2,22100811,2/7/2022,1610612764,Washington Wizards,1,0,1610612748,Miami Heat,0,1,29,20,49,7,24,31,36,44,80,21,2,23,9,35,25,9,17,99,100
2023,2,22300218,11/20/2023,1610612765,Detroit Pistons,1,0,1610612743,Denver Nuggets,0,1,29,31,60,7,14,21,36,45,81,24,2,26,12,33,21,7,18,100,103
2021,2,22101168,4/3/2022,1610612743,Denver Nuggets,0,1,1610612747,Los Angeles Lakers,1,0,35,16,51,12,19,31,47,35,82,23,6,29,6,34,33,4,12,100,129
2017,2,21700637,1/14/2018,1610612750,Minnesota Timberwolves,1,1,1610612757,Portland Trail Blazers,0,0,36,25,61,7,12,19,43,37,80,27,6,33,9,31,21,6,11,96,120
2017,2,21700637,1/14/2018,1610612757,Portland Trail Blazers,0,0,1610612750,Minnesota Timberwolves,1,1,28,26,54,11,14,25,39,40,79,14,3,17,8,33,19,12,18,96,103
2021,2,22101168,4/3/2022,1610612747,Los Angeles Lakers,1,0,1610612743,Denver Nuggets,0,1,43,29,72,6,14,20,49,43,92,14,7,21,12,33,31,10,13,101,118
2020,2,22000489,2/24/2021,1610612744,Golden State Warriors,0,1,1610612754,Indiana Pacers,1,0,34,23,57,5,21,26,39,44,83,28,3,31,11,33,27,11,18,106,111
2014,2,21400584,1/15/2015,1610612745,Houston Rockets,1,1,1610612760,Oklahoma City Thunder,0,0,25,25,50,16,20,36,41,45,86,14,5,19,15,34,25,8,14,94,112
2014,2,21400584,1/15/2015,1610612760,Oklahoma City Thunder,0,0,1610612745,Houston Rockets,1,1,24,28,52,11,18,29,35,46,81,20,8,28,17,31,25,12,17,95,101
2014,2,21400280,12/5/2014,1610612737,Atlanta Hawks,0,1,1610612751,Brooklyn Nets,1,0,22,25,47,13,21,34,35,46,81,15,9,24,9,43,22,4,11,93,98
2014,2,21400280,12/5/2014,1610612751,Brooklyn Nets,1,0,1610612737,Atlanta Hawks,0,1,27,35,62,3,15,18,30,50,80,12,7,19,15,40,16,12,19,93,75
2017,2,21700636,1/14/2018,1610612754,Indiana Pacers,0,1,1610612756,Phoenix Suns,1,0,37,28,65,11,12,23,48,40,88,13,1,14,8,33,20,2,6,92,120
2017,2,21700636,1/14/2018,1610612756,Phoenix Suns,1,0,1610612754,Indiana Pacers,0,1,26,22,48,9,28,37,35,50,85,18,6,24,17,36,20,9,13,93,97
2021,2,22101167,4/3/2022,1610612742,Dallas Mavericks,0,1,1610612749,Milwaukee Bucks,1,0,23,15,38,16,22,38,39,37,76,24,3,27,6,32,28,9,14,95,118
2021,2,22101167,4/3/2022,1610612749,Milwaukee Bucks,1,0,1610612742,Dallas Mavericks,0,1,27,28,55,15,25,40,42,53,95,13,5,18,16,39,25,7,9,96,112
2014,2,21400583,1/14/2015,1610612746,LA Clippers,0,1,1610612757,Portland Trail Blazers,1,0,29,36,65,8,15,23,37,51,88,18,1,19,9,42,20,5,7,97,100
2014,2,21400583,1/14/2015,1610612757,Portland Trail Blazers,1,0,1610612746,LA Clippers,0,1,29,32,61,6,20,26,35,52,87,18,2,20,13,41,22,9,13,98,94
2020,2,22000768,4/5/2021,1610612745,Houston Rockets,1,0,1610612756,Phoenix Suns,0,1,26,20,46,17,16,33,43,36,79,27,6,33,7,33,28,11,18,102,130
2017,2,21700635,1/14/2018,1610612740,New Orleans Pelicans,0,1,1610612752,New York Knicks,1,0,36,27,63,9,23,32,45,50,95,24,10,34,18,36,19,12,19,113,123
2017,2,21700635,1/14/2018,1610612752,New York Knicks,1,0,1610612740,New Orleans Pelicans,0,1,34,29,63,12,22,34,46,51,97,14,4,18,18,34,28,17,24,113,118
2021,2,22101166,4/3/2022,1610612738,Boston Celtics,1,1,1610612764,Washington Wizards,0,0,33,14,47,23,21,44,56,35,91,9,4,13,9,27,39,4,8,95,144
2021,2,22101166,4/3/2022,1610612764,Washington Wizards,0,0,1610612738,Boston Celtics,1,1,30,31,61,8,13,21,38,44,82,18,2,20,9,35,21,6,12,95,102
2014,2,21400279,12/5/2014,1610612738,Boston Celtics,1,1,1610612747,Los Angeles Lakers,0,0,38,32,70,8,12,20,46,44,90,13,9,22,16,33,29,2,17,102,113
2014,2,21400279,12/5/2014,1610612747,Los Angeles Lakers,0,0,1610612738,Boston Celtics,1,1,32,44,76,6,10,16,38,54,92,14,5,19,9,48,14,6,12,103,96
2023,2,22300217,11/20/2023,1610612738,Boston Celtics,0,0,1610612766,Charlotte Hornets,1,1,26,21,47,16,34,50,42,55,97,18,10,28,17,42,19,9,15,108,118
2023,2,22300374,12/21/2023,1610612765,Detroit Pistons,1,0,1610612762,Utah Jazz,0,1,34,21,55,9,22,31,43,43,86,16,3,19,14,31,24,15,21,101,111
2022,2,22200628,1/12/2023,1610612748,Miami Heat,1,1,1610612749,Milwaukee Bucks,0,0,33,28,61,9,25,34,42,53,95,15,1,16,20,33,22,10,13,95,108
2022,2,22200628,1/12/2023,1610612749,Milwaukee Bucks,0,0,1610612748,Miami Heat,1,1,13,17,30,22,35,57,35,52,87,10,5,15,11,44,20,8,11,95,102
2022,2,22200284,11/25/2022,1610612744,Golden State Warriors,1,1,1610612762,Utah Jazz,0,0,32,24,56,20,25,45,52,49,101,5,1,6,21,29,33,12,21,103,129
2022,2,22200284,11/25/2022,1610612762,Utah Jazz,0,0,1610612744,Golden State Warriors,1,1,35,17,52,11,34,45,46,51,97,15,2,17,16,35,28,8,13,102,118
2021,2,22100810,2/7/2022,1610612761,Toronto Raptors,0,1,1610612766,Charlotte Hornets,1,0,26,23,49,15,20,35,41,43,84,19,10,29,17,32,21,11,18,99,116
2014,2,21401113,4/1/2015,1610612753,Orlando Magic,1,0,1610612759,San Antonio Spurs,0,1,34,42,76,5,12,17,39,54,93,8,1,9,15,39,24,8,12,95,91
2014,2,21401113,4/1/2015,1610612759,San Antonio Spurs,0,1,1610612753,Orlando Magic,1,0,22,35,57,13,16,29,35,51,86,20,3,23,15,38,20,7,11,95,103
2016,2,21600040,10/30/2016,1610612747,Los Angeles Lakers,0,0,1610612760,Oklahoma City Thunder,1,1,28,27,55,7,25,32,35,52,87,19,5,24,16,39,20,15,22,103,96
2016,2,21600040,10/30/2016,1610612760,Oklahoma City Thunder,1,1,1610612747,Los Angeles Lakers,0,0,36,33,69,9,17,26,45,50,95,14,3,17,16,36,29,15,20,105,113
2022,2,22200283,11/25/2022,1610612756,Phoenix Suns,1,1,1610612765,Detroit Pistons,0,0,35,23,58,7,22,29,42,45,87,17,9,26,15,33,25,6,13,98,108
2022,2,22200283,11/25/2022,1610612765,Detroit Pistons,0,0,1610612756,Phoenix Suns,1,1,30,36,66,9,17,26,39,53,92,15,1,16,21,33,21,7,19,99,102
2021,2,22100810,2/7/2022,1610612766,Charlotte Hornets,1,0,1610612761,Toronto Raptors,0,1,30,25,55,9,31,40,39,56,95,14,2,16,16,41,28,9,13,99,101
2021,2,22101165,4/2/2022,1610612744,Golden State Warriors,1,1,1610612762,Utah Jazz,0,0,20,16,36,20,28,48,40,44,84,11,1,12,9,36,30,8,11,92,111
2021,2,22101165,4/2/2022,1610612762,Utah Jazz,0,0,1610612744,Golden State Warriors,1,1,23,20,43,15,31,46,38,51,89,16,6,22,19,35,19,5,13,93,107
2017,2,21700634,1/14/2018,1610612748,Miami Heat,1,1,1610612749,Milwaukee Bucks,0,0,24,23,47,11,18,29,35,41,76,16,4,20,5,37,23,8,15,95,97
2017,2,21700634,1/14/2018,1610612749,Milwaukee Bucks,0,0,1610612748,Miami Heat,1,1,21,30,51,4,24,28,25,54,79,25,2,27,10,46,9,8,15,96,79
2014,2,21400582,1/14/2015,1610612744,Golden State Warriors,1,1,1610612748,Miami Heat,0,0,25,27,52,13,16,29,38,43,81,15,4,19,11,34,29,5,13,91,104
2014,2,21400582,1/14/2015,1610612748,Miami Heat,0,0,1610612744,Golden State Warriors,1,1,24,29,53,6,12,18,30,41,71,23,4,27,14,28,19,5,19,92,89
2017,2,21700633,1/13/2018,1610612743,Denver Nuggets,0,0,1610612759,San Antonio Spurs,1,1,22,33,55,7,21,28,29,54,83,15,2,17,16,38,18,9,17,94,80
2017,2,21700633,1/13/2018,1610612759,San Antonio Spurs,1,1,1610612743,Denver Nuggets,0,0,27,25,52,14,13,27,41,38,79,16,2,18,8,30,23,9,15,93,112
2023,2,22300218,11/20/2023,1610612743,Denver Nuggets,0,1,1610612765,Detroit Pistons,1,0,29,30,59,11,17,28,40,47,87,16,5,21,13,37,30,7,14,97,107
2016,2,21600402,12/17/2016,1610612739,Cleveland Cavaliers,1,1,1610612747,Los Angeles Lakers,0,0,31,25,56,15,18,33,46,43,89,12,6,18,13,33,30,3,8,92,119
2016,2,21600402,12/17/2016,1610612747,Los Angeles Lakers,0,0,1610612739,Cleveland Cavaliers,1,1,25,24,49,16,20,36,41,44,85,10,3,13,11,34,30,8,12,91,108
2022,2,22200282,11/25/2022,1610612747,Los Angeles Lakers,0,1,1610612759,San Antonio Spurs,1,0,32,24,56,8,19,27,40,43,83,17,3,20,14,32,28,11,22,101,105
2017,2,21700632,1/13/2018,1610612741,Chicago Bulls,1,1,1610612765,Detroit Pistons,0,0,25,26,51,17,19,36,42,45,87,6,3,9,12,33,27,8,15,95,107
2017,2,21700632,1/13/2018,1610612765,Detroit Pistons,0,0,1610612741,Chicago Bulls,1,1,29,34,63,12,17,29,41,51,92,11,3,14,17,35,28,10,14,96,105
2022,2,22200282,11/25/2022,1610612759,San Antonio Spurs,1,0,1610612747,Los Angeles Lakers,0,1,32,35,67,6,27,33,38,62,100,12,4,16,22,42,21,12,16,101,94
2021,2,22100809,2/6/2022,1610612746,LA Clippers,1,0,1610612749,Milwaukee Bucks,0,1,22,28,50,18,28,46,40,56,96,15,1,16,12,44,26,6,10,101,113
2021,2,22100809,2/6/2022,1610612749,Milwaukee Bucks,0,1,1610612746,LA Clippers,1,0,29,21,50,19,19,38,48,40,88,22,5,27,8,34,28,6,10,102,137
2014,2,21401112,4/1/2015,1610612765,Detroit Pistons,0,0,1610612766,Charlotte Hornets,1,1,26,40,66,5,17,22,31,57,88,11,7,18,17,44,24,10,14,94,78
2014,2,21401112,4/1/2015,1610612766,Charlotte Hornets,1,1,1610612765,Detroit Pistons,0,0,29,39,68,9,13,22,38,52,90,17,7,24,16,37,21,6,10,93,102
2022,2,22200281,11/25/2022,1610612741,Chicago Bulls,0,0,1610612760,Oklahoma City Thunder,1,1,32,36,68,12,21,33,44,57,101,19,4,23,16,42,25,7,15,109,119
2022,2,22200281,11/25/2022,1610612760,Oklahoma City Thunder,1,1,1610612741,Chicago Bulls,0,0,37,29,66,7,22,29,44,51,95,28,4,32,14,38,24,5,13,110,123
2014,2,21400278,12/5/2014,1610612743,Denver Nuggets,0,0,1610612764,Washington Wizards,1,1,26,34,60,5,17,22,31,51,82,22,8,30,16,39,16,12,19,99,89
2014,2,21400278,12/5/2014,1610612764,Washington Wizards,1,1,1610612743,Denver Nuggets,0,0,38,27,65,7,13,20,45,40,85,22,5,27,16,27,35,8,16,100,119
2016,2,21600936,3/6/2017,1610612739,Cleveland Cavaliers,1,0,1610612748,Miami Heat,0,1,26,25,51,9,18,27,35,43,78,19,10,29,15,33,15,7,17,94,98
2016,2,21600936,3/6/2017,1610612748,Miami Heat,0,1,1610612739,Cleveland Cavaliers,1,0,23,33,56,16,19,35,39,52,91,12,2,14,11,42,23,3,8,93,106
2021,2,22101164,4/2/2022,1610612741,Chicago Bulls,1,0,1610612748,Miami Heat,0,1,28,24,52,9,25,34,37,49,86,26,3,29,13,37,21,4,6,91,109
2021,2,22101164,4/2/2022,1610612748,Miami Heat,0,1,1610612741,Chicago Bulls,1,0,27,21,48,17,17,34,44,38,82,22,5,27,10,30,28,5,9,93,127
2014,2,21400277,12/5/2014,1610612755,Philadelphia 76ers,1,0,1610612760,Oklahoma City Thunder,0,1,24,32,56,8,20,28,32,52,84,19,11,30,23,36,25,7,19,93,91
2014,2,21400277,12/5/2014,1610612760,Oklahoma City Thunder,0,1,1610612755,Philadelphia 76ers,1,0,26,22,48,9,14,23,35,36,71,24,7,31,10,28,27,13,17,92,103
2021,2,22100808,2/6/2022,1610612740,New Orleans Pelicans,0,1,1610612745,Houston Rockets,1,0,29,19,48,12,17,29,41,36,77,26,10,36,10,32,29,5,13,97,120
2021,2,22100808,2/6/2022,1610612745,Houston Rockets,1,0,1610612740,New Orleans Pelicans,0,1,24,15,39,16,29,45,40,44,84,11,5,16,14,32,28,12,18,97,107
2020,2,22000489,2/24/2021,1610612754,Indiana Pacers,1,0,1610612744,Golden State Warriors,0,1,30,22,52,7,22,29,37,44,81,26,6,32,10,36,20,10,19,105,107
2017,2,21700631,1/13/2018,1610612744,Golden State Warriors,0,1,1610612761,Toronto Raptors,1,0,38,19,57,9,15,24,47,34,81,24,4,28,4,32,28,3,7,99,127
2021,2,22101163,4/2/2022,1610612737,Atlanta Hawks,1,1,1610612751,Brooklyn Nets,0,0,23,22,45,13,28,41,36,50,86,37,12,49,12,44,18,5,7,105,122
2021,2,22101163,4/2/2022,1610612751,Brooklyn Nets,0,0,1610612737,Atlanta Hawks,1,1,25,37,62,17,20,37,42,57,99,14,5,19,15,44,17,10,13,104,115
2017,2,21700631,1/13/2018,1610612761,Toronto Raptors,1,0,1610612744,Golden State Warriors,0,1,37,31,68,8,17,25,45,48,93,27,5,32,19,32,22,4,10,101,125
2014,2,21400581,1/14/2015,1610612742,Dallas Mavericks,0,0,1610612743,Denver Nuggets,1,1,32,31,63,9,28,37,41,59,100,16,4,20,18,41,24,6,9,102,107
2014,2,21400581,1/14/2015,1610612743,Denver Nuggets,1,1,1610612742,Dallas Mavericks,0,0,37,26,63,4,15,19,41,41,82,28,7,35,13,30,25,8,16,100,114
2019,2,21900001,10/22/2019,1610612740,New Orleans Pelicans,0,0,1610612761,Toronto Raptors,1,1,24,33,57,19,26,45,43,59,102,17,3,20,16,43,30,7,19,113,122
2019,2,21900001,10/22/2019,1610612761,Toronto Raptors,1,1,1610612740,New Orleans Pelicans,0,0,28,35,63,14,26,40,42,61,103,32,6,38,26,39,23,4,17,114,130
2020,2,22000768,4/5/2021,1610612756,Phoenix Suns,0,1,1610612745,Houston Rockets,1,0,26,23,49,18,19,37,44,42,86,27,4,31,9,35,29,6,11,103,133
2014,2,21400276,12/5/2014,1610612752,New York Knicks,0,0,1610612766,Charlotte Hornets,1,1,27,30,57,10,12,22,37,42,79,18,4,22,8,34,23,2,6,89,102
2014,2,21400276,12/5/2014,1610612766,Charlotte Hornets,1,1,1610612752,New York Knicks,0,0,38,32,70,4,14,18,42,46,88,15,3,18,16,32,19,5,7,89,103
2022,2,22200280,11/25/2022,1610612739,Cleveland Cavaliers,0,0,1610612749,Milwaukee Bucks,1,1,22,32,54,12,21,33,34,53,87,22,4,26,14,40,12,4,9,94,102
2015,2,21500864,2/26/2016,1610612739,Cleveland Cavaliers,0,0,1610612761,Toronto Raptors,1,1,23,27,50,12,12,24,35,39,74,15,6,21,14,29,21,6,14,86,97
2022,2,22200280,11/25/2022,1610612749,Milwaukee Bucks,1,1,1610612739,Cleveland Cavaliers,0,0,27,24,51,15,17,32,42,41,83,18,7,25,11,33,27,9,13,94,117
2021,2,22100807,2/6/2022,1610612737,Atlanta Hawks,0,0,1610612742,Dallas Mavericks,1,1,32,38,70,5,20,25,37,58,95,15,1,16,21,38,21,8,12,95,94
2017,2,21700630,1/13/2018,1610612751,Brooklyn Nets,0,0,1610612764,Washington Wizards,1,1,30,26,56,12,31,43,42,57,99,17,3,20,15,45,28,10,16,109,113
2017,2,21700630,1/13/2018,1610612764,Washington Wizards,1,1,1610612751,Brooklyn Nets,0,0,36,34,70,10,13,23,46,47,93,17,6,23,9,39,31,6,15,110,119
2014,2,21400580,1/14/2015,1610612737,Atlanta Hawks,0,1,1610612738,Boston Celtics,1,0,26,18,44,10,19,29,36,37,73,23,4,27,7,30,23,5,12,90,105
2014,2,21400580,1/14/2015,1610612738,Boston Celtics,1,0,1610612737,Atlanta Hawks,0,1,23,27,50,11,22,33,34,49,83,12,2,14,17,32,22,13,17,91,91
2015,2,21500864,2/26/2016,1610612761,Toronto Raptors,1,1,1610612739,Cleveland Cavaliers,0,0,31,25,56,6,11,17,37,36,73,19,7,26,11,29,18,4,12,84,99
2014,2,21400275,12/4/2014,1610612740,New Orleans Pelicans,0,0,1610612744,Golden State Warriors,1,1,34,40,74,3,12,15,37,52,89,8,5,13,15,39,23,11,17,96,85
2014,2,21400275,12/4/2014,1610612744,Golden State Warriors,1,1,1610612740,New Orleans Pelicans,0,0,37,41,78,10,12,22,47,53,100,8,9,17,19,39,31,8,9,97,112
2016,2,21600401,12/17/2016,1610612737,Atlanta Hawks,1,0,1610612766,Charlotte Hornets,0,1,30,30,60,10,16,26,40,46,86,9,7,16,10,40,26,8,12,97,99
2016,2,21600401,12/17/2016,1610612766,Charlotte Hornets,0,1,1610612737,Atlanta Hawks,1,0,31,30,61,12,15,27,43,45,88,9,4,13,10,38,26,4,12,97,107
2021,2,22100807,2/6/2022,1610612742,Dallas Mavericks,1,1,1610612737,Atlanta Hawks,0,0,22,30,52,16,20,36,38,50,88,11,2,13,15,36,25,7,16,94,103
2021,2,22101162,4/2/2022,1610612739,Cleveland Cavaliers,0,1,1610612752,New York Knicks,1,0,29,18,47,15,19,34,44,37,81,16,5,21,9,29,26,6,12,93,119
2021,2,22101162,4/2/2022,1610612752,New York Knicks,1,0,1610612739,Cleveland Cavaliers,0,1,18,29,47,13,17,30,31,46,77,26,8,34,12,37,19,6,11,93,101
2014,2,21400579,1/14/2015,1610612741,Chicago Bulls,1,0,1610612764,Washington Wizards,0,1,21,31,52,13,14,27,34,45,79,18,6,24,11,37,18,4,13,93,99
2014,2,21400579,1/14/2015,1610612764,Washington Wizards,0,1,1610612741,Chicago Bulls,1,0,35,28,63,5,10,15,40,38,78,20,5,25,14,26,29,10,15,92,105
2017,2,21700629,1/13/2018,1610612760,Oklahoma City Thunder,0,1,1610612766,Charlotte Hornets,1,0,31,40,71,8,18,26,39,58,97,15,5,20,21,42,17,3,9,93,101
2017,2,21700629,1/13/2018,1610612766,Charlotte Hornets,1,0,1610612760,Oklahoma City Thunder,0,1,24,31,55,9,19,28,33,50,83,16,7,23,14,39,16,8,15,94,91
2023,2,22300214,11/19/2023,1610612762,Utah Jazz,1,0,1610612756,Phoenix Suns,0,1,33,36,69,15,31,46,48,67,115,26,6,32,34,36,27,11,19,115,137
2014,2,21400274,12/4/2014,1610612754,Indiana Pacers,0,0,1610612757,Portland Trail Blazers,1,1,31,42,73,5,13,18,36,55,91,5,3,8,14,43,19,9,17,99,82
2014,2,21400274,12/4/2014,1610612757,Portland Trail Blazers,1,1,1610612754,Indiana Pacers,0,0,29,33,62,4,17,21,33,50,83,18,5,23,7,43,20,5,12,98,88
2021,2,22100806,2/6/2022,1610612738,Boston Celtics,0,1,1610612753,Orlando Magic,1,0,32,21,53,13,33,46,45,54,99,13,1,14,21,34,29,8,16,100,116
2014,2,21401111,3/31/2015,1610612744,Golden State Warriors,0,1,1610612746,LA Clippers,1,0,30,34,64,8,13,21,38,47,85,26,8,34,14,37,28,4,9,96,110
2014,2,21401111,3/31/2015,1610612746,LA Clippers,1,0,1610612744,Golden State Warriors,0,1,30,30,60,6,16,22,36,46,82,28,5,33,14,35,19,6,13,97,106
2022,2,22201113,3/26/2023,1610612742,Dallas Mavericks,0,0,1610612766,Charlotte Hornets,1,1,13,22,35,19,30,49,32,52,84,21,1,22,7,45,18,6,8,98,104
2021,2,22100806,2/6/2022,1610612753,Orlando Magic,1,0,1610612738,Boston Celtics,0,1,24,31,55,5,21,26,29,52,81,20,1,21,10,42,17,9,19,99,83
2016,2,21600293,12/3/2016,1610612737,Atlanta Hawks,0,0,1610612761,Toronto Raptors,1,1,28,32,60,7,21,28,35,53,88,7,7,14,18,38,21,14,19,97,84
2022,2,22200279,11/25/2022,1610612740,New Orleans Pelicans,0,0,1610612763,Memphis Grizzlies,1,1,27,28,55,10,21,31,37,49,86,27,4,31,14,36,26,4,13,101,111
2022,2,22200279,11/25/2022,1610612763,Memphis Grizzlies,1,1,1610612740,New Orleans Pelicans,0,0,29,24,53,18,20,38,47,44,91,20,7,27,16,33,26,9,14,100,132
2017,2,21700628,1/13/2018,1610612746,LA Clippers,1,1,1610612758,Sacramento Kings,0,0,34,17,51,12,19,31,46,36,82,22,4,26,9,30,29,12,16,101,126
2017,2,21700628,1/13/2018,1610612758,Sacramento Kings,0,0,1610612746,LA Clippers,1,1,37,31,68,6,11,17,43,42,85,13,9,22,12,35,26,11,16,100,105
2014,2,21401110,3/31/2015,1610612748,Miami Heat,1,0,1610612759,San Antonio Spurs,0,1,27,37,64,5,10,15,32,47,79,12,0,12,15,32,11,11,18,89,81
2014,2,21401110,3/31/2015,1610612759,San Antonio Spurs,0,1,1610612748,Miami Heat,1,0,29,27,56,8,10,18,37,37,74,13,4,17,14,24,21,9,19,88,95
2021,2,22100805,2/6/2022,1610612739,Cleveland Cavaliers,1,1,1610612754,Indiana Pacers,0,0,23,29,52,11,21,32,34,50,84,19,9,28,17,36,25,5,11,91,98
2021,2,22100805,2/6/2022,1610612754,Indiana Pacers,0,0,1610612739,Cleveland Cavaliers,1,1,23,29,52,8,23,31,31,52,83,15,2,17,17,36,17,9,19,93,85
2017,2,21700627,1/13/2018,1610612742,Dallas Mavericks,1,0,1610612747,Los Angeles Lakers,0,1,23,24,47,11,32,43,34,56,90,22,6,28,9,50,20,4,9,104,101
2017,2,21700627,1/13/2018,1610612747,Los Angeles Lakers,0,1,1610612742,Dallas Mavericks,1,0,35,34,69,8,18,26,43,52,95,13,5,18,17,36,24,5,15,103,107
2014,2,21400273,12/4/2014,1610612739,Cleveland Cavaliers,0,1,1610612752,New York Knicks,1,0,27,25,52,5,13,18,32,38,70,21,5,26,10,31,19,11,17,90,90
2014,2,21400273,12/4/2014,1610612752,New York Knicks,1,0,1610612739,Cleveland Cavaliers,0,1,29,33,62,8,18,26,37,51,88,5,1,6,23,28,26,8,22,91,87
2016,2,21600935,3/6/2017,1610612752,New York Knicks,0,1,1610612753,Orlando Magic,1,0,34,38,72,6,8,14,40,46,86,27,1,28,15,32,26,4,9,93,113
2021,2,22101161,4/2/2022,1610612755,Philadelphia 76ers,1,1,1610612766,Charlotte Hornets,0,0,32,12,44,21,22,43,53,34,87,17,4,21,12,25,38,14,19,102,144
2021,2,22101161,4/2/2022,1610612766,Charlotte Hornets,0,0,1610612755,Philadelphia 76ers,1,1,31,26,57,11,19,30,42,45,87,19,5,24,11,37,34,10,17,104,114
2014,2,21400578,1/14/2015,1610612755,Philadelphia 76ers,0,0,1610612761,Toronto Raptors,1,1,28,33,61,3,16,19,31,49,80,19,12,31,14,41,13,7,12,96,84
2014,2,21400578,1/14/2015,1610612761,Toronto Raptors,1,1,1610612755,Philadelphia 76ers,0,0,28,25,53,10,19,29,38,44,82,14,8,22,14,34,26,10,17,95,100
2017,2,21700626,1/12/2018,1610612745,Houston Rockets,0,1,1610612756,Phoenix Suns,1,0,24,23,47,15,32,47,39,55,94,19,3,22,17,40,18,5,11,101,112
2017,2,21700626,1/12/2018,1610612756,Phoenix Suns,1,0,1610612745,Houston Rockets,0,1,23,24,47,14,19,33,37,43,80,7,2,9,4,40,27,11,19,99,95
2016,2,21600293,12/3/2016,1610612761,Toronto Raptors,1,1,1610612737,Atlanta Hawks,0,0,40,28,68,13,11,24,53,39,92,9,2,11,15,26,28,7,15,95,128
2016,2,21600935,3/6/2017,1610612753,Orlando Magic,1,0,1610612752,New York Knicks,0,1,31,22,53,9,23,32,40,45,85,16,8,24,16,34,23,6,13,95,105
2016,2,21600400,12/17/2016,1610612754,Indiana Pacers,0,1,1610612765,Detroit Pistons,1,0,34,30,64,6,13,19,40,43,83,19,6,25,12,31,20,6,9,93,105
2016,2,21600400,12/17/2016,1610612765,Detroit Pistons,1,0,1610612754,Indiana Pacers,0,1,22,32,54,10,20,30,32,52,84,16,6,22,11,43,22,6,9,93,90
2016,2,21600039,10/30/2016,1610612763,Memphis Grizzlies,1,1,1610612764,Washington Wizards,0,0,24,33,57,15,16,31,39,49,88,19,7,26,16,36,24,8,14,98,112
2022,2,22200656,1/16/2023,1610612766,Charlotte Hornets,1,0,1610612738,Boston Celtics,0,1,28,31,59,13,18,31,41,49,90,23,7,30,15,36,26,1,5,93,118
2022,2,22200278,11/25/2022,1610612737,Atlanta Hawks,0,0,1610612745,Houston Rockets,1,1,24,19,43,15,24,39,39,43,82,29,7,36,9,39,14,9,14,104,122
2022,2,22200278,11/25/2022,1610612745,Houston Rockets,1,1,1610612737,Atlanta Hawks,0,0,29,23,52,12,23,35,41,46,87,34,7,41,25,24,25,9,22,104,128
2014,2,21400577,1/14/2015,1610612740,New Orleans Pelicans,0,1,1610612765,Detroit Pistons,1,0,31,28,59,8,13,21,39,41,80,19,4,23,15,28,23,8,13,89,105
2014,2,21400577,1/14/2015,1610612765,Detroit Pistons,1,0,1610612740,New Orleans Pelicans,0,1,26,25,51,8,14,22,34,39,73,18,5,23,4,39,23,4,8,88,94
2014,2,21400272,12/3/2014,1610612746,LA Clippers,1,1,1610612753,Orlando Magic,0,0,30,17,47,12,19,31,42,36,78,18,7,25,9,30,32,11,18,99,114
2014,2,21400272,12/3/2014,1610612753,Orlando Magic,0,0,1610612746,LA Clippers,1,1,26,33,59,7,13,20,33,46,79,13,12,25,10,41,21,11,17,99,86
2022,2,22200277,11/25/2022,1610612748,Miami Heat,1,1,1610612764,Washington Wizards,0,0,35,28,63,7,19,26,42,47,89,19,4,23,14,34,24,7,13,96,110
2023,2,22300219,11/20/2023,1610612764,Washington Wizards,1,0,1610612749,Milwaukee Bucks,0,1,45,25,70,10,19,29,55,44,99,9,2,11,5,40,29,3,4,102,129
2014,2,21401109,3/31/2015,1610612737,Atlanta Hawks,0,0,1610612765,Detroit Pistons,1,1,32,27,59,8,17,25,40,44,84,7,3,10,16,29,25,11,18,91,95
2014,2,21401109,3/31/2015,1610612765,Detroit Pistons,1,1,1610612737,Atlanta Hawks,0,0,30,24,54,11,18,29,41,42,83,12,5,17,11,35,26,8,11,91,105
2014,2,21400576,1/14/2015,1610612751,Brooklyn Nets,1,0,1610612763,Memphis Grizzlies,0,1,26,23,49,10,16,26,36,39,75,10,2,12,12,29,19,13,19,89,92
2014,2,21400576,1/14/2015,1610612763,Memphis Grizzlies,0,1,1610612751,Brooklyn Nets,1,0,36,30,66,3,14,17,39,44,83,22,7,29,16,32,18,5,9,88,103
2016,2,21600039,10/30/2016,1610612764,Washington Wizards,0,0,1610612763,Memphis Grizzlies,1,1,33,28,61,5,20,25,38,48,86,22,3,25,12,37,19,9,14,98,103
2017,2,21700625,1/12/2018,1610612743,Denver Nuggets,1,1,1610612763,Memphis Grizzlies,0,0,20,28,48,7,15,22,27,43,70,26,6,32,13,32,15,8,15,88,87
2017,2,21700625,1/12/2018,1610612763,Memphis Grizzlies,0,0,1610612743,Denver Nuggets,1,1,23,30,53,7,17,24,30,47,77,11,3,14,10,38,17,8,15,88,78
2023,2,22301222,12/8/2023,1610612744,Golden State Warriors,0,0,1610612760,Oklahoma City Thunder,1,1,30,26,56,19,29,48,49,55,104,19,4,23,29,29,29,17,29,115,136
2022,2,22200277,11/25/2022,1610612764,Washington Wizards,0,0,1610612748,Miami Heat,1,1,29,25,54,11,28,39,40,53,93,16,4,20,19,37,27,5,12,97,107
2020,2,22000488,2/23/2021,1610612746,LA Clippers,1,1,1610612764,Washington Wizards,0,0,35,21,56,19,19,38,54,40,94,8,5,13,11,31,26,5,11,99,135
2020,2,22000488,2/23/2021,1610612764,Washington Wizards,0,0,1610612746,LA Clippers,1,1,36,32,68,11,9,20,47,41,88,11,5,16,6,39,32,7,13,99,116
2021,2,22101160,4/1/2022,1610612740,New Orleans Pelicans,0,1,1610612747,Los Angeles Lakers,1,0,34,19,53,7,19,26,41,38,79,25,4,29,5,35,23,10,15,102,114
2021,2,22101160,4/1/2022,1610612747,Los Angeles Lakers,1,0,1610612740,New Orleans Pelicans,0,1,28,27,55,11,16,27,39,43,82,22,9,31,11,36,24,8,17,102,111
2016,2,21600934,3/6/2017,1610612749,Milwaukee Bucks,0,1,1610612755,Philadelphia 76ers,1,0,27,23,50,14,19,33,41,42,83,16,4,20,14,30,28,5,15,93,112
2014,2,21400271,12/3/2014,1610612761,Toronto Raptors,0,1,1610612762,Utah Jazz,1,0,33,25,58,12,9,21,45,34,79,21,3,24,13,24,15,7,9,87,123
2014,2,21400271,12/3/2014,1610612762,Utah Jazz,1,0,1610612761,Toronto Raptors,0,1,34,25,59,8,20,28,42,45,87,12,3,15,15,32,21,7,8,86,104
2016,2,21600934,3/6/2017,1610612755,Philadelphia 76ers,1,0,1610612749,Milwaukee Bucks,0,1,31,28,59,8,22,30,39,50,89,12,7,19,20,34,30,7,14,94,98
2022,2,22200276,11/25/2022,1610612751,Brooklyn Nets,0,0,1610612754,Indiana Pacers,1,1,32,15,47,15,26,41,47,41,88,8,2,10,6,36,27,13,19,104,117
2022,2,22200276,11/25/2022,1610612754,Indiana Pacers,1,1,1610612751,Brooklyn Nets,0,0,31,21,52,12,22,34,43,43,86,30,8,38,9,37,28,2,10,104,128
2021,2,22100804,2/6/2022,1610612743,Denver Nuggets,1,1,1610612751,Brooklyn Nets,0,0,39,23,62,10,22,32,49,45,94,16,5,21,16,31,37,8,11,100,124
2017,2,21700624,1/12/2018,1610612740,New Orleans Pelicans,1,1,1610612757,Portland Trail Blazers,0,0,38,25,63,7,12,19,45,37,82,22,1,23,11,27,26,13,18,98,119
2017,2,21700624,1/12/2018,1610612757,Portland Trail Blazers,0,0,1610612740,New Orleans Pelicans,1,1,33,26,59,12,30,42,45,56,101,11,3,14,20,38,24,7,11,98,113
2023,2,22301222,12/8/2023,1610612760,Oklahoma City Thunder,1,1,1610612744,Golden State Warriors,0,0,46,23,69,5,24,29,51,47,98,31,5,36,12,38,15,3,11,113,138
2014,2,21400270,12/3/2014,1610612750,Minnesota Timberwolves,1,0,1610612755,Philadelphia 76ers,0,1,27,40,67,3,14,17,30,54,84,14,3,17,14,41,17,12,19,98,77
2014,2,21400270,12/3/2014,1610612755,Philadelphia 76ers,0,1,1610612750,Minnesota Timberwolves,1,0,27,31,58,5,19,24,32,50,82,16,9,25,14,40,15,8,19,98,85
2016,2,21600371,12/13/2016,1610612740,New Orleans Pelicans,1,0,1610612744,Golden State Warriors,0,1,25,22,47,14,21,35,39,43,82,17,4,21,9,38,26,6,17,101,109
2017,2,21700623,1/12/2018,1610612750,Minnesota Timberwolves,1,1,1610612752,New York Knicks,0,0,39,29,68,10,17,27,49,46,95,10,6,16,19,30,33,6,12,94,118
2017,2,21700623,1/12/2018,1610612752,New York Knicks,0,0,1610612750,Minnesota Timberwolves,1,1,33,26,59,12,12,24,45,38,83,6,3,9,11,30,25,12,16,93,108
2016,2,21600399,12/17/2016,1610612756,Phoenix Suns,0,0,1610612760,Oklahoma City Thunder,1,1,31,37,68,8,14,22,39,51,90,15,5,20,21,33,16,12,18,97,101
2016,2,21600399,12/17/2016,1610612760,Oklahoma City Thunder,1,1,1610612756,Phoenix Suns,0,0,34,31,65,7,9,16,41,40,81,25,9,34,16,29,28,5,14,96,114
2016,2,21600038,10/30/2016,1610612749,Milwaukee Bucks,0,0,1610612765,Detroit Pistons,1,1,30,40,70,4,13,17,34,53,87,11,3,14,13,43,22,8,12,93,83
2016,2,21600038,10/30/2016,1610612765,Detroit Pistons,1,1,1610612749,Milwaukee Bucks,0,0,34,34,68,5,15,20,39,49,88,15,5,20,21,31,23,10,16,94,98
2021,2,22101159,4/1/2022,1610612743,Denver Nuggets,1,0,1610612750,Minnesota Timberwolves,0,1,34,17,51,12,23,35,46,40,86,26,3,29,13,29,36,14,18,104,130
2014,2,21400575,1/14/2015,1610612745,Houston Rockets,0,0,1610612753,Orlando Magic,1,1,33,24,57,9,17,26,42,41,83,20,3,23,12,31,26,14,21,103,113
2022,2,22200583,1/6/2023,1610612749,Milwaukee Bucks,1,0,1610612766,Charlotte Hornets,0,1,17,19,36,20,28,48,37,47,84,15,9,24,14,38,22,11,17,101,109
2021,2,22101159,4/1/2022,1610612750,Minnesota Timberwolves,0,1,1610612743,Denver Nuggets,1,0,24,22,46,19,21,40,43,43,86,31,5,36,11,35,26,7,12,103,136
2022,2,22200583,1/6/2023,1610612766,Charlotte Hornets,0,1,1610612749,Milwaukee Bucks,1,0,33,21,54,20,28,48,53,49,102,12,7,19,16,35,32,5,5,102,138
2014,2,21400575,1/14/2015,1610612753,Orlando Magic,1,1,1610612745,Houston Rockets,0,0,35,29,64,9,17,26,44,46,90,23,3,26,17,29,22,11,17,103,120
2017,2,21700622,1/12/2018,1610612744,Golden State Warriors,0,1,1610612749,Milwaukee Bucks,1,0,39,25,64,5,10,15,44,35,79,15,3,18,10,27,28,9,11,89,108
2022,2,22200275,11/25/2022,1610612738,Boston Celtics,1,1,1610612758,Sacramento Kings,0,0,25,21,46,16,21,37,41,42,83,24,3,27,6,37,27,3,10,99,122
2022,2,22200275,11/25/2022,1610612758,Sacramento Kings,0,0,1610612738,Boston Celtics,1,1,27,24,51,9,27,36,36,51,87,23,3,26,17,36,20,9,18,101,104
2021,2,22100804,2/6/2022,1610612751,Brooklyn Nets,0,0,1610612743,Denver Nuggets,1,1,20,26,46,16,25,41,36,51,87,16,6,22,9,45,24,7,10,98,104
2017,2,21700622,1/12/2018,1610612749,Milwaukee Bucks,1,0,1610612744,Golden State Warriors,0,1,25,32,57,11,17,28,36,49,85,11,1,12,14,36,21,7,12,90,94
2021,2,22101158,4/1/2022,1610612757,Portland Trail Blazers,0,0,1610612759,San Antonio Spurs,1,1,26,31,57,15,20,35,41,51,92,14,6,20,16,37,27,9,12,99,111
2014,2,21400269,12/3/2014,1610612742,Dallas Mavericks,0,1,1610612749,Milwaukee Bucks,1,0,34,31,65,8,19,27,42,50,92,15,7,22,22,32,20,11,17,97,107
2021,2,22101158,4/1/2022,1610612759,San Antonio Spurs,1,1,1610612757,Portland Trail Blazers,0,0,30,14,44,16,21,37,46,35,81,22,6,28,9,32,34,12,15,97,130
2014,2,21400269,12/3/2014,1610612749,Milwaukee Bucks,1,0,1610612742,Dallas Mavericks,0,1,31,31,62,7,4,11,38,35,73,22,10,32,10,30,24,8,19,97,105
2014,2,21401108,3/31/2015,1610612751,Brooklyn Nets,1,1,1610612754,Indiana Pacers,0,0,31,31,62,9,9,18,40,40,80,22,6,28,6,36,25,3,8,94,111
2014,2,21401108,3/31/2015,1610612754,Indiana Pacers,0,0,1610612751,Brooklyn Nets,1,1,25,34,59,12,11,23,37,45,82,20,4,24,9,37,23,5,10,95,106
2014,2,21400574,1/14/2015,1610612759,San Antonio Spurs,0,1,1610612766,Charlotte Hornets,1,0,29,35,64,8,13,21,37,48,85,16,4,20,14,36,27,4,14,94,98
2014,2,21400268,12/3/2014,1610612745,Houston Rockets,1,1,1610612763,Memphis Grizzlies,0,0,31,34,65,10,18,28,41,52,93,13,7,20,26,31,22,9,20,95,105
2014,2,21400268,12/3/2014,1610612763,Memphis Grizzlies,0,0,1610612745,Houston Rockets,1,1,37,26,63,2,11,13,39,37,76,16,11,27,14,29,26,14,21,95,96
2014,2,21400267,12/3/2014,1610612737,Atlanta Hawks,0,1,1610612748,Miami Heat,1,0,28,21,49,12,13,25,40,34,74,20,3,23,10,26,25,10,19,94,112
2016,2,21600933,3/5/2017,1610612740,New Orleans Pelicans,0,1,1610612747,Los Angeles Lakers,1,0,27,38,65,9,15,24,36,53,89,24,11,35,18,39,23,7,13,102,105
2016,2,21600933,3/5/2017,1610612747,Los Angeles Lakers,1,0,1610612740,New Orleans Pelicans,0,1,28,27,55,10,18,28,38,45,83,11,4,15,13,34,22,12,25,102,97
2022,2,22200274,11/25/2022,1610612752,New York Knicks,1,0,1610612757,Portland Trail Blazers,0,1,33,31,64,13,28,41,46,59,105,24,4,28,19,41,27,3,10,109,129
2022,2,22200274,11/25/2022,1610612757,Portland Trail Blazers,0,1,1610612752,New York Knicks,1,0,32,21,53,10,22,32,42,43,85,38,13,51,16,33,24,7,13,107,132
2016,2,21600398,12/16/2016,1610612742,Dallas Mavericks,0,0,1610612762,Utah Jazz,1,1,23,26,49,12,16,28,35,42,77,18,3,21,7,35,18,4,7,86,100
2016,2,21600398,12/16/2016,1610612762,Utah Jazz,1,1,1610612742,Dallas Mavericks,0,0,29,14,43,8,14,22,37,28,65,21,6,27,9,21,18,9,16,85,103
2014,2,21400267,12/3/2014,1610612748,Miami Heat,1,0,1610612737,Atlanta Hawks,0,1,30,18,48,6,10,16,36,28,64,24,8,32,5,26,25,9,19,94,102
2021,2,22101157,4/1/2022,1610612760,Oklahoma City Thunder,1,0,1610612765,Detroit Pistons,0,1,25,25,50,11,23,34,36,48,84,18,11,29,16,37,24,9,17,99,101
2014,2,21400574,1/14/2015,1610612766,Charlotte Hornets,1,0,1610612759,San Antonio Spurs,0,1,29,44,73,4,9,13,33,53,86,23,12,35,21,38,15,7,11,93,93
2017,2,21700621,1/12/2018,1610612737,Atlanta Hawks,1,0,1610612751,Brooklyn Nets,0,1,26,26,52,11,17,28,37,43,80,20,6,26,13,33,21,8,18,99,105
2017,2,21700621,1/12/2018,1610612751,Brooklyn Nets,0,1,1610612737,Atlanta Hawks,1,0,27,26,53,13,21,34,40,47,87,17,9,26,15,39,29,6,15,98,110
2014,2,21400573,1/13/2015,1610612747,Los Angeles Lakers,1,0,1610612748,Miami Heat,0,1,25,44,69,4,19,23,29,63,92,13,5,18,20,45,20,7,12,95,75
2014,2,21400573,1/13/2015,1610612748,Miami Heat,0,1,1610612747,Los Angeles Lakers,1,0,31,31,62,2,14,16,33,45,78,10,5,15,12,35,23,10,19,94,78
2014,2,21400266,12/3/2014,1610612751,Brooklyn Nets,1,1,1610612759,San Antonio Spurs,0,0,28,43,71,9,10,19,37,53,90,12,6,18,13,43,20,5,10,98,95
2014,2,21400266,12/3/2014,1610612759,San Antonio Spurs,0,0,1610612751,Brooklyn Nets,1,1,24,45,69,12,20,32,36,65,101,9,3,12,20,48,23,2,8,98,93
2021,2,22100803,2/6/2022,1610612750,Minnesota Timberwolves,1,1,1610612765,Detroit Pistons,0,0,25,30,55,17,19,36,42,49,91,17,4,21,15,35,27,6,10,97,118
2021,2,22100803,2/6/2022,1610612765,Detroit Pistons,0,0,1610612750,Minnesota Timberwolves,1,1,28,35,63,12,20,32,40,55,95,13,6,19,16,43,28,6,11,97,105
2014,2,21401107,3/30/2015,1610612756,Phoenix Suns,0,0,1610612757,Portland Trail Blazers,1,1,35,36,71,3,13,16,38,49,87,7,3,10,10,40,18,6,12,94,86
2014,2,21401107,3/30/2015,1610612757,Portland Trail Blazers,1,1,1610612756,Phoenix Suns,0,0,32,27,59,12,15,27,44,42,86,9,1,10,12,31,26,6,14,94,109
2016,2,21600037,10/30/2016,1610612748,Miami Heat,1,0,1610612759,San Antonio Spurs,0,1,30,30,60,7,13,20,37,43,80,18,8,26,11,34,19,4,12,95,99
2016,2,21600037,10/30/2016,1610612759,San Antonio Spurs,0,1,1610612748,Miami Heat,1,0,27,37,64,10,8,18,37,45,82,22,4,26,17,31,20,7,15,94,106
2017,2,21700620,1/12/2018,1610612753,Orlando Magic,0,0,1610612764,Washington Wizards,1,1,29,22,51,12,17,29,41,39,80,25,6,31,12,28,32,9,16,98,119
2017,2,21700620,1/12/2018,1610612764,Washington Wizards,1,1,1610612753,Orlando Magic,0,0,50,29,79,4,12,16,54,41,95,13,6,19,16,29,26,7,12,99,125
2016,2,21600397,12/16/2016,1610612746,LA Clippers,0,1,1610612748,Miami Heat,1,0,29,29,58,7,18,25,36,47,83,23,6,29,11,40,17,5,10,97,102
2016,2,21600397,12/16/2016,1610612748,Miami Heat,1,0,1610612746,LA Clippers,0,1,32,34,66,6,21,27,38,55,93,16,9,25,14,46,20,1,6,97,98
2022,2,22200273,11/25/2022,1610612753,Orlando Magic,1,0,1610612755,Philadelphia 76ers,0,1,25,20,45,9,26,35,34,46,80,22,5,27,14,34,20,7,14,92,99
2014,2,21400572,1/13/2015,1610612742,Dallas Mavericks,0,1,1610612758,Sacramento Kings,1,0,37,39,76,6,18,24,43,57,100,16,7,23,14,48,23,7,10,108,108
2014,2,21400572,1/13/2015,1610612758,Sacramento Kings,1,0,1610612742,Dallas Mavericks,0,1,37,31,68,1,17,18,38,48,86,27,7,34,16,35,22,12,20,107,104
2017,2,21700619,1/12/2018,1610612739,Cleveland Cavaliers,0,0,1610612754,Indiana Pacers,1,1,30,21,51,7,27,34,37,48,85,14,5,19,12,39,19,5,12,97,95
2017,2,21700619,1/12/2018,1610612754,Indiana Pacers,1,1,1610612739,Cleveland Cavaliers,0,0,29,35,64,10,11,21,39,46,85,9,3,12,10,38,16,12,14,97,97
2016,2,21600932,3/5/2017,1610612742,Dallas Mavericks,1,1,1610612760,Oklahoma City Thunder,0,0,35,26,61,7,18,25,42,44,86,13,3,16,6,39,24,4,8,94,104
2016,2,21600932,3/5/2017,1610612760,Oklahoma City Thunder,0,0,1610612742,Dallas Mavericks,1,1,31,29,60,2,20,22,33,49,82,21,9,30,15,38,19,6,15,96,89
2016,2,21600371,12/13/2016,1610612744,Golden State Warriors,0,1,1610612740,New Orleans Pelicans,1,0,28,33,61,14,20,34,42,53,95,15,4,19,14,40,30,12,12,102,113
2022,2,22200273,11/25/2022,1610612755,Philadelphia 76ers,0,1,1610612753,Orlando Magic,1,0,25,21,46,14,22,36,39,43,82,15,3,18,15,29,25,7,16,92,107
2014,2,21400265,12/3/2014,1610612738,Boston Celtics,1,1,1610612765,Detroit Pistons,0,0,24,39,63,13,17,30,37,56,93,22,5,27,14,44,28,7,13,106,109
2014,2,21400265,12/3/2014,1610612765,Detroit Pistons,0,0,1610612738,Boston Celtics,1,1,29,46,75,8,19,27,37,65,102,20,9,29,24,45,20,8,12,105,102
2017,2,21700618,1/12/2018,1610612762,Utah Jazz,0,0,1610612766,Charlotte Hornets,1,1,16,26,42,12,23,35,28,49,77,20,3,23,9,41,19,8,15,96,88
2017,2,21700618,1/12/2018,1610612766,Charlotte Hornets,1,1,1610612762,Utah Jazz,0,0,23,28,51,9,18,27,32,46,78,26,8,34,11,39,17,5,13,96,99
2021,2,22100802,2/6/2022,1610612741,Chicago Bulls,1,0,1610612755,Philadelphia 76ers,0,1,32,23,55,7,19,26,39,42,81,23,3,26,9,35,21,5,8,92,108
2021,2,22100802,2/6/2022,1610612755,Philadelphia 76ers,0,1,1610612741,Chicago Bulls,1,0,33,27,60,12,12,24,45,39,84,17,4,21,8,32,29,3,11,93,119
2021,2,22101157,4/1/2022,1610612765,Detroit Pistons,0,1,1610612760,Oklahoma City Thunder,1,0,25,21,46,15,33,48,40,54,94,15,3,18,11,44,29,1,8,99,110
2017,2,21700248,11/20/2017,1610612740,New Orleans Pelicans,1,1,1610612760,Oklahoma City Thunder,0,0,34,21,55,7,18,25,41,39,80,25,7,32,9,33,26,14,19,103,114
2017,2,21700617,1/11/2018,1610612747,Los Angeles Lakers,1,1,1610612759,San Antonio Spurs,0,0,23,26,49,13,25,38,36,51,87,8,6,14,14,40,22,6,16,95,93
2017,2,21700617,1/11/2018,1610612759,San Antonio Spurs,0,0,1610612747,Los Angeles Lakers,1,1,23,33,56,8,12,20,31,45,76,11,4,15,10,37,21,15,21,96,81
2014,2,21400571,1/13/2015,1610612744,Golden State Warriors,0,1,1610612762,Utah Jazz,1,0,33,33,66,13,12,25,46,45,91,11,2,13,12,34,32,7,10,95,116
2014,2,21400571,1/13/2015,1610612762,Utah Jazz,1,0,1610612744,Golden State Warriors,0,1,32,28,60,7,14,21,39,42,81,20,4,24,15,27,14,10,17,95,105
2014,2,21401106,3/30/2015,1610612750,Minnesota Timberwolves,1,0,1610612762,Utah Jazz,0,1,22,38,60,6,10,16,28,48,76,22,5,27,15,35,21,8,13,88,84
2014,2,21401106,3/30/2015,1610612762,Utah Jazz,0,1,1610612750,Minnesota Timberwolves,1,0,29,20,49,10,23,33,39,43,82,16,2,18,19,25,18,5,14,86,104
2014,2,21400570,1/13/2015,1610612739,Cleveland Cavaliers,0,0,1610612756,Phoenix Suns,1,1,23,24,47,13,22,35,36,46,82,15,5,20,20,27,16,10,19,90,100
2014,2,21400570,1/13/2015,1610612756,Phoenix Suns,1,1,1610612739,Cleveland Cavaliers,0,0,33,23,56,7,13,20,40,36,76,20,7,27,11,28,23,7,11,90,107
2016,2,21600396,12/16/2016,1610612747,Los Angeles Lakers,0,1,1610612755,Philadelphia 76ers,1,0,27,22,49,9,21,30,36,43,79,19,3,22,10,34,19,7,20,100,100
2016,2,21600396,12/16/2016,1610612755,Philadelphia 76ers,1,0,1610612747,Los Angeles Lakers,0,1,26,31,57,6,25,31,32,56,88,19,5,24,16,43,22,10,17,101,89
2016,2,21600036,10/30/2016,1610612744,Golden State Warriors,0,1,1610612756,Phoenix Suns,1,0,27,27,54,8,21,29,35,48,83,28,5,33,12,41,27,10,16,100,106
2016,2,21600036,10/30/2016,1610612756,Phoenix Suns,1,0,1610612744,Golden State Warriors,0,1,29,38,67,8,15,23,37,53,90,18,7,25,15,39,19,6,12,101,100
2017,2,21700248,11/20/2017,1610612760,Oklahoma City Thunder,0,0,1610612740,New Orleans Pelicans,1,1,27,27,54,11,24,35,38,51,89,20,6,26,11,43,22,8,14,104,107
2014,2,21400264,12/3/2014,1610612747,Los Angeles Lakers,0,0,1610612764,Washington Wizards,1,1,21,35,56,12,17,29,33,52,85,17,4,21,11,43,16,6,13,95,95
2017,2,21700616,1/11/2018,1610612746,LA Clippers,0,1,1610612758,Sacramento Kings,1,0,30,23,53,13,18,31,43,41,84,22,8,30,11,36,28,9,18,104,121
2017,2,21700616,1/11/2018,1610612758,Sacramento Kings,1,0,1610612746,LA Clippers,0,1,34,25,59,8,18,26,42,43,85,23,5,28,11,34,23,9,16,105,115
2023,2,22300215,11/19/2023,1610612757,Portland Trail Blazers,1,0,1610612760,Oklahoma City Thunder,0,1,25,26,51,9,25,34,34,51,85,14,7,21,19,35,21,8,19,95,91
2018,2,21800011,10/17/2018,1610612758,Sacramento Kings,1,0,1610612762,Utah Jazz,0,1,42,34,76,7,12,19,49,46,95,12,6,18,7,42,17,8,9,107,117
2014,2,21400264,12/3/2014,1610612764,Washington Wizards,1,1,1610612747,Los Angeles Lakers,0,0,39,35,74,6,13,19,45,48,93,15,4,19,15,36,33,8,11,95,111
2021,2,22101156,4/1/2022,1610612746,LA Clippers,0,1,1610612749,Milwaukee Bucks,1,0,33,16,49,23,20,43,56,36,92,18,6,24,14,26,34,6,10,99,153
2021,2,22101156,4/1/2022,1610612749,Milwaukee Bucks,1,0,1610612746,LA Clippers,0,1,42,27,69,8,17,25,50,44,94,11,7,18,18,31,30,9,15,98,119
2018,2,21800011,10/17/2018,1610612762,Utah Jazz,0,1,1610612758,Sacramento Kings,1,0,28,24,52,13,14,27,41,38,79,28,10,38,9,35,21,8,17,105,123
2014,2,21400263,12/3/2014,1610612741,Chicago Bulls,0,1,1610612766,Charlotte Hornets,1,0,25,27,52,12,16,28,37,43,80,16,5,21,7,38,27,5,13,97,102
2014,2,21400263,12/3/2014,1610612766,Charlotte Hornets,1,0,1610612741,Chicago Bulls,0,1,34,41,75,2,13,15,36,54,90,21,2,23,8,48,17,4,5,97,95
2017,2,21700615,1/11/2018,1610612739,Cleveland Cavaliers,0,0,1610612761,Toronto Raptors,1,1,28,35,63,6,20,26,34,55,89,25,5,30,14,46,18,3,10,98,99
2017,2,21700615,1/11/2018,1610612761,Toronto Raptors,1,1,1610612739,Cleveland Cavaliers,0,0,35,29,64,18,24,42,53,53,106,9,4,13,24,31,31,3,9,99,133
2021,2,22100801,2/5/2022,1610612758,Sacramento Kings,1,1,1610612760,Oklahoma City Thunder,0,0,31,20,51,12,20,32,43,40,83,15,7,22,9,35,30,8,16,100,113
2021,2,22100801,2/5/2022,1610612760,Oklahoma City Thunder,0,0,1610612758,Sacramento Kings,1,1,33,24,57,9,21,30,42,45,87,10,6,16,8,42,23,13,14,99,103
2021,2,22101155,4/1/2022,1610612756,Phoenix Suns,0,0,1610612763,Memphis Grizzlies,1,1,37,22,59,10,17,27,47,39,86,10,7,17,8,33,27,7,20,106,114
2021,2,22101155,4/1/2022,1610612763,Memphis Grizzlies,1,1,1610612756,Phoenix Suns,0,0,39,39,78,7,17,24,46,56,102,23,5,28,21,39,30,8,11,105,122
2016,2,21600931,3/5/2017,1610612758,Sacramento Kings,1,0,1610612762,Utah Jazz,0,1,35,31,66,8,9,17,43,40,83,15,5,20,6,36,24,8,13,99,109
2016,2,21600931,3/5/2017,1610612762,Utah Jazz,0,1,1610612758,Sacramento Kings,1,0,31,26,57,10,23,33,41,49,90,18,9,27,19,34,24,8,14,99,110
2016,2,21600395,12/16/2016,1610612740,New Orleans Pelicans,0,0,1610612745,Houston Rockets,1,1,31,40,71,9,18,27,40,58,98,11,9,20,17,46,17,7,11,100,100
2016,2,21600395,12/16/2016,1610612745,Houston Rockets,1,1,1610612740,New Orleans Pelicans,0,0,18,15,33,24,37,61,42,52,94,14,5,19,17,37,27,4,14,100,122
2017,2,21700614,1/11/2018,1610612738,Boston Celtics,0,1,1610612755,Philadelphia 76ers,1,0,30,24,54,13,22,35,43,46,89,15,4,19,14,35,24,12,18,103,114
2017,2,21700614,1/11/2018,1610612755,Philadelphia 76ers,1,0,1610612738,Boston Celtics,0,1,27,27,54,11,17,28,38,44,82,16,2,18,7,38,20,11,19,103,103
2023,2,22300215,11/19/2023,1610612760,Oklahoma City Thunder,0,1,1610612757,Portland Trail Blazers,1,0,27,18,45,22,14,36,49,32,81,14,0,14,12,20,28,10,18,94,134
2021,2,22100800,2/5/2022,1610612749,Milwaukee Bucks,0,1,1610612757,Portland Trail Blazers,1,0,26,16,42,23,27,50,49,43,92,16,6,22,14,34,36,6,10,100,137
2014,2,21400262,12/2/2014,1610612744,Golden State Warriors,1,1,1610612753,Orlando Magic,0,0,30,25,55,8,19,27,38,44,82,14,4,18,13,32,25,11,15,92,98
2014,2,21400262,12/2/2014,1610612753,Orlando Magic,0,0,1610612744,Golden State Warriors,1,1,33,37,70,6,11,17,39,48,87,13,1,14,12,36,19,8,11,93,97
2014,2,21400261,12/2/2014,1610612758,Sacramento Kings,1,0,1610612761,Toronto Raptors,0,1,36,29,65,3,7,10,39,36,75,28,9,37,17,23,28,8,16,91,109
2014,2,21400261,12/2/2014,1610612761,Toronto Raptors,0,1,1610612758,Sacramento Kings,1,0,34,31,65,10,13,23,44,44,88,19,2,21,22,24,22,5,13,93,117
2023,2,22301216,12/8/2023,1610612766,Charlotte Hornets,1,1,1610612761,Toronto Raptors,0,0,31,23,54,13,12,25,44,35,79,18,2,20,7,29,30,7,16,97,119
2014,2,21400569,1/13/2015,1610612759,San Antonio Spurs,0,0,1610612764,Washington Wizards,1,1,29,38,67,9,20,29,38,58,96,8,4,12,18,42,26,4,9,93,93
2014,2,21400569,1/13/2015,1610612764,Washington Wizards,1,1,1610612759,San Antonio Spurs,0,0,31,32,63,6,6,12,37,38,75,21,3,24,9,29,20,3,15,92,101
2023,2,22300063,10/25/2023,1610612766,Charlotte Hornets,1,1,1610612737,Atlanta Hawks,0,0,32,17,49,11,26,37,43,43,86,19,7,26,15,31,34,12,19,103,116
2017,2,21700613,1/10/2018,1610612744,Golden State Warriors,1,0,1610612746,LA Clippers,0,1,30,26,56,8,15,23,38,41,79,22,4,26,5,37,26,9,16,103,106
2018,2,21800133,11/4/2018,1610612749,Milwaukee Bucks,1,1,1610612758,Sacramento Kings,0,0,24,15,39,22,34,56,46,49,95,30,3,33,14,37,30,6,12,109,144
2017,2,21700613,1/10/2018,1610612746,LA Clippers,0,1,1610612744,Golden State Warriors,1,0,35,35,70,11,13,24,46,48,94,22,6,28,20,30,24,9,14,103,125
2021,2,22100800,2/5/2022,1610612757,Portland Trail Blazers,1,0,1610612749,Milwaukee Bucks,0,1,27,13,40,14,31,45,41,44,85,12,9,21,9,38,25,9,16,100,108
2016,2,21600394,12/16/2016,1610612758,Sacramento Kings,0,1,1610612763,Memphis Grizzlies,1,0,24,32,56,7,17,24,31,49,80,27,10,37,18,35,18,7,12,91,96
2016,2,21600394,12/16/2016,1610612763,Memphis Grizzlies,1,0,1610612758,Sacramento Kings,0,1,24,28,52,5,20,25,29,48,77,29,7,36,19,33,19,5,13,91,92
2014,2,21400260,12/2/2014,1610612754,Indiana Pacers,0,0,1610612756,Phoenix Suns,1,1,37,35,72,4,9,13,41,44,85,13,4,17,11,36,20,13,19,99,99
2014,2,21400260,12/2/2014,1610612756,Phoenix Suns,1,1,1610612754,Indiana Pacers,0,0,31,30,61,12,13,25,43,43,86,18,8,26,11,36,18,8,12,99,116
2018,2,21800133,11/4/2018,1610612758,Sacramento Kings,0,0,1610612749,Milwaukee Bucks,1,1,28,31,59,14,22,36,42,53,95,11,11,22,11,49,24,6,16,108,109
2023,2,22300064,10/25/2023,1610612764,Washington Wizards,0,0,1610612754,Indiana Pacers,1,1,35,37,72,9,15,24,44,52,96,23,6,29,13,43,28,10,14,110,120
2017,2,21700612,1/10/2018,1610612737,Atlanta Hawks,0,1,1610612743,Denver Nuggets,1,0,28,25,53,12,15,27,40,40,80,18,0,18,11,29,25,13,16,95,110
2017,2,21700612,1/10/2018,1610612743,Denver Nuggets,1,0,1610612737,Atlanta Hawks,0,1,29,29,58,9,28,37,38,57,95,12,8,20,21,40,27,6,12,97,97
2021,2,22100799,2/5/2022,1610612747,Los Angeles Lakers,1,1,1610612752,New York Knicks,0,0,39,29,68,9,25,34,48,54,102,17,11,28,16,45,29,8,13,109,122
2021,2,22100799,2/5/2022,1610612752,New York Knicks,0,0,1610612747,Los Angeles Lakers,1,1,28,32,60,11,27,38,39,59,98,26,10,36,20,44,24,8,14,110,115
2020,2,22000487,2/23/2021,1610612743,Denver Nuggets,1,1,1610612757,Portland Trail Blazers,0,0,26,32,58,14,22,36,40,54,94,17,1,18,13,41,25,0,1,90,111
2016,2,21600930,3/5/2017,1610612753,Orlando Magic,0,0,1610612764,Washington Wizards,1,1,30,24,54,14,21,35,44,45,89,12,7,19,18,31,16,9,15,94,114
2016,2,21600930,3/5/2017,1610612764,Washington Wizards,1,1,1610612753,Orlando Magic,0,0,25,30,55,14,12,26,39,42,81,23,2,25,11,31,26,9,12,94,115
2016,2,21600035,10/30/2016,1610612746,LA Clippers,1,1,1610612762,Utah Jazz,0,0,28,28,56,6,21,27,34,49,83,14,6,20,17,36,17,8,13,90,88
2016,2,21600035,10/30/2016,1610612762,Utah Jazz,0,0,1610612746,LA Clippers,1,1,22,32,54,7,12,19,29,44,73,10,3,13,8,39,18,8,18,89,75
2014,2,21400568,1/13/2015,1610612737,Atlanta Hawks,0,1,1610612755,Philadelphia 76ers,1,0,30,34,64,12,11,23,42,45,87,9,7,16,21,26,34,8,19,93,105
2014,2,21400568,1/13/2015,1610612755,Philadelphia 76ers,1,0,1610612737,Atlanta Hawks,0,1,22,29,51,9,16,25,31,45,76,16,9,25,14,34,20,6,19,94,87
2021,2,22100798,2/5/2022,1610612756,Phoenix Suns,0,1,1610612764,Washington Wizards,1,0,32,36,68,8,23,31,40,59,99,7,7,14,26,36,26,8,10,92,95
2021,2,22100798,2/5/2022,1610612764,Washington Wizards,1,0,1610612756,Phoenix Suns,0,1,25,36,61,5,19,24,30,55,85,15,4,19,11,45,14,6,9,92,80
2014,2,21400259,12/2/2014,1610612743,Denver Nuggets,1,0,1610612757,Portland Trail Blazers,0,1,34,27,61,7,13,20,41,40,81,14,5,19,8,36,21,7,14,95,103
2021,2,22101154,4/1/2022,1610612745,Houston Rockets,1,0,1610612758,Sacramento Kings,0,1,24,28,52,17,28,45,41,56,97,18,8,26,20,41,26,6,11,100,117
2014,2,21400259,12/2/2014,1610612757,Portland Trail Blazers,0,1,1610612743,Denver Nuggets,1,0,38,26,64,5,17,22,43,43,86,14,3,17,11,35,26,8,12,95,105
2021,2,22101154,4/1/2022,1610612758,Sacramento Kings,0,1,1610612745,Houston Rockets,1,0,30,23,53,12,16,28,42,39,81,26,8,34,9,34,29,9,13,100,122
2020,2,22000487,2/23/2021,1610612757,Portland Trail Blazers,0,0,1610612743,Denver Nuggets,1,1,27,19,46,14,27,41,41,46,87,10,0,10,11,35,21,8,9,91,106
2016,2,21600393,12/16/2016,1610612741,Chicago Bulls,1,0,1610612749,Milwaukee Bucks,0,1,23,48,71,5,16,21,28,64,92,8,7,15,26,43,17,7,12,87,69
2016,2,21600393,12/16/2016,1610612749,Milwaukee Bucks,0,1,1610612741,Chicago Bulls,1,0,28,29,57,10,15,25,38,44,82,9,4,13,14,31,26,7,12,86,95
2020,2,22000767,4/5/2021,1610612739,Cleveland Cavaliers,0,1,1610612759,San Antonio Spurs,1,0,33,19,52,12,22,34,45,41,86,23,4,27,9,34,29,4,9,98,125
2020,2,22000767,4/5/2021,1610612759,San Antonio Spurs,1,0,1610612739,Cleveland Cavaliers,0,1,30,27,57,5,21,26,35,48,83,26,6,32,11,40,22,5,10,97,101
2018,2,21800506,12/26/2018,1610612748,Miami Heat,1,0,1610612761,Toronto Raptors,0,1,31,23,54,12,17,29,43,40,83,6,6,12,8,36,28,8,12,94,104
2023,2,22300065,10/25/2023,1610612752,New York Knicks,1,0,1610612738,Boston Celtics,0,1,18,38,56,18,23,41,36,61,97,14,12,26,24,42,24,6,11,97,104
2014,2,21400258,12/2/2014,1610612740,New Orleans Pelicans,1,1,1610612760,Oklahoma City Thunder,0,0,34,37,71,5,12,17,39,49,88,29,16,45,20,38,23,7,13,100,112
2017,2,21700611,1/10/2018,1610612750,Minnesota Timberwolves,1,1,1610612760,Oklahoma City Thunder,0,0,32,28,60,7,13,20,39,41,80,19,8,27,14,31,22,9,16,95,104
2017,2,21700611,1/10/2018,1610612760,Oklahoma City Thunder,0,0,1610612750,Minnesota Timberwolves,1,1,26,29,55,6,19,25,32,48,80,18,6,24,16,37,13,11,19,94,88
2014,2,21400258,12/2/2014,1610612760,Oklahoma City Thunder,0,0,1610612740,New Orleans Pelicans,1,1,30,30,60,7,17,24,37,47,84,23,4,27,13,35,16,13,17,100,104
2016,2,21600929,3/5/2017,1610612738,Boston Celtics,0,0,1610612756,Phoenix Suns,1,1,19,29,48,13,24,37,32,53,85,29,11,40,19,41,19,7,14,101,106
2016,2,21600929,3/5/2017,1610612756,Phoenix Suns,1,1,1610612738,Boston Celtics,0,0,38,36,74,4,16,20,42,52,94,21,5,26,15,42,16,6,11,101,109
2014,2,21400567,1/13/2015,1610612750,Minnesota Timberwolves,0,1,1610612754,Indiana Pacers,1,0,31,36,67,10,10,20,41,46,87,18,1,19,14,33,22,9,17,97,110
2014,2,21400567,1/13/2015,1610612754,Indiana Pacers,1,0,1610612750,Minnesota Timberwolves,0,1,34,28,62,5,13,18,39,41,80,18,12,30,17,29,22,11,18,98,101
2020,2,22000486,2/23/2021,1610612749,Milwaukee Bucks,1,1,1610612750,Minnesota Timberwolves,0,0,33,24,57,20,22,42,53,46,99,13,5,18,10,39,33,4,8,105,139
2020,2,22000486,2/23/2021,1610612750,Minnesota Timberwolves,0,0,1610612749,Milwaukee Bucks,1,1,23,21,44,19,35,54,42,56,98,9,0,9,11,45,35,11,14,106,112
2017,2,21700610,1/10/2018,1610612749,Milwaukee Bucks,1,1,1610612753,Orlando Magic,0,0,41,22,63,4,15,19,45,37,82,16,9,25,13,28,20,6,17,97,110
2017,2,21700610,1/10/2018,1610612753,Orlando Magic,0,0,1610612749,Milwaukee Bucks,1,1,31,30,61,8,21,29,39,51,90,17,1,18,12,39,26,4,10,96,103
2023,2,22300064,10/25/2023,1610612754,Indiana Pacers,1,1,1610612764,Washington Wizards,0,0,36,28,64,20,23,43,56,51,107,11,1,12,16,35,38,6,12,108,143
2018,2,21800506,12/26/2018,1610612761,Toronto Raptors,0,1,1610612748,Miami Heat,1,0,24,25,49,13,17,30,37,42,79,19,4,23,13,31,19,10,16,92,106
2019,2,21900217,11/22/2019,1610612751,Brooklyn Nets,1,1,1610612758,Sacramento Kings,0,0,29,18,47,12,22,34,41,40,81,22,9,31,14,28,22,8,18,100,116
2022,2,22200555,1/2/2023,1610612751,Brooklyn Nets,1,1,1610612759,San Antonio Spurs,0,0,47,26,73,11,9,20,58,35,93,12,3,15,8,29,31,5,13,104,139
2019,2,21900217,11/22/2019,1610612758,Sacramento Kings,0,0,1610612751,Brooklyn Nets,1,1,35,25,60,4,22,26,39,47,86,15,4,19,11,39,26,9,16,100,97
2014,2,21400257,12/2/2014,1610612741,Chicago Bulls,1,0,1610612742,Dallas Mavericks,0,1,39,38,77,8,18,26,47,56,103,27,7,34,23,37,38,9,18,117,129
2014,2,21401105,3/30/2015,1610612758,Sacramento Kings,0,0,1610612763,Memphis Grizzlies,1,1,28,37,65,5,11,16,33,48,81,12,8,20,18,34,16,7,15,88,83
2017,2,21700609,1/10/2018,1610612740,New Orleans Pelicans,0,0,1610612763,Memphis Grizzlies,1,1,23,19,42,11,24,35,34,43,77,23,11,34,12,37,20,7,12,95,102
2017,2,21700609,1/10/2018,1610612763,Memphis Grizzlies,1,1,1610612740,New Orleans Pelicans,0,0,32,37,69,5,14,19,37,51,88,26,6,32,19,33,21,5,10,94,105
2014,2,21401105,3/30/2015,1610612763,Memphis Grizzlies,1,1,1610612758,Sacramento Kings,0,0,30,30,60,8,15,23,38,45,83,13,4,17,18,29,23,4,14,89,97
2022,2,22200555,1/2/2023,1610612759,San Antonio Spurs,0,0,1610612751,Brooklyn Nets,1,1,34,32,66,8,23,31,42,55,97,11,7,18,19,41,26,13,18,104,103
2021,2,22100797,2/5/2022,1610612748,Miami Heat,0,1,1610612766,Charlotte Hornets,1,0,27,32,59,11,21,32,38,53,91,17,1,18,14,40,27,4,12,99,104
2021,2,22100797,2/5/2022,1610612766,Charlotte Hornets,1,0,1610612748,Miami Heat,0,1,23,27,50,10,26,36,33,53,86,10,6,16,14,42,23,14,20,99,86
2014,2,21400566,1/12/2015,1610612741,Chicago Bulls,1,0,1610612753,Orlando Magic,0,1,33,24,57,8,19,27,41,43,84,24,9,33,15,33,25,10,14,100,114
2021,2,22101153,4/1/2022,1610612738,Boston Celtics,1,1,1610612754,Indiana Pacers,0,0,33,17,50,12,21,33,45,38,83,26,2,28,14,25,29,9,16,99,128
2021,2,22101153,4/1/2022,1610612754,Indiana Pacers,0,0,1610612738,Boston Celtics,1,1,25,20,45,17,19,36,42,39,81,22,1,23,10,30,25,7,16,98,123
2020,2,22000485,2/23/2021,1610612738,Boston Celtics,0,0,1610612742,Dallas Mavericks,1,1,29,18,47,12,27,39,41,45,86,13,5,18,15,32,19,5,13,94,107
2016,2,21600392,12/16/2016,1610612737,Atlanta Hawks,0,1,1610612761,Toronto Raptors,1,0,35,26,61,11,14,25,46,40,86,22,10,32,23,21,26,7,14,91,125
2016,2,21600392,12/16/2016,1610612761,Toronto Raptors,1,0,1610612737,Atlanta Hawks,0,1,37,28,65,10,11,21,47,39,86,17,9,26,15,28,20,6,10,91,121
2017,2,21700608,1/10/2018,1610612745,Houston Rockets,1,1,1610612757,Portland Trail Blazers,0,0,33,29,62,12,26,38,45,55,100,19,6,25,22,38,25,5,13,101,121
2017,2,21700608,1/10/2018,1610612757,Portland Trail Blazers,0,0,1610612745,Houston Rockets,1,1,31,26,57,9,17,26,40,43,83,23,9,32,13,35,21,7,14,99,112
2014,2,21400257,12/2/2014,1610612742,Dallas Mavericks,0,1,1610612741,Chicago Bulls,1,0,32,40,72,15,15,30,47,55,102,23,4,27,15,41,30,5,14,115,132
2016,2,21600928,3/5/2017,1610612744,Golden State Warriors,0,1,1610612752,New York Knicks,1,0,27,26,53,13,22,35,40,48,88,19,4,23,14,36,21,5,8,93,112
2016,2,21600928,3/5/2017,1610612752,New York Knicks,1,0,1610612744,Golden State Warriors,0,1,32,29,61,7,15,22,39,44,83,20,5,25,18,27,18,11,15,94,105
2014,2,21400566,1/12/2015,1610612753,Orlando Magic,0,1,1610612741,Chicago Bulls,1,0,41,22,63,7,11,18,48,33,81,18,11,29,5,33,28,6,11,100,121
2014,2,21400256,12/2/2014,1610612751,Brooklyn Nets,0,1,1610612752,New York Knicks,1,0,33,39,72,6,11,17,39,50,89,14,6,20,24,30,22,8,14,88,98
2014,2,21400256,12/2/2014,1610612752,New York Knicks,1,0,1610612751,Brooklyn Nets,0,1,24,29,53,11,17,28,35,46,81,12,2,14,14,33,22,7,14,87,93
2023,2,22300132,11/4/2023,1610612755,Philadelphia 76ers,1,1,1610612756,Phoenix Suns,0,0,32,28,60,11,19,30,43,47,90,15,3,18,18,30,24,11,18,98,112
2020,2,22000485,2/23/2021,1610612742,Dallas Mavericks,1,1,1610612738,Boston Celtics,0,0,29,27,56,13,20,33,42,47,89,13,2,15,13,35,19,6,10,94,110
2016,2,21600391,12/16/2016,1610612738,Boston Celtics,1,1,1610612766,Charlotte Hornets,0,0,25,25,50,9,19,28,34,44,78,19,7,26,8,40,26,10,13,95,96
2023,2,22301201,12/5/2023,1610612752,New York Knicks,0,0,1610612749,Milwaukee Bucks,1,1,36,28,64,7,16,23,43,44,87,29,4,33,18,29,27,12,17,102,122
2016,2,21600391,12/16/2016,1610612766,Charlotte Hornets,0,0,1610612738,Boston Celtics,1,1,24,43,67,8,22,30,32,65,97,16,3,19,23,43,21,7,12,96,88
2019,2,21900579,1/11/2020,1610612741,Chicago Bulls,0,1,1610612765,Detroit Pistons,1,0,31,17,48,11,24,35,42,41,83,13,1,14,12,30,24,7,15,93,108
2014,2,21400255,12/2/2014,1610612747,Los Angeles Lakers,0,1,1610612765,Detroit Pistons,1,0,29,35,64,10,7,17,39,42,81,18,6,24,12,34,25,6,14,92,106
2014,2,21400255,12/2/2014,1610612765,Detroit Pistons,1,0,1610612747,Los Angeles Lakers,0,1,27,42,69,6,15,21,33,57,90,24,7,31,26,36,20,9,14,94,96
2017,2,21700607,1/10/2018,1610612741,Chicago Bulls,0,1,1610612752,New York Knicks,1,0,30,35,65,15,18,33,45,53,98,17,3,20,12,42,21,5,17,113,122
2017,2,21700607,1/10/2018,1610612752,New York Knicks,1,0,1610612741,Chicago Bulls,0,1,38,36,74,10,12,22,48,48,96,13,8,21,13,39,24,10,18,114,119
2014,2,21401104,3/30/2015,1610612745,Houston Rockets,0,0,1610612761,Toronto Raptors,1,1,27,30,57,8,19,27,35,49,84,18,13,31,18,37,21,9,14,94,96
2014,2,21401104,3/30/2015,1610612761,Toronto Raptors,1,1,1610612745,Houston Rockets,0,0,27,29,56,8,14,22,35,43,78,21,6,27,13,31,20,7,16,93,99
2016,2,21600034,10/29/2016,1610612750,Minnesota Timberwolves,0,0,1610612758,Sacramento Kings,1,1,30,18,48,7,15,22,37,33,70,22,9,31,10,27,19,6,14,89,103
2023,2,22300313,12/13/2023,1610612737,Atlanta Hawks,0,0,1610612761,Toronto Raptors,1,1,30,29,59,18,23,41,48,52,100,14,5,19,15,40,32,3,7,102,128
2016,2,21600034,10/29/2016,1610612758,Sacramento Kings,1,1,1610612750,Minnesota Timberwolves,0,0,30,29,59,9,17,26,39,46,85,19,6,25,19,30,24,6,13,91,106
2020,2,22000484,2/23/2021,1610612755,Philadelphia 76ers,0,1,1610612761,Toronto Raptors,1,0,16,26,42,17,21,38,33,47,80,26,4,30,15,33,24,12,19,100,109
2022,2,22200752,1/29/2023,1610612748,Miami Heat,0,0,1610612766,Charlotte Hornets,1,1,35,27,62,10,21,31,45,48,93,17,6,23,15,36,26,6,11,98,117
2016,2,21600927,3/5/2017,1610612737,Atlanta Hawks,1,0,1610612754,Indiana Pacers,0,1,25,25,50,9,18,27,34,43,77,19,12,31,14,35,21,6,15,92,96
2016,2,21600927,3/5/2017,1610612754,Indiana Pacers,0,1,1610612737,Atlanta Hawks,1,0,20,25,45,15,18,33,35,43,78,12,9,21,11,37,24,12,15,93,97
2016,2,21600390,12/16/2016,1610612751,Brooklyn Nets,0,0,1610612753,Orlando Magic,1,1,28,28,56,11,16,27,39,44,83,22,4,26,9,37,21,8,17,104,111
2016,2,21600390,12/16/2016,1610612753,Orlando Magic,1,1,1610612751,Brooklyn Nets,0,0,32,36,68,7,22,29,39,58,97,33,9,42,21,42,22,5,7,105,118
2014,2,21400254,12/2/2014,1610612737,Atlanta Hawks,1,1,1610612738,Boston Celtics,0,0,32,26,58,11,13,24,43,39,82,12,2,14,5,35,36,10,16,99,109
2014,2,21400254,12/2/2014,1610612738,Boston Celtics,0,0,1610612737,Atlanta Hawks,1,1,29,32,61,12,11,23,41,43,84,11,2,13,12,31,33,8,23,100,105
2020,2,22000766,4/5/2021,1610612760,Oklahoma City Thunder,1,0,1610612765,Detroit Pistons,0,1,36,34,70,5,22,27,41,56,97,21,4,25,17,41,17,10,15,106,108
2020,2,22000766,4/5/2021,1610612765,Detroit Pistons,0,1,1610612760,Oklahoma City Thunder,1,0,36,31,67,13,15,28,49,46,95,21,3,24,15,32,32,10,14,105,132
2019,2,21900579,1/11/2020,1610612765,Detroit Pistons,1,0,1610612741,Chicago Bulls,0,1,27,23,50,9,19,28,36,42,78,18,9,27,17,30,22,11,19,95,99
2017,2,21700606,1/10/2018,1610612751,Brooklyn Nets,1,0,1610612765,Detroit Pistons,0,1,15,22,37,12,25,37,27,47,74,13,1,14,3,45,19,10,20,97,79
2017,2,21700606,1/10/2018,1610612765,Detroit Pistons,0,1,1610612751,Brooklyn Nets,1,0,38,34,72,10,11,21,48,45,93,8,4,12,14,34,24,11,13,98,114
2021,2,22100796,2/5/2022,1610612753,Orlando Magic,1,0,1610612763,Memphis Grizzlies,0,1,22,20,42,17,31,48,39,51,90,20,9,29,10,46,27,6,9,102,115
2021,2,22100796,2/5/2022,1610612763,Memphis Grizzlies,0,1,1610612753,Orlando Magic,1,0,40,26,66,13,26,39,53,52,105,16,6,22,21,33,33,2,8,102,135
2021,2,22101152,4/1/2022,1610612742,Dallas Mavericks,0,0,1610612764,Washington Wizards,1,1,23,17,40,11,27,38,34,44,78,24,2,26,8,38,14,7,13,99,103
2021,2,22101152,4/1/2022,1610612764,Washington Wizards,1,1,1610612742,Dallas Mavericks,0,0,32,25,57,17,16,33,49,41,90,20,2,22,10,32,33,3,9,98,135
2014,2,21400253,12/2/2014,1610612739,Cleveland Cavaliers,1,1,1610612749,Milwaukee Bucks,0,0,33,19,52,6,15,21,39,34,73,27,11,38,10,31,22,11,19,99,111
2014,2,21400253,12/2/2014,1610612749,Milwaukee Bucks,0,0,1610612739,Cleveland Cavaliers,1,1,38,34,72,7,13,20,45,47,92,11,2,13,14,33,31,5,13,98,108
2020,2,22000484,2/23/2021,1610612761,Toronto Raptors,1,0,1610612755,Philadelphia 76ers,0,1,29,27,56,11,26,37,40,53,93,11,2,13,12,42,29,5,10,102,102
2017,2,21700605,1/10/2018,1610612762,Utah Jazz,0,1,1610612764,Washington Wizards,1,0,32,27,59,11,22,33,43,49,92,10,3,13,14,37,23,8,13,96,107
2017,2,21700605,1/10/2018,1610612764,Washington Wizards,1,0,1610612762,Utah Jazz,0,1,31,22,53,10,15,25,41,37,78,12,5,17,12,28,25,15,23,97,104
2022,2,22200752,1/29/2023,1610612766,Charlotte Hornets,1,1,1610612748,Miami Heat,0,0,30,13,43,15,25,40,45,38,83,17,5,22,13,28,25,11,19,99,122
2022,2,22200711,1/23/2023,1610612757,Portland Trail Blazers,1,1,1610612759,San Antonio Spurs,0,0,35,24,59,20,13,33,55,37,92,17,5,22,10,30,34,7,10,101,147
2014,2,21400565,1/12/2015,1610612761,Toronto Raptors,1,0,1610612765,Detroit Pistons,0,1,40,20,60,7,20,27,47,40,87,10,4,14,13,30,29,10,19,99,111
2014,2,21400565,1/12/2015,1610612765,Detroit Pistons,0,1,1610612761,Toronto Raptors,1,0,34,41,75,7,14,21,41,55,96,25,6,31,21,35,24,4,8,98,114
2014,2,21400252,12/1/2014,1610612746,LA Clippers,1,1,1610612750,Minnesota Timberwolves,0,0,26,20,46,15,19,34,41,39,80,30,6,36,11,30,33,9,15,102,127
2014,2,21400252,12/1/2014,1610612750,Minnesota Timberwolves,0,0,1610612746,LA Clippers,1,1,33,37,70,2,10,12,35,47,82,29,11,40,10,42,26,5,11,103,101
2019,2,21900706,1/28/2020,1610612742,Dallas Mavericks,1,0,1610612756,Phoenix Suns,0,1,30,20,50,7,26,33,37,46,83,23,4,27,14,33,19,10,17,98,104
2017,2,21700604,1/10/2018,1610612748,Miami Heat,0,1,1610612754,Indiana Pacers,1,0,30,21,51,13,17,30,43,38,81,15,6,21,7,36,25,7,16,100,114
2017,2,21700604,1/10/2018,1610612754,Indiana Pacers,1,0,1610612748,Miami Heat,0,1,42,27,69,1,17,18,43,44,87,19,9,28,15,34,13,6,14,100,106
2023,2,22300068,10/25/2023,1610612765,Detroit Pistons,0,0,1610612748,Miami Heat,1,1,30,30,60,11,21,32,41,51,92,9,6,15,21,35,28,11,17,96,102
2021,2,22100795,2/4/2022,1610612757,Portland Trail Blazers,1,0,1610612760,Oklahoma City Thunder,0,1,34,34,68,6,27,33,40,61,101,7,3,10,21,42,18,5,12,98,93
2014,2,21400251,12/1/2014,1610612743,Denver Nuggets,0,1,1610612762,Utah Jazz,1,0,32,29,61,9,17,26,41,46,87,12,5,17,12,36,23,3,11,95,103
2014,2,21400251,12/1/2014,1610612762,Utah Jazz,1,0,1610612743,Denver Nuggets,0,1,29,37,66,7,11,18,36,48,84,22,8,30,18,35,18,7,14,96,101
2021,2,22100795,2/4/2022,1610612760,Oklahoma City Thunder,0,1,1610612757,Portland Trail Blazers,1,0,18,27,45,15,27,42,33,54,87,15,6,21,15,40,24,7,15,97,96
2021,2,22101151,4/1/2022,1610612753,Orlando Magic,1,0,1610612761,Toronto Raptors,0,1,23,21,44,11,24,35,34,45,79,10,1,11,11,34,24,13,22,95,89
2021,2,22101151,4/1/2022,1610612761,Toronto Raptors,0,1,1610612753,Orlando Magic,1,0,23,21,44,13,29,42,36,50,86,17,3,20,11,40,21,6,10,95,102
2020,2,22000483,2/23/2021,1610612744,Golden State Warriors,0,1,1610612752,New York Knicks,1,0,27,24,51,13,25,38,40,49,89,21,3,24,8,41,30,4,10,100,114
2014,2,21401103,3/30/2015,1610612737,Atlanta Hawks,1,1,1610612749,Milwaukee Bucks,0,0,27,23,50,9,20,29,36,43,79,20,4,24,16,28,29,4,11,85,101
2022,2,22200712,1/23/2023,1610612758,Sacramento Kings,1,1,1610612763,Memphis Grizzlies,0,0,27,21,48,22,18,40,49,39,88,13,1,14,15,25,37,14,25,104,133
2014,2,21401103,3/30/2015,1610612749,Milwaukee Bucks,0,0,1610612737,Atlanta Hawks,1,1,30,28,58,4,13,17,34,41,75,16,7,23,15,30,26,5,15,86,88
2016,2,21600033,10/29/2016,1610612743,Denver Nuggets,1,0,1610612757,Portland Trail Blazers,0,1,32,45,77,6,17,23,38,62,100,31,8,39,23,44,19,10,17,114,113
2023,2,22300310,12/13/2023,1610612755,Philadelphia 76ers,0,1,1610612765,Detroit Pistons,1,0,34,23,57,11,19,30,45,42,87,28,6,34,11,33,28,6,11,101,129
2019,2,21900706,1/28/2020,1610612756,Phoenix Suns,0,1,1610612742,Dallas Mavericks,1,0,39,19,58,12,16,28,51,35,86,19,2,21,8,27,34,6,13,100,133
2016,2,21600033,10/29/2016,1610612757,Portland Trail Blazers,0,1,1610612743,Denver Nuggets,1,0,35,31,66,10,22,32,45,53,98,15,6,21,9,46,23,10,16,115,115
2023,2,22300239,11/25/2023,1610612755,Philadelphia 76ers,0,1,1610612760,Oklahoma City Thunder,1,0,24,18,42,14,27,41,38,45,83,37,8,45,22,26,30,3,13,97,127
2017,2,21700603,1/10/2018,1610612742,Dallas Mavericks,0,1,1610612766,Charlotte Hornets,1,0,24,23,47,15,21,36,39,44,83,22,6,28,4,41,23,6,8,100,115
2014,2,21400250,12/1/2014,1610612748,Miami Heat,0,0,1610612764,Washington Wizards,1,1,31,19,50,2,20,22,33,39,72,18,12,30,8,38,12,7,11,88,86
2017,2,21700603,1/10/2018,1610612766,Charlotte Hornets,1,0,1610612742,Dallas Mavericks,0,1,33,25,58,10,16,26,43,41,84,15,15,30,9,38,16,7,11,102,111
2016,2,21600926,3/4/2017,1610612751,Brooklyn Nets,0,0,1610612757,Portland Trail Blazers,1,1,31,25,56,14,16,30,45,41,86,12,5,17,10,35,24,9,14,97,116
2016,2,21600926,3/4/2017,1610612757,Portland Trail Blazers,1,1,1610612751,Brooklyn Nets,0,0,33,28,61,16,9,25,49,37,86,16,6,22,13,25,29,7,13,97,130
2016,2,21600389,12/16/2016,1610612764,Washington Wizards,1,1,1610612765,Detroit Pistons,0,0,32,20,52,12,13,25,44,33,77,22,5,27,4,31,30,3,6,92,122
2016,2,21600389,12/16/2016,1610612765,Detroit Pistons,0,0,1610612764,Washington Wizards,1,1,32,26,58,10,18,28,42,44,86,14,7,21,12,36,22,6,9,93,108
2019,2,21900776,2/7/2020,1610612757,Portland Trail Blazers,0,0,1610612762,Utah Jazz,1,1,27,30,57,17,23,40,44,53,97,9,5,14,12,43,14,6,9,99,114
2021,2,22100794,2/4/2022,1610612740,New Orleans Pelicans,0,1,1610612743,Denver Nuggets,1,0,34,16,50,8,17,25,42,33,75,21,2,23,9,24,27,9,15,94,113
2014,2,21400250,12/1/2014,1610612764,Washington Wizards,1,1,1610612748,Miami Heat,0,0,29,24,53,10,9,19,39,33,72,19,5,24,9,26,29,5,14,89,107
2021,2,22101150,3/31/2022,1610612747,Los Angeles Lakers,0,0,1610612762,Utah Jazz,1,1,34,24,58,7,18,25,41,42,83,20,8,28,11,33,18,7,11,94,109
2021,2,22101150,3/31/2022,1610612762,Utah Jazz,1,1,1610612747,Los Angeles Lakers,0,0,31,15,46,15,29,44,46,44,90,15,9,24,16,33,25,5,8,95,122
2014,2,21400249,12/1/2014,1610612755,Philadelphia 76ers,1,0,1610612759,San Antonio Spurs,0,1,26,34,60,12,17,29,38,51,89,15,10,25,13,44,22,6,12,101,103
2021,2,22100794,2/4/2022,1610612743,Denver Nuggets,1,0,1610612740,New Orleans Pelicans,0,1,16,21,37,19,22,41,35,43,78,16,1,17,8,35,22,8,15,93,105
2014,2,21400249,12/1/2014,1610612759,San Antonio Spurs,0,1,1610612755,Philadelphia 76ers,1,0,27,30,57,9,17,26,36,47,83,28,7,35,13,35,25,9,15,101,109
2022,2,22200657,1/16/2023,1610612749,Milwaukee Bucks,1,1,1610612754,Indiana Pacers,0,0,25,20,45,23,23,46,48,43,91,13,2,15,12,33,32,6,14,101,132
2016,2,21600388,12/15/2016,1610612744,Golden State Warriors,1,1,1610612752,New York Knicks,0,0,36,28,64,9,23,32,45,51,96,4,4,8,18,35,41,10,17,99,103
2021,2,22101149,3/31/2022,1610612741,Chicago Bulls,1,1,1610612746,LA Clippers,0,0,40,33,73,10,19,29,50,52,102,25,7,32,17,38,24,7,8,108,135
2021,2,22101149,3/31/2022,1610612746,LA Clippers,0,0,1610612741,Chicago Bulls,1,1,29,25,54,16,20,36,45,45,90,24,2,26,7,38,26,6,12,108,130
2016,2,21600388,12/15/2016,1610612752,New York Knicks,0,0,1610612744,Golden State Warriors,1,1,33,39,72,5,16,21,38,55,93,9,10,19,15,45,19,7,13,100,90
2023,2,22300535,1/12/2024,1610612748,Miami Heat,1,1,1610612753,Orlando Magic,0,0,29,28,57,8,18,26,37,46,83,17,3,20,17,31,23,10,17,90,99
2023,2,22300069,10/25/2023,1610612750,Minnesota Timberwolves,0,0,1610612761,Toronto Raptors,1,1,26,43,69,8,23,31,34,66,100,18,4,22,25,43,20,9,14,101,94
2019,2,21900776,2/7/2020,1610612762,Utah Jazz,1,1,1610612757,Portland Trail Blazers,0,0,35,26,61,10,20,30,45,46,91,17,7,24,17,33,21,9,15,100,117
2023,2,22300067,10/25/2023,1610612739,Cleveland Cavaliers,0,1,1610612751,Brooklyn Nets,1,0,27,24,51,17,26,43,44,50,94,9,1,10,10,41,25,6,10,98,114
2017,2,21700602,1/9/2018,1610612747,Los Angeles Lakers,1,1,1610612758,Sacramento Kings,0,0,25,17,42,12,23,35,37,40,77,13,8,21,13,34,30,15,26,100,99
2017,2,21700602,1/9/2018,1610612758,Sacramento Kings,0,0,1610612747,Los Angeles Lakers,1,1,22,44,66,8,13,21,30,57,87,18,9,27,15,47,15,12,16,98,86
2021,2,22100793,2/4/2022,1610612751,Brooklyn Nets,0,0,1610612762,Utah Jazz,1,1,29,36,65,12,22,34,41,58,99,8,3,11,18,42,25,7,10,96,102
2021,2,22100793,2/4/2022,1610612762,Utah Jazz,1,1,1610612751,Brooklyn Nets,0,0,31,16,47,17,21,38,48,37,85,12,2,14,12,27,33,10,18,96,125
2021,2,22101148,3/31/2022,1610612749,Milwaukee Bucks,0,1,1610612751,Brooklyn Nets,1,0,28,20,48,12,29,41,40,49,89,28,6,34,16,37,17,12,23,111,120
2021,2,22101148,3/31/2022,1610612751,Brooklyn Nets,1,0,1610612749,Milwaukee Bucks,0,1,27,33,60,18,19,37,45,52,97,11,5,16,7,47,31,12,16,113,119
2020,2,22000483,2/23/2021,1610612752,New York Knicks,1,0,1610612744,Golden State Warriors,0,1,27,41,68,11,18,29,38,59,97,19,3,22,24,36,22,9,15,100,106
2017,2,21700601,1/9/2018,1610612742,Dallas Mavericks,1,1,1610612753,Orlando Magic,0,0,34,23,57,9,17,26,43,40,83,19,3,22,7,36,27,2,4,90,114
2017,2,21700601,1/9/2018,1610612753,Orlando Magic,0,0,1610612742,Dallas Mavericks,1,1,25,25,50,11,18,29,36,43,79,16,6,22,11,34,27,6,13,89,99
2021,2,22100792,2/4/2022,1610612745,Houston Rockets,0,0,1610612759,San Antonio Spurs,1,1,25,25,50,11,22,33,36,47,83,23,6,29,16,34,15,14,19,101,106
2021,2,22100792,2/4/2022,1610612759,San Antonio Spurs,1,1,1610612745,Houston Rockets,0,0,38,23,61,13,15,28,51,38,89,16,4,20,12,29,33,9,13,99,131
2019,2,21900833,2/21/2020,1610612747,Los Angeles Lakers,1,1,1610612763,Memphis Grizzlies,0,0,32,25,57,9,20,29,41,45,86,26,14,40,17,37,25,9,15,104,117
2014,2,21400564,1/12/2015,1610612745,Houston Rockets,0,1,1610612751,Brooklyn Nets,1,0,25,21,46,16,24,40,41,45,86,15,5,20,13,33,22,7,14,95,113
2021,2,22101147,3/31/2022,1610612755,Philadelphia 76ers,0,0,1610612765,Detroit Pistons,1,1,24,19,43,7,19,26,31,38,69,25,3,28,5,34,22,11,15,90,94
2021,2,22101147,3/31/2022,1610612765,Detroit Pistons,1,1,1610612755,Philadelphia 76ers,0,0,31,16,47,10,25,35,41,41,82,10,5,15,10,35,26,8,10,92,102
2014,2,21400564,1/12/2015,1610612751,Brooklyn Nets,1,0,1610612745,Houston Rockets,0,1,34,29,63,5,16,21,39,45,84,16,2,18,14,31,18,9,16,95,99
2023,2,22301219,12/8/2023,1610612764,Washington Wizards,0,0,1610612751,Brooklyn Nets,1,1,32,26,58,6,27,33,38,53,91,15,6,21,17,39,19,8,16,101,97
2014,2,21400248,11/30/2014,1610612747,Los Angeles Lakers,1,1,1610612761,Toronto Raptors,0,0,37,35,72,10,14,24,47,49,96,25,9,34,13,39,24,6,10,107,129
2014,2,21400248,11/30/2014,1610612761,Toronto Raptors,0,0,1610612747,Los Angeles Lakers,1,1,36,34,70,9,25,34,45,59,104,23,8,31,21,44,25,4,8,106,122
2017,2,21700600,1/9/2018,1610612757,Portland Trail Blazers,0,1,1610612760,Oklahoma City Thunder,1,0,33,25,58,10,13,23,43,38,81,21,5,26,13,28,19,6,16,97,117
2017,2,21700600,1/9/2018,1610612760,Oklahoma City Thunder,1,0,1610612757,Portland Trail Blazers,0,1,24,29,53,13,18,31,37,47,84,19,7,26,15,35,20,10,14,97,106
2014,2,21400563,1/12/2015,1610612738,Boston Celtics,1,1,1610612740,New Orleans Pelicans,0,0,29,35,64,8,16,24,37,51,88,26,5,31,20,32,24,7,11,94,108
2014,2,21400563,1/12/2015,1610612740,New Orleans Pelicans,0,0,1610612738,Boston Celtics,1,1,25,35,60,6,9,15,31,44,75,32,5,37,16,29,20,8,18,95,100
2023,2,22300069,10/25/2023,1610612761,Toronto Raptors,1,1,1610612750,Minnesota Timberwolves,0,0,22,33,55,14,21,35,36,54,90,11,5,16,12,46,27,8,14,99,97
2021,2,22100791,2/4/2022,1610612742,Dallas Mavericks,1,1,1610612755,Philadelphia 76ers,0,0,29,22,51,10,24,34,39,46,85,19,4,23,16,32,22,5,11,89,107
2021,2,22100791,2/4/2022,1610612755,Philadelphia 76ers,0,0,1610612742,Dallas Mavericks,1,1,27,16,43,9,18,27,36,34,70,17,6,23,7,30,23,8,14,88,98
2017,2,21700599,1/9/2018,1610612748,Miami Heat,0,1,1610612761,Toronto Raptors,1,0,35,40,75,4,18,22,39,58,97,8,2,10,24,35,18,7,14,93,90
2017,2,21700599,1/9/2018,1610612761,Toronto Raptors,1,0,1610612748,Miami Heat,0,1,28,41,69,7,14,21,35,55,90,12,3,15,11,46,15,2,5,93,89
2022,2,22200711,1/23/2023,1610612759,San Antonio Spurs,0,0,1610612757,Portland Trail Blazers,1,1,34,29,63,13,14,27,47,43,90,20,6,26,16,31,30,11,15,101,127
2020,2,22000765,4/5/2021,1610612750,Minnesota Timberwolves,1,1,1610612758,Sacramento Kings,0,0,26,33,59,12,20,32,38,53,91,28,5,33,20,35,22,9,14,102,116
2020,2,22000765,4/5/2021,1610612758,Sacramento Kings,0,0,1610612750,Minnesota Timberwolves,1,1,30,22,52,9,27,36,39,49,88,19,5,24,12,39,27,10,15,103,106
2023,2,22300009,11/10/2023,1610612766,Charlotte Hornets,0,1,1610612764,Washington Wizards,1,0,44,38,82,6,22,28,50,60,110,18,10,28,34,30,31,4,10,101,124
2023,2,22300023,11/14/2023,1610612757,Portland Trail Blazers,0,0,1610612762,Utah Jazz,1,1,26,27,53,11,24,35,37,51,88,14,6,20,16,37,23,11,17,101,99
2019,2,21900833,2/21/2020,1610612763,Memphis Grizzlies,0,0,1610612747,Los Angeles Lakers,1,1,37,40,77,5,10,15,42,50,92,16,15,31,18,39,22,9,17,103,105
2014,2,21400247,11/30/2014,1610612750,Minnesota Timberwolves,0,0,1610612757,Portland Trail Blazers,1,1,37,44,81,2,7,9,39,51,90,13,7,20,15,40,24,8,15,97,93
2016,2,21600925,3/4/2017,1610612750,Minnesota Timberwolves,0,0,1610612759,San Antonio Spurs,1,1,31,42,73,4,12,16,35,54,89,16,6,22,20,36,24,10,18,99,90
2014,2,21401102,3/30/2015,1610612747,Los Angeles Lakers,0,1,1610612755,Philadelphia 76ers,1,0,30,31,61,10,11,21,40,42,82,23,7,30,14,32,27,11,17,100,113
2014,2,21401102,3/30/2015,1610612755,Philadelphia 76ers,1,0,1610612747,Los Angeles Lakers,0,1,29,37,66,10,20,30,39,57,96,23,15,38,30,34,27,7,17,102,111
2016,2,21600925,3/4/2017,1610612759,San Antonio Spurs,1,1,1610612750,Minnesota Timberwolves,0,0,32,38,70,6,18,24,38,56,94,15,9,24,20,41,16,6,13,99,97
2022,2,22200656,1/16/2023,1610612738,Boston Celtics,0,1,1610612766,Charlotte Hornets,1,0,23,21,44,20,23,43,43,44,87,24,1,25,17,27,34,7,12,94,130
2014,2,21400562,1/11/2015,1610612747,Los Angeles Lakers,1,0,1610612757,Portland Trail Blazers,0,1,29,30,59,7,15,22,36,45,81,15,4,19,8,40,29,5,13,95,94
2014,2,21400562,1/11/2015,1610612757,Portland Trail Blazers,0,1,1610612747,Los Angeles Lakers,1,0,28,27,55,13,18,31,41,45,86,11,6,17,9,39,28,2,11,96,106
2019,2,21900884,2/28/2020,1610612756,Phoenix Suns,1,0,1610612765,Detroit Pistons,0,1,36,16,52,9,14,23,45,30,75,12,5,17,7,24,31,14,18,94,111
2023,2,22300023,11/14/2023,1610612762,Utah Jazz,1,1,1610612757,Portland Trail Blazers,0,0,31,21,52,13,30,43,44,51,95,14,1,15,17,34,26,5,13,98,115
2014,2,21400247,11/30/2014,1610612757,Portland Trail Blazers,1,1,1610612750,Minnesota Timberwolves,0,0,27,26,53,12,21,33,39,47,86,17,8,25,18,34,27,12,18,99,107
2017,2,21700598,1/8/2018,1610612737,Atlanta Hawks,0,0,1610612746,LA Clippers,1,1,28,31,59,10,27,37,38,58,96,21,8,29,24,37,20,10,14,103,107
2017,2,21700598,1/8/2018,1610612746,LA Clippers,1,1,1610612737,Atlanta Hawks,0,0,29,38,67,9,9,18,38,47,85,23,11,34,16,37,16,9,17,102,108
2021,2,22100790,2/4/2022,1610612737,Atlanta Hawks,0,0,1610612761,Toronto Raptors,1,1,34,30,64,9,20,29,43,50,93,19,2,21,14,38,27,7,9,97,114
2021,2,22100790,2/4/2022,1610612761,Toronto Raptors,1,1,1610612737,Atlanta Hawks,0,0,29,25,54,17,10,27,46,35,81,16,2,18,10,27,29,12,17,96,125
2021,2,22101146,3/30/2022,1610612740,New Orleans Pelicans,0,1,1610612757,Portland Trail Blazers,1,0,34,20,54,6,18,24,40,38,78,31,8,39,12,29,26,7,14,97,117
2021,2,22101146,3/30/2022,1610612757,Portland Trail Blazers,1,0,1610612740,New Orleans Pelicans,0,1,25,18,43,14,28,42,39,46,85,15,3,18,17,29,30,16,22,98,107
2014,2,21400561,1/11/2015,1610612739,Cleveland Cavaliers,0,0,1610612758,Sacramento Kings,1,1,22,24,46,11,21,32,33,45,78,7,5,12,7,41,18,8,14,90,84
2014,2,21400561,1/11/2015,1610612758,Sacramento Kings,1,1,1610612739,Cleveland Cavaliers,0,0,36,33,69,6,11,17,42,44,86,13,4,17,11,35,20,2,5,90,103
2019,2,21900884,2/28/2020,1610612765,Detroit Pistons,0,1,1610612756,Phoenix Suns,1,0,31,27,58,13,19,32,44,46,90,12,4,16,14,35,27,9,10,94,113
2022,2,22200657,1/16/2023,1610612754,Indiana Pacers,0,0,1610612749,Milwaukee Bucks,1,1,24,20,44,19,21,40,43,41,84,14,1,15,5,37,29,9,16,102,119
2019,2,21901317,8/14/2020,1610612746,LA Clippers,1,1,1610612760,Oklahoma City Thunder,0,0,22,26,48,12,25,37,34,51,85,27,12,39,15,43,23,5,23,112,107
2017,2,21700597,1/8/2018,1610612743,Denver Nuggets,0,0,1610612744,Golden State Warriors,1,1,39,37,76,8,11,19,47,48,95,12,4,16,18,33,30,7,11,96,114
2020,2,22000482,2/23/2021,1610612751,Brooklyn Nets,1,1,1610612758,Sacramento Kings,0,0,27,22,49,17,23,40,44,45,89,22,9,31,12,36,30,6,8,101,127
2017,2,21700597,1/8/2018,1610612744,Golden State Warriors,1,1,1610612743,Denver Nuggets,0,0,35,20,55,13,17,30,48,37,85,15,6,21,14,26,33,8,16,96,124
2020,2,22000482,2/23/2021,1610612758,Sacramento Kings,0,0,1610612751,Brooklyn Nets,1,1,30,26,56,15,16,31,45,42,87,13,6,19,11,33,25,8,15,101,118
2014,2,21400246,11/30/2014,1610612753,Orlando Magic,0,1,1610612756,Phoenix Suns,1,0,30,31,61,5,10,15,35,41,76,18,7,25,11,33,14,5,23,99,93
2014,2,21400246,11/30/2014,1610612756,Phoenix Suns,1,0,1610612753,Orlando Magic,0,1,27,32,59,7,19,26,34,51,85,15,3,18,16,37,22,8,19,99,90
2016,2,21600387,12/15/2016,1610612756,Phoenix Suns,1,0,1610612759,San Antonio Spurs,0,1,24,34,58,10,17,27,34,51,85,14,4,18,12,41,15,6,14,95,92
2016,2,21600387,12/15/2016,1610612759,San Antonio Spurs,0,1,1610612756,Phoenix Suns,1,0,34,24,58,5,11,16,39,35,74,24,2,26,12,24,19,9,20,93,107
2016,2,21600032,10/29/2016,1610612740,New Orleans Pelicans,0,0,1610612759,San Antonio Spurs,1,1,28,36,64,4,18,22,32,54,86,11,4,15,12,45,14,6,10,92,79
2019,2,21901317,8/14/2020,1610612760,Oklahoma City Thunder,0,0,1610612746,LA Clippers,1,1,24,38,62,14,30,44,38,68,106,13,9,22,20,51,18,10,16,115,103
2017,2,21700596,1/8/2018,1610612758,Sacramento Kings,1,0,1610612759,San Antonio Spurs,0,1,32,27,59,8,15,23,40,42,82,12,4,16,13,31,19,11,18,97,100
2017,2,21700596,1/8/2018,1610612759,San Antonio Spurs,0,1,1610612758,Sacramento Kings,1,0,33,31,64,11,15,26,44,46,90,8,5,13,10,38,23,6,10,95,107
2014,2,21400245,11/30/2014,1610612748,Miami Heat,0,1,1610612752,New York Knicks,1,0,23,26,49,7,16,23,30,42,72,19,12,31,15,32,20,6,15,89,86
2014,2,21400245,11/30/2014,1610612752,New York Knicks,1,0,1610612748,Miami Heat,0,1,28,36,64,3,21,24,31,57,88,14,6,20,24,35,14,8,14,88,79
2021,2,22100789,2/4/2022,1610612741,Chicago Bulls,0,1,1610612754,Indiana Pacers,1,0,43,21,64,6,20,26,49,41,90,18,5,23,13,30,30,3,9,99,122
2014,2,21400244,11/30/2014,1610612758,Sacramento Kings,1,0,1610612763,Memphis Grizzlies,0,1,32,27,59,1,10,11,33,37,70,18,9,27,16,26,16,13,23,91,85
2022,2,22200712,1/23/2023,1610612763,Memphis Grizzlies,0,0,1610612758,Sacramento Kings,1,1,28,34,62,12,24,36,40,58,98,8,2,10,14,45,28,10,15,103,100
2021,2,22100789,2/4/2022,1610612754,Indiana Pacers,1,0,1610612741,Chicago Bulls,0,1,35,33,68,12,15,27,47,48,95,9,0,9,13,35,25,5,13,97,115
2017,2,21700595,1/8/2018,1610612740,New Orleans Pelicans,1,1,1610612765,Detroit Pistons,0,0,40,20,60,6,16,22,46,36,82,14,7,21,10,28,31,5,17,101,112
2017,2,21700595,1/8/2018,1610612765,Detroit Pistons,0,0,1610612740,New Orleans Pelicans,1,1,33,33,66,8,19,27,41,52,93,19,3,22,16,37,22,7,12,102,109
2021,2,22101145,3/30/2022,1610612744,Golden State Warriors,1,0,1610612756,Phoenix Suns,0,1,22,23,45,13,25,38,35,48,83,20,5,25,13,38,26,9,21,105,103
2021,2,22101145,3/30/2022,1610612756,Phoenix Suns,0,1,1610612744,Golden State Warriors,1,0,31,33,64,7,21,28,38,54,92,24,6,30,17,39,20,7,14,105,107
2023,2,22300019,11/14/2023,1610612755,Philadelphia 76ers,1,0,1610612754,Indiana Pacers,0,1,37,27,64,6,16,22,43,43,86,34,1,35,10,34,22,7,16,108,126
2016,2,21600386,12/15/2016,1610612743,Denver Nuggets,1,1,1610612757,Portland Trail Blazers,0,0,28,25,53,15,16,31,43,41,84,31,4,35,13,30,27,6,15,103,132
2016,2,21600386,12/15/2016,1610612757,Portland Trail Blazers,0,0,1610612743,Denver Nuggets,1,1,33,32,65,8,15,23,41,47,88,30,6,36,16,33,22,10,14,102,120
2014,2,21400560,1/11/2015,1610612756,Phoenix Suns,0,0,1610612763,Memphis Grizzlies,1,1,34,31,65,8,27,35,42,58,100,18,5,23,14,47,20,7,21,119,110
2014,2,21400560,1/11/2015,1610612763,Memphis Grizzlies,1,1,1610612756,Phoenix Suns,0,0,39,40,79,9,12,21,48,52,100,17,7,24,17,37,24,14,24,120,122
2014,2,21400244,11/30/2014,1610612763,Memphis Grizzlies,0,1,1610612758,Sacramento Kings,1,0,35,31,66,3,10,13,38,41,79,18,10,28,12,34,25,7,13,91,97
2016,2,21600924,3/4/2017,1610612745,Houston Rockets,1,1,1610612763,Memphis Grizzlies,0,0,21,15,36,18,24,42,39,39,78,27,9,36,12,32,25,8,14,99,123
2020,2,22000003,12/23/2020,1610612738,Boston Celtics,1,1,1610612749,Milwaukee Bucks,0,0,30,31,61,18,22,40,48,53,101,8,3,11,13,42,23,4,7,99,122
2016,2,21600924,3/4/2017,1610612763,Memphis Grizzlies,0,0,1610612745,Houston Rockets,1,1,35,34,69,8,20,28,43,54,97,14,7,21,21,37,26,10,13,98,108
2016,2,21600032,10/29/2016,1610612759,San Antonio Spurs,1,1,1610612740,New Orleans Pelicans,0,0,25,34,59,10,14,24,35,48,83,18,5,23,11,41,21,6,10,92,98
2017,2,21700594,1/8/2018,1610612739,Cleveland Cavaliers,0,0,1610612750,Minnesota Timberwolves,1,1,24,22,46,13,25,38,37,47,84,12,4,16,9,41,26,6,14,94,99
2017,2,21700594,1/8/2018,1610612750,Minnesota Timberwolves,1,1,1610612739,Cleveland Cavaliers,0,0,42,27,69,10,21,31,52,48,100,13,4,17,19,30,30,0,5,95,127
2014,2,21401101,3/30/2015,1610612738,Boston Celtics,0,1,1610612766,Charlotte Hornets,1,0,36,27,63,9,17,26,45,44,89,17,6,23,16,31,28,3,7,89,116
2014,2,21401101,3/30/2015,1610612766,Charlotte Hornets,1,0,1610612738,Boston Celtics,0,1,33,26,59,7,19,26,40,45,85,17,2,19,14,30,20,7,11,90,104
2014,2,21400559,1/11/2015,1610612746,LA Clippers,1,0,1610612748,Miami Heat,0,1,25,24,49,9,17,26,34,41,75,13,5,18,8,36,17,8,13,89,90
2019,2,21900216,11/22/2019,1610612764,Washington Wizards,1,1,1610612766,Charlotte Hornets,0,0,34,23,57,14,20,34,48,43,91,15,5,20,7,40,34,9,11,105,125
2019,2,21900216,11/22/2019,1610612766,Charlotte Hornets,0,0,1610612764,Washington Wizards,1,1,34,25,59,14,20,34,48,45,93,8,0,8,9,36,24,10,16,104,118
2020,2,22000003,12/23/2020,1610612749,Milwaukee Bucks,0,0,1610612738,Boston Celtics,1,1,32,23,55,14,21,35,46,44,90,15,3,18,15,30,19,8,16,100,121
2023,2,22300071,10/25/2023,1610612763,Memphis Grizzlies,1,0,1610612740,New Orleans Pelicans,0,1,26,22,48,12,31,43,38,53,91,16,4,20,13,43,23,8,13,102,104
2022,2,22200755,1/29/2023,1610612749,Milwaukee Bucks,1,1,1610612740,New Orleans Pelicans,0,0,36,17,53,17,26,43,53,43,96,12,8,20,14,33,27,7,12,103,135
2021,2,22100788,2/4/2022,1610612738,Boston Celtics,0,1,1610612765,Detroit Pistons,1,0,28,26,54,9,19,28,37,45,82,19,6,25,11,37,23,5,14,96,102
2021,2,22100788,2/4/2022,1610612765,Detroit Pistons,1,0,1610612738,Boston Celtics,0,1,24,54,78,10,16,26,34,70,104,15,5,20,28,45,18,4,11,96,93
2021,2,22101144,3/30/2022,1610612759,San Antonio Spurs,1,0,1610612763,Memphis Grizzlies,0,1,28,20,48,14,21,35,42,41,83,13,3,16,11,32,26,8,15,97,111
2017,2,21700593,1/8/2018,1610612741,Chicago Bulls,1,0,1610612745,Houston Rockets,0,1,28,30,58,12,16,28,40,46,86,15,3,18,8,40,26,6,13,98,107
2017,2,21700593,1/8/2018,1610612745,Houston Rockets,0,1,1610612741,Chicago Bulls,1,0,19,13,32,20,34,54,39,47,86,18,6,24,15,35,28,6,17,98,116
2021,2,22101144,3/30/2022,1610612763,Memphis Grizzlies,0,1,1610612759,San Antonio Spurs,1,0,28,24,52,16,23,39,44,47,91,8,3,11,15,33,26,8,14,95,112
2016,2,21600923,3/4/2017,1610612743,Denver Nuggets,1,0,1610612766,Charlotte Hornets,0,1,27,23,50,9,21,30,36,44,80,21,4,25,13,32,21,8,13,90,102
2014,2,21400559,1/11/2015,1610612748,Miami Heat,0,1,1610612746,LA Clippers,1,0,33,27,60,6,15,21,39,42,81,20,4,24,17,25,28,4,13,88,104
2017,2,21700592,1/8/2018,1610612751,Brooklyn Nets,1,0,1610612761,Toronto Raptors,0,1,27,40,67,12,21,33,39,61,100,23,5,28,16,47,22,7,16,114,113
2014,2,21400243,11/30/2014,1610612744,Golden State Warriors,0,1,1610612765,Detroit Pistons,1,0,28,30,58,9,12,21,37,42,79,21,6,27,13,31,24,11,16,97,104
2014,2,21400243,11/30/2014,1610612765,Detroit Pistons,1,0,1610612744,Golden State Warriors,0,1,22,46,68,11,12,23,33,58,91,16,8,24,18,44,25,5,13,96,93
2022,2,22201114,3/26/2023,1610612741,Chicago Bulls,0,1,1610612747,Los Angeles Lakers,1,0,33,23,56,14,17,31,47,40,87,10,3,13,11,31,32,5,9,94,118
2023,2,22300678,1/31/2024,1610612748,Miami Heat,1,1,1610612758,Sacramento Kings,0,0,29,27,56,13,15,28,42,42,84,18,5,23,9,35,38,6,10,95,115
2021,2,22101143,3/30/2022,1610612737,Atlanta Hawks,0,1,1610612760,Oklahoma City Thunder,1,0,31,21,52,18,21,39,49,42,91,20,2,22,9,35,28,5,13,106,136
2021,2,22101143,3/30/2022,1610612760,Oklahoma City Thunder,1,0,1610612737,Atlanta Hawks,0,1,24,22,46,17,24,41,41,46,87,19,8,27,11,39,31,10,18,105,118
2014,2,21400558,1/11/2015,1610612737,Atlanta Hawks,1,1,1610612764,Washington Wizards,0,0,26,32,58,16,15,31,42,47,89,20,4,24,17,31,34,5,9,92,120
2014,2,21400558,1/11/2015,1610612764,Washington Wizards,0,0,1610612737,Atlanta Hawks,1,1,31,25,56,5,15,20,36,40,76,12,3,15,11,30,25,14,20,93,89
2017,2,21700592,1/8/2018,1610612761,Toronto Raptors,0,1,1610612751,Brooklyn Nets,1,0,33,34,67,10,24,34,43,58,101,18,5,23,12,48,19,8,15,113,114
2016,2,21600923,3/4/2017,1610612766,Charlotte Hornets,0,1,1610612743,Denver Nuggets,1,0,25,38,63,16,11,27,41,49,90,14,3,17,16,34,25,5,6,90,112
2014,2,21400242,11/30/2014,1610612741,Chicago Bulls,0,1,1610612751,Brooklyn Nets,1,0,27,18,45,7,17,24,34,35,69,27,7,34,8,30,19,9,20,98,102
2020,2,22000452,2/19/2021,1610612763,Memphis Grizzlies,1,1,1610612765,Detroit Pistons,0,0,37,33,70,5,15,20,42,48,90,20,3,23,16,34,20,8,13,98,109
2016,2,21600385,12/15/2016,1610612740,New Orleans Pelicans,1,1,1610612754,Indiana Pacers,0,0,26,32,58,10,17,27,36,49,85,20,8,28,13,41,23,6,16,100,102
2016,2,21600385,12/15/2016,1610612754,Indiana Pacers,0,0,1610612740,New Orleans Pelicans,1,1,33,33,66,3,18,21,36,51,87,20,4,24,9,45,23,7,12,101,95
2021,2,22101142,3/30/2022,1610612745,Houston Rockets,1,0,1610612758,Sacramento Kings,0,1,30,22,52,13,29,42,43,51,94,19,6,25,20,36,23,7,18,105,118
2021,2,22101142,3/30/2022,1610612758,Sacramento Kings,0,1,1610612745,Houston Rockets,1,0,37,32,69,7,19,26,44,51,95,26,10,36,15,40,21,7,9,104,121
2023,2,22300008,11/10/2023,1610612765,Detroit Pistons,1,0,1610612755,Philadelphia 76ers,0,1,32,26,58,8,20,28,40,46,86,18,4,22,15,35,28,13,17,99,106
2014,2,21400242,11/30/2014,1610612751,Brooklyn Nets,1,0,1610612741,Chicago Bulls,0,1,30,42,72,2,12,14,32,54,86,18,6,24,10,46,16,6,10,99,84
2022,2,22200755,1/29/2023,1610612740,New Orleans Pelicans,0,0,1610612749,Milwaukee Bucks,1,1,28,31,59,13,21,34,41,52,93,15,6,21,11,45,25,7,12,104,110
2020,2,22000452,2/19/2021,1610612765,Detroit Pistons,0,0,1610612763,Memphis Grizzlies,1,1,22,19,41,14,31,45,36,50,86,9,4,13,16,37,27,12,21,97,95
2022,2,22201114,3/26/2023,1610612747,Los Angeles Lakers,1,0,1610612741,Chicago Bulls,0,1,25,14,39,13,23,36,38,37,75,19,9,28,9,34,24,8,18,94,108
2021,2,22101141,3/30/2022,1610612750,Minnesota Timberwolves,0,0,1610612761,Toronto Raptors,1,1,26,29,55,11,26,37,37,55,92,17,6,23,20,37,26,9,22,105,102
2021,2,22101141,3/30/2022,1610612761,Toronto Raptors,1,1,1610612750,Minnesota Timberwolves,0,0,30,30,60,18,18,36,48,48,96,11,4,15,16,35,32,11,19,106,125
2014,2,21400241,11/30/2014,1610612738,Boston Celtics,1,0,1610612759,San Antonio Spurs,0,1,30,39,69,6,12,18,36,51,87,11,4,15,15,38,21,9,15,94,89
2020,2,22000481,2/23/2021,1610612753,Orlando Magic,1,0,1610612765,Detroit Pistons,0,1,19,31,50,14,24,38,33,55,88,13,9,22,12,45,25,10,12,100,93
2014,2,21400241,11/30/2014,1610612759,San Antonio Spurs,0,1,1610612738,Boston Celtics,1,0,30,29,59,11,15,26,41,44,85,18,2,20,15,31,25,5,14,95,111
2014,2,21401100,3/29/2015,1610612756,Phoenix Suns,1,0,1610612760,Oklahoma City Thunder,0,1,32,28,60,5,17,22,37,45,82,18,6,24,8,38,23,9,18,103,97
2020,2,22000546,3/3/2021,1610612745,Houston Rockets,1,0,1610612751,Brooklyn Nets,0,1,20,28,48,18,25,43,38,53,91,20,8,28,12,44,24,5,9,100,114
2014,2,21401100,3/29/2015,1610612760,Oklahoma City Thunder,0,1,1610612756,Phoenix Suns,1,0,30,30,60,10,16,26,40,46,86,19,7,26,11,37,16,9,16,102,109
2014,2,21400557,1/10/2015,1610612753,Orlando Magic,0,0,1610612757,Portland Trail Blazers,1,1,34,37,71,3,18,21,37,55,92,15,5,20,19,39,22,6,16,99,92
2014,2,21400557,1/10/2015,1610612757,Portland Trail Blazers,1,1,1610612753,Orlando Magic,0,0,26,24,50,10,16,26,36,40,76,21,5,26,10,32,22,10,20,100,103
2021,2,22101140,3/30/2022,1610612752,New York Knicks,1,0,1610612766,Charlotte Hornets,0,1,24,17,41,16,28,44,40,45,85,18,8,26,13,34,23,7,14,97,114
2021,2,22101140,3/30/2022,1610612766,Charlotte Hornets,0,1,1610612752,New York Knicks,1,0,37,18,55,12,23,35,49,41,90,15,2,17,10,32,39,5,12,99,125
2014,2,21400240,11/29/2014,1610612745,Houston Rockets,0,1,1610612749,Milwaukee Bucks,1,0,29,20,49,15,23,38,44,43,87,14,2,16,17,28,26,7,13,91,117
2020,2,22000546,3/3/2021,1610612751,Brooklyn Nets,0,1,1610612745,Houston Rockets,1,0,32,18,50,17,18,35,49,36,85,17,7,24,11,27,33,10,15,99,132
2021,2,22100787,2/4/2022,1610612739,Cleveland Cavaliers,0,1,1610612766,Charlotte Hornets,1,0,22,33,55,14,21,35,36,54,90,16,4,20,17,40,26,9,12,97,102
2017,2,21700591,1/8/2018,1610612749,Milwaukee Bucks,0,0,1610612754,Indiana Pacers,1,1,27,20,47,7,20,27,34,40,74,20,6,26,8,34,18,9,18,98,95
2017,2,21700591,1/8/2018,1610612754,Indiana Pacers,1,1,1610612749,Milwaukee Bucks,0,0,37,20,57,7,15,22,44,35,79,14,6,20,8,30,30,11,16,97,109
2021,2,22101139,3/30/2022,1610612738,Boston Celtics,1,0,1610612748,Miami Heat,0,1,24,24,48,11,26,37,35,50,85,17,6,23,11,42,27,9,18,101,98
2021,2,22101139,3/30/2022,1610612748,Miami Heat,0,1,1610612738,Boston Celtics,1,0,25,20,45,13,21,34,38,41,79,17,8,25,8,39,27,9,18,101,106
2023,2,22300071,10/25/2023,1610612740,New Orleans Pelicans,0,1,1610612763,Memphis Grizzlies,1,0,26,27,53,14,18,32,40,45,85,17,5,22,13,33,22,8,21,102,111
2014,2,21400240,11/29/2014,1610612749,Milwaukee Bucks,1,0,1610612745,Houston Rockets,0,1,27,28,55,6,13,19,33,41,74,31,4,35,12,33,23,7,11,92,103
2014,2,21401099,3/29/2015,1610612742,Dallas Mavericks,0,0,1610612754,Indiana Pacers,1,1,34,41,75,6,9,15,40,50,90,13,6,19,12,42,20,6,12,98,99
2014,2,21401099,3/29/2015,1610612754,Indiana Pacers,1,1,1610612742,Dallas Mavericks,0,0,28,31,59,10,7,17,38,38,76,18,8,26,5,36,23,5,15,98,104
2023,2,22300766,2/12/2024,1610612763,Memphis Grizzlies,1,0,1610612740,New Orleans Pelicans,0,1,22,15,37,12,32,44,34,47,81,7,1,8,8,39,28,12,18,95,87
2017,2,21700590,1/7/2018,1610612737,Atlanta Hawks,0,0,1610612747,Los Angeles Lakers,1,1,29,31,60,12,22,34,41,53,94,19,4,23,14,43,22,13,15,106,113
2017,2,21700590,1/7/2018,1610612747,Los Angeles Lakers,1,1,1610612737,Atlanta Hawks,0,0,32,18,50,16,20,36,48,38,86,20,5,25,10,30,32,5,18,107,132
2014,2,21400556,1/10/2015,1610612750,Minnesota Timberwolves,1,0,1610612759,San Antonio Spurs,0,1,29,37,66,3,12,15,32,49,81,26,0,26,9,40,17,9,13,97,93
2014,2,21400556,1/10/2015,1610612759,San Antonio Spurs,0,1,1610612750,Minnesota Timberwolves,1,0,32,28,60,9,15,24,41,43,84,17,3,20,10,36,21,7,12,96,108
2022,2,22200761,1/30/2023,1610612765,Detroit Pistons,0,0,1610612742,Dallas Mavericks,1,1,22,18,40,14,25,39,36,43,79,19,8,27,13,33,18,6,14,93,105
2021,2,22100787,2/4/2022,1610612766,Charlotte Hornets,1,0,1610612739,Cleveland Cavaliers,0,1,24,25,49,14,29,43,38,54,92,11,1,12,16,38,27,7,14,95,101
2020,2,22000481,2/23/2021,1610612765,Detroit Pistons,0,1,1610612753,Orlando Magic,1,0,31,23,54,10,24,34,41,47,88,13,3,16,11,38,24,9,15,99,105
2017,2,21700589,1/7/2018,1610612757,Portland Trail Blazers,1,1,1610612759,San Antonio Spurs,0,0,40,29,69,8,15,23,48,44,92,7,3,10,12,34,19,4,9,93,111
2017,2,21700589,1/7/2018,1610612759,San Antonio Spurs,0,0,1610612757,Portland Trail Blazers,1,1,29,29,58,11,12,23,40,41,81,19,7,26,15,30,26,7,14,92,110
2016,2,21600922,3/4/2017,1610612741,Chicago Bulls,1,0,1610612746,LA Clippers,0,1,29,37,66,6,11,17,35,48,83,15,5,20,18,30,26,7,19,94,91
2016,2,21600922,3/4/2017,1610612746,LA Clippers,0,1,1610612741,Chicago Bulls,1,0,35,25,60,6,19,25,41,44,85,13,3,16,13,32,20,11,14,93,101
2020,2,22000764,4/5/2021,1610612742,Dallas Mavericks,1,1,1610612762,Utah Jazz,0,0,18,24,42,23,26,49,41,50,91,6,2,8,15,36,22,3,10,90,111
2020,2,22000764,4/5/2021,1610612762,Utah Jazz,0,0,1610612742,Dallas Mavericks,1,1,25,19,44,12,32,44,37,51,88,17,5,22,17,36,20,2,9,89,103
2016,2,21600031,10/29/2016,1610612749,Milwaukee Bucks,1,1,1610612751,Brooklyn Nets,0,0,33,33,66,8,14,22,41,47,88,20,4,24,13,37,25,12,14,102,110
2016,2,21600031,10/29/2016,1610612751,Brooklyn Nets,0,0,1610612749,Milwaukee Bucks,1,1,26,24,50,11,23,34,37,47,84,23,5,28,12,36,23,14,18,101,108
2014,2,21400239,11/29/2014,1610612746,LA Clippers,0,1,1610612762,Utah Jazz,1,0,34,18,52,11,17,28,45,35,80,11,4,15,10,27,21,6,11,87,112
2014,2,21400239,11/29/2014,1610612762,Utah Jazz,1,0,1610612746,LA Clippers,0,1,27,27,54,7,14,21,34,41,75,21,12,33,15,30,19,6,13,88,96
2017,2,21700588,1/7/2018,1610612756,Phoenix Suns,1,1,1610612760,Oklahoma City Thunder,0,0,22,27,49,17,22,39,39,49,88,19,4,23,15,36,24,7,9,94,114
2021,2,22100786,2/3/2022,1610612746,LA Clippers,1,1,1610612747,Los Angeles Lakers,0,0,33,26,59,13,17,30,46,43,89,6,5,11,10,36,29,6,10,93,111
2017,2,21700588,1/7/2018,1610612760,Oklahoma City Thunder,0,0,1610612756,Phoenix Suns,1,1,32,27,59,8,19,27,40,46,86,12,9,21,14,35,23,6,12,94,100
2020,2,22000650,3/21/2021,1610612752,New York Knicks,1,0,1610612755,Philadelphia 76ers,0,1,27,37,64,11,13,24,38,50,88,13,10,23,17,37,16,12,17,101,100
2014,2,21400555,1/10/2015,1610612745,Houston Rockets,1,1,1610612762,Utah Jazz,0,0,20,23,43,13,21,34,33,44,77,18,3,21,11,34,24,15,20,98,97
2014,2,21400555,1/10/2015,1610612762,Utah Jazz,0,0,1610612745,Houston Rockets,1,1,24,29,53,5,12,17,29,41,70,19,2,21,13,29,20,16,31,98,82
2014,2,21400238,11/29/2014,1610612739,Cleveland Cavaliers,1,1,1610612754,Indiana Pacers,0,0,34,28,62,7,9,16,41,37,78,20,12,32,10,35,20,2,10,91,109
2014,2,21400238,11/29/2014,1610612754,Indiana Pacers,0,0,1610612739,Cleveland Cavaliers,1,1,28,39,67,7,15,22,35,54,89,20,6,26,18,39,26,4,8,91,97
2021,2,22100786,2/3/2022,1610612747,Los Angeles Lakers,0,0,1610612746,LA Clippers,1,1,30,29,59,11,18,29,41,47,88,17,8,25,15,39,19,5,11,95,110
2021,2,22101138,3/30/2022,1610612753,Orlando Magic,0,0,1610612764,Washington Wizards,1,1,29,33,62,11,23,34,40,56,96,19,3,22,16,42,21,5,12,104,110
2021,2,22101138,3/30/2022,1610612764,Washington Wizards,1,1,1610612753,Orlando Magic,0,0,34,22,56,13,23,36,47,45,92,20,6,26,15,32,35,8,12,103,127
2017,2,21700587,1/7/2018,1610612742,Dallas Mavericks,1,0,1610612752,New York Knicks,0,1,29,39,68,6,18,24,35,57,92,20,4,24,10,50,22,4,7,97,96
2017,2,21700587,1/7/2018,1610612752,New York Knicks,0,1,1610612742,Dallas Mavericks,1,0,32,35,67,6,10,16,38,45,83,18,2,20,13,32,22,7,16,96,100
2020,2,22000650,3/21/2021,1610612755,Philadelphia 76ers,0,1,1610612752,New York Knicks,1,0,27,30,57,11,14,25,38,44,82,14,9,23,12,35,19,13,20,102,101
2014,2,21400237,11/29/2014,1610612737,Atlanta Hawks,1,1,1610612766,Charlotte Hornets,0,0,28,24,52,12,11,23,40,35,75,13,3,16,8,28,31,3,14,89,105
2021,2,22100785,2/3/2022,1610612744,Golden State Warriors,1,1,1610612758,Sacramento Kings,0,0,27,15,42,20,22,42,47,37,84,12,4,16,13,26,27,13,16,97,126
2021,2,22100785,2/3/2022,1610612758,Sacramento Kings,0,0,1610612744,Golden State Warriors,1,1,31,18,49,11,20,31,42,38,80,19,4,23,8,33,29,11,16,97,114
2016,2,21600384,12/15/2016,1610612741,Chicago Bulls,0,0,1610612749,Milwaukee Bucks,1,1,30,24,54,5,15,20,35,39,74,22,7,29,11,30,23,8,17,96,97
2016,2,21600384,12/15/2016,1610612749,Milwaukee Bucks,1,1,1610612741,Chicago Bulls,0,0,34,41,75,11,9,20,45,50,95,7,6,13,14,38,32,5,8,95,108
2021,2,22100784,2/1/2022,1610612748,Miami Heat,0,0,1610612761,Toronto Raptors,1,1,30,18,48,8,22,30,38,40,78,22,3,25,13,29,26,9,17,93,106
2021,2,22100784,2/1/2022,1610612761,Toronto Raptors,1,1,1610612748,Miami Heat,0,0,27,28,55,12,14,26,39,42,81,20,9,29,16,30,20,8,15,91,110
2021,2,22101137,3/30/2022,1610612743,Denver Nuggets,0,1,1610612754,Indiana Pacers,1,0,38,14,52,12,16,28,50,30,80,13,1,14,11,19,33,11,20,96,125
2021,2,22101137,3/30/2022,1610612754,Indiana Pacers,1,0,1610612743,Denver Nuggets,0,1,32,25,57,12,28,40,44,53,97,18,5,23,21,35,29,6,8,96,118
2020,2,22000480,2/23/2021,1610612737,Atlanta Hawks,0,0,1610612739,Cleveland Cavaliers,1,1,26,32,58,14,17,31,40,49,89,17,6,23,19,34,22,7,13,94,111
2020,2,22000480,2/23/2021,1610612739,Cleveland Cavaliers,1,1,1610612737,Atlanta Hawks,0,0,26,24,50,15,13,28,41,37,78,15,4,19,9,28,28,10,16,94,112
2017,2,21700586,1/7/2018,1610612748,Miami Heat,1,1,1610612762,Utah Jazz,0,0,31,23,54,9,20,29,40,43,83,14,6,20,10,37,21,6,8,92,103
2014,2,21400237,11/29/2014,1610612766,Charlotte Hornets,0,0,1610612737,Atlanta Hawks,1,1,24,41,65,5,18,23,29,59,88,12,4,16,19,40,20,8,12,90,75
2017,2,21700586,1/7/2018,1610612762,Utah Jazz,0,0,1610612748,Miami Heat,1,1,27,23,50,10,22,32,37,45,82,18,2,20,13,34,15,6,11,91,102
2016,2,21600921,3/4/2017,1610612739,Cleveland Cavaliers,0,0,1610612748,Miami Heat,1,1,24,22,46,11,16,27,35,38,73,11,7,18,9,34,20,6,16,88,92
2016,2,21600921,3/4/2017,1610612748,Miami Heat,1,1,1610612739,Cleveland Cavaliers,0,0,28,26,54,18,16,34,46,42,88,10,2,12,17,26,20,4,11,88,120
2016,2,21600383,12/14/2016,1610612738,Boston Celtics,0,0,1610612759,San Antonio Spurs,1,1,27,26,53,10,21,31,37,47,84,17,3,20,12,35,25,9,13,96,101
2020,2,22000695,3/27/2021,1610612749,Milwaukee Bucks,1,0,1610612752,New York Knicks,0,1,22,29,51,14,22,36,36,51,87,10,6,16,17,35,21,8,15,92,96
2023,2,22300070,10/25/2023,1610612760,Oklahoma City Thunder,0,1,1610612741,Chicago Bulls,1,0,26,17,43,19,20,39,45,37,82,15,3,18,8,30,30,10,16,100,124
2017,2,21700585,1/6/2018,1610612743,Denver Nuggets,0,0,1610612758,Sacramento Kings,1,1,22,20,42,13,21,34,35,41,76,15,6,21,12,33,20,16,26,101,98
2017,2,21700585,1/6/2018,1610612758,Sacramento Kings,1,1,1610612743,Denver Nuggets,0,0,33,36,69,9,16,25,42,52,94,13,4,17,11,42,21,2,9,101,106
2014,2,21400236,11/29/2014,1610612740,New Orleans Pelicans,0,0,1610612764,Washington Wizards,1,1,24,40,64,6,11,17,30,51,81,14,7,21,19,37,12,9,13,86,80
2021,2,22100783,2/3/2022,1610612737,Atlanta Hawks,1,1,1610612756,Phoenix Suns,0,0,24,20,44,20,20,40,44,40,84,16,6,22,9,34,25,11,15,101,124
2023,2,22300047,11/24/2023,1610612754,Indiana Pacers,1,1,1610612765,Detroit Pistons,0,0,33,31,64,16,22,38,49,53,102,22,2,24,24,31,24,6,9,99,136
2021,2,22100783,2/3/2022,1610612756,Phoenix Suns,0,0,1610612737,Atlanta Hawks,1,1,37,19,56,9,23,32,46,42,88,14,4,18,6,37,30,6,11,101,115
2023,2,22300767,2/12/2024,1610612749,Milwaukee Bucks,1,1,1610612743,Denver Nuggets,0,0,26,24,50,16,18,34,42,42,84,12,6,18,9,36,30,7,13,96,112
2023,2,22300397,12/23/2023,1610612760,Oklahoma City Thunder,1,0,1610612747,Los Angeles Lakers,0,1,33,21,54,13,28,41,46,49,95,15,4,19,14,37,24,7,9,98,120
2016,2,21600383,12/14/2016,1610612759,San Antonio Spurs,1,1,1610612738,Boston Celtics,0,0,36,22,58,8,14,22,44,36,80,12,2,14,8,29,33,12,16,94,108
2014,2,21400236,11/29/2014,1610612764,Washington Wizards,1,1,1610612740,New Orleans Pelicans,0,0,30,34,64,5,7,12,35,41,76,8,4,12,12,30,21,8,14,84,83
2017,2,21700584,1/6/2018,1610612740,New Orleans Pelicans,0,0,1610612750,Minnesota Timberwolves,1,1,27,22,49,6,23,29,33,45,78,26,2,28,11,35,20,10,16,97,98
2017,2,21700584,1/6/2018,1610612750,Minnesota Timberwolves,1,1,1610612740,New Orleans Pelicans,0,0,35,37,72,9,9,18,44,46,90,19,2,21,15,32,26,5,10,97,116
2020,2,22000695,3/27/2021,1610612752,New York Knicks,0,1,1610612749,Milwaukee Bucks,1,0,24,25,49,16,28,44,40,53,93,6,2,8,20,34,28,12,17,95,102
2021,2,22100782,2/3/2022,1610612750,Minnesota Timberwolves,0,1,1610612765,Detroit Pistons,1,0,29,24,53,15,19,34,44,43,87,25,3,28,11,33,29,3,14,103,128
2021,2,22100782,2/3/2022,1610612765,Detroit Pistons,1,0,1610612750,Minnesota Timberwolves,0,1,25,20,45,15,31,46,40,51,91,22,6,28,17,35,27,11,16,104,117
2021,2,22101136,3/30/2022,1610612739,Cleveland Cavaliers,1,0,1610612742,Dallas Mavericks,0,1,31,27,58,11,14,25,42,41,83,17,5,22,15,29,24,6,15,94,112
2021,2,22101136,3/30/2022,1610612742,Dallas Mavericks,0,1,1610612739,Cleveland Cavaliers,1,0,30,16,46,16,26,42,46,42,88,12,3,15,12,31,28,7,12,94,120
2023,2,22301227,12/8/2023,1610612752,New York Knicks,0,0,1610612738,Boston Celtics,1,1,29,22,51,15,22,37,44,44,88,20,7,27,17,28,28,8,14,97,123
2017,2,21700583,1/6/2018,1610612749,Milwaukee Bucks,0,1,1610612764,Washington Wizards,1,0,32,26,58,7,15,22,39,41,80,25,5,30,12,31,20,6,16,99,110
2017,2,21700583,1/6/2018,1610612764,Washington Wizards,1,0,1610612749,Milwaukee Bucks,0,1,29,28,57,8,13,21,37,41,78,21,8,29,7,37,25,11,14,97,103
2020,2,22000724,3/31/2021,1610612745,Houston Rockets,0,0,1610612751,Brooklyn Nets,1,1,26,12,38,13,27,40,39,39,78,17,7,24,8,33,22,6,13,94,108
2023,2,22300538,1/12/2024,1610612757,Portland Trail Blazers,0,0,1610612750,Minnesota Timberwolves,1,1,20,29,49,10,18,28,30,47,77,23,11,34,14,40,18,14,20,99,93
2020,2,22000479,2/22/2021,1610612747,Los Angeles Lakers,1,0,1610612764,Washington Wizards,0,1,34,26,60,15,29,44,49,55,104,11,6,17,15,45,29,9,20,114,124
2020,2,22000479,2/22/2021,1610612764,Washington Wizards,0,1,1610612747,Los Angeles Lakers,1,0,38,33,71,9,16,25,47,49,96,24,9,33,14,38,25,9,16,115,127
2021,2,22101135,3/29/2022,1610612746,LA Clippers,1,1,1610612762,Utah Jazz,0,0,26,21,47,15,21,36,41,42,83,24,4,28,13,30,21,5,11,93,121
2017,2,21700582,1/6/2018,1610612739,Cleveland Cavaliers,0,1,1610612753,Orlando Magic,1,0,32,28,60,15,19,34,47,47,94,22,9,31,19,34,25,5,18,108,131
2017,2,21700582,1/6/2018,1610612753,Orlando Magic,1,0,1610612739,Cleveland Cavaliers,0,1,35,26,61,14,23,37,49,49,98,13,7,20,19,34,29,11,20,108,125
2021,2,22101135,3/29/2022,1610612762,Utah Jazz,0,0,1610612746,LA Clippers,1,1,31,16,47,12,19,31,43,35,78,17,12,29,13,28,23,8,16,94,115
2014,2,21400235,11/29/2014,1610612742,Dallas Mavericks,0,1,1610612755,Philadelphia 76ers,1,0,32,27,59,8,22,30,40,49,89,22,8,30,18,34,28,10,12,98,110
2023,2,22300544,1/13/2024,1610612763,Memphis Grizzlies,1,0,1610612752,New York Knicks,0,1,27,22,49,9,29,38,36,51,87,13,2,15,10,41,27,11,12,97,94
2014,2,21400235,11/29/2014,1610612755,Philadelphia 76ers,1,0,1610612742,Dallas Mavericks,0,1,30,34,64,6,15,21,36,49,85,25,6,31,26,27,26,13,24,99,103
2014,2,21400554,1/10/2015,1610612741,Chicago Bulls,1,1,1610612749,Milwaukee Bucks,0,0,31,40,71,4,13,17,35,53,88,21,3,24,29,25,24,9,14,84,95
2014,2,21400554,1/10/2015,1610612749,Milwaukee Bucks,0,0,1610612741,Chicago Bulls,1,1,33,37,70,3,8,11,36,45,81,12,4,16,14,33,19,5,11,84,87
2023,2,22300050,11/24/2023,1610612758,Sacramento Kings,0,1,1610612750,Minnesota Timberwolves,1,0,32,33,65,17,18,35,49,51,100,9,2,11,18,35,25,6,13,99,124
2017,2,21700581,1/6/2018,1610612741,Chicago Bulls,0,0,1610612754,Indiana Pacers,1,1,20,28,48,10,22,32,30,50,80,16,4,20,13,39,15,9,16,95,86
2017,2,21700581,1/6/2018,1610612754,Indiana Pacers,1,1,1610612741,Chicago Bulls,0,0,33,22,55,15,16,31,48,38,86,14,4,18,14,27,24,4,13,94,125
2021,2,22100781,2/2/2022,1610612747,Los Angeles Lakers,1,1,1610612757,Portland Trail Blazers,0,0,22,26,48,11,19,30,33,45,78,22,11,33,13,39,25,11,17,97,99
2014,2,21400234,11/28/2014,1610612747,Los Angeles Lakers,1,0,1610612750,Minnesota Timberwolves,0,1,40,28,68,8,13,21,48,41,89,15,7,22,17,26,27,8,14,99,119
2020,2,22000724,3/31/2021,1610612751,Brooklyn Nets,1,1,1610612745,Houston Rockets,0,0,31,23,54,13,23,36,44,46,90,19,0,19,17,29,25,5,12,94,120
2021,2,22101134,3/29/2022,1610612742,Dallas Mavericks,1,1,1610612747,Los Angeles Lakers,0,0,25,16,41,20,26,46,45,42,87,18,5,23,11,34,27,7,8,94,128
2021,2,22101134,3/29/2022,1610612747,Los Angeles Lakers,0,0,1610612742,Dallas Mavericks,1,1,28,17,45,12,32,44,40,49,89,18,4,22,15,37,20,5,9,94,110
2017,2,21700580,1/6/2018,1610612745,Houston Rockets,0,0,1610612765,Detroit Pistons,1,1,23,20,43,15,32,47,38,52,90,10,1,11,17,35,29,8,15,93,101
2021,2,22100781,2/2/2022,1610612757,Portland Trail Blazers,0,0,1610612747,Los Angeles Lakers,1,1,21,35,56,14,28,42,35,63,98,10,9,19,22,45,23,8,13,98,94
2014,2,21400234,11/28/2014,1610612750,Minnesota Timberwolves,0,1,1610612747,Los Angeles Lakers,1,0,35,26,61,10,8,18,45,34,79,20,4,24,10,25,37,12,19,97,120
2017,2,21700580,1/6/2018,1610612765,Detroit Pistons,1,1,1610612745,Houston Rockets,0,0,26,24,50,12,13,25,38,37,75,20,7,27,9,30,21,5,13,93,108
2021,2,22101133,3/29/2022,1610612751,Brooklyn Nets,1,1,1610612765,Detroit Pistons,0,0,27,21,48,15,13,28,42,34,76,31,3,34,10,25,24,11,19,101,130
2021,2,22101133,3/29/2022,1610612765,Detroit Pistons,0,0,1610612751,Brooklyn Nets,1,1,32,29,61,16,22,38,48,51,99,11,2,13,16,36,28,9,14,102,123
2016,2,21600920,3/4/2017,1610612749,Milwaukee Bucks,1,1,1610612761,Toronto Raptors,0,0,32,28,60,6,21,27,38,49,87,19,4,23,14,36,16,2,6,89,101
2016,2,21600920,3/4/2017,1610612761,Toronto Raptors,0,0,1610612749,Milwaukee Bucks,1,1,28,26,54,7,14,21,35,40,75,17,3,20,7,33,20,3,12,90,94
2017,2,21700579,1/6/2018,1610612738,Boston Celtics,0,1,1610612751,Brooklyn Nets,1,0,32,48,80,5,13,18,37,61,98,8,7,15,18,46,12,2,5,94,87
2017,2,21700579,1/6/2018,1610612751,Brooklyn Nets,1,0,1610612738,Boston Celtics,0,1,24,36,60,6,25,31,30,61,91,19,3,22,28,34,11,8,18,94,85
2021,2,22100780,2/2/2022,1610612751,Brooklyn Nets,0,0,1610612758,Sacramento Kings,1,1,33,26,59,8,17,25,41,43,84,11,3,14,10,34,22,8,13,94,101
2021,2,22100780,2/2/2022,1610612758,Sacramento Kings,1,1,1610612751,Brooklyn Nets,0,0,27,24,51,14,28,42,41,52,93,16,2,18,22,30,23,7,14,94,112
2014,2,21400233,11/28/2014,1610612757,Portland Trail Blazers,1,0,1610612763,Memphis Grizzlies,0,1,31,38,69,8,20,28,39,58,97,13,5,18,18,41,22,7,8,95,99
2021,2,22101132,3/29/2022,1610612741,Chicago Bulls,0,1,1610612764,Washington Wizards,1,0,37,30,67,6,12,18,43,42,85,15,3,18,10,33,26,6,9,92,107
2021,2,22101132,3/29/2022,1610612764,Washington Wizards,1,0,1610612741,Chicago Bulls,0,1,32,21,53,6,20,26,38,41,79,12,5,17,11,33,25,9,14,92,94
2017,2,21700578,1/6/2018,1610612744,Golden State Warriors,0,1,1610612746,LA Clippers,1,0,26,29,55,13,26,39,39,55,94,30,7,37,23,37,31,10,17,105,121
2017,2,21700578,1/6/2018,1610612746,LA Clippers,1,0,1610612744,Golden State Warriors,0,1,36,44,80,3,8,11,39,52,91,24,6,30,15,42,19,13,18,106,105
2023,2,22300239,11/25/2023,1610612760,Oklahoma City Thunder,1,0,1610612755,Philadelphia 76ers,0,1,27,28,55,16,27,43,43,55,98,21,5,26,18,38,29,2,4,97,123
2023,2,22300479,1/5/2024,1610612738,Boston Celtics,1,1,1610612762,Utah Jazz,0,0,22,19,41,17,32,49,39,51,90,31,5,36,12,42,24,11,14,109,126
2020,2,22000478,2/22/2021,1610612762,Utah Jazz,1,1,1610612766,Charlotte Hornets,0,0,17,13,30,28,27,55,45,40,85,14,3,17,11,30,34,13,23,107,132
2020,2,22000478,2/22/2021,1610612766,Charlotte Hornets,0,0,1610612762,Utah Jazz,1,1,30,23,53,11,25,36,41,48,89,17,4,21,10,41,18,7,16,106,110
2021,2,22101131,3/29/2022,1610612749,Milwaukee Bucks,0,1,1610612755,Philadelphia 76ers,1,0,30,20,50,14,24,38,44,44,88,16,7,23,12,37,26,7,11,96,118
2021,2,22101131,3/29/2022,1610612755,Philadelphia 76ers,1,0,1610612749,Milwaukee Bucks,0,1,27,21,48,16,25,41,43,46,89,14,4,18,10,39,28,5,9,97,116
2023,2,22300054,11/28/2023,1610612751,Brooklyn Nets,1,1,1610612761,Toronto Raptors,0,0,27,24,51,13,25,38,40,49,89,22,4,26,18,33,26,11,15,98,115
2014,2,21401098,3/29/2015,1610612759,San Antonio Spurs,1,1,1610612763,Memphis Grizzlies,0,0,38,28,66,4,13,17,42,41,83,15,3,18,11,32,25,5,10,90,103
2014,2,21401098,3/29/2015,1610612763,Memphis Grizzlies,0,0,1610612759,San Antonio Spurs,1,1,30,38,68,6,8,14,36,46,82,11,1,12,6,41,22,9,10,91,89
2014,2,21400553,1/10/2015,1610612738,Boston Celtics,0,0,1610612761,Toronto Raptors,1,1,33,32,65,6,12,18,39,44,83,12,8,20,14,33,23,8,18,96,96
2014,2,21400553,1/10/2015,1610612761,Toronto Raptors,1,1,1610612738,Boston Celtics,0,0,28,33,61,13,17,30,41,50,91,14,5,19,17,35,23,7,13,96,109
2017,2,21700577,1/5/2018,1610612747,Los Angeles Lakers,1,0,1610612766,Charlotte Hornets,0,1,29,29,58,9,27,36,38,56,94,9,3,12,15,43,24,10,16,100,94
2017,2,21700577,1/5/2018,1610612766,Charlotte Hornets,0,1,1610612747,Los Angeles Lakers,1,0,30,36,66,12,21,33,42,57,99,12,4,16,22,36,26,7,15,100,108
2023,2,22300140,11/5/2023,1610612765,Detroit Pistons,1,0,1610612756,Phoenix Suns,0,1,35,29,64,8,15,23,43,44,87,12,2,14,11,34,25,8,16,97,106
2020,2,22001038,5/11/2021,1610612749,Milwaukee Bucks,1,1,1610612753,Orlando Magic,0,0,35,33,68,8,25,33,43,58,101,20,7,27,20,44,16,6,9,104,114
2021,2,22101130,3/28/2022,1610612757,Portland Trail Blazers,1,0,1610612760,Oklahoma City Thunder,0,1,31,31,62,20,30,50,51,61,112,9,4,13,24,39,28,7,11,107,131
2021,2,22101130,3/28/2022,1610612760,Oklahoma City Thunder,0,1,1610612757,Portland Trail Blazers,1,0,28,17,45,20,25,45,48,42,90,18,7,25,16,31,32,17,21,106,134
2014,2,21400552,1/10/2015,1610612754,Indiana Pacers,0,0,1610612755,Philadelphia 76ers,1,1,25,44,69,4,14,18,29,58,87,30,12,42,26,37,16,4,13,94,92
2014,2,21400552,1/10/2015,1610612755,Philadelphia 76ers,1,1,1610612754,Indiana Pacers,0,0,21,35,56,11,13,24,32,48,80,18,7,25,15,36,21,9,17,93,93
2014,2,21400233,11/28/2014,1610612763,Memphis Grizzlies,0,1,1610612757,Portland Trail Blazers,1,0,39,32,71,6,7,13,45,39,84,16,10,26,11,32,28,6,9,95,112
2020,2,22001038,5/11/2021,1610612753,Orlando Magic,0,0,1610612749,Milwaukee Bucks,1,1,29,35,64,10,20,30,39,55,94,14,6,20,12,46,18,10,12,104,102
2023,2,22300050,11/24/2023,1610612750,Minnesota Timberwolves,1,0,1610612758,Sacramento Kings,0,1,24,25,49,12,21,33,36,46,82,27,2,29,13,33,25,7,18,100,111
2021,2,22100779,2/2/2022,1610612743,Denver Nuggets,0,0,1610612762,Utah Jazz,1,1,31,20,51,11,17,28,42,37,79,9,3,12,7,31,24,8,14,91,104
2014,2,21400232,11/28/2014,1610612743,Denver Nuggets,1,1,1610612756,Phoenix Suns,0,0,33,34,67,8,13,21,41,47,88,32,4,36,22,26,20,4,18,100,122
2023,2,22301219,12/8/2023,1610612751,Brooklyn Nets,1,1,1610612764,Washington Wizards,0,0,40,31,71,10,23,33,50,54,104,14,4,18,22,34,27,4,11,100,124
2017,2,21700576,1/5/2018,1610612737,Atlanta Hawks,0,0,1610612757,Portland Trail Blazers,1,1,22,35,57,8,18,26,30,53,83,20,4,24,13,41,14,11,16,97,88
2017,2,21700576,1/5/2018,1610612757,Portland Trail Blazers,1,1,1610612737,Atlanta Hawks,0,0,30,20,50,13,17,30,43,37,80,11,3,14,9,31,30,7,18,96,110
2014,2,21400551,1/10/2015,1610612751,Brooklyn Nets,0,0,1610612765,Detroit Pistons,1,1,28,29,57,9,22,31,37,51,88,10,0,10,15,36,25,8,14,93,93
2014,2,21400551,1/10/2015,1610612765,Detroit Pistons,1,1,1610612751,Brooklyn Nets,0,0,23,24,47,11,22,33,34,46,80,19,7,26,10,40,27,6,11,92,98
2014,2,21400232,11/28/2014,1610612756,Phoenix Suns,0,0,1610612743,Denver Nuggets,1,1,25,37,62,8,15,23,33,52,85,23,6,29,12,43,14,10,15,101,97
2021,2,22100779,2/2/2022,1610612762,Utah Jazz,1,1,1610612743,Denver Nuggets,0,0,35,22,57,7,22,29,42,44,86,17,5,22,15,33,21,5,8,92,108
2021,2,22101129,3/28/2022,1610612744,Golden State Warriors,0,0,1610612763,Memphis Grizzlies,1,1,24,28,52,9,20,29,33,48,81,20,6,26,9,42,18,11,17,103,95
2021,2,22101129,3/28/2022,1610612763,Memphis Grizzlies,1,1,1610612744,Golden State Warriors,0,0,31,31,62,12,18,30,43,49,92,25,10,35,18,37,26,6,14,104,123
2020,2,22000477,2/22/2021,1610612756,Phoenix Suns,1,1,1610612757,Portland Trail Blazers,0,0,34,32,66,16,17,33,50,49,99,16,2,18,18,33,29,6,7,96,132
2020,2,22000477,2/22/2021,1610612757,Portland Trail Blazers,0,0,1610612756,Phoenix Suns,1,1,25,20,45,12,27,39,37,47,84,14,5,19,16,32,15,6,17,95,100
2017,2,21700575,1/5/2018,1610612763,Memphis Grizzlies,1,0,1610612764,Washington Wizards,0,1,25,31,56,10,20,30,35,51,86,20,6,26,16,39,20,7,16,100,100
2017,2,21700575,1/5/2018,1610612764,Washington Wizards,0,1,1610612763,Memphis Grizzlies,1,0,23,34,57,10,17,27,33,51,84,26,8,34,15,38,21,6,14,99,102
2023,2,22301210,12/6/2023,1610612759,San Antonio Spurs,0,0,1610612750,Minnesota Timberwolves,1,1,30,35,65,8,28,36,38,63,101,10,5,15,21,44,23,4,12,100,94
2014,2,21400550,1/10/2015,1610612742,Dallas Mavericks,0,0,1610612746,LA Clippers,1,1,26,30,56,12,18,30,38,48,86,12,5,17,11,39,29,8,11,95,100
2014,2,21400550,1/10/2015,1610612746,LA Clippers,1,1,1610612742,Dallas Mavericks,0,0,33,24,57,13,18,31,46,42,88,15,6,21,12,33,31,4,11,96,120
2020,2,22000763,4/5/2021,1610612761,Toronto Raptors,1,1,1610612764,Washington Wizards,0,0,37,24,61,7,26,33,44,50,94,8,3,11,9,43,22,7,13,102,103
2020,2,22000763,4/5/2021,1610612764,Washington Wizards,0,0,1610612761,Toronto Raptors,1,1,25,34,59,12,23,35,37,57,94,15,3,18,19,39,21,11,18,100,101
2021,2,22100072,10/29/2021,1610612751,Brooklyn Nets,1,1,1610612754,Indiana Pacers,0,0,28,22,50,6,20,26,34,42,76,31,10,41,11,38,20,10,19,100,105
2021,2,22100072,10/29/2021,1610612754,Indiana Pacers,0,0,1610612751,Brooklyn Nets,1,1,29,35,64,8,21,29,37,56,93,16,7,23,17,40,20,8,13,102,98
2022,2,22200737,1/27/2023,1610612763,Memphis Grizzlies,0,0,1610612750,Minnesota Timberwolves,1,1,30,30,60,8,25,33,38,55,93,16,3,19,20,37,22,12,21,103,100
2017,2,21700574,1/5/2018,1610612743,Denver Nuggets,1,1,1610612762,Utah Jazz,0,0,24,27,51,14,21,35,38,48,86,9,6,15,5,46,24,7,10,94,99
2017,2,21700574,1/5/2018,1610612762,Utah Jazz,0,0,1610612743,Denver Nuggets,1,1,26,25,51,12,21,33,38,46,84,3,3,6,10,38,26,9,17,96,91
2014,2,21401097,3/29/2015,1610612745,Houston Rockets,0,1,1610612764,Washington Wizards,1,0,25,26,51,9,20,29,34,46,80,22,11,33,19,34,18,14,20,97,99
2014,2,21401097,3/29/2015,1610612764,Washington Wizards,1,0,1610612745,Houston Rockets,0,1,25,35,60,4,11,15,29,46,75,29,8,37,12,38,17,12,17,97,91
2021,2,22100444,12/18/2021,1610612746,LA Clippers,0,0,1610612760,Oklahoma City Thunder,1,1,21,23,44,16,23,39,37,46,83,13,6,19,10,39,26,4,13,94,103
2020,2,22000476,2/22/2021,1610612742,Dallas Mavericks,1,1,1610612763,Memphis Grizzlies,0,0,20,19,39,15,26,41,35,45,80,17,9,26,9,40,17,7,16,100,102
2020,2,22000476,2/22/2021,1610612763,Memphis Grizzlies,0,0,1610612742,Dallas Mavericks,1,1,31,32,63,6,25,31,37,57,94,12,7,19,17,44,17,6,14,100,92
2021,2,22101128,3/28/2022,1610612745,Houston Rockets,1,0,1610612759,San Antonio Spurs,0,1,18,25,43,20,29,49,38,54,92,24,4,28,13,42,26,11,12,105,120
2017,2,21700573,1/5/2018,1610612756,Phoenix Suns,0,0,1610612759,San Antonio Spurs,1,1,28,25,53,7,23,30,35,48,83,12,6,18,11,41,22,15,23,103,89
2017,2,21700573,1/5/2018,1610612759,San Antonio Spurs,1,1,1610612756,Phoenix Suns,0,0,30,27,57,11,19,30,41,46,87,10,8,18,9,38,21,11,17,104,103
2021,2,22101128,3/28/2022,1610612759,San Antonio Spurs,0,1,1610612745,Houston Rockets,1,0,40,31,71,7,22,29,47,53,100,22,6,28,21,37,28,5,13,104,123
2014,2,21400549,1/10/2015,1610612752,New York Knicks,1,0,1610612766,Charlotte Hornets,0,1,25,31,56,8,21,29,33,52,85,8,1,9,7,45,17,8,13,96,82
2014,2,21400549,1/10/2015,1610612766,Charlotte Hornets,0,1,1610612752,New York Knicks,1,0,32,30,62,7,9,16,39,39,78,25,8,33,14,27,18,9,16,96,110
2022,2,22200516,12/28/2022,1610612756,Phoenix Suns,0,0,1610612764,Washington Wizards,1,1,26,30,56,13,18,31,39,48,87,11,5,16,16,35,25,7,11,91,102
2022,2,22200516,12/28/2022,1610612764,Washington Wizards,1,1,1610612756,Phoenix Suns,0,0,39,17,56,8,18,26,47,35,82,25,3,28,16,20,27,7,13,90,127
2022,2,22200535,12/30/2022,1610612743,Denver Nuggets,1,1,1610612748,Miami Heat,0,0,28,20,48,17,11,28,45,31,76,17,5,22,7,26,34,13,20,98,124
2022,2,22200535,12/30/2022,1610612748,Miami Heat,0,0,1610612743,Denver Nuggets,1,1,25,27,52,14,21,35,39,48,87,27,3,30,14,34,21,6,15,100,119
2014,2,21400231,11/28/2014,1610612758,Sacramento Kings,0,0,1610612759,San Antonio Spurs,1,1,32,33,65,6,4,10,38,37,75,22,4,26,10,30,22,8,15,94,104
2014,2,21400231,11/28/2014,1610612759,San Antonio Spurs,1,1,1610612758,Sacramento Kings,0,0,30,28,58,12,12,24,42,40,82,16,4,20,6,38,29,4,7,94,112
2017,2,21700572,1/5/2018,1610612741,Chicago Bulls,0,1,1610612742,Dallas Mavericks,1,0,30,20,50,14,14,28,44,34,78,25,6,31,10,28,25,11,19,101,127
2017,2,21700572,1/5/2018,1610612742,Dallas Mavericks,1,0,1610612741,Chicago Bulls,0,1,35,25,60,14,18,32,49,43,92,12,5,17,12,34,33,9,13,102,124
2016,2,21600382,12/14/2016,1610612760,Oklahoma City Thunder,0,0,1610612762,Utah Jazz,1,1,24,39,63,6,13,19,30,52,82,23,4,27,16,37,14,4,10,87,89
2023,2,22300011,11/10/2023,1610612745,Houston Rockets,1,1,1610612740,New Orleans Pelicans,0,0,26,27,53,10,25,35,36,52,88,22,6,28,14,42,20,6,9,96,104
2016,2,21600382,12/14/2016,1610612762,Utah Jazz,1,1,1610612760,Oklahoma City Thunder,0,0,29,20,49,13,10,23,42,30,72,12,3,15,6,25,22,4,14,86,109
2021,2,22101127,3/28/2022,1610612738,Boston Celtics,0,0,1610612761,Toronto Raptors,1,1,27,28,55,12,28,40,39,56,95,22,6,28,20,39,23,10,17,104,112
2021,2,22101127,3/28/2022,1610612761,Toronto Raptors,1,1,1610612738,Boston Celtics,0,0,36,31,67,10,29,39,46,60,106,13,5,18,20,43,16,5,10,105,115
2021,2,22100444,12/18/2021,1610612760,Oklahoma City Thunder,1,1,1610612746,LA Clippers,0,0,31,30,61,12,19,31,43,49,92,6,4,10,18,33,23,11,16,94,104
2023,2,22301205,12/6/2023,1610612739,Cleveland Cavaliers,1,1,1610612753,Orlando Magic,0,0,32,20,52,14,20,34,46,40,86,15,5,20,11,32,29,10,17,101,121
2021,2,22100778,2/2/2022,1610612742,Dallas Mavericks,1,0,1610612760,Oklahoma City Thunder,0,1,32,23,55,14,29,43,46,52,98,8,2,10,17,36,28,6,14,100,114
2021,2,22100778,2/2/2022,1610612760,Oklahoma City Thunder,0,1,1610612742,Dallas Mavericks,1,0,24,25,49,17,20,37,41,45,86,21,4,25,20,27,25,12,20,101,120
2014,2,21400230,11/28/2014,1610612753,Orlando Magic,0,0,1610612754,Indiana Pacers,1,1,24,28,52,7,11,18,31,39,70,14,2,16,2,39,16,7,18,93,83
2014,2,21400230,11/28/2014,1610612754,Indiana Pacers,1,1,1610612753,Orlando Magic,0,0,37,41,78,4,12,16,41,53,94,12,2,14,20,33,25,7,12,92,98
2021,2,22101126,3/28/2022,1610612741,Chicago Bulls,0,0,1610612752,New York Knicks,1,1,28,28,56,6,17,23,34,45,79,30,3,33,12,35,16,4,14,97,104
2021,2,22101126,3/28/2022,1610612752,New York Knicks,1,1,1610612741,Chicago Bulls,0,0,26,28,54,12,23,35,38,51,89,21,14,35,15,42,19,6,6,97,109
2017,2,21700571,1/5/2018,1610612749,Milwaukee Bucks,1,0,1610612761,Toronto Raptors,0,1,34,26,60,7,10,17,41,36,77,21,8,29,7,31,26,9,11,94,110
2017,2,21700571,1/5/2018,1610612761,Toronto Raptors,0,1,1610612749,Milwaukee Bucks,1,0,38,15,53,10,23,33,48,38,86,23,5,28,13,28,25,4,11,94,129
2023,2,22300208,11/19/2023,1610612755,Philadelphia 76ers,0,1,1610612751,Brooklyn Nets,1,0,28,31,59,16,19,35,44,50,94,17,1,18,11,40,32,2,5,95,121
2021,2,22100624,1/12/2022,1610612739,Cleveland Cavaliers,0,1,1610612762,Utah Jazz,1,0,32,19,51,11,19,30,43,38,81,14,3,17,10,29,28,7,15,95,111
2020,2,22000762,4/5/2021,1610612751,Brooklyn Nets,1,1,1610612752,New York Knicks,0,0,32,28,60,10,22,32,42,50,92,20,6,26,16,37,27,7,10,98,114
2020,2,22000762,4/5/2021,1610612752,New York Knicks,0,0,1610612751,Brooklyn Nets,1,1,26,31,57,14,15,29,40,46,86,18,4,22,10,37,24,6,12,100,112
2014,2,21400229,11/28/2014,1610612752,New York Knicks,0,0,1610612760,Oklahoma City Thunder,1,1,27,29,56,2,17,19,29,46,75,18,6,24,9,41,17,9,13,90,78
2023,2,22300049,11/24/2023,1610612749,Milwaukee Bucks,1,1,1610612764,Washington Wizards,0,0,39,22,61,9,22,31,48,44,92,26,7,33,12,37,28,3,9,104,131
2014,2,21401096,3/29/2015,1610612748,Miami Heat,1,1,1610612765,Detroit Pistons,0,0,32,32,64,7,11,18,39,43,82,24,5,29,20,25,20,5,11,89,109
2014,2,21401096,3/29/2015,1610612765,Detroit Pistons,0,0,1610612748,Miami Heat,1,1,32,26,58,8,17,25,40,43,83,14,8,22,15,34,24,4,11,89,102
2021,2,22101125,3/28/2022,1610612748,Miami Heat,1,1,1610612758,Sacramento Kings,0,0,30,20,50,19,21,40,49,41,90,6,0,6,14,27,30,6,16,95,123
2021,2,22101125,3/28/2022,1610612758,Sacramento Kings,0,0,1610612748,Miami Heat,1,1,25,21,46,12,23,35,37,44,81,14,4,18,8,39,21,7,14,96,100
2014,2,21400229,11/28/2014,1610612760,Oklahoma City Thunder,1,1,1610612752,New York Knicks,0,0,28,34,62,10,14,24,38,48,86,19,4,23,21,29,20,3,15,92,105
2016,2,21600030,10/29/2016,1610612741,Chicago Bulls,1,1,1610612754,Indiana Pacers,0,0,36,29,65,9,12,21,45,41,86,19,2,21,16,26,34,8,12,94,118
2021,2,22101124,3/28/2022,1610612737,Atlanta Hawks,0,1,1610612754,Indiana Pacers,1,0,30,21,51,17,18,35,47,39,86,21,5,26,17,22,32,7,15,98,132
2021,2,22101124,3/28/2022,1610612754,Indiana Pacers,1,0,1610612737,Atlanta Hawks,0,1,28,23,51,17,19,36,45,42,87,16,2,18,13,29,32,11,14,99,123
2019,2,21900215,11/22/2019,1610612737,Atlanta Hawks,0,0,1610612765,Detroit Pistons,1,1,28,23,51,10,27,37,38,50,88,17,0,17,17,33,26,13,20,97,103
2016,2,21600030,10/29/2016,1610612754,Indiana Pacers,0,0,1610612741,Chicago Bulls,1,1,36,34,70,7,11,18,43,45,88,8,1,9,11,35,34,8,13,94,101
2014,2,21400228,11/28/2014,1610612745,Houston Rockets,1,0,1610612746,LA Clippers,0,1,22,23,45,10,27,37,32,50,82,11,4,15,13,39,17,8,15,92,85
2022,2,22200679,1/19/2023,1610612738,Boston Celtics,1,1,1610612744,Golden State Warriors,0,0,30,37,67,13,28,41,43,65,108,22,8,30,24,43,21,10,17,116,121
2017,2,21700570,1/5/2018,1610612738,Boston Celtics,1,1,1610612750,Minnesota Timberwolves,0,0,32,26,58,6,30,36,38,56,94,9,4,13,22,37,24,6,11,90,91
2017,2,21700570,1/5/2018,1610612750,Minnesota Timberwolves,0,0,1610612738,Boston Celtics,1,1,21,32,53,7,16,23,28,48,76,21,7,28,12,40,15,6,12,90,84
2022,2,22200753,1/29/2023,1610612763,Memphis Grizzlies,1,1,1610612754,Indiana Pacers,0,0,34,18,52,9,28,37,43,46,89,17,5,22,19,28,29,4,9,91,112
2021,2,22101123,3/28/2022,1610612739,Cleveland Cavaliers,1,1,1610612753,Orlando Magic,0,0,24,18,42,13,28,41,37,46,83,20,3,23,10,38,26,6,15,101,107
2021,2,22101123,3/28/2022,1610612753,Orlando Magic,0,0,1610612739,Cleveland Cavaliers,1,1,32,18,50,10,27,37,42,45,87,7,6,13,11,36,31,11,17,99,101
2023,2,22301227,12/8/2023,1610612738,Boston Celtics,1,1,1610612752,New York Knicks,0,0,29,15,44,19,28,47,48,43,91,18,3,21,10,34,24,4,8,97,133
2023,2,22300176,11/11/2023,1610612744,Golden State Warriors,1,0,1610612739,Cleveland Cavaliers,0,1,24,28,52,13,25,38,37,53,90,23,7,30,21,36,26,13,20,103,110
2014,2,21400228,11/28/2014,1610612746,LA Clippers,0,1,1610612745,Houston Rockets,1,0,29,27,56,9,16,25,38,43,81,17,5,22,12,34,23,7,13,91,102
2017,2,21700569,1/5/2018,1610612755,Philadelphia 76ers,1,1,1610612765,Detroit Pistons,0,0,30,30,60,14,16,30,44,46,90,12,1,13,15,31,29,9,14,93,114
2017,2,21700569,1/5/2018,1610612765,Detroit Pistons,0,0,1610612755,Philadelphia 76ers,1,1,23,33,56,7,15,22,30,48,78,11,8,19,7,45,20,5,12,93,78
2022,2,22200233,11/18/2022,1610612744,Golden State Warriors,1,1,1610612752,New York Knicks,0,0,23,18,41,18,32,50,41,50,91,11,9,20,17,37,32,8,18,102,111
2022,2,22200233,11/18/2022,1610612752,New York Knicks,0,0,1610612744,Golden State Warriors,1,1,21,32,53,9,25,34,30,57,87,32,2,34,17,41,16,8,16,101,101
2021,2,22100777,2/2/2022,1610612739,Cleveland Cavaliers,0,0,1610612745,Houston Rockets,1,1,34,25,59,7,14,21,41,39,80,15,12,27,16,31,23,11,20,96,104
2016,2,21600919,3/4/2017,1610612755,Philadelphia 76ers,1,0,1610612765,Detroit Pistons,0,1,29,25,54,14,20,34,43,45,88,6,1,7,12,34,30,11,20,99,106
2021,2,22101122,3/28/2022,1610612743,Denver Nuggets,0,1,1610612766,Charlotte Hornets,1,0,28,25,53,12,21,33,40,46,86,21,7,28,17,32,29,11,16,99,113
2016,2,21600919,3/4/2017,1610612765,Detroit Pistons,0,1,1610612755,Philadelphia 76ers,1,0,44,28,72,10,13,23,54,41,95,18,3,21,12,30,26,5,8,101,136
2021,2,22101122,3/28/2022,1610612766,Charlotte Hornets,1,0,1610612743,Denver Nuggets,0,1,31,20,51,13,29,42,44,49,93,8,4,12,15,36,33,7,15,101,109
2014,2,21400548,1/9/2015,1610612747,Los Angeles Lakers,1,1,1610612753,Orlando Magic,0,0,29,40,69,7,14,21,36,54,90,22,9,31,22,36,16,8,14,97,101
2014,2,21400548,1/9/2015,1610612753,Orlando Magic,0,0,1610612747,Los Angeles Lakers,1,1,24,38,62,6,8,14,30,46,76,18,5,23,5,44,19,8,16,98,84
2022,2,22200232,11/18/2022,1610612756,Phoenix Suns,0,0,1610612762,Utah Jazz,1,1,40,24,64,9,21,30,49,45,94,26,2,28,18,28,29,6,14,104,133
2017,2,21700568,1/5/2018,1610612748,Miami Heat,1,1,1610612752,New York Knicks,0,0,26,26,52,12,30,42,38,56,94,19,1,20,21,36,24,11,15,99,107
2017,2,21700568,1/5/2018,1610612752,New York Knicks,0,0,1610612748,Miami Heat,1,1,34,33,67,5,8,13,39,41,80,20,3,23,11,31,14,10,19,100,103
2022,2,22200232,11/18/2022,1610612762,Utah Jazz,1,1,1610612756,Phoenix Suns,0,0,35,25,60,16,15,31,51,40,91,16,8,24,14,32,32,7,17,102,134
2021,2,22100777,2/2/2022,1610612745,Houston Rockets,1,1,1610612739,Cleveland Cavaliers,0,0,25,17,42,14,26,40,39,43,82,23,10,33,12,39,25,6,11,96,115
2022,2,22200734,1/26/2023,1610612742,Dallas Mavericks,0,1,1610612756,Phoenix Suns,1,0,20,23,43,13,21,34,33,44,77,20,8,28,11,38,20,4,9,88,99
2021,2,22100624,1/12/2022,1610612762,Utah Jazz,1,0,1610612739,Cleveland Cavaliers,0,1,18,20,38,16,31,47,34,51,85,7,4,11,5,47,11,6,7,92,91
2022,2,22200762,1/30/2023,1610612756,Phoenix Suns,1,1,1610612761,Toronto Raptors,0,0,32,27,59,11,17,28,43,44,87,17,4,21,16,29,28,9,12,93,114
2023,2,22300242,11/25/2023,1610612747,Los Angeles Lakers,0,1,1610612739,Cleveland Cavaliers,1,0,38,25,63,9,18,27,47,43,90,18,3,21,12,33,34,13,18,106,121
2023,2,22300207,11/18/2023,1610612744,Golden State Warriors,1,0,1610612760,Oklahoma City Thunder,0,1,26,25,51,18,28,46,44,53,97,17,4,21,15,39,33,8,16,108,123
2022,2,22200231,11/18/2022,1610612738,Boston Celtics,0,1,1610612740,New Orleans Pelicans,1,0,21,18,39,20,26,46,41,44,85,15,2,17,13,32,28,13,17,97,117
2022,2,22200231,11/18/2022,1610612740,New Orleans Pelicans,1,0,1610612738,Boston Celtics,0,1,30,22,52,13,22,35,43,44,87,10,3,13,8,37,24,6,13,98,109
2021,2,22100776,2/2/2022,1610612752,New York Knicks,1,0,1610612763,Memphis Grizzlies,0,1,26,26,52,12,24,36,38,50,88,20,6,26,13,40,23,11,15,101,108
2021,2,22101121,3/27/2022,1610612742,Dallas Mavericks,1,1,1610612762,Utah Jazz,0,0,23,20,43,17,17,34,40,37,77,17,7,24,11,31,21,5,10,86,114
2021,2,22101121,3/27/2022,1610612762,Utah Jazz,0,0,1610612742,Dallas Mavericks,1,1,29,26,55,12,22,34,41,48,89,6,4,10,12,39,23,3,6,87,100
2021,2,22100776,2/2/2022,1610612763,Memphis Grizzlies,0,1,1610612752,New York Knicks,1,0,28,35,63,16,23,39,44,58,102,16,7,23,22,37,30,5,11,103,120
2020,2,22000475,2/22/2021,1610612748,Miami Heat,0,1,1610612760,Oklahoma City Thunder,1,0,21,20,41,15,25,40,36,45,81,21,4,25,13,35,30,6,13,92,108
2014,2,21401095,3/29/2015,1610612738,Boston Celtics,1,0,1610612746,LA Clippers,0,1,31,31,62,8,23,31,39,54,93,20,3,23,14,40,29,5,10,102,106
2020,2,22000475,2/22/2021,1610612760,Oklahoma City Thunder,1,0,1610612748,Miami Heat,0,1,18,17,35,14,25,39,32,42,74,16,3,19,8,36,20,7,18,94,94
2014,2,21401095,3/29/2015,1610612746,LA Clippers,0,1,1610612738,Boston Celtics,1,0,28,24,52,13,19,32,41,43,84,24,16,40,17,34,28,8,12,100,119
2014,2,21400547,1/9/2015,1610612739,Cleveland Cavaliers,0,0,1610612744,Golden State Warriors,1,1,28,35,63,7,16,23,35,51,86,17,6,23,17,39,13,9,16,97,94
2014,2,21400547,1/9/2015,1610612744,Golden State Warriors,1,1,1610612739,Cleveland Cavaliers,0,0,33,23,56,10,20,30,43,43,86,16,1,17,11,33,35,8,13,97,112
2014,2,21400227,11/28/2014,1610612742,Dallas Mavericks,0,1,1610612761,Toronto Raptors,1,0,29,31,60,11,15,26,40,46,86,15,7,22,8,42,27,7,8,97,106
2014,2,21400227,11/28/2014,1610612761,Toronto Raptors,1,0,1610612742,Dallas Mavericks,0,1,24,34,58,14,19,33,38,53,91,12,4,16,19,35,17,7,17,98,102
2017,2,21700567,1/4/2018,1610612746,LA Clippers,1,0,1610612760,Oklahoma City Thunder,0,1,36,34,70,9,21,30,45,55,100,18,5,23,23,36,29,4,10,98,117
2017,2,21700567,1/4/2018,1610612760,Oklahoma City Thunder,0,1,1610612746,LA Clippers,1,0,36,25,61,15,19,34,51,44,95,10,4,14,15,31,23,5,14,100,127
2022,2,22200230,11/18/2022,1610612742,Dallas Mavericks,1,1,1610612743,Denver Nuggets,0,0,33,12,45,13,19,32,46,31,77,22,6,28,6,26,29,4,10,92,127
2022,2,22200230,11/18/2022,1610612743,Denver Nuggets,0,0,1610612742,Dallas Mavericks,1,1,28,32,60,10,20,30,38,52,90,13,5,18,15,41,24,5,13,94,99
2021,2,22100775,2/2/2022,1610612738,Boston Celtics,1,1,1610612766,Charlotte Hornets,0,0,28,18,46,14,22,36,42,40,82,15,2,17,9,32,31,12,19,100,113
2021,2,22101120,3/27/2022,1610612751,Brooklyn Nets,1,0,1610612766,Charlotte Hornets,0,1,36,27,63,7,27,34,43,54,97,17,9,26,19,40,30,6,11,101,110
2021,2,22101120,3/27/2022,1610612766,Charlotte Hornets,0,1,1610612751,Brooklyn Nets,1,0,25,41,66,17,15,32,42,56,98,18,5,23,21,37,26,9,12,101,119
2023,2,22300140,11/5/2023,1610612756,Phoenix Suns,0,1,1610612765,Detroit Pistons,1,0,35,30,65,8,13,21,43,43,86,26,3,29,18,26,29,7,18,98,120
2017,2,21700566,1/4/2018,1610612744,Golden State Warriors,0,1,1610612745,Houston Rockets,1,0,35,22,57,13,17,30,48,39,87,15,5,20,8,34,35,7,13,102,124
2017,2,21700566,1/4/2018,1610612745,Houston Rockets,1,0,1610612744,Golden State Warriors,0,1,25,14,39,17,33,50,42,47,89,13,9,22,8,43,20,6,10,104,114
2023,2,22300207,11/18/2023,1610612760,Oklahoma City Thunder,0,1,1610612744,Golden State Warriors,1,0,44,33,77,8,15,23,52,48,100,18,2,20,12,37,26,6,12,110,130
2014,2,21400226,11/28/2014,1610612749,Milwaukee Bucks,0,1,1610612765,Detroit Pistons,1,0,26,22,48,13,16,29,39,38,77,13,3,16,12,28,30,8,19,91,104
2014,2,21400226,11/28/2014,1610612765,Detroit Pistons,1,0,1610612749,Milwaukee Bucks,0,1,28,32,60,6,17,23,34,49,83,14,11,25,19,35,25,9,14,91,88
2014,2,21400546,1/9/2015,1610612743,Denver Nuggets,0,1,1610612758,Sacramento Kings,1,0,42,26,68,5,12,17,47,38,85,19,9,28,13,30,27,5,11,95,118
2014,2,21400546,1/9/2015,1610612758,Sacramento Kings,1,0,1610612743,Denver Nuggets,0,1,36,31,67,6,13,19,42,44,86,18,6,24,16,30,19,10,15,97,108
2017,2,21700565,1/3/2018,1610612747,Los Angeles Lakers,1,0,1610612760,Oklahoma City Thunder,0,1,27,32,59,11,22,33,38,54,92,9,6,15,18,38,24,12,17,99,96
2021,2,22100775,2/2/2022,1610612766,Charlotte Hornets,0,0,1610612738,Boston Celtics,1,1,25,22,47,12,28,40,37,50,87,21,6,27,17,37,18,9,16,100,107
2017,2,21700565,1/3/2018,1610612760,Oklahoma City Thunder,0,1,1610612747,Los Angeles Lakers,1,0,42,21,63,14,16,30,56,37,93,7,2,9,9,29,36,5,9,97,133
2014,2,21400545,1/9/2015,1610612756,Phoenix Suns,0,0,1610612759,San Antonio Spurs,1,1,30,27,57,7,19,26,37,46,83,14,7,21,14,34,23,12,20,101,95
2014,2,21400545,1/9/2015,1610612759,San Antonio Spurs,1,1,1610612756,Phoenix Suns,0,0,27,39,66,11,12,23,38,51,89,13,5,18,12,41,28,10,15,101,100
2014,2,21400225,11/28/2014,1610612737,Atlanta Hawks,1,1,1610612740,New Orleans Pelicans,0,0,33,26,59,5,12,17,38,38,76,19,3,22,13,26,26,8,18,90,100
2014,2,21400225,11/28/2014,1610612740,New Orleans Pelicans,0,0,1610612737,Atlanta Hawks,1,1,29,36,65,7,17,24,36,53,89,12,4,16,18,36,23,6,12,91,91
2017,2,21700564,1/3/2018,1610612740,New Orleans Pelicans,0,1,1610612762,Utah Jazz,1,0,27,25,52,14,16,30,41,41,82,12,0,12,9,32,23,12,20,97,108
2017,2,21700564,1/3/2018,1610612762,Utah Jazz,1,0,1610612740,New Orleans Pelicans,0,1,31,21,52,7,25,32,38,46,84,15,2,17,10,37,23,8,14,99,98
2023,2,22300600,1/21/2024,1610612746,LA Clippers,1,1,1610612751,Brooklyn Nets,0,0,29,28,57,13,13,26,42,41,83,28,5,33,12,32,26,6,11,98,125
2021,2,22100774,2/2/2022,1610612755,Philadelphia 76ers,1,0,1610612764,Washington Wizards,0,1,30,34,64,11,16,27,41,50,91,10,3,13,12,39,23,1,4,89,103
2021,2,22100774,2/2/2022,1610612764,Washington Wizards,0,1,1610612755,Philadelphia 76ers,1,0,32,36,68,9,13,22,41,49,90,15,4,19,19,33,25,2,10,90,106
2014,2,21401094,3/29/2015,1610612740,New Orleans Pelicans,1,1,1610612750,Minnesota Timberwolves,0,0,37,25,62,6,7,13,43,32,75,18,6,24,8,28,29,5,14,91,110
2021,2,22101119,3/27/2022,1610612740,New Orleans Pelicans,1,1,1610612747,Los Angeles Lakers,0,0,35,29,64,9,18,27,44,47,91,19,5,24,16,33,25,5,7,95,116
2021,2,22101119,3/27/2022,1610612747,Los Angeles Lakers,0,0,1610612740,New Orleans Pelicans,1,1,28,17,45,14,21,35,42,38,80,10,6,16,8,32,26,10,15,93,108
2014,2,21401094,3/29/2015,1610612750,Minnesota Timberwolves,0,0,1610612740,New Orleans Pelicans,1,1,30,33,63,2,10,12,32,43,75,22,2,24,14,30,17,12,21,93,88
2017,2,21700563,1/3/2018,1610612743,Denver Nuggets,1,1,1610612756,Phoenix Suns,0,0,39,16,55,12,15,27,51,31,82,20,2,22,8,24,35,12,20,102,134
2017,2,21700563,1/3/2018,1610612756,Phoenix Suns,0,0,1610612743,Denver Nuggets,1,1,26,31,57,13,22,35,39,53,92,20,8,28,15,41,26,8,12,101,111
2022,2,22200229,11/18/2022,1610612760,Oklahoma City Thunder,0,0,1610612763,Memphis Grizzlies,1,1,34,28,62,11,23,34,45,51,96,9,2,11,11,42,34,4,11,101,110
2022,2,22200229,11/18/2022,1610612763,Memphis Grizzlies,1,1,1610612760,Oklahoma City Thunder,0,0,25,29,54,14,25,39,39,54,93,29,11,40,21,39,26,5,11,102,121
2021,2,22100773,2/2/2022,1610612753,Orlando Magic,0,1,1610612754,Indiana Pacers,1,0,31,29,60,11,24,35,42,53,95,24,2,26,11,43,29,7,12,107,119
2021,2,22100773,2/2/2022,1610612754,Indiana Pacers,1,0,1610612753,Orlando Magic,0,1,30,36,66,14,18,32,44,54,98,16,7,23,10,46,25,5,8,109,118
2021,2,22101118,3/27/2022,1610612755,Philadelphia 76ers,0,0,1610612756,Phoenix Suns,1,1,27,26,53,10,26,36,37,52,89,20,6,26,18,36,22,5,12,97,104
2021,2,22101118,3/27/2022,1610612756,Phoenix Suns,1,1,1610612755,Philadelphia 76ers,0,0,32,28,60,13,14,27,45,42,87,11,6,17,10,34,24,6,13,97,114
2021,2,22100748,1/29/2022,1610612748,Miami Heat,1,0,1610612761,Toronto Raptors,0,1,29,31,60,16,34,50,45,65,110,14,6,20,27,42,26,15,24,118,120
2021,2,22100772,2/1/2022,1610612751,Brooklyn Nets,0,0,1610612756,Phoenix Suns,1,1,24,17,41,16,24,40,40,41,81,15,6,21,9,33,25,8,12,94,111
2021,2,22100772,2/1/2022,1610612756,Phoenix Suns,1,1,1610612751,Brooklyn Nets,0,0,31,14,45,11,20,31,42,34,76,26,5,31,8,28,26,7,16,95,121
2017,2,21700562,1/3/2018,1610612742,Dallas Mavericks,1,0,1610612744,Golden State Warriors,0,1,24,23,47,19,24,43,43,47,90,17,5,22,10,39,29,8,13,105,122
2017,2,21700562,1/3/2018,1610612744,Golden State Warriors,0,1,1610612742,Dallas Mavericks,1,0,35,24,59,13,19,32,48,43,91,16,3,19,10,34,36,6,14,105,125
2022,2,22200564,1/4/2023,1610612763,Memphis Grizzlies,0,1,1610612766,Charlotte Hornets,1,0,38,26,64,9,21,30,47,47,94,28,9,37,16,35,28,11,14,107,131
2014,2,21400224,11/28/2014,1610612744,Golden State Warriors,0,1,1610612766,Charlotte Hornets,1,0,35,38,73,7,19,26,42,57,99,15,1,16,20,38,28,4,12,99,106
2014,2,21400224,11/28/2014,1610612766,Charlotte Hornets,1,0,1610612744,Golden State Warriors,0,1,32,36,68,6,13,19,38,49,87,19,4,23,14,36,27,7,14,100,101
2021,2,22101117,3/27/2022,1610612744,Golden State Warriors,0,0,1610612764,Washington Wizards,1,1,30,26,56,8,25,33,38,51,89,31,8,39,17,39,20,5,10,98,115
2021,2,22101117,3/27/2022,1610612764,Washington Wizards,1,1,1610612744,Golden State Warriors,0,0,28,28,56,16,12,28,44,40,84,19,3,22,7,34,33,8,12,98,123
2022,2,22200228,11/18/2022,1610612745,Houston Rockets,1,0,1610612754,Indiana Pacers,0,1,23,35,58,6,22,28,29,57,86,27,5,32,21,37,15,8,17,98,91
2022,2,22200228,11/18/2022,1610612754,Indiana Pacers,0,1,1610612745,Houston Rockets,1,0,21,20,41,12,29,41,33,49,82,21,6,27,14,38,25,8,15,98,99
2022,2,22200564,1/4/2023,1610612766,Charlotte Hornets,1,0,1610612763,Memphis Grizzlies,0,1,27,29,56,11,27,38,38,56,94,20,4,24,10,48,25,10,12,106,107
2016,2,21600918,3/3/2017,1610612738,Boston Celtics,0,1,1610612747,Los Angeles Lakers,1,0,33,18,51,10,23,33,43,41,84,19,6,25,11,33,30,11,18,101,115
2022,2,22200762,1/30/2023,1610612761,Toronto Raptors,0,0,1610612756,Phoenix Suns,1,1,31,25,56,9,24,33,40,49,89,17,2,19,19,32,19,10,14,93,106
2016,2,21600918,3/3/2017,1610612747,Los Angeles Lakers,1,0,1610612738,Boston Celtics,0,1,31,32,63,6,18,24,37,50,87,15,5,20,9,44,23,7,14,102,95
2021,2,22101116,3/27/2022,1610612738,Boston Celtics,1,1,1610612750,Minnesota Timberwolves,0,0,32,16,48,17,22,39,49,38,87,19,2,21,12,27,27,7,13,96,134
2021,2,22101116,3/27/2022,1610612750,Minnesota Timberwolves,0,0,1610612738,Boston Celtics,1,1,31,21,52,14,18,32,45,39,84,8,4,12,5,36,26,7,14,98,112
2017,2,21700561,1/3/2018,1610612749,Milwaukee Bucks,1,1,1610612754,Indiana Pacers,0,0,35,23,58,9,8,17,44,31,75,25,3,28,10,22,33,7,16,96,122
2017,2,21700561,1/3/2018,1610612754,Indiana Pacers,0,0,1610612749,Milwaukee Bucks,1,1,38,31,69,3,12,15,41,43,84,16,3,19,13,30,24,8,15,96,101
2022,2,22200227,11/18/2022,1610612741,Chicago Bulls,1,0,1610612753,Orlando Magic,0,1,36,32,68,5,16,21,41,48,89,20,5,25,15,35,27,4,11,96,107
2022,2,22200227,11/18/2022,1610612753,Orlando Magic,0,1,1610612741,Chicago Bulls,1,0,26,23,49,12,16,28,38,39,77,20,2,22,7,33,25,6,16,97,108
2021,2,22100771,2/1/2022,1610612744,Golden State Warriors,0,1,1610612759,San Antonio Spurs,1,0,23,27,50,20,26,46,43,53,96,18,0,18,22,31,30,7,16,99,124
2021,2,22100771,2/1/2022,1610612759,San Antonio Spurs,1,0,1610612744,Golden State Warriors,0,1,30,20,50,16,17,33,46,37,83,12,5,17,6,34,33,10,14,99,120
2021,2,22101115,3/27/2022,1610612752,New York Knicks,0,1,1610612765,Detroit Pistons,1,0,21,23,44,13,28,41,34,51,85,23,6,29,20,32,19,8,14,94,104
2021,2,22101115,3/27/2022,1610612765,Detroit Pistons,1,0,1610612752,New York Knicks,0,1,31,25,56,8,21,29,39,46,85,16,2,18,10,38,23,8,10,93,102
2014,2,21400223,11/28/2014,1610612738,Boston Celtics,1,0,1610612741,Chicago Bulls,0,1,31,39,70,6,16,22,37,55,92,22,7,29,19,40,20,5,13,100,102
2014,2,21400223,11/28/2014,1610612741,Chicago Bulls,0,1,1610612738,Boston Celtics,1,0,32,41,73,5,12,17,37,53,90,30,7,37,22,33,18,7,13,99,109
2019,2,21900215,11/22/2019,1610612765,Detroit Pistons,1,1,1610612737,Atlanta Hawks,0,0,32,16,48,17,17,34,49,33,82,13,7,20,14,24,30,12,19,98,128
2017,2,21700560,1/3/2018,1610612741,Chicago Bulls,1,0,1610612761,Toronto Raptors,0,1,30,30,60,13,20,33,43,50,93,16,3,19,11,42,29,9,13,102,115
2017,2,21700560,1/3/2018,1610612761,Toronto Raptors,0,1,1610612741,Chicago Bulls,1,0,30,24,54,15,23,38,45,47,92,19,0,19,10,37,23,5,11,101,124
2022,2,22200226,11/18/2022,1610612749,Milwaukee Bucks,0,0,1610612755,Philadelphia 76ers,1,1,29,25,54,12,24,36,41,49,90,8,13,21,12,41,22,5,13,100,102
2022,2,22200226,11/18/2022,1610612755,Philadelphia 76ers,1,1,1610612749,Milwaukee Bucks,0,0,27,23,50,13,15,28,40,38,78,17,9,26,7,36,28,8,18,101,110
2021,2,22100770,2/1/2022,1610612743,Denver Nuggets,0,0,1610612750,Minnesota Timberwolves,1,1,24,21,45,14,30,44,38,51,89,25,3,28,12,41,27,8,12,100,115
2021,2,22100748,1/29/2022,1610612761,Toronto Raptors,0,1,1610612748,Miami Heat,1,0,31,31,62,16,29,45,47,60,107,14,4,18,19,42,24,12,17,116,124
2023,2,22300047,11/24/2023,1610612765,Detroit Pistons,0,0,1610612754,Indiana Pacers,1,1,36,36,72,7,11,18,43,47,90,20,4,24,18,30,22,7,14,99,113
2016,2,21600381,12/14/2016,1610612742,Dallas Mavericks,1,0,1610612765,Detroit Pistons,0,1,24,29,53,8,17,25,32,46,78,13,3,16,7,41,19,4,12,90,85
2021,2,22101114,3/26/2022,1610612745,Houston Rockets,0,1,1610612757,Portland Trail Blazers,1,0,29,20,49,15,20,35,44,40,84,12,6,18,13,31,34,14,21,99,115
2021,2,22101114,3/26/2022,1610612757,Portland Trail Blazers,1,0,1610612745,Houston Rockets,0,1,25,28,53,12,28,40,37,56,93,12,5,17,26,32,21,12,23,97,98
2016,2,21600381,12/14/2016,1610612765,Detroit Pistons,0,1,1610612742,Dallas Mavericks,1,0,31,23,54,5,12,17,36,35,71,18,4,22,12,26,18,13,19,88,95
2014,2,21400544,1/9/2015,1610612749,Milwaukee Bucks,1,1,1610612750,Minnesota Timberwolves,0,0,27,29,56,12,7,19,39,36,75,8,2,10,11,27,30,13,23,90,98
2014,2,21400544,1/9/2015,1610612750,Minnesota Timberwolves,0,0,1610612749,Milwaukee Bucks,1,1,26,31,57,6,16,22,32,47,79,14,3,17,17,31,22,13,20,91,84
2014,2,21400222,11/26/2014,1610612747,Los Angeles Lakers,1,0,1610612763,Memphis Grizzlies,0,1,25,37,62,8,11,19,33,48,81,19,5,24,13,37,16,7,12,91,93
2014,2,21400222,11/26/2014,1610612763,Memphis Grizzlies,0,1,1610612747,Los Angeles Lakers,1,0,31,27,58,5,17,22,36,44,80,22,3,25,13,33,25,6,14,92,99
2022,2,22200225,11/18/2022,1610612739,Cleveland Cavaliers,1,1,1610612766,Charlotte Hornets,0,0,41,23,64,8,20,28,49,43,92,26,6,32,10,37,25,11,20,116,132
2022,2,22200225,11/18/2022,1610612766,Charlotte Hornets,0,0,1610612739,Cleveland Cavaliers,1,1,30,36,66,14,30,44,44,66,110,20,4,24,23,46,24,8,16,113,122
2017,2,21700559,1/3/2018,1610612738,Boston Celtics,1,1,1610612739,Cleveland Cavaliers,0,0,29,27,56,12,24,36,41,51,92,8,3,11,13,40,27,6,16,100,102
2017,2,21700559,1/3/2018,1610612739,Cleveland Cavaliers,0,0,1610612738,Boston Celtics,1,1,23,34,57,8,24,32,31,58,89,18,0,18,12,46,16,9,15,99,88
2014,2,21401093,3/29/2015,1610612747,Los Angeles Lakers,0,0,1610612751,Brooklyn Nets,1,1,36,37,73,6,12,18,42,49,91,9,2,11,13,37,25,11,11,96,99
2014,2,21401093,3/29/2015,1610612751,Brooklyn Nets,1,1,1610612747,Los Angeles Lakers,0,0,34,25,59,8,20,28,42,45,87,15,6,21,10,37,29,7,8,95,107
2014,2,21400221,11/26/2014,1610612743,Denver Nuggets,0,0,1610612756,Phoenix Suns,1,1,31,34,65,8,17,25,39,51,90,26,8,34,25,29,19,9,18,100,112
2014,2,21400221,11/26/2014,1610612756,Phoenix Suns,1,1,1610612743,Denver Nuggets,0,0,32,31,63,13,12,25,45,43,88,17,4,21,16,28,27,10,17,98,120
2022,2,22200224,11/18/2022,1610612748,Miami Heat,0,0,1610612764,Washington Wizards,1,1,24,31,55,11,32,43,35,63,98,25,7,32,17,49,23,6,10,107,106
2022,2,22200224,11/18/2022,1610612764,Washington Wizards,1,1,1610612748,Miami Heat,0,0,26,24,50,15,31,46,41,55,96,10,4,14,11,46,33,6,16,106,107
2022,2,22200734,1/26/2023,1610612756,Phoenix Suns,1,0,1610612742,Dallas Mavericks,0,1,22,32,54,13,19,32,35,51,86,12,4,16,16,36,24,3,9,88,95
2023,2,22300072,10/25/2023,1610612758,Sacramento Kings,0,1,1610612762,Utah Jazz,1,0,28,23,51,19,32,51,47,55,102,17,3,20,16,41,29,6,12,105,130
2023,2,22300048,11/24/2023,1610612743,Denver Nuggets,0,0,1610612745,Houston Rockets,1,1,25,39,64,7,23,30,32,62,94,15,6,21,20,46,17,9,15,97,86
2016,2,21600029,10/29/2016,1610612739,Cleveland Cavaliers,1,1,1610612753,Orlando Magic,0,0,25,26,51,11,26,37,36,52,88,22,8,30,14,42,17,6,9,95,105
2016,2,21600029,10/29/2016,1610612753,Orlando Magic,0,0,1610612739,Cleveland Cavaliers,1,1,30,26,56,8,20,28,38,46,84,15,11,26,21,31,21,8,21,94,99
2022,2,22200768,1/31/2023,1610612743,Denver Nuggets,1,1,1610612740,New Orleans Pelicans,0,0,27,24,51,16,20,36,43,44,87,20,4,24,16,32,33,13,18,101,122
2014,2,21400220,11/26/2014,1610612754,Indiana Pacers,0,0,1610612759,San Antonio Spurs,1,1,30,36,66,10,11,21,40,47,87,10,8,18,12,40,23,8,13,95,100
2014,2,21400220,11/26/2014,1610612759,San Antonio Spurs,1,1,1610612754,Indiana Pacers,0,0,36,23,59,5,10,15,41,33,74,19,10,29,9,30,21,9,15,95,106
2022,2,22200223,11/17/2022,1610612746,LA Clippers,1,1,1610612765,Detroit Pistons,0,0,22,29,51,11,19,30,33,48,81,19,5,24,15,35,17,9,18,96,96
2022,2,22200223,11/17/2022,1610612765,Detroit Pistons,0,0,1610612746,LA Clippers,1,1,27,30,57,6,25,31,33,55,88,19,5,24,15,44,15,1,13,96,91
2017,2,21700558,1/3/2018,1610612748,Miami Heat,1,1,1610612765,Detroit Pistons,0,0,26,24,50,17,17,34,43,41,84,8,3,11,9,32,29,4,12,92,111
2017,2,21700558,1/3/2018,1610612765,Detroit Pistons,0,0,1610612748,Miami Heat,1,1,32,30,62,9,15,24,41,45,86,13,3,16,9,37,21,6,9,93,104
2021,2,22100770,2/1/2022,1610612750,Minnesota Timberwolves,1,1,1610612743,Denver Nuggets,0,0,27,21,48,19,26,45,46,47,93,19,6,25,15,37,35,7,10,100,130
2021,2,22101113,3/26/2022,1610612743,Denver Nuggets,1,1,1610612760,Oklahoma City Thunder,0,0,33,21,54,8,23,31,41,44,85,23,1,24,11,33,33,8,15,100,113
2021,2,22101113,3/26/2022,1610612760,Oklahoma City Thunder,0,0,1610612743,Denver Nuggets,1,1,25,23,48,14,22,36,39,45,84,15,1,16,8,37,29,11,17,101,107
2014,2,21400543,1/9/2015,1610612741,Chicago Bulls,0,0,1610612764,Washington Wizards,1,1,22,35,57,10,16,26,32,51,83,12,7,19,15,40,16,9,16,93,86
2014,2,21400543,1/9/2015,1610612764,Washington Wizards,1,1,1610612741,Chicago Bulls,0,0,33,38,71,8,7,15,41,45,86,12,7,19,13,37,27,9,13,95,102
2017,2,21700557,1/3/2018,1610612750,Minnesota Timberwolves,0,0,1610612751,Brooklyn Nets,1,1,35,34,69,1,10,11,36,44,80,23,6,29,10,36,10,3,8,93,96
2017,2,21700557,1/3/2018,1610612751,Brooklyn Nets,1,1,1610612750,Minnesota Timberwolves,0,0,23,19,42,14,16,30,37,35,72,10,1,11,5,30,22,9,20,92,98
2020,2,22000474,2/22/2021,1610612741,Chicago Bulls,0,1,1610612745,Houston Rockets,1,0,34,21,55,15,21,36,49,42,91,7,3,10,9,36,24,7,12,98,120
2021,2,22101112,3/26/2022,1610612749,Milwaukee Bucks,0,0,1610612763,Memphis Grizzlies,1,1,30,31,61,7,25,32,37,56,93,21,5,26,18,40,19,10,14,99,102
2021,2,22101112,3/26/2022,1610612763,Memphis Grizzlies,1,1,1610612749,Milwaukee Bucks,0,0,36,29,65,13,24,37,49,53,102,16,7,23,20,36,30,4,8,99,127
2022,2,22200222,11/17/2022,1610612758,Sacramento Kings,1,1,1610612759,San Antonio Spurs,0,0,36,17,53,12,18,30,48,35,83,22,2,24,8,27,28,8,12,97,130
2022,2,22200222,11/17/2022,1610612759,San Antonio Spurs,0,0,1610612758,Sacramento Kings,1,1,35,23,58,11,15,26,46,38,84,9,3,12,9,31,29,7,19,99,112
2021,2,22100751,1/30/2022,1610612737,Atlanta Hawks,1,1,1610612747,Los Angeles Lakers,0,0,39,14,53,10,21,31,49,35,84,21,11,32,10,33,31,5,12,101,129
2016,2,21600917,3/3/2017,1610612740,New Orleans Pelicans,1,0,1610612759,San Antonio Spurs,0,1,27,39,66,8,17,25,35,56,91,20,4,24,14,45,20,6,17,107,98
2016,2,21600917,3/3/2017,1610612759,San Antonio Spurs,0,1,1610612740,New Orleans Pelicans,1,0,34,34,68,6,21,27,40,55,95,15,10,25,13,46,20,2,11,107,101
2014,2,21400219,11/26/2014,1610612760,Oklahoma City Thunder,1,1,1610612762,Utah Jazz,0,0,28,29,57,12,14,26,40,43,83,5,5,10,15,32,21,9,19,92,97
2014,2,21400219,11/26/2014,1610612762,Utah Jazz,0,0,1610612760,Oklahoma City Thunder,1,1,28,26,54,3,13,16,31,39,70,17,11,28,10,35,11,9,19,90,82
2017,2,21700556,1/3/2018,1610612752,New York Knicks,0,0,1610612764,Washington Wizards,1,1,34,33,67,7,12,19,41,45,86,14,4,18,10,37,19,9,14,97,103
2017,2,21700556,1/3/2018,1610612764,Washington Wizards,1,1,1610612752,New York Knicks,0,0,39,19,58,9,14,23,48,33,81,16,10,26,7,31,27,7,13,97,121
2021,2,22100769,2/1/2022,1610612741,Chicago Bulls,1,1,1610612753,Orlando Magic,0,0,35,25,60,11,19,30,46,44,90,23,6,29,14,34,25,7,10,100,126
2021,2,22100769,2/1/2022,1610612753,Orlando Magic,0,0,1610612741,Chicago Bulls,1,1,32,22,54,14,25,39,46,47,93,9,2,11,8,39,33,5,9,100,115
2021,2,22101111,3/26/2022,1610612748,Miami Heat,1,0,1610612751,Brooklyn Nets,0,1,23,18,41,10,24,34,33,42,75,19,7,26,12,33,20,15,24,100,95
2021,2,22101111,3/26/2022,1610612751,Brooklyn Nets,0,1,1610612748,Miami Heat,1,0,28,22,50,11,22,33,39,44,83,21,5,26,13,34,26,7,17,98,110
2020,2,22000474,2/22/2021,1610612745,Houston Rockets,1,0,1610612741,Chicago Bulls,0,1,24,32,56,13,27,40,37,59,96,13,6,19,14,49,20,5,9,99,100
2014,2,21400542,1/9/2015,1610612760,Oklahoma City Thunder,1,1,1610612762,Utah Jazz,0,0,35,35,70,7,14,21,42,49,91,8,1,9,14,36,25,12,14,95,99
2014,2,21400542,1/9/2015,1610612762,Utah Jazz,0,0,1610612760,Oklahoma City Thunder,1,1,29,24,53,7,14,21,36,38,74,15,7,22,10,32,22,12,20,94,94
2022,2,22200735,1/26/2023,1610612746,LA Clippers,1,1,1610612759,San Antonio Spurs,0,0,34,17,51,18,20,38,52,37,89,16,5,21,8,32,26,2,5,94,138
2014,2,21400218,11/26/2014,1610612749,Milwaukee Bucks,0,1,1610612750,Minnesota Timberwolves,1,0,35,34,69,5,11,16,40,45,85,18,1,19,16,29,22,11,19,97,103
2014,2,21400218,11/26/2014,1610612750,Minnesota Timberwolves,1,0,1610612749,Milwaukee Bucks,0,1,28,39,67,3,11,14,31,50,81,21,13,34,19,35,19,12,19,97,86
2022,2,22200221,11/17/2022,1610612751,Brooklyn Nets,0,1,1610612757,Portland Trail Blazers,1,0,29,21,50,11,18,29,40,39,79,18,5,23,8,31,32,9,17,99,109
2017,2,21700555,1/3/2018,1610612755,Philadelphia 76ers,1,1,1610612759,San Antonio Spurs,0,0,29,29,58,7,15,22,36,44,80,33,10,43,17,33,23,4,13,96,112
2017,2,21700555,1/3/2018,1610612759,San Antonio Spurs,0,0,1610612755,Philadelphia 76ers,1,1,31,31,62,8,17,25,39,48,87,20,3,23,16,34,15,10,16,97,106
2022,2,22200221,11/17/2022,1610612757,Portland Trail Blazers,1,0,1610612751,Brooklyn Nets,0,1,23,34,57,13,23,36,36,57,93,22,5,27,17,44,22,4,10,98,107
2014,2,21401092,3/29/2015,1610612739,Cleveland Cavaliers,1,1,1610612755,Philadelphia 76ers,0,0,24,38,62,9,14,23,33,52,85,12,6,18,20,35,17,11,17,93,87
2014,2,21401092,3/29/2015,1610612755,Philadelphia 76ers,0,0,1610612739,Cleveland Cavaliers,1,1,24,30,54,10,20,30,34,50,84,8,7,15,13,41,18,7,13,92,86
2014,2,21400541,1/9/2015,1610612740,New Orleans Pelicans,1,1,1610612763,Memphis Grizzlies,0,0,27,34,61,10,10,20,37,44,81,22,4,26,15,33,21,7,10,88,106
2014,2,21400541,1/9/2015,1610612763,Memphis Grizzlies,0,0,1610612740,New Orleans Pelicans,1,1,30,35,65,6,11,17,36,46,82,17,5,22,14,35,17,3,11,89,95
2017,2,21700554,1/3/2018,1610612745,Houston Rockets,0,1,1610612753,Orlando Magic,1,0,27,28,55,15,19,34,42,47,89,17,4,21,11,40,25,7,16,104,116
2017,2,21700554,1/3/2018,1610612753,Orlando Magic,1,0,1610612745,Houston Rockets,0,1,29,31,60,6,25,31,35,56,91,22,3,25,12,46,16,6,12,105,98
2021,2,22101110,3/26/2022,1610612739,Cleveland Cavaliers,1,0,1610612741,Chicago Bulls,0,1,27,24,51,7,24,31,34,48,82,19,8,27,17,35,17,6,13,92,94
2021,2,22101110,3/26/2022,1610612741,Chicago Bulls,0,1,1610612739,Cleveland Cavaliers,1,0,31,23,54,5,16,21,36,39,75,21,4,25,9,33,23,7,15,92,98
2014,2,21400540,1/9/2015,1610612737,Atlanta Hawks,0,1,1610612765,Detroit Pistons,1,0,30,29,59,10,13,23,40,42,82,16,8,24,11,36,27,9,14,98,106
2014,2,21400540,1/9/2015,1610612765,Detroit Pistons,1,0,1610612737,Atlanta Hawks,0,1,25,28,53,13,30,43,38,58,96,14,4,18,16,45,24,3,8,97,103
2022,2,22200753,1/29/2023,1610612754,Indiana Pacers,0,0,1610612763,Memphis Grizzlies,1,1,27,20,47,9,23,32,36,43,79,19,2,21,16,28,21,10,18,91,100
2022,2,22200660,1/16/2023,1610612744,Golden State Warriors,0,1,1610612764,Washington Wizards,1,0,27,20,47,18,26,44,45,46,91,19,2,21,10,36,28,7,13,100,127
2020,2,22000761,4/4/2021,1610612743,Denver Nuggets,1,1,1610612753,Orlando Magic,0,0,34,25,59,9,20,29,43,45,88,24,7,31,21,29,27,11,15,95,119
2020,2,22000761,4/4/2021,1610612753,Orlando Magic,0,0,1610612743,Denver Nuggets,1,1,29,25,54,13,22,35,42,47,89,12,5,17,12,38,27,6,12,95,109
2022,2,22200735,1/26/2023,1610612759,San Antonio Spurs,0,0,1610612746,LA Clippers,1,1,29,29,58,8,16,24,37,45,82,18,10,28,16,34,24,9,14,95,100
2021,2,22100751,1/30/2022,1610612747,Los Angeles Lakers,0,0,1610612737,Atlanta Hawks,1,1,32,20,52,15,20,35,47,40,87,12,11,23,9,38,29,7,13,102,121
2022,2,22200768,1/31/2023,1610612740,New Orleans Pelicans,0,0,1610612743,Denver Nuggets,1,1,34,24,58,8,19,27,42,43,85,21,4,25,10,35,28,7,15,101,113
2014,2,21400217,11/26/2014,1610612745,Houston Rockets,1,1,1610612758,Sacramento Kings,0,0,30,29,59,12,23,35,42,52,94,6,9,15,14,43,26,2,4,92,102
2022,2,22200220,11/16/2022,1610612744,Golden State Warriors,0,0,1610612756,Phoenix Suns,1,1,24,26,50,18,24,42,42,50,92,17,0,17,9,41,30,5,17,106,119
2022,2,22200220,11/16/2022,1610612756,Phoenix Suns,1,1,1610612744,Golden State Warriors,0,0,23,23,46,21,19,40,44,42,86,21,4,25,8,35,33,5,16,105,130
2021,2,22100768,2/1/2022,1610612749,Milwaukee Bucks,1,1,1610612764,Washington Wizards,0,0,34,20,54,12,26,38,46,46,92,8,1,9,13,33,26,4,9,93,112
2021,2,22100768,2/1/2022,1610612764,Washington Wizards,0,0,1610612749,Milwaukee Bucks,1,1,24,23,47,12,23,35,36,46,82,14,6,20,10,39,22,7,12,92,98
2017,2,21700553,1/2/2018,1610612746,LA Clippers,1,1,1610612763,Memphis Grizzlies,0,0,30,18,48,9,14,23,39,32,71,26,5,31,6,29,23,10,19,99,113
2017,2,21700553,1/2/2018,1610612763,Memphis Grizzlies,0,0,1610612746,LA Clippers,1,1,30,23,53,8,18,26,38,41,79,21,12,33,11,35,18,5,14,100,105
2014,2,21400217,11/26/2014,1610612758,Sacramento Kings,0,0,1610612745,Houston Rockets,1,1,26,29,55,5,11,16,31,40,71,22,6,28,14,30,16,13,21,91,89
2021,2,22101109,3/26/2022,1610612754,Indiana Pacers,0,0,1610612761,Toronto Raptors,1,1,22,21,43,11,25,36,33,46,79,14,6,20,12,35,23,9,14,91,91
2021,2,22101109,3/26/2022,1610612761,Toronto Raptors,1,1,1610612754,Indiana Pacers,0,0,36,16,52,15,17,32,51,33,84,14,5,19,9,27,34,5,6,90,131
2014,2,21400539,1/9/2015,1610612751,Brooklyn Nets,1,0,1610612755,Philadelphia 76ers,0,1,30,27,57,3,13,16,33,40,73,19,8,27,17,29,21,15,18,90,88
2014,2,21400539,1/9/2015,1610612755,Philadelphia 76ers,0,1,1610612751,Brooklyn Nets,1,0,28,34,62,8,9,17,36,43,79,10,7,17,12,35,22,8,14,89,90
2021,2,22100843,2/11/2022,1610612741,Chicago Bulls,1,1,1610612750,Minnesota Timberwolves,0,0,41,15,56,14,17,31,55,32,87,10,3,13,7,26,32,7,15,101,134
2020,2,22000473,4/19/2021,1610612754,Indiana Pacers,1,0,1610612759,San Antonio Spurs,0,1,26,44,70,8,26,34,34,70,104,18,9,27,22,53,20,4,7,103,94
2020,2,22000473,4/19/2021,1610612759,San Antonio Spurs,0,1,1610612754,Indiana Pacers,1,0,28,28,56,8,20,28,36,48,84,29,6,35,11,41,27,4,12,102,109
2014,2,21400216,11/26/2014,1610612746,LA Clippers,0,1,1610612765,Detroit Pistons,1,0,25,25,50,12,16,28,37,41,78,18,1,19,12,29,21,8,15,90,104
2014,2,21400216,11/26/2014,1610612765,Detroit Pistons,1,0,1610612746,LA Clippers,0,1,25,26,51,10,17,27,35,43,78,18,6,24,15,32,18,9,16,91,98
2014,2,21401091,3/28/2015,1610612743,Denver Nuggets,0,0,1610612757,Portland Trail Blazers,1,1,34,34,68,9,15,24,43,49,92,19,3,22,13,37,24,8,11,100,114
2021,2,22101108,3/26/2022,1610612753,Orlando Magic,1,0,1610612758,Sacramento Kings,0,1,32,38,70,13,23,36,45,61,106,7,0,7,17,44,27,4,13,105,110
2021,2,22101108,3/26/2022,1610612758,Sacramento Kings,0,1,1610612753,Orlando Magic,1,0,31,31,62,11,25,36,42,56,98,19,5,24,18,42,24,9,14,105,114
2014,2,21401091,3/28/2015,1610612757,Portland Trail Blazers,1,1,1610612743,Denver Nuggets,0,0,40,27,67,8,10,18,48,37,85,16,2,18,9,28,29,12,16,99,120
2016,2,21600380,12/14/2016,1610612745,Houston Rockets,1,1,1610612758,Sacramento Kings,0,0,28,15,43,22,20,42,50,35,85,10,6,16,9,30,40,8,16,99,132
2016,2,21600380,12/14/2016,1610612758,Sacramento Kings,0,0,1610612745,Houston Rockets,1,1,28,32,60,11,21,32,39,53,92,9,2,11,14,40,27,8,16,99,98
2023,2,22300072,10/25/2023,1610612762,Utah Jazz,1,0,1610612758,Sacramento Kings,0,1,32,31,63,9,19,28,41,50,91,23,8,31,16,35,22,6,14,104,114
2023,2,22301209,12/6/2023,1610612751,Brooklyn Nets,0,1,1610612737,Atlanta Hawks,1,0,32,35,67,11,16,27,43,51,94,17,7,24,14,42,24,5,12,101,114
2017,2,21700552,1/2/2018,1610612758,Sacramento Kings,1,0,1610612766,Charlotte Hornets,0,1,38,32,70,7,10,17,45,42,87,14,4,18,18,26,22,7,15,93,111
2017,2,21700552,1/2/2018,1610612766,Charlotte Hornets,0,1,1610612758,Sacramento Kings,1,0,36,21,57,15,17,32,51,38,89,14,4,18,7,33,25,1,3,93,131
2014,2,21400215,11/26/2014,1610612737,Atlanta Hawks,1,0,1610612761,Toronto Raptors,0,1,32,26,58,10,14,24,42,40,82,21,3,24,13,27,31,7,14,94,115
2014,2,21400215,11/26/2014,1610612761,Toronto Raptors,0,1,1610612737,Atlanta Hawks,1,0,28,25,53,14,15,29,42,40,82,28,4,32,13,29,24,2,11,94,126
2021,2,22100843,2/11/2022,1610612750,Minnesota Timberwolves,0,0,1610612741,Chicago Bulls,1,1,35,21,56,13,27,40,48,48,96,13,3,16,11,39,32,6,9,100,122
2021,2,22101107,3/26/2022,1610612740,New Orleans Pelicans,1,0,1610612759,San Antonio Spurs,0,1,30,28,58,10,22,32,40,50,90,13,6,19,17,35,23,4,8,89,103
2021,2,22101107,3/26/2022,1610612759,San Antonio Spurs,0,1,1610612740,New Orleans Pelicans,1,0,32,34,66,7,19,26,39,53,92,22,3,25,23,32,22,4,10,90,107
2021,2,22100913,2/27/2022,1610612756,Phoenix Suns,1,0,1610612762,Utah Jazz,0,1,31,27,58,13,15,28,44,42,86,13,3,16,14,30,24,7,9,89,114
2014,2,21400214,11/26/2014,1610612742,Dallas Mavericks,1,1,1610612752,New York Knicks,0,0,34,30,64,4,27,31,38,57,95,29,9,38,22,39,20,7,12,103,109
2014,2,21400214,11/26/2014,1610612752,New York Knicks,0,0,1610612742,Dallas Mavericks,1,1,25,39,64,14,14,28,39,53,92,10,6,16,17,37,21,12,22,104,102
2017,2,21700551,1/2/2018,1610612737,Atlanta Hawks,0,0,1610612756,Phoenix Suns,1,1,26,30,56,10,21,31,36,51,87,21,4,25,17,37,18,7,16,97,103
2017,2,21700551,1/2/2018,1610612756,Phoenix Suns,1,1,1610612737,Atlanta Hawks,0,0,32,23,55,7,15,22,39,38,77,19,7,26,15,27,24,11,22,96,104
2014,2,21400538,1/9/2015,1610612738,Boston Celtics,0,0,1610612754,Indiana Pacers,1,1,31,38,69,10,24,34,41,62,103,11,5,16,17,45,25,5,11,105,103
2014,2,21400538,1/9/2015,1610612754,Indiana Pacers,1,1,1610612738,Boston Celtics,0,0,25,44,69,9,14,23,34,58,92,30,4,34,22,39,21,10,17,105,107
2023,2,22300030,11/17/2023,1610612739,Cleveland Cavaliers,1,1,1610612765,Detroit Pistons,0,0,33,28,61,9,12,21,42,40,82,15,6,21,8,34,21,8,12,96,108
2017,2,21700550,1/2/2018,1610612752,New York Knicks,1,0,1610612759,San Antonio Spurs,0,1,28,37,65,7,15,22,35,52,87,13,4,17,18,36,21,11,14,93,90
2017,2,21700550,1/2/2018,1610612759,San Antonio Spurs,0,1,1610612752,New York Knicks,1,0,21,34,55,10,17,27,31,51,82,28,6,34,16,38,18,5,8,92,100
2021,2,22100913,2/27/2022,1610612762,Utah Jazz,0,1,1610612756,Phoenix Suns,1,0,27,27,54,17,23,40,44,50,94,13,7,20,24,29,23,7,10,90,118
2016,2,21600916,3/3/2017,1610612756,Phoenix Suns,1,1,1610612760,Oklahoma City Thunder,0,0,39,29,68,5,16,21,44,45,89,25,6,31,11,38,28,10,17,109,118
2021,2,22100767,1/31/2022,1610612737,Atlanta Hawks,1,0,1610612761,Toronto Raptors,0,1,25,24,49,12,20,32,37,44,81,14,2,16,7,38,28,7,15,97,100
2021,2,22100767,1/31/2022,1610612761,Toronto Raptors,0,1,1610612737,Atlanta Hawks,1,0,20,33,53,18,18,36,38,51,89,12,5,17,9,45,21,6,8,97,106
2021,2,22101106,3/25/2022,1610612746,LA Clippers,1,0,1610612755,Philadelphia 76ers,0,1,26,34,60,8,17,25,34,51,85,21,4,25,13,41,19,12,16,100,97
2021,2,22101106,3/25/2022,1610612755,Philadelphia 76ers,0,1,1610612746,LA Clippers,1,0,28,29,57,15,20,35,43,49,92,21,3,24,16,33,23,7,13,100,122
2016,2,21600916,3/3/2017,1610612760,Oklahoma City Thunder,0,0,1610612756,Phoenix Suns,1,1,28,24,52,9,26,35,37,50,87,28,7,35,14,38,14,10,19,109,111
2014,2,21400537,1/8/2015,1610612748,Miami Heat,0,0,1610612757,Portland Trail Blazers,1,1,26,37,63,3,11,14,29,48,77,22,8,30,13,38,15,5,9,87,83
2014,2,21400537,1/8/2015,1610612757,Portland Trail Blazers,1,1,1610612748,Miami Heat,0,0,32,36,68,8,19,27,40,55,95,11,4,15,23,34,19,6,7,87,99
2014,2,21400213,11/26/2014,1610612751,Brooklyn Nets,0,1,1610612755,Philadelphia 76ers,1,0,27,20,47,8,16,24,35,36,71,21,7,28,10,29,25,11,24,100,99
2014,2,21400213,11/26/2014,1610612755,Philadelphia 76ers,1,0,1610612751,Brooklyn Nets,0,1,25,36,61,9,15,24,34,51,85,14,3,17,15,39,23,10,20,99,91
2014,2,21401090,3/28/2015,1610612760,Oklahoma City Thunder,0,0,1610612762,Utah Jazz,1,1,25,32,57,6,10,16,31,42,73,21,11,32,16,31,14,14,23,96,89
2014,2,21401090,3/28/2015,1610612762,Utah Jazz,1,1,1610612760,Oklahoma City Thunder,0,0,26,29,55,6,23,29,32,52,84,24,11,35,17,42,12,5,12,94,94
2014,2,21400536,1/8/2015,1610612745,Houston Rockets,0,1,1610612752,New York Knicks,1,0,25,16,41,16,20,36,41,36,77,22,10,32,12,30,25,12,19,98,120
2014,2,21400536,1/8/2015,1610612752,New York Knicks,1,0,1610612745,Houston Rockets,0,1,26,28,54,11,15,26,37,43,80,11,10,21,15,32,22,14,21,98,96
2021,2,22101105,3/25/2022,1610612745,Houston Rockets,0,1,1610612757,Portland Trail Blazers,1,0,24,14,38,19,26,45,43,40,83,20,3,23,12,30,27,6,16,98,125
2021,2,22101105,3/25/2022,1610612757,Portland Trail Blazers,1,0,1610612745,Houston Rockets,0,1,40,25,65,3,17,20,43,42,85,17,6,23,15,31,28,12,17,96,106
2022,2,22200707,1/23/2023,1610612753,Orlando Magic,1,1,1610612738,Boston Celtics,0,0,32,25,57,11,16,27,43,41,84,16,8,24,12,32,22,5,11,95,113
2021,2,22101016,3/13/2022,1610612737,Atlanta Hawks,1,1,1610612754,Indiana Pacers,0,0,29,17,46,17,21,38,46,38,84,22,2,24,9,30,27,7,12,97,131
2022,2,22200652,1/15/2023,1610612758,Sacramento Kings,0,1,1610612759,San Antonio Spurs,1,0,35,24,59,14,16,30,49,40,89,20,5,25,10,33,24,1,6,94,132
2021,2,22100766,2/1/2022,1610612740,New Orleans Pelicans,0,1,1610612765,Detroit Pistons,1,0,31,30,61,8,20,28,39,50,89,25,3,28,23,30,24,7,17,97,111
2021,2,22100766,2/1/2022,1610612765,Detroit Pistons,1,0,1610612740,New Orleans Pelicans,0,1,33,19,52,8,24,32,41,43,84,11,3,14,11,34,21,8,19,97,101
2021,2,22101104,3/25/2022,1610612742,Dallas Mavericks,0,0,1610612750,Minnesota Timberwolves,1,1,25,22,47,10,33,43,35,55,90,15,4,19,14,41,21,4,11,95,95
2021,2,22101104,3/25/2022,1610612750,Minnesota Timberwolves,1,1,1610612742,Dallas Mavericks,0,0,32,20,52,11,21,32,43,41,84,19,5,24,8,35,26,4,9,95,116
2020,2,22000472,2/21/2021,1610612746,LA Clippers,1,0,1610612751,Brooklyn Nets,0,1,25,27,52,15,20,35,40,47,87,13,5,18,17,33,24,10,17,97,108
2014,2,21400212,11/26/2014,1610612744,Golden State Warriors,0,1,1610612753,Orlando Magic,1,0,32,27,59,12,14,26,44,41,85,11,8,19,10,36,30,8,15,99,111
2014,2,21400212,11/26/2014,1610612753,Orlando Magic,1,0,1610612744,Golden State Warriors,0,1,30,37,67,6,14,20,36,51,87,18,6,24,14,39,21,7,14,99,96
2020,2,22000472,2/21/2021,1610612751,Brooklyn Nets,0,1,1610612746,LA Clippers,1,0,33,21,54,11,27,38,44,48,92,13,6,19,11,42,21,3,6,97,112
2017,2,21700549,1/2/2018,1610612739,Cleveland Cavaliers,1,1,1610612757,Portland Trail Blazers,0,0,30,21,51,13,19,32,43,40,83,28,9,37,14,31,28,5,10,98,127
2023,2,22301205,12/6/2023,1610612753,Orlando Magic,0,0,1610612739,Cleveland Cavaliers,1,1,39,22,61,2,21,23,41,43,84,27,10,37,11,37,22,5,11,101,111
2021,2,22101016,3/13/2022,1610612754,Indiana Pacers,0,0,1610612737,Atlanta Hawks,1,1,31,23,54,15,20,35,46,43,89,21,5,26,17,29,23,9,15,100,128
2020,2,22000760,4/4/2021,1610612740,New Orleans Pelicans,0,1,1610612745,Houston Rockets,1,0,26,28,54,16,21,37,42,49,91,22,13,35,17,40,26,3,15,104,122
2020,2,22000760,4/4/2021,1610612745,Houston Rockets,1,0,1610612740,New Orleans Pelicans,0,1,25,24,49,16,24,40,41,48,89,17,7,24,14,39,25,12,17,104,115
2017,2,21700549,1/2/2018,1610612757,Portland Trail Blazers,0,0,1610612739,Cleveland Cavaliers,1,1,29,29,58,13,19,32,42,48,90,13,6,19,17,34,25,11,15,97,110
2014,2,21400211,11/26/2014,1610612739,Cleveland Cavaliers,1,1,1610612764,Washington Wizards,0,0,32,22,54,6,14,20,38,36,74,31,7,38,13,25,23,5,10,91,113
2014,2,21400211,11/26/2014,1610612764,Washington Wizards,0,0,1610612739,Cleveland Cavaliers,1,1,28,30,58,5,8,13,33,38,71,16,6,22,10,29,24,13,18,90,87
2021,2,22101208,4/8/2022,1610612741,Chicago Bulls,1,0,1610612766,Charlotte Hornets,0,1,31,27,58,13,11,24,44,38,82,16,4,20,9,30,25,7,12,94,117
2021,2,22100765,1/31/2022,1610612757,Portland Trail Blazers,0,0,1610612760,Oklahoma City Thunder,1,1,27,16,43,7,31,38,34,47,81,6,2,8,6,41,18,6,15,92,81
2021,2,22100765,1/31/2022,1610612760,Oklahoma City Thunder,1,1,1610612757,Portland Trail Blazers,0,0,23,22,45,12,29,41,35,51,86,16,1,17,15,37,22,7,13,94,98
2021,2,22101103,3/25/2022,1610612748,Miami Heat,1,0,1610612752,New York Knicks,0,1,23,14,37,12,21,33,35,35,70,21,4,25,10,26,18,8,15,87,103
2021,2,22101103,3/25/2022,1610612752,New York Knicks,0,1,1610612748,Miami Heat,1,0,19,13,32,17,33,50,36,46,82,22,6,28,20,29,23,6,11,86,111
2020,2,22000471,2/21/2021,1610612749,Milwaukee Bucks,1,1,1610612758,Sacramento Kings,0,0,33,29,62,11,17,28,44,46,90,29,7,36,20,30,22,6,18,104,128
2020,2,22000471,2/21/2021,1610612758,Sacramento Kings,0,0,1610612749,Milwaukee Bucks,1,1,32,35,67,12,21,33,44,56,100,15,5,20,17,42,29,8,13,104,115
2014,2,21400535,1/8/2015,1610612761,Toronto Raptors,1,0,1610612766,Charlotte Hornets,0,1,23,29,52,10,21,31,33,50,83,19,6,25,12,40,20,5,14,96,95
2014,2,21400535,1/8/2015,1610612766,Charlotte Hornets,0,1,1610612761,Toronto Raptors,1,0,38,34,72,4,12,16,42,46,88,15,7,22,13,38,21,2,8,95,103
2014,2,21400210,11/26/2014,1610612757,Portland Trail Blazers,0,1,1610612766,Charlotte Hornets,1,0,27,38,65,12,15,27,39,53,92,15,5,20,16,41,21,3,8,94,105
2014,2,21400210,11/26/2014,1610612766,Charlotte Hornets,1,0,1610612757,Portland Trail Blazers,0,1,36,43,79,5,10,15,41,53,94,10,5,15,12,43,29,4,6,94,97
2022,2,22200560,1/2/2023,1610612746,LA Clippers,1,0,1610612748,Miami Heat,0,1,17,21,38,12,17,29,29,38,67,30,4,34,4,37,19,7,15,94,100
2022,2,22200560,1/2/2023,1610612748,Miami Heat,0,1,1610612746,LA Clippers,1,0,27,22,49,12,24,36,39,46,85,20,4,24,14,34,22,7,11,94,110
2021,2,22100764,1/31/2022,1610612744,Golden State Warriors,0,1,1610612745,Houston Rockets,1,0,26,14,40,17,23,40,43,37,80,19,4,23,9,29,23,4,15,96,122
2021,2,22101208,4/8/2022,1610612766,Charlotte Hornets,0,1,1610612741,Chicago Bulls,1,0,33,13,46,19,21,40,52,34,86,10,0,10,9,25,34,7,11,92,133
2021,2,22101102,3/25/2022,1610612737,Atlanta Hawks,1,1,1610612744,Golden State Warriors,0,0,32,20,52,14,23,37,46,43,89,15,4,19,14,33,27,4,12,94,121
2021,2,22101102,3/25/2022,1610612744,Golden State Warriors,0,0,1610612737,Atlanta Hawks,1,1,29,20,49,14,27,41,43,47,90,10,3,13,16,32,27,11,16,96,110
2014,2,21401089,3/28/2015,1610612744,Golden State Warriors,0,1,1610612749,Milwaukee Bucks,1,0,30,27,57,12,13,25,42,40,82,12,2,14,13,28,27,14,22,99,108
2014,2,21401089,3/28/2015,1610612749,Milwaukee Bucks,1,0,1610612744,Golden State Warriors,0,1,31,41,72,2,13,15,33,54,87,27,5,32,17,39,24,7,15,99,95
2022,2,22200706,1/23/2023,1610612765,Detroit Pistons,1,0,1610612749,Milwaukee Bucks,0,1,30,25,55,13,19,32,43,44,87,31,9,40,12,38,26,11,20,112,130
2022,2,22200763,1/30/2023,1610612757,Portland Trail Blazers,1,1,1610612737,Atlanta Hawks,0,0,24,15,39,19,21,40,43,36,79,24,3,27,7,31,24,5,8,93,129
2023,2,22300019,11/14/2023,1610612754,Indiana Pacers,0,1,1610612755,Philadelphia 76ers,1,0,35,21,56,13,24,37,48,45,93,23,10,33,11,38,32,5,11,108,132
2022,2,22200558,1/2/2023,1610612737,Atlanta Hawks,0,0,1610612744,Golden State Warriors,1,1,42,32,74,11,24,35,53,56,109,24,5,29,12,46,30,9,13,125,141
2023,2,22301208,12/6/2023,1610612764,Washington Wizards,1,0,1610612755,Philadelphia 76ers,0,1,38,19,57,14,21,35,52,40,92,8,0,8,4,36,39,7,11,103,126
2021,2,22100764,1/31/2022,1610612745,Houston Rockets,1,0,1610612744,Golden State Warriors,0,1,20,21,41,16,27,43,36,48,84,20,9,29,17,36,25,10,17,97,108
2020,2,22000470,2/21/2021,1610612737,Atlanta Hawks,1,1,1610612743,Denver Nuggets,0,0,30,17,47,12,22,34,42,39,81,27,6,33,10,32,29,8,11,98,123
2021,2,22101101,3/25/2022,1610612764,Washington Wizards,0,1,1610612765,Detroit Pistons,1,0,27,26,53,9,21,30,36,47,83,19,2,21,8,40,23,9,17,101,100
2021,2,22101101,3/25/2022,1610612765,Detroit Pistons,1,0,1610612764,Washington Wizards,0,1,33,30,63,6,26,32,39,56,95,13,1,14,15,42,19,6,15,101,97
2020,2,22000470,2/21/2021,1610612743,Denver Nuggets,0,0,1610612737,Atlanta Hawks,1,1,27,21,48,16,20,36,43,41,84,13,3,16,6,35,25,6,13,99,115
2017,2,21700548,1/1/2018,1610612747,Los Angeles Lakers,0,0,1610612750,Minnesota Timberwolves,1,1,26,24,50,8,18,26,34,42,76,20,9,29,11,34,18,14,24,102,96
2020,2,22000759,4/4/2021,1610612737,Atlanta Hawks,1,1,1610612744,Golden State Warriors,0,0,23,26,49,12,20,32,35,46,81,35,10,45,12,39,19,12,15,104,117
2020,2,22000759,4/4/2021,1610612744,Golden State Warriors,0,0,1610612737,Atlanta Hawks,1,1,33,19,52,10,30,40,43,49,92,15,6,21,11,41,25,10,16,105,111
2014,2,21400209,11/25/2014,1610612741,Chicago Bulls,0,0,1610612743,Denver Nuggets,1,1,28,33,61,7,14,21,35,47,82,32,5,37,16,34,20,5,12,96,109
2014,2,21400209,11/25/2014,1610612743,Denver Nuggets,1,1,1610612741,Chicago Bulls,0,0,35,34,69,8,8,16,43,42,85,20,7,27,16,28,22,9,14,95,114
2017,2,21700548,1/1/2018,1610612750,Minnesota Timberwolves,1,1,1610612747,Los Angeles Lakers,0,0,33,28,61,7,13,20,40,41,81,27,3,30,11,32,26,12,17,103,114
2022,2,22200558,1/2/2023,1610612744,Golden State Warriors,1,1,1610612737,Atlanta Hawks,0,0,35,27,62,19,40,59,54,67,121,16,8,24,26,45,34,9,19,126,143
2014,2,21400534,1/7/2015,1610612746,LA Clippers,1,1,1610612747,Los Angeles Lakers,0,0,28,24,52,12,21,33,40,45,85,22,8,30,11,39,29,3,6,97,114
2014,2,21400534,1/7/2015,1610612747,Los Angeles Lakers,0,0,1610612746,LA Clippers,1,1,32,33,65,5,15,20,37,48,85,10,7,17,10,40,21,9,13,96,89
2014,2,21400208,11/25/2014,1610612740,New Orleans Pelicans,1,0,1610612758,Sacramento Kings,0,1,30,32,62,3,14,17,33,46,79,20,9,29,16,33,15,9,11,88,89
2014,2,21400208,11/25/2014,1610612758,Sacramento Kings,0,1,1610612740,New Orleans Pelicans,1,0,32,31,63,5,9,14,37,40,77,20,4,24,14,29,16,3,10,87,99
2022,2,22200706,1/23/2023,1610612749,Milwaukee Bucks,0,1,1610612765,Detroit Pistons,1,0,32,14,46,23,29,52,55,43,98,17,7,24,15,31,38,10,19,111,150
2022,2,22200809,2/6/2023,1610612739,Cleveland Cavaliers,0,1,1610612764,Washington Wizards,1,0,32,17,49,12,17,29,44,34,78,14,6,20,8,30,26,8,17,95,114
2023,2,22300396,12/23/2023,1610612741,Chicago Bulls,1,0,1610612739,Cleveland Cavaliers,0,1,27,18,45,8,27,35,35,45,80,17,2,19,8,37,23,7,12,91,95
2022,2,22200763,1/30/2023,1610612737,Atlanta Hawks,0,0,1610612757,Portland Trail Blazers,1,1,31,33,64,13,17,30,44,50,94,24,6,30,23,30,26,2,7,92,125
2021,2,22100763,1/31/2022,1610612752,New York Knicks,1,1,1610612758,Sacramento Kings,0,0,27,18,45,13,22,35,40,40,80,23,6,29,11,31,25,6,17,99,116
2021,2,22100763,1/31/2022,1610612758,Sacramento Kings,0,0,1610612752,New York Knicks,1,1,26,22,48,11,27,38,37,49,86,11,11,22,13,42,24,12,16,99,96
2021,2,22101100,3/25/2022,1610612762,Utah Jazz,0,0,1610612766,Charlotte Hornets,1,1,21,16,37,17,30,47,38,46,84,8,3,11,12,36,25,7,12,89,101
2021,2,22101100,3/25/2022,1610612766,Charlotte Hornets,1,1,1610612762,Utah Jazz,0,0,28,26,54,13,21,34,41,47,88,12,5,17,19,31,26,7,10,88,107
2020,2,22000758,4/4/2021,1610612755,Philadelphia 76ers,1,0,1610612763,Memphis Grizzlies,0,1,29,26,55,8,26,34,37,52,89,18,10,28,18,40,23,6,11,95,100
2020,2,22000758,4/4/2021,1610612763,Memphis Grizzlies,0,1,1610612755,Philadelphia 76ers,1,0,28,23,51,16,22,38,44,45,89,12,3,15,11,36,30,4,12,95,116
2014,2,21400207,11/25/2014,1610612749,Milwaukee Bucks,1,1,1610612765,Detroit Pistons,0,0,29,39,68,10,12,22,39,51,90,10,3,13,21,32,22,7,17,92,98
2016,2,21600915,3/3/2017,1610612751,Brooklyn Nets,0,0,1610612762,Utah Jazz,1,1,29,30,59,7,23,30,36,53,89,18,6,24,15,41,12,7,12,98,97
2014,2,21400207,11/25/2014,1610612765,Detroit Pistons,0,0,1610612749,Milwaukee Bucks,1,1,29,29,58,7,13,20,36,42,78,7,10,17,13,35,23,9,19,93,86
2014,2,21401088,3/28/2015,1610612741,Chicago Bulls,1,1,1610612752,New York Knicks,0,0,37,30,67,6,11,17,43,41,84,19,3,22,18,26,28,7,14,91,111
2021,2,22100762,1/31/2022,1610612738,Boston Celtics,1,1,1610612748,Miami Heat,0,0,28,14,42,16,26,42,44,40,84,18,9,27,12,31,24,6,10,96,122
2021,2,22100762,1/31/2022,1610612748,Miami Heat,0,0,1610612738,Boston Celtics,1,1,17,26,43,17,27,44,34,53,87,7,3,10,15,39,25,9,19,96,92
2016,2,21600915,3/3/2017,1610612762,Utah Jazz,1,1,1610612751,Brooklyn Nets,0,0,26,22,48,12,14,26,38,36,74,24,10,34,6,34,25,6,14,97,112
2014,2,21401088,3/28/2015,1610612752,New York Knicks,0,0,1610612741,Chicago Bulls,1,1,26,36,62,4,13,17,30,49,79,16,3,19,11,40,22,8,14,91,80
2016,2,21600028,10/29/2016,1610612752,New York Knicks,1,1,1610612763,Memphis Grizzlies,0,0,34,21,55,6,15,21,40,36,76,25,14,39,11,33,24,3,13,97,111
2016,2,21600028,10/29/2016,1610612763,Memphis Grizzlies,0,0,1610612752,New York Knicks,1,1,28,33,61,9,16,25,37,49,86,21,5,26,14,37,19,4,12,96,104
2019,2,21900214,11/21/2019,1610612740,New Orleans Pelicans,0,1,1610612756,Phoenix Suns,1,0,31,22,53,16,19,35,47,41,88,14,8,22,14,30,28,10,18,102,124
2022,2,22200658,1/16/2023,1610612740,New Orleans Pelicans,0,0,1610612739,Cleveland Cavaliers,1,1,28,20,48,10,17,27,38,37,75,17,5,22,7,33,26,5,17,95,103
2023,2,22300176,11/11/2023,1610612739,Cleveland Cavaliers,0,1,1610612744,Golden State Warriors,1,0,26,30,56,11,19,30,37,49,86,33,10,43,12,42,23,5,11,105,118
2021,2,22100761,1/31/2022,1610612755,Philadelphia 76ers,1,1,1610612763,Memphis Grizzlies,0,0,38,31,69,11,20,31,49,51,100,13,2,15,18,34,30,14,21,109,122
2021,2,22100761,1/31/2022,1610612763,Memphis Grizzlies,0,0,1610612755,Philadelphia 76ers,1,1,41,31,72,6,24,30,47,55,102,19,9,28,19,41,18,8,14,108,119
2021,2,22101099,3/24/2022,1610612743,Denver Nuggets,1,0,1610612756,Phoenix Suns,0,1,33,16,49,15,17,32,48,33,81,19,8,27,11,25,27,7,17,99,130
2021,2,22101099,3/24/2022,1610612756,Phoenix Suns,0,1,1610612743,Denver Nuggets,1,0,39,20,59,13,14,27,52,34,86,23,6,29,10,27,32,5,9,98,140
2023,2,22301207,12/6/2023,1610612748,Miami Heat,0,1,1610612761,Toronto Raptors,1,0,27,24,51,14,24,38,41,48,89,16,3,19,8,40,33,3,7,96,112
2021,2,22100760,1/31/2022,1610612746,LA Clippers,0,0,1610612754,Indiana Pacers,1,1,30,22,52,15,29,44,45,51,96,11,2,13,12,41,25,3,10,99,116
2021,2,22100760,1/31/2022,1610612754,Indiana Pacers,1,1,1610612746,LA Clippers,0,0,36,30,66,14,15,29,50,45,95,8,4,12,14,33,31,7,12,99,122
2014,2,21400206,11/25/2014,1610612744,Golden State Warriors,0,1,1610612748,Miami Heat,1,0,30,17,47,13,15,28,43,32,75,15,8,23,6,30,21,7,12,92,114
2014,2,21400206,11/25/2014,1610612748,Miami Heat,1,0,1610612744,Golden State Warriors,0,1,23,39,62,10,13,23,33,52,85,21,6,27,16,40,16,6,12,93,97
2022,2,22200654,1/15/2023,1610612742,Dallas Mavericks,0,0,1610612757,Portland Trail Blazers,1,1,27,20,47,14,28,42,41,48,89,27,6,33,15,35,31,3,9,97,123
2020,2,22000469,2/21/2021,1610612750,Minnesota Timberwolves,0,0,1610612752,New York Knicks,1,1,17,30,47,16,19,35,33,49,82,17,4,21,14,39,24,4,16,93,99
2020,2,22000469,2/21/2021,1610612752,New York Knicks,1,1,1610612750,Minnesota Timberwolves,0,0,27,33,60,6,12,18,33,45,78,31,7,38,15,36,17,6,13,94,103
2017,2,21700547,1/1/2018,1610612741,Chicago Bulls,1,0,1610612757,Portland Trail Blazers,0,1,34,43,77,11,16,27,45,59,104,19,4,23,18,43,28,7,12,110,120
2017,2,21700547,1/1/2018,1610612757,Portland Trail Blazers,0,1,1610612741,Chicago Bulls,1,0,33,42,75,14,19,33,47,61,108,16,2,18,14,47,25,5,8,110,124
2019,2,21900214,11/21/2019,1610612756,Phoenix Suns,1,0,1610612740,New Orleans Pelicans,0,1,27,28,55,13,18,31,40,46,86,28,4,32,12,36,28,8,14,103,121
2023,2,22301207,12/6/2023,1610612761,Toronto Raptors,1,0,1610612748,Miami Heat,0,1,23,26,49,14,23,37,37,49,86,15,2,17,12,38,29,5,14,97,103
2021,2,22101098,3/24/2022,1610612740,New Orleans Pelicans,1,1,1610612741,Chicago Bulls,0,0,29,25,54,12,17,29,41,42,83,32,2,34,12,31,23,5,11,97,126
2021,2,22101098,3/24/2022,1610612741,Chicago Bulls,0,0,1610612740,New Orleans Pelicans,1,1,26,18,44,14,20,34,40,38,78,15,4,19,6,34,25,10,15,97,109
2014,2,21400533,1/7/2015,1610612744,Golden State Warriors,1,1,1610612754,Indiana Pacers,0,0,33,30,63,12,16,28,45,46,91,15,5,20,12,38,30,4,11,100,117
2014,2,21400533,1/7/2015,1610612754,Indiana Pacers,0,0,1610612744,Golden State Warriors,1,1,31,24,55,6,20,26,37,44,81,22,1,23,11,33,24,11,17,101,102
2014,2,21400205,11/25/2014,1610612737,Atlanta Hawks,0,1,1610612764,Washington Wizards,1,0,29,31,60,7,18,25,36,49,85,27,7,34,16,35,17,2,11,98,106
2014,2,21400205,11/25/2014,1610612764,Washington Wizards,1,0,1610612737,Atlanta Hawks,0,1,27,37,64,9,11,20,36,48,84,21,8,29,21,32,25,16,20,97,102
2021,2,22100759,1/31/2022,1610612739,Cleveland Cavaliers,1,1,1610612740,New Orleans Pelicans,0,0,27,26,53,9,22,31,36,48,84,12,2,14,12,37,26,6,10,90,93
2017,2,21700546,1/1/2018,1610612749,Milwaukee Bucks,0,0,1610612761,Toronto Raptors,1,1,31,35,66,13,14,27,44,49,93,26,2,28,15,34,27,8,15,110,127
2021,2,22100759,1/31/2022,1610612740,New Orleans Pelicans,0,0,1610612739,Cleveland Cavaliers,1,1,27,28,55,6,24,30,33,52,85,18,3,21,19,33,26,6,13,89,90
2020,2,22000468,2/21/2021,1610612755,Philadelphia 76ers,0,0,1610612761,Toronto Raptors,1,1,22,26,48,11,26,37,33,52,85,26,9,35,17,38,26,5,10,95,103
2014,2,21401087,3/28/2015,1610612737,Atlanta Hawks,0,0,1610612766,Charlotte Hornets,1,1,22,34,56,15,15,30,37,49,86,11,3,14,14,35,32,4,11,91,100
2014,2,21401087,3/28/2015,1610612766,Charlotte Hornets,1,1,1610612737,Atlanta Hawks,0,0,30,24,54,12,14,26,42,38,80,19,3,22,8,31,28,6,9,92,115
2017,2,21700546,1/1/2018,1610612761,Toronto Raptors,1,1,1610612749,Milwaukee Bucks,0,0,31,27,58,14,19,33,45,46,91,27,6,33,12,37,25,9,13,108,131
2020,2,22000468,2/21/2021,1610612761,Toronto Raptors,1,1,1610612755,Philadelphia 76ers,0,0,26,21,47,14,20,34,40,41,81,16,2,18,8,34,25,8,14,95,110
2014,2,21400204,11/24/2014,1610612741,Chicago Bulls,0,1,1610612762,Utah Jazz,1,0,27,25,52,9,11,20,36,36,72,16,7,23,8,32,20,9,16,91,97
2014,2,21400204,11/24/2014,1610612762,Utah Jazz,1,0,1610612741,Chicago Bulls,0,1,39,38,77,3,6,9,42,44,86,8,2,10,14,32,22,9,13,90,95
2021,2,22101097,3/24/2022,1610612749,Milwaukee Bucks,1,1,1610612764,Washington Wizards,0,0,26,20,46,16,19,35,42,39,81,14,2,16,8,31,23,9,16,96,114
2014,2,21400532,1/7/2015,1610612758,Sacramento Kings,1,1,1610612760,Oklahoma City Thunder,0,0,26,47,73,10,9,19,36,56,92,22,6,28,17,42,18,7,16,104,104
2021,2,22101097,3/24/2022,1610612764,Washington Wizards,0,0,1610612749,Milwaukee Bucks,1,1,32,22,54,11,27,38,43,49,92,5,4,9,13,39,25,5,11,94,102
2014,2,21400532,1/7/2015,1610612760,Oklahoma City Thunder,0,0,1610612758,Sacramento Kings,1,1,20,39,59,9,21,30,29,60,89,16,7,23,20,45,16,12,24,104,83
2020,2,22000757,4/4/2021,1610612738,Boston Celtics,1,1,1610612766,Charlotte Hornets,0,0,22,18,40,21,33,54,43,51,94,9,2,11,17,35,29,3,6,89,116
2020,2,22000757,4/4/2021,1610612766,Charlotte Hornets,0,0,1610612738,Boston Celtics,1,1,22,27,49,10,21,31,32,48,80,12,8,20,17,34,23,11,17,88,86
2022,2,22200707,1/23/2023,1610612738,Boston Celtics,0,0,1610612753,Orlando Magic,1,1,18,19,37,18,28,46,36,47,83,8,3,11,12,37,24,10,18,94,98
2014,2,21400203,11/24/2014,1610612742,Dallas Mavericks,1,0,1610612754,Indiana Pacers,0,1,32,24,56,8,16,24,40,40,80,12,9,21,8,37,21,6,12,94,100
2014,2,21400203,11/24/2014,1610612754,Indiana Pacers,0,1,1610612742,Dallas Mavericks,1,0,24,27,51,13,13,26,37,40,77,24,12,36,14,32,20,6,16,96,111
2023,2,22301208,12/6/2023,1610612755,Philadelphia 76ers,0,1,1610612764,Washington Wizards,1,0,39,26,65,8,19,27,47,45,92,29,5,34,14,32,29,8,11,104,131
2014,2,21400531,1/7/2015,1610612750,Minnesota Timberwolves,1,0,1610612756,Phoenix Suns,0,1,37,38,75,7,10,17,44,48,92,16,3,19,22,28,30,14,22,100,111
2014,2,21400531,1/7/2015,1610612756,Phoenix Suns,0,1,1610612750,Minnesota Timberwolves,1,0,41,29,70,5,21,26,46,50,96,16,3,19,20,32,12,8,13,101,113
2021,2,22100758,1/30/2022,1610612756,Phoenix Suns,1,1,1610612759,San Antonio Spurs,0,0,37,28,65,11,21,32,48,49,97,8,4,12,15,34,31,6,8,98,115
2021,2,22100758,1/30/2022,1610612759,San Antonio Spurs,0,0,1610612756,Phoenix Suns,1,1,32,31,63,13,24,37,45,55,100,7,1,8,16,39,27,6,11,98,110
2014,2,21400202,11/24/2014,1610612745,Houston Rockets,1,1,1610612752,New York Knicks,0,0,18,22,40,14,22,36,32,44,76,13,6,19,13,34,19,8,17,90,91
2014,2,21400202,11/24/2014,1610612752,New York Knicks,0,0,1610612745,Houston Rockets,1,1,29,25,54,6,16,22,35,41,76,10,5,15,10,32,25,13,17,91,86
2023,2,22301210,12/6/2023,1610612750,Minnesota Timberwolves,1,1,1610612759,San Antonio Spurs,0,0,24,23,47,12,28,40,36,51,87,18,3,21,13,39,20,7,14,99,102
2014,2,21401086,3/27/2015,1610612756,Phoenix Suns,1,0,1610612757,Portland Trail Blazers,0,1,26,41,67,6,14,20,32,55,87,11,1,12,13,43,14,4,13,92,81
2014,2,21401086,3/27/2015,1610612757,Portland Trail Blazers,0,1,1610612756,Phoenix Suns,1,0,29,34,63,7,19,26,36,53,89,8,10,18,19,39,15,5,13,92,87
2014,2,21400530,1/7/2015,1610612743,Denver Nuggets,1,1,1610612753,Orlando Magic,0,0,26,31,57,7,10,17,33,41,74,20,6,26,10,34,22,11,21,98,93
2014,2,21400530,1/7/2015,1610612753,Orlando Magic,0,0,1610612743,Denver Nuggets,1,1,27,39,66,8,14,22,35,53,88,12,4,16,13,42,21,5,16,99,90
2022,2,22200655,1/15/2023,1610612747,Los Angeles Lakers,1,0,1610612755,Philadelphia 76ers,0,1,42,25,67,6,14,20,48,39,87,10,3,13,6,35,28,3,11,96,112
2023,2,22300398,12/23/2023,1610612742,Dallas Mavericks,1,1,1610612759,San Antonio Spurs,0,0,29,26,55,23,22,45,52,48,100,17,4,21,14,36,26,9,13,109,144
2014,2,21400201,11/24/2014,1610612756,Phoenix Suns,0,0,1610612761,Toronto Raptors,1,1,25,26,51,14,19,33,39,45,84,8,3,11,13,33,22,9,20,97,100
2014,2,21400201,11/24/2014,1610612761,Toronto Raptors,1,1,1610612756,Phoenix Suns,0,0,33,32,65,4,13,17,37,45,82,26,6,32,14,35,21,6,12,95,104
2020,2,22000467,2/21/2021,1610612753,Orlando Magic,1,1,1610612765,Detroit Pistons,0,0,26,25,51,9,21,30,35,46,81,26,3,29,7,41,24,10,12,99,105
2021,2,22101096,3/24/2022,1610612754,Indiana Pacers,0,0,1610612763,Memphis Grizzlies,1,1,30,29,59,9,24,33,39,53,92,16,7,23,16,40,20,8,11,98,103
2021,2,22101096,3/24/2022,1610612763,Memphis Grizzlies,1,1,1610612754,Indiana Pacers,0,0,29,22,51,21,21,42,50,43,93,12,5,17,21,24,34,7,17,97,133
2014,2,21400200,11/24/2014,1610612755,Philadelphia 76ers,1,0,1610612757,Portland Trail Blazers,0,1,42,34,76,0,8,8,42,42,84,20,4,24,10,34,28,6,10,94,104
2014,2,21400200,11/24/2014,1610612757,Portland Trail Blazers,0,1,1610612755,Philadelphia 76ers,1,0,37,25,62,7,20,27,44,45,89,19,4,23,23,24,30,11,17,95,114
2017,2,21700545,1/1/2018,1610612751,Brooklyn Nets,1,1,1610612753,Orlando Magic,0,0,27,30,57,9,16,25,36,46,82,17,6,23,13,36,17,5,13,94,98
2014,2,21401085,3/27/2015,1610612743,Denver Nuggets,1,1,1610612762,Utah Jazz,0,0,26,26,52,13,11,24,39,37,76,16,7,23,12,29,23,12,18,93,107
2014,2,21401085,3/27/2015,1610612762,Utah Jazz,0,0,1610612743,Denver Nuggets,1,1,27,27,54,5,22,27,32,49,81,22,9,31,19,35,20,8,14,92,91
2014,2,21400199,11/24/2014,1610612739,Cleveland Cavaliers,1,1,1610612753,Orlando Magic,0,0,36,29,65,6,10,16,42,39,81,16,6,22,15,28,30,5,13,88,106
2014,2,21400199,11/24/2014,1610612753,Orlando Magic,0,0,1610612739,Cleveland Cavaliers,1,1,24,39,63,5,12,17,29,51,80,11,4,15,18,34,14,14,18,89,74
2021,2,22100757,1/30/2022,1610612750,Minnesota Timberwolves,1,1,1610612762,Utah Jazz,0,0,36,22,58,13,18,31,49,40,89,15,3,18,12,30,35,8,16,100,126
2021,2,22100757,1/30/2022,1610612762,Utah Jazz,0,0,1610612750,Minnesota Timberwolves,1,1,23,18,41,15,25,40,38,43,81,15,6,21,12,34,23,11,20,100,106
2021,2,22101095,3/24/2022,1610612739,Cleveland Cavaliers,0,0,1610612761,Toronto Raptors,1,1,25,24,49,12,18,30,37,42,79,18,4,22,11,32,24,9,13,89,104
2021,2,22101095,3/24/2022,1610612761,Toronto Raptors,1,1,1610612739,Cleveland Cavaliers,0,0,26,26,52,16,21,37,42,47,89,17,2,19,17,32,26,4,9,91,117
2014,2,21400198,11/24/2014,1610612746,LA Clippers,0,1,1610612766,Charlotte Hornets,1,0,30,26,56,15,17,32,45,43,88,8,2,10,13,31,28,6,8,88,113
2014,2,21400198,11/24/2014,1610612766,Charlotte Hornets,1,0,1610612746,LA Clippers,0,1,29,26,55,2,18,20,31,44,75,28,7,35,10,38,21,2,5,89,92
2023,2,22300373,12/20/2023,1610612738,Boston Celtics,0,1,1610612758,Sacramento Kings,1,0,29,21,50,22,20,42,51,41,92,20,4,24,15,28,35,4,9,94,144
2021,2,22100756,1/30/2022,1610612743,Denver Nuggets,0,1,1610612749,Milwaukee Bucks,1,0,30,15,45,23,20,43,53,35,88,7,3,10,7,28,39,6,10,95,136
2017,2,21700545,1/1/2018,1610612753,Orlando Magic,0,0,1610612751,Brooklyn Nets,1,1,29,36,65,6,25,31,35,61,96,19,6,25,23,43,16,7,12,94,95
2021,2,22101094,3/23/2022,1610612757,Portland Trail Blazers,1,0,1610612759,San Antonio Spurs,0,1,29,39,68,7,19,26,36,58,94,17,1,18,19,40,18,8,18,101,96
2016,2,21600914,3/3/2017,1610612742,Dallas Mavericks,1,1,1610612763,Memphis Grizzlies,0,0,34,21,55,5,22,27,39,43,82,21,6,27,11,35,23,4,9,92,104
2016,2,21600914,3/3/2017,1610612763,Memphis Grizzlies,0,0,1610612742,Dallas Mavericks,1,1,29,25,54,9,19,28,38,44,82,15,7,22,10,37,16,5,10,92,100
2021,2,22101094,3/23/2022,1610612759,San Antonio Spurs,0,1,1610612757,Portland Trail Blazers,1,0,27,23,50,19,25,44,46,48,94,22,2,24,18,32,34,5,14,101,133
2014,2,21400197,11/23/2014,1610612743,Denver Nuggets,0,1,1610612747,Los Angeles Lakers,1,0,24,29,53,10,27,37,34,56,90,23,15,38,18,47,20,10,16,106,101
2014,2,21400197,11/23/2014,1610612747,Los Angeles Lakers,1,0,1610612743,Denver Nuggets,0,1,30,35,65,3,21,24,33,56,89,25,9,34,14,45,15,7,13,107,94
2021,2,22100756,1/30/2022,1610612749,Milwaukee Bucks,1,0,1610612743,Denver Nuggets,0,1,27,21,48,10,20,30,37,41,78,16,6,22,7,36,23,8,15,96,100
2014,2,21400529,1/7/2015,1610612742,Dallas Mavericks,1,0,1610612765,Detroit Pistons,0,1,32,33,65,6,16,22,38,49,87,13,5,18,9,43,24,9,14,99,95
2014,2,21400529,1/7/2015,1610612765,Detroit Pistons,0,1,1610612742,Dallas Mavericks,1,0,33,43,76,10,11,21,43,54,97,12,2,14,20,34,22,9,16,99,108
2021,2,22101093,3/23/2022,1610612747,Los Angeles Lakers,1,0,1610612755,Philadelphia 76ers,0,1,39,28,67,11,19,30,50,47,97,10,6,16,15,36,25,7,12,102,121
2021,2,22101093,3/23/2022,1610612755,Philadelphia 76ers,0,1,1610612747,Los Angeles Lakers,1,0,37,27,64,10,17,27,47,44,91,22,6,28,10,36,26,6,7,101,126
2016,2,21600379,12/14/2016,1610612739,Cleveland Cavaliers,0,0,1610612763,Memphis Grizzlies,1,1,19,31,50,9,16,25,28,47,75,20,11,31,9,43,10,9,11,91,85
2016,2,21600379,12/14/2016,1610612763,Memphis Grizzlies,1,1,1610612739,Cleveland Cavaliers,0,0,23,35,58,12,11,23,35,46,81,11,5,16,15,34,22,10,17,90,93
2023,2,22300054,11/28/2023,1610612761,Toronto Raptors,0,0,1610612751,Brooklyn Nets,1,1,26,39,65,13,23,36,39,62,101,12,7,19,17,46,27,7,7,99,103
2021,2,22101092,3/23/2022,1610612742,Dallas Mavericks,1,1,1610612745,Houston Rockets,0,0,34,19,53,8,25,33,42,44,86,18,4,22,11,36,24,8,13,95,110
2021,2,22101092,3/23/2022,1610612745,Houston Rockets,0,0,1610612742,Dallas Mavericks,1,1,29,25,54,4,24,28,33,49,82,21,7,28,15,37,17,9,16,97,91
2014,2,21400196,11/23/2014,1610612744,Golden State Warriors,0,1,1610612760,Oklahoma City Thunder,1,0,26,42,68,7,18,25,33,60,93,18,6,24,16,46,26,3,10,97,91
2014,2,21400196,11/23/2014,1610612760,Oklahoma City Thunder,1,0,1610612744,Golden State Warriors,0,1,29,44,73,3,14,17,32,58,90,19,8,27,15,48,13,7,11,99,86
2022,2,22200651,1/15/2023,1610612751,Brooklyn Nets,1,0,1610612760,Oklahoma City Thunder,0,1,27,23,50,12,29,41,39,52,91,12,7,19,17,40,24,5,16,98,102
2021,2,22101091,3/23/2022,1610612753,Orlando Magic,0,0,1610612760,Oklahoma City Thunder,1,1,19,23,42,17,34,51,36,57,93,13,3,16,14,44,24,6,11,101,102
2021,2,22101091,3/23/2022,1610612760,Oklahoma City Thunder,1,1,1610612753,Orlando Magic,0,0,21,17,38,17,24,41,38,41,79,25,5,30,5,37,21,3,12,99,118
2022,2,22200654,1/15/2023,1610612757,Portland Trail Blazers,1,1,1610612742,Dallas Mavericks,0,0,26,15,41,17,27,44,43,42,85,37,5,42,13,30,28,3,8,98,140
2014,2,21400528,1/7/2015,1610612741,Chicago Bulls,1,0,1610612762,Utah Jazz,0,1,22,42,64,6,14,20,28,56,84,15,5,20,20,38,17,8,16,91,77
2014,2,21400528,1/7/2015,1610612762,Utah Jazz,0,1,1610612741,Chicago Bulls,1,0,32,30,62,5,11,16,37,41,78,18,6,24,15,30,21,5,16,90,97
2023,2,22300327,12/15/2023,1610612755,Philadelphia 76ers,1,1,1610612765,Detroit Pistons,0,0,27,34,61,14,23,37,41,57,98,28,3,31,23,37,24,3,12,103,124
2023,2,22300305,12/12/2023,1610612738,Boston Celtics,1,1,1610612739,Cleveland Cavaliers,0,0,20,20,40,18,26,44,38,46,84,26,0,26,16,30,23,6,15,97,120
2022,2,22200739,1/27/2023,1610612739,Cleveland Cavaliers,0,0,1610612760,Oklahoma City Thunder,1,1,31,28,59,8,21,29,39,49,88,14,4,18,13,39,27,5,10,93,100
2021,2,22100755,1/30/2022,1610612742,Dallas Mavericks,0,0,1610612753,Orlando Magic,1,1,23,20,43,16,22,38,39,42,81,14,4,18,11,33,22,8,18,98,108
2021,2,22100755,1/30/2022,1610612753,Orlando Magic,1,1,1610612742,Dallas Mavericks,0,0,32,18,50,11,23,34,43,41,84,13,3,16,11,33,26,9,16,97,110
2021,2,22101090,3/23/2022,1610612750,Minnesota Timberwolves,1,0,1610612756,Phoenix Suns,0,1,29,23,52,13,30,43,42,53,95,19,3,22,19,34,27,6,12,98,116
2021,2,22101090,3/23/2022,1610612756,Phoenix Suns,0,1,1610612750,Minnesota Timberwolves,1,0,33,20,53,12,21,33,45,41,86,23,6,29,14,30,30,5,13,96,125
2017,2,21700544,12/31/2017,1610612755,Philadelphia 76ers,0,1,1610612756,Phoenix Suns,1,0,33,20,53,10,14,24,43,34,77,27,7,34,13,26,24,9,21,102,123
2021,2,22100754,1/30/2022,1610612739,Cleveland Cavaliers,0,0,1610612765,Detroit Pistons,1,1,25,23,48,13,21,34,38,44,82,16,9,25,14,34,25,7,13,91,105
2021,2,22100754,1/30/2022,1610612765,Detroit Pistons,1,1,1610612739,Cleveland Cavaliers,0,0,32,33,65,10,16,26,42,49,91,21,4,25,19,33,26,6,9,91,115
2014,2,21400195,11/23/2014,1610612748,Miami Heat,1,1,1610612766,Charlotte Hornets,0,0,22,21,43,11,12,23,33,33,66,17,2,19,5,29,19,9,17,89,94
2014,2,21400195,11/23/2014,1610612766,Charlotte Hornets,0,0,1610612748,Miami Heat,1,1,30,28,58,7,14,21,37,42,79,12,4,16,9,35,18,4,11,89,93
2014,2,21401084,3/27/2015,1610612742,Dallas Mavericks,0,0,1610612759,San Antonio Spurs,1,1,27,37,64,4,14,18,31,51,82,10,5,15,16,38,15,8,18,92,76
2014,2,21401084,3/27/2015,1610612759,San Antonio Spurs,1,1,1610612742,Dallas Mavericks,0,0,28,30,58,9,17,26,37,47,84,11,3,14,15,33,28,9,14,90,94
2022,2,22200655,1/15/2023,1610612755,Philadelphia 76ers,0,1,1610612747,Los Angeles Lakers,1,0,31,20,51,12,22,34,43,42,85,15,4,19,9,35,29,4,10,95,113
2023,2,22300013,11/10/2023,1610612759,San Antonio Spurs,1,0,1610612750,Minnesota Timberwolves,0,1,31,27,58,12,22,34,43,49,92,12,7,19,13,40,29,6,14,104,110
2021,2,22100753,1/30/2022,1610612741,Chicago Bulls,1,1,1610612757,Portland Trail Blazers,0,0,37,21,58,13,19,32,50,40,90,17,1,18,8,33,36,4,7,95,130
2021,2,22100753,1/30/2022,1610612757,Portland Trail Blazers,0,0,1610612741,Chicago Bulls,1,1,25,19,44,18,21,39,43,40,83,12,4,16,7,36,23,10,12,95,116
2021,2,22101089,3/23/2022,1610612751,Brooklyn Nets,0,0,1610612763,Memphis Grizzlies,1,1,34,28,62,9,16,25,43,44,87,25,2,27,14,30,18,8,14,100,120
2021,2,22101089,3/23/2022,1610612763,Memphis Grizzlies,1,1,1610612751,Brooklyn Nets,0,0,28,35,63,19,19,38,47,54,101,19,3,22,23,32,28,6,13,100,132
2014,2,21400527,1/7/2015,1610612738,Boston Celtics,0,1,1610612751,Brooklyn Nets,1,0,30,40,70,5,13,18,35,53,88,14,3,17,15,40,22,3,7,89,89
2014,2,21400527,1/7/2015,1610612751,Brooklyn Nets,1,0,1610612738,Boston Celtics,0,1,27,33,60,3,11,14,30,44,74,18,8,26,16,31,18,8,18,89,81
2021,2,22100752,1/30/2022,1610612746,LA Clippers,0,1,1610612766,Charlotte Hornets,1,0,33,23,56,11,17,28,44,40,84,16,3,19,7,35,23,8,18,106,115
2014,2,21400194,11/23/2014,1610612738,Boston Celtics,1,0,1610612757,Portland Trail Blazers,0,1,32,40,72,5,18,23,37,58,95,9,3,12,13,47,17,7,8,96,88
2014,2,21400194,11/23/2014,1610612757,Portland Trail Blazers,0,1,1610612738,Boston Celtics,1,0,30,37,67,7,12,19,37,49,86,13,2,15,12,37,20,12,16,97,94
2021,2,22100752,1/30/2022,1610612766,Charlotte Hornets,1,0,1610612746,LA Clippers,0,1,24,40,64,8,26,34,32,66,98,18,9,27,16,56,24,5,9,105,90
2020,2,22000467,2/21/2021,1610612765,Detroit Pistons,0,0,1610612753,Orlando Magic,1,1,23,28,51,11,29,40,34,57,91,17,4,21,13,46,23,7,11,100,96
2014,2,21400193,11/23/2014,1610612746,LA Clippers,0,0,1610612763,Memphis Grizzlies,1,1,25,27,52,7,18,25,32,45,77,20,8,28,6,42,14,3,10,94,91
2014,2,21400193,11/23/2014,1610612763,Memphis Grizzlies,1,1,1610612746,LA Clippers,0,0,35,29,64,7,14,21,42,43,85,16,7,23,19,27,20,10,17,95,107
2022,2,22200680,1/19/2023,1610612761,Toronto Raptors,0,0,1610612750,Minnesota Timberwolves,1,1,32,27,59,14,14,28,46,41,87,20,7,27,13,31,26,12,16,102,126
2014,2,21401083,3/27/2015,1610612740,New Orleans Pelicans,1,1,1610612758,Sacramento Kings,0,0,34,30,64,9,11,20,43,41,84,7,5,12,16,28,25,5,12,87,102
2014,2,21401083,3/27/2015,1610612758,Sacramento Kings,0,0,1610612740,New Orleans Pelicans,1,1,28,36,64,7,8,15,35,44,79,11,7,18,12,35,14,5,11,87,88
2014,2,21400526,1/7/2015,1610612737,Atlanta Hawks,1,1,1610612763,Memphis Grizzlies,0,0,19,28,47,13,12,25,32,40,72,19,4,23,8,33,21,10,18,94,96
2014,2,21400526,1/7/2015,1610612763,Memphis Grizzlies,0,0,1610612737,Atlanta Hawks,1,1,30,32,62,5,12,17,35,44,79,11,0,11,12,32,20,17,21,95,86
2014,2,21400192,11/22/2014,1610612740,New Orleans Pelicans,0,1,1610612762,Utah Jazz,1,0,38,38,76,4,13,17,42,51,93,18,4,22,21,33,19,6,10,92,106
2014,2,21400192,11/22/2014,1610612762,Utah Jazz,1,0,1610612740,New Orleans Pelicans,0,1,28,29,57,5,9,14,33,38,71,23,6,29,13,28,15,11,18,91,94
2022,2,22200809,2/6/2023,1610612764,Washington Wizards,1,0,1610612739,Cleveland Cavaliers,0,1,29,25,54,6,22,28,35,47,82,15,4,19,9,40,20,9,14,95,91
2014,2,21401082,3/27/2015,1610612744,Golden State Warriors,0,1,1610612763,Memphis Grizzlies,1,0,23,36,59,16,15,31,39,51,90,13,4,17,19,35,28,9,14,94,107
2014,2,21401082,3/27/2015,1610612763,Memphis Grizzlies,1,0,1610612744,Golden State Warriors,0,1,29,34,63,5,8,13,34,42,76,11,4,15,12,31,19,15,19,93,84
2017,2,21700544,12/31/2017,1610612756,Phoenix Suns,1,0,1610612755,Philadelphia 76ers,0,1,27,34,61,10,17,27,37,51,88,25,8,33,17,39,18,11,16,102,109
2022,2,22200502,12/26/2022,1610612740,New Orleans Pelicans,1,1,1610612754,Indiana Pacers,0,0,29,21,50,12,28,40,41,49,90,19,5,24,21,31,30,9,16,97,113
2022,2,22200502,12/26/2022,1610612754,Indiana Pacers,0,0,1610612740,New Orleans Pelicans,1,1,26,22,48,9,26,35,35,48,83,14,6,20,8,43,23,10,13,96,93
2014,2,21400191,11/22/2014,1610612751,Brooklyn Nets,0,0,1610612759,San Antonio Spurs,1,1,25,39,64,9,18,27,34,57,91,10,0,10,15,42,24,7,12,92,87
2021,2,22101088,3/23/2022,1610612744,Golden State Warriors,0,1,1610612748,Miami Heat,1,0,25,16,41,15,21,36,40,37,77,23,4,27,12,27,23,8,13,91,118
2021,2,22101088,3/23/2022,1610612748,Miami Heat,1,0,1610612744,Golden State Warriors,0,1,23,26,49,14,22,36,37,48,85,16,5,21,12,39,26,5,10,92,104
2020,2,22000466,2/21/2021,1610612739,Cleveland Cavaliers,1,0,1610612760,Oklahoma City Thunder,0,1,31,18,49,8,27,35,39,45,84,15,5,20,15,33,22,9,18,95,101
2017,2,21700543,12/31/2017,1610612758,Sacramento Kings,1,0,1610612763,Memphis Grizzlies,0,1,28,34,62,9,15,24,37,49,86,13,12,25,16,42,20,11,16,98,96
2022,2,22200754,1/29/2023,1610612746,LA Clippers,0,0,1610612739,Cleveland Cavaliers,1,1,35,35,70,2,17,19,37,52,89,23,4,27,22,32,17,9,15,95,99
2023,2,22300305,12/12/2023,1610612739,Cleveland Cavaliers,0,0,1610612738,Boston Celtics,1,1,25,22,47,19,26,45,44,48,92,6,3,9,14,37,27,9,13,96,113
2023,2,22300373,12/20/2023,1610612758,Sacramento Kings,1,0,1610612738,Boston Celtics,0,1,22,25,47,21,23,44,43,48,91,12,11,23,16,37,29,6,7,94,119
2014,2,21400191,11/22/2014,1610612759,San Antonio Spurs,1,1,1610612751,Brooklyn Nets,0,0,33,25,58,8,13,21,41,38,79,9,2,11,7,33,29,5,15,91,99
2022,2,22200661,1/16/2023,1610612748,Miami Heat,0,0,1610612737,Atlanta Hawks,1,1,35,23,58,8,23,31,43,46,89,19,1,20,16,30,30,9,16,99,113
2022,2,22200658,1/16/2023,1610612739,Cleveland Cavaliers,1,1,1610612740,New Orleans Pelicans,0,0,30,22,52,9,19,28,39,41,80,26,7,33,15,29,22,9,15,96,113
2022,2,22200739,1/27/2023,1610612760,Oklahoma City Thunder,1,1,1610612739,Cleveland Cavaliers,0,0,30,28,58,10,8,18,40,36,76,22,3,25,11,27,19,9,15,93,112
2014,2,21400525,1/7/2015,1610612752,New York Knicks,0,0,1610612764,Washington Wizards,1,1,23,33,56,11,15,26,34,48,82,12,4,16,11,38,18,9,15,93,91
2014,2,21400525,1/7/2015,1610612764,Washington Wizards,1,1,1610612752,New York Knicks,0,0,31,29,60,8,8,16,39,37,76,15,6,21,11,31,28,11,16,93,101
2023,2,22300369,12/20/2023,1610612761,Toronto Raptors,1,0,1610612743,Denver Nuggets,0,1,34,29,63,9,18,27,43,47,90,9,4,13,12,37,26,9,11,94,104
2022,2,22200766,1/31/2023,1610612741,Chicago Bulls,1,0,1610612746,LA Clippers,0,1,26,27,53,12,12,24,38,39,77,15,6,21,7,34,26,15,20,100,103
2017,2,21700543,12/31/2017,1610612763,Memphis Grizzlies,0,1,1610612758,Sacramento Kings,1,0,27,19,46,14,16,30,41,35,76,18,6,24,7,31,22,6,16,97,114
2020,2,22000466,2/21/2021,1610612760,Oklahoma City Thunder,0,1,1610612739,Cleveland Cavaliers,1,0,30,21,51,13,15,28,43,36,79,18,6,24,7,32,22,9,15,96,117
2020,2,22000756,4/4/2021,1610612746,LA Clippers,1,1,1610612747,Los Angeles Lakers,0,0,27,31,58,14,14,28,41,45,86,8,1,9,15,31,23,9,20,96,104
2020,2,22000756,4/4/2021,1610612747,Los Angeles Lakers,0,0,1610612746,LA Clippers,1,1,25,32,57,7,16,23,32,48,80,15,5,20,11,39,16,10,19,96,86
2022,2,22200754,1/29/2023,1610612739,Cleveland Cavaliers,1,1,1610612746,LA Clippers,0,0,24,21,45,20,13,33,44,34,78,14,5,19,6,30,35,6,13,93,122
2014,2,21400524,1/7/2015,1610612749,Milwaukee Bucks,0,1,1610612755,Philadelphia 76ers,1,0,33,26,59,8,9,17,41,35,76,7,4,11,7,31,32,11,26,100,97
2014,2,21400524,1/7/2015,1610612755,Philadelphia 76ers,1,0,1610612749,Milwaukee Bucks,0,1,23,35,58,2,23,25,25,58,83,25,4,29,20,40,14,14,24,101,77
2014,2,21400190,11/22/2014,1610612749,Milwaukee Bucks,1,0,1610612764,Washington Wizards,0,1,31,38,69,5,10,15,36,48,84,23,3,26,16,34,21,7,15,95,100
2014,2,21400190,11/22/2014,1610612764,Washington Wizards,0,1,1610612749,Milwaukee Bucks,1,0,35,40,75,8,10,18,43,50,93,17,5,22,25,28,27,11,17,95,111
2016,2,21600913,3/3/2017,1610612737,Atlanta Hawks,1,0,1610612739,Cleveland Cavaliers,0,1,39,26,65,10,16,26,49,42,91,22,8,30,13,31,30,7,12,104,130
2016,2,21600913,3/3/2017,1610612739,Cleveland Cavaliers,0,1,1610612737,Atlanta Hawks,1,0,22,18,40,25,21,46,47,39,86,16,4,20,7,34,31,7,14,104,135
2022,2,22200680,1/19/2023,1610612750,Minnesota Timberwolves,1,1,1610612761,Toronto Raptors,0,0,28,21,49,17,23,40,45,44,89,21,2,23,14,31,31,8,15,103,128
2022,2,22200651,1/15/2023,1610612760,Oklahoma City Thunder,0,1,1610612751,Brooklyn Nets,1,0,28,31,59,12,19,31,40,50,90,20,6,26,14,38,21,4,9,99,112
2022,2,22200770,2/1/2023,1610612755,Philadelphia 76ers,1,1,1610612753,Orlando Magic,0,0,20,23,43,14,21,35,34,44,78,23,3,26,9,36,27,10,19,100,105
2022,2,22200738,1/27/2023,1610612748,Miami Heat,1,1,1610612753,Orlando Magic,0,0,29,23,52,10,23,33,39,46,85,22,4,26,9,40,28,5,11,98,110
2014,2,21400189,11/22/2014,1610612750,Minnesota Timberwolves,1,0,1610612758,Sacramento Kings,0,1,31,42,73,6,11,17,37,53,90,21,6,27,17,40,23,4,10,98,101
2014,2,21400189,11/22/2014,1610612758,Sacramento Kings,0,1,1610612750,Minnesota Timberwolves,1,0,32,23,55,8,18,26,40,41,81,25,5,30,17,26,24,10,19,97,113
2023,2,22300073,10/25/2023,1610612759,San Antonio Spurs,1,0,1610612742,Dallas Mavericks,0,1,35,19,54,11,24,35,46,43,89,16,6,22,12,35,33,6,19,107,119
2014,2,21400523,1/7/2015,1610612739,Cleveland Cavaliers,1,0,1610612745,Houston Rockets,0,1,24,29,53,10,19,29,34,48,82,15,4,19,16,34,16,9,15,92,93
2014,2,21400523,1/7/2015,1610612745,Houston Rockets,0,1,1610612739,Cleveland Cavaliers,1,0,27,25,52,12,22,34,39,47,86,15,9,24,24,29,26,9,17,91,105
2022,2,22200660,1/16/2023,1610612764,Washington Wizards,1,0,1610612744,Golden State Warriors,0,1,28,23,51,14,21,35,42,44,86,20,3,23,9,35,31,8,13,102,118
2022,2,22200653,1/15/2023,1610612743,Denver Nuggets,1,1,1610612753,Orlando Magic,0,0,35,15,50,13,26,39,48,41,89,10,9,19,15,30,32,7,16,99,119
2022,2,22200772,2/1/2023,1610612738,Boston Celtics,1,1,1610612751,Brooklyn Nets,0,0,27,11,38,26,28,54,53,39,92,7,3,10,12,28,28,8,12,97,139
2014,2,21401081,3/27/2015,1610612745,Houston Rockets,1,1,1610612750,Minnesota Timberwolves,0,0,24,15,39,20,24,44,44,39,83,12,5,17,15,26,34,6,18,96,120
2014,2,21401081,3/27/2015,1610612750,Minnesota Timberwolves,0,0,1610612745,Houston Rockets,1,1,31,31,62,6,8,14,37,39,76,30,4,34,11,31,26,10,14,96,110
2022,2,22200765,1/31/2023,1610612752,New York Knicks,1,0,1610612747,Los Angeles Lakers,0,1,37,27,64,7,27,34,44,54,98,28,4,32,15,40,27,6,9,106,123
2014,2,21400188,11/22/2014,1610612742,Dallas Mavericks,0,0,1610612745,Houston Rockets,1,1,29,24,53,6,29,35,35,53,88,16,6,22,21,33,17,8,16,93,92
2014,2,21400188,11/22/2014,1610612745,Houston Rockets,1,1,1610612742,Dallas Mavericks,0,0,15,21,36,15,31,46,30,52,82,20,3,23,18,36,17,6,18,93,95
2023,2,22300177,11/12/2023,1610612752,New York Knicks,1,1,1610612766,Charlotte Hornets,0,0,32,19,51,15,21,36,47,40,87,20,10,30,14,29,25,5,9,93,129
2021,2,22100750,1/29/2022,1610612744,Golden State Warriors,1,1,1610612751,Brooklyn Nets,0,0,26,27,53,14,31,45,40,58,98,16,2,18,23,37,24,7,12,99,110
2021,2,22100750,1/29/2022,1610612751,Brooklyn Nets,0,0,1610612744,Golden State Warriors,1,1,28,42,70,11,17,28,39,59,98,17,4,21,21,40,21,8,11,97,106
2021,2,22101087,3/23/2022,1610612738,Boston Celtics,1,1,1610612762,Utah Jazz,0,0,31,17,48,19,17,36,50,34,84,6,1,7,10,24,37,8,13,91,125
2021,2,22101087,3/23/2022,1610612762,Utah Jazz,0,0,1610612738,Boston Celtics,1,1,27,25,52,8,28,36,35,53,88,19,2,21,19,34,13,8,14,91,97
2014,2,21400522,1/7/2015,1610612740,New Orleans Pelicans,0,0,1610612766,Charlotte Hornets,1,1,30,32,62,6,12,18,36,44,80,16,8,24,11,35,19,9,14,95,94
2014,2,21400522,1/7/2015,1610612766,Charlotte Hornets,1,1,1610612740,New Orleans Pelicans,0,0,33,39,72,4,10,14,37,49,86,20,6,26,14,38,18,6,12,95,98
2014,2,21400187,11/22/2014,1610612752,New York Knicks,1,1,1610612755,Philadelphia 76ers,0,0,27,22,49,6,11,17,33,33,66,19,2,21,7,28,15,8,20,90,91
2014,2,21400187,11/22/2014,1610612755,Philadelphia 76ers,0,0,1610612752,New York Knicks,1,1,22,27,49,8,18,26,30,45,75,15,10,25,13,38,13,7,18,91,83
2022,2,22200679,1/19/2023,1610612744,Golden State Warriors,0,0,1610612738,Boston Celtics,1,1,22,26,48,18,34,52,40,60,100,20,3,23,12,49,28,10,16,116,118
2014,2,21401080,3/27/2015,1610612747,Los Angeles Lakers,0,0,1610612761,Toronto Raptors,1,1,25,42,67,4,13,17,29,55,84,21,8,29,23,35,14,8,13,87,83
2014,2,21401080,3/27/2015,1610612761,Toronto Raptors,1,1,1610612747,Los Angeles Lakers,0,0,29,28,57,7,11,18,36,39,75,15,6,21,9,33,25,6,11,87,94
2014,2,21400186,11/22/2014,1610612739,Cleveland Cavaliers,1,0,1610612761,Toronto Raptors,0,1,32,33,65,3,13,16,35,46,81,20,9,29,17,30,24,8,20,97,93
2014,2,21400186,11/22/2014,1610612761,Toronto Raptors,0,1,1610612739,Cleveland Cavaliers,1,0,24,32,56,8,16,24,32,48,80,38,4,42,11,39,20,4,8,99,110
2023,2,22300032,11/17/2023,1610612759,San Antonio Spurs,1,0,1610612758,Sacramento Kings,0,1,28,28,56,15,21,36,43,49,92,19,4,23,10,41,33,10,15,106,120
2022,2,22200736,1/27/2023,1610612754,Indiana Pacers,1,0,1610612749,Milwaukee Bucks,0,1,36,20,56,13,20,33,49,40,89,20,8,28,5,38,22,11,13,110,131
2014,2,21401079,3/27/2015,1610612738,Boston Celtics,0,1,1610612752,New York Knicks,1,0,25,24,49,4,16,20,29,40,69,34,9,43,13,29,18,9,16,93,96
2014,2,21401079,3/27/2015,1610612752,New York Knicks,1,0,1610612738,Boston Celtics,0,1,31,32,63,7,17,24,38,49,87,9,5,14,15,38,23,6,14,93,92
2023,2,22300073,10/25/2023,1610612742,Dallas Mavericks,0,1,1610612759,San Antonio Spurs,1,0,32,20,52,15,32,47,47,52,99,17,6,23,15,38,24,8,12,106,126
2022,2,22200771,2/1/2023,1610612757,Portland Trail Blazers,0,1,1610612763,Memphis Grizzlies,1,0,27,24,51,14,22,36,41,46,87,26,1,27,12,34,24,8,13,100,122
2022,2,22200738,1/27/2023,1610612753,Orlando Magic,0,0,1610612748,Miami Heat,1,1,21,14,35,12,22,34,33,36,69,27,5,32,5,34,21,9,20,98,105
2023,2,22300188,11/13/2023,1610612738,Boston Celtics,1,1,1610612752,New York Knicks,0,0,21,15,36,19,24,43,40,39,79,15,1,16,11,28,27,5,11,85,114
2023,2,22300048,11/24/2023,1610612745,Houston Rockets,1,1,1610612743,Denver Nuggets,0,0,28,25,53,12,17,29,40,42,82,13,2,15,8,34,25,8,14,97,105
2021,2,22100749,1/29/2022,1610612763,Memphis Grizzlies,1,1,1610612764,Washington Wizards,0,0,33,36,69,13,18,31,46,54,100,10,2,12,23,32,24,6,9,93,115
2021,2,22100749,1/29/2022,1610612764,Washington Wizards,0,0,1610612763,Memphis Grizzlies,1,1,25,30,55,10,19,29,35,49,84,15,6,21,13,41,27,8,12,93,95
2017,2,21700542,12/31/2017,1610612746,LA Clippers,1,1,1610612766,Charlotte Hornets,0,0,26,22,48,10,18,28,36,40,76,24,3,27,9,32,24,10,17,97,106
2014,2,21400521,1/6/2015,1610612759,San Antonio Spurs,1,0,1610612765,Detroit Pistons,0,1,27,31,58,9,12,21,36,43,79,23,11,34,17,30,24,10,17,95,104
2014,2,21400521,1/6/2015,1610612765,Detroit Pistons,0,1,1610612759,San Antonio Spurs,1,0,38,30,68,3,16,19,41,46,87,20,8,28,20,30,19,6,15,95,105
2014,2,21400185,11/22/2014,1610612748,Miami Heat,0,1,1610612753,Orlando Magic,1,0,25,20,45,12,14,26,37,34,71,13,5,18,11,26,17,10,16,86,99
2022,2,22200652,1/15/2023,1610612759,San Antonio Spurs,1,0,1610612758,Sacramento Kings,0,1,38,29,67,10,16,26,48,45,93,13,7,20,16,34,27,5,10,95,119
2014,2,21400185,11/22/2014,1610612753,Orlando Magic,1,0,1610612748,Miami Heat,0,1,32,30,62,3,13,16,35,43,78,19,8,27,19,27,18,7,15,86,92
2021,2,22101086,3/23/2022,1610612754,Indiana Pacers,1,0,1610612758,Sacramento Kings,0,1,28,27,55,14,22,36,42,49,91,11,0,11,14,35,34,7,15,99,109
2021,2,22101086,3/23/2022,1610612758,Sacramento Kings,0,1,1610612754,Indiana Pacers,1,0,31,14,45,12,25,37,43,39,82,12,5,17,6,36,26,11,17,98,110
2017,2,21700542,12/31/2017,1610612766,Charlotte Hornets,0,0,1610612746,LA Clippers,1,1,25,35,60,11,22,33,36,57,93,15,4,19,21,37,23,9,17,99,98
2022,2,22200458,12/19/2022,1610612757,Portland Trail Blazers,0,0,1610612760,Oklahoma City Thunder,1,1,28,23,51,16,21,37,44,44,88,17,4,21,16,30,26,7,16,99,121
2014,2,21400184,11/22/2014,1610612754,Indiana Pacers,1,0,1610612756,Phoenix Suns,0,1,24,37,61,7,16,23,31,53,84,14,6,20,16,41,18,10,14,92,83
2014,2,21400184,11/22/2014,1610612756,Phoenix Suns,0,1,1610612754,Indiana Pacers,1,0,26,28,54,12,19,31,38,47,85,18,2,20,14,35,17,9,13,93,106
2014,2,21401078,3/27/2015,1610612739,Cleveland Cavaliers,0,0,1610612751,Brooklyn Nets,1,1,29,22,51,8,22,30,37,44,81,16,4,20,9,38,17,6,17,98,98
2021,2,22101085,3/23/2022,1610612737,Atlanta Hawks,0,0,1610612765,Detroit Pistons,1,1,23,25,48,14,30,44,37,55,92,13,2,15,10,47,21,10,14,104,101
2021,2,22101085,3/23/2022,1610612765,Detroit Pistons,1,1,1610612737,Atlanta Hawks,0,0,32,23,55,12,21,33,44,44,88,22,3,25,12,33,30,8,16,105,122
2014,2,21401078,3/27/2015,1610612751,Brooklyn Nets,1,1,1610612739,Cleveland Cavaliers,0,0,31,32,63,9,14,23,40,46,86,17,2,19,14,34,21,10,15,98,106
2022,2,22200770,2/1/2023,1610612753,Orlando Magic,0,0,1610612755,Philadelphia 76ers,1,1,27,22,49,6,32,38,33,54,87,22,7,29,16,41,12,7,15,99,94
2022,2,22200653,1/15/2023,1610612753,Orlando Magic,0,0,1610612743,Denver Nuggets,1,1,34,21,55,7,22,29,41,43,84,27,7,34,14,31,24,10,13,100,116
2023,2,22300206,11/18/2023,1610612763,Memphis Grizzlies,0,1,1610612759,San Antonio Spurs,1,0,29,24,53,11,22,33,40,46,86,29,7,36,20,29,23,5,14,97,120
2021,2,22101084,3/23/2022,1610612752,New York Knicks,0,1,1610612766,Charlotte Hornets,1,0,23,15,38,20,25,45,43,40,83,15,2,17,9,31,30,5,9,90,121
2021,2,22101084,3/23/2022,1610612766,Charlotte Hornets,1,0,1610612752,New York Knicks,0,1,29,14,43,13,33,46,42,47,89,9,8,17,16,35,26,5,11,91,106
2022,2,22200458,12/19/2022,1610612760,Oklahoma City Thunder,1,1,1610612757,Portland Trail Blazers,0,0,29,28,57,11,20,31,40,48,88,32,5,37,17,34,20,5,12,101,123
2014,2,21400183,11/21/2014,1610612741,Chicago Bulls,0,0,1610612757,Portland Trail Blazers,1,1,22,39,61,8,14,22,30,53,83,19,9,28,14,43,14,8,14,98,87
2014,2,21400183,11/21/2014,1610612757,Portland Trail Blazers,1,1,1610612741,Chicago Bulls,0,0,30,33,63,9,7,16,39,40,79,18,4,22,6,37,26,9,17,97,105
2017,2,21700541,12/31/2017,1610612742,Dallas Mavericks,0,1,1610612760,Oklahoma City Thunder,1,0,31,24,55,15,19,34,46,43,89,9,5,14,11,35,26,4,8,94,116
2017,2,21700541,12/31/2017,1610612760,Oklahoma City Thunder,1,0,1610612742,Dallas Mavericks,0,1,33,24,57,10,22,32,43,46,89,17,6,23,18,31,18,5,11,94,113
2016,2,21600378,12/14/2016,1610612747,Los Angeles Lakers,0,0,1610612751,Brooklyn Nets,1,1,29,35,64,6,21,27,35,56,91,21,13,34,20,43,11,7,10,98,97
2016,2,21600378,12/14/2016,1610612751,Brooklyn Nets,1,1,1610612747,Los Angeles Lakers,0,0,22,29,51,11,24,35,33,53,86,30,10,40,21,35,19,8,16,98,107
2022,2,22200771,2/1/2023,1610612763,Memphis Grizzlies,1,0,1610612757,Portland Trail Blazers,0,1,32,18,50,9,28,37,41,46,87,21,7,28,14,36,28,3,13,100,112
2022,2,22201055,3/18/2023,1610612752,New York Knicks,1,1,1610612743,Denver Nuggets,0,0,32,19,51,9,23,32,41,42,83,25,3,28,15,29,23,3,12,92,116
2023,2,22300204,11/18/2023,1610612748,Miami Heat,0,0,1610612741,Chicago Bulls,1,1,21,20,41,12,24,36,33,44,77,19,4,23,11,35,23,9,15,92,97
2017,2,21700540,12/31/2017,1610612745,Houston Rockets,1,1,1610612747,Los Angeles Lakers,0,0,31,23,54,18,34,52,49,57,106,32,7,39,17,43,29,6,12,117,148
2017,2,21700540,12/31/2017,1610612747,Los Angeles Lakers,0,0,1610612745,Houston Rockets,1,1,43,37,80,10,15,25,53,52,105,26,11,37,22,37,31,7,16,116,142
2021,2,22101083,3/22/2022,1610612743,Denver Nuggets,1,1,1610612746,LA Clippers,0,0,29,22,51,16,16,32,45,38,83,21,2,23,10,29,31,3,11,96,127
2021,2,22101083,3/22/2022,1610612746,LA Clippers,0,0,1610612743,Denver Nuggets,1,1,32,22,54,10,22,32,42,44,86,21,5,26,9,38,27,4,6,94,115
2014,2,21400182,11/21/2014,1610612744,Golden State Warriors,1,1,1610612762,Utah Jazz,0,0,35,24,59,6,17,23,41,41,82,13,6,19,10,33,28,12,13,94,101
2014,2,21400182,11/21/2014,1610612762,Utah Jazz,0,0,1610612744,Golden State Warriors,1,1,29,36,65,6,11,17,35,47,82,12,7,19,16,36,26,10,20,95,88
2022,2,22201162,4/1/2023,1610612740,New Orleans Pelicans,1,1,1610612746,LA Clippers,0,0,35,34,69,7,10,17,42,44,86,31,4,35,16,30,21,5,7,93,122
2014,2,21400520,1/6/2015,1610612749,Milwaukee Bucks,1,0,1610612756,Phoenix Suns,0,1,34,34,68,3,17,20,37,51,88,19,3,22,18,35,22,7,17,99,96
2014,2,21400520,1/6/2015,1610612756,Phoenix Suns,0,1,1610612749,Milwaukee Bucks,1,0,30,26,56,7,18,25,37,44,81,21,6,27,14,32,19,9,20,99,102
2023,2,22300204,11/18/2023,1610612741,Chicago Bulls,1,1,1610612748,Miami Heat,0,0,20,16,36,16,29,45,36,45,81,14,5,19,12,33,24,9,13,92,102
2021,2,22100747,1/29/2022,1610612755,Philadelphia 76ers,1,1,1610612758,Sacramento Kings,0,0,24,16,40,12,18,30,36,34,70,19,7,26,5,34,24,9,18,93,103
2021,2,22101082,3/22/2022,1610612741,Chicago Bulls,0,0,1610612749,Milwaukee Bucks,1,1,26,33,59,13,20,33,39,53,92,7,6,13,7,49,21,4,7,100,98
2021,2,22101082,3/22/2022,1610612749,Milwaukee Bucks,1,1,1610612741,Chicago Bulls,0,0,38,16,54,12,16,28,50,32,82,14,6,20,6,28,26,9,15,100,126
2022,2,22200758,1/30/2023,1610612750,Minnesota Timberwolves,1,0,1610612758,Sacramento Kings,0,1,31,22,53,12,27,39,43,49,92,13,12,25,11,43,26,15,18,109,111
2022,2,22200772,2/1/2023,1610612751,Brooklyn Nets,0,0,1610612738,Boston Celtics,1,1,27,22,49,9,30,39,36,52,88,15,3,18,6,48,19,4,7,96,96
2014,2,21400519,1/5/2015,1610612737,Atlanta Hawks,0,1,1610612746,LA Clippers,1,0,23,31,54,13,14,27,36,45,81,22,11,33,12,38,25,5,12,98,107
2022,2,22200767,1/31/2023,1610612766,Charlotte Hornets,0,0,1610612749,Milwaukee Bucks,1,1,31,41,72,11,28,39,42,69,111,20,6,26,20,52,27,7,11,114,115
2023,2,22300074,10/25/2023,1610612757,Portland Trail Blazers,0,0,1610612746,LA Clippers,1,1,34,27,61,10,22,32,44,49,93,13,4,17,19,33,20,11,18,99,111
2022,2,22201161,4/1/2023,1610612742,Dallas Mavericks,0,0,1610612748,Miami Heat,1,1,33,10,43,14,20,34,47,30,77,14,2,16,1,29,32,6,14,96,122
2022,2,22201162,4/1/2023,1610612746,LA Clippers,0,0,1610612740,New Orleans Pelicans,1,1,31,25,56,11,18,29,42,43,85,19,4,23,15,30,25,6,13,94,114
2014,2,21400181,11/21/2014,1610612740,New Orleans Pelicans,0,0,1610612743,Denver Nuggets,1,1,26,36,62,5,11,16,31,47,78,30,4,34,12,37,19,8,13,95,97
2014,2,21400181,11/21/2014,1610612743,Denver Nuggets,1,1,1610612740,New Orleans Pelicans,0,0,32,26,58,11,13,24,43,39,82,20,5,25,8,35,24,7,10,96,117
2021,2,22100747,1/29/2022,1610612758,Sacramento Kings,0,0,1610612755,Philadelphia 76ers,1,1,24,23,47,12,23,35,36,46,82,17,3,20,13,35,24,8,13,93,101
2021,2,22101081,3/22/2022,1610612737,Atlanta Hawks,0,1,1610612752,New York Knicks,1,0,25,20,45,15,21,36,40,41,81,22,5,27,11,32,26,12,14,96,117
2021,2,22101081,3/22/2022,1610612752,New York Knicks,1,0,1610612737,Atlanta Hawks,0,1,29,23,52,13,21,34,42,44,86,14,12,26,16,34,20,7,14,96,111
2022,2,22201055,3/18/2023,1610612743,Denver Nuggets,0,0,1610612752,New York Knicks,1,1,31,20,51,12,21,33,43,41,84,12,3,15,11,31,30,9,13,94,110
2023,2,22300159,11/8/2023,1610612738,Boston Celtics,0,0,1610612755,Philadelphia 76ers,1,1,21,23,44,15,32,47,36,55,91,16,3,19,12,44,28,7,13,101,103
2023,2,22300074,10/25/2023,1610612746,LA Clippers,1,1,1610612757,Portland Trail Blazers,0,0,31,25,56,16,18,34,47,43,90,13,3,16,18,27,36,10,18,98,123
2014,2,21400180,11/21/2014,1610612742,Dallas Mavericks,1,1,1610612747,Los Angeles Lakers,0,0,33,14,47,18,17,35,51,31,82,20,8,28,14,20,37,3,9,91,140
2014,2,21400180,11/21/2014,1610612747,Los Angeles Lakers,0,0,1610612742,Dallas Mavericks,1,1,39,33,72,5,8,13,44,41,85,13,8,21,15,30,24,4,10,90,106
2021,2,22100746,1/29/2022,1610612742,Dallas Mavericks,1,1,1610612754,Indiana Pacers,0,0,35,27,62,16,18,34,51,45,96,14,8,22,13,37,31,1,5,97,132
2017,2,21700539,12/31/2017,1610612738,Boston Celtics,1,1,1610612751,Brooklyn Nets,0,0,25,21,46,14,19,33,39,40,79,16,9,25,10,37,21,5,17,98,108
2021,2,22101080,3/22/2022,1610612744,Golden State Warriors,0,0,1610612753,Orlando Magic,1,1,23,30,53,11,21,32,34,51,85,11,5,16,15,38,21,9,18,95,90
2022,2,22200681,1/19/2023,1610612756,Phoenix Suns,1,1,1610612751,Brooklyn Nets,0,0,28,29,57,11,17,28,39,46,85,28,13,41,17,34,30,10,16,101,117
2021,2,22101080,3/22/2022,1610612753,Orlando Magic,1,1,1610612744,Golden State Warriors,0,0,24,19,43,10,26,36,34,45,79,16,4,20,8,37,25,6,14,96,94
2017,2,21700539,12/31/2017,1610612751,Brooklyn Nets,0,0,1610612738,Boston Celtics,1,1,28,31,59,11,25,36,39,56,95,16,3,19,16,43,25,7,11,97,105
2014,2,21401077,3/27/2015,1610612737,Atlanta Hawks,1,1,1610612748,Miami Heat,0,0,31,23,54,6,12,18,37,35,72,19,5,24,7,32,31,9,17,93,99
2014,2,21401077,3/27/2015,1610612748,Miami Heat,0,0,1610612737,Atlanta Hawks,1,1,21,26,47,11,24,35,32,50,82,11,4,15,15,37,20,12,19,94,86
2022,2,22201161,4/1/2023,1610612748,Miami Heat,1,1,1610612742,Dallas Mavericks,0,0,32,17,49,13,24,37,45,41,86,26,3,29,13,30,27,3,11,97,129
2022,2,22200810,2/6/2023,1610612746,LA Clippers,0,1,1610612751,Brooklyn Nets,1,0,32,30,62,12,18,30,44,48,92,24,6,30,14,37,20,4,9,100,124
2022,2,22200766,1/31/2023,1610612746,LA Clippers,0,1,1610612741,Chicago Bulls,1,0,25,24,49,12,32,44,37,56,93,22,4,26,12,48,24,6,8,100,108
2023,2,22300206,11/18/2023,1610612759,San Antonio Spurs,1,0,1610612763,Memphis Grizzlies,0,1,21,22,43,15,25,40,36,47,83,21,5,26,13,36,26,7,15,96,108
2023,2,22300158,11/8/2023,1610612754,Indiana Pacers,1,1,1610612762,Utah Jazz,0,0,39,21,60,13,28,41,52,49,101,17,3,20,16,34,26,3,12,105,134
2017,2,21700538,12/31/2017,1610612750,Minnesota Timberwolves,0,1,1610612754,Indiana Pacers,1,0,37,30,67,4,15,19,41,45,86,21,4,25,16,31,20,3,8,88,107
2017,2,21700538,12/31/2017,1610612754,Indiana Pacers,1,0,1610612750,Minnesota Timberwolves,0,1,23,37,60,10,15,25,33,52,85,14,4,18,22,33,20,11,17,90,90
2022,2,22200681,1/19/2023,1610612751,Brooklyn Nets,0,0,1610612756,Phoenix Suns,1,1,32,24,56,11,15,26,43,39,82,15,10,25,5,39,27,4,13,101,112
2014,2,21400179,11/21/2014,1610612739,Cleveland Cavaliers,0,0,1610612764,Washington Wizards,1,1,21,27,48,6,21,27,27,48,75,18,5,23,12,38,13,10,19,92,78
2014,2,21400179,11/21/2014,1610612764,Washington Wizards,1,1,1610612739,Cleveland Cavaliers,0,0,37,37,74,4,6,10,41,43,84,5,4,9,12,33,24,12,17,93,91
2021,2,22101079,3/21/2022,1610612742,Dallas Mavericks,1,1,1610612750,Minnesota Timberwolves,0,0,26,11,37,14,32,46,40,43,83,16,5,21,8,37,27,9,12,97,110
2021,2,22101079,3/21/2022,1610612750,Minnesota Timberwolves,0,0,1610612742,Dallas Mavericks,1,1,23,32,55,13,23,36,36,55,91,23,6,29,18,42,21,5,9,98,108
2022,2,22200685,1/20/2023,1610612739,Cleveland Cavaliers,1,0,1610612744,Golden State Warriors,0,1,28,23,51,14,19,33,42,42,84,16,3,19,11,32,24,9,15,98,114
2014,2,21400519,1/5/2015,1610612746,LA Clippers,1,0,1610612737,Atlanta Hawks,0,1,26,23,49,7,18,25,33,41,74,25,8,33,11,35,23,13,21,98,98
2014,2,21400178,11/21/2014,1610612751,Brooklyn Nets,0,1,1610612760,Oklahoma City Thunder,1,0,26,26,52,5,10,15,31,36,67,27,3,30,12,25,17,9,19,88,94
2014,2,21400178,11/21/2014,1610612760,Oklahoma City Thunder,1,0,1610612751,Brooklyn Nets,0,1,34,31,65,4,16,20,38,47,85,12,7,19,17,32,18,2,14,90,92
2022,2,22200662,1/16/2023,1610612750,Minnesota Timberwolves,1,0,1610612762,Utah Jazz,0,1,28,32,60,18,23,41,46,55,101,15,3,18,20,37,28,0,6,99,125
2022,2,22200661,1/16/2023,1610612737,Atlanta Hawks,1,1,1610612748,Miami Heat,0,0,32,17,49,13,14,27,45,31,76,18,4,22,4,31,27,10,16,99,121
2021,2,22101078,3/21/2022,1610612738,Boston Celtics,0,1,1610612760,Oklahoma City Thunder,1,0,29,17,46,15,25,40,44,42,86,29,5,34,10,33,22,5,9,98,132
2021,2,22101078,3/21/2022,1610612760,Oklahoma City Thunder,1,0,1610612738,Boston Celtics,0,1,31,25,56,17,20,37,48,45,93,10,4,14,11,38,23,8,11,99,123
2014,2,21400518,1/5/2015,1610612744,Golden State Warriors,1,1,1610612760,Oklahoma City Thunder,0,0,26,34,60,15,13,28,41,47,88,20,12,32,13,39,27,10,12,102,117
2014,2,21400518,1/5/2015,1610612760,Oklahoma City Thunder,0,0,1610612744,Golden State Warriors,1,1,25,45,70,5,23,28,30,68,98,26,8,34,23,48,19,8,12,104,91
2022,2,22200759,1/30/2023,1610612744,Golden State Warriors,0,1,1610612760,Oklahoma City Thunder,1,0,26,17,43,20,27,47,46,44,90,16,4,20,8,37,37,10,15,109,128
2023,2,22300141,11/5/2023,1610612759,San Antonio Spurs,1,0,1610612761,Toronto Raptors,0,1,38,26,64,10,22,32,48,48,96,10,3,13,13,37,30,12,17,108,116
2022,2,22200740,1/27/2023,1610612744,Golden State Warriors,1,1,1610612761,Toronto Raptors,0,0,32,15,47,18,25,43,50,40,90,11,4,15,9,32,40,5,14,101,129
2022,2,22200659,1/16/2023,1610612761,Toronto Raptors,0,1,1610612752,New York Knicks,1,0,25,27,52,13,31,44,38,58,96,34,7,41,23,39,27,3,6,100,123
2022,2,22200659,1/16/2023,1610612752,New York Knicks,1,0,1610612761,Toronto Raptors,0,1,33,35,68,9,22,31,42,57,99,28,7,35,27,34,17,8,12,100,121
2023,2,22300032,11/17/2023,1610612758,Sacramento Kings,0,1,1610612759,San Antonio Spurs,1,0,28,15,43,18,24,42,46,39,85,19,5,24,4,40,31,7,14,106,129
2023,2,22300159,11/8/2023,1610612755,Philadelphia 76ers,1,1,1610612738,Boston Celtics,0,0,33,28,61,9,25,34,42,53,95,13,2,15,15,39,20,8,14,101,106
2016,2,21600912,3/3/2017,1610612746,LA Clippers,0,0,1610612749,Milwaukee Bucks,1,1,28,17,45,8,11,19,36,28,64,21,15,36,8,25,23,11,23,95,101
2021,2,22100746,1/29/2022,1610612754,Indiana Pacers,0,0,1610612742,Dallas Mavericks,1,1,31,27,58,9,24,33,40,51,91,16,7,23,16,38,25,8,11,98,105
2016,2,21600912,3/3/2017,1610612749,Milwaukee Bucks,1,1,1610612746,LA Clippers,0,0,34,21,55,10,15,25,44,36,80,14,1,15,5,31,35,4,12,94,112
2014,2,21400517,1/5/2015,1610612747,Los Angeles Lakers,0,0,1610612757,Portland Trail Blazers,1,1,33,41,74,4,10,14,37,51,88,16,4,20,15,37,20,7,10,94,94
2014,2,21400517,1/5/2015,1610612757,Portland Trail Blazers,1,1,1610612747,Los Angeles Lakers,0,0,22,35,57,11,15,26,33,50,83,21,3,24,12,40,18,5,9,93,98
2022,2,22200662,1/16/2023,1610612762,Utah Jazz,0,1,1610612750,Minnesota Timberwolves,1,0,32,18,50,13,21,34,45,39,84,23,5,28,17,25,25,9,18,98,126
2021,2,22100745,1/29/2022,1610612738,Boston Celtics,0,1,1610612740,New Orleans Pelicans,1,0,29,11,40,14,27,41,43,38,81,7,4,11,7,33,31,8,15,94,107
2021,2,22100745,1/29/2022,1610612740,New Orleans Pelicans,1,0,1610612738,Boston Celtics,0,1,28,22,50,8,24,32,36,46,82,17,6,23,12,37,22,6,15,95,97
2017,2,21700537,12/31/2017,1610612741,Chicago Bulls,0,0,1610612764,Washington Wizards,1,1,34,23,57,8,27,35,42,50,92,18,4,22,16,37,24,6,12,97,110
2021,2,22101077,3/21/2022,1610612745,Houston Rockets,1,1,1610612764,Washington Wizards,0,0,22,24,46,20,19,39,42,43,85,11,2,13,6,39,30,7,13,94,115
2021,2,22101077,3/21/2022,1610612764,Washington Wizards,0,0,1610612745,Houston Rockets,1,1,29,27,56,6,23,29,35,50,85,21,3,24,14,38,24,5,11,94,97
2017,2,21700537,12/31/2017,1610612764,Washington Wizards,1,1,1610612741,Chicago Bulls,0,0,27,30,57,16,20,36,43,50,93,12,5,17,15,37,27,6,10,96,114
2019,2,21900213,11/21/2019,1610612749,Milwaukee Bucks,1,1,1610612757,Portland Trail Blazers,0,0,34,29,63,16,27,43,50,56,106,21,5,26,25,34,32,6,12,105,137
2014,2,21400177,11/21/2014,1610612750,Minnesota Timberwolves,1,0,1610612759,San Antonio Spurs,0,1,33,44,77,4,9,13,37,53,90,14,8,22,17,39,16,6,12,97,92
2014,2,21400177,11/21/2014,1610612759,San Antonio Spurs,0,1,1610612750,Minnesota Timberwolves,1,0,33,30,63,13,8,21,46,38,84,16,2,18,15,24,26,12,20,96,121
2019,2,21900213,11/21/2019,1610612757,Portland Trail Blazers,0,0,1610612749,Milwaukee Bucks,1,1,33,31,64,17,22,39,50,53,103,12,2,14,13,41,32,7,8,106,129
2014,2,21400176,11/21/2014,1610612738,Boston Celtics,0,0,1610612763,Memphis Grizzlies,1,1,29,32,61,9,18,27,38,50,88,15,6,21,11,42,22,4,12,100,100
2023,2,22300229,11/22/2023,1610612748,Miami Heat,0,1,1610612739,Cleveland Cavaliers,1,0,26,27,53,20,15,35,46,42,88,17,4,21,16,29,30,5,12,95,129
2021,2,22100744,1/28/2022,1610612749,Milwaukee Bucks,1,1,1610612752,New York Knicks,0,0,27,19,46,14,29,43,41,48,89,27,4,31,15,36,27,6,13,100,123
2021,2,22100744,1/28/2022,1610612752,New York Knicks,0,0,1610612749,Milwaukee Bucks,1,1,25,19,44,14,26,40,39,45,84,16,12,28,12,38,21,11,14,99,108
2021,2,22101076,3/21/2022,1610612741,Chicago Bulls,1,1,1610612761,Toronto Raptors,0,0,33,29,62,11,17,28,44,46,90,14,10,24,15,38,28,5,6,91,113
2017,2,21700536,12/30/2017,1610612743,Denver Nuggets,1,0,1610612755,Philadelphia 76ers,0,1,28,27,55,7,25,32,35,52,87,25,9,34,16,43,18,6,13,102,102
2017,2,21700536,12/30/2017,1610612755,Philadelphia 76ers,0,1,1610612743,Denver Nuggets,1,0,37,32,69,8,16,24,45,48,93,9,1,10,10,39,34,10,13,100,107
2014,2,21401076,3/27/2015,1610612764,Washington Wizards,1,1,1610612766,Charlotte Hornets,0,0,35,53,88,9,16,25,44,69,113,13,9,22,22,53,25,11,17,119,110
2023,2,22300327,12/15/2023,1610612765,Detroit Pistons,0,0,1610612755,Philadelphia 76ers,1,1,31,29,60,4,17,21,35,46,81,18,5,23,10,39,19,17,21,103,92
2022,2,22200740,1/27/2023,1610612761,Toronto Raptors,0,0,1610612744,Golden State Warriors,1,1,34,34,68,12,21,33,46,55,101,13,8,21,18,42,24,5,10,101,117
2014,2,21401076,3/27/2015,1610612766,Charlotte Hornets,0,0,1610612764,Washington Wizards,1,1,28,51,79,8,17,25,36,68,104,27,8,35,16,56,25,9,13,118,107
2021,2,22100743,1/28/2022,1610612750,Minnesota Timberwolves,0,0,1610612756,Phoenix Suns,1,1,30,21,51,14,25,39,44,46,90,22,5,27,9,40,20,4,7,100,124
2021,2,22100743,1/28/2022,1610612756,Phoenix Suns,1,1,1610612750,Minnesota Timberwolves,0,0,23,22,45,20,19,39,43,41,84,28,9,37,13,33,36,7,12,99,134
2021,2,22101076,3/21/2022,1610612761,Toronto Raptors,0,0,1610612741,Chicago Bulls,1,1,34,25,59,6,26,32,40,51,91,13,2,15,22,30,26,6,14,91,99
2014,2,21400176,11/21/2014,1610612763,Memphis Grizzlies,1,1,1610612738,Boston Celtics,0,0,40,35,75,8,8,16,48,43,91,13,1,14,12,31,31,7,14,100,117
2022,2,22200682,1/19/2023,1610612755,Philadelphia 76ers,0,1,1610612757,Portland Trail Blazers,1,0,33,22,55,8,18,26,41,40,81,15,4,19,10,32,24,4,15,96,105
2014,2,21401075,3/27/2015,1610612746,LA Clippers,0,1,1610612755,Philadelphia 76ers,1,0,32,21,53,12,17,29,44,38,82,19,12,31,9,34,28,11,17,104,119
2014,2,21401075,3/27/2015,1610612755,Philadelphia 76ers,1,0,1610612746,LA Clippers,0,1,25,30,55,11,20,31,36,50,86,15,12,27,9,49,17,8,15,104,98
2022,2,22200709,1/23/2023,1610612750,Minnesota Timberwolves,0,0,1610612745,Houston Rockets,1,1,25,24,49,16,26,42,41,50,91,16,6,22,14,40,19,11,19,107,114
2022,2,22200758,1/30/2023,1610612758,Sacramento Kings,0,1,1610612750,Minnesota Timberwolves,1,0,38,31,69,9,21,30,47,52,99,15,7,22,13,43,20,7,12,109,118
2022,2,22200910,2/26/2023,1610612749,Milwaukee Bucks,1,1,1610612756,Phoenix Suns,0,0,25,17,42,13,32,45,38,49,87,15,6,21,16,38,15,4,12,93,104
2022,2,22200737,1/27/2023,1610612750,Minnesota Timberwolves,1,1,1610612763,Memphis Grizzlies,0,0,31,20,51,13,22,35,44,42,86,10,5,15,11,34,31,14,20,103,111
2014,2,21400175,11/21/2014,1610612749,Milwaukee Bucks,0,0,1610612761,Toronto Raptors,1,1,21,33,54,6,14,20,27,47,74,22,10,32,9,43,19,8,14,94,82
2014,2,21400175,11/21/2014,1610612761,Toronto Raptors,1,1,1610612749,Milwaukee Bucks,0,0,30,31,61,15,10,25,45,41,86,19,5,24,19,26,27,11,16,94,124
2022,2,22200181,11/11/2022,1610612750,Minnesota Timberwolves,0,0,1610612763,Memphis Grizzlies,1,1,27,22,49,10,20,30,37,42,79,19,3,22,10,34,29,8,15,94,103
2022,2,22200181,11/11/2022,1610612763,Memphis Grizzlies,1,1,1610612750,Minnesota Timberwolves,0,0,37,18,55,7,26,33,44,44,88,19,8,27,20,29,25,10,14,92,114
2022,2,22200708,1/23/2023,1610612737,Atlanta Hawks,0,0,1610612741,Chicago Bulls,1,1,29,23,52,10,23,33,39,46,85,12,7,19,15,34,24,13,19,98,100
2021,2,22100742,1/28/2022,1610612741,Chicago Bulls,0,0,1610612759,San Antonio Spurs,1,1,38,20,58,8,22,30,46,42,88,22,4,26,7,36,22,3,6,99,122
2021,2,22100742,1/28/2022,1610612759,San Antonio Spurs,1,1,1610612741,Chicago Bulls,0,0,34,24,58,16,21,37,50,45,95,15,3,18,11,35,35,5,7,100,131
2021,2,22101075,3/21/2022,1610612751,Brooklyn Nets,1,1,1610612762,Utah Jazz,0,0,34,19,53,11,19,30,45,38,83,13,2,15,11,27,31,8,14,95,114
2021,2,22101075,3/21/2022,1610612762,Utah Jazz,0,0,1610612751,Brooklyn Nets,1,1,23,21,44,14,25,39,37,46,83,18,4,22,14,35,18,5,14,94,106
2022,2,22200736,1/27/2023,1610612749,Milwaukee Bucks,0,1,1610612754,Indiana Pacers,1,0,34,21,55,18,25,43,52,46,98,19,12,31,19,34,32,10,16,110,141
2022,2,22200760,1/30/2023,1610612759,San Antonio Spurs,1,0,1610612764,Washington Wizards,0,1,35,33,68,7,22,29,42,55,97,15,8,23,18,42,26,7,10,99,106
2014,2,21400174,11/21/2014,1610612737,Atlanta Hawks,1,1,1610612765,Detroit Pistons,0,0,33,23,56,5,19,24,38,42,80,18,8,26,11,33,20,6,10,91,99
2014,2,21400174,11/21/2014,1610612765,Detroit Pistons,0,0,1610612737,Atlanta Hawks,1,1,27,35,62,4,17,21,31,52,83,23,1,24,14,39,12,7,12,91,89
2022,2,22200180,11/11/2022,1610612749,Milwaukee Bucks,0,0,1610612759,San Antonio Spurs,1,1,20,35,55,12,31,43,32,66,98,17,6,23,28,43,22,3,17,98,93
2014,2,21400516,1/5/2015,1610612754,Indiana Pacers,0,1,1610612762,Utah Jazz,1,0,28,33,61,7,6,13,35,39,74,28,2,30,11,29,20,6,10,88,105
2014,2,21400516,1/5/2015,1610612762,Utah Jazz,1,0,1610612754,Indiana Pacers,0,1,31,27,58,4,19,23,35,46,81,27,7,34,19,30,16,8,10,89,101
2022,2,22200180,11/11/2022,1610612759,San Antonio Spurs,1,1,1610612749,Milwaukee Bucks,0,0,31,23,54,12,19,31,43,42,85,13,2,15,14,29,22,7,19,98,111
2020,2,22000465,2/21/2021,1610612738,Boston Celtics,0,0,1610612740,New Orleans Pelicans,1,1,29,32,61,10,27,37,39,59,98,27,7,34,16,45,22,5,11,108,115
2020,2,22000465,2/21/2021,1610612740,New Orleans Pelicans,1,1,1610612738,Boston Celtics,0,0,31,27,58,11,25,36,42,52,94,25,12,37,16,43,22,9,13,107,120
2017,2,21700535,12/30/2017,1610612744,Golden State Warriors,1,1,1610612763,Memphis Grizzlies,0,0,32,20,52,18,15,33,50,35,85,23,2,25,9,27,37,6,10,97,141
2017,2,21700535,12/30/2017,1610612763,Memphis Grizzlies,0,0,1610612744,Golden State Warriors,1,1,34,39,73,15,6,21,49,45,94,15,7,22,15,33,29,3,8,98,128
2021,2,22101074,3/21/2022,1610612748,Miami Heat,0,0,1610612755,Philadelphia 76ers,1,1,28,19,47,10,23,33,38,42,80,20,0,20,6,36,23,6,12,94,106
2021,2,22101074,3/21/2022,1610612755,Philadelphia 76ers,1,1,1610612748,Miami Heat,0,0,28,21,49,15,22,37,43,43,86,12,4,16,12,32,26,6,12,93,113
2016,2,21600027,10/29/2016,1610612738,Boston Celtics,0,1,1610612766,Charlotte Hornets,1,0,24,26,50,15,16,31,39,42,81,11,6,17,10,35,25,8,13,92,104
2016,2,21600027,10/29/2016,1610612766,Charlotte Hornets,1,0,1610612738,Boston Celtics,0,1,23,24,47,9,23,32,32,47,79,25,8,33,9,42,22,4,9,93,98
2022,2,22200682,1/19/2023,1610612757,Portland Trail Blazers,1,0,1610612755,Philadelphia 76ers,0,1,23,25,48,9,28,37,32,53,85,22,7,29,19,38,19,8,16,95,95
2022,2,22200808,2/6/2023,1610612765,Detroit Pistons,1,0,1610612738,Boston Celtics,0,1,28,26,54,9,24,33,37,50,87,16,5,21,10,43,22,2,9,94,99
2022,2,22200767,1/31/2023,1610612749,Milwaukee Bucks,1,1,1610612766,Charlotte Hornets,0,0,28,33,61,15,29,44,43,62,105,23,4,27,17,46,18,6,12,113,124
2014,2,21400173,11/21/2014,1610612755,Philadelphia 76ers,1,0,1610612756,Phoenix Suns,0,1,32,23,55,4,19,23,36,42,78,20,13,33,14,37,18,11,18,99,96
2014,2,21400173,11/21/2014,1610612756,Phoenix Suns,0,1,1610612755,Philadelphia 76ers,1,0,31,24,55,13,18,31,44,42,86,21,2,23,11,31,24,10,13,98,122
2022,2,22200179,11/11/2022,1610612760,Oklahoma City Thunder,1,1,1610612761,Toronto Raptors,0,0,37,20,57,15,21,36,52,41,93,13,4,17,18,26,31,13,19,102,132
2022,2,22200179,11/11/2022,1610612761,Toronto Raptors,0,0,1610612760,Oklahoma City Thunder,1,1,27,31,58,11,19,30,38,50,88,26,10,36,18,34,20,10,16,103,113
2022,2,22200956,3/4/2023,1610612764,Washington Wizards,1,0,1610612761,Toronto Raptors,0,1,24,27,51,14,10,24,38,37,75,19,3,22,13,26,26,14,24,97,109
2021,2,22100741,1/28/2022,1610612754,Indiana Pacers,0,1,1610612760,Oklahoma City Thunder,1,0,28,28,56,13,26,39,41,54,95,18,11,29,24,34,25,12,21,106,113
2021,2,22101073,3/21/2022,1610612757,Portland Trail Blazers,0,1,1610612765,Detroit Pistons,1,0,29,31,60,8,20,28,37,51,88,37,12,49,20,37,22,8,9,102,119
2021,2,22101073,3/21/2022,1610612765,Detroit Pistons,1,0,1610612757,Portland Trail Blazers,0,1,27,23,50,9,26,35,36,49,85,34,7,41,22,31,22,15,20,102,115
2014,2,21400172,11/21/2014,1610612753,Orlando Magic,0,1,1610612766,Charlotte Hornets,1,0,35,31,66,4,12,16,39,43,82,23,9,32,11,38,12,4,8,93,105
2022,2,22200708,1/23/2023,1610612741,Chicago Bulls,1,1,1610612737,Atlanta Hawks,0,0,33,28,61,11,23,34,44,51,95,12,6,18,19,35,28,6,11,98,111
2022,2,22200178,11/11/2022,1610612752,New York Knicks,1,1,1610612765,Detroit Pistons,0,0,32,22,54,10,30,40,42,52,94,27,2,29,20,34,23,6,11,99,121
2022,2,22200178,11/11/2022,1610612765,Detroit Pistons,0,0,1610612752,New York Knicks,1,1,30,19,49,7,24,31,37,43,80,31,10,41,15,32,22,7,15,99,112
2021,2,22100741,1/28/2022,1610612760,Oklahoma City Thunder,1,0,1610612754,Indiana Pacers,0,1,29,23,52,14,29,43,43,52,95,10,7,17,11,44,22,7,14,106,110
2014,2,21400172,11/21/2014,1610612766,Charlotte Hornets,1,0,1610612753,Orlando Magic,0,1,35,36,71,7,13,20,42,49,91,9,6,15,12,41,22,2,7,94,100
2020,2,22000755,4/4/2021,1610612741,Chicago Bulls,1,1,1610612751,Brooklyn Nets,0,0,35,21,56,8,14,22,43,35,78,21,9,30,7,32,29,3,9,93,115
2020,2,22000755,4/4/2021,1610612751,Brooklyn Nets,0,0,1610612741,Chicago Bulls,1,1,34,31,65,11,17,28,45,48,93,6,1,7,8,40,28,4,5,95,107
2022,2,22200177,11/11/2022,1610612753,Orlando Magic,1,1,1610612756,Phoenix Suns,0,0,28,21,49,15,18,33,43,39,82,13,2,15,11,29,23,7,15,92,114
2022,2,22200177,11/11/2022,1610612756,Phoenix Suns,0,0,1610612753,Orlando Magic,1,1,25,28,53,13,29,42,38,57,95,8,1,9,17,41,22,2,11,93,97
2014,2,21400171,11/20/2014,1610612741,Chicago Bulls,0,0,1610612758,Sacramento Kings,1,1,31,34,65,5,14,19,36,48,84,11,5,16,16,35,23,5,15,91,88
2014,2,21400171,11/20/2014,1610612758,Sacramento Kings,1,1,1610612741,Chicago Bulls,0,0,34,34,68,4,2,6,38,36,74,23,4,27,8,31,26,6,13,89,103
2022,2,22200956,3/4/2023,1610612761,Toronto Raptors,0,1,1610612764,Washington Wizards,1,0,35,25,60,12,18,30,47,43,90,10,4,14,11,35,30,9,14,97,116
2017,2,21700534,12/30/2017,1610612739,Cleveland Cavaliers,0,0,1610612762,Utah Jazz,1,1,22,19,41,12,28,40,34,47,81,21,5,26,10,40,20,12,15,98,101
2022,2,22200741,1/28/2023,1610612755,Philadelphia 76ers,1,1,1610612743,Denver Nuggets,0,0,28,26,54,18,17,35,46,43,89,16,8,24,15,31,31,6,11,96,126
2017,2,21700534,12/30/2017,1610612762,Utah Jazz,1,1,1610612739,Cleveland Cavaliers,0,0,28,23,51,10,21,31,38,44,82,18,3,21,6,39,24,6,11,97,104
2014,2,21401074,3/27/2015,1610612753,Orlando Magic,1,0,1610612765,Detroit Pistons,0,1,40,27,67,3,12,15,43,39,82,8,0,8,9,30,31,10,17,92,97
2014,2,21401074,3/27/2015,1610612765,Detroit Pistons,0,1,1610612753,Orlando Magic,1,0,35,37,72,7,11,18,42,48,90,20,7,27,18,34,22,3,7,93,111
2021,2,22101072,3/21/2022,1610612739,Cleveland Cavaliers,1,0,1610612747,Los Angeles Lakers,0,1,31,16,47,14,25,39,45,41,86,16,3,19,9,34,29,7,12,97,120
2021,2,22101072,3/21/2022,1610612747,Los Angeles Lakers,0,1,1610612739,Cleveland Cavaliers,1,0,41,21,62,12,20,32,53,41,94,13,3,16,11,31,34,3,8,98,131
2014,2,21400170,11/20/2014,1610612746,LA Clippers,0,1,1610612748,Miami Heat,1,0,30,16,46,13,18,31,43,34,77,11,6,17,12,25,31,10,14,87,110
2022,2,22200760,1/30/2023,1610612764,Washington Wizards,0,1,1610612759,San Antonio Spurs,1,0,32,24,56,16,14,30,48,38,86,15,2,17,8,32,32,6,14,98,127
2021,2,22100740,1/28/2022,1610612762,Utah Jazz,0,0,1610612763,Memphis Grizzlies,1,1,20,19,39,17,29,46,37,48,85,18,3,21,12,37,20,9,18,98,109
2021,2,22100740,1/28/2022,1610612763,Memphis Grizzlies,1,1,1610612762,Utah Jazz,0,0,37,22,59,9,14,23,46,36,82,18,6,24,10,29,27,10,15,99,119
2017,2,21700533,12/30/2017,1610612737,Atlanta Hawks,1,1,1610612757,Portland Trail Blazers,0,0,26,33,59,14,16,30,40,49,89,10,5,15,16,34,29,9,13,93,104
2014,2,21400170,11/20/2014,1610612748,Miami Heat,1,0,1610612746,LA Clippers,0,1,24,17,41,6,20,26,30,37,67,27,4,31,8,31,11,6,13,87,93
2022,2,22200741,1/28/2023,1610612743,Denver Nuggets,0,0,1610612755,Philadelphia 76ers,1,1,30,17,47,14,20,34,44,37,81,17,3,20,9,28,28,10,14,96,119
2017,2,21700533,12/30/2017,1610612757,Portland Trail Blazers,0,0,1610612737,Atlanta Hawks,1,1,29,31,60,7,18,25,36,49,85,10,3,13,17,34,19,12,20,92,89
2022,2,22200687,1/20/2023,1610612759,San Antonio Spurs,1,0,1610612746,LA Clippers,0,1,37,26,63,14,12,26,51,38,89,10,4,14,15,24,34,4,7,90,126
2016,2,21600911,3/3/2017,1610612748,Miami Heat,0,0,1610612753,Orlando Magic,1,1,27,36,63,8,20,28,35,56,91,21,4,25,15,42,20,7,9,96,99
2016,2,21600911,3/3/2017,1610612753,Orlando Magic,1,1,1610612748,Miami Heat,0,0,40,33,73,5,12,17,45,45,90,15,4,19,12,35,27,7,9,97,110
2016,2,21600377,12/14/2016,1610612748,Miami Heat,1,1,1610612754,Indiana Pacers,0,0,30,27,57,7,18,25,37,45,82,14,11,25,17,33,23,8,15,92,95
2014,2,21400515,1/5/2015,1610612740,New Orleans Pelicans,1,0,1610612764,Washington Wizards,0,1,27,28,55,6,13,19,33,41,74,13,4,17,14,30,19,10,18,86,85
2022,2,22200761,1/30/2023,1610612742,Dallas Mavericks,1,1,1610612765,Detroit Pistons,0,0,29,16,45,10,24,34,39,40,79,23,10,33,12,32,17,9,11,92,111
2014,2,21400515,1/5/2015,1610612764,Washington Wizards,0,1,1610612740,New Orleans Pelicans,1,0,36,33,69,2,8,10,38,41,79,14,3,17,15,29,23,8,12,85,92
2014,2,21400169,11/19/2014,1610612745,Houston Rockets,1,0,1610612747,Los Angeles Lakers,0,1,15,21,36,15,23,38,30,44,74,17,6,23,9,38,20,8,17,94,92
2014,2,21400169,11/19/2014,1610612747,Los Angeles Lakers,0,1,1610612745,Houston Rockets,1,0,32,39,71,5,15,20,37,54,91,19,4,23,21,35,17,8,14,92,98
2017,2,21700532,12/30/2017,1610612740,New Orleans Pelicans,1,0,1610612752,New York Knicks,0,1,32,26,58,6,20,26,38,46,84,21,6,27,5,44,24,6,10,100,103
2017,2,21700532,12/30/2017,1610612752,New York Knicks,0,1,1610612740,New Orleans Pelicans,1,0,36,39,75,5,14,19,41,53,94,18,3,21,11,44,24,3,7,100,105
2021,2,22101071,3/21/2022,1610612740,New Orleans Pelicans,0,0,1610612766,Charlotte Hornets,1,1,31,35,66,9,15,24,40,50,90,14,2,16,18,33,23,5,15,93,103
2021,2,22101071,3/21/2022,1610612766,Charlotte Hornets,1,1,1610612740,New Orleans Pelicans,0,0,27,15,42,13,24,37,40,39,79,13,2,15,7,33,34,9,17,94,106
2022,2,22200709,1/23/2023,1610612745,Houston Rockets,1,1,1610612750,Minnesota Timberwolves,0,0,33,25,58,11,19,30,44,44,88,20,10,30,19,30,24,8,23,107,119
2014,2,21400514,1/5/2015,1610612743,Denver Nuggets,0,1,1610612750,Minnesota Timberwolves,1,0,39,26,65,7,12,19,46,38,84,11,5,16,13,28,26,7,12,91,110
2014,2,21400514,1/5/2015,1610612750,Minnesota Timberwolves,1,0,1610612743,Denver Nuggets,0,1,28,37,65,10,14,24,38,51,89,15,3,18,20,33,21,8,13,92,101
2022,2,22200759,1/30/2023,1610612760,Oklahoma City Thunder,1,0,1610612744,Golden State Warriors,0,1,35,34,69,11,13,24,46,47,93,17,3,20,10,39,23,9,17,109,120
2014,2,21400168,11/19/2014,1610612743,Denver Nuggets,1,1,1610612760,Oklahoma City Thunder,0,0,30,23,53,10,19,29,40,42,82,17,5,22,14,31,25,5,9,86,107
2014,2,21400168,11/19/2014,1610612760,Oklahoma City Thunder,0,0,1610612743,Denver Nuggets,1,1,26,30,56,10,13,23,36,43,79,18,7,25,16,31,21,6,10,86,100
2022,2,22200176,11/11/2022,1610612738,Boston Celtics,1,1,1610612743,Denver Nuggets,0,0,34,19,53,16,21,37,50,40,90,15,5,20,12,29,30,3,7,94,131
2022,2,22200176,11/11/2022,1610612743,Denver Nuggets,0,0,1610612738,Boston Celtics,1,1,30,33,63,12,17,29,42,50,92,16,4,20,15,38,26,3,6,93,112
2021,2,22100739,1/28/2022,1610612745,Houston Rockets,1,0,1610612757,Portland Trail Blazers,0,1,28,10,38,10,31,41,38,41,79,24,7,31,10,33,25,10,19,101,110
2021,2,22100739,1/28/2022,1610612757,Portland Trail Blazers,0,1,1610612745,Houston Rockets,1,0,29,13,42,17,22,39,46,35,81,16,4,20,4,35,20,6,15,100,125
2014,2,21400167,11/19/2014,1610612750,Minnesota Timberwolves,1,1,1610612752,New York Knicks,0,0,33,34,67,11,11,22,44,45,89,16,6,22,21,28,26,6,14,92,115
2014,2,21400167,11/19/2014,1610612752,New York Knicks,0,0,1610612750,Minnesota Timberwolves,1,1,25,28,53,9,7,16,34,35,69,22,6,28,13,24,19,15,23,93,99
2023,2,22300020,11/14/2023,1610612751,Brooklyn Nets,1,1,1610612753,Orlando Magic,0,0,27,19,46,19,20,39,46,39,85,13,7,20,16,29,22,9,16,94,124
2022,2,22200687,1/20/2023,1610612746,LA Clippers,0,1,1610612759,San Antonio Spurs,1,0,36,17,53,15,13,28,51,30,81,14,6,20,11,22,31,3,9,89,131
2017,2,21700531,12/30/2017,1610612748,Miami Heat,0,1,1610612753,Orlando Magic,1,0,33,31,64,12,12,24,45,43,88,15,3,18,16,29,24,2,10,91,117
2022,2,22200910,2/26/2023,1610612756,Phoenix Suns,0,0,1610612749,Milwaukee Bucks,1,1,32,39,71,8,16,24,40,55,95,13,9,22,23,37,21,4,12,94,101
2014,2,21400166,11/19/2014,1610612761,Toronto Raptors,1,1,1610612763,Memphis Grizzlies,0,0,29,28,57,9,17,26,38,45,83,11,2,13,9,38,24,8,8,88,96
2021,2,22101070,3/20/2022,1610612744,Golden State Warriors,1,0,1610612759,San Antonio Spurs,0,1,30,27,57,11,22,33,41,49,90,15,6,21,22,30,26,7,15,95,108
2021,2,22101070,3/20/2022,1610612759,San Antonio Spurs,0,1,1610612744,Golden State Warriors,1,0,23,35,58,15,25,40,38,60,98,19,6,25,23,39,25,5,11,96,110
2014,2,21401073,3/26/2015,1610612749,Milwaukee Bucks,1,1,1610612754,Indiana Pacers,0,0,30,24,54,9,10,19,39,34,73,24,10,34,9,30,26,7,16,96,111
2014,2,21401073,3/26/2015,1610612754,Indiana Pacers,0,0,1610612749,Milwaukee Bucks,1,1,16,25,41,14,16,30,30,41,71,33,10,43,19,26,18,10,23,96,107
2014,2,21400166,11/19/2014,1610612763,Memphis Grizzlies,0,0,1610612761,Toronto Raptors,1,1,32,38,70,3,7,10,35,45,80,19,7,26,19,29,16,9,13,87,92
2022,2,22200808,2/6/2023,1610612738,Boston Celtics,0,1,1610612765,Detroit Pistons,1,0,23,23,46,16,21,37,39,44,83,17,4,21,11,36,25,9,12,94,111
2021,2,22100738,1/28/2022,1610612746,LA Clippers,0,0,1610612748,Miami Heat,1,1,32,25,57,9,26,35,41,51,92,23,9,32,17,40,22,6,13,103,114
2017,2,21700531,12/30/2017,1610612753,Orlando Magic,1,0,1610612748,Miami Heat,0,1,32,22,54,12,15,27,44,37,81,11,4,15,11,29,31,6,12,90,111
2014,2,21400513,1/5/2015,1610612752,New York Knicks,0,0,1610612763,Memphis Grizzlies,1,1,25,25,50,8,18,26,33,43,76,9,4,13,9,36,25,14,21,94,83
2014,2,21400513,1/5/2015,1610612763,Memphis Grizzlies,1,1,1610612752,New York Knicks,0,0,36,31,67,7,8,15,43,39,82,12,7,19,13,31,25,9,17,94,105
2022,2,22200732,1/26/2023,1610612766,Charlotte Hornets,1,1,1610612741,Chicago Bulls,0,0,32,20,52,7,25,32,39,45,84,26,5,31,9,38,24,8,16,107,111
2022,2,22200810,2/6/2023,1610612751,Brooklyn Nets,1,0,1610612746,LA Clippers,0,1,25,28,53,16,15,31,41,43,84,18,4,22,8,38,21,11,16,100,116
2021,2,22100738,1/28/2022,1610612748,Miami Heat,1,1,1610612746,LA Clippers,0,0,25,26,51,15,19,34,40,45,85,26,1,27,15,31,28,7,18,102,121
2020,2,22000464,2/20/2021,1610612757,Portland Trail Blazers,1,0,1610612764,Washington Wizards,0,1,18,30,48,19,36,55,37,66,103,18,7,25,21,48,19,8,13,105,111
2020,2,22000464,2/20/2021,1610612764,Washington Wizards,0,1,1610612757,Portland Trail Blazers,1,0,39,24,63,6,20,26,45,44,89,22,7,29,15,33,23,10,17,104,118
2014,2,21400165,11/19/2014,1610612756,Phoenix Suns,0,1,1610612765,Detroit Pistons,1,0,33,27,60,4,11,15,37,38,75,10,3,13,7,31,21,9,18,93,88
2014,2,21400165,11/19/2014,1610612765,Detroit Pistons,1,0,1610612756,Phoenix Suns,0,1,26,36,62,7,18,25,33,54,87,13,6,19,19,39,21,10,15,94,86
2014,2,21401072,3/25/2015,1610612756,Phoenix Suns,1,0,1610612758,Sacramento Kings,0,1,32,30,62,6,19,25,38,49,87,17,9,26,16,37,16,8,18,102,99
2014,2,21401072,3/25/2015,1610612758,Sacramento Kings,0,1,1610612756,Phoenix Suns,1,0,32,28,60,8,13,21,40,41,81,20,3,23,9,34,27,10,19,101,108
2016,2,21600377,12/14/2016,1610612754,Indiana Pacers,0,0,1610612748,Miami Heat,1,1,24,38,62,9,18,27,33,56,89,14,3,17,11,46,14,4,9,92,89
2020,2,22000754,4/3/2021,1610612749,Milwaukee Bucks,0,1,1610612758,Sacramento Kings,1,0,39,23,62,11,20,31,50,43,93,18,2,20,14,29,31,7,13,102,129
2020,2,22000754,4/3/2021,1610612758,Sacramento Kings,1,0,1610612749,Milwaukee Bucks,0,1,32,28,60,17,22,39,49,50,99,13,0,13,14,36,31,10,12,102,128
2022,2,22200508,12/27/2022,1610612737,Atlanta Hawks,0,0,1610612754,Indiana Pacers,1,1,28,31,59,12,18,30,40,49,89,22,7,29,9,43,26,3,9,103,114
2022,2,22200508,12/27/2022,1610612754,Indiana Pacers,1,1,1610612737,Atlanta Hawks,0,0,34,23,57,13,22,35,47,45,92,22,5,27,13,35,28,4,13,103,129
2022,2,22200175,11/10/2022,1610612740,New Orleans Pelicans,1,0,1610612757,Portland Trail Blazers,0,1,23,28,51,10,18,28,33,46,79,19,5,24,13,36,19,8,17,95,95
2022,2,22200175,11/10/2022,1610612757,Portland Trail Blazers,0,1,1610612740,New Orleans Pelicans,1,0,25,26,51,12,22,34,37,48,85,20,6,26,13,37,25,3,9,94,106
2021,2,22100737,1/28/2022,1610612737,Atlanta Hawks,1,1,1610612738,Boston Celtics,0,0,29,29,58,12,19,31,41,48,89,14,6,20,14,38,19,5,12,100,108
2021,2,22101069,3/20/2022,1610612755,Philadelphia 76ers,1,0,1610612761,Toronto Raptors,0,1,23,23,46,7,20,27,30,43,73,21,7,28,7,39,21,5,10,91,88
2021,2,22101069,3/20/2022,1610612761,Toronto Raptors,0,1,1610612755,Philadelphia 76ers,1,0,28,39,67,7,19,26,35,58,93,16,7,23,22,39,16,7,9,91,93
2021,2,22100737,1/28/2022,1610612738,Boston Celtics,0,0,1610612737,Atlanta Hawks,1,1,23,27,50,7,29,36,30,56,86,25,2,27,18,38,15,10,18,99,92
2017,2,21700530,12/30/2017,1610612759,San Antonio Spurs,0,0,1610612765,Detroit Pistons,1,1,26,32,58,5,21,26,31,53,84,12,1,13,12,41,18,10,14,94,79
2021,2,22101068,3/20/2022,1610612738,Boston Celtics,0,1,1610612743,Denver Nuggets,1,0,28,14,42,19,21,40,47,35,82,11,0,11,6,29,29,4,9,91,124
2021,2,22101068,3/20/2022,1610612743,Denver Nuggets,1,0,1610612738,Boston Celtics,0,1,21,27,48,14,25,39,35,52,87,20,5,25,18,36,22,4,11,92,104
2014,2,21400164,11/19/2014,1610612749,Milwaukee Bucks,0,1,1610612751,Brooklyn Nets,1,0,43,41,84,5,19,24,48,60,108,21,7,28,23,40,23,7,15,115,122
2014,2,21400164,11/19/2014,1610612751,Brooklyn Nets,1,0,1610612749,Milwaukee Bucks,0,1,35,26,61,9,22,31,44,48,92,21,8,29,13,37,26,12,22,116,118
2022,2,22200663,1/16/2023,1610612756,Phoenix Suns,0,0,1610612763,Memphis Grizzlies,1,1,29,27,56,10,23,33,39,50,89,18,1,19,12,39,33,8,15,99,106
2014,2,21400512,1/5/2015,1610612741,Chicago Bulls,1,1,1610612745,Houston Rockets,0,0,36,32,68,5,12,17,41,44,85,27,3,30,20,27,27,9,17,96,114
2014,2,21400512,1/5/2015,1610612745,Houston Rockets,0,0,1610612741,Chicago Bulls,1,1,39,38,77,8,17,25,47,55,102,3,2,5,23,34,25,10,16,97,105
2014,2,21400163,11/19/2014,1610612742,Dallas Mavericks,0,1,1610612764,Washington Wizards,1,0,22,32,54,12,16,28,34,48,82,25,4,29,11,38,18,8,12,96,105
2014,2,21400163,11/19/2014,1610612764,Washington Wizards,1,0,1610612742,Dallas Mavericks,0,1,27,35,62,10,12,22,37,47,84,18,3,21,13,35,25,5,14,97,102
2022,2,22200663,1/16/2023,1610612763,Memphis Grizzlies,1,1,1610612756,Phoenix Suns,0,0,36,25,61,16,21,37,52,46,98,16,4,20,16,33,29,4,11,101,136
2021,2,22100736,1/28/2022,1610612753,Orlando Magic,1,1,1610612765,Detroit Pistons,0,0,29,29,58,12,13,25,41,42,83,25,1,26,12,30,28,10,17,98,119
2021,2,22101067,3/20/2022,1610612752,New York Knicks,1,0,1610612762,Utah Jazz,0,1,15,28,43,16,24,40,31,52,83,15,6,21,15,40,20,9,11,90,93
2021,2,22101067,3/20/2022,1610612762,Utah Jazz,0,1,1610612752,New York Knicks,1,0,17,11,28,17,29,46,34,40,74,23,6,29,11,30,16,7,12,89,108
2017,2,21700530,12/30/2017,1610612765,Detroit Pistons,1,1,1610612759,San Antonio Spurs,0,0,28,29,57,8,16,24,36,45,81,13,3,16,8,39,22,8,11,93,93
2016,2,21600910,3/3/2017,1610612761,Toronto Raptors,0,1,1610612764,Washington Wizards,1,0,30,26,56,11,14,25,41,40,81,21,6,27,11,32,16,8,18,99,114
2022,2,22200174,11/10/2022,1610612748,Miami Heat,1,1,1610612766,Charlotte Hornets,0,0,29,25,54,10,26,36,39,51,90,29,7,36,10,45,21,4,11,106,117
2022,2,22200174,11/10/2022,1610612766,Charlotte Hornets,0,0,1610612748,Miami Heat,1,1,29,20,49,14,25,39,43,45,88,12,8,20,14,35,23,9,21,105,112
2021,2,22100736,1/28/2022,1610612765,Detroit Pistons,0,0,1610612753,Orlando Magic,1,1,22,36,58,10,19,29,32,55,87,29,8,37,15,41,23,5,10,99,103
2014,2,21400162,11/19/2014,1610612738,Boston Celtics,0,1,1610612755,Philadelphia 76ers,1,0,35,28,63,6,14,20,41,42,83,13,8,21,10,37,32,10,15,97,101
2021,2,22101066,3/20/2022,1610612756,Phoenix Suns,0,1,1610612758,Sacramento Kings,1,0,34,30,64,12,16,28,46,46,92,23,4,27,12,36,25,12,18,111,127
2021,2,22101066,3/20/2022,1610612758,Sacramento Kings,1,0,1610612756,Phoenix Suns,0,1,23,34,57,16,18,34,39,52,91,30,6,36,11,42,27,12,15,111,124
2014,2,21400162,11/19/2014,1610612755,Philadelphia 76ers,1,0,1610612738,Boston Celtics,0,1,27,38,65,7,14,21,34,52,86,15,6,21,13,41,22,11,16,98,90
2020,2,22000753,4/3/2021,1610612757,Portland Trail Blazers,1,1,1610612760,Oklahoma City Thunder,0,0,31,27,58,20,26,46,51,53,104,11,3,14,16,38,25,4,9,102,133
2017,2,21700529,12/29/2017,1610612746,LA Clippers,0,1,1610612747,Los Angeles Lakers,1,0,33,21,54,9,23,32,42,44,86,28,6,34,19,26,23,7,16,99,121
2014,2,21400161,11/19/2014,1610612746,LA Clippers,0,1,1610612753,Orlando Magic,1,0,33,30,63,12,9,21,45,39,84,12,4,16,5,38,24,5,7,95,114
2014,2,21400161,11/19/2014,1610612753,Orlando Magic,1,0,1610612746,LA Clippers,0,1,26,36,62,8,16,24,34,52,86,14,4,18,15,38,21,8,15,96,90
2014,2,21401071,3/25/2015,1610612759,San Antonio Spurs,1,1,1610612760,Oklahoma City Thunder,0,0,38,29,67,13,8,21,51,37,88,15,4,19,11,27,28,7,10,96,130
2014,2,21401071,3/25/2015,1610612760,Oklahoma City Thunder,0,0,1610612759,San Antonio Spurs,1,1,30,42,72,6,12,18,36,54,90,13,1,14,11,43,16,7,10,97,91
2022,2,22200173,11/10/2022,1610612737,Atlanta Hawks,1,1,1610612755,Philadelphia 76ers,0,0,33,29,62,6,20,26,39,49,88,20,3,23,12,38,19,10,18,104,104
2022,2,22200173,11/10/2022,1610612755,Philadelphia 76ers,0,0,1610612737,Atlanta Hawks,1,1,26,27,53,6,24,30,32,51,83,25,5,30,9,45,15,8,17,104,95
2022,2,22200690,1/20/2023,1610612763,Memphis Grizzlies,0,0,1610612747,Los Angeles Lakers,1,1,34,39,73,9,20,29,43,59,102,26,14,40,30,38,24,7,14,105,121
2017,2,21700529,12/29/2017,1610612747,Los Angeles Lakers,1,0,1610612746,LA Clippers,0,1,43,32,75,3,16,19,46,48,94,11,5,16,14,37,25,7,12,99,106
2021,2,22101065,3/20/2022,1610612753,Orlando Magic,1,1,1610612760,Oklahoma City Thunder,0,0,25,27,52,7,24,31,32,51,83,19,5,24,17,36,22,13,21,98,90
2021,2,22101065,3/20/2022,1610612760,Oklahoma City Thunder,0,0,1610612753,Orlando Magic,1,1,17,27,44,13,35,48,30,62,92,12,6,18,18,48,19,11,16,100,85
2014,2,21400160,11/19/2014,1610612754,Indiana Pacers,1,1,1610612766,Charlotte Hornets,0,0,33,30,63,2,13,15,35,43,78,16,8,24,16,30,15,6,12,85,88
2014,2,21401070,3/25/2015,1610612757,Portland Trail Blazers,0,1,1610612762,Utah Jazz,1,0,27,27,54,7,20,27,34,47,81,17,3,20,17,32,19,11,14,89,92
2014,2,21401070,3/25/2015,1610612762,Utah Jazz,1,0,1610612757,Portland Trail Blazers,0,1,31,33,64,4,12,16,35,45,80,15,8,23,14,36,12,4,10,89,89
2014,2,21400160,11/19/2014,1610612766,Charlotte Hornets,0,0,1610612754,Indiana Pacers,1,1,32,40,72,5,9,14,37,49,86,7,5,12,14,37,18,3,6,83,86
2022,2,22200577,1/5/2023,1610612738,Boston Celtics,0,1,1610612742,Dallas Mavericks,1,0,25,16,41,16,27,43,41,43,84,26,5,31,11,34,29,4,11,98,124
2022,2,22200577,1/5/2023,1610612742,Dallas Mavericks,1,0,1610612738,Boston Celtics,0,1,27,31,58,7,25,32,34,56,90,20,5,25,14,44,15,6,11,97,95
2016,2,21600910,3/3/2017,1610612764,Washington Wizards,1,0,1610612761,Toronto Raptors,0,1,24,38,62,10,20,30,34,58,92,28,4,32,19,41,23,5,11,100,106
2022,2,22200562,1/3/2023,1610612738,Boston Celtics,0,0,1610612760,Oklahoma City Thunder,1,1,28,20,48,12,28,40,40,48,88,25,6,31,13,37,29,14,17,108,117
2022,2,22200562,1/3/2023,1610612760,Oklahoma City Thunder,1,1,1610612738,Boston Celtics,0,0,38,20,58,20,20,40,58,40,98,14,8,22,15,29,31,4,13,108,150
2016,2,21600026,10/29/2016,1610612737,Atlanta Hawks,0,1,1610612755,Philadelphia 76ers,1,0,37,28,65,5,15,20,42,43,85,15,7,22,11,39,31,9,12,99,104
2016,2,21600026,10/29/2016,1610612755,Philadelphia 76ers,1,0,1610612737,Atlanta Hawks,0,1,23,39,62,5,13,18,28,52,80,11,4,15,8,43,16,11,20,99,72
2014,2,21400159,11/19/2014,1610612739,Cleveland Cavaliers,1,0,1610612759,San Antonio Spurs,0,1,30,35,65,7,11,18,37,46,83,9,4,13,16,33,23,11,18,91,90
2014,2,21400511,1/5/2015,1610612742,Dallas Mavericks,0,1,1610612751,Brooklyn Nets,1,0,27,40,67,10,17,27,37,57,94,12,7,19,16,45,24,5,11,99,96
2022,2,22200692,1/21/2023,1610612738,Boston Celtics,0,1,1610612761,Toronto Raptors,1,0,22,28,50,16,19,35,38,47,85,14,1,15,12,36,25,7,15,95,106
2022,2,22200691,1/20/2023,1610612758,Sacramento Kings,1,1,1610612760,Oklahoma City Thunder,0,0,29,20,49,12,26,38,41,46,87,24,4,28,18,30,25,4,15,100,118
2014,2,21400511,1/5/2015,1610612751,Brooklyn Nets,1,0,1610612742,Dallas Mavericks,0,1,30,29,59,3,22,25,33,51,84,19,4,23,14,39,20,8,15,101,88
2021,2,22101064,3/20/2022,1610612737,Atlanta Hawks,1,0,1610612740,New Orleans Pelicans,0,1,31,24,55,10,22,32,41,46,87,20,3,23,10,38,22,12,16,105,112
2021,2,22101064,3/20/2022,1610612740,New Orleans Pelicans,0,1,1610612737,Atlanta Hawks,1,0,36,39,75,7,14,21,43,53,96,24,3,27,19,34,22,7,16,105,117
2022,2,22200698,1/21/2023,1610612758,Sacramento Kings,1,0,1610612755,Philadelphia 76ers,0,1,33,18,51,13,20,33,46,38,84,22,7,29,8,33,28,4,9,98,127
2022,2,22200697,1/21/2023,1610612756,Phoenix Suns,1,1,1610612754,Indiana Pacers,0,0,26,34,60,12,19,31,38,53,91,24,11,35,19,40,27,10,15,105,112
2022,2,22200732,1/26/2023,1610612741,Chicago Bulls,0,0,1610612766,Charlotte Hornets,1,1,33,33,66,4,21,25,37,54,91,18,4,22,9,46,16,8,13,106,96
2022,2,22200831,2/9/2023,1610612743,Denver Nuggets,0,0,1610612753,Orlando Magic,1,1,29,22,51,10,23,33,39,45,84,16,8,24,13,35,24,12,16,98,104
2014,2,21400159,11/19/2014,1610612759,San Antonio Spurs,0,1,1610612739,Cleveland Cavaliers,1,0,30,28,58,5,11,16,35,39,74,17,8,25,13,29,26,7,16,91,92
2022,2,22200690,1/20/2023,1610612747,Los Angeles Lakers,1,1,1610612763,Memphis Grizzlies,0,0,25,27,52,13,28,41,38,55,93,33,8,41,18,42,24,6,10,105,122
2014,2,21400158,11/18/2014,1610612740,New Orleans Pelicans,0,1,1610612758,Sacramento Kings,1,0,30,25,55,9,15,24,39,40,79,19,5,24,7,35,21,3,6,90,106
2022,2,22200172,11/10/2022,1610612742,Dallas Mavericks,0,0,1610612764,Washington Wizards,1,1,19,20,39,18,29,47,37,49,86,13,8,21,10,44,19,5,13,101,105
2022,2,22200172,11/10/2022,1610612764,Washington Wizards,1,1,1610612742,Dallas Mavericks,0,0,29,25,54,12,18,30,41,43,84,19,1,20,9,35,25,9,17,101,113
2021,2,22100735,1/28/2022,1610612747,Los Angeles Lakers,0,0,1610612766,Charlotte Hornets,1,1,23,28,51,15,25,40,38,53,91,23,9,32,17,41,19,4,7,96,114
2021,2,22100735,1/28/2022,1610612766,Charlotte Hornets,1,1,1610612747,Los Angeles Lakers,0,0,32,15,47,11,25,36,43,40,83,20,8,28,12,33,25,7,12,96,117
2017,2,21700528,12/29/2017,1610612744,Golden State Warriors,1,0,1610612766,Charlotte Hornets,0,1,32,33,65,8,14,22,40,47,87,12,1,13,11,36,32,12,18,102,100
2017,2,21700528,12/29/2017,1610612766,Charlotte Hornets,0,1,1610612744,Golden State Warriors,1,0,35,34,69,6,14,20,41,48,89,23,11,34,16,36,27,6,11,101,111
2020,2,22000753,4/3/2021,1610612760,Oklahoma City Thunder,0,0,1610612757,Portland Trail Blazers,1,1,22,29,51,8,26,34,30,55,85,17,7,24,15,43,17,13,22,103,85
2014,2,21400510,1/5/2015,1610612738,Boston Celtics,1,0,1610612766,Charlotte Hornets,0,1,29,44,73,7,11,18,36,55,91,16,7,23,18,39,22,2,6,90,95
2014,2,21400510,1/5/2015,1610612766,Charlotte Hornets,0,1,1610612738,Boston Celtics,1,0,32,27,59,6,13,19,38,40,78,22,1,23,16,25,22,8,16,90,104
2014,2,21400158,11/18/2014,1610612758,Sacramento Kings,1,0,1610612740,New Orleans Pelicans,0,1,34,41,75,4,7,11,38,48,86,20,9,29,22,29,23,6,15,92,100
2022,2,22200710,1/23/2023,1610612766,Charlotte Hornets,0,0,1610612762,Utah Jazz,1,1,36,33,69,2,14,16,38,47,85,24,10,34,15,38,22,8,15,100,102
2022,2,22200664,1/16/2023,1610612747,Los Angeles Lakers,1,1,1610612745,Houston Rockets,0,0,37,21,58,12,21,33,49,42,91,30,5,35,11,33,23,0,2,98,140
2022,2,22200698,1/21/2023,1610612755,Philadelphia 76ers,0,1,1610612758,Sacramento Kings,1,0,37,28,65,12,16,28,49,44,93,19,4,23,19,26,27,6,15,98,129
2022,2,22200868,2/14/2023,1610612753,Orlando Magic,0,0,1610612761,Toronto Raptors,1,1,30,23,53,13,18,31,43,41,84,14,4,18,14,29,26,9,19,98,113
2022,2,22200833,2/9/2023,1610612741,Chicago Bulls,0,0,1610612751,Brooklyn Nets,1,1,37,28,65,5,21,26,42,49,91,16,5,21,12,40,15,8,12,101,105
2022,2,22200689,1/20/2023,1610612762,Utah Jazz,1,0,1610612751,Brooklyn Nets,0,1,21,28,49,16,23,39,37,51,88,16,7,23,17,38,24,7,11,93,106
2022,2,22200774,2/1/2023,1610612744,Golden State Warriors,0,0,1610612750,Minnesota Timberwolves,1,1,27,29,56,11,24,35,38,53,91,27,7,34,11,45,21,5,17,112,114
2023,2,22300141,11/5/2023,1610612761,Toronto Raptors,0,1,1610612759,San Antonio Spurs,1,0,25,24,49,19,29,48,44,53,97,16,10,26,18,39,29,7,15,108,123
2017,2,21700527,12/29/2017,1610612756,Phoenix Suns,0,1,1610612758,Sacramento Kings,1,0,28,27,55,13,17,30,41,44,85,16,8,24,19,29,26,6,11,91,111
2014,2,21400157,11/18/2014,1610612760,Oklahoma City Thunder,0,0,1610612762,Utah Jazz,1,1,22,39,61,8,15,23,30,54,84,13,6,19,15,44,17,8,14,92,81
2014,2,21400157,11/18/2014,1610612762,Utah Jazz,1,1,1610612760,Oklahoma City Thunder,0,0,25,32,57,10,14,24,35,46,81,18,8,26,15,34,22,8,13,91,98
2021,2,22100734,1/27/2022,1610612744,Golden State Warriors,1,1,1610612750,Minnesota Timberwolves,0,0,23,23,46,21,15,36,44,38,82,15,6,21,10,32,31,10,19,101,124
2021,2,22100734,1/27/2022,1610612750,Minnesota Timberwolves,0,0,1610612744,Golden State Warriors,1,1,32,19,51,10,34,44,42,53,95,21,6,27,14,41,22,8,9,103,115
2017,2,21700527,12/29/2017,1610612758,Sacramento Kings,1,0,1610612756,Phoenix Suns,0,1,29,28,57,8,15,23,37,43,80,18,4,22,9,36,23,5,9,91,100
2014,2,21401069,3/25/2015,1610612743,Denver Nuggets,1,0,1610612755,Philadelphia 76ers,0,1,21,34,55,8,21,29,29,55,84,19,8,27,15,42,13,14,16,98,85
2022,2,22200664,1/16/2023,1610612745,Houston Rockets,0,0,1610612747,Los Angeles Lakers,1,1,38,32,70,11,19,30,49,51,100,23,8,31,23,32,28,4,8,99,132
2020,2,22000463,2/20/2021,1610612747,Los Angeles Lakers,1,0,1610612748,Miami Heat,0,1,20,19,39,13,32,45,33,51,84,15,2,17,12,41,25,8,15,96,94
2014,2,21401069,3/25/2015,1610612755,Philadelphia 76ers,0,1,1610612743,Denver Nuggets,1,0,21,29,50,14,20,34,35,49,84,15,7,22,15,38,17,8,17,98,99
2021,2,22101063,3/20/2022,1610612745,Houston Rockets,1,0,1610612763,Memphis Grizzlies,0,1,27,28,55,10,21,31,37,49,86,14,10,24,7,47,26,14,17,105,98
2021,2,22101063,3/20/2022,1610612763,Memphis Grizzlies,0,1,1610612745,Houston Rockets,1,0,30,32,62,16,18,34,46,50,96,14,3,17,11,41,26,6,14,106,122
2022,2,22200831,2/9/2023,1610612753,Orlando Magic,1,1,1610612743,Denver Nuggets,0,0,38,32,70,9,18,27,47,50,97,12,7,19,18,35,24,6,10,98,115
2022,2,22200692,1/21/2023,1610612761,Toronto Raptors,1,0,1610612738,Boston Celtics,0,1,39,28,67,7,12,19,46,40,86,5,2,7,8,33,24,9,14,95,104
2022,2,22200665,1/17/2023,1610612749,Milwaukee Bucks,1,1,1610612761,Toronto Raptors,0,0,27,20,47,19,20,39,46,40,86,19,2,21,10,31,24,7,12,99,130
2022,2,22200793,2/4/2023,1610612764,Washington Wizards,0,0,1610612751,Brooklyn Nets,1,1,26,27,53,13,15,28,39,42,81,32,9,41,14,31,22,4,16,103,123
2022,2,22200697,1/21/2023,1610612754,Indiana Pacers,0,0,1610612756,Phoenix Suns,1,1,23,36,59,13,24,37,36,60,96,22,4,26,19,43,22,9,15,105,107
2023,2,22300020,11/14/2023,1610612753,Orlando Magic,0,0,1610612751,Brooklyn Nets,1,1,20,16,36,16,30,46,36,46,82,16,5,21,15,34,23,13,16,95,104
2023,2,22300088,10/28/2023,1610612741,Chicago Bulls,0,0,1610612765,Detroit Pistons,1,1,28,37,65,11,17,28,39,54,93,13,3,16,14,42,16,4,8,92,102
2023,2,22300226,11/22/2023,1610612753,Orlando Magic,1,1,1610612743,Denver Nuggets,0,0,34,18,52,10,19,29,44,37,81,26,4,30,13,25,27,6,12,93,124
2014,2,21400156,11/18/2014,1610612749,Milwaukee Bucks,1,1,1610612752,New York Knicks,0,0,34,27,61,9,8,17,43,35,78,22,5,27,19,18,30,9,16,89,117
2014,2,21400156,11/18/2014,1610612752,New York Knicks,0,0,1610612749,Milwaukee Bucks,1,1,33,22,55,11,14,25,44,36,80,14,5,19,11,29,30,5,12,90,113
2022,2,22200171,11/9/2022,1610612739,Cleveland Cavaliers,0,0,1610612758,Sacramento Kings,1,1,35,25,60,11,15,26,46,40,86,17,3,20,17,24,24,12,18,97,120
2022,2,22200171,11/9/2022,1610612758,Sacramento Kings,1,1,1610612739,Cleveland Cavaliers,0,0,23,14,37,17,22,39,40,36,76,30,5,35,5,32,30,4,9,97,127
2020,2,22000463,2/20/2021,1610612748,Miami Heat,0,1,1610612747,Los Angeles Lakers,1,0,28,29,57,8,20,28,36,49,85,16,7,23,14,39,24,5,14,95,96
2016,2,21600025,10/28/2016,1610612740,New Orleans Pelicans,1,0,1610612744,Golden State Warriors,0,1,42,36,78,5,17,22,47,53,100,15,8,23,16,42,29,8,15,110,114
2016,2,21600025,10/28/2016,1610612744,Golden State Warriors,0,1,1610612740,New Orleans Pelicans,1,0,35,28,63,9,19,28,44,47,91,25,3,28,10,40,32,8,14,109,122
2020,2,22000752,4/3/2021,1610612753,Orlando Magic,0,0,1610612762,Utah Jazz,1,1,30,34,64,2,21,23,32,55,87,25,6,31,13,45,11,10,11,98,91
2020,2,22000752,4/3/2021,1610612762,Utah Jazz,1,1,1610612753,Orlando Magic,0,0,25,12,37,26,29,55,51,41,92,9,3,12,10,32,34,5,11,99,137
2014,2,21400155,11/18/2014,1610612737,Atlanta Hawks,1,0,1610612747,Los Angeles Lakers,0,1,32,26,58,9,18,27,41,44,85,18,5,23,15,33,22,7,11,91,109
2014,2,21400155,11/18/2014,1610612747,Los Angeles Lakers,0,1,1610612737,Atlanta Hawks,1,0,41,29,70,6,11,17,47,40,87,14,8,22,15,30,24,7,11,92,114
2021,2,22100733,1/27/2022,1610612747,Los Angeles Lakers,0,0,1610612755,Philadelphia 76ers,1,1,30,29,59,6,23,29,36,52,88,9,0,9,13,39,19,8,19,98,87
2014,2,21401068,3/25/2015,1610612740,New Orleans Pelicans,1,0,1610612745,Houston Rockets,0,1,29,31,60,5,10,15,34,41,75,20,12,32,15,33,20,7,13,89,93
2022,2,22200731,1/26/2023,1610612765,Detroit Pistons,0,1,1610612751,Brooklyn Nets,1,0,37,31,68,11,16,27,48,47,95,23,3,26,17,31,27,5,11,99,130
2014,2,21401068,3/25/2015,1610612745,Houston Rockets,0,1,1610612740,New Orleans Pelicans,1,0,34,25,59,6,16,22,40,41,81,9,3,12,16,27,29,8,18,88,95
2022,2,22200691,1/20/2023,1610612760,Oklahoma City Thunder,0,0,1610612758,Sacramento Kings,1,1,29,24,53,16,24,40,45,48,93,7,4,11,9,42,21,1,9,98,113
2022,2,22200868,2/14/2023,1610612761,Toronto Raptors,1,1,1610612753,Orlando Magic,0,0,42,17,59,8,16,24,50,33,83,15,5,20,14,22,31,6,20,98,123
2022,2,22200854,2/11/2023,1610612758,Sacramento Kings,1,1,1610612742,Dallas Mavericks,0,0,43,25,68,8,24,32,51,49,100,23,2,25,12,38,22,4,7,109,133
2023,2,22300090,10/28/2023,1610612740,New Orleans Pelicans,1,1,1610612752,New York Knicks,0,0,31,23,54,9,24,33,40,47,87,7,9,16,8,44,20,7,13,100,96
2023,2,22300189,11/13/2023,1610612761,Toronto Raptors,1,1,1610612764,Washington Wizards,0,0,41,29,70,4,16,20,45,45,90,17,8,25,19,32,28,11,19,100,111
2021,2,22101062,3/20/2022,1610612754,Indiana Pacers,1,1,1610612757,Portland Trail Blazers,0,0,33,16,49,15,20,35,48,36,84,18,3,21,14,24,38,10,16,95,129
2021,2,22101062,3/20/2022,1610612757,Portland Trail Blazers,0,0,1610612754,Indiana Pacers,1,1,29,19,48,9,24,33,38,43,81,13,5,18,12,34,23,10,18,94,98
2014,2,21400509,1/5/2015,1610612739,Cleveland Cavaliers,0,0,1610612755,Philadelphia 76ers,1,1,22,33,55,11,19,30,33,52,85,15,7,22,18,38,23,5,13,91,92
2014,2,21400509,1/5/2015,1610612755,Philadelphia 76ers,1,1,1610612739,Cleveland Cavaliers,0,0,31,25,56,7,16,23,38,41,79,12,3,15,12,31,31,8,17,92,95
2023,2,22300158,11/8/2023,1610612762,Utah Jazz,0,0,1610612754,Indiana Pacers,1,1,34,35,69,11,16,27,45,51,96,17,1,18,20,32,26,14,22,105,118
2023,2,22300089,10/28/2023,1610612764,Washington Wizards,1,1,1610612763,Memphis Grizzlies,0,0,24,23,47,16,30,46,40,53,93,17,5,22,13,41,24,7,12,101,113
2014,2,21400154,11/17/2014,1610612741,Chicago Bulls,0,1,1610612746,LA Clippers,1,0,29,25,54,10,16,26,39,41,80,17,8,25,11,32,28,2,9,90,105
2021,2,22100733,1/27/2022,1610612755,Philadelphia 76ers,1,1,1610612747,Los Angeles Lakers,0,0,28,19,47,13,22,35,41,41,82,10,7,17,9,33,30,7,15,99,105
2017,2,21700526,12/29/2017,1610612749,Milwaukee Bucks,0,1,1610612760,Oklahoma City Thunder,1,0,31,25,56,9,20,29,40,45,85,8,9,17,13,37,26,5,9,88,97
2022,2,22200567,1/4/2023,1610612754,Indiana Pacers,0,0,1610612755,Philadelphia 76ers,1,1,32,27,59,13,23,36,45,50,95,23,3,26,18,33,31,4,13,105,126
2022,2,22200567,1/4/2023,1610612755,Philadelphia 76ers,1,1,1610612754,Indiana Pacers,0,0,34,28,62,14,22,36,48,50,98,19,3,22,17,35,24,7,11,103,129
2022,2,22201056,3/18/2023,1610612746,LA Clippers,1,0,1610612753,Orlando Magic,0,1,36,32,68,6,16,22,42,48,90,18,6,24,15,36,23,14,15,100,108
2023,2,22300012,11/10/2023,1610612763,Memphis Grizzlies,1,0,1610612762,Utah Jazz,0,1,27,26,53,19,29,48,46,55,101,10,3,13,19,36,23,10,11,100,121
2014,2,21400508,1/4/2015,1610612747,Los Angeles Lakers,1,1,1610612754,Indiana Pacers,0,0,21,32,53,6,12,18,27,44,71,28,2,30,7,37,14,5,11,91,88
2014,2,21400508,1/4/2015,1610612754,Indiana Pacers,0,0,1610612747,Los Angeles Lakers,1,1,25,37,62,8,20,28,33,57,90,13,5,18,25,34,21,8,16,91,87
2014,2,21400154,11/17/2014,1610612746,LA Clippers,1,0,1610612741,Chicago Bulls,0,1,29,29,58,7,16,23,36,45,81,10,12,22,14,37,20,7,12,89,89
2017,2,21700526,12/29/2017,1610612760,Oklahoma City Thunder,1,0,1610612749,Milwaukee Bucks,0,1,31,27,58,7,18,25,38,45,83,12,8,20,16,33,16,9,13,89,95
2014,2,21400507,1/4/2015,1610612756,Phoenix Suns,1,1,1610612761,Toronto Raptors,0,0,40,26,66,8,15,23,48,41,89,21,7,28,11,34,26,9,17,106,125
2019,2,21900212,11/20/2019,1610612738,Boston Celtics,0,0,1610612746,LA Clippers,1,1,29,30,59,12,33,45,41,63,104,10,4,14,24,40,26,12,18,109,104
2021,2,22101061,3/19/2022,1610612747,Los Angeles Lakers,0,0,1610612764,Washington Wizards,1,1,35,21,56,13,22,35,48,43,91,10,1,11,13,31,25,10,15,98,119
2021,2,22101061,3/19/2022,1610612764,Washington Wizards,1,1,1610612747,Los Angeles Lakers,0,0,31,23,54,13,18,31,44,41,85,26,5,31,9,34,30,3,8,99,127
2019,2,21900212,11/20/2019,1610612746,LA Clippers,1,1,1610612738,Boston Celtics,0,0,22,26,48,17,28,45,39,54,93,12,4,16,18,38,26,11,23,109,107
2014,2,21400507,1/4/2015,1610612761,Toronto Raptors,0,0,1610612756,Phoenix Suns,1,1,29,28,57,9,17,26,38,45,83,24,5,29,12,36,22,15,21,106,109
2017,2,21700525,12/29/2017,1610612740,New Orleans Pelicans,1,0,1610612742,Dallas Mavericks,0,1,34,20,54,8,23,31,42,43,85,28,4,32,6,38,28,5,8,101,120
2022,2,22200710,1/23/2023,1610612762,Utah Jazz,1,1,1610612766,Charlotte Hornets,0,0,25,21,46,16,24,40,41,45,86,22,4,26,13,35,25,8,16,102,120
2021,2,22100732,1/26/2022,1610612742,Dallas Mavericks,0,1,1610612757,Portland Trail Blazers,1,0,32,20,52,16,20,36,48,40,88,20,6,26,9,36,35,4,9,97,132
2021,2,22100732,1/26/2022,1610612757,Portland Trail Blazers,1,0,1610612742,Dallas Mavericks,0,1,28,16,44,14,24,38,42,40,82,14,9,23,5,41,27,6,9,96,112
2014,2,21400153,11/17/2014,1610612740,New Orleans Pelicans,0,0,1610612757,Portland Trail Blazers,1,1,33,33,66,5,14,19,38,47,85,12,7,19,15,35,16,7,11,91,93
2014,2,21400153,11/17/2014,1610612757,Portland Trail Blazers,1,1,1610612740,New Orleans Pelicans,0,0,31,26,57,7,12,19,38,38,76,19,4,23,11,30,20,11,18,92,102
2022,2,22201056,3/18/2023,1610612753,Orlando Magic,0,1,1610612746,LA Clippers,1,0,32,21,53,10,21,31,42,42,84,19,6,25,14,31,23,9,18,100,113
2022,2,22200854,2/11/2023,1610612742,Dallas Mavericks,0,0,1610612758,Sacramento Kings,1,1,27,13,40,20,31,51,47,44,91,14,5,19,8,40,27,9,16,108,128
2022,2,22200832,2/9/2023,1610612756,Phoenix Suns,0,0,1610612737,Atlanta Hawks,1,1,32,24,56,7,23,30,39,47,86,22,7,29,10,40,24,6,11,100,107
2020,2,22000751,4/3/2021,1610612754,Indiana Pacers,0,1,1610612759,San Antonio Spurs,1,0,40,25,65,12,17,29,52,42,94,23,3,26,11,32,27,6,14,109,139
2017,2,21700525,12/29/2017,1610612742,Dallas Mavericks,0,1,1610612740,New Orleans Pelicans,1,0,24,20,44,22,17,39,46,37,83,13,4,17,9,29,27,8,18,102,127
2016,2,21600909,3/3/2017,1610612752,New York Knicks,0,0,1610612755,Philadelphia 76ers,1,1,26,37,63,7,14,21,33,51,84,29,4,33,13,41,14,5,12,100,102
2016,2,21600909,3/3/2017,1610612755,Philadelphia 76ers,1,1,1610612752,New York Knicks,0,0,27,28,55,9,19,28,36,47,83,24,7,31,16,33,20,10,16,99,105
2014,2,21401067,3/25/2015,1610612747,Los Angeles Lakers,0,1,1610612750,Minnesota Timberwolves,1,0,33,33,66,6,20,26,39,53,92,17,1,18,17,37,21,8,16,101,101
2014,2,21401067,3/25/2015,1610612750,Minnesota Timberwolves,1,0,1610612747,Los Angeles Lakers,0,1,27,29,56,6,16,22,33,45,78,27,3,30,11,36,14,8,19,100,99
2022,2,22200688,1/20/2023,1610612754,Indiana Pacers,0,0,1610612743,Denver Nuggets,1,1,29,23,52,8,24,32,37,47,84,29,8,37,22,29,23,16,21,100,111
2017,2,21700524,12/29/2017,1610612741,Chicago Bulls,1,1,1610612754,Indiana Pacers,0,0,25,21,46,18,21,39,43,42,85,15,0,15,9,33,31,10,15,97,119
2017,2,21700524,12/29/2017,1610612754,Indiana Pacers,0,0,1610612741,Chicago Bulls,1,1,36,35,71,7,15,22,43,50,93,14,6,20,16,36,22,6,10,98,107
2022,2,22200756,1/30/2023,1610612753,Orlando Magic,0,1,1610612755,Philadelphia 76ers,1,0,31,39,70,11,18,29,42,57,99,24,6,30,18,41,23,8,10,104,119
2022,2,22200832,2/9/2023,1610612737,Atlanta Hawks,1,1,1610612756,Phoenix Suns,0,0,33,33,66,10,19,29,43,52,95,20,7,27,26,29,23,14,19,100,116
2023,2,22300088,10/28/2023,1610612765,Detroit Pistons,1,1,1610612741,Chicago Bulls,0,0,33,25,58,12,16,28,45,41,86,16,4,20,18,25,29,10,17,93,118
2014,2,21401066,3/25/2015,1610612739,Cleveland Cavaliers,0,1,1610612763,Memphis Grizzlies,1,0,29,21,50,14,20,34,43,41,84,11,2,13,16,26,30,9,18,92,111
2022,2,22200742,1/28/2023,1610612751,Brooklyn Nets,1,1,1610612752,New York Knicks,0,0,24,23,47,22,18,40,46,41,87,8,6,14,11,32,31,4,9,94,122
2020,2,22000462,2/20/2021,1610612756,Phoenix Suns,0,1,1610612763,Memphis Grizzlies,1,0,22,18,40,24,22,46,46,40,86,12,1,13,8,33,35,5,12,96,128
2017,2,21700523,12/29/2017,1610612748,Miami Heat,1,0,1610612751,Brooklyn Nets,0,1,27,36,63,3,23,26,30,59,89,24,7,31,14,48,12,8,10,100,87
2017,2,21700523,12/29/2017,1610612751,Brooklyn Nets,0,1,1610612748,Miami Heat,1,0,28,25,53,11,15,26,39,40,79,22,3,25,9,32,25,9,20,100,111
2014,2,21401066,3/25/2015,1610612763,Memphis Grizzlies,1,0,1610612739,Cleveland Cavaliers,0,1,33,35,68,4,13,17,37,48,85,11,5,16,10,41,18,6,8,92,89
2014,2,21400506,1/4/2015,1610612749,Milwaukee Bucks,0,1,1610612752,New York Knicks,1,0,31,30,61,4,12,16,35,42,77,21,6,27,16,29,23,8,19,90,95
2014,2,21400152,11/17/2014,1610612755,Philadelphia 76ers,0,0,1610612759,San Antonio Spurs,1,1,23,34,57,4,22,26,27,56,83,17,7,24,10,51,15,9,14,98,75
2022,2,22200731,1/26/2023,1610612751,Brooklyn Nets,1,0,1610612765,Detroit Pistons,0,1,30,26,56,13,25,38,43,51,94,23,4,27,18,34,24,12,16,101,122
2020,2,22000462,2/20/2021,1610612763,Memphis Grizzlies,1,0,1610612756,Phoenix Suns,0,1,31,29,60,5,28,33,36,57,93,20,3,23,22,37,19,5,12,94,97
2014,2,21400152,11/17/2014,1610612759,San Antonio Spurs,1,1,1610612755,Philadelphia 76ers,0,0,26,29,55,10,16,26,36,45,81,18,3,21,11,35,27,11,18,99,100
2021,2,22100731,1/26/2022,1610612756,Phoenix Suns,0,1,1610612762,Utah Jazz,1,0,33,31,64,7,11,18,40,42,82,18,9,27,12,32,14,6,9,94,105
2014,2,21400151,11/17/2014,1610612745,Houston Rockets,0,0,1610612763,Memphis Grizzlies,1,1,26,18,44,8,26,34,34,44,78,17,4,21,16,31,24,14,21,93,93
2021,2,22100731,1/26/2022,1610612762,Utah Jazz,1,0,1610612756,Phoenix Suns,0,1,22,27,49,12,18,30,34,45,79,17,6,23,14,36,20,6,16,93,97
2021,2,22101060,3/19/2022,1610612739,Cleveland Cavaliers,1,1,1610612765,Detroit Pistons,0,0,35,27,62,10,16,26,45,43,88,13,10,23,18,28,28,10,16,97,113
2021,2,22101060,3/19/2022,1610612765,Detroit Pistons,0,0,1610612739,Cleveland Cavaliers,1,1,28,27,55,13,17,30,41,44,85,14,5,19,13,33,23,7,16,97,109
2016,2,21600376,12/14/2016,1610612746,LA Clippers,0,1,1610612753,Orlando Magic,1,0,24,25,49,13,12,25,37,37,74,26,11,37,12,31,21,5,11,92,113
2016,2,21600376,12/14/2016,1610612753,Orlando Magic,1,0,1610612746,LA Clippers,0,1,28,28,56,14,19,33,42,47,89,10,10,20,16,37,29,6,8,90,108
2014,2,21400506,1/4/2015,1610612752,New York Knicks,1,0,1610612749,Milwaukee Bucks,0,1,22,29,51,9,16,25,31,45,76,11,3,14,11,36,23,10,18,91,82
2014,2,21400151,11/17/2014,1610612763,Memphis Grizzlies,1,1,1610612745,Houston Rockets,0,0,39,30,69,7,10,17,46,40,86,20,2,22,14,26,27,6,11,94,119
2022,2,22200775,2/1/2023,1610612759,San Antonio Spurs,1,0,1610612758,Sacramento Kings,0,1,40,24,64,8,16,24,48,40,88,5,2,7,9,32,30,10,18,100,109
2017,2,21700522,12/29/2017,1610612737,Atlanta Hawks,0,0,1610612761,Toronto Raptors,1,1,29,35,64,9,15,24,38,50,88,13,7,20,21,32,21,9,18,95,98
2017,2,21700522,12/29/2017,1610612761,Toronto Raptors,1,1,1610612737,Atlanta Hawks,0,0,33,35,68,13,24,37,46,59,105,6,2,8,25,35,22,6,12,95,111
2020,2,22000461,4/14/2021,1610612745,Houston Rockets,1,0,1610612754,Indiana Pacers,0,1,38,32,70,10,24,34,48,56,104,18,4,22,21,37,22,10,15,107,124
2022,2,22200833,2/9/2023,1610612751,Brooklyn Nets,1,1,1610612741,Chicago Bulls,0,0,22,25,47,17,27,44,39,52,91,21,4,25,13,41,26,4,11,101,116
2014,2,21400150,11/17/2014,1610612753,Orlando Magic,0,1,1610612765,Detroit Pistons,1,0,28,25,53,13,13,26,41,38,79,12,3,15,8,31,33,5,12,90,107
2014,2,21400150,11/17/2014,1610612765,Detroit Pistons,1,0,1610612753,Orlando Magic,0,1,21,35,56,11,13,24,32,48,80,18,6,24,14,39,17,9,14,90,93
2022,2,22200689,1/20/2023,1610612751,Brooklyn Nets,0,1,1610612762,Utah Jazz,1,0,25,14,39,18,23,41,43,37,80,13,7,20,8,35,26,6,11,94,117
2021,2,22101059,3/19/2022,1610612742,Dallas Mavericks,0,0,1610612766,Charlotte Hornets,1,1,25,26,51,14,24,38,39,50,89,16,4,20,16,37,18,8,15,98,108
2021,2,22101059,3/19/2022,1610612766,Charlotte Hornets,1,1,1610612742,Dallas Mavericks,0,0,24,22,46,20,22,42,44,44,88,21,6,27,13,34,33,4,9,98,129
2014,2,21400149,11/17/2014,1610612748,Miami Heat,0,1,1610612751,Brooklyn Nets,1,0,22,23,45,9,18,27,31,41,72,24,3,27,18,26,19,10,15,83,95
2014,2,21400149,11/17/2014,1610612751,Brooklyn Nets,1,0,1610612748,Miami Heat,0,1,20,27,47,9,14,23,29,41,70,16,10,26,12,34,18,6,12,83,83
2017,2,21700521,12/29/2017,1610612745,Houston Rockets,0,0,1610612764,Washington Wizards,1,1,24,17,41,14,34,48,38,51,89,13,3,16,13,39,15,12,14,100,103
2017,2,21700521,12/29/2017,1610612764,Washington Wizards,1,1,1610612745,Houston Rockets,0,0,29,23,52,18,18,36,47,41,88,9,3,12,14,28,23,11,18,98,121
2014,2,21401065,3/25/2015,1610612741,Chicago Bulls,0,1,1610612761,Toronto Raptors,1,0,33,18,51,12,11,23,45,29,74,14,3,17,4,26,26,6,8,86,116
2014,2,21401065,3/25/2015,1610612761,Toronto Raptors,1,0,1610612741,Chicago Bulls,0,1,30,32,62,9,12,21,39,44,83,16,3,19,14,32,16,4,7,87,103
2017,2,21700520,12/28/2017,1610612755,Philadelphia 76ers,0,0,1610612757,Portland Trail Blazers,1,1,26,29,55,16,16,32,42,45,87,10,4,14,6,41,28,7,14,101,110
2017,2,21700520,12/28/2017,1610612757,Portland Trail Blazers,1,1,1610612755,Philadelphia 76ers,0,0,27,24,51,8,16,24,35,40,75,36,11,47,12,32,15,8,15,101,114
2014,2,21400505,1/4/2015,1610612748,Miami Heat,1,1,1610612751,Brooklyn Nets,0,0,26,27,53,5,9,14,31,36,67,21,7,28,11,28,21,9,16,86,88
2014,2,21400505,1/4/2015,1610612751,Brooklyn Nets,0,0,1610612748,Miami Heat,1,1,27,35,62,7,17,24,34,52,86,9,4,13,18,36,18,8,11,86,84
2014,2,21400148,11/17/2014,1610612738,Boston Celtics,1,0,1610612756,Phoenix Suns,0,1,41,36,77,4,6,10,45,42,87,20,11,31,13,33,28,11,19,107,114
2023,2,22300188,11/13/2023,1610612752,New York Knicks,0,0,1610612738,Boston Celtics,1,1,18,26,44,15,20,35,33,46,79,17,7,24,17,31,17,3,12,85,98
2020,2,22000461,4/14/2021,1610612754,Indiana Pacers,0,1,1610612745,Houston Rockets,1,0,35,23,58,15,21,36,50,44,94,17,5,22,14,33,28,12,18,107,132
2021,2,22101058,3/19/2022,1610612749,Milwaukee Bucks,0,0,1610612750,Minnesota Timberwolves,1,1,24,21,45,19,33,52,43,54,97,14,3,17,16,38,27,12,14,106,119
2022,2,22200566,1/4/2023,1610612753,Orlando Magic,1,1,1610612760,Oklahoma City Thunder,0,0,29,19,48,13,20,33,42,39,81,29,7,36,15,27,26,9,17,99,126
2022,2,22200566,1/4/2023,1610612760,Oklahoma City Thunder,0,0,1610612753,Orlando Magic,1,1,21,31,52,15,22,37,36,53,89,28,3,31,15,39,23,6,9,99,115
2021,2,22101058,3/19/2022,1610612750,Minnesota Timberwolves,1,1,1610612749,Milwaukee Bucks,0,0,25,20,45,22,25,47,47,45,92,22,4,26,10,38,30,6,11,104,138
2014,2,21400504,1/4/2015,1610612758,Sacramento Kings,0,0,1610612765,Detroit Pistons,1,1,29,31,60,3,12,15,32,43,75,28,8,36,6,42,18,8,16,99,95
2014,2,21400504,1/4/2015,1610612765,Detroit Pistons,1,1,1610612758,Sacramento Kings,0,0,33,27,60,12,19,31,45,46,91,12,4,16,11,37,21,9,13,99,114
2017,2,21700519,12/28/2017,1610612752,New York Knicks,0,0,1610612759,San Antonio Spurs,1,1,36,40,76,5,9,14,41,49,90,20,2,22,15,36,31,2,10,95,107
2014,2,21400148,11/17/2014,1610612756,Phoenix Suns,0,1,1610612738,Boston Celtics,1,0,39,33,72,9,12,21,48,45,93,13,3,16,12,35,30,10,18,107,118
2017,2,21700519,12/28/2017,1610612759,San Antonio Spurs,1,1,1610612752,New York Knicks,0,0,32,28,60,9,11,20,41,39,80,28,11,39,13,33,28,6,9,95,119
2021,2,22100730,1/24/2022,1610612741,Chicago Bulls,0,1,1610612760,Oklahoma City Thunder,1,0,26,24,50,15,24,39,41,48,89,14,5,19,15,35,31,9,19,101,111
2021,2,22100730,1/24/2022,1610612760,Oklahoma City Thunder,1,0,1610612741,Chicago Bulls,0,1,22,25,47,16,29,45,38,54,92,18,6,24,13,44,26,7,11,102,110
2020,2,22000460,2/20/2021,1610612741,Chicago Bulls,1,1,1610612758,Sacramento Kings,0,0,38,21,59,11,12,23,49,33,82,13,2,15,5,30,24,8,14,99,122
2021,2,22101057,3/18/2022,1610612738,Boston Celtics,0,1,1610612758,Sacramento Kings,1,0,24,18,42,22,18,40,46,36,82,12,5,17,9,30,33,5,13,95,126
2021,2,22101057,3/18/2022,1610612758,Sacramento Kings,1,0,1610612738,Boston Celtics,0,1,20,23,43,13,23,36,33,46,79,18,6,24,10,38,23,11,16,96,97
2014,2,21400503,1/4/2015,1610612739,Cleveland Cavaliers,1,0,1610612742,Dallas Mavericks,0,1,27,34,61,8,17,25,35,51,86,12,5,17,19,35,26,7,14,89,90
2014,2,21400503,1/4/2015,1610612742,Dallas Mavericks,0,1,1610612739,Cleveland Cavaliers,1,0,32,20,52,12,14,26,44,34,78,9,2,11,6,29,30,6,10,90,109
2022,2,22200688,1/20/2023,1610612743,Denver Nuggets,1,1,1610612754,Indiana Pacers,0,0,37,18,55,14,14,28,51,32,83,18,8,26,12,25,38,7,18,100,134
2020,2,22000751,4/3/2021,1610612759,San Antonio Spurs,1,0,1610612754,Indiana Pacers,0,1,38,32,70,10,19,29,48,51,99,27,5,32,21,33,22,10,18,109,133
2014,2,21400147,11/17/2014,1610612739,Cleveland Cavaliers,1,0,1610612743,Denver Nuggets,0,1,24,26,50,10,19,29,34,45,79,19,4,23,12,34,18,10,15,94,97
2014,2,21400147,11/17/2014,1610612743,Denver Nuggets,0,1,1610612739,Cleveland Cavaliers,1,0,29,25,54,12,19,31,41,44,85,12,3,15,12,34,25,7,15,94,106
2014,2,21401064,3/25/2015,1610612738,Boston Celtics,1,0,1610612748,Miami Heat,0,1,23,27,50,5,14,19,28,41,69,25,12,37,12,34,16,7,17,93,86
2014,2,21401064,3/25/2015,1610612748,Miami Heat,0,1,1610612738,Boston Celtics,1,0,25,28,53,9,15,24,34,43,77,16,7,23,12,36,23,8,17,92,93
2022,2,22200742,1/28/2023,1610612752,New York Knicks,0,0,1610612751,Brooklyn Nets,1,1,35,25,60,10,18,28,45,43,88,15,4,19,16,29,19,5,11,93,115
2014,2,21400146,11/17/2014,1610612742,Dallas Mavericks,0,1,1610612766,Charlotte Hornets,1,0,33,23,56,10,18,28,43,41,84,11,5,16,12,32,32,1,8,88,107
2014,2,21400146,11/17/2014,1610612766,Charlotte Hornets,1,0,1610612742,Dallas Mavericks,0,1,22,36,58,10,12,22,32,48,80,6,7,13,12,41,22,7,13,87,80
2014,2,21401063,3/25/2015,1610612754,Indiana Pacers,0,1,1610612764,Washington Wizards,1,0,29,30,59,9,17,26,38,47,85,18,10,28,13,40,21,6,10,95,103
2021,2,22100729,1/28/2022,1610612740,New Orleans Pelicans,1,0,1610612743,Denver Nuggets,0,1,30,26,56,5,29,34,35,55,90,30,3,33,18,37,23,9,13,103,105
2022,2,22201071,3/20/2023,1610612754,Indiana Pacers,0,0,1610612766,Charlotte Hornets,1,1,28,28,56,9,17,26,37,45,82,26,8,34,19,29,27,12,22,103,109
2021,2,22100729,1/28/2022,1610612743,Denver Nuggets,0,1,1610612740,New Orleans Pelicans,1,0,29,20,49,12,21,33,41,41,82,22,3,25,12,30,29,14,21,102,116
2014,2,21401063,3/25/2015,1610612764,Washington Wizards,1,0,1610612754,Indiana Pacers,0,1,28,33,61,5,9,14,33,42,75,30,8,38,9,36,13,7,10,96,101
2021,2,22101056,3/18/2022,1610612741,Chicago Bulls,0,0,1610612756,Phoenix Suns,1,1,28,30,58,7,20,27,35,50,85,25,6,31,15,39,20,5,11,97,102
2021,2,22101056,3/18/2022,1610612756,Phoenix Suns,1,1,1610612741,Chicago Bulls,0,0,36,23,59,11,14,25,47,37,84,24,2,26,12,26,23,6,13,98,129
2022,2,22200773,2/1/2023,1610612760,Oklahoma City Thunder,0,0,1610612745,Houston Rockets,1,1,26,34,60,12,31,43,38,65,103,18,4,22,25,41,22,6,10,98,106
2023,2,22300012,11/10/2023,1610612762,Utah Jazz,0,1,1610612763,Memphis Grizzlies,1,0,23,16,39,18,19,37,41,35,76,27,2,29,11,25,28,5,21,99,127
2021,2,22100728,1/26/2022,1610612759,San Antonio Spurs,1,0,1610612763,Memphis Grizzlies,0,1,34,23,57,9,28,37,43,51,94,15,4,19,18,34,30,9,13,100,110
2017,2,21700518,12/28/2017,1610612749,Milwaukee Bucks,1,1,1610612750,Minnesota Timberwolves,0,0,36,24,60,5,10,15,41,34,75,15,1,16,8,27,23,9,18,92,102
2021,2,22101055,3/18/2022,1610612746,LA Clippers,0,0,1610612762,Utah Jazz,1,1,20,31,51,11,24,35,31,55,86,19,2,21,11,45,23,9,12,99,92
2014,2,21400145,11/16/2014,1610612744,Golden State Warriors,0,1,1610612747,Los Angeles Lakers,1,0,32,26,58,14,14,28,46,40,86,30,4,34,14,28,32,9,16,103,136
2014,2,21400145,11/16/2014,1610612747,Los Angeles Lakers,1,0,1610612744,Golden State Warriors,0,1,36,47,83,3,13,16,39,60,99,34,9,43,23,41,17,4,7,103,115
2021,2,22101055,3/18/2022,1610612762,Utah Jazz,1,1,1610612746,LA Clippers,0,0,31,22,53,16,28,44,47,50,97,11,3,14,16,35,30,10,12,99,121
2023,2,22300189,11/13/2023,1610612764,Washington Wizards,0,0,1610612761,Toronto Raptors,1,1,31,27,58,12,14,26,43,41,84,9,3,12,9,34,32,11,22,101,107
2017,2,21700518,12/28/2017,1610612750,Minnesota Timberwolves,0,0,1610612749,Milwaukee Bucks,1,1,25,18,43,9,19,28,34,37,71,19,7,26,11,31,20,10,19,92,96
2023,2,22300089,10/28/2023,1610612763,Memphis Grizzlies,0,0,1610612764,Washington Wizards,1,1,20,24,44,19,28,47,39,52,91,9,0,9,12,40,27,9,18,102,106
2021,2,22100728,1/26/2022,1610612763,Memphis Grizzlies,0,1,1610612759,San Antonio Spurs,1,0,39,28,67,7,16,23,46,44,90,19,7,26,17,29,24,9,13,99,118
2020,2,22000460,2/20/2021,1610612758,Sacramento Kings,0,0,1610612741,Chicago Bulls,1,1,36,33,69,8,21,29,44,54,98,18,4,22,15,41,22,5,7,98,114
2023,2,22300312,12/13/2023,1610612748,Miami Heat,1,1,1610612766,Charlotte Hornets,0,0,26,30,56,15,15,30,41,45,86,18,1,19,18,27,29,11,23,98,115
2022,2,22201072,3/20/2023,1610612741,Chicago Bulls,0,1,1610612755,Philadelphia 76ers,1,0,32,29,61,7,26,33,39,55,94,24,5,29,11,47,20,8,11,109,109
2020,2,22000750,4/3/2021,1610612750,Minnesota Timberwolves,0,0,1610612755,Philadelphia 76ers,1,1,23,19,42,12,24,36,35,43,78,31,5,36,6,38,17,7,11,100,113
2020,2,22000750,4/3/2021,1610612755,Philadelphia 76ers,1,1,1610612750,Minnesota Timberwolves,0,0,29,24,53,12,16,28,41,40,81,28,9,37,13,32,26,7,12,99,122
2023,2,22300157,11/8/2023,1610612764,Washington Wizards,0,1,1610612766,Charlotte Hornets,1,0,29,25,54,18,25,43,47,50,97,20,5,25,17,38,26,8,11,101,132
2016,2,21600908,3/2/2017,1610612757,Portland Trail Blazers,1,1,1610612760,Oklahoma City Thunder,0,0,29,25,54,10,15,25,39,40,79,26,9,35,14,29,19,9,14,97,114
2021,2,22100727,1/26/2022,1610612748,Miami Heat,1,1,1610612752,New York Knicks,0,0,21,16,37,16,21,37,37,37,74,20,2,22,10,29,30,8,20,93,110
2021,2,22100727,1/26/2022,1610612752,New York Knicks,0,0,1610612748,Miami Heat,1,1,20,19,39,15,29,44,35,48,83,11,6,17,16,34,24,8,18,92,96
2020,2,22000459,2/20/2021,1610612744,Golden State Warriors,0,0,1610612766,Charlotte Hornets,1,1,24,22,46,13,26,39,37,48,85,13,4,17,10,41,23,7,14,97,100
2020,2,22000459,2/20/2021,1610612766,Charlotte Hornets,1,1,1610612744,Golden State Warriors,0,0,17,18,35,20,20,40,37,38,75,8,1,9,6,32,23,10,25,98,102
2021,2,22101054,3/18/2022,1610612740,New Orleans Pelicans,0,1,1610612759,San Antonio Spurs,1,0,34,28,62,14,20,34,48,48,96,14,4,18,15,35,24,5,10,101,124
2021,2,22101054,3/18/2022,1610612759,San Antonio Spurs,1,0,1610612740,New Orleans Pelicans,0,1,21,24,45,11,33,44,32,57,89,16,4,20,14,46,22,13,16,103,91
2016,2,21600908,3/2/2017,1610612760,Oklahoma City Thunder,0,0,1610612757,Portland Trail Blazers,1,1,23,34,57,11,18,29,34,52,86,30,2,32,15,38,11,9,12,97,109
2016,2,21600375,12/14/2016,1610612764,Washington Wizards,1,1,1610612766,Charlotte Hornets,0,0,40,29,69,5,13,18,45,42,87,14,3,17,13,31,27,7,14,96,109
2020,2,22000749,4/3/2021,1610612739,Cleveland Cavaliers,0,0,1610612748,Miami Heat,1,1,25,18,43,10,21,31,35,39,74,21,4,25,8,34,25,6,16,94,101
2020,2,22000749,4/3/2021,1610612748,Miami Heat,1,1,1610612739,Cleveland Cavaliers,0,0,29,15,44,15,23,38,44,38,82,12,4,16,7,31,35,7,11,95,115
2017,2,21700517,12/28/2017,1610612738,Boston Celtics,1,1,1610612745,Houston Rockets,0,0,29,24,53,8,21,29,37,45,82,17,7,24,12,37,18,9,17,100,99
2023,2,22300226,11/22/2023,1610612743,Denver Nuggets,0,0,1610612753,Orlando Magic,1,1,29,29,58,15,20,35,44,49,93,16,5,21,22,30,29,9,12,96,119
2017,2,21700517,12/28/2017,1610612745,Houston Rockets,0,0,1610612738,Boston Celtics,1,1,16,21,37,14,29,43,30,50,80,24,7,31,11,42,16,9,18,99,98
2014,2,21401062,3/25/2015,1610612737,Atlanta Hawks,0,1,1610612753,Orlando Magic,1,0,29,30,59,10,21,31,39,51,90,7,3,10,18,35,21,7,14,92,95
2014,2,21401062,3/25/2015,1610612753,Orlando Magic,1,0,1610612737,Atlanta Hawks,0,1,29,33,62,3,13,16,32,46,78,16,4,20,13,34,19,9,17,91,83
2017,2,21700516,12/28/2017,1610612753,Orlando Magic,1,1,1610612765,Detroit Pistons,0,0,26,30,56,11,15,26,37,45,82,17,0,17,12,33,22,5,19,98,102
2017,2,21700516,12/28/2017,1610612765,Detroit Pistons,0,0,1610612753,Orlando Magic,1,1,26,38,64,9,14,23,35,52,87,10,4,14,13,42,20,10,16,98,89
2014,2,21400144,11/16/2014,1610612745,Houston Rockets,0,1,1610612760,Oklahoma City Thunder,1,0,16,29,45,7,28,35,23,57,80,16,14,30,25,39,11,6,17,86,69
2014,2,21400144,11/16/2014,1610612760,Oklahoma City Thunder,1,0,1610612745,Houston Rockets,0,1,17,32,49,3,16,19,20,48,68,22,6,28,12,38,14,5,16,86,65
2020,2,22000458,5/13/2021,1610612752,New York Knicks,1,1,1610612759,San Antonio Spurs,0,0,21,30,51,14,21,35,35,51,86,18,0,18,11,40,23,4,10,94,102
2020,2,22000458,5/13/2021,1610612759,San Antonio Spurs,0,0,1610612752,New York Knicks,1,1,32,38,70,6,15,21,38,53,91,16,3,19,16,40,22,7,11,93,98
2022,2,22200775,2/1/2023,1610612758,Sacramento Kings,0,1,1610612759,San Antonio Spurs,1,0,40,23,63,8,19,27,48,42,90,15,4,19,8,36,25,5,10,102,119
2016,2,21600375,12/14/2016,1610612766,Charlotte Hornets,0,0,1610612764,Washington Wizards,1,1,24,17,41,14,19,33,38,36,74,16,5,21,8,30,25,15,18,97,106
2020,2,22000748,4/3/2021,1610612752,New York Knicks,0,1,1610612765,Detroit Pistons,1,0,24,16,40,19,20,39,43,36,79,20,7,27,9,31,31,4,7,89,125
2020,2,22000748,4/3/2021,1610612765,Detroit Pistons,1,0,1610612752,New York Knicks,0,1,20,34,54,9,19,28,29,53,82,14,6,20,18,38,20,12,15,90,81
2017,2,21700515,12/27/2017,1610612747,Los Angeles Lakers,1,0,1610612763,Memphis Grizzlies,0,1,27,38,65,8,20,28,35,58,93,21,12,33,31,34,14,3,12,91,99
2017,2,21700515,12/27/2017,1610612763,Memphis Grizzlies,0,1,1610612747,Los Angeles Lakers,1,0,30,20,50,5,16,21,35,36,71,34,5,39,10,28,20,5,11,91,109
2014,2,21400143,11/16/2014,1610612748,Miami Heat,1,0,1610612749,Milwaukee Bucks,0,1,19,29,48,11,14,25,30,43,73,13,9,22,8,38,19,11,17,92,84
2014,2,21400143,11/16/2014,1610612749,Milwaukee Bucks,0,1,1610612748,Miami Heat,1,0,30,26,56,5,13,18,35,39,74,16,10,26,9,38,16,10,16,92,91
2022,2,22200852,2/11/2023,1610612739,Cleveland Cavaliers,1,1,1610612741,Chicago Bulls,0,0,27,24,51,9,26,35,36,50,86,16,3,19,13,39,26,7,13,94,97
2016,2,21600907,3/2/2017,1610612756,Phoenix Suns,1,1,1610612766,Charlotte Hornets,0,0,39,19,58,7,12,19,46,31,77,21,4,25,5,26,30,14,19,101,120
2016,2,21600907,3/2/2017,1610612766,Charlotte Hornets,0,0,1610612756,Phoenix Suns,1,1,25,30,55,10,24,34,35,54,89,23,5,28,15,41,19,8,16,103,103
2016,2,21600374,12/14/2016,1610612755,Philadelphia 76ers,1,0,1610612761,Toronto Raptors,0,1,34,23,57,9,20,29,43,43,86,19,6,25,18,27,29,9,14,95,114
2016,2,21600374,12/14/2016,1610612761,Toronto Raptors,0,1,1610612755,Philadelphia 76ers,1,0,31,27,58,10,19,29,41,46,87,31,5,36,20,30,21,5,11,95,123
2023,2,22300034,11/17/2023,1610612740,New Orleans Pelicans,1,1,1610612743,Denver Nuggets,0,0,34,31,65,12,11,23,46,42,88,11,10,21,9,42,33,4,11,98,115
2014,2,21401061,3/25/2015,1610612746,LA Clippers,0,1,1610612752,New York Knicks,1,0,33,17,50,11,17,28,44,34,78,12,6,18,8,29,31,8,15,93,111
2014,2,21401061,3/25/2015,1610612752,New York Knicks,1,0,1610612746,LA Clippers,0,1,24,35,59,5,18,23,29,53,82,17,2,19,19,35,14,12,20,95,80
2014,2,21400142,11/16/2014,1610612743,Denver Nuggets,0,0,1610612752,New York Knicks,1,1,19,29,48,13,21,34,32,50,82,16,10,26,13,38,20,9,18,97,93
2014,2,21400142,11/16/2014,1610612752,New York Knicks,1,1,1610612743,Denver Nuggets,0,0,35,27,62,6,8,14,41,35,76,21,6,27,10,29,16,9,16,95,109
2023,2,22301209,12/6/2023,1610612737,Atlanta Hawks,1,0,1610612751,Brooklyn Nets,0,1,30,29,59,12,23,35,42,52,94,17,1,18,13,39,25,7,13,103,113
2017,2,21700514,12/27/2017,1610612744,Golden State Warriors,1,1,1610612762,Utah Jazz,0,0,40,23,63,11,12,23,51,35,86,13,4,17,6,33,37,10,16,102,126
2017,2,21700514,12/27/2017,1610612762,Utah Jazz,0,0,1610612744,Golden State Warriors,1,1,31,38,69,6,17,23,37,55,92,20,6,26,13,47,21,8,13,104,100
2014,2,21400141,11/15/2014,1610612746,LA Clippers,1,1,1610612756,Phoenix Suns,0,0,22,17,39,14,15,29,36,32,68,34,9,43,8,29,24,9,21,102,120
2022,2,22200793,2/4/2023,1610612751,Brooklyn Nets,1,1,1610612764,Washington Wizards,0,0,29,24,53,14,19,33,43,43,86,25,3,28,11,34,21,10,15,101,125
2014,2,21400141,11/15/2014,1610612756,Phoenix Suns,0,0,1610612746,LA Clippers,1,1,27,42,69,11,19,30,38,61,99,20,3,23,18,44,26,5,10,103,107
2022,2,22200765,1/31/2023,1610612747,Los Angeles Lakers,0,1,1610612752,New York Knicks,1,0,37,23,60,11,22,33,48,45,93,22,9,31,13,35,29,6,14,107,129
2022,2,22200733,1/26/2023,1610612739,Cleveland Cavaliers,0,1,1610612745,Houston Rockets,1,0,25,26,51,15,21,36,40,47,87,18,4,22,14,36,29,5,10,92,113
2022,2,22201071,3/20/2023,1610612766,Charlotte Hornets,1,1,1610612754,Indiana Pacers,0,0,31,28,59,10,21,31,41,49,90,23,9,32,15,38,26,5,11,102,115
2014,2,21400502,1/3/2015,1610612746,LA Clippers,1,1,1610612755,Philadelphia 76ers,0,0,31,17,48,15,22,37,46,39,85,20,6,26,11,30,33,7,9,95,127
2023,2,22300090,10/28/2023,1610612752,New York Knicks,0,0,1610612740,New Orleans Pelicans,1,1,26,27,53,7,30,37,33,57,90,14,4,18,19,40,19,8,19,100,87
2014,2,21400502,1/3/2015,1610612755,Philadelphia 76ers,0,0,1610612746,LA Clippers,1,1,23,31,54,9,16,25,32,47,79,18,8,26,17,35,17,13,21,95,91
2023,2,22300011,11/10/2023,1610612740,New Orleans Pelicans,0,0,1610612745,Houston Rockets,1,1,26,24,50,8,17,25,34,41,75,25,9,34,10,35,12,9,18,97,101
2021,2,22100726,2/28/2022,1610612751,Brooklyn Nets,1,0,1610612761,Toronto Raptors,0,1,21,30,51,12,23,35,33,53,86,19,5,24,21,33,23,17,23,99,97
2021,2,22100726,2/28/2022,1610612761,Toronto Raptors,0,1,1610612751,Brooklyn Nets,1,0,33,28,61,18,20,38,51,48,99,13,9,22,21,32,35,4,13,98,133
2014,2,21401060,3/25/2015,1610612751,Brooklyn Nets,0,1,1610612766,Charlotte Hornets,1,0,36,41,77,3,11,14,39,52,91,10,1,11,8,44,28,4,9,98,91
2021,2,22101053,3/18/2022,1610612745,Houston Rockets,1,0,1610612754,Indiana Pacers,0,1,27,25,52,12,15,27,39,40,79,28,4,32,8,32,24,7,16,101,118
2021,2,22101053,3/18/2022,1610612754,Indiana Pacers,0,1,1610612745,Houston Rockets,1,0,33,25,58,14,29,43,47,54,101,13,6,19,21,38,29,9,13,103,121
2014,2,21401060,3/25/2015,1610612766,Charlotte Hornets,1,0,1610612751,Brooklyn Nets,0,1,33,46,79,3,9,12,36,55,91,13,7,20,14,43,23,6,12,97,88
2019,2,21900211,11/20/2019,1610612743,Denver Nuggets,1,1,1610612745,Houston Rockets,0,0,35,32,67,9,18,27,44,50,94,8,7,15,18,35,29,9,15,95,105
2019,2,21900211,11/20/2019,1610612745,Houston Rockets,0,0,1610612743,Denver Nuggets,1,1,20,18,38,12,26,38,32,44,76,19,6,25,13,34,19,13,21,95,95
2017,2,21700513,12/27/2017,1610612739,Cleveland Cavaliers,0,0,1610612758,Sacramento Kings,1,1,20,23,43,12,19,31,32,42,74,19,6,25,9,35,19,8,12,90,95
2014,2,21401059,3/24/2015,1610612744,Golden State Warriors,0,1,1610612757,Portland Trail Blazers,1,0,38,19,57,12,14,26,50,33,83,10,1,11,8,25,37,9,14,95,122
2014,2,21401059,3/24/2015,1610612757,Portland Trail Blazers,1,0,1610612744,Golden State Warriors,0,1,24,34,58,15,19,34,39,53,92,15,4,19,14,41,23,4,10,96,108
2017,2,21700513,12/27/2017,1610612758,Sacramento Kings,1,1,1610612739,Cleveland Cavaliers,0,0,29,20,49,12,18,30,41,38,79,15,3,18,8,31,25,9,11,90,109
2014,2,21400501,1/3/2015,1610612737,Atlanta Hawks,0,1,1610612757,Portland Trail Blazers,1,0,37,30,67,6,11,17,43,41,84,23,8,31,11,34,17,6,14,100,115
2014,2,21400501,1/3/2015,1610612757,Portland Trail Blazers,1,0,1610612737,Atlanta Hawks,0,1,29,31,60,13,20,33,42,51,93,10,2,12,15,37,24,9,18,102,107
2017,2,21700512,12/27/2017,1610612760,Oklahoma City Thunder,1,1,1610612761,Toronto Raptors,0,0,37,25,62,9,16,25,46,41,87,23,10,33,16,29,25,9,12,97,124
2017,2,21700512,12/27/2017,1610612761,Toronto Raptors,0,0,1610612760,Oklahoma City Thunder,1,1,25,22,47,11,27,38,36,49,85,24,2,26,9,41,24,9,11,98,107
2014,2,21400140,11/15/2014,1610612744,Golden State Warriors,1,1,1610612766,Charlotte Hornets,0,0,34,27,61,11,15,26,45,42,87,11,3,14,11,33,30,5,15,96,112
2014,2,21400140,11/15/2014,1610612766,Charlotte Hornets,0,0,1610612744,Golden State Warriors,1,1,25,42,67,7,10,17,32,52,84,16,12,28,13,44,14,7,13,96,87
2021,2,22100725,1/26/2022,1610612737,Atlanta Hawks,1,1,1610612758,Sacramento Kings,0,0,36,18,54,12,24,36,48,42,90,13,4,17,8,35,29,6,9,100,121
2021,2,22100725,1/26/2022,1610612758,Sacramento Kings,0,0,1610612737,Atlanta Hawks,1,1,27,26,53,12,28,40,39,54,93,14,5,19,14,44,23,9,12,100,104
2017,2,21700511,12/27/2017,1610612740,New Orleans Pelicans,1,1,1610612751,Brooklyn Nets,0,0,31,26,57,17,16,33,48,42,90,14,4,18,10,34,40,8,11,101,127
2020,2,22000457,2/19/2021,1610612746,LA Clippers,1,1,1610612762,Utah Jazz,0,0,33,26,59,10,20,30,43,46,89,20,2,22,12,35,22,7,11,99,116
2020,2,22000457,2/19/2021,1610612762,Utah Jazz,0,0,1610612746,LA Clippers,1,1,29,23,52,12,22,34,41,45,86,18,3,21,10,37,13,5,11,98,112
2017,2,21700511,12/27/2017,1610612751,Brooklyn Nets,0,0,1610612740,New Orleans Pelicans,1,1,22,30,52,19,19,38,41,49,90,11,2,13,12,39,26,8,17,101,112
2014,2,21400139,11/15/2014,1610612758,Sacramento Kings,1,1,1610612759,San Antonio Spurs,0,0,37,37,74,0,12,12,37,49,86,20,4,24,16,36,19,6,9,93,94
2014,2,21400139,11/15/2014,1610612759,San Antonio Spurs,0,0,1610612758,Sacramento Kings,1,1,27,29,56,7,17,24,34,46,80,16,2,18,10,36,24,5,14,92,91
2021,2,22101052,3/18/2022,1610612748,Miami Heat,1,1,1610612760,Oklahoma City Thunder,0,0,28,16,44,18,33,51,46,49,95,10,2,12,14,36,25,4,6,94,120
2021,2,22101052,3/18/2022,1610612760,Oklahoma City Thunder,0,0,1610612748,Miami Heat,1,1,30,20,50,10,24,34,40,44,84,18,5,23,12,35,19,5,12,93,108
2014,2,21400500,1/3/2015,1610612743,Denver Nuggets,1,1,1610612763,Memphis Grizzlies,0,0,34,30,64,7,8,15,41,38,79,25,6,31,10,30,21,6,13,93,114
2014,2,21400500,1/3/2015,1610612763,Memphis Grizzlies,0,0,1610612743,Denver Nuggets,1,1,35,37,72,2,12,14,37,49,86,9,4,13,12,41,20,6,13,93,85
2017,2,21700510,12/27/2017,1610612743,Denver Nuggets,0,0,1610612750,Minnesota Timberwolves,1,1,27,25,52,15,24,39,42,49,91,26,5,31,15,36,26,4,9,100,125
2017,2,21700510,12/27/2017,1610612750,Minnesota Timberwolves,1,1,1610612743,Denver Nuggets,0,0,35,26,61,12,17,29,47,43,90,22,8,30,11,37,27,3,6,100,128
2022,2,22200686,1/20/2023,1610612748,Miami Heat,0,0,1610612742,Dallas Mavericks,1,1,29,20,49,4,16,20,33,36,69,20,7,27,9,30,15,7,16,91,90
2016,2,21600906,3/2/2017,1610612741,Chicago Bulls,1,1,1610612744,Golden State Warriors,0,0,31,32,63,5,14,19,36,46,82,17,4,21,11,38,19,10,16,97,94
2014,2,21400499,1/3/2015,1610612759,San Antonio Spurs,1,1,1610612764,Washington Wizards,0,0,39,23,62,4,12,16,43,35,78,11,7,18,14,24,27,6,11,83,101
2022,2,22200730,1/26/2023,1610612752,New York Knicks,0,1,1610612738,Boston Celtics,1,0,31,27,58,13,25,38,44,52,96,19,4,23,12,42,17,4,10,104,120
2014,2,21400499,1/3/2015,1610612764,Washington Wizards,0,0,1610612759,San Antonio Spurs,1,1,36,32,68,4,10,14,40,42,82,8,5,13,14,31,23,4,9,84,92
2022,2,22200870,2/14/2023,1610612756,Phoenix Suns,1,1,1610612758,Sacramento Kings,0,0,43,23,66,7,15,22,50,38,88,13,3,16,11,29,33,8,15,98,120
2022,2,22201072,3/20/2023,1610612755,Philadelphia 76ers,1,0,1610612741,Chicago Bulls,0,1,28,26,54,10,26,36,38,52,90,19,3,22,13,40,28,12,21,109,105
2023,2,22300013,11/10/2023,1610612750,Minnesota Timberwolves,0,1,1610612759,San Antonio Spurs,1,0,33,27,60,10,17,27,43,44,87,21,6,27,15,33,23,9,18,103,117
2014,2,21400138,11/15/2014,1610612751,Brooklyn Nets,0,0,1610612757,Portland Trail Blazers,1,1,34,36,70,1,18,19,35,54,89,16,1,17,15,39,15,6,9,91,87
2014,2,21400138,11/15/2014,1610612757,Portland Trail Blazers,1,1,1610612751,Brooklyn Nets,0,0,22,30,52,11,15,26,33,45,78,20,7,27,15,33,26,7,15,90,97
2021,2,22100724,1/26/2022,1610612746,LA Clippers,0,1,1610612753,Orlando Magic,1,0,21,31,52,15,14,29,36,45,81,24,3,27,11,34,20,9,15,99,111
2021,2,22100724,1/26/2022,1610612753,Orlando Magic,1,0,1610612746,LA Clippers,0,1,29,20,49,9,26,35,38,46,84,17,5,22,8,41,29,7,13,98,102
2014,2,21401058,3/24/2015,1610612755,Philadelphia 76ers,0,0,1610612758,Sacramento Kings,1,1,27,26,53,13,15,28,40,41,81,13,8,21,12,31,18,10,21,98,106
2014,2,21401058,3/24/2015,1610612758,Sacramento Kings,1,1,1610612755,Philadelphia 76ers,0,0,28,49,77,7,13,20,35,62,97,30,8,38,28,39,21,6,10,98,107
2016,2,21600906,3/2/2017,1610612744,Golden State Warriors,0,0,1610612741,Chicago Bulls,1,1,28,30,58,6,24,30,34,54,88,13,1,14,13,42,23,9,15,98,87
2014,2,21400498,1/3/2015,1610612750,Minnesota Timberwolves,1,0,1610612762,Utah Jazz,0,1,28,39,67,6,13,19,34,52,86,15,3,18,18,36,17,6,8,84,89
2020,2,22000747,4/3/2021,1610612742,Dallas Mavericks,0,1,1610612764,Washington Wizards,1,0,30,30,60,10,20,30,40,50,90,19,5,24,15,37,17,4,8,94,109
2020,2,22000747,4/3/2021,1610612764,Washington Wizards,1,0,1610612742,Dallas Mavericks,0,1,30,31,61,5,20,25,35,51,86,12,3,15,14,37,12,7,14,93,87
2022,2,22200701,1/22/2023,1610612746,LA Clippers,0,1,1610612742,Dallas Mavericks,1,0,23,26,49,12,16,28,35,42,77,30,1,31,13,29,20,3,11,90,112
2022,2,22200764,1/31/2023,1610612739,Cleveland Cavaliers,1,0,1610612748,Miami Heat,0,1,29,14,43,11,29,40,40,43,83,6,6,12,9,37,32,7,13,93,97
2022,2,22200757,1/30/2023,1610612751,Brooklyn Nets,1,1,1610612747,Los Angeles Lakers,0,0,29,25,54,16,25,41,45,50,95,15,4,19,14,37,24,1,11,101,121
2022,2,22200774,2/1/2023,1610612750,Minnesota Timberwolves,1,1,1610612744,Golden State Warriors,0,0,32,24,56,14,36,50,46,60,106,13,11,24,15,50,26,7,11,114,119
2022,2,22200811,2/6/2023,1610612741,Chicago Bulls,1,1,1610612759,San Antonio Spurs,0,0,44,23,67,6,16,22,50,39,89,22,3,25,7,33,27,7,14,107,128
2023,2,22300326,12/15/2023,1610612740,New Orleans Pelicans,0,1,1610612766,Charlotte Hornets,1,0,29,24,53,9,18,27,38,42,80,27,5,32,14,32,24,7,16,98,112
2014,2,21400137,11/15/2014,1610612742,Dallas Mavericks,1,1,1610612750,Minnesota Timberwolves,0,0,44,24,68,8,18,26,52,42,94,19,4,23,14,30,31,2,9,99,131
2014,2,21400137,11/15/2014,1610612750,Minnesota Timberwolves,0,0,1610612742,Dallas Mavericks,1,1,36,33,69,7,10,17,43,43,86,24,5,29,19,28,24,5,20,100,117
2022,2,22200773,2/1/2023,1610612745,Houston Rockets,1,1,1610612760,Oklahoma City Thunder,0,0,34,37,71,7,16,23,41,53,94,23,8,31,27,32,20,11,18,99,112
2021,2,22100723,1/26/2022,1610612754,Indiana Pacers,1,0,1610612766,Charlotte Hornets,0,1,34,24,58,10,24,34,44,48,92,28,6,34,22,30,33,9,20,108,126
2017,2,21700509,12/27/2017,1610612741,Chicago Bulls,1,1,1610612752,New York Knicks,0,0,25,33,58,10,18,28,35,51,86,12,4,16,8,46,23,6,15,101,92
2017,2,21700509,12/27/2017,1610612752,New York Knicks,0,0,1610612741,Chicago Bulls,1,1,33,35,68,4,19,23,37,54,91,9,4,13,9,47,21,9,12,101,87
2014,2,21400498,1/3/2015,1610612762,Utah Jazz,0,1,1610612750,Minnesota Timberwolves,1,0,27,28,55,11,9,20,38,37,75,14,7,21,15,25,23,8,14,85,101
2021,2,22100723,1/26/2022,1610612766,Charlotte Hornets,0,1,1610612754,Indiana Pacers,1,0,30,18,48,24,21,45,54,39,93,26,7,33,14,28,37,9,13,107,158
2017,2,21700508,12/27/2017,1610612737,Atlanta Hawks,1,1,1610612764,Washington Wizards,0,0,30,27,57,11,26,37,41,53,94,20,9,29,22,36,28,6,12,100,113
2017,2,21700508,12/27/2017,1610612764,Washington Wizards,0,0,1610612737,Atlanta Hawks,1,1,26,31,57,9,15,24,35,46,81,20,6,26,10,39,24,7,14,98,99
2021,2,22101051,3/18/2022,1610612747,Los Angeles Lakers,0,1,1610612761,Toronto Raptors,1,0,28,25,53,19,24,43,47,49,96,15,6,21,19,34,33,8,14,102,128
2021,2,22101051,3/18/2022,1610612761,Toronto Raptors,1,0,1610612747,Los Angeles Lakers,0,1,37,23,60,12,25,37,49,48,97,13,7,20,18,33,25,6,12,100,123
2014,2,21400136,11/15/2014,1610612763,Memphis Grizzlies,1,1,1610612765,Detroit Pistons,0,0,28,43,71,4,11,15,32,54,86,27,6,33,22,34,18,4,8,89,95
2022,2,22200764,1/31/2023,1610612748,Miami Heat,0,1,1610612739,Cleveland Cavaliers,1,0,20,27,47,14,17,31,34,44,78,18,7,25,12,34,21,9,15,92,100
2014,2,21400136,11/15/2014,1610612765,Detroit Pistons,0,0,1610612763,Memphis Grizzlies,1,1,24,32,56,10,16,26,34,48,82,10,7,17,12,40,15,5,10,89,88
2016,2,21600023,10/28/2016,1610612742,Dallas Mavericks,1,0,1610612745,Houston Rockets,0,1,27,24,51,8,21,29,35,45,80,20,4,24,9,37,13,6,10,94,98
2016,2,21600023,10/28/2016,1610612745,Houston Rockets,0,1,1610612742,Dallas Mavericks,1,0,18,20,38,15,17,32,33,37,70,25,6,31,10,30,21,11,19,93,106
2022,2,22200812,2/6/2023,1610612758,Sacramento Kings,0,1,1610612745,Houston Rockets,1,0,31,17,48,21,20,41,52,37,89,15,3,18,9,30,38,5,10,98,140
2022,2,22200870,2/14/2023,1610612758,Sacramento Kings,0,0,1610612756,Phoenix Suns,1,1,23,22,45,14,24,38,37,46,83,21,3,24,15,33,23,12,17,97,109
2022,2,22200811,2/6/2023,1610612759,San Antonio Spurs,0,0,1610612741,Chicago Bulls,1,1,32,32,64,8,18,26,40,50,90,16,1,17,9,42,25,10,18,107,104
2014,2,21401057,3/24/2015,1610612742,Dallas Mavericks,1,1,1610612759,San Antonio Spurs,0,0,35,30,65,7,15,22,42,45,87,10,3,13,11,36,21,12,17,99,101
2017,2,21700507,12/27/2017,1610612742,Dallas Mavericks,0,1,1610612754,Indiana Pacers,1,0,32,17,49,8,21,29,40,38,78,10,5,15,7,35,26,8,10,89,98
2014,2,21401057,3/24/2015,1610612759,San Antonio Spurs,0,0,1610612742,Dallas Mavericks,1,1,28,29,57,8,20,28,36,49,85,14,4,18,11,40,16,6,16,99,94
2022,2,22200798,2/4/2023,1610612740,New Orleans Pelicans,1,1,1610612747,Los Angeles Lakers,0,0,43,27,70,9,21,30,52,48,100,18,2,20,17,31,28,4,11,102,131
2022,2,22200812,2/6/2023,1610612745,Houston Rockets,1,0,1610612758,Sacramento Kings,0,1,31,25,56,13,19,32,44,44,88,19,5,24,17,30,27,9,14,98,120
2017,2,21700507,12/27/2017,1610612754,Indiana Pacers,1,0,1610612742,Dallas Mavericks,0,1,28,26,54,10,15,25,38,41,79,8,2,10,11,31,27,7,15,89,94
2016,2,21600905,3/1/2017,1610612751,Brooklyn Nets,0,1,1610612758,Sacramento Kings,1,0,23,23,46,11,17,28,34,40,74,30,6,36,14,30,16,8,19,98,109
2021,2,22100722,1/26/2022,1610612739,Cleveland Cavaliers,1,1,1610612749,Milwaukee Bucks,0,0,22,23,45,19,23,42,41,46,87,14,3,17,14,34,27,7,13,93,115
2021,2,22100722,1/26/2022,1610612749,Milwaukee Bucks,0,0,1610612739,Cleveland Cavaliers,1,1,28,20,48,9,23,32,37,43,80,16,2,18,14,30,22,11,19,95,99
2016,2,21600905,3/1/2017,1610612758,Sacramento Kings,1,0,1610612751,Brooklyn Nets,0,1,24,35,59,11,11,22,35,46,81,19,3,22,11,37,12,8,15,96,100
2021,2,22101050,3/18/2022,1610612752,New York Knicks,1,1,1610612764,Washington Wizards,0,0,21,36,57,10,23,33,31,59,90,28,8,36,23,38,18,2,13,96,100
2021,2,22101050,3/18/2022,1610612764,Washington Wizards,0,0,1610612752,New York Knicks,1,1,21,24,45,13,21,34,34,45,79,16,5,21,6,42,19,9,13,98,97
2017,2,21700506,12/27/2017,1610612738,Boston Celtics,0,1,1610612766,Charlotte Hornets,1,0,22,22,44,15,19,34,37,41,78,13,0,13,8,33,20,7,16,93,102
2017,2,21700506,12/27/2017,1610612766,Charlotte Hornets,1,0,1610612738,Boston Celtics,0,1,25,39,64,7,16,23,32,55,87,20,9,29,20,39,15,4,12,94,91
2021,2,22100721,1/25/2022,1610612750,Minnesota Timberwolves,0,1,1610612757,Portland Trail Blazers,1,0,22,17,39,14,29,43,36,46,82,23,8,31,13,37,21,4,17,100,109
2021,2,22100721,1/25/2022,1610612757,Portland Trail Blazers,1,0,1610612750,Minnesota Timberwolves,0,1,21,32,53,16,25,41,37,57,94,17,3,20,18,40,26,8,14,100,107
2021,2,22101049,3/18/2022,1610612739,Cleveland Cavaliers,1,1,1610612743,Denver Nuggets,0,0,30,31,61,14,23,37,44,54,98,17,9,26,18,40,31,6,11,104,119
2021,2,22101049,3/18/2022,1610612743,Denver Nuggets,0,0,1610612739,Cleveland Cavaliers,1,1,36,23,59,10,23,33,46,46,92,14,4,18,16,33,35,11,19,104,116
2016,2,21600373,12/13/2016,1610612757,Portland Trail Blazers,1,1,1610612760,Oklahoma City Thunder,0,0,35,22,57,8,15,23,43,37,80,20,7,27,9,30,23,10,14,99,114
2016,2,21600373,12/13/2016,1610612760,Oklahoma City Thunder,0,0,1610612757,Portland Trail Blazers,1,1,25,35,60,8,19,27,33,54,87,21,7,28,22,35,18,11,21,100,95
2014,2,21400497,1/3/2015,1610612745,Houston Rockets,1,1,1610612748,Miami Heat,0,0,28,24,52,13,18,31,41,42,83,20,8,28,19,26,21,6,16,93,115
2014,2,21400497,1/3/2015,1610612748,Miami Heat,0,0,1610612745,Houston Rockets,1,1,26,25,51,4,13,17,30,38,68,15,10,25,9,34,20,13,21,92,79
2021,2,22101048,3/18/2022,1610612751,Brooklyn Nets,1,1,1610612757,Portland Trail Blazers,0,0,35,17,52,10,15,25,45,32,77,28,5,33,14,21,24,14,21,100,128
2021,2,22101048,3/18/2022,1610612757,Portland Trail Blazers,0,0,1610612751,Brooklyn Nets,1,1,35,26,61,13,22,35,48,48,96,14,10,24,20,34,29,7,14,101,123
2022,2,22200780,2/2/2023,1610612748,Miami Heat,0,0,1610612752,New York Knicks,1,1,26,25,51,13,23,36,39,48,87,13,3,16,13,38,24,8,11,94,104
2022,2,22200813,2/6/2023,1610612742,Dallas Mavericks,0,1,1610612762,Utah Jazz,1,0,26,23,49,15,24,39,41,47,88,27,4,31,20,29,26,4,14,96,124
2022,2,22200813,2/6/2023,1610612762,Utah Jazz,1,0,1610612742,Dallas Mavericks,0,1,35,21,56,6,25,31,41,46,87,23,3,26,14,33,21,6,13,97,111
2016,2,21600904,3/1/2017,1610612745,Houston Rockets,0,1,1610612746,LA Clippers,1,0,17,18,35,20,32,52,37,50,87,28,5,33,22,30,21,8,17,95,122
2022,2,22200701,1/22/2023,1610612742,Dallas Mavericks,1,0,1610612746,LA Clippers,0,1,22,23,45,13,22,35,35,45,80,15,11,26,13,37,15,6,10,89,98
2016,2,21600904,3/1/2017,1610612746,LA Clippers,1,0,1610612745,Houston Rockets,0,1,30,30,60,12,22,34,42,52,94,7,6,13,12,43,26,3,8,96,103
2014,2,21401056,3/24/2015,1610612747,Los Angeles Lakers,0,0,1610612760,Oklahoma City Thunder,1,1,35,31,66,9,10,19,44,41,85,20,7,27,10,36,22,7,10,97,117
2014,2,21401056,3/24/2015,1610612760,Oklahoma City Thunder,1,1,1610612747,Los Angeles Lakers,0,0,37,28,65,11,10,21,48,38,86,20,3,23,17,22,29,10,17,97,127
2017,2,21700505,12/26/2017,1610612746,LA Clippers,1,1,1610612758,Sacramento Kings,0,0,31,19,50,13,18,31,44,37,81,21,6,27,12,28,31,11,13,95,122
2017,2,21700505,12/26/2017,1610612758,Sacramento Kings,0,0,1610612746,LA Clippers,1,1,33,41,74,7,15,22,40,56,96,8,4,12,15,42,25,7,10,97,95
2016,2,21600024,10/28/2016,1610612747,Los Angeles Lakers,0,0,1610612762,Utah Jazz,1,1,23,38,61,9,14,23,32,52,84,16,5,21,19,36,16,4,17,93,89
2016,2,21600024,10/28/2016,1610612762,Utah Jazz,1,1,1610612747,Los Angeles Lakers,0,0,25,25,50,6,19,25,31,44,75,28,12,40,15,33,14,6,14,92,96
2017,2,21700504,12/26/2017,1610612756,Phoenix Suns,1,1,1610612763,Memphis Grizzlies,0,0,24,26,50,8,14,22,32,40,72,27,8,35,14,29,24,10,21,95,99
2017,2,21700504,12/26/2017,1610612763,Memphis Grizzlies,0,0,1610612756,Phoenix Suns,1,1,32,35,67,3,17,20,35,52,87,24,5,29,14,40,12,5,10,94,97
2014,2,21400135,11/15/2014,1610612741,Chicago Bulls,1,0,1610612754,Indiana Pacers,0,1,31,35,66,4,13,17,35,48,83,16,7,23,15,38,18,5,13,93,90
2014,2,21400135,11/15/2014,1610612754,Indiana Pacers,0,1,1610612741,Chicago Bulls,1,0,30,29,59,7,11,18,37,40,77,18,7,25,12,31,18,6,17,93,99
2022,2,22200776,2/1/2023,1610612761,Toronto Raptors,0,0,1610612762,Utah Jazz,1,1,40,47,87,10,13,23,50,60,110,18,8,26,28,37,27,3,8,101,128
2022,2,22201073,3/20/2023,1610612750,Minnesota Timberwolves,0,1,1610612752,New York Knicks,1,0,37,22,59,14,10,24,51,32,83,24,8,32,9,27,34,7,15,104,140
2022,2,22200834,2/9/2023,1610612747,Los Angeles Lakers,1,0,1610612749,Milwaukee Bucks,0,1,35,36,71,7,11,18,42,47,89,15,6,21,12,38,23,5,12,98,106
2022,2,22201073,3/20/2023,1610612752,New York Knicks,1,0,1610612750,Minnesota Timberwolves,0,1,34,23,57,14,14,28,48,37,85,24,4,28,11,28,26,9,17,105,134
2021,2,22100720,1/25/2022,1610612742,Dallas Mavericks,0,0,1610612744,Golden State Warriors,1,1,22,29,51,10,30,40,32,59,91,18,0,18,13,46,17,8,11,99,92
2021,2,22100720,1/25/2022,1610612744,Golden State Warriors,1,1,1610612742,Dallas Mavericks,0,0,32,17,49,17,26,43,49,43,92,15,3,18,14,30,31,9,14,98,130
2017,2,21700503,12/26/2017,1610612743,Denver Nuggets,1,1,1610612762,Utah Jazz,0,0,28,23,51,11,19,30,39,42,81,18,4,22,12,32,23,7,10,86,107
2017,2,21700503,12/26/2017,1610612762,Utah Jazz,0,0,1610612743,Denver Nuggets,1,1,17,32,49,10,25,35,27,57,84,19,4,23,16,43,19,3,7,85,83
2021,2,22101047,3/18/2022,1610612737,Atlanta Hawks,1,1,1610612763,Memphis Grizzlies,0,0,32,31,63,13,15,28,45,46,91,17,4,21,13,35,28,6,10,98,120
2022,2,22200756,1/30/2023,1610612755,Philadelphia 76ers,1,0,1610612753,Orlando Magic,0,1,29,26,55,11,19,30,40,45,85,18,5,23,10,36,28,11,19,105,109
2022,2,22200776,2/1/2023,1610612762,Utah Jazz,1,1,1610612761,Toronto Raptors,0,0,27,9,36,17,30,47,44,39,83,26,4,30,14,28,29,11,16,99,131
2021,2,22101047,3/18/2022,1610612763,Memphis Grizzlies,0,0,1610612737,Atlanta Hawks,1,1,32,32,64,8,14,22,40,46,86,17,6,23,16,34,18,12,17,97,105
2014,2,21400496,1/3/2015,1610612738,Boston Celtics,0,0,1610612741,Chicago Bulls,1,1,40,43,83,5,12,17,45,55,100,9,2,11,19,38,26,10,22,109,104
2023,2,22300038,11/21/2023,1610612761,Toronto Raptors,0,0,1610612753,Orlando Magic,1,1,24,23,47,14,14,28,38,37,75,17,5,22,10,28,29,12,24,102,107
2014,2,21400496,1/3/2015,1610612741,Chicago Bulls,1,1,1610612738,Boston Celtics,0,0,31,41,72,6,22,28,37,63,100,29,11,40,29,41,19,9,18,109,109
2017,2,21700502,12/26/2017,1610612751,Brooklyn Nets,0,0,1610612759,San Antonio Spurs,1,1,27,34,61,12,20,32,39,54,93,7,2,9,15,40,23,7,13,95,97
2022,2,22200798,2/4/2023,1610612747,Los Angeles Lakers,0,0,1610612740,New Orleans Pelicans,1,1,34,28,62,11,21,32,45,49,94,25,8,33,16,35,30,6,9,103,126
2022,2,22200834,2/9/2023,1610612749,Milwaukee Bucks,0,1,1610612747,Los Angeles Lakers,1,0,33,19,52,12,35,47,45,54,99,13,5,18,21,35,24,2,11,100,115
2017,2,21700502,12/26/2017,1610612759,San Antonio Spurs,1,1,1610612751,Brooklyn Nets,0,0,34,30,64,7,9,16,41,39,80,20,4,24,6,34,18,5,12,95,109
2014,2,21401055,3/24/2015,1610612748,Miami Heat,0,0,1610612749,Milwaukee Bucks,1,1,25,31,56,8,11,19,33,42,75,14,4,18,11,33,18,8,20,92,88
2014,2,21401055,3/24/2015,1610612749,Milwaukee Bucks,1,1,1610612748,Miami Heat,0,0,32,38,70,4,13,17,36,51,87,13,4,17,24,31,25,11,21,92,89
2014,2,21400495,1/3/2015,1610612753,Orlando Magic,1,0,1610612766,Charlotte Hornets,0,1,29,39,68,4,15,19,33,54,87,20,1,21,14,40,18,3,6,89,90
2023,2,22300225,11/22/2023,1610612764,Washington Wizards,0,0,1610612766,Charlotte Hornets,1,1,33,32,65,11,21,32,44,53,97,15,3,18,14,40,26,6,10,101,114
2022,2,22200730,1/26/2023,1610612738,Boston Celtics,1,0,1610612752,New York Knicks,0,1,25,29,54,16,30,46,41,59,100,19,4,23,20,41,22,5,13,105,117
2014,2,21400495,1/3/2015,1610612766,Charlotte Hornets,0,1,1610612753,Orlando Magic,1,0,31,31,62,4,12,16,35,43,78,24,8,32,17,32,16,10,15,89,98
2021,2,22101046,3/18/2022,1610612742,Dallas Mavericks,0,0,1610612755,Philadelphia 76ers,1,1,25,23,48,12,20,32,37,43,80,15,6,21,11,36,21,9,12,90,101
2021,2,22101046,3/18/2022,1610612755,Philadelphia 76ers,1,1,1610612742,Dallas Mavericks,0,0,21,16,37,16,22,38,37,38,75,21,2,23,9,30,23,4,12,90,111
2016,2,21600022,10/28/2016,1610612748,Miami Heat,1,0,1610612766,Charlotte Hornets,0,1,18,34,52,14,20,34,32,54,86,13,7,20,19,38,19,10,20,96,91
2016,2,21600022,10/28/2016,1610612766,Charlotte Hornets,0,1,1610612748,Miami Heat,1,0,28,42,70,7,15,22,35,57,92,20,4,24,17,42,20,2,8,96,97
2017,2,21700501,12/26/2017,1610612741,Chicago Bulls,0,1,1610612749,Milwaukee Bucks,1,0,35,40,75,10,18,28,45,58,103,15,10,25,19,42,26,2,7,104,115
2017,2,21700501,12/26/2017,1610612749,Milwaukee Bucks,1,0,1610612741,Chicago Bulls,0,1,29,23,52,10,21,31,39,44,83,18,6,24,11,35,23,11,20,104,106
2016,2,21600903,3/1/2017,1610612750,Minnesota Timberwolves,0,1,1610612762,Utah Jazz,1,0,31,31,62,8,8,16,39,39,78,21,5,26,11,31,23,6,12,90,107
2016,2,21600903,3/1/2017,1610612762,Utah Jazz,1,0,1610612750,Minnesota Timberwolves,0,1,31,40,71,4,15,19,35,55,90,6,5,11,18,39,18,11,14,92,80
2014,2,21401054,3/24/2015,1610612761,Toronto Raptors,0,0,1610612765,Detroit Pistons,1,1,28,24,52,7,16,23,35,40,75,27,2,29,17,24,19,5,13,86,104
2014,2,21401054,3/24/2015,1610612765,Detroit Pistons,1,1,1610612761,Toronto Raptors,0,0,28,36,64,12,17,29,40,53,93,16,8,24,24,33,26,2,7,86,108
2017,2,21700500,12/26/2017,1610612748,Miami Heat,1,1,1610612753,Orlando Magic,0,0,30,28,58,11,22,33,41,50,91,14,3,17,18,33,22,8,17,97,107
2017,2,21700500,12/26/2017,1610612753,Orlando Magic,0,0,1610612748,Miami Heat,1,1,28,33,61,5,15,20,33,48,81,18,4,22,11,38,14,11,17,97,89
2020,2,22000456,4/7/2021,1610612742,Dallas Mavericks,0,0,1610612745,Houston Rockets,1,1,23,25,48,10,29,39,33,54,87,17,5,22,14,43,16,7,9,92,93
2020,2,22000456,4/7/2021,1610612745,Houston Rockets,1,1,1610612742,Dallas Mavericks,0,0,21,23,44,17,27,44,38,50,88,9,7,16,15,39,21,4,11,93,102
2022,2,22200733,1/26/2023,1610612745,Houston Rockets,1,0,1610612739,Cleveland Cavaliers,0,1,34,21,55,5,16,21,39,37,76,12,8,20,13,27,24,12,22,93,95
2022,2,22200853,2/11/2023,1610612744,Golden State Warriors,1,0,1610612747,Los Angeles Lakers,0,1,28,24,52,12,32,44,40,56,96,11,1,12,13,44,31,4,16,105,103
2022,2,22200700,1/22/2023,1610612752,New York Knicks,0,0,1610612761,Toronto Raptors,1,1,22,19,41,18,23,41,40,42,82,18,8,26,16,28,30,12,17,94,116
2021,2,22101045,3/17/2022,1610612753,Orlando Magic,1,0,1610612765,Detroit Pistons,0,1,36,31,67,11,19,30,47,50,97,15,6,21,18,36,24,11,14,104,120
2021,2,22101045,3/17/2022,1610612765,Detroit Pistons,0,1,1610612753,Orlando Magic,1,0,27,24,51,20,23,43,47,47,94,20,11,31,15,38,34,3,9,103,134
2016,2,21600372,12/13/2016,1610612752,New York Knicks,0,0,1610612756,Phoenix Suns,1,1,31,46,77,7,13,20,38,59,97,28,10,38,19,46,23,9,14,108,111
2016,2,21600372,12/13/2016,1610612756,Phoenix Suns,1,1,1610612752,New York Knicks,0,0,29,34,63,9,21,30,38,55,93,28,5,33,19,38,13,10,18,107,113
2020,2,22000746,4/2/2021,1610612747,Los Angeles Lakers,0,1,1610612758,Sacramento Kings,1,0,26,32,58,17,16,33,43,48,91,12,8,20,19,34,26,8,17,99,115
2020,2,22000746,4/2/2021,1610612758,Sacramento Kings,1,0,1610612747,Los Angeles Lakers,0,1,26,24,50,10,25,35,36,49,85,12,4,16,9,43,24,10,15,99,94
2017,2,21700499,12/26/2017,1610612742,Dallas Mavericks,1,1,1610612761,Toronto Raptors,0,0,34,36,70,6,18,24,40,54,94,12,4,16,19,38,20,10,14,97,98
2017,2,21700499,12/26/2017,1610612761,Toronto Raptors,0,0,1610612742,Dallas Mavericks,1,1,21,37,58,9,22,31,30,59,89,24,8,32,19,43,16,5,12,99,93
2016,2,21600902,3/1/2017,1610612754,Indiana Pacers,0,0,1610612759,San Antonio Spurs,1,1,30,28,58,7,16,23,37,44,81,18,7,25,18,31,22,8,18,93,99
2016,2,21600902,3/1/2017,1610612759,San Antonio Spurs,1,1,1610612754,Indiana Pacers,0,0,26,19,45,9,20,29,35,39,74,21,3,24,9,31,20,13,18,92,100
2022,2,22200666,1/17/2023,1610612751,Brooklyn Nets,0,0,1610612759,San Antonio Spurs,1,1,34,31,65,3,20,23,37,51,88,21,3,24,11,41,22,12,21,107,98
2014,2,21400134,11/15/2014,1610612761,Toronto Raptors,1,1,1610612762,Utah Jazz,0,0,35,28,63,8,13,21,43,41,84,17,6,23,15,29,15,5,8,89,111
2014,2,21400134,11/15/2014,1610612762,Utah Jazz,0,0,1610612761,Toronto Raptors,1,1,28,31,59,5,11,16,33,42,75,22,8,30,13,31,22,6,12,88,93
2022,2,22200700,1/22/2023,1610612761,Toronto Raptors,1,1,1610612752,New York Knicks,0,0,26,30,56,15,19,34,41,49,90,28,7,35,20,33,21,4,8,96,125
2017,2,21700498,12/26/2017,1610612754,Indiana Pacers,0,0,1610612765,Detroit Pistons,1,1,28,28,56,6,15,21,34,43,77,9,4,13,10,37,18,5,12,87,83
2021,2,22100719,1/25/2022,1610612745,Houston Rockets,1,0,1610612759,San Antonio Spurs,0,1,30,31,61,9,25,34,39,56,95,17,8,25,20,40,21,8,17,104,104
2021,2,22100719,1/25/2022,1610612759,San Antonio Spurs,0,1,1610612745,Houston Rockets,1,0,46,23,69,12,20,32,58,43,101,6,0,6,14,29,38,8,13,103,134
2020,2,22000455,2/19/2021,1610612740,New Orleans Pelicans,1,0,1610612756,Phoenix Suns,0,1,31,19,50,11,21,32,42,40,82,19,5,24,7,35,28,8,14,100,114
2020,2,22000455,2/19/2021,1610612756,Phoenix Suns,0,1,1610612740,New Orleans Pelicans,1,0,29,20,49,22,17,39,51,37,88,8,4,12,6,33,38,11,13,101,132
2021,2,22101044,3/16/2022,1610612746,LA Clippers,1,0,1610612761,Toronto Raptors,0,1,27,21,48,11,19,30,38,40,78,13,2,15,10,31,27,5,14,88,100
2021,2,22101044,3/16/2022,1610612761,Toronto Raptors,0,1,1610612746,LA Clippers,1,0,27,24,51,11,21,32,38,45,83,16,5,21,18,31,14,7,11,88,103
2019,2,21900210,11/20/2019,1610612750,Minnesota Timberwolves,1,0,1610612762,Utah Jazz,0,1,21,23,44,14,31,45,35,54,89,11,10,21,17,40,13,7,14,97,95
2019,2,21900210,11/20/2019,1610612762,Utah Jazz,0,1,1610612750,Minnesota Timberwolves,1,0,21,32,53,14,19,33,35,51,86,19,8,27,14,41,22,5,11,96,103
2022,2,22200814,2/6/2023,1610612744,Golden State Warriors,1,1,1610612760,Oklahoma City Thunder,0,0,30,17,47,26,24,50,56,41,97,3,4,7,13,31,43,8,16,103,141
2017,2,21700498,12/26/2017,1610612765,Detroit Pistons,1,1,1610612754,Indiana Pacers,0,0,29,19,48,12,22,34,41,41,82,13,3,16,17,26,26,6,13,86,107
2014,2,21401053,3/23/2015,1610612744,Golden State Warriors,1,1,1610612764,Washington Wizards,0,0,26,36,62,13,20,33,39,56,95,16,5,21,21,38,23,5,11,95,107
2014,2,21401053,3/23/2015,1610612764,Washington Wizards,0,0,1610612744,Golden State Warriors,1,1,24,46,70,3,8,11,27,54,81,19,7,26,10,46,15,9,12,97,76
2014,2,21400494,1/2/2015,1610612747,Los Angeles Lakers,1,0,1610612763,Memphis Grizzlies,0,1,37,25,62,6,13,19,43,38,81,14,5,19,8,34,24,7,14,95,106
2014,2,21400494,1/2/2015,1610612763,Memphis Grizzlies,0,1,1610612747,Los Angeles Lakers,1,0,35,35,70,6,8,14,41,43,84,21,10,31,16,33,27,10,12,95,109
2022,2,22200757,1/30/2023,1610612747,Los Angeles Lakers,0,0,1610612751,Brooklyn Nets,1,1,24,36,60,11,18,29,35,54,89,23,14,37,21,39,24,8,14,100,104
2020,2,22000454,2/19/2021,1610612750,Minnesota Timberwolves,1,0,1610612761,Toronto Raptors,0,1,23,22,45,9,29,38,32,51,83,8,3,11,12,39,24,8,17,92,81
2022,2,22200561,1/3/2023,1610612749,Milwaukee Bucks,1,1,1610612764,Washington Wizards,0,0,37,23,60,11,29,40,48,52,100,16,1,17,18,34,27,9,12,101,123
2021,2,22101043,3/16/2022,1610612749,Milwaukee Bucks,0,1,1610612758,Sacramento Kings,1,0,29,25,54,18,17,35,47,42,89,23,9,32,10,37,21,8,13,107,135
2021,2,22101043,3/16/2022,1610612758,Sacramento Kings,1,0,1610612749,Milwaukee Bucks,0,1,30,21,51,16,27,43,46,48,94,18,3,21,9,42,27,12,15,108,126
2022,2,22200561,1/3/2023,1610612764,Washington Wizards,0,0,1610612749,Milwaukee Bucks,1,1,34,36,70,8,19,27,42,55,97,21,2,23,17,38,27,8,10,101,113
2022,2,22200814,2/6/2023,1610612760,Oklahoma City Thunder,0,0,1610612744,Golden State Warriors,1,1,33,26,59,11,21,32,44,47,91,15,6,21,10,38,21,6,11,103,114
2022,2,22200001,10/18/2022,1610612738,Boston Celtics,1,1,1610612755,Philadelphia 76ers,0,0,34,13,47,12,23,35,46,36,82,22,6,28,10,29,24,8,11,98,126
2016,2,21600021,10/28/2016,1610612756,Phoenix Suns,0,0,1610612760,Oklahoma City Thunder,1,1,37,29,66,5,23,28,42,52,94,21,11,32,12,45,15,11,15,112,110
2016,2,21600021,10/28/2016,1610612760,Oklahoma City Thunder,1,1,1610612756,Phoenix Suns,0,0,35,40,75,5,16,21,40,56,96,28,10,38,21,39,13,11,22,114,113
2022,2,22200001,10/18/2022,1610612755,Philadelphia 76ers,0,0,1610612738,Boston Celtics,1,1,27,19,46,13,21,34,40,40,80,24,4,28,8,34,16,8,14,97,117
2020,2,22000454,2/19/2021,1610612761,Toronto Raptors,0,1,1610612750,Minnesota Timberwolves,1,0,16,29,45,12,28,40,28,57,85,18,4,22,20,39,16,6,15,93,86
2017,2,21700497,12/25/2017,1610612747,Los Angeles Lakers,1,0,1610612750,Minnesota Timberwolves,0,1,30,32,62,10,20,30,40,52,92,13,6,19,17,38,21,9,12,97,103
2017,2,21700497,12/25/2017,1610612750,Minnesota Timberwolves,0,1,1610612747,Los Angeles Lakers,1,0,38,14,52,11,21,32,49,35,84,12,2,14,10,25,30,10,15,95,121
2016,2,21600901,3/1/2017,1610612738,Boston Celtics,1,1,1610612739,Cleveland Cavaliers,0,0,23,24,47,13,18,31,36,42,78,18,5,23,10,34,28,3,12,93,103
2021,2,22100718,1/25/2022,1610612747,Los Angeles Lakers,0,1,1610612751,Brooklyn Nets,1,0,30,21,51,12,26,38,42,47,89,10,0,10,9,38,23,5,10,95,106
2021,2,22100718,1/25/2022,1610612751,Brooklyn Nets,1,0,1610612747,Los Angeles Lakers,0,1,30,31,61,7,20,27,37,51,88,15,7,22,22,33,20,12,19,93,96
2021,2,22101042,3/16/2022,1610612738,Boston Celtics,0,1,1610612744,Golden State Warriors,1,0,23,18,41,15,25,40,38,43,81,19,3,22,9,37,23,8,10,90,110
2021,2,22101042,3/16/2022,1610612744,Golden State Warriors,1,0,1610612738,Boston Celtics,0,1,21,17,38,11,37,48,32,54,86,13,3,16,10,46,19,4,8,91,88
2017,2,21700496,12/25/2017,1610612745,Houston Rockets,0,0,1610612760,Oklahoma City Thunder,1,1,23,21,44,12,25,37,35,46,81,24,6,30,14,35,23,9,14,94,106
2017,2,21700496,12/25/2017,1610612760,Oklahoma City Thunder,1,1,1610612745,Houston Rockets,0,0,35,26,61,8,10,18,43,36,79,18,5,23,10,30,21,11,15,94,112
2016,2,21600901,3/1/2017,1610612739,Cleveland Cavaliers,0,0,1610612738,Boston Celtics,1,1,27,31,58,10,23,33,37,54,91,15,7,22,20,39,20,4,11,94,99
2022,2,22200683,1/20/2023,1610612740,New Orleans Pelicans,0,0,1610612753,Orlando Magic,1,1,31,25,56,10,25,35,41,50,91,18,6,24,15,39,29,2,11,98,110
2022,2,22200777,2/1/2023,1610612737,Atlanta Hawks,0,1,1610612756,Phoenix Suns,1,0,33,25,58,19,14,33,52,39,91,9,2,11,6,34,32,8,12,100,132
2017,2,21700495,12/25/2017,1610612738,Boston Celtics,1,0,1610612764,Washington Wizards,0,1,25,27,52,14,15,29,39,42,81,11,6,17,11,34,20,6,17,96,103
2017,2,21700495,12/25/2017,1610612764,Washington Wizards,0,1,1610612738,Boston Celtics,1,0,37,30,67,6,20,26,43,50,93,19,9,28,17,39,26,2,9,97,111
2014,2,21400133,11/15/2014,1610612737,Atlanta Hawks,0,0,1610612739,Cleveland Cavaliers,1,1,37,31,68,3,19,22,40,50,90,11,2,13,16,35,26,12,19,97,94
2020,2,22000905,4/24/2021,1610612749,Milwaukee Bucks,1,1,1610612755,Philadelphia 76ers,0,0,31,24,55,18,22,40,49,46,95,16,8,24,18,34,33,11,16,103,132
2022,2,22200777,2/1/2023,1610612756,Phoenix Suns,1,0,1610612737,Atlanta Hawks,0,1,31,27,58,4,24,28,35,51,86,26,5,31,14,40,22,6,16,101,100
2022,2,22200852,2/11/2023,1610612741,Chicago Bulls,0,0,1610612739,Cleveland Cavaliers,1,1,31,22,53,5,16,21,36,38,74,12,3,15,10,30,27,9,23,94,89
2022,2,22200783,2/2/2023,1610612744,Golden State Warriors,0,0,1610612743,Denver Nuggets,1,1,24,23,47,19,19,38,43,42,85,12,7,19,11,35,25,10,17,98,117
2021,2,22101041,3/16/2022,1610612741,Chicago Bulls,0,0,1610612762,Utah Jazz,1,1,31,26,57,12,22,34,43,48,91,12,5,17,11,39,28,8,12,102,110
2021,2,22101041,3/16/2022,1610612762,Utah Jazz,1,1,1610612741,Chicago Bulls,0,0,23,21,44,19,20,39,42,41,83,22,7,29,11,32,20,10,17,102,125
2017,2,21700494,12/25/2017,1610612739,Cleveland Cavaliers,0,0,1610612744,Golden State Warriors,1,1,13,39,52,15,21,36,28,60,88,21,4,25,21,39,12,7,13,94,92
2017,2,21700494,12/25/2017,1610612744,Golden State Warriors,1,1,1610612739,Cleveland Cavaliers,0,0,28,17,45,10,27,37,38,44,82,13,4,17,12,36,28,8,16,95,99
2016,2,21600370,12/13/2016,1610612741,Chicago Bulls,1,0,1610612750,Minnesota Timberwolves,0,1,34,38,72,4,11,15,38,49,87,14,5,19,15,36,20,3,10,92,94
2016,2,21600370,12/13/2016,1610612750,Minnesota Timberwolves,0,1,1610612741,Chicago Bulls,1,0,32,33,65,6,15,21,38,48,86,17,5,22,20,30,24,7,14,91,99
2016,2,21600020,10/28/2016,1610612753,Orlando Magic,0,0,1610612765,Detroit Pistons,1,1,25,44,69,8,18,26,33,62,95,8,4,12,17,46,20,8,9,95,82
2016,2,21600020,10/28/2016,1610612765,Detroit Pistons,1,1,1610612753,Orlando Magic,0,0,41,35,76,7,12,19,48,47,95,5,1,6,16,32,27,8,12,94,108
2014,2,21400133,11/15/2014,1610612739,Cleveland Cavaliers,1,1,1610612737,Atlanta Hawks,0,0,30,29,59,19,12,31,49,41,90,10,3,13,13,29,39,6,14,97,127
2020,2,22000905,4/24/2021,1610612755,Philadelphia 76ers,0,0,1610612749,Milwaukee Bucks,1,1,24,27,51,7,24,31,31,51,82,25,9,34,11,45,15,10,17,102,94
2022,2,22200686,1/20/2023,1610612742,Dallas Mavericks,1,1,1610612748,Miami Heat,0,0,19,23,42,18,20,38,37,43,80,23,5,28,11,34,21,3,10,90,115
2022,2,22200783,2/2/2023,1610612743,Denver Nuggets,1,1,1610612744,Golden State Warriors,0,0,35,20,55,16,19,35,51,39,90,16,5,21,11,32,35,4,13,99,134
2014,2,21401052,3/23/2015,1610612750,Minnesota Timberwolves,0,1,1610612762,Utah Jazz,1,0,25,34,59,12,7,19,37,41,78,20,5,25,16,25,19,11,21,94,106
2014,2,21401052,3/23/2015,1610612762,Utah Jazz,1,0,1610612750,Minnesota Timberwolves,0,1,29,30,59,9,19,28,38,49,87,19,12,31,26,29,21,10,18,95,104
2014,2,21400493,1/2/2015,1610612744,Golden State Warriors,1,1,1610612761,Toronto Raptors,0,0,37,27,64,12,16,28,49,43,92,16,4,20,15,30,35,7,9,96,126
2014,2,21400493,1/2/2015,1610612761,Toronto Raptors,0,0,1610612744,Golden State Warriors,1,1,30,31,61,10,15,25,40,46,86,15,5,20,16,33,23,8,17,97,105
2017,2,21700493,12/25/2017,1610612752,New York Knicks,1,0,1610612755,Philadelphia 76ers,0,1,34,45,79,4,11,15,38,56,94,18,9,27,25,38,18,7,13,96,98
2022,2,22200002,10/18/2022,1610612744,Golden State Warriors,1,1,1610612747,Los Angeles Lakers,0,0,29,25,54,16,29,45,45,54,99,17,6,23,16,41,31,12,18,112,123
2022,2,22200665,1/17/2023,1610612761,Toronto Raptors,0,0,1610612749,Milwaukee Bucks,1,1,33,33,66,13,22,35,46,55,101,17,10,27,23,37,20,5,9,99,122
2017,2,21700493,12/25/2017,1610612755,Philadelphia 76ers,0,1,1610612752,New York Knicks,1,0,25,29,54,10,18,28,35,47,82,25,5,30,15,33,21,7,15,96,105
2016,2,21600900,3/1/2017,1610612740,New Orleans Pelicans,1,1,1610612765,Detroit Pistons,0,0,30,23,53,9,16,25,39,39,78,22,1,23,11,28,18,11,14,91,109
2016,2,21600900,3/1/2017,1610612765,Detroit Pistons,0,0,1610612740,New Orleans Pelicans,1,1,37,43,80,3,20,23,40,63,103,3,14,17,26,46,13,6,7,92,86
2020,2,22000745,4/2/2021,1610612749,Milwaukee Bucks,0,1,1610612757,Portland Trail Blazers,1,0,37,14,51,12,27,39,49,41,90,17,2,19,8,34,25,11,15,106,127
2022,2,22200002,10/18/2022,1610612747,Los Angeles Lakers,0,0,1610612744,Golden State Warriors,1,1,30,24,54,10,30,40,40,54,94,19,6,25,14,43,23,11,22,112,109
2021,2,22100717,1/25/2022,1610612738,Boston Celtics,1,1,1610612758,Sacramento Kings,0,0,31,27,58,20,25,45,51,52,103,6,1,7,21,31,32,7,11,95,128
2021,2,22100717,1/25/2022,1610612758,Sacramento Kings,0,0,1610612738,Boston Celtics,1,1,23,39,62,6,27,33,29,66,95,11,4,15,19,50,15,6,12,96,75
2017,2,21700492,12/23/2017,1610612758,Sacramento Kings,1,0,1610612759,San Antonio Spurs,0,1,28,36,64,12,10,22,40,46,86,7,4,11,11,37,21,3,10,91,99
2017,2,21700492,12/23/2017,1610612759,San Antonio Spurs,0,1,1610612758,Sacramento Kings,1,0,33,32,65,11,12,23,44,44,88,9,2,11,11,34,29,2,8,91,108
2021,2,22101040,3/16/2022,1610612759,San Antonio Spurs,1,1,1610612760,Oklahoma City Thunder,0,0,24,33,57,19,22,41,43,55,98,17,3,20,19,37,31,11,12,101,122
2022,2,22200684,1/20/2023,1610612752,New York Knicks,0,0,1610612737,Atlanta Hawks,1,1,36,17,53,13,17,30,49,34,83,13,4,17,10,27,27,6,12,92,124
2022,2,22200815,2/6/2023,1610612749,Milwaukee Bucks,0,1,1610612757,Portland Trail Blazers,1,0,31,14,45,16,26,42,47,40,87,17,4,21,10,33,27,5,16,104,127
2022,2,22201014,3/12/2023,1610612743,Denver Nuggets,1,0,1610612751,Brooklyn Nets,0,1,33,26,59,12,19,31,45,45,90,18,6,24,23,25,27,11,15,95,120
2023,2,22300021,11/14/2023,1610612760,Oklahoma City Thunder,1,1,1610612759,San Antonio Spurs,0,0,31,19,50,15,24,39,46,43,89,16,4,20,9,35,34,7,16,106,123
2017,2,21700491,12/23/2017,1610612747,Los Angeles Lakers,1,0,1610612757,Portland Trail Blazers,0,1,28,32,60,8,17,25,36,49,85,12,8,20,14,40,23,7,17,97,92
2017,2,21700491,12/23/2017,1610612757,Portland Trail Blazers,0,1,1610612747,Los Angeles Lakers,1,0,29,41,70,10,15,25,39,56,95,7,7,14,15,45,19,8,11,98,95
2023,2,22300157,11/8/2023,1610612766,Charlotte Hornets,1,0,1610612764,Washington Wizards,0,1,33,21,54,8,17,25,41,38,79,26,9,35,14,29,17,10,22,103,116
2021,2,22100716,1/25/2022,1610612746,LA Clippers,0,1,1610612764,Washington Wizards,1,0,28,37,65,11,18,29,39,55,94,27,4,31,15,43,28,4,12,105,116
2022,2,22200003,10/19/2022,1610612753,Orlando Magic,0,0,1610612765,Detroit Pistons,1,1,31,25,56,11,19,30,42,44,86,14,5,19,13,34,21,11,18,101,109
2022,2,22200683,1/20/2023,1610612753,Orlando Magic,1,1,1610612740,New Orleans Pelicans,0,0,24,21,45,15,15,30,39,36,75,30,4,34,7,32,28,9,15,99,123
2022,2,22200003,10/19/2022,1610612765,Detroit Pistons,1,1,1610612753,Orlando Magic,0,0,26,30,56,14,24,38,40,54,94,19,5,24,17,41,31,5,13,100,113
2022,2,22200815,2/6/2023,1610612757,Portland Trail Blazers,1,0,1610612749,Milwaukee Bucks,0,1,28,27,55,9,27,36,37,54,91,25,4,29,8,49,23,4,9,104,108
2016,2,21600019,10/28/2016,1610612751,Brooklyn Nets,1,1,1610612754,Indiana Pacers,0,0,28,26,54,10,23,33,38,49,87,17,3,20,13,37,20,7,16,99,103
2016,2,21600019,10/28/2016,1610612754,Indiana Pacers,0,0,1610612751,Brooklyn Nets,1,1,30,44,74,7,17,24,37,61,98,13,7,20,20,44,22,6,13,101,94
2017,2,21700490,12/23/2017,1610612750,Minnesota Timberwolves,0,1,1610612756,Phoenix Suns,1,0,36,32,68,6,10,16,42,42,84,25,4,29,16,29,18,5,14,97,115
2017,2,21700490,12/23/2017,1610612756,Phoenix Suns,1,0,1610612750,Minnesota Timberwolves,0,1,29,25,54,11,21,32,40,46,86,15,9,24,14,37,24,6,13,98,106
2022,2,22200004,10/19/2022,1610612754,Indiana Pacers,1,0,1610612764,Washington Wizards,0,1,24,31,55,15,27,42,39,58,97,14,7,21,18,44,21,5,15,104,107
2022,2,22200004,10/19/2022,1610612764,Washington Wizards,0,1,1610612754,Indiana Pacers,1,0,31,30,61,11,20,31,42,50,92,19,5,24,18,33,21,7,17,105,114
2021,2,22100716,1/25/2022,1610612764,Washington Wizards,1,0,1610612746,LA Clippers,0,1,28,25,53,9,18,27,37,43,80,32,8,40,12,37,25,9,19,104,115
2022,2,22200005,10/19/2022,1610612737,Atlanta Hawks,1,1,1610612745,Houston Rockets,0,0,38,27,65,7,18,25,45,45,90,20,4,24,6,41,30,4,9,104,117
2022,2,22200005,10/19/2022,1610612745,Houston Rockets,0,0,1610612737,Atlanta Hawks,1,1,33,30,63,9,26,35,42,56,98,14,1,15,17,39,25,12,16,105,107
2017,2,21700489,12/23/2017,1610612743,Denver Nuggets,0,1,1610612744,Golden State Warriors,1,0,31,23,54,7,21,28,38,44,82,13,2,15,15,30,25,14,19,91,96
2022,2,22200006,10/19/2022,1610612740,New Orleans Pelicans,0,1,1610612751,Brooklyn Nets,1,0,38,38,76,12,14,26,50,52,102,18,7,25,24,32,31,11,14,100,130
2017,2,21700489,12/23/2017,1610612744,Golden State Warriors,1,0,1610612743,Denver Nuggets,0,1,29,28,57,3,24,27,32,52,84,14,3,17,17,38,25,10,18,93,81
2014,2,21400132,11/15/2014,1610612753,Orlando Magic,0,0,1610612764,Washington Wizards,1,1,30,31,61,7,10,17,37,41,78,12,6,18,12,32,14,5,15,89,93
2022,2,22200974,3/6/2023,1610612737,Atlanta Hawks,0,0,1610612748,Miami Heat,1,1,42,21,63,9,20,29,51,41,92,17,6,23,17,28,28,6,11,98,128
2021,2,22100715,1/25/2022,1610612761,Toronto Raptors,1,1,1610612766,Charlotte Hornets,0,0,27,21,48,16,18,34,43,39,82,23,6,29,13,30,27,7,17,101,125
2021,2,22100715,1/25/2022,1610612766,Charlotte Hornets,0,0,1610612761,Toronto Raptors,1,1,30,21,51,10,21,31,40,42,82,23,9,32,11,37,25,6,12,102,113
2021,2,22101040,3/16/2022,1610612760,Oklahoma City Thunder,0,0,1610612759,San Antonio Spurs,1,1,30,17,47,13,22,35,43,39,82,21,8,29,13,33,24,10,19,101,120
2020,2,22000453,2/19/2021,1610612749,Milwaukee Bucks,1,1,1610612760,Oklahoma City Thunder,0,0,24,28,52,11,23,34,35,51,86,17,8,25,14,40,23,4,13,96,98
2020,2,22000453,2/19/2021,1610612760,Oklahoma City Thunder,0,0,1610612749,Milwaukee Bucks,1,1,19,26,45,12,28,40,31,54,85,11,10,21,10,51,20,5,12,95,85
2016,2,21600369,12/13/2016,1610612737,Atlanta Hawks,1,0,1610612753,Orlando Magic,0,1,34,27,61,11,17,28,45,44,89,19,2,21,17,28,29,8,15,98,120
2016,2,21600369,12/13/2016,1610612753,Orlando Magic,0,1,1610612737,Atlanta Hawks,1,0,36,17,53,15,19,34,51,36,87,14,6,20,7,32,36,6,9,99,131
2020,2,22000745,4/2/2021,1610612757,Portland Trail Blazers,1,0,1610612749,Milwaukee Bucks,0,1,15,30,45,21,33,54,36,63,99,16,6,22,18,49,19,7,14,106,109
2014,2,21400132,11/15/2014,1610612764,Washington Wizards,1,1,1610612753,Orlando Magic,0,0,39,35,74,3,7,10,42,42,84,11,5,16,13,31,31,5,12,89,98
2022,2,22200006,10/19/2022,1610612751,Brooklyn Nets,1,0,1610612740,New Orleans Pelicans,0,1,30,26,56,10,23,33,40,49,89,18,6,24,12,41,22,8,15,102,108
2022,2,22200846,2/11/2023,1610612751,Brooklyn Nets,1,0,1610612755,Philadelphia 76ers,0,1,24,28,52,13,27,40,37,55,92,11,2,13,19,38,23,4,9,89,98
2023,2,22300075,10/26/2023,1610612755,Philadelphia 76ers,0,0,1610612749,Milwaukee Bucks,1,1,25,20,45,16,19,35,41,39,80,19,9,28,4,38,25,9,15,103,117
2021,2,22100714,1/25/2022,1610612743,Denver Nuggets,0,1,1610612765,Detroit Pistons,1,0,25,27,52,11,21,32,36,48,84,27,4,31,22,29,25,14,25,104,110
2022,2,22200784,2/2/2023,1610612749,Milwaukee Bucks,1,1,1610612746,LA Clippers,0,0,30,23,53,9,28,37,39,51,90,19,8,27,12,42,16,8,10,100,106
2016,2,21600899,3/1/2017,1610612743,Denver Nuggets,0,1,1610612749,Milwaukee Bucks,1,0,31,20,51,10,23,33,41,43,84,18,2,20,16,27,21,8,14,92,110
2016,2,21600899,3/1/2017,1610612749,Milwaukee Bucks,1,0,1610612743,Denver Nuggets,0,1,29,36,65,9,9,18,38,45,83,13,2,15,13,33,26,8,14,91,98
2014,2,21400492,1/2/2015,1610612737,Atlanta Hawks,0,1,1610612762,Utah Jazz,1,0,27,31,58,6,17,23,33,48,81,26,4,30,15,33,24,6,11,93,98
2023,2,22300021,11/14/2023,1610612759,San Antonio Spurs,0,0,1610612760,Oklahoma City Thunder,1,1,27,36,63,9,21,30,36,57,93,6,3,9,19,40,24,19,25,105,87
2014,2,21400492,1/2/2015,1610612762,Utah Jazz,1,0,1610612737,Atlanta Hawks,0,1,22,33,55,10,21,31,32,54,86,18,6,24,18,39,18,9,14,93,92
2023,2,22300075,10/26/2023,1610612749,Milwaukee Bucks,1,1,1610612755,Philadelphia 76ers,0,0,30,21,51,11,19,30,41,40,81,25,11,36,9,36,20,8,14,103,118
2017,2,21700488,12/23/2017,1610612760,Oklahoma City Thunder,0,1,1610612762,Utah Jazz,1,0,27,32,59,12,17,29,39,49,88,13,3,16,18,32,18,3,8,87,103
2017,2,21700488,12/23/2017,1610612762,Utah Jazz,1,0,1610612760,Oklahoma City Thunder,0,1,27,19,46,6,20,26,33,39,72,17,3,20,9,31,16,9,14,86,89
2016,2,21600018,10/28/2016,1610612739,Cleveland Cavaliers,0,1,1610612761,Toronto Raptors,1,0,21,26,47,12,20,32,33,46,79,16,6,22,11,36,20,9,18,97,94
2016,2,21600018,10/28/2016,1610612761,Toronto Raptors,1,0,1610612739,Cleveland Cavaliers,0,1,31,43,74,4,12,16,35,55,90,17,1,18,21,34,12,8,18,97,91
2022,2,22200667,1/17/2023,1610612743,Denver Nuggets,1,1,1610612757,Portland Trail Blazers,0,0,33,23,56,11,21,32,44,44,88,23,5,28,16,31,32,3,12,98,122
2022,2,22200666,1/17/2023,1610612759,San Antonio Spurs,1,1,1610612751,Brooklyn Nets,0,0,30,33,63,7,27,34,37,60,97,25,3,28,21,40,23,10,16,107,106
2014,2,21400131,11/14/2014,1610612747,Los Angeles Lakers,1,0,1610612759,San Antonio Spurs,0,1,26,37,63,2,10,12,28,47,75,22,9,31,13,39,17,9,13,90,80
2022,2,22200007,10/19/2022,1610612741,Chicago Bulls,0,1,1610612748,Miami Heat,1,0,28,29,57,13,23,36,41,52,93,21,7,28,17,39,23,6,15,105,116
2021,2,22100714,1/25/2022,1610612765,Detroit Pistons,1,0,1610612743,Denver Nuggets,0,1,29,32,61,12,24,36,41,56,97,11,3,14,12,45,25,7,9,104,105
2016,2,21600898,3/1/2017,1610612748,Miami Heat,1,1,1610612755,Philadelphia 76ers,0,0,36,24,60,13,17,30,49,41,90,14,7,21,11,32,24,7,13,103,125
2016,2,21600898,3/1/2017,1610612755,Philadelphia 76ers,0,0,1610612748,Miami Heat,1,1,31,37,68,6,11,17,37,48,85,18,4,22,13,37,16,9,19,102,98
2022,2,22200685,1/20/2023,1610612744,Golden State Warriors,0,1,1610612739,Cleveland Cavaliers,1,0,19,24,43,23,20,43,42,44,86,13,6,19,17,28,25,7,18,96,120
2016,2,21600017,10/27/2016,1610612746,LA Clippers,0,1,1610612757,Portland Trail Blazers,1,0,29,33,62,8,21,29,37,54,91,32,14,46,18,42,12,4,8,101,114
2022,2,22200784,2/2/2023,1610612746,LA Clippers,0,0,1610612749,Milwaukee Bucks,1,1,26,33,59,13,23,36,39,56,95,14,6,20,11,47,15,2,7,101,105
2016,2,21600017,10/27/2016,1610612757,Portland Trail Blazers,1,0,1610612746,LA Clippers,0,1,35,32,67,4,14,18,39,46,85,24,8,32,14,36,18,10,14,100,106
2022,2,22200974,3/6/2023,1610612748,Miami Heat,1,1,1610612737,Atlanta Hawks,0,0,25,23,48,16,13,29,41,36,77,32,5,37,10,27,27,5,11,97,130
2022,2,22200872,2/14/2023,1610612764,Washington Wizards,0,1,1610612757,Portland Trail Blazers,1,0,28,18,46,17,16,33,45,34,79,19,3,22,8,26,28,9,16,98,126
2017,2,21700487,12/23/2017,1610612746,LA Clippers,0,0,1610612763,Memphis Grizzlies,1,1,26,19,45,13,21,34,39,40,79,21,7,28,8,34,14,5,11,95,112
2022,2,22200007,10/19/2022,1610612748,Miami Heat,1,0,1610612741,Chicago Bulls,0,1,25,27,52,12,16,28,37,43,80,22,6,28,9,37,21,12,19,103,108
2017,2,21700487,12/23/2017,1610612763,Memphis Grizzlies,1,1,1610612746,LA Clippers,0,0,27,32,59,13,18,31,40,50,90,22,3,25,19,34,28,4,10,94,115
2014,2,21400131,11/14/2014,1610612759,San Antonio Spurs,0,1,1610612747,Los Angeles Lakers,1,0,23,34,57,10,13,23,33,47,80,17,3,20,11,37,28,6,10,90,93
2016,2,21600368,12/13/2016,1610612739,Cleveland Cavaliers,1,1,1610612763,Memphis Grizzlies,0,0,25,25,50,12,19,31,37,44,81,17,6,23,14,33,21,10,18,95,103
2021,2,22100713,1/24/2022,1610612756,Phoenix Suns,1,1,1610612762,Utah Jazz,0,0,34,29,63,13,23,36,47,52,99,8,7,15,24,32,28,11,14,97,115
2016,2,21600368,12/13/2016,1610612763,Memphis Grizzlies,0,0,1610612739,Cleveland Cavaliers,1,1,31,33,64,4,18,22,35,51,86,12,3,15,14,39,19,8,16,95,86
2017,2,21700486,12/23/2017,1610612740,New Orleans Pelicans,0,1,1610612748,Miami Heat,1,0,24,24,48,15,10,25,39,34,73,16,3,19,7,28,27,4,14,89,109
2017,2,21700486,12/23/2017,1610612748,Miami Heat,1,0,1610612740,New Orleans Pelicans,0,1,26,27,53,10,22,32,36,49,85,12,3,15,18,32,18,5,14,90,94
2021,2,22100713,1/24/2022,1610612762,Utah Jazz,0,0,1610612756,Phoenix Suns,1,1,26,24,50,14,17,31,40,41,81,15,7,22,9,35,16,10,14,97,109
2020,2,22000451,2/19/2021,1610612737,Atlanta Hawks,0,0,1610612738,Boston Celtics,1,1,28,32,60,10,20,30,38,52,90,23,2,25,16,38,21,8,14,101,109
2021,2,22101039,3/16/2022,1610612747,Los Angeles Lakers,0,0,1610612750,Minnesota Timberwolves,1,1,29,20,49,10,34,44,39,54,93,16,7,23,17,39,23,7,14,101,104
2021,2,22101039,3/16/2022,1610612750,Minnesota Timberwolves,1,1,1610612747,Los Angeles Lakers,0,0,23,25,48,17,25,42,40,50,90,27,4,31,22,29,22,7,17,101,124
2016,2,21600367,12/12/2016,1610612747,Los Angeles Lakers,0,0,1610612758,Sacramento Kings,1,1,23,38,61,10,13,23,33,51,84,16,5,21,18,36,18,16,20,98,92
2016,2,21600367,12/12/2016,1610612758,Sacramento Kings,1,1,1610612747,Los Angeles Lakers,0,0,37,24,61,10,13,23,47,37,84,12,9,21,17,25,23,12,22,99,116
2022,2,22200684,1/20/2023,1610612737,Atlanta Hawks,1,1,1610612752,New York Knicks,0,0,43,23,66,13,21,34,56,44,100,14,2,16,19,26,27,5,7,94,139
2022,2,22200871,2/14/2023,1610612746,LA Clippers,1,1,1610612744,Golden State Warriors,0,0,32,24,56,17,19,36,49,43,92,19,3,22,16,28,33,2,8,95,134
2022,2,22200008,10/19/2022,1610612739,Cleveland Cavaliers,0,0,1610612761,Toronto Raptors,1,1,28,21,49,10,18,28,38,39,77,19,4,23,8,33,25,15,17,98,105
2022,2,22200008,10/19/2022,1610612761,Toronto Raptors,1,1,1610612739,Cleveland Cavaliers,0,0,23,33,56,13,17,30,36,50,86,23,9,32,17,36,19,5,13,98,108
2022,2,22200853,2/11/2023,1610612747,Los Angeles Lakers,0,1,1610612744,Golden State Warriors,1,0,32,32,64,8,17,25,40,49,89,21,5,26,12,38,19,11,16,105,109
2017,2,21700485,12/23/2017,1610612738,Boston Celtics,1,1,1610612741,Chicago Bulls,0,0,32,28,60,12,20,32,44,48,92,17,4,21,11,39,29,4,6,97,117
2022,2,22200846,2/11/2023,1610612755,Philadelphia 76ers,0,1,1610612751,Brooklyn Nets,1,0,27,25,52,6,17,23,33,42,75,29,1,30,11,32,17,7,12,89,101
2017,2,21700485,12/23/2017,1610612741,Chicago Bulls,0,0,1610612738,Boston Celtics,1,1,27,40,67,7,12,19,34,52,86,17,8,25,16,40,24,9,15,98,92
2016,2,21600897,3/1/2017,1610612737,Atlanta Hawks,1,1,1610612742,Dallas Mavericks,0,0,26,17,43,10,11,21,36,28,64,18,6,24,7,25,24,10,23,92,100
2016,2,21600897,3/1/2017,1610612742,Dallas Mavericks,0,0,1610612737,Atlanta Hawks,1,1,21,23,44,14,19,33,35,42,77,11,2,13,12,31,22,12,22,92,95
2022,2,22200871,2/14/2023,1610612744,Golden State Warriors,0,0,1610612746,LA Clippers,1,1,30,19,49,15,19,34,45,38,83,19,8,27,12,31,28,5,11,95,124
2022,2,22200971,3/6/2023,1610612738,Boston Celtics,0,0,1610612739,Cleveland Cavaliers,1,1,26,27,53,16,32,48,42,59,101,14,7,21,17,44,25,4,14,106,114
2022,2,22200782,2/2/2023,1610612740,New Orleans Pelicans,0,0,1610612742,Dallas Mavericks,1,1,37,27,64,5,15,20,42,42,84,17,4,21,13,32,27,10,17,95,106
2017,2,21700484,12/23/2017,1610612737,Atlanta Hawks,1,1,1610612742,Dallas Mavericks,0,0,32,19,51,10,14,24,42,33,75,18,4,22,10,26,29,8,15,90,112
2017,2,21700484,12/23/2017,1610612742,Dallas Mavericks,0,0,1610612737,Atlanta Hawks,1,1,34,18,52,9,24,33,43,42,85,12,3,15,11,32,31,5,11,91,107
2021,2,22100712,1/24/2022,1610612740,New Orleans Pelicans,1,1,1610612754,Indiana Pacers,0,0,35,23,58,6,24,30,41,47,88,29,2,31,14,34,23,5,12,101,117
2016,2,21600896,3/1/2017,1610612761,Toronto Raptors,1,0,1610612764,Washington Wizards,0,1,26,44,70,7,13,20,33,57,90,23,3,26,19,39,11,6,12,95,96
2016,2,21600896,3/1/2017,1610612764,Washington Wizards,0,1,1610612761,Toronto Raptors,1,0,31,28,59,9,16,25,40,44,84,16,3,19,8,36,32,8,12,96,105
2022,2,22200009,10/19/2022,1610612752,New York Knicks,0,0,1610612763,Memphis Grizzlies,1,1,35,37,72,9,28,37,44,65,109,15,3,18,22,46,28,6,12,105,112
2021,2,22101038,3/16/2022,1610612745,Houston Rockets,1,0,1610612756,Phoenix Suns,0,1,26,20,46,16,23,39,42,43,85,12,7,19,11,38,26,5,12,96,112
2021,2,22101038,3/16/2022,1610612756,Phoenix Suns,0,1,1610612745,Houston Rockets,1,0,40,22,62,13,20,33,53,42,95,10,3,13,17,26,32,9,11,94,129
2022,2,22200009,10/19/2022,1610612763,Memphis Grizzlies,1,1,1610612752,New York Knicks,0,0,25,33,58,17,33,50,42,66,108,14,9,23,28,42,27,7,14,106,115
2022,2,22200699,1/22/2023,1610612748,Miami Heat,1,1,1610612740,New Orleans Pelicans,0,0,27,19,46,8,26,34,35,45,80,22,5,27,15,34,17,17,22,99,100
2022,2,22200627,1/12/2023,1610612738,Boston Celtics,0,1,1610612751,Brooklyn Nets,1,0,29,21,50,12,24,36,41,45,86,15,2,17,15,31,23,8,14,93,109
2022,2,22200627,1/12/2023,1610612751,Brooklyn Nets,1,0,1610612738,Boston Celtics,0,1,25,25,50,13,21,34,38,46,84,9,2,11,8,39,26,4,12,94,98
2014,2,21400130,11/14/2014,1610612756,Phoenix Suns,1,0,1610612766,Charlotte Hornets,0,1,29,28,57,8,21,29,37,49,86,13,1,14,13,36,16,5,11,92,95
2014,2,21400130,11/14/2014,1610612766,Charlotte Hornets,0,1,1610612756,Phoenix Suns,1,0,32,43,75,7,9,16,39,52,91,18,1,19,17,35,21,3,8,90,103
2022,2,22200667,1/17/2023,1610612757,Portland Trail Blazers,0,0,1610612743,Denver Nuggets,1,1,25,18,43,13,27,40,38,45,83,24,1,25,10,35,21,8,13,99,113
2022,2,22200782,2/2/2023,1610612742,Dallas Mavericks,1,1,1610612740,New Orleans Pelicans,0,0,23,21,44,14,27,41,37,48,85,23,6,29,10,41,16,6,8,96,111
2016,2,21600366,12/12/2016,1610612746,LA Clippers,1,1,1610612757,Portland Trail Blazers,0,0,31,35,66,11,12,23,42,47,89,26,2,28,16,31,26,6,13,98,121
2022,2,22200872,2/14/2023,1610612757,Portland Trail Blazers,1,0,1610612764,Washington Wizards,0,1,24,20,44,12,30,42,36,50,86,17,7,24,13,42,20,5,12,97,101
2016,2,21600366,12/12/2016,1610612757,Portland Trail Blazers,0,0,1610612746,LA Clippers,1,1,34,32,66,10,11,21,44,43,87,22,3,25,17,28,25,9,16,99,120
2022,2,22201014,3/12/2023,1610612751,Brooklyn Nets,0,1,1610612743,Denver Nuggets,1,0,25,15,40,17,27,44,42,42,84,21,3,24,8,35,32,4,10,93,122
2022,2,22200699,1/22/2023,1610612740,New Orleans Pelicans,0,0,1610612748,Miami Heat,1,1,29,19,48,8,22,30,37,41,78,14,4,18,11,31,24,16,25,101,96
2022,2,22200010,10/19/2022,1610612750,Minnesota Timberwolves,1,1,1610612760,Oklahoma City Thunder,0,0,29,27,56,10,28,38,39,55,94,27,6,33,18,42,25,6,14,105,115
2022,2,22200010,10/19/2022,1610612760,Oklahoma City Thunder,0,0,1610612750,Minnesota Timberwolves,1,1,24,30,54,14,31,45,38,61,99,18,4,22,20,43,22,6,14,104,108
2022,2,22200013,10/19/2022,1610612742,Dallas Mavericks,0,0,1610612756,Phoenix Suns,1,1,21,19,40,14,21,35,35,40,75,21,13,34,10,36,17,4,12,96,105
2021,2,22100712,1/24/2022,1610612754,Indiana Pacers,0,0,1610612740,New Orleans Pelicans,1,1,19,22,41,19,27,46,38,49,87,18,7,25,17,36,26,7,17,101,113
2017,2,21700483,12/23/2017,1610612753,Orlando Magic,0,0,1610612764,Washington Wizards,1,1,34,27,61,8,18,26,42,45,87,11,6,17,8,39,17,5,12,97,103
2017,2,21700483,12/23/2017,1610612764,Washington Wizards,1,1,1610612753,Orlando Magic,0,0,31,25,56,16,14,30,47,39,86,20,3,23,16,25,29,7,17,95,130
2022,2,22200781,2/2/2023,1610612766,Charlotte Hornets,0,0,1610612741,Chicago Bulls,1,1,32,26,58,7,28,35,39,54,93,13,2,15,20,35,19,9,15,94,98
2016,2,21600895,3/1/2017,1610612752,New York Knicks,0,1,1610612753,Orlando Magic,1,0,26,26,52,8,21,29,34,47,81,25,6,31,14,36,21,3,11,93,101
2016,2,21600895,3/1/2017,1610612753,Orlando Magic,1,0,1610612752,New York Knicks,0,1,29,29,58,5,20,25,34,49,83,17,5,22,13,38,11,9,13,93,90
2022,2,22200013,10/19/2022,1610612756,Phoenix Suns,1,1,1610612742,Dallas Mavericks,0,0,32,31,63,8,14,22,40,45,85,19,3,22,12,35,25,6,12,95,107
2023,2,22300034,11/17/2023,1610612743,Denver Nuggets,0,0,1610612740,New Orleans Pelicans,1,1,37,19,56,10,30,40,47,49,96,6,6,12,13,40,37,8,13,99,110
2020,2,22000451,2/19/2021,1610612738,Boston Celtics,1,1,1610612737,Atlanta Hawks,0,0,36,19,55,14,21,35,50,40,90,7,3,10,12,30,26,14,18,100,121
2014,2,21400129,11/14/2014,1610612760,Oklahoma City Thunder,1,0,1610612765,Detroit Pistons,0,1,26,34,60,12,24,36,38,58,96,1,5,6,14,47,23,8,14,96,89
2014,2,21400129,11/14/2014,1610612765,Detroit Pistons,0,1,1610612760,Oklahoma City Thunder,1,0,27,31,58,11,20,31,38,51,89,9,6,15,17,36,18,9,17,95,96
2022,2,22200779,2/2/2023,1610612763,Memphis Grizzlies,0,0,1610612739,Cleveland Cavaliers,1,1,31,33,64,10,13,23,41,46,87,21,1,22,14,33,22,12,18,103,113
2022,2,22200913,2/26/2023,1610612742,Dallas Mavericks,1,0,1610612747,Los Angeles Lakers,0,1,19,25,44,20,29,49,39,54,93,10,4,14,16,41,21,9,17,101,108
2016,2,21600016,10/27/2016,1610612758,Sacramento Kings,1,0,1610612759,San Antonio Spurs,0,1,22,28,50,6,14,20,28,42,70,32,6,38,13,32,22,10,16,92,94
2016,2,21600016,10/27/2016,1610612759,San Antonio Spurs,0,1,1610612758,Sacramento Kings,1,0,30,31,61,6,12,18,36,43,79,24,3,27,10,35,23,7,10,91,102
2022,2,22200779,2/2/2023,1610612739,Cleveland Cavaliers,1,1,1610612763,Memphis Grizzlies,0,0,35,27,62,14,15,29,49,42,91,16,6,22,13,33,33,8,16,103,128
2017,2,21700482,12/23/2017,1610612751,Brooklyn Nets,0,0,1610612754,Indiana Pacers,1,1,26,36,62,16,20,36,42,56,98,19,6,25,24,35,24,8,14,100,119
2017,2,21700482,12/23/2017,1610612754,Indiana Pacers,1,1,1610612751,Brooklyn Nets,0,0,37,30,67,10,13,23,47,43,90,19,5,24,11,34,31,2,9,100,123
2022,2,22200014,10/19/2022,1610612758,Sacramento Kings,1,0,1610612757,Portland Trail Blazers,0,1,22,19,41,17,27,44,39,46,85,13,6,19,11,36,27,11,16,101,108
2016,2,21600894,2/28/2017,1610612747,Los Angeles Lakers,1,0,1610612766,Charlotte Hornets,0,1,29,23,52,12,20,32,41,43,84,10,3,13,9,36,22,3,14,96,104
2016,2,21600894,2/28/2017,1610612766,Charlotte Hornets,0,1,1610612747,Los Angeles Lakers,1,0,22,24,46,16,23,39,38,47,85,17,7,24,14,35,25,9,12,94,109
2022,2,22200816,2/7/2023,1610612752,New York Knicks,0,1,1610612753,Orlando Magic,1,0,22,16,38,15,28,43,37,44,81,13,6,19,14,33,21,4,11,89,102
2022,2,22200704,1/22/2023,1610612744,Golden State Warriors,1,0,1610612751,Brooklyn Nets,0,1,28,30,58,13,19,32,41,49,90,21,6,27,14,37,28,4,12,101,116
2022,2,22200972,3/6/2023,1610612755,Philadelphia 76ers,0,1,1610612754,Indiana Pacers,1,0,32,16,48,16,18,34,48,34,82,35,3,38,8,27,37,8,12,103,147
2022,2,22200011,10/19/2022,1610612759,San Antonio Spurs,1,0,1610612766,Charlotte Hornets,0,1,33,32,65,7,27,34,40,59,99,15,6,21,18,43,22,7,15,105,102
2017,2,21700481,12/23/2017,1610612749,Milwaukee Bucks,0,0,1610612766,Charlotte Hornets,1,1,34,27,61,8,18,26,42,45,87,14,3,17,11,35,25,2,9,93,106
2017,2,21700481,12/23/2017,1610612766,Charlotte Hornets,1,1,1610612749,Milwaukee Bucks,0,0,27,26,53,9,12,21,36,38,74,30,10,40,14,29,22,4,17,95,111
2016,2,21600365,12/12/2016,1610612742,Dallas Mavericks,1,1,1610612743,Denver Nuggets,0,0,33,18,51,12,14,26,45,32,77,10,2,12,9,24,22,6,11,84,112
2016,2,21600365,12/12/2016,1610612743,Denver Nuggets,0,0,1610612742,Dallas Mavericks,1,1,28,30,58,7,18,25,35,48,83,15,3,18,24,26,19,9,16,83,92
2022,2,22200781,2/2/2023,1610612741,Chicago Bulls,1,1,1610612766,Charlotte Hornets,0,0,30,21,51,11,17,28,41,38,79,21,5,26,10,32,24,6,14,94,114
2022,2,22200705,1/22/2023,1610612747,Los Angeles Lakers,0,1,1610612757,Portland Trail Blazers,1,0,35,21,56,10,20,30,45,41,86,21,6,27,15,30,23,5,13,98,121
2022,2,22200011,10/19/2022,1610612766,Charlotte Hornets,0,1,1610612759,San Antonio Spurs,1,0,35,30,65,13,16,29,48,46,94,20,3,23,16,32,26,8,15,103,129
2021,2,22100711,1/10/2022,1610612745,Houston Rockets,1,0,1610612755,Philadelphia 76ers,0,1,17,18,35,13,29,42,30,47,77,18,9,27,12,37,18,14,21,102,91
2021,2,22100711,1/10/2022,1610612755,Philadelphia 76ers,0,1,1610612745,Houston Rockets,1,0,33,26,59,10,25,35,43,51,94,15,3,18,16,36,23,8,15,100,111
2021,2,22101037,3/16/2022,1610612752,New York Knicks,1,1,1610612757,Portland Trail Blazers,0,0,24,18,42,16,22,38,40,40,80,32,7,39,13,31,31,1,11,97,128
2021,2,22101037,3/16/2022,1610612757,Portland Trail Blazers,0,0,1610612752,New York Knicks,1,1,29,28,57,11,23,34,40,51,91,7,7,14,12,43,26,9,12,97,98
2017,2,21700480,12/23/2017,1610612755,Philadelphia 76ers,0,0,1610612761,Toronto Raptors,1,1,26,27,53,7,20,27,33,47,80,13,7,20,13,36,19,15,23,102,86
2020,2,22000744,4/2/2021,1610612756,Phoenix Suns,1,1,1610612760,Oklahoma City Thunder,0,0,39,18,57,15,18,33,54,36,90,17,4,21,7,29,36,6,10,102,140
2020,2,22000744,4/2/2021,1610612760,Oklahoma City Thunder,0,0,1610612756,Phoenix Suns,1,1,20,31,51,15,23,38,35,54,89,18,5,23,16,40,19,12,16,103,103
2020,2,22000450,2/19/2021,1610612741,Chicago Bulls,0,0,1610612755,Philadelphia 76ers,1,1,33,30,63,7,25,32,40,55,95,18,0,18,17,38,24,5,11,98,105
2017,2,21700480,12/23/2017,1610612761,Toronto Raptors,1,1,1610612755,Philadelphia 76ers,0,0,26,32,58,9,18,27,35,50,85,23,3,26,13,39,18,10,18,100,102
2016,2,21600893,2/28/2017,1610612760,Oklahoma City Thunder,1,1,1610612762,Utah Jazz,0,0,24,30,54,15,7,22,39,37,76,16,7,23,10,30,20,8,14,90,109
2021,2,22101036,3/16/2022,1610612742,Dallas Mavericks,0,1,1610612751,Brooklyn Nets,1,0,29,20,49,12,22,34,41,42,83,19,0,19,15,27,21,2,11,88,113
2022,2,22200012,10/19/2022,1610612743,Denver Nuggets,0,0,1610612762,Utah Jazz,1,1,35,26,61,5,17,22,40,43,83,17,1,18,11,33,21,10,21,101,102
2022,2,22200012,10/19/2022,1610612762,Utah Jazz,1,1,1610612743,Denver Nuggets,0,0,26,19,45,16,22,38,42,41,83,23,8,31,18,26,27,10,20,100,123
2021,2,22101036,3/16/2022,1610612751,Brooklyn Nets,1,0,1610612742,Dallas Mavericks,0,1,36,29,65,9,17,26,45,46,91,12,3,15,20,29,28,5,11,87,111
2023,2,22300033,11/17/2023,1610612741,Chicago Bulls,1,0,1610612753,Orlando Magic,0,1,25,25,50,10,19,29,35,44,79,17,5,22,10,37,19,7,16,94,97
2022,2,22200705,1/22/2023,1610612757,Portland Trail Blazers,1,0,1610612747,Los Angeles Lakers,0,1,20,20,40,17,29,46,37,49,86,21,4,25,12,41,24,5,12,98,112
2022,2,22200702,1/22/2023,1610612743,Denver Nuggets,1,0,1610612760,Oklahoma City Thunder,0,1,26,28,54,10,18,28,36,46,82,17,16,33,17,38,22,4,9,90,99
2020,2,22000450,2/19/2021,1610612755,Philadelphia 76ers,1,1,1610612741,Chicago Bulls,0,0,34,32,66,7,14,21,41,46,87,23,6,29,18,31,23,5,15,96,112
2017,2,21700479,12/22/2017,1610612744,Golden State Warriors,1,1,1610612747,Los Angeles Lakers,0,0,35,26,61,7,17,24,42,43,85,22,5,27,14,32,24,11,16,102,113
2022,2,22200794,2/4/2023,1610612756,Phoenix Suns,0,1,1610612765,Detroit Pistons,1,0,31,21,52,11,12,23,42,33,75,21,10,31,13,24,34,8,17,94,116
2022,2,22200668,1/17/2023,1610612746,LA Clippers,1,0,1610612755,Philadelphia 76ers,0,1,29,19,48,12,22,34,41,41,82,16,4,20,16,27,20,12,19,92,110
2017,2,21700479,12/22/2017,1610612747,Los Angeles Lakers,0,0,1610612744,Golden State Warriors,1,1,29,36,65,11,18,29,40,54,94,15,7,22,22,35,22,9,17,101,106
2022,2,22200971,3/6/2023,1610612739,Cleveland Cavaliers,1,1,1610612738,Boston Celtics,0,0,31,31,62,12,22,34,43,53,96,20,5,25,16,39,27,5,15,105,118
2022,2,22200015,10/20/2022,1610612749,Milwaukee Bucks,0,1,1610612755,Philadelphia 76ers,1,0,21,21,42,13,29,42,34,50,84,9,5,14,11,41,24,6,14,94,90
2022,2,22200015,10/20/2022,1610612755,Philadelphia 76ers,1,0,1610612749,Milwaukee Bucks,0,1,31,28,59,5,19,24,36,47,83,11,2,13,6,42,17,4,10,93,88
2021,2,22100710,3/3/2022,1610612737,Atlanta Hawks,1,1,1610612741,Chicago Bulls,0,0,26,18,44,18,22,40,44,40,84,24,4,28,9,32,26,5,6,95,130
2021,2,22100710,3/3/2022,1610612741,Chicago Bulls,0,0,1610612737,Atlanta Hawks,1,1,38,24,62,14,12,26,52,36,88,6,1,7,10,27,30,7,14,96,124
2021,2,22101035,3/16/2022,1610612743,Denver Nuggets,0,1,1610612764,Washington Wizards,1,0,31,22,53,15,22,37,46,44,90,20,1,21,9,35,30,7,10,99,127
2014,2,21400128,11/14/2014,1610612740,New Orleans Pelicans,1,1,1610612750,Minnesota Timberwolves,0,0,41,23,64,15,5,20,56,28,84,12,4,16,3,26,31,5,13,100,139
2021,2,22101035,3/16/2022,1610612764,Washington Wizards,1,0,1610612743,Denver Nuggets,0,1,36,28,64,5,18,23,41,46,87,22,9,31,15,35,26,7,11,99,109
2014,2,21400128,11/14/2014,1610612750,Minnesota Timberwolves,0,0,1610612740,New Orleans Pelicans,1,1,26,32,58,3,11,14,29,43,72,30,11,41,15,32,13,13,24,102,91
2023,2,22300306,12/12/2023,1610612742,Dallas Mavericks,1,1,1610612747,Los Angeles Lakers,0,0,23,23,46,21,22,43,44,45,89,18,3,21,14,32,28,4,10,95,127
2016,2,21600893,2/28/2017,1610612762,Utah Jazz,0,0,1610612760,Oklahoma City Thunder,1,1,34,37,71,9,13,22,43,50,93,11,2,13,14,38,22,5,7,91,106
2021,2,22101034,3/16/2022,1610612739,Cleveland Cavaliers,1,0,1610612755,Philadelphia 76ers,0,1,30,22,52,9,19,28,39,41,80,27,5,32,10,34,25,6,9,93,114
2021,2,22101034,3/16/2022,1610612755,Philadelphia 76ers,0,1,1610612739,Cleveland Cavaliers,1,0,29,18,47,12,20,32,41,38,79,24,4,28,9,32,24,9,11,94,118
2022,2,22200668,1/17/2023,1610612755,Philadelphia 76ers,0,1,1610612746,LA Clippers,1,0,26,16,42,13,18,31,39,34,73,29,5,34,10,26,25,4,15,93,120
2022,2,22200016,10/20/2022,1610612746,LA Clippers,0,1,1610612747,Los Angeles Lakers,1,0,28,23,51,9,20,29,37,43,80,20,11,31,13,33,18,13,23,104,103
2022,2,22200795,2/4/2023,1610612752,New York Knicks,1,0,1610612746,LA Clippers,0,1,27,27,54,18,22,40,45,49,94,20,6,26,12,38,30,8,10,106,128
2023,2,22300549,1/13/2024,1610612747,Los Angeles Lakers,0,0,1610612762,Utah Jazz,1,1,33,30,63,13,16,29,46,46,92,20,4,24,9,40,30,7,12,105,125
2017,2,21700478,12/22/2017,1610612743,Denver Nuggets,0,1,1610612757,Portland Trail Blazers,1,0,35,25,60,7,18,25,42,43,85,11,4,15,20,26,19,6,14,85,102
2021,2,22101033,3/16/2022,1610612737,Atlanta Hawks,0,0,1610612766,Charlotte Hornets,1,1,27,29,56,13,24,37,40,53,93,13,1,14,19,34,28,8,13,93,106
2021,2,22101033,3/16/2022,1610612766,Charlotte Hornets,1,1,1610612737,Atlanta Hawks,0,0,32,20,52,11,24,35,43,44,87,19,4,23,13,34,30,6,9,94,116
2022,2,22200703,1/22/2023,1610612756,Phoenix Suns,1,1,1610612763,Memphis Grizzlies,0,0,26,27,53,13,22,35,39,49,88,21,4,25,11,40,25,8,16,101,112
2022,2,22200016,10/20/2022,1610612747,Los Angeles Lakers,1,0,1610612746,LA Clippers,0,1,24,25,49,9,36,45,33,61,94,22,4,26,13,52,23,7,10,104,97
2020,2,22000743,4/2/2021,1610612741,Chicago Bulls,0,0,1610612762,Utah Jazz,1,1,36,25,61,7,21,28,43,46,89,13,4,17,9,38,26,6,7,96,106
2020,2,22000743,4/2/2021,1610612762,Utah Jazz,1,1,1610612741,Chicago Bulls,0,0,24,19,43,13,23,36,37,42,79,26,1,27,8,35,16,5,11,95,113
2023,2,22300135,11/4/2023,1610612737,Atlanta Hawks,0,1,1610612740,New Orleans Pelicans,1,0,31,21,52,14,27,41,45,48,93,19,5,24,23,28,28,9,13,95,123
2021,2,22100709,1/24/2022,1610612739,Cleveland Cavaliers,1,1,1610612752,New York Knicks,0,0,22,23,45,13,23,36,35,46,81,12,8,20,16,35,29,11,20,94,95
2022,2,22200032,10/22/2022,1610612739,Cleveland Cavaliers,0,1,1610612741,Chicago Bulls,1,0,32,26,58,16,11,27,48,37,85,16,2,18,13,25,32,12,18,96,128
2021,2,22100709,1/24/2022,1610612752,New York Knicks,0,0,1610612739,Cleveland Cavaliers,1,1,23,23,46,12,26,38,35,49,84,11,10,21,13,40,21,7,12,94,93
2020,2,22000449,2/19/2021,1610612744,Golden State Warriors,0,0,1610612753,Orlando Magic,1,1,27,28,55,19,23,42,46,51,97,9,6,15,11,43,37,7,13,105,120
2020,2,22000449,2/19/2021,1610612753,Orlando Magic,1,1,1610612744,Golden State Warriors,0,0,28,23,51,18,25,43,46,48,94,14,3,17,10,38,30,8,13,104,124
2021,2,22101032,3/15/2022,1610612740,New Orleans Pelicans,1,0,1610612756,Phoenix Suns,0,1,31,21,52,12,22,34,43,43,86,17,7,24,17,29,29,9,17,98,115
2021,2,22101032,3/15/2022,1610612756,Phoenix Suns,0,1,1610612740,New Orleans Pelicans,1,0,31,25,56,18,16,34,49,41,90,15,0,15,7,34,35,7,9,98,131
2017,2,21700478,12/22/2017,1610612757,Portland Trail Blazers,1,0,1610612743,Denver Nuggets,0,1,29,32,61,6,16,22,35,48,83,9,7,16,14,37,15,4,10,86,85
2014,2,21400127,11/14/2014,1610612745,Houston Rockets,1,1,1610612755,Philadelphia 76ers,0,0,22,22,44,7,27,34,29,49,78,23,14,37,19,38,16,10,21,98,88
2018,2,21801109,3/26/2019,1610612748,Miami Heat,1,0,1610612753,Orlando Magic,0,1,26,27,53,10,23,33,36,50,86,17,4,21,10,41,25,5,12,97,99
2018,2,21801109,3/26/2019,1610612753,Orlando Magic,0,1,1610612748,Miami Heat,1,0,23,24,47,14,28,42,37,52,89,16,7,23,18,38,27,10,15,99,104
2018,2,21800962,3/5/2019,1610612757,Portland Trail Blazers,0,0,1610612763,Memphis Grizzlies,1,1,33,17,50,9,20,29,42,37,79,18,3,21,7,31,25,11,20,103,111
2018,2,21800962,3/5/2019,1610612763,Memphis Grizzlies,1,1,1610612757,Portland Trail Blazers,0,0,27,21,48,13,14,27,40,35,75,27,9,36,7,32,22,7,17,102,120
2018,2,21800840,2/11/2019,1610612764,Washington Wizards,0,0,1610612765,Detroit Pistons,1,1,28,17,45,14,25,39,42,42,84,14,5,19,7,38,31,6,14,98,112
2018,2,21800840,2/11/2019,1610612765,Detroit Pistons,1,1,1610612764,Washington Wizards,0,0,29,20,49,15,21,36,44,41,85,18,3,21,13,30,25,7,16,99,121
2022,2,22200578,1/5/2023,1610612745,Houston Rockets,1,0,1610612762,Utah Jazz,0,1,23,27,50,15,27,42,38,54,92,23,3,26,18,37,19,10,15,102,114
2022,2,22200578,1/5/2023,1610612762,Utah Jazz,0,1,1610612745,Houston Rockets,1,0,27,18,45,19,29,48,46,47,93,20,1,21,10,37,33,4,8,101,131
2017,2,21700477,12/22/2017,1610612737,Atlanta Hawks,0,0,1610612760,Oklahoma City Thunder,1,1,29,24,53,15,17,32,44,41,85,14,3,17,14,27,28,11,17,99,117
2022,2,22200032,10/22/2022,1610612741,Chicago Bulls,1,0,1610612739,Cleveland Cavaliers,0,1,27,28,55,7,22,29,34,50,84,21,4,25,10,42,19,4,10,95,96
2017,2,21700477,12/22/2017,1610612760,Oklahoma City Thunder,1,1,1610612737,Atlanta Hawks,0,0,31,26,57,13,12,25,44,38,82,19,12,31,20,21,24,12,19,98,120
2022,2,22200703,1/22/2023,1610612763,Memphis Grizzlies,0,0,1610612756,Phoenix Suns,1,1,29,31,60,11,21,32,40,52,92,19,8,27,21,35,28,10,21,103,110
2022,2,22200998,3/10/2023,1610612757,Portland Trail Blazers,0,0,1610612755,Philadelphia 76ers,1,1,27,17,44,15,21,36,42,38,80,20,10,30,9,32,24,7,9,96,119
2023,2,22300136,11/4/2023,1610612751,Brooklyn Nets,1,0,1610612738,Boston Celtics,0,1,26,22,48,17,35,52,43,57,100,11,6,17,15,44,22,4,6,100,114
2022,2,22201163,4/2/2023,1610612766,Charlotte Hornets,1,0,1610612761,Toronto Raptors,0,1,27,27,54,15,16,31,42,43,85,9,4,13,13,31,26,8,18,96,108
2023,2,22300306,12/12/2023,1610612747,Los Angeles Lakers,0,0,1610612742,Dallas Mavericks,1,1,34,28,62,15,14,29,49,42,91,12,6,18,17,27,34,7,15,96,125
2023,2,22300253,11/27/2023,1610612765,Detroit Pistons,1,0,1610612764,Washington Wizards,0,1,35,29,64,8,30,38,43,59,102,13,6,19,21,41,29,8,17,107,107
2023,2,22300477,1/4/2024,1610612759,San Antonio Spurs,1,0,1610612749,Milwaukee Bucks,0,1,32,23,55,14,26,40,46,49,95,15,2,17,12,37,31,5,12,103,121
2023,2,22300379,12/21/2023,1610612760,Oklahoma City Thunder,1,1,1610612746,LA Clippers,0,0,35,18,53,16,18,34,51,36,87,16,2,18,7,31,35,9,12,100,134
2021,2,22100708,1/23/2022,1610612744,Golden State Warriors,1,1,1610612762,Utah Jazz,0,0,23,18,41,13,29,42,36,47,83,9,1,10,12,35,19,7,10,84,94
2021,2,22100708,1/23/2022,1610612762,Utah Jazz,0,0,1610612744,Golden State Warriors,1,1,20,26,46,11,24,35,31,50,81,19,4,23,20,33,17,8,12,85,92
2021,2,22101031,3/15/2022,1610612748,Miami Heat,1,1,1610612765,Detroit Pistons,0,0,17,22,39,12,21,33,29,43,72,35,4,39,9,36,20,6,13,94,105
2021,2,22101031,3/15/2022,1610612765,Detroit Pistons,0,0,1610612748,Miami Heat,1,1,27,19,46,10,24,34,37,43,80,14,8,22,9,38,23,1,13,95,98
2020,2,22000448,5/11/2021,1610612743,Denver Nuggets,0,1,1610612766,Charlotte Hornets,1,0,28,22,50,13,20,33,41,42,83,22,4,26,10,34,26,9,17,102,117
2020,2,22000448,5/11/2021,1610612766,Charlotte Hornets,1,0,1610612743,Denver Nuggets,0,1,31,21,52,11,28,39,42,49,91,17,3,20,17,32,30,12,17,102,112
2022,2,22200977,3/6/2023,1610612765,Detroit Pistons,1,0,1610612757,Portland Trail Blazers,0,1,30,24,54,10,22,32,40,46,86,14,6,20,16,33,30,7,16,96,104
2022,2,22200031,10/22/2022,1610612748,Miami Heat,1,1,1610612761,Toronto Raptors,0,0,27,19,46,11,19,30,38,38,76,25,2,27,11,29,28,9,16,94,112
2022,2,22200031,10/22/2022,1610612761,Toronto Raptors,0,0,1610612748,Miami Heat,1,1,23,25,48,14,25,39,37,50,87,21,7,28,13,40,24,2,6,95,109
2023,2,22300307,12/12/2023,1610612743,Denver Nuggets,0,1,1610612741,Chicago Bulls,1,0,25,28,53,14,16,30,39,44,83,22,10,32,17,32,28,6,11,92,114
2021,2,22100707,1/23/2022,1610612743,Denver Nuggets,1,1,1610612765,Detroit Pistons,0,0,32,18,50,12,23,35,44,41,85,17,6,23,13,32,29,4,13,97,117
2017,2,21700476,12/22/2017,1610612749,Milwaukee Bucks,1,1,1610612766,Charlotte Hornets,0,0,33,25,58,8,21,29,41,46,87,19,4,23,14,35,27,4,8,93,109
2017,2,21700476,12/22/2017,1610612766,Charlotte Hornets,0,0,1610612749,Milwaukee Bucks,1,1,27,35,62,12,14,26,39,49,88,14,3,17,13,38,21,7,9,93,104
2021,2,22100707,1/23/2022,1610612765,Detroit Pistons,0,0,1610612743,Denver Nuggets,1,1,31,15,46,11,18,29,42,33,75,16,3,19,7,28,28,8,22,98,111
2022,2,22200794,2/4/2023,1610612765,Detroit Pistons,1,0,1610612756,Phoenix Suns,0,1,19,20,39,16,26,42,35,46,81,14,8,22,12,40,23,10,16,94,100
2022,2,22200702,1/22/2023,1610612760,Oklahoma City Thunder,0,1,1610612743,Denver Nuggets,1,0,33,30,63,7,19,26,40,49,89,14,2,16,16,34,21,7,8,89,101
2021,2,22101030,3/15/2022,1610612751,Brooklyn Nets,0,1,1610612753,Orlando Magic,1,0,37,24,61,16,11,27,53,35,88,28,6,34,11,28,35,2,13,105,150
2022,2,22200033,10/22/2022,1610612745,Houston Rockets,0,0,1610612749,Milwaukee Bucks,1,1,20,36,56,16,21,37,36,57,93,17,5,22,19,42,20,6,14,100,105
2022,2,22200033,10/22/2022,1610612749,Milwaukee Bucks,1,1,1610612745,Houston Rockets,0,0,32,22,54,16,15,31,48,37,85,13,8,21,10,32,29,9,16,98,125
2021,2,22100706,1/23/2022,1610612750,Minnesota Timberwolves,1,1,1610612751,Brooklyn Nets,0,0,34,26,60,14,18,32,48,44,92,26,5,31,11,35,24,4,9,101,136
2021,2,22100706,1/23/2022,1610612751,Brooklyn Nets,0,0,1610612750,Minnesota Timberwolves,1,1,33,24,57,15,23,38,48,47,95,14,1,15,20,28,27,11,19,102,125
2020,2,22000447,2/18/2021,1610612748,Miami Heat,0,1,1610612758,Sacramento Kings,1,0,37,24,61,12,22,34,49,46,95,8,2,10,14,34,36,7,16,100,118
2020,2,22000447,2/18/2021,1610612758,Sacramento Kings,1,0,1610612748,Miami Heat,0,1,28,24,52,15,26,41,43,50,93,9,7,16,16,38,29,8,16,99,110
2021,2,22101030,3/15/2022,1610612753,Orlando Magic,1,0,1610612751,Brooklyn Nets,0,1,21,33,54,15,26,41,36,59,95,21,6,27,17,44,25,9,12,106,108
2017,2,21700475,12/22/2017,1610612745,Houston Rockets,1,0,1610612746,LA Clippers,0,1,19,19,38,17,23,40,36,42,78,29,6,35,14,31,16,8,18,99,118
2017,2,21700475,12/22/2017,1610612746,LA Clippers,0,1,1610612745,Houston Rockets,1,0,25,24,49,18,24,42,43,48,91,24,7,31,14,35,24,4,8,98,128
2019,2,21900209,11/20/2019,1610612741,Chicago Bulls,1,1,1610612765,Detroit Pistons,0,0,25,39,64,14,13,27,39,52,91,17,9,26,18,37,25,6,15,99,109
2019,2,21900209,11/20/2019,1610612765,Detroit Pistons,0,0,1610612741,Chicago Bulls,1,1,20,30,50,8,25,33,28,55,83,25,7,32,14,45,23,9,17,98,89
2014,2,21400127,11/14/2014,1610612755,Philadelphia 76ers,0,0,1610612745,Houston Rockets,1,1,27,32,59,7,14,21,34,46,80,12,6,18,16,34,19,17,26,98,87
2016,2,21600015,10/27/2016,1610612738,Boston Celtics,0,0,1610612741,Chicago Bulls,1,1,30,23,53,8,15,23,38,38,76,15,9,24,3,40,22,5,12,96,99
2016,2,21600015,10/27/2016,1610612741,Chicago Bulls,1,1,1610612738,Boston Celtics,0,0,25,42,67,11,14,25,36,56,92,22,8,30,22,37,25,6,12,96,105
2022,2,22200034,10/22/2022,1610612742,Dallas Mavericks,1,1,1610612763,Memphis Grizzlies,0,0,28,23,51,17,22,39,45,45,90,30,6,36,21,27,23,4,15,99,137
2022,2,22201163,4/2/2023,1610612761,Toronto Raptors,0,1,1610612766,Charlotte Hornets,1,0,48,28,76,8,20,28,56,48,104,8,0,8,20,28,38,3,8,96,128
2022,2,22200913,2/26/2023,1610612747,Los Angeles Lakers,0,1,1610612742,Dallas Mavericks,1,0,36,27,63,6,28,34,42,55,97,21,7,28,20,38,25,5,11,99,111
2022,2,22200034,10/22/2022,1610612763,Memphis Grizzlies,0,0,1610612742,Dallas Mavericks,1,1,25,21,46,9,24,33,34,45,79,19,5,24,10,39,20,7,18,99,96
2021,2,22100705,1/23/2022,1610612742,Dallas Mavericks,1,1,1610612763,Memphis Grizzlies,0,0,27,17,44,9,21,30,36,38,74,23,8,31,11,31,22,10,18,96,104
2021,2,22100705,1/23/2022,1610612763,Memphis Grizzlies,0,0,1610612742,Dallas Mavericks,1,1,33,42,75,4,20,24,37,62,99,13,6,19,27,38,20,10,15,96,91
2022,2,22200719,1/24/2023,1610612747,Los Angeles Lakers,1,0,1610612746,LA Clippers,0,1,26,29,55,16,24,40,42,53,95,15,9,24,17,41,21,4,7,96,115
2021,2,22101029,3/15/2022,1610612754,Indiana Pacers,1,0,1610612763,Memphis Grizzlies,0,1,35,33,68,6,24,30,41,57,98,14,5,19,23,35,23,11,19,103,102
2021,2,22101029,3/15/2022,1610612763,Memphis Grizzlies,0,1,1610612754,Indiana Pacers,1,0,39,26,65,15,25,40,54,51,105,12,8,20,20,37,38,4,10,103,135
2022,2,22200704,1/22/2023,1610612751,Brooklyn Nets,0,1,1610612744,Golden State Warriors,1,0,29,23,52,14,13,27,43,36,79,20,11,31,10,33,30,10,16,99,120
2022,2,22200717,1/24/2023,1610612742,Dallas Mavericks,1,0,1610612764,Washington Wizards,0,1,37,22,59,10,20,30,47,42,89,22,4,26,9,36,24,7,9,102,126
2023,2,22300134,11/4/2023,1610612753,Orlando Magic,1,1,1610612747,Los Angeles Lakers,0,0,34,34,68,12,21,33,46,55,101,16,3,19,26,32,29,6,16,96,120
2023,2,22300307,12/12/2023,1610612741,Chicago Bulls,1,0,1610612743,Denver Nuggets,0,1,23,23,46,13,27,40,36,50,86,21,2,23,19,32,26,4,14,93,106
2022,2,22200035,10/22/2022,1610612743,Denver Nuggets,1,1,1610612760,Oklahoma City Thunder,0,0,22,25,47,20,18,38,42,43,85,18,13,31,14,39,33,10,18,103,122
2022,2,22200035,10/22/2022,1610612760,Oklahoma City Thunder,0,0,1610612743,Denver Nuggets,1,1,27,29,56,15,23,38,42,52,94,18,5,23,15,41,29,5,13,104,117
2020,2,22000446,2/18/2021,1610612747,Los Angeles Lakers,1,0,1610612751,Brooklyn Nets,0,1,32,21,53,8,22,30,40,43,83,10,4,14,11,35,21,9,16,92,98
2020,2,22000446,2/18/2021,1610612751,Brooklyn Nets,0,1,1610612747,Los Angeles Lakers,1,0,20,18,38,18,21,39,38,39,77,15,9,24,10,32,23,7,14,93,109
2021,2,22101028,3/14/2022,1610612747,Los Angeles Lakers,1,0,1610612761,Toronto Raptors,0,1,21,24,45,13,29,42,34,53,87,22,7,29,10,47,20,8,13,102,103
2022,2,22200719,1/24/2023,1610612746,LA Clippers,0,1,1610612747,Los Angeles Lakers,1,0,32,14,46,19,19,38,51,33,84,12,3,15,10,25,25,8,15,97,133
2021,2,22101028,3/14/2022,1610612761,Toronto Raptors,0,1,1610612747,Los Angeles Lakers,1,0,29,30,59,10,27,37,39,57,96,26,10,36,23,39,24,7,13,103,114
2016,2,21600364,12/12/2016,1610612745,Houston Rockets,1,1,1610612751,Brooklyn Nets,0,0,25,23,48,17,26,43,42,49,91,21,15,36,16,39,23,9,14,108,122
2016,2,21600364,12/12/2016,1610612751,Brooklyn Nets,0,0,1610612745,Houston Rockets,1,1,35,25,60,7,13,20,42,38,80,27,9,36,9,34,21,10,20,107,118
2023,2,22300092,10/28/2023,1610612761,Toronto Raptors,1,0,1610612755,Philadelphia 76ers,0,1,21,34,55,17,15,32,38,49,87,14,5,19,17,33,28,8,13,92,107
2020,2,22000742,4/2/2021,1610612737,Atlanta Hawks,0,1,1610612740,New Orleans Pelicans,1,0,36,22,58,13,16,29,49,38,87,15,6,21,9,31,25,7,15,103,126
2020,2,22000742,4/2/2021,1610612740,New Orleans Pelicans,1,0,1610612737,Atlanta Hawks,0,1,30,29,59,8,21,29,38,50,88,19,4,23,11,41,22,10,15,103,103
2021,2,22100704,1/23/2022,1610612755,Philadelphia 76ers,0,1,1610612759,San Antonio Spurs,1,0,37,39,76,7,9,16,44,48,92,20,3,23,17,33,22,4,10,96,115
2021,2,22100704,1/23/2022,1610612759,San Antonio Spurs,1,0,1610612755,Philadelphia 76ers,0,1,32,27,59,10,20,30,42,47,89,15,7,22,15,35,30,5,9,96,109
2020,2,22000445,2/18/2021,1610612749,Milwaukee Bucks,1,0,1610612761,Toronto Raptors,0,1,25,29,54,10,24,34,35,53,88,16,7,23,19,37,23,6,15,95,96
2020,2,22000445,2/18/2021,1610612761,Toronto Raptors,0,1,1610612749,Milwaukee Bucks,1,0,26,17,43,12,23,35,38,40,78,22,1,23,3,38,26,6,9,94,110
2020,2,22000741,4/2/2021,1610612750,Minnesota Timberwolves,0,0,1610612763,Memphis Grizzlies,1,1,26,26,52,12,21,33,38,47,85,20,3,23,8,40,21,8,11,98,108
2020,2,22000741,4/2/2021,1610612763,Memphis Grizzlies,1,1,1610612750,Minnesota Timberwolves,0,0,23,33,56,19,20,39,42,53,95,17,8,25,21,35,26,6,12,99,120
2017,2,21700474,12/22/2017,1610612742,Dallas Mavericks,0,0,1610612748,Miami Heat,1,1,21,19,40,17,18,35,38,37,75,8,3,11,4,34,28,3,8,84,101
2022,2,22200036,10/22/2022,1610612746,LA Clippers,0,1,1610612758,Sacramento Kings,1,0,32,27,59,9,13,22,41,40,81,20,2,22,8,34,24,5,13,99,111
2017,2,21700474,12/22/2017,1610612748,Miami Heat,1,1,1610612742,Dallas Mavericks,0,0,30,17,47,16,9,25,46,26,72,5,1,6,3,23,25,5,12,85,113
2022,2,22200036,10/22/2022,1610612758,Sacramento Kings,1,0,1610612746,LA Clippers,0,1,26,24,50,14,21,35,40,45,85,15,11,26,10,38,24,8,12,100,109
2016,2,21600892,2/28/2017,1610612756,Phoenix Suns,0,0,1610612763,Memphis Grizzlies,1,1,36,26,62,7,14,21,43,40,83,19,5,24,12,28,22,6,13,95,112
2016,2,21600892,2/28/2017,1610612763,Memphis Grizzlies,1,1,1610612756,Phoenix Suns,0,0,36,25,61,12,13,25,48,38,86,22,7,29,15,25,24,6,10,96,130
2016,2,21600363,12/12/2016,1610612748,Miami Heat,1,1,1610612764,Washington Wizards,0,0,36,26,62,9,17,26,45,43,88,13,6,19,16,29,25,8,15,96,112
2016,2,21600363,12/12/2016,1610612764,Washington Wizards,0,0,1610612748,Miami Heat,1,1,34,27,61,5,18,23,39,45,84,18,4,22,11,37,17,6,15,96,101
2014,2,21400126,11/14/2014,1610612752,New York Knicks,1,0,1610612762,Utah Jazz,0,1,34,40,74,5,3,8,39,43,82,17,3,20,11,33,15,6,8,89,100
2021,2,22101027,3/14/2022,1610612749,Milwaukee Bucks,0,1,1610612762,Utah Jazz,1,0,28,27,55,12,19,31,40,46,86,25,4,29,12,36,21,7,14,100,117
2021,2,22101027,3/14/2022,1610612762,Utah Jazz,1,0,1610612749,Milwaukee Bucks,0,1,20,25,45,17,31,48,37,56,93,20,4,24,18,40,21,10,14,101,111
2019,2,21900208,11/20/2019,1610612742,Dallas Mavericks,1,1,1610612744,Golden State Warriors,0,0,29,23,52,22,16,38,51,39,90,18,5,23,13,28,33,7,12,98,142
2019,2,21900208,11/20/2019,1610612744,Golden State Warriors,0,0,1610612742,Dallas Mavericks,1,1,27,36,63,8,19,27,35,55,90,16,9,25,13,47,18,7,10,100,94
2021,2,22100703,1/23/2022,1610612737,Atlanta Hawks,0,1,1610612766,Charlotte Hornets,1,0,25,24,49,15,24,39,40,48,88,18,6,24,7,43,25,6,10,99,113
2021,2,22100703,1/23/2022,1610612766,Charlotte Hornets,1,0,1610612737,Atlanta Hawks,0,1,30,21,51,4,32,36,34,53,87,19,8,27,16,41,23,12,16,101,91
2020,2,22000444,2/17/2021,1610612746,LA Clippers,1,0,1610612762,Utah Jazz,0,1,29,31,60,9,17,26,38,48,86,11,6,17,12,38,18,12,17,102,96
2017,2,21700473,12/22/2017,1610612751,Brooklyn Nets,1,1,1610612764,Washington Wizards,0,0,30,17,47,14,27,41,44,44,88,17,4,21,18,28,29,7,18,96,119
2017,2,21700473,12/22/2017,1610612764,Washington Wizards,0,0,1610612751,Brooklyn Nets,1,1,29,44,73,5,15,20,34,59,93,11,4,15,12,49,22,4,7,96,84
2022,2,22200797,2/4/2023,1610612749,Milwaukee Bucks,1,1,1610612748,Miami Heat,0,0,32,16,48,14,26,40,46,42,88,17,11,28,12,34,23,9,12,101,123
2022,2,22200037,10/23/2022,1610612747,Los Angeles Lakers,1,0,1610612757,Portland Trail Blazers,0,1,35,24,59,6,27,33,41,51,92,16,4,20,12,41,26,6,13,101,104
2022,2,22200942,3/2/2023,1610612764,Washington Wizards,1,1,1610612761,Toronto Raptors,0,0,29,25,54,14,16,30,43,41,84,19,5,24,10,35,30,8,15,100,119
2022,2,22200718,1/24/2023,1610612756,Phoenix Suns,1,1,1610612766,Charlotte Hornets,0,0,25,30,55,22,17,39,47,47,94,12,1,13,17,30,38,10,18,102,128
2022,2,22200816,2/7/2023,1610612753,Orlando Magic,1,0,1610612752,New York Knicks,0,1,31,23,54,6,19,25,37,42,79,18,6,24,11,34,23,6,11,88,98
2022,2,22200792,2/3/2023,1610612737,Atlanta Hawks,0,1,1610612762,Utah Jazz,1,0,34,24,58,10,27,37,44,51,95,17,6,23,15,40,28,4,9,98,115
2022,2,22200037,10/23/2022,1610612757,Portland Trail Blazers,0,1,1610612747,Los Angeles Lakers,1,0,27,30,57,10,17,27,37,47,84,22,5,27,16,33,19,9,19,99,106
2023,2,22300400,12/23/2023,1610612758,Sacramento Kings,1,0,1610612750,Minnesota Timberwolves,0,1,29,23,52,8,25,33,37,48,85,16,5,21,9,42,23,9,11,96,98
2020,2,22000444,2/17/2021,1610612762,Utah Jazz,0,1,1610612746,LA Clippers,1,0,29,29,58,13,27,40,42,56,98,17,3,20,18,39,19,5,13,101,114
2022,2,22200038,10/23/2022,1610612737,Atlanta Hawks,1,0,1610612766,Charlotte Hornets,0,1,31,29,60,8,27,35,39,56,95,23,5,28,20,40,23,7,12,102,109
2017,2,21700472,12/22/2017,1610612740,New Orleans Pelicans,0,1,1610612753,Orlando Magic,1,0,33,23,56,10,20,30,43,43,86,15,9,24,11,33,23,7,15,103,111
2021,2,22101026,3/14/2022,1610612741,Chicago Bulls,0,0,1610612758,Sacramento Kings,1,1,26,28,54,10,24,34,36,52,88,21,1,22,14,38,22,10,15,100,103
2017,2,21700472,12/22/2017,1610612753,Orlando Magic,1,0,1610612740,New Orleans Pelicans,0,1,32,33,65,4,16,20,36,49,85,21,8,29,13,41,16,10,14,103,97
2016,2,21600891,2/28/2017,1610612741,Chicago Bulls,1,0,1610612743,Denver Nuggets,0,1,34,36,70,10,16,26,44,52,96,9,1,10,14,39,26,6,12,98,107
2021,2,22101026,3/14/2022,1610612758,Sacramento Kings,1,1,1610612741,Chicago Bulls,0,0,29,28,57,10,15,25,39,43,82,24,2,26,12,32,25,5,16,100,112
2022,2,22200038,10/23/2022,1610612766,Charlotte Hornets,0,1,1610612737,Atlanta Hawks,1,0,36,28,64,11,15,26,47,43,90,21,9,30,17,30,28,8,14,101,126
2022,2,22200717,1/24/2023,1610612764,Washington Wizards,0,1,1610612742,Dallas Mavericks,1,0,31,22,53,11,19,30,42,41,83,32,9,41,12,32,28,6,11,102,127
2023,2,22300247,11/26/2023,1610612756,Phoenix Suns,0,1,1610612752,New York Knicks,1,0,26,27,53,16,22,38,42,49,91,16,5,21,25,26,27,7,13,90,116
2023,2,22300133,11/4/2023,1610612766,Charlotte Hornets,0,1,1610612754,Indiana Pacers,1,0,39,29,68,8,12,20,47,41,88,23,0,23,14,27,23,7,13,98,125
2023,2,22300400,12/23/2023,1610612750,Minnesota Timberwolves,0,1,1610612758,Sacramento Kings,1,0,34,20,54,10,23,33,44,43,87,12,2,14,9,36,31,10,12,96,110
2023,2,22300033,11/17/2023,1610612753,Orlando Magic,0,1,1610612741,Chicago Bulls,1,0,27,18,45,11,23,34,38,41,79,16,7,23,13,33,24,10,19,94,103
2021,2,22101025,3/14/2022,1610612744,Golden State Warriors,1,1,1610612764,Washington Wizards,0,0,27,12,39,18,27,45,45,39,84,18,4,22,8,33,26,7,13,100,126
2021,2,22101025,3/14/2022,1610612764,Washington Wizards,0,0,1610612744,Golden State Warriors,1,1,32,24,56,10,16,26,42,40,82,18,5,23,5,39,28,7,12,99,112
2022,2,22200695,1/21/2023,1610612739,Cleveland Cavaliers,1,1,1610612749,Milwaukee Bucks,0,0,41,23,64,7,15,22,48,38,86,11,6,17,11,30,33,3,9,93,114
2022,2,22200039,10/23/2022,1610612739,Cleveland Cavaliers,1,1,1610612764,Washington Wizards,0,0,28,35,63,13,20,33,41,55,96,22,3,25,19,37,19,9,13,102,117
2020,2,22000740,4/2/2021,1610612754,Indiana Pacers,1,0,1610612766,Charlotte Hornets,0,1,28,21,49,10,23,33,38,44,82,11,8,19,9,37,29,16,20,102,97
2022,2,22200716,1/24/2023,1610612743,Denver Nuggets,0,1,1610612740,New Orleans Pelicans,1,0,28,19,47,11,22,33,39,41,80,10,3,13,8,34,27,5,12,91,99
2022,2,22200718,1/24/2023,1610612766,Charlotte Hornets,0,0,1610612756,Phoenix Suns,1,1,33,38,71,6,19,25,39,57,96,13,5,18,15,45,19,3,14,101,97
2022,2,22200039,10/23/2022,1610612764,Washington Wizards,0,0,1610612739,Cleveland Cavaliers,1,1,31,28,59,12,16,28,43,44,87,9,6,15,14,35,25,10,20,101,107
2023,2,22300092,10/28/2023,1610612755,Philadelphia 76ers,0,1,1610612761,Toronto Raptors,1,0,33,25,58,10,18,28,43,43,86,18,3,21,15,30,25,5,11,93,114
2021,2,22100702,1/23/2022,1610612757,Portland Trail Blazers,0,1,1610612761,Toronto Raptors,1,0,27,26,53,18,14,32,45,40,85,6,7,13,14,30,31,15,22,99,114
2021,2,22100702,1/23/2022,1610612761,Toronto Raptors,1,0,1610612757,Portland Trail Blazers,0,1,21,23,44,18,36,54,39,59,98,9,5,14,22,39,28,8,16,100,105
2021,2,22101024,3/14/2022,1610612750,Minnesota Timberwolves,0,1,1610612759,San Antonio Spurs,1,0,35,22,57,17,16,33,52,38,90,28,4,32,11,28,28,5,16,110,149
2021,2,22101024,3/14/2022,1610612759,San Antonio Spurs,1,0,1610612750,Minnesota Timberwolves,0,1,39,23,62,13,22,35,52,45,97,22,4,26,13,33,33,8,15,111,139
2014,2,21400126,11/14/2014,1610612762,Utah Jazz,0,1,1610612752,New York Knicks,1,0,26,22,48,10,12,22,36,34,70,20,5,25,12,25,25,12,19,89,102
2016,2,21600891,2/28/2017,1610612743,Denver Nuggets,0,1,1610612741,Chicago Bulls,1,0,32,18,50,13,17,30,45,35,80,22,2,24,8,28,26,10,16,99,125
2022,2,22200693,1/21/2023,1610612753,Orlando Magic,0,0,1610612764,Washington Wizards,1,1,28,28,56,14,20,34,42,48,90,20,4,24,12,38,24,6,11,102,118
2022,2,22200977,3/6/2023,1610612757,Portland Trail Blazers,0,1,1610612765,Detroit Pistons,1,0,23,22,45,15,18,33,38,40,78,19,6,25,6,38,28,9,11,95,110
2022,2,22200040,10/23/2022,1610612740,New Orleans Pelicans,1,0,1610612762,Utah Jazz,0,1,40,35,75,8,19,27,48,54,102,17,5,22,21,34,30,13,17,110,121
2022,2,22200040,10/23/2022,1610612762,Utah Jazz,0,1,1610612740,New Orleans Pelicans,1,0,30,30,60,13,25,38,43,55,98,23,5,28,19,37,29,8,17,110,122
2023,2,22300253,11/27/2023,1610612764,Washington Wizards,0,1,1610612765,Detroit Pistons,1,0,35,25,60,10,19,29,45,44,89,26,2,28,9,37,29,7,16,107,126
2021,2,22100701,1/23/2022,1610612741,Chicago Bulls,0,0,1610612753,Orlando Magic,1,1,28,27,55,5,16,21,33,43,76,24,8,32,14,33,10,7,22,100,95
2021,2,22100701,1/23/2022,1610612753,Orlando Magic,1,1,1610612741,Chicago Bulls,0,0,30,24,54,12,14,26,42,38,80,18,5,23,6,34,31,3,14,101,114
2017,2,21700471,12/22/2017,1610612752,New York Knicks,0,0,1610612765,Detroit Pistons,1,1,36,37,73,8,16,24,44,53,97,5,1,6,22,31,25,8,15,97,101
2017,2,21700471,12/22/2017,1610612765,Detroit Pistons,1,1,1610612752,New York Knicks,0,0,28,35,63,10,15,25,38,50,88,18,7,25,17,38,19,6,12,95,104
2021,2,22101023,3/14/2022,1610612760,Oklahoma City Thunder,1,0,1610612766,Charlotte Hornets,0,1,26,20,46,16,28,44,42,48,90,16,3,19,18,31,31,12,18,99,116
2021,2,22101023,3/14/2022,1610612766,Charlotte Hornets,0,1,1610612760,Oklahoma City Thunder,1,0,29,27,56,20,15,35,49,42,91,16,5,21,8,36,33,4,6,97,134
2020,2,22000740,4/2/2021,1610612766,Charlotte Hornets,0,1,1610612754,Indiana Pacers,1,0,35,29,64,8,23,31,43,52,95,20,9,29,15,43,27,7,10,102,114
2014,2,21400491,1/2/2015,1610612755,Philadelphia 76ers,0,0,1610612756,Phoenix Suns,1,1,30,31,61,7,19,26,37,50,87,15,10,25,19,36,20,9,16,96,96
2014,2,21400491,1/2/2015,1610612756,Phoenix Suns,1,1,1610612755,Philadelphia 76ers,0,0,28,24,52,14,18,32,42,42,84,14,2,16,16,27,24,12,19,95,112
2021,2,22100700,1/23/2022,1610612747,Los Angeles Lakers,0,0,1610612748,Miami Heat,1,1,25,14,39,11,29,40,36,43,79,24,6,30,12,34,20,9,18,96,107
2021,2,22100700,1/23/2022,1610612748,Miami Heat,1,1,1610612747,Los Angeles Lakers,0,0,25,23,48,15,18,33,40,41,81,18,2,20,9,34,31,7,16,97,113
2017,2,21700470,12/21/2017,1610612759,San Antonio Spurs,0,0,1610612762,Utah Jazz,1,1,24,33,57,10,11,21,34,44,78,11,5,16,6,39,14,7,14,93,89
2017,2,21700470,12/21/2017,1610612762,Utah Jazz,1,1,1610612759,San Antonio Spurs,0,0,22,26,48,12,14,26,34,40,74,20,4,24,9,34,18,7,15,92,100
2022,2,22200041,10/23/2022,1610612750,Minnesota Timberwolves,0,1,1610612760,Oklahoma City Thunder,1,0,36,18,54,10,24,34,46,42,88,14,8,22,15,32,24,7,15,99,116
2021,2,22101022,3/14/2022,1610612743,Denver Nuggets,0,1,1610612755,Philadelphia 76ers,1,0,31,18,49,13,20,33,44,38,82,13,7,20,6,37,29,8,14,99,114
2021,2,22101022,3/14/2022,1610612755,Philadelphia 76ers,1,0,1610612743,Denver Nuggets,0,1,24,27,51,12,21,33,36,48,84,26,6,32,13,36,25,8,13,99,110
2022,2,22200041,10/23/2022,1610612760,Oklahoma City Thunder,1,0,1610612750,Minnesota Timberwolves,0,1,32,21,53,9,32,41,41,53,94,15,6,21,15,42,24,9,11,99,106
2022,2,22200792,2/3/2023,1610612762,Utah Jazz,1,0,1610612737,Atlanta Hawks,0,1,28,19,47,13,31,44,41,50,91,13,5,18,15,39,20,8,15,99,108
2021,2,22100699,1/23/2022,1610612738,Boston Celtics,0,1,1610612764,Washington Wizards,1,0,21,30,51,19,20,39,40,50,90,17,4,21,16,35,26,8,13,96,116
2021,2,22100699,1/23/2022,1610612764,Washington Wizards,1,0,1610612738,Boston Celtics,0,1,25,34,59,8,26,34,33,60,93,13,3,16,11,50,20,5,7,96,87
2020,2,22000443,2/17/2021,1610612744,Golden State Warriors,1,1,1610612748,Miami Heat,0,0,25,18,43,18,34,52,43,52,95,16,5,21,13,43,32,8,16,109,120
2022,2,22200911,2/26/2023,1610612737,Atlanta Hawks,1,1,1610612751,Brooklyn Nets,0,0,29,31,60,16,14,30,45,45,90,23,5,28,16,32,20,12,16,103,129
2022,2,22200942,3/2/2023,1610612761,Toronto Raptors,0,0,1610612764,Washington Wizards,1,1,32,27,59,9,24,33,41,51,92,17,0,17,15,36,28,5,14,101,108
2020,2,22000443,2/17/2021,1610612748,Miami Heat,0,0,1610612744,Golden State Warriors,1,1,31,30,61,13,23,36,44,53,97,11,1,12,11,42,28,10,18,109,112
2016,2,21600890,2/28/2017,1610612757,Portland Trail Blazers,0,0,1610612765,Detroit Pistons,1,1,34,25,59,10,15,25,44,40,84,15,7,22,12,32,25,13,24,106,113
2016,2,21600890,2/28/2017,1610612765,Detroit Pistons,1,1,1610612757,Portland Trail Blazers,0,0,38,41,79,7,18,25,45,59,104,23,8,31,20,44,23,5,8,106,120
2016,2,21600362,12/12/2016,1610612749,Milwaukee Bucks,0,0,1610612761,Toronto Raptors,1,1,38,27,65,4,20,24,42,47,89,12,5,17,15,34,27,7,11,93,100
2022,2,22200042,10/23/2022,1610612744,Golden State Warriors,1,1,1610612758,Sacramento Kings,0,0,31,23,54,14,19,33,45,42,87,26,10,36,9,38,24,10,13,109,130
2022,2,22200042,10/23/2022,1610612758,Sacramento Kings,0,0,1610612744,Golden State Warriors,1,1,36,21,57,11,32,43,47,53,100,20,5,25,18,35,31,7,16,111,125
2016,2,21600362,12/12/2016,1610612761,Toronto Raptors,1,1,1610612749,Milwaukee Bucks,0,0,28,28,56,14,11,25,42,39,81,24,4,28,15,26,26,8,14,93,122
2023,2,22300135,11/4/2023,1610612740,New Orleans Pelicans,1,0,1610612737,Atlanta Hawks,0,1,32,21,53,8,23,31,40,44,84,17,4,21,11,34,24,4,11,93,105
2021,2,22100698,1/23/2022,1610612746,LA Clippers,0,0,1610612752,New York Knicks,1,1,20,18,38,14,27,41,34,45,79,20,10,30,10,39,20,6,12,94,102
2017,2,21700469,12/21/2017,1610612756,Phoenix Suns,1,1,1610612763,Memphis Grizzlies,0,0,23,32,55,10,16,26,33,48,81,21,6,27,15,36,21,5,10,87,97
2021,2,22101021,3/14/2022,1610612737,Atlanta Hawks,1,1,1610612757,Portland Trail Blazers,0,0,28,33,61,12,36,48,40,69,109,30,2,32,24,46,28,4,4,104,122
2021,2,22101021,3/14/2022,1610612757,Portland Trail Blazers,0,0,1610612737,Atlanta Hawks,1,1,34,30,64,10,14,24,44,44,88,15,6,21,14,34,25,13,21,105,113
2017,2,21700469,12/21/2017,1610612763,Memphis Grizzlies,0,0,1610612756,Phoenix Suns,1,1,34,30,64,5,21,26,39,51,90,12,4,16,21,34,15,4,10,89,95
2022,2,22200043,10/23/2022,1610612746,LA Clippers,1,0,1610612756,Phoenix Suns,0,1,27,23,50,9,23,32,36,46,82,14,6,20,10,39,16,5,15,96,95
2022,2,22200972,3/6/2023,1610612754,Indiana Pacers,1,0,1610612755,Philadelphia 76ers,0,1,38,15,53,15,22,37,53,37,90,22,9,31,9,33,28,6,9,104,143
2022,2,22200043,10/23/2022,1610612756,Phoenix Suns,0,1,1610612746,LA Clippers,1,0,28,23,51,15,27,42,43,50,93,11,1,12,16,35,29,10,13,96,112
2023,2,22300091,10/28/2023,1610612739,Cleveland Cavaliers,1,0,1610612754,Indiana Pacers,0,1,31,37,68,12,19,31,43,56,99,15,9,24,21,38,29,3,7,98,113
2023,2,22300091,10/28/2023,1610612754,Indiana Pacers,0,1,1610612739,Cleveland Cavaliers,1,0,33,27,60,15,23,38,48,50,98,14,3,17,15,36,36,2,8,98,125
2021,2,22100698,1/23/2022,1610612752,New York Knicks,1,1,1610612746,LA Clippers,0,0,23,32,55,16,20,36,39,52,91,16,3,19,19,35,26,7,13,95,110
2022,2,22200044,10/24/2022,1610612754,Indiana Pacers,0,0,1610612755,Philadelphia 76ers,1,1,26,20,46,12,32,44,38,52,90,18,5,23,21,34,27,8,13,94,106
2022,2,22200044,10/24/2022,1610612755,Philadelphia 76ers,1,1,1610612754,Indiana Pacers,0,0,19,18,37,19,24,43,38,42,80,25,3,28,9,35,25,3,8,92,120
2020,2,22000739,4/2/2021,1610612742,Dallas Mavericks,0,1,1610612752,New York Knicks,1,0,29,22,51,12,25,37,41,47,88,5,5,10,11,40,19,7,10,93,99
2020,2,22000739,4/2/2021,1610612752,New York Knicks,1,0,1610612742,Dallas Mavericks,0,1,20,31,51,12,26,38,32,57,89,10,0,10,12,45,18,6,12,93,86
2017,2,21700468,12/21/2017,1610612738,Boston Celtics,0,0,1610612752,New York Knicks,1,1,20,28,48,13,25,38,33,53,86,14,5,19,14,40,17,8,10,92,93
2017,2,21700468,12/21/2017,1610612752,New York Knicks,1,1,1610612738,Boston Celtics,0,0,28,37,65,8,6,14,36,43,79,22,4,26,17,27,13,11,17,92,102
2022,2,22200943,3/2/2023,1610612742,Dallas Mavericks,1,1,1610612755,Philadelphia 76ers,0,0,20,14,34,25,23,48,45,37,82,18,9,27,9,35,26,9,13,99,133
2021,2,22101020,3/14/2022,1610612739,Cleveland Cavaliers,1,1,1610612746,LA Clippers,0,0,26,30,56,15,15,30,41,45,86,23,9,32,17,32,28,5,12,98,120
2021,2,22101020,3/14/2022,1610612746,LA Clippers,0,0,1610612739,Cleveland Cavaliers,1,1,31,31,62,12,24,36,43,55,98,13,4,17,19,39,29,7,11,99,111
2022,2,22200048,10/24/2022,1610612745,Houston Rockets,1,1,1610612762,Utah Jazz,0,0,27,28,55,11,24,35,38,52,90,27,5,32,23,32,17,8,16,99,114
2023,2,22300326,12/15/2023,1610612766,Charlotte Hornets,1,0,1610612740,New Orleans Pelicans,0,1,32,29,61,9,22,31,41,51,92,16,5,21,11,42,18,4,8,98,107
2020,2,22000442,4/21/2021,1610612742,Dallas Mavericks,1,1,1610612765,Detroit Pistons,0,0,30,19,49,16,27,43,46,46,92,19,7,26,15,36,25,2,6,95,127
2020,2,22000442,4/21/2021,1610612765,Detroit Pistons,0,0,1610612742,Dallas Mavericks,1,1,27,20,47,13,19,32,40,39,79,24,7,31,12,32,30,8,14,95,117
2022,2,22200048,10/24/2022,1610612762,Utah Jazz,0,0,1610612745,Houston Rockets,1,1,33,28,61,11,21,32,44,49,93,9,7,16,22,32,23,7,20,99,108
2022,2,22200911,2/26/2023,1610612751,Brooklyn Nets,0,0,1610612737,Atlanta Hawks,1,1,29,19,48,14,25,39,43,44,87,27,2,29,9,35,20,7,10,103,127
2017,2,21700467,12/21/2017,1610612755,Philadelphia 76ers,1,0,1610612761,Toronto Raptors,0,1,36,21,57,9,20,29,45,41,86,10,4,14,17,26,27,14,24,100,109
2017,2,21700467,12/21/2017,1610612761,Toronto Raptors,0,1,1610612755,Philadelphia 76ers,1,0,23,27,50,12,23,35,35,50,85,32,3,35,25,27,18,14,22,99,114
2022,2,22200695,1/21/2023,1610612749,Milwaukee Bucks,0,0,1610612739,Cleveland Cavaliers,1,1,25,22,47,14,25,39,39,47,86,10,1,11,14,33,24,9,16,93,102
2022,2,22200855,2/12/2023,1610612738,Boston Celtics,1,1,1610612763,Memphis Grizzlies,0,0,18,19,37,21,30,51,39,49,88,20,6,26,17,35,28,4,11,95,119
2021,2,22100697,1/22/2022,1610612754,Indiana Pacers,0,0,1610612756,Phoenix Suns,1,1,27,28,55,10,19,29,37,47,84,19,8,27,16,37,19,11,18,96,103
2022,2,22200046,10/24/2022,1610612752,New York Knicks,1,1,1610612753,Orlando Magic,0,0,32,24,56,11,26,37,43,50,93,18,7,25,23,31,24,6,14,97,115
2022,2,22200716,1/24/2023,1610612740,New Orleans Pelicans,1,0,1610612743,Denver Nuggets,0,1,33,26,59,5,21,26,38,47,85,17,3,20,19,29,18,8,16,91,98
2022,2,22200046,10/24/2022,1610612753,Orlando Magic,0,0,1610612752,New York Knicks,1,1,29,22,51,7,28,35,36,50,86,23,4,27,15,36,14,7,13,97,102
2022,2,22200943,3/2/2023,1610612755,Philadelphia 76ers,0,0,1610612742,Dallas Mavericks,1,1,33,18,51,12,15,27,45,33,78,24,5,29,6,29,28,8,14,98,126
2022,2,22200856,2/12/2023,1610612761,Toronto Raptors,1,1,1610612765,Detroit Pistons,0,0,31,26,57,11,19,30,42,45,87,24,12,36,17,29,21,3,8,97,119
2023,2,22300133,11/4/2023,1610612754,Indiana Pacers,1,0,1610612766,Charlotte Hornets,0,1,23,25,48,22,23,45,45,48,93,12,4,16,19,31,31,5,15,98,124
2017,2,21700466,12/21/2017,1610612739,Cleveland Cavaliers,1,1,1610612741,Chicago Bulls,0,0,30,23,53,12,17,29,42,40,82,19,3,22,9,33,25,8,12,95,115
2022,2,22200693,1/21/2023,1610612764,Washington Wizards,1,1,1610612753,Orlando Magic,0,0,33,28,61,18,16,34,51,44,95,18,7,25,14,34,34,3,8,101,138
2017,2,21700466,12/21/2017,1610612741,Chicago Bulls,0,0,1610612739,Cleveland Cavaliers,1,1,35,19,54,12,19,31,47,38,85,6,2,8,8,31,34,10,14,94,112
2022,2,22200855,2/12/2023,1610612763,Memphis Grizzlies,0,0,1610612738,Boston Celtics,1,1,30,20,50,12,22,34,42,42,84,13,8,21,6,40,24,5,8,96,109
2022,2,22200923,2/28/2023,1610612764,Washington Wizards,0,1,1610612737,Atlanta Hawks,1,0,42,34,76,6,15,21,48,49,97,17,3,20,20,30,19,4,9,95,119
2022,2,22200536,12/30/2022,1610612744,Golden State Warriors,1,1,1610612757,Portland Trail Blazers,0,0,25,23,48,17,26,43,42,49,91,17,4,21,19,33,29,2,13,96,118
2022,2,22200536,12/30/2022,1610612757,Portland Trail Blazers,0,0,1610612744,Golden State Warriors,1,1,30,22,52,12,27,39,42,49,91,16,7,23,21,33,22,9,16,96,112
2022,2,22200049,10/24/2022,1610612751,Brooklyn Nets,0,0,1610612763,Memphis Grizzlies,1,1,38,20,58,9,20,29,47,40,87,21,5,26,13,29,27,7,11,97,124
2022,2,22200049,10/24/2022,1610612763,Memphis Grizzlies,1,1,1610612751,Brooklyn Nets,0,0,31,29,60,16,18,34,47,47,94,24,7,31,22,29,21,4,9,95,134
2023,2,22300038,11/21/2023,1610612753,Orlando Magic,1,1,1610612761,Toronto Raptors,0,0,38,31,69,12,19,31,50,50,100,14,6,20,20,35,31,6,13,101,126
2021,2,22100697,1/22/2022,1610612756,Phoenix Suns,1,1,1610612754,Indiana Pacers,0,0,40,31,71,7,18,25,47,49,96,12,2,14,17,33,34,5,11,95,113
2020,2,22000441,2/17/2021,1610612740,New Orleans Pelicans,1,0,1610612757,Portland Trail Blazers,0,1,28,29,57,15,17,32,43,46,89,23,6,29,21,28,25,6,12,94,124
2021,2,22101019,3/13/2022,1610612747,Los Angeles Lakers,0,0,1610612756,Phoenix Suns,1,1,20,21,41,16,24,40,36,45,81,23,8,31,12,37,24,12,19,105,111
2021,2,22101019,3/13/2022,1610612756,Phoenix Suns,1,1,1610612747,Los Angeles Lakers,0,0,46,23,69,12,21,33,58,44,102,12,2,14,14,32,36,4,11,104,140
2022,2,22200047,10/24/2022,1610612738,Boston Celtics,0,0,1610612741,Chicago Bulls,1,1,19,33,52,18,30,48,37,63,100,10,2,12,16,48,26,4,11,104,102
2016,2,21600889,2/28/2017,1610612744,Golden State Warriors,0,0,1610612764,Washington Wizards,1,1,31,24,55,8,21,29,39,45,84,22,5,27,15,33,28,11,19,102,108
2016,2,21600889,2/28/2017,1610612764,Washington Wizards,1,1,1610612744,Golden State Warriors,0,0,29,34,63,12,16,28,41,50,91,18,2,20,19,32,29,10,20,101,112
2017,2,21700465,12/20/2017,1610612746,LA Clippers,1,1,1610612756,Phoenix Suns,0,0,31,26,57,10,20,30,41,46,87,16,8,24,11,39,22,3,9,97,108
2017,2,21700465,12/20/2017,1610612756,Phoenix Suns,0,0,1610612746,LA Clippers,1,1,27,35,62,8,27,35,35,62,97,17,2,19,20,43,22,1,10,97,95
2020,2,22000441,2/17/2021,1610612757,Portland Trail Blazers,0,1,1610612740,New Orleans Pelicans,1,0,28,21,49,18,23,41,46,44,90,16,2,18,12,34,26,5,9,95,126
2022,2,22200818,2/7/2023,1610612740,New Orleans Pelicans,1,1,1610612737,Atlanta Hawks,0,0,33,26,59,12,20,32,45,46,91,14,7,21,16,32,28,4,10,94,116
2022,2,22200047,10/24/2022,1610612741,Chicago Bulls,1,1,1610612738,Boston Celtics,0,0,32,34,66,10,11,21,42,45,87,26,3,29,14,32,29,5,14,102,120
2022,2,22200912,2/26/2023,1610612764,Washington Wizards,0,0,1610612741,Chicago Bulls,1,1,26,22,48,6,22,28,32,44,76,12,11,23,17,34,22,7,17,86,82
2022,2,22200856,2/12/2023,1610612765,Detroit Pistons,0,0,1610612761,Toronto Raptors,1,1,27,18,45,13,21,34,40,39,79,25,7,32,14,28,25,5,18,96,118
2023,2,22300134,11/4/2023,1610612747,Los Angeles Lakers,0,0,1610612753,Orlando Magic,1,1,29,25,54,8,22,30,37,47,84,19,2,21,15,32,17,6,17,96,101
2020,2,22000440,2/17/2021,1610612750,Minnesota Timberwolves,1,0,1610612754,Indiana Pacers,0,1,30,37,67,15,25,40,45,62,107,23,2,25,19,45,37,5,11,111,128
2020,2,22000440,2/17/2021,1610612754,Indiana Pacers,0,1,1610612750,Minnesota Timberwolves,1,0,36,35,71,13,13,26,49,48,97,23,4,27,15,35,31,12,15,110,134
2021,2,22101018,3/13/2022,1610612760,Oklahoma City Thunder,1,0,1610612763,Memphis Grizzlies,0,1,28,28,56,13,28,41,41,56,97,23,5,28,19,38,25,8,11,103,118
2021,2,22101018,3/13/2022,1610612763,Memphis Grizzlies,0,1,1610612760,Oklahoma City Thunder,1,0,37,36,73,11,18,29,48,54,102,18,2,20,24,31,30,7,13,102,125
2022,2,22200050,10/24/2022,1610612750,Minnesota Timberwolves,1,0,1610612759,San Antonio Spurs,0,1,30,25,55,8,23,31,38,48,86,22,2,24,12,38,24,11,16,102,106
2022,2,22200050,10/24/2022,1610612759,San Antonio Spurs,0,1,1610612750,Minnesota Timberwolves,1,0,36,32,68,12,25,37,48,57,105,7,6,13,21,41,37,7,13,102,115
2022,2,22200999,3/10/2023,1610612764,Washington Wizards,1,0,1610612737,Atlanta Hawks,0,1,36,25,61,7,20,27,43,45,88,14,4,18,11,35,27,9,15,101,107
2022,2,22200912,2/26/2023,1610612741,Chicago Bulls,1,1,1610612764,Washington Wizards,0,0,32,17,49,8,22,30,40,39,79,14,3,17,10,31,21,5,10,86,102
2022,2,22200053,10/25/2022,1610612740,New Orleans Pelicans,1,1,1610612742,Dallas Mavericks,0,0,32,17,49,12,15,27,44,32,76,13,5,18,6,28,25,8,14,91,113
2021,2,22100696,1/22/2022,1610612749,Milwaukee Bucks,1,1,1610612758,Sacramento Kings,0,0,24,25,49,21,21,42,45,46,91,22,3,25,10,37,19,4,7,101,133
2021,2,22100696,1/22/2022,1610612758,Sacramento Kings,0,0,1610612749,Milwaukee Bucks,1,1,36,24,60,15,22,37,51,46,97,10,6,16,16,34,29,12,14,101,127
2014,2,21401051,3/23/2015,1610612741,Chicago Bulls,1,1,1610612766,Charlotte Hornets,0,0,34,32,66,3,13,16,37,45,82,21,8,29,9,42,21,2,6,92,98
2014,2,21401051,3/23/2015,1610612766,Charlotte Hornets,0,0,1610612741,Chicago Bulls,1,1,20,41,61,8,12,20,28,53,81,22,6,28,13,41,11,5,11,93,86
2021,2,22101017,3/13/2022,1610612740,New Orleans Pelicans,1,1,1610612745,Houston Rockets,0,0,38,23,61,10,22,32,48,45,93,24,10,34,17,32,30,3,11,101,130
2021,2,22101017,3/13/2022,1610612745,Houston Rockets,0,0,1610612740,New Orleans Pelicans,1,1,27,19,46,12,19,31,39,38,77,15,10,25,10,32,24,17,25,101,105
2022,2,22200796,2/4/2023,1610612741,Chicago Bulls,1,1,1610612757,Portland Trail Blazers,0,0,36,18,54,12,14,26,48,32,80,21,4,25,7,27,32,3,12,97,129
2022,2,22200053,10/25/2022,1610612742,Dallas Mavericks,0,0,1610612740,New Orleans Pelicans,1,1,29,14,43,12,27,39,41,41,82,17,7,24,13,29,18,7,12,93,111
2016,2,21600014,10/27/2016,1610612737,Atlanta Hawks,1,1,1610612764,Washington Wizards,0,0,32,30,62,12,14,26,44,44,88,14,4,18,17,30,28,14,21,102,114
2016,2,21600014,10/27/2016,1610612764,Washington Wizards,0,0,1610612737,Atlanta Hawks,1,1,34,40,74,6,14,20,40,54,94,13,5,18,17,41,25,13,19,102,99
2022,2,22201015,3/12/2023,1610612739,Cleveland Cavaliers,0,1,1610612766,Charlotte Hornets,1,0,34,26,60,7,20,27,41,46,87,25,9,34,13,36,18,8,10,99,114
2020,2,22000738,4/2/2021,1610612738,Boston Celtics,1,1,1610612745,Houston Rockets,0,0,29,18,47,17,24,41,46,42,88,9,3,12,12,32,35,6,15,97,118
2020,2,22000738,4/2/2021,1610612745,Houston Rockets,0,0,1610612738,Boston Celtics,1,1,25,25,50,12,24,36,37,49,86,16,10,26,14,42,26,9,14,98,102
2022,2,22200799,2/4/2023,1610612745,Houston Rockets,0,0,1610612760,Oklahoma City Thunder,1,1,35,24,59,10,20,30,45,44,89,21,6,27,15,33,29,11,16,103,121
2017,2,21700464,12/20/2017,1610612744,Golden State Warriors,1,1,1610612763,Memphis Grizzlies,0,0,27,26,53,7,14,21,34,40,74,22,3,25,14,28,26,10,16,88,97
2020,2,22000439,2/17/2021,1610612745,Houston Rockets,0,0,1610612755,Philadelphia 76ers,1,1,27,18,45,15,32,47,42,50,92,14,4,18,10,43,26,13,19,107,113
2017,2,21700464,12/20/2017,1610612763,Memphis Grizzlies,0,0,1610612744,Golden State Warriors,1,1,16,37,53,12,19,31,28,56,84,16,3,19,23,35,20,9,17,89,84
2022,2,22200051,10/24/2022,1610612743,Denver Nuggets,0,0,1610612757,Portland Trail Blazers,1,1,33,27,60,12,19,31,45,46,91,8,6,14,12,37,28,3,8,94,110
2022,2,22200051,10/24/2022,1610612757,Portland Trail Blazers,1,1,1610612743,Denver Nuggets,0,0,32,16,48,16,19,35,48,35,83,23,8,31,11,29,23,4,10,95,135
2023,2,22300077,10/27/2023,1610612765,Detroit Pistons,0,1,1610612766,Charlotte Hornets,1,0,30,28,58,10,20,30,40,48,88,21,4,25,17,31,28,13,24,107,111
2023,2,22300255,11/27/2023,1610612755,Philadelphia 76ers,1,1,1610612747,Los Angeles Lakers,0,0,25,22,47,22,24,46,47,46,93,22,4,26,17,31,33,3,7,95,138
2022,2,22200800,2/4/2023,1610612742,Dallas Mavericks,0,0,1610612744,Golden State Warriors,1,1,25,20,45,14,26,40,39,46,85,21,6,27,13,36,22,6,14,99,113
2022,2,22200791,2/3/2023,1610612755,Philadelphia 76ers,0,1,1610612759,San Antonio Spurs,1,0,33,27,60,13,14,27,46,41,87,32,9,41,17,28,28,8,11,102,137
2020,2,22000439,2/17/2021,1610612755,Philadelphia 76ers,1,1,1610612745,Houston Rockets,0,0,27,28,55,12,14,26,39,42,81,28,4,32,13,31,23,12,22,107,118
2022,2,22200800,2/4/2023,1610612744,Golden State Warriors,1,1,1610612742,Dallas Mavericks,0,0,31,16,47,14,21,35,45,37,82,15,4,19,6,34,33,9,14,99,119
2022,2,22201074,3/20/2023,1610612745,Houston Rockets,1,0,1610612744,Golden State Warriors,0,1,29,28,57,10,26,36,39,54,93,20,4,24,22,33,14,12,18,101,108
2022,2,22200052,10/25/2022,1610612764,Washington Wizards,1,1,1610612765,Detroit Pistons,0,0,34,18,52,10,23,33,44,41,85,22,4,26,11,32,26,6,12,97,120
2022,2,22200052,10/25/2022,1610612765,Detroit Pistons,0,0,1610612764,Washington Wizards,1,1,28,32,60,8,20,28,36,52,88,19,6,25,14,42,12,7,13,97,99
2021,2,22101015,3/13/2022,1610612753,Orlando Magic,1,0,1610612755,Philadelphia 76ers,0,1,23,25,48,18,25,43,41,50,91,14,6,20,13,39,28,7,12,104,114
2021,2,22101015,3/13/2022,1610612755,Philadelphia 76ers,0,1,1610612753,Orlando Magic,1,0,21,34,55,14,23,37,35,57,92,32,5,37,13,45,21,7,8,104,116
2022,2,22200054,10/25/2022,1610612746,LA Clippers,0,0,1610612760,Oklahoma City Thunder,1,1,25,27,52,10,21,31,35,48,83,14,4,18,9,41,21,12,19,102,94
2021,2,22100695,1/22/2022,1610612739,Cleveland Cavaliers,1,1,1610612760,Oklahoma City Thunder,0,0,29,20,49,6,21,27,35,41,76,18,17,35,20,32,22,14,23,93,94
2021,2,22100695,1/22/2022,1610612760,Oklahoma City Thunder,0,0,1610612739,Cleveland Cavaliers,1,1,21,23,44,12,29,41,33,52,85,9,7,16,15,40,16,5,15,94,87
2020,2,22000438,2/17/2021,1610612737,Atlanta Hawks,0,1,1610612738,Boston Celtics,1,0,36,17,53,8,16,24,44,33,77,26,5,31,9,26,19,9,15,98,122
2020,2,22000438,2/17/2021,1610612738,Boston Celtics,1,0,1610612737,Atlanta Hawks,0,1,30,25,55,10,21,31,40,46,86,24,3,27,18,30,22,8,16,99,114
2021,2,22101014,3/13/2022,1610612738,Boston Celtics,1,0,1610612742,Dallas Mavericks,0,1,24,27,51,9,28,37,33,55,88,17,2,19,16,40,16,7,11,95,92
2021,2,22101014,3/13/2022,1610612742,Dallas Mavericks,0,1,1610612738,Boston Celtics,1,0,18,19,37,15,22,37,33,41,74,14,5,19,8,35,20,8,18,95,95
2017,2,21700463,12/20/2017,1610612757,Portland Trail Blazers,1,0,1610612759,San Antonio Spurs,0,1,32,39,71,6,19,25,38,58,96,9,5,14,18,45,18,7,9,93,91
2017,2,21700463,12/20/2017,1610612759,San Antonio Spurs,0,1,1610612757,Portland Trail Blazers,1,0,35,27,62,6,11,17,41,38,79,5,1,6,11,27,17,13,23,94,93
2014,2,21400125,11/14/2014,1610612738,Boston Celtics,1,0,1610612739,Cleveland Cavaliers,0,1,42,26,68,6,14,20,48,40,88,19,4,23,10,33,32,5,14,103,121
2017,2,21700462,12/20/2017,1610612743,Denver Nuggets,1,0,1610612750,Minnesota Timberwolves,0,1,23,21,44,13,15,28,36,36,72,19,5,24,10,29,27,12,22,94,104
2017,2,21700462,12/20/2017,1610612750,Minnesota Timberwolves,0,1,1610612743,Denver Nuggets,1,0,35,28,63,8,16,24,43,44,87,18,1,19,10,34,28,6,9,95,112
2022,2,22200054,10/25/2022,1610612760,Oklahoma City Thunder,1,1,1610612746,LA Clippers,0,0,38,42,80,4,26,30,42,68,110,20,5,25,26,45,19,5,6,103,108
2023,2,22300076,10/26/2023,1610612747,Los Angeles Lakers,1,1,1610612756,Phoenix Suns,0,0,31,24,55,5,24,29,36,48,84,23,6,29,10,42,24,7,16,103,100
2016,2,21600361,12/12/2016,1610612754,Indiana Pacers,1,1,1610612766,Charlotte Hornets,0,0,26,26,52,17,19,36,43,45,88,7,3,10,7,39,24,8,11,97,110
2022,2,22200799,2/4/2023,1610612760,Oklahoma City Thunder,1,1,1610612745,Houston Rockets,0,0,35,16,51,21,25,46,56,41,97,20,3,23,15,26,39,4,9,101,153
2021,2,22101013,3/13/2022,1610612746,LA Clippers,0,1,1610612765,Detroit Pistons,1,0,30,29,59,10,20,30,40,49,89,16,4,20,15,37,25,3,6,89,106
2021,2,22101013,3/13/2022,1610612765,Detroit Pistons,1,0,1610612746,LA Clippers,0,1,24,27,51,12,17,29,36,44,80,18,2,20,10,35,23,5,10,90,102
2022,2,22200924,2/28/2023,1610612751,Brooklyn Nets,1,0,1610612749,Milwaukee Bucks,0,1,24,23,47,12,24,36,36,47,83,20,5,25,5,45,25,10,18,106,104
2023,2,22300057,11/28/2023,1610612752,New York Knicks,1,1,1610612766,Charlotte Hornets,0,0,26,24,50,15,23,38,41,47,88,18,2,20,19,30,21,8,16,95,115
2017,2,21700461,12/20/2017,1610612742,Dallas Mavericks,1,1,1610612765,Detroit Pistons,0,0,26,19,45,14,16,30,40,35,75,16,4,20,4,33,22,4,12,92,110
2022,2,22200944,3/2/2023,1610612759,San Antonio Spurs,1,1,1610612754,Indiana Pacers,0,0,35,31,66,10,22,32,45,53,98,10,3,13,19,35,31,11,17,101,110
2017,2,21700461,12/20/2017,1610612765,Detroit Pistons,0,0,1610612742,Dallas Mavericks,1,1,26,27,53,7,17,24,33,44,77,20,2,22,8,37,19,6,13,93,93
2021,2,22100694,1/21/2022,1610612744,Golden State Warriors,1,1,1610612745,Houston Rockets,0,0,29,22,51,10,20,30,39,42,81,17,5,22,10,35,25,10,19,96,105
2021,2,22100694,1/21/2022,1610612745,Houston Rockets,0,0,1610612744,Golden State Warriors,1,1,28,26,54,10,25,35,38,51,89,17,3,20,14,38,25,4,12,95,103
2016,2,21600888,2/27/2017,1610612750,Minnesota Timberwolves,0,1,1610612758,Sacramento Kings,1,0,32,40,72,8,15,23,40,55,95,14,6,20,20,38,25,6,10,94,102
2016,2,21600888,2/27/2017,1610612758,Sacramento Kings,1,0,1610612750,Minnesota Timberwolves,0,1,30,35,65,6,11,17,36,46,82,10,5,15,11,38,23,11,18,96,88
2016,2,21600361,12/12/2016,1610612766,Charlotte Hornets,0,0,1610612754,Indiana Pacers,1,1,18,40,58,10,16,26,28,56,84,28,4,32,16,40,16,4,13,96,94
2021,2,22101012,3/13/2022,1610612751,Brooklyn Nets,1,1,1610612752,New York Knicks,0,0,38,22,60,6,23,29,44,45,89,16,6,22,18,31,30,8,14,97,110
2021,2,22101012,3/13/2022,1610612752,New York Knicks,0,0,1610612751,Brooklyn Nets,1,1,28,26,54,11,18,29,39,44,83,18,3,21,14,30,27,11,17,95,107
2017,2,21700460,12/20/2017,1610612760,Oklahoma City Thunder,1,1,1610612762,Utah Jazz,0,0,32,22,54,8,15,23,40,37,77,19,3,22,9,29,23,6,14,92,107
2022,2,22200797,2/4/2023,1610612748,Miami Heat,0,0,1610612749,Milwaukee Bucks,1,1,37,33,70,8,23,31,45,56,101,17,4,21,16,41,23,6,7,101,115
2017,2,21700460,12/20/2017,1610612762,Utah Jazz,0,0,1610612760,Oklahoma City Thunder,1,1,19,23,42,7,24,31,26,47,73,20,7,27,14,35,13,15,19,91,79
2022,2,22200055,10/25/2022,1610612744,Golden State Warriors,0,0,1610612756,Phoenix Suns,1,1,31,25,56,10,25,35,41,50,91,13,4,17,13,39,28,8,16,102,105
2022,2,22200055,10/25/2022,1610612756,Phoenix Suns,1,1,1610612744,Golden State Warriors,0,0,35,28,63,12,17,29,47,45,92,28,6,34,19,31,31,7,14,103,134
2021,2,22101011,3/12/2022,1610612757,Portland Trail Blazers,1,1,1610612764,Washington Wizards,0,0,37,26,63,11,19,30,48,45,93,20,2,22,15,30,21,7,11,98,127
2021,2,22101011,3/12/2022,1610612764,Washington Wizards,0,0,1610612757,Portland Trail Blazers,1,1,25,24,49,14,20,34,39,44,83,26,1,27,13,32,26,10,15,98,118
2021,2,22100693,1/21/2022,1610612762,Utah Jazz,1,1,1610612765,Detroit Pistons,0,0,26,22,48,10,21,31,36,43,79,29,5,34,11,34,22,6,11,95,111
2021,2,22100693,1/21/2022,1610612765,Detroit Pistons,0,0,1610612762,Utah Jazz,1,1,25,30,55,13,19,32,38,49,87,12,4,16,12,39,22,3,11,94,101
2016,2,21600887,2/27/2017,1610612742,Dallas Mavericks,1,1,1610612748,Miami Heat,0,0,24,34,58,9,9,18,33,43,76,21,2,23,12,32,18,11,13,89,96
2016,2,21600887,2/27/2017,1610612748,Miami Heat,0,0,1610612742,Dallas Mavericks,1,1,28,29,57,9,17,26,37,46,83,6,7,13,15,33,21,5,14,88,89
2016,2,21600360,12/11/2016,1610612747,Los Angeles Lakers,1,0,1610612752,New York Knicks,0,1,32,28,60,10,18,28,42,46,88,18,4,22,11,37,26,9,15,99,112
2016,2,21600360,12/11/2016,1610612752,New York Knicks,0,1,1610612747,Los Angeles Lakers,1,0,31,31,62,10,12,22,41,43,84,26,5,31,11,33,21,7,11,98,118
2022,2,22200056,10/26/2022,1610612739,Cleveland Cavaliers,1,1,1610612753,Orlando Magic,0,0,26,28,54,10,23,33,36,51,87,21,9,30,19,37,25,6,13,96,103
2023,2,22300076,10/26/2023,1610612756,Phoenix Suns,0,0,1610612747,Los Angeles Lakers,1,1,25,25,50,9,22,31,34,47,81,18,5,23,13,36,16,14,24,102,95
2020,2,22000737,4/2/2021,1610612744,Golden State Warriors,0,0,1610612761,Toronto Raptors,1,1,15,30,45,11,23,34,26,53,79,14,4,18,9,44,19,14,21,99,77
2020,2,22000737,4/2/2021,1610612761,Toronto Raptors,1,1,1610612744,Golden State Warriors,0,0,32,21,53,15,20,35,47,41,88,21,4,25,12,32,26,5,12,100,130
2022,2,22200056,10/26/2022,1610612753,Orlando Magic,0,0,1610612739,Cleveland Cavaliers,1,1,29,28,57,6,18,24,35,46,81,16,5,21,12,36,19,6,17,95,92
2021,2,22100692,1/21/2022,1610612743,Denver Nuggets,1,0,1610612763,Memphis Grizzlies,0,1,30,29,59,13,19,32,43,48,91,19,4,23,13,35,34,11,13,103,118
2021,2,22100692,1/21/2022,1610612763,Memphis Grizzlies,0,1,1610612743,Denver Nuggets,1,0,32,25,57,11,14,25,43,39,82,25,15,40,15,29,19,6,16,103,122
2020,2,22000437,2/17/2021,1610612743,Denver Nuggets,0,0,1610612764,Washington Wizards,1,1,31,23,54,17,21,38,48,44,92,15,3,18,11,36,23,7,13,100,128
2020,2,22000437,2/17/2021,1610612764,Washington Wizards,1,1,1610612743,Denver Nuggets,0,0,29,24,53,15,18,33,44,42,86,27,7,34,12,33,31,7,14,101,130
2017,2,21700459,12/20/2017,1610612745,Houston Rockets,1,0,1610612747,Los Angeles Lakers,0,1,20,28,48,17,25,42,37,53,90,25,7,32,17,40,19,8,15,102,116
2021,2,22101010,3/12/2022,1610612758,Sacramento Kings,0,0,1610612762,Utah Jazz,1,1,34,27,61,13,20,33,47,47,94,18,3,21,14,35,27,4,7,97,125
2021,2,22101010,3/12/2022,1610612762,Utah Jazz,1,1,1610612758,Sacramento Kings,0,0,32,13,45,16,25,41,48,38,86,22,9,31,15,27,21,6,10,97,134
2017,2,21700459,12/20/2017,1610612747,Los Angeles Lakers,0,1,1610612745,Houston Rockets,1,0,25,25,50,15,20,35,40,45,85,27,16,43,12,39,27,7,10,102,122
2017,2,21700458,12/20/2017,1610612741,Chicago Bulls,1,1,1610612753,Orlando Magic,0,0,33,22,55,11,21,32,44,43,87,13,1,14,11,33,31,5,13,95,112
2022,2,22200796,2/4/2023,1610612757,Portland Trail Blazers,0,0,1610612741,Chicago Bulls,1,1,30,14,44,14,29,43,44,43,87,19,2,21,7,37,22,6,9,97,121
2017,2,21700458,12/20/2017,1610612753,Orlando Magic,0,0,1610612741,Chicago Bulls,1,1,30,32,62,5,22,27,35,54,89,19,4,23,12,45,23,6,9,97,94
2021,2,22100691,1/21/2022,1610612751,Brooklyn Nets,0,1,1610612759,San Antonio Spurs,1,0,39,36,75,9,16,25,48,52,100,12,0,12,18,34,24,3,8,95,117
2021,2,22100691,1/21/2022,1610612759,San Antonio Spurs,1,0,1610612751,Brooklyn Nets,0,1,29,37,66,8,21,29,37,58,95,20,4,24,18,44,24,3,6,94,102
2014,2,21400125,11/14/2014,1610612739,Cleveland Cavaliers,0,1,1610612738,Boston Celtics,1,0,35,27,62,8,15,23,43,42,85,28,9,37,11,35,22,7,11,102,122
2022,2,22200790,2/3/2023,1610612753,Orlando Magic,0,1,1610612750,Minnesota Timberwolves,1,0,33,29,62,12,11,23,45,40,85,25,13,38,15,32,23,7,17,104,127
2014,2,21400490,1/2/2015,1610612749,Milwaukee Bucks,1,0,1610612754,Indiana Pacers,0,1,31,34,65,7,17,24,38,51,89,8,2,10,15,37,28,7,13,94,91
2014,2,21400490,1/2/2015,1610612754,Indiana Pacers,0,1,1610612749,Milwaukee Bucks,1,0,27,34,61,8,12,20,35,46,81,16,4,20,13,34,24,10,15,93,94
2022,2,22200998,3/10/2023,1610612755,Philadelphia 76ers,1,1,1610612757,Portland Trail Blazers,0,0,32,21,53,11,19,30,43,40,83,23,6,29,12,31,25,6,10,94,120
2022,2,22200057,10/26/2022,1610612737,Atlanta Hawks,0,1,1610612765,Detroit Pistons,1,0,37,32,69,8,14,22,45,46,91,20,5,25,16,32,22,4,12,99,118
2023,2,22300055,11/28/2023,1610612737,Atlanta Hawks,0,0,1610612739,Cleveland Cavaliers,1,1,22,35,57,13,31,44,35,66,101,22,2,24,21,46,21,8,11,103,105
2020,2,22000736,4/1/2021,1610612743,Denver Nuggets,0,1,1610612746,LA Clippers,1,0,26,30,56,13,12,25,39,42,81,10,4,14,11,33,28,6,13,89,101
2020,2,22000736,4/1/2021,1610612746,LA Clippers,1,0,1610612743,Denver Nuggets,0,1,25,26,51,10,24,34,35,50,85,14,2,16,18,33,17,6,12,88,94
2022,2,22200057,10/26/2022,1610612765,Detroit Pistons,1,0,1610612737,Atlanta Hawks,0,1,28,31,59,14,18,32,42,49,91,15,7,22,16,36,23,6,14,99,113
2023,2,22300093,10/28/2023,1610612748,Miami Heat,0,0,1610612750,Minnesota Timberwolves,1,1,23,26,49,12,26,38,35,52,87,8,6,14,12,41,24,9,15,98,90
2017,2,21700457,12/20/2017,1610612751,Brooklyn Nets,1,0,1610612758,Sacramento Kings,0,1,17,23,40,15,27,42,32,50,82,20,3,23,16,36,15,4,11,87,99
2017,2,21700457,12/20/2017,1610612758,Sacramento Kings,0,1,1610612751,Brooklyn Nets,1,0,33,30,63,7,12,19,40,42,82,17,3,20,18,25,14,5,14,88,104
2016,2,21600886,2/27/2017,1610612745,Houston Rockets,1,0,1610612754,Indiana Pacers,0,1,22,21,43,10,35,45,32,56,88,34,8,42,15,44,22,7,11,101,108
2016,2,21600886,2/27/2017,1610612754,Indiana Pacers,0,1,1610612745,Houston Rockets,1,0,28,33,61,13,17,30,41,50,91,22,3,25,18,33,29,8,15,102,117
2022,2,22200790,2/3/2023,1610612750,Minnesota Timberwolves,1,0,1610612753,Orlando Magic,0,1,24,19,43,16,28,44,40,47,87,24,4,28,16,33,21,11,20,105,120
2023,2,22300229,11/22/2023,1610612739,Cleveland Cavaliers,1,0,1610612748,Miami Heat,0,1,22,25,47,14,16,30,36,41,77,10,4,14,10,34,25,11,19,92,96
2017,2,21700456,12/20/2017,1610612738,Boston Celtics,1,0,1610612748,Miami Heat,0,1,17,31,48,13,19,32,30,50,80,16,5,21,9,43,18,6,10,91,89
2017,2,21700456,12/20/2017,1610612748,Miami Heat,0,1,1610612738,Boston Celtics,1,0,23,24,47,10,18,28,33,42,75,14,11,25,11,40,23,5,15,89,90
2022,2,22200743,1/28/2023,1610612765,Detroit Pistons,1,0,1610612745,Houston Rockets,0,1,24,21,45,14,24,38,38,45,83,24,7,31,11,37,23,8,16,103,114
2022,2,22200058,10/26/2022,1610612752,New York Knicks,1,1,1610612766,Charlotte Hornets,0,0,41,26,67,11,19,30,52,45,97,19,3,22,14,33,26,9,16,110,134
2022,2,22200058,10/26/2022,1610612766,Charlotte Hornets,0,0,1610612752,New York Knicks,1,1,36,32,68,13,18,31,49,50,99,20,10,30,17,37,31,5,15,112,131
2022,2,22200925,2/28/2023,1610612741,Chicago Bulls,0,0,1610612761,Toronto Raptors,1,1,27,19,46,10,15,25,37,34,71,14,3,17,7,29,28,11,19,91,98
2016,2,21600013,10/26/2016,1610612745,Houston Rockets,0,0,1610612747,Los Angeles Lakers,1,1,37,20,57,7,22,29,44,42,86,19,8,27,13,33,29,10,15,100,114
2016,2,21600013,10/26/2016,1610612747,Los Angeles Lakers,1,1,1610612745,Houston Rockets,0,0,33,21,54,12,23,35,45,44,89,18,4,22,15,31,21,10,16,101,120
2021,2,22101009,3/12/2022,1610612743,Denver Nuggets,1,0,1610612761,Toronto Raptors,0,1,32,19,51,11,16,27,43,35,78,18,6,24,13,27,32,12,19,94,115
2021,2,22101009,3/12/2022,1610612761,Toronto Raptors,0,1,1610612743,Denver Nuggets,1,0,36,35,71,12,19,31,48,54,102,19,6,25,24,32,28,4,8,96,127
2022,2,22200999,3/10/2023,1610612737,Atlanta Hawks,0,1,1610612764,Washington Wizards,1,0,27,37,64,15,16,31,42,53,95,15,4,19,16,38,25,8,14,102,114
2017,2,21700455,12/20/2017,1610612737,Atlanta Hawks,1,0,1610612754,Indiana Pacers,0,1,27,25,52,8,21,29,35,46,81,17,3,20,15,31,27,5,14,90,95
2017,2,21700455,12/20/2017,1610612754,Indiana Pacers,0,1,1610612737,Atlanta Hawks,1,0,33,28,61,7,14,21,40,42,82,18,1,19,10,32,19,5,10,91,105
2022,2,22200059,10/26/2022,1610612755,Philadelphia 76ers,0,0,1610612761,Toronto Raptors,1,1,24,19,43,16,20,36,40,39,79,13,6,19,6,35,29,9,13,93,109
2022,2,22200789,2/3/2023,1610612761,Toronto Raptors,0,1,1610612745,Houston Rockets,1,0,26,25,51,15,24,39,41,49,90,20,7,27,15,39,21,5,9,97,117
2022,2,22201000,3/10/2023,1610612748,Miami Heat,1,1,1610612739,Cleveland Cavaliers,0,0,28,25,53,14,15,29,42,40,82,21,2,23,14,27,22,5,16,96,119
2022,2,22201015,3/12/2023,1610612766,Charlotte Hornets,1,0,1610612739,Cleveland Cavaliers,0,1,31,28,59,10,11,21,41,39,80,16,6,22,11,31,25,8,19,100,108
2022,2,22200130,11/4/2022,1610612756,Phoenix Suns,1,0,1610612757,Portland Trail Blazers,0,1,22,27,49,14,20,34,36,47,83,20,1,21,14,33,26,6,17,95,106
2022,2,22200130,11/4/2022,1610612757,Portland Trail Blazers,0,1,1610612756,Phoenix Suns,1,0,33,29,62,10,13,23,43,42,85,12,3,15,15,28,30,8,18,96,108
2021,2,22100690,1/21/2022,1610612741,Chicago Bulls,0,0,1610612749,Milwaukee Bucks,1,1,24,23,47,7,31,38,31,54,85,21,3,24,11,44,21,3,10,95,90
2021,2,22100690,1/21/2022,1610612749,Milwaukee Bucks,1,1,1610612741,Chicago Bulls,0,0,28,29,57,6,25,31,34,54,88,20,8,28,15,44,20,4,8,95,94
2016,2,21600885,2/27/2017,1610612737,Atlanta Hawks,0,1,1610612738,Boston Celtics,1,0,40,30,70,6,19,25,46,49,95,16,4,20,16,35,22,9,14,105,114
2016,2,21600885,2/27/2017,1610612738,Boston Celtics,1,0,1610612737,Atlanta Hawks,0,1,24,29,53,10,24,34,34,53,87,20,5,25,14,42,21,10,18,104,98
2016,2,21600359,12/11/2016,1610612740,New Orleans Pelicans,0,1,1610612756,Phoenix Suns,1,0,22,35,57,16,24,40,38,59,97,28,7,35,20,44,24,6,12,107,120
2022,2,22200789,2/3/2023,1610612745,Houston Rockets,1,0,1610612761,Toronto Raptors,0,1,33,26,59,7,14,21,40,40,80,24,9,33,12,33,22,9,13,96,111
2022,2,22200743,1/28/2023,1610612745,Houston Rockets,0,1,1610612765,Detroit Pistons,1,0,36,29,65,8,19,27,44,48,92,21,6,27,19,32,20,10,17,102,117
2022,2,22200059,10/26/2022,1610612761,Toronto Raptors,1,1,1610612755,Philadelphia 76ers,0,0,30,17,47,16,21,37,46,38,84,11,3,14,8,32,32,6,9,92,119
2022,2,22201075,3/20/2023,1610612742,Dallas Mavericks,0,0,1610612763,Memphis Grizzlies,1,1,28,20,48,11,25,36,39,45,84,19,1,20,12,33,22,5,12,92,108
2023,2,22300351,12/18/2023,1610612755,Philadelphia 76ers,1,0,1610612741,Chicago Bulls,0,1,27,29,56,11,21,32,38,50,88,17,2,19,16,35,23,7,12,94,104
2017,2,21700454,12/20/2017,1610612761,Toronto Raptors,0,1,1610612766,Charlotte Hornets,1,0,33,25,58,16,17,33,49,42,91,15,3,18,13,32,35,10,14,100,129
2022,2,22200129,11/4/2022,1610612749,Milwaukee Bucks,0,1,1610612750,Minnesota Timberwolves,1,0,24,23,47,17,21,38,41,44,85,16,12,28,10,41,29,2,13,103,115
2022,2,22200129,11/4/2022,1610612750,Minnesota Timberwolves,1,0,1610612749,Milwaukee Bucks,0,1,28,23,51,11,30,41,39,53,92,13,4,17,11,46,22,7,16,103,102
2020,2,22000436,2/17/2021,1610612752,New York Knicks,0,0,1610612753,Orlando Magic,1,1,26,34,60,7,20,27,33,54,87,16,3,19,12,43,16,10,16,101,89
2017,2,21700454,12/20/2017,1610612766,Charlotte Hornets,1,0,1610612761,Toronto Raptors,0,1,32,30,62,7,16,23,39,46,85,26,9,35,14,33,21,6,12,99,111
2014,2,21400124,11/14/2014,1610612737,Atlanta Hawks,1,1,1610612748,Miami Heat,0,0,31,16,47,11,17,28,42,33,75,19,4,23,7,29,33,10,13,92,114
2022,2,22200060,10/26/2022,1610612749,Milwaukee Bucks,1,1,1610612751,Brooklyn Nets,0,0,29,23,52,10,26,36,39,49,88,22,7,29,16,35,21,7,19,102,110
2022,2,22200791,2/3/2023,1610612759,San Antonio Spurs,1,0,1610612755,Philadelphia 76ers,0,1,45,23,68,7,14,21,52,37,89,14,1,15,11,27,32,11,18,102,125
2022,2,22200924,2/28/2023,1610612749,Milwaukee Bucks,0,1,1610612751,Brooklyn Nets,1,0,36,29,65,14,23,37,50,52,102,4,8,12,18,40,32,12,17,107,118
2022,2,22200060,10/26/2022,1610612751,Brooklyn Nets,0,0,1610612749,Milwaukee Bucks,1,1,27,32,59,7,20,27,34,52,86,24,6,30,12,43,23,8,14,103,99
2022,2,22200062,10/26/2022,1610612750,Minnesota Timberwolves,1,1,1610612759,San Antonio Spurs,0,0,32,14,46,20,14,34,52,28,80,10,6,16,2,30,37,6,17,105,134
2022,2,22200062,10/26/2022,1610612759,San Antonio Spurs,0,0,1610612750,Minnesota Timberwolves,1,1,27,32,59,16,20,36,43,52,95,20,2,22,17,36,34,9,16,104,122
2022,2,22200128,11/4/2022,1610612740,New Orleans Pelicans,1,1,1610612744,Golden State Warriors,0,0,29,23,52,12,17,29,41,40,81,20,9,29,14,28,24,7,16,98,114
2022,2,22200128,11/4/2022,1610612744,Golden State Warriors,0,0,1610612740,New Orleans Pelicans,1,1,23,16,39,12,20,32,35,36,71,23,2,25,7,30,23,10,23,98,105
2017,2,21700453,12/19/2017,1610612739,Cleveland Cavaliers,0,0,1610612749,Milwaukee Bucks,1,1,24,15,39,16,25,41,40,40,80,20,4,24,10,32,26,12,14,95,116
2017,2,21700453,12/19/2017,1610612749,Milwaukee Bucks,1,1,1610612739,Cleveland Cavaliers,0,0,32,21,53,11,18,29,43,39,82,22,5,27,11,32,27,9,14,95,119
2020,2,22000436,2/17/2021,1610612753,Orlando Magic,1,1,1610612752,New York Knicks,0,0,26,32,58,16,18,34,42,50,92,7,3,10,12,39,27,7,14,101,107
2019,2,21900207,11/20/2019,1610612753,Orlando Magic,0,0,1610612761,Toronto Raptors,1,1,26,33,59,9,23,32,35,56,91,18,10,28,21,43,26,5,14,96,97
2019,2,21900207,11/20/2019,1610612761,Toronto Raptors,1,1,1610612753,Orlando Magic,0,0,36,24,60,9,18,27,45,42,87,14,5,19,13,31,26,9,13,96,113
2017,2,21700452,12/19/2017,1610612740,New Orleans Pelicans,0,0,1610612764,Washington Wizards,1,1,29,31,60,5,15,20,34,46,80,32,7,39,15,34,20,8,16,103,105
2021,2,22100689,1/21/2022,1610612761,Toronto Raptors,0,1,1610612764,Washington Wizards,1,0,31,29,60,11,19,30,42,48,90,14,3,17,13,37,20,3,8,92,109
2021,2,22100689,1/21/2022,1610612764,Washington Wizards,1,0,1610612761,Toronto Raptors,0,1,32,20,52,11,22,33,43,42,85,8,2,10,15,29,29,10,18,93,105
2017,2,21700452,12/19/2017,1610612764,Washington Wizards,1,1,1610612740,New Orleans Pelicans,0,0,32,25,57,14,21,35,46,46,92,10,4,14,13,34,29,7,16,101,116
2020,2,22000435,3/19/2021,1610612739,Cleveland Cavaliers,1,0,1610612759,San Antonio Spurs,0,1,32,30,62,7,20,27,39,50,89,25,7,32,19,35,19,5,11,98,110
2017,2,21700451,12/19/2017,1610612755,Philadelphia 76ers,1,0,1610612758,Sacramento Kings,0,1,24,22,46,10,25,35,34,47,81,17,7,24,16,35,21,11,20,98,95
2021,2,22101008,3/12/2022,1610612744,Golden State Warriors,1,1,1610612749,Milwaukee Bucks,0,0,27,21,48,18,27,45,45,48,93,14,1,15,17,32,33,8,12,96,122
2021,2,22101008,3/12/2022,1610612749,Milwaukee Bucks,0,0,1610612744,Golden State Warriors,1,1,21,27,48,17,27,44,38,54,92,16,7,23,12,47,27,3,5,97,109
2017,2,21700451,12/19/2017,1610612758,Sacramento Kings,0,1,1610612755,Philadelphia 76ers,1,0,34,30,64,7,20,27,41,50,91,12,11,23,16,41,21,7,12,99,101
2020,2,22000435,3/19/2021,1610612759,San Antonio Spurs,0,1,1610612739,Cleveland Cavaliers,1,0,34,36,70,7,11,18,41,47,88,27,6,33,17,33,19,8,13,98,116
2021,2,22101007,3/12/2022,1610612754,Indiana Pacers,0,1,1610612759,San Antonio Spurs,1,0,31,25,56,14,22,36,45,47,92,15,0,15,10,37,23,6,13,103,119
2021,2,22101007,3/12/2022,1610612759,San Antonio Spurs,1,0,1610612754,Indiana Pacers,0,1,31,37,68,11,23,34,42,60,102,13,3,16,20,42,28,6,12,102,108
2017,2,21700450,12/18/2017,1610612744,Golden State Warriors,0,1,1610612747,Los Angeles Lakers,1,0,32,41,73,11,23,34,43,64,107,19,2,21,22,42,25,9,15,112,116
2017,2,21700450,12/18/2017,1610612747,Los Angeles Lakers,1,0,1610612744,Golden State Warriors,0,1,31,36,67,10,15,25,41,51,92,22,13,35,12,46,23,6,12,112,114
2022,2,22200694,1/21/2023,1610612737,Atlanta Hawks,1,0,1610612766,Charlotte Hornets,0,1,34,24,58,11,14,25,45,38,83,17,3,20,7,34,24,11,18,102,118
2022,2,22200127,11/4/2022,1610612742,Dallas Mavericks,1,1,1610612761,Toronto Raptors,0,0,27,16,43,12,22,34,39,38,77,21,4,25,13,28,23,10,19,95,111
2022,2,22200127,11/4/2022,1610612761,Toronto Raptors,0,0,1610612742,Dallas Mavericks,1,1,28,26,54,11,23,34,39,49,88,21,4,25,23,28,20,12,19,96,110
2014,2,21400124,11/14/2014,1610612748,Miami Heat,0,0,1610612737,Atlanta Hawks,1,1,25,28,53,10,11,21,35,39,74,23,2,25,8,33,27,10,14,92,103
2016,2,21600359,12/11/2016,1610612756,Phoenix Suns,1,0,1610612740,New Orleans Pelicans,0,1,30,25,55,14,27,41,44,52,96,17,9,26,17,38,21,12,16,107,119
2022,2,22200063,10/26/2022,1610612745,Houston Rockets,0,0,1610612762,Utah Jazz,1,1,25,29,54,11,29,40,36,58,94,18,6,24,18,43,19,11,19,108,101
2022,2,22200745,1/28/2023,1610612737,Atlanta Hawks,1,0,1610612746,LA Clippers,0,1,38,30,68,7,20,27,45,50,95,16,4,20,18,32,24,5,9,97,113
2022,2,22200976,3/6/2023,1610612758,Sacramento Kings,1,1,1610612740,New Orleans Pelicans,0,0,31,14,45,16,22,38,47,36,83,13,7,20,6,33,39,6,11,95,123
2022,2,22200063,10/26/2022,1610612762,Utah Jazz,1,1,1610612745,Houston Rockets,0,0,25,20,45,13,32,45,38,52,90,20,10,30,16,40,28,7,16,108,109
2016,2,21600884,2/27/2017,1610612739,Cleveland Cavaliers,1,1,1610612749,Milwaukee Bucks,0,0,25,17,42,10,18,28,35,35,70,22,4,26,7,30,20,3,16,91,102
2016,2,21600884,2/27/2017,1610612749,Milwaukee Bucks,0,0,1610612739,Cleveland Cavaliers,1,1,26,27,53,11,19,30,37,46,83,10,6,16,8,42,27,4,8,90,95
2016,2,21600358,12/11/2016,1610612744,Golden State Warriors,0,1,1610612750,Minnesota Timberwolves,1,0,25,26,51,13,19,32,38,45,83,27,3,30,10,37,30,3,9,98,116
2022,2,22200975,3/6/2023,1610612743,Denver Nuggets,1,1,1610612761,Toronto Raptors,0,0,30,23,53,13,20,33,43,43,86,19,4,23,14,30,30,6,14,96,118
2022,2,22200744,1/28/2023,1610612753,Orlando Magic,1,0,1610612741,Chicago Bulls,0,1,31,24,55,10,18,28,41,42,83,17,7,24,10,36,29,5,13,97,109
2016,2,21600358,12/11/2016,1610612750,Minnesota Timberwolves,1,0,1610612744,Golden State Warriors,0,1,27,30,57,9,15,24,36,45,81,27,9,36,18,32,17,9,15,97,108
2022,2,22200675,1/18/2023,1610612746,LA Clippers,0,0,1610612762,Utah Jazz,1,1,22,36,58,15,19,34,37,55,92,14,7,21,21,36,23,4,13,94,103
2022,2,22200744,1/28/2023,1610612741,Chicago Bulls,0,1,1610612753,Orlando Magic,1,0,32,14,46,16,19,35,48,33,81,16,3,19,5,31,30,5,12,95,128
2022,2,22200976,3/6/2023,1610612740,New Orleans Pelicans,0,0,1610612758,Sacramento Kings,1,1,32,19,51,11,18,29,43,37,80,11,3,14,7,31,29,7,16,94,108
2022,2,22200061,10/26/2022,1610612741,Chicago Bulls,1,1,1610612754,Indiana Pacers,0,0,27,30,57,16,14,30,43,44,87,22,2,24,13,32,34,5,18,101,124
2022,2,22201075,3/20/2023,1610612763,Memphis Grizzlies,1,1,1610612742,Dallas Mavericks,0,0,31,23,54,10,25,35,41,48,89,20,6,26,19,34,21,5,11,92,112
2022,2,22200061,10/26/2022,1610612754,Indiana Pacers,0,0,1610612741,Chicago Bulls,1,1,21,25,46,16,24,40,37,49,86,19,5,24,17,35,31,10,20,103,109
2021,2,22100688,1/21/2022,1610612738,Boston Celtics,1,0,1610612757,Portland Trail Blazers,0,1,26,19,45,11,26,37,37,45,82,20,3,23,11,37,25,6,12,93,105
2022,2,22200669,1/18/2023,1610612764,Washington Wizards,0,1,1610612752,New York Knicks,1,0,26,27,53,16,26,42,42,53,95,16,3,19,25,30,28,9,14,94,116
2021,2,22101006,3/12/2022,1610612739,Cleveland Cavaliers,0,0,1610612741,Chicago Bulls,1,1,31,31,62,5,19,24,36,50,86,14,3,17,13,40,19,12,14,94,91
2021,2,22101006,3/12/2022,1610612741,Chicago Bulls,1,1,1610612739,Cleveland Cavaliers,0,0,30,37,67,9,12,21,39,49,88,14,1,15,12,37,20,7,14,96,101
2022,2,22201074,3/20/2023,1610612744,Golden State Warriors,0,1,1610612745,Houston Rockets,1,0,27,13,40,17,31,48,44,44,88,16,3,19,17,30,31,14,20,101,121
2022,2,22200694,1/21/2023,1610612766,Charlotte Hornets,0,1,1610612737,Atlanta Hawks,1,0,32,23,55,13,21,34,45,44,89,19,3,22,9,35,28,5,12,102,122
2022,2,22200927,2/28/2023,1610612763,Memphis Grizzlies,1,1,1610612747,Los Angeles Lakers,0,0,45,36,81,6,25,31,51,61,112,13,4,17,19,43,25,5,7,108,121
2022,2,22200064,10/26/2022,1610612743,Denver Nuggets,1,1,1610612747,Los Angeles Lakers,0,0,33,25,58,9,25,34,42,50,92,17,4,21,10,42,34,8,11,102,110
2022,2,22200064,10/26/2022,1610612747,Los Angeles Lakers,0,0,1610612743,Denver Nuggets,1,1,32,28,60,8,22,30,40,50,90,11,5,16,8,46,25,12,14,103,99
2017,2,21700449,12/18/2017,1610612746,LA Clippers,0,0,1610612759,San Antonio Spurs,1,1,28,27,55,9,20,29,37,47,84,8,8,16,11,40,21,7,18,100,91
2017,2,21700449,12/18/2017,1610612759,San Antonio Spurs,1,1,1610612746,LA Clippers,0,0,31,27,58,9,15,24,40,42,82,20,5,25,10,35,22,12,18,100,109
2021,2,22100688,1/21/2022,1610612757,Portland Trail Blazers,0,1,1610612738,Boston Celtics,1,0,20,23,43,16,17,33,36,40,76,21,9,30,8,34,20,7,13,93,109
2022,2,22200065,10/26/2022,1610612748,Miami Heat,0,1,1610612757,Portland Trail Blazers,1,0,29,20,49,15,23,38,44,43,87,16,3,19,18,27,34,9,18,96,119
2022,2,22200778,2/2/2023,1610612747,Los Angeles Lakers,0,1,1610612754,Indiana Pacers,1,0,36,34,70,6,16,22,42,50,92,22,9,31,16,40,29,8,13,105,112
2022,2,22200065,10/26/2022,1610612757,Portland Trail Blazers,1,0,1610612748,Miami Heat,0,1,22,19,41,12,25,37,34,44,78,18,8,26,14,34,20,13,19,96,98
2020,2,22000434,5/6/2021,1610612741,Chicago Bulls,0,1,1610612766,Charlotte Hornets,1,0,28,26,54,18,19,37,46,45,91,10,7,17,16,33,33,11,17,98,120
2022,2,22200925,2/28/2023,1610612761,Toronto Raptors,1,1,1610612741,Chicago Bulls,0,0,23,29,52,15,27,42,38,56,94,13,6,19,23,36,26,6,13,91,104
2021,2,22101005,3/12/2022,1610612748,Miami Heat,1,0,1610612750,Minnesota Timberwolves,0,1,20,23,43,15,30,45,35,53,88,19,6,25,14,42,23,12,18,104,104
2021,2,22101005,3/12/2022,1610612750,Minnesota Timberwolves,0,1,1610612748,Miami Heat,1,0,20,21,41,15,27,42,35,48,83,28,4,32,9,42,21,7,15,104,113
2017,2,21700448,12/18/2017,1610612742,Dallas Mavericks,1,0,1610612756,Phoenix Suns,0,1,21,30,51,11,26,37,32,56,88,16,1,17,13,44,21,9,15,100,91
2017,2,21700448,12/18/2017,1610612756,Phoenix Suns,0,1,1610612742,Dallas Mavericks,1,0,25,29,54,10,15,25,35,44,79,17,5,22,9,37,17,10,19,99,97
2022,2,22200818,2/7/2023,1610612737,Atlanta Hawks,0,0,1610612740,New Orleans Pelicans,1,1,26,23,49,12,24,36,38,47,85,19,6,25,15,35,30,8,12,94,107
2022,2,22200126,11/4/2022,1610612746,LA Clippers,0,1,1610612759,San Antonio Spurs,1,0,27,20,47,15,18,33,42,38,80,14,5,19,7,32,26,7,16,101,113
2022,2,22200126,11/4/2022,1610612759,San Antonio Spurs,1,0,1610612746,LA Clippers,0,1,30,27,57,12,19,31,42,46,88,10,8,18,9,44,23,6,13,100,106
2022,2,22200923,2/28/2023,1610612737,Atlanta Hawks,1,0,1610612764,Washington Wizards,0,1,30,28,58,13,22,35,43,50,93,17,2,19,17,34,21,6,9,96,116
2014,2,21400123,11/14/2014,1610612749,Milwaukee Bucks,0,0,1610612753,Orlando Magic,1,1,34,27,61,2,17,19,36,44,80,11,3,14,7,38,19,7,18,97,85
2014,2,21400123,11/14/2014,1610612753,Orlando Magic,1,1,1610612749,Milwaukee Bucks,0,0,25,31,56,10,14,24,35,45,80,21,6,27,12,35,22,8,16,98,101
2022,2,22200669,1/18/2023,1610612752,New York Knicks,1,0,1610612764,Washington Wizards,0,1,33,37,70,7,19,26,40,56,96,18,9,27,22,41,14,5,9,93,105
2022,2,22200081,10/29/2022,1610612748,Miami Heat,0,0,1610612758,Sacramento Kings,1,1,27,34,61,11,17,28,38,51,89,26,5,31,14,39,18,1,9,99,113
2022,2,22200081,10/29/2022,1610612758,Sacramento Kings,1,1,1610612748,Miami Heat,0,0,28,17,45,14,17,31,42,34,76,21,8,29,8,31,27,7,21,100,119
2017,2,21700447,12/18/2017,1610612743,Denver Nuggets,0,0,1610612760,Oklahoma City Thunder,1,1,25,24,49,12,25,37,37,49,86,8,4,12,14,37,21,9,12,91,94
2017,2,21700447,12/18/2017,1610612760,Oklahoma City Thunder,1,1,1610612743,Denver Nuggets,0,0,32,25,57,7,17,24,39,42,81,10,5,15,8,38,13,8,10,91,95
2022,2,22200914,2/26/2023,1610612761,Toronto Raptors,0,0,1610612739,Cleveland Cavaliers,1,1,27,41,68,9,16,25,36,57,93,12,3,15,16,43,19,7,14,98,93
2022,2,22200082,10/29/2022,1610612744,Golden State Warriors,0,0,1610612766,Charlotte Hornets,1,1,31,25,56,13,31,44,44,56,100,12,4,16,13,45,31,2,10,106,113
2022,2,22200082,10/29/2022,1610612766,Charlotte Hornets,1,1,1610612744,Golden State Warriors,0,0,33,38,71,10,21,31,43,59,102,24,7,31,20,42,32,8,10,106,120
2021,2,22101004,3/11/2022,1610612747,Los Angeles Lakers,1,1,1610612764,Washington Wizards,0,0,34,26,60,14,17,31,48,43,91,12,5,17,11,34,25,6,9,97,122
2021,2,22101004,3/11/2022,1610612764,Washington Wizards,0,0,1610612747,Los Angeles Lakers,1,1,30,28,58,9,18,27,39,46,85,22,11,33,17,34,21,5,11,96,109
2017,2,21700446,12/18/2017,1610612750,Minnesota Timberwolves,1,1,1610612757,Portland Trail Blazers,0,0,35,37,72,7,12,19,42,49,91,17,4,21,16,34,19,6,10,93,108
2017,2,21700446,12/18/2017,1610612757,Portland Trail Blazers,0,0,1610612750,Minnesota Timberwolves,1,1,36,24,60,10,14,24,46,38,84,5,0,5,11,27,26,6,17,94,107
2021,2,22100687,1/21/2022,1610612737,Atlanta Hawks,1,1,1610612748,Miami Heat,0,0,24,11,35,14,19,33,38,30,68,20,4,24,7,23,26,8,18,90,110
2021,2,22100687,1/21/2022,1610612748,Miami Heat,0,0,1610612737,Atlanta Hawks,1,1,26,19,45,15,25,40,41,44,85,11,1,12,14,30,30,3,15,92,108
2021,2,22101003,3/11/2022,1610612756,Phoenix Suns,1,0,1610612761,Toronto Raptors,0,1,33,19,52,11,25,36,44,44,88,13,4,17,9,37,27,11,16,104,112
2021,2,22101003,3/11/2022,1610612761,Toronto Raptors,0,1,1610612756,Phoenix Suns,1,0,28,34,62,14,18,32,42,52,94,19,2,21,16,36,19,7,17,103,117
2020,2,22000735,4/1/2021,1610612737,Atlanta Hawks,0,1,1610612759,San Antonio Spurs,1,0,37,39,76,13,11,24,50,50,100,21,5,26,13,39,28,8,12,113,134
2017,2,21700445,12/18/2017,1610612745,Houston Rockets,1,1,1610612762,Utah Jazz,0,0,23,11,34,17,26,43,40,37,77,23,4,27,12,28,25,12,14,91,120
2017,2,21700445,12/18/2017,1610612762,Utah Jazz,0,0,1610612745,Houston Rockets,1,1,34,30,64,8,19,27,42,49,91,7,1,8,8,42,17,5,6,91,99
2022,2,22200778,2/2/2023,1610612754,Indiana Pacers,1,0,1610612747,Los Angeles Lakers,0,1,29,23,52,16,25,41,45,48,93,5,1,6,8,40,30,8,16,105,111
2022,2,22200125,11/4/2022,1610612763,Memphis Grizzlies,1,1,1610612766,Charlotte Hornets,0,0,34,28,62,16,20,36,50,48,98,14,4,18,19,30,34,11,19,107,130
2022,2,22200125,11/4/2022,1610612766,Charlotte Hornets,0,0,1610612763,Memphis Grizzlies,1,1,25,34,59,8,19,27,33,53,86,25,6,31,14,42,22,6,18,105,99
2021,2,22100686,1/21/2022,1610612746,LA Clippers,0,1,1610612755,Philadelphia 76ers,1,0,29,26,55,11,21,32,40,47,87,11,4,15,15,34,21,7,12,94,102
2016,2,21600357,12/11/2016,1610612738,Boston Celtics,0,0,1610612760,Oklahoma City Thunder,1,1,29,29,58,11,21,32,40,50,90,5,3,8,17,34,28,9,14,91,96
2016,2,21600357,12/11/2016,1610612760,Oklahoma City Thunder,1,1,1610612738,Boston Celtics,0,0,38,24,62,3,18,21,41,42,83,14,13,27,19,29,17,9,13,91,99
2022,2,22200914,2/26/2023,1610612739,Cleveland Cavaliers,1,1,1610612761,Toronto Raptors,0,0,26,22,48,18,18,36,44,40,84,12,2,14,8,33,31,4,14,96,118
2022,2,22200083,10/29/2022,1610612751,Brooklyn Nets,1,0,1610612754,Indiana Pacers,0,1,27,16,43,14,25,39,41,41,82,20,6,26,7,36,29,7,9,95,116
2022,2,22200083,10/29/2022,1610612754,Indiana Pacers,0,1,1610612751,Brooklyn Nets,1,0,17,31,48,23,23,46,40,54,94,22,4,26,25,31,31,6,12,94,125
2022,2,22200124,11/4/2022,1610612738,Boston Celtics,1,1,1610612741,Chicago Bulls,0,0,32,20,52,9,22,31,41,42,83,32,7,39,11,33,24,8,14,103,123
2022,2,22200745,1/28/2023,1610612746,LA Clippers,0,1,1610612737,Atlanta Hawks,1,0,23,18,41,19,20,39,42,38,80,17,2,19,8,32,25,12,14,97,120
2022,2,22200124,11/4/2022,1610612741,Chicago Bulls,0,0,1610612738,Boston Celtics,1,1,32,23,55,11,17,28,43,40,83,22,3,25,9,33,21,5,17,103,119
2021,2,22100686,1/21/2022,1610612755,Philadelphia 76ers,1,0,1610612746,LA Clippers,0,1,28,35,63,10,18,28,38,53,91,15,6,21,16,39,23,5,7,94,101
2022,2,22200801,2/4/2023,1610612743,Denver Nuggets,1,1,1610612737,Atlanta Hawks,0,0,33,24,57,15,23,38,48,47,95,17,3,20,15,34,32,7,13,103,128
2022,2,22200801,2/4/2023,1610612737,Atlanta Hawks,0,0,1610612743,Denver Nuggets,1,1,38,33,71,6,14,20,44,47,91,14,3,17,12,37,26,14,16,102,108
2017,2,21700444,12/18/2017,1610612741,Chicago Bulls,1,1,1610612755,Philadelphia 76ers,0,0,31,33,64,13,15,28,44,48,92,16,3,19,10,40,27,9,16,106,117
2017,2,21700444,12/18/2017,1610612755,Philadelphia 76ers,0,0,1610612741,Chicago Bulls,1,1,30,28,58,14,19,33,44,47,91,13,5,18,11,38,30,9,20,107,115
2022,2,22200085,10/29/2022,1610612737,Atlanta Hawks,0,0,1610612749,Milwaukee Bucks,1,1,32,33,65,13,16,29,45,49,94,12,3,15,15,36,19,8,13,100,115
2021,2,22100685,1/21/2022,1610612747,Los Angeles Lakers,0,1,1610612753,Orlando Magic,1,0,29,26,55,13,17,30,42,43,85,19,4,23,10,34,23,6,19,105,116
2021,2,22100685,1/21/2022,1610612753,Orlando Magic,1,0,1610612747,Los Angeles Lakers,0,1,25,16,41,11,29,40,36,45,81,22,7,29,8,40,23,12,18,104,105
2020,2,22000434,5/6/2021,1610612766,Charlotte Hornets,1,0,1610612741,Chicago Bulls,0,1,22,33,55,16,19,35,38,52,90,7,11,18,16,42,29,10,15,98,99
2022,2,22200085,10/29/2022,1610612749,Milwaukee Bucks,1,1,1610612737,Atlanta Hawks,0,0,31,25,56,14,22,36,45,47,92,19,10,29,18,33,24,5,12,99,123
2014,2,21400122,11/14/2014,1610612743,Denver Nuggets,0,1,1610612754,Indiana Pacers,1,0,35,29,64,8,15,23,43,44,87,14,11,25,16,33,20,2,8,92,108
2023,2,22300600,1/21/2024,1610612751,Brooklyn Nets,0,0,1610612746,LA Clippers,1,1,30,21,51,14,25,39,44,46,90,12,4,16,10,38,29,6,13,99,114
2022,2,22200123,11/4/2022,1610612751,Brooklyn Nets,0,1,1610612764,Washington Wizards,1,0,36,26,62,14,14,28,50,40,90,14,0,14,8,32,32,4,9,96,128
2016,2,21600883,2/27/2017,1610612744,Golden State Warriors,0,1,1610612755,Philadelphia 76ers,1,0,34,26,60,6,23,29,40,49,89,33,6,39,20,32,31,11,14,103,119
2016,2,21600883,2/27/2017,1610612755,Philadelphia 76ers,1,0,1610612744,Golden State Warriors,0,1,27,21,48,10,24,34,37,45,82,24,3,27,13,32,24,14,23,103,108
2022,2,22200780,2/2/2023,1610612752,New York Knicks,1,1,1610612748,Miami Heat,0,0,28,19,47,12,24,36,40,43,83,14,4,18,16,28,25,8,18,94,106
2017,2,21700443,12/18/2017,1610612737,Atlanta Hawks,1,1,1610612748,Miami Heat,0,0,30,31,61,8,14,22,38,45,83,26,5,31,14,34,25,9,13,97,110
2017,2,21700443,12/18/2017,1610612748,Miami Heat,0,0,1610612737,Atlanta Hawks,1,1,29,25,54,7,18,25,36,43,79,25,5,30,15,31,19,8,19,98,104
2022,2,22200975,3/6/2023,1610612761,Toronto Raptors,0,0,1610612743,Denver Nuggets,1,1,33,26,59,10,17,27,43,43,86,17,3,20,14,31,29,9,15,98,113
2022,2,22200123,11/4/2022,1610612764,Washington Wizards,1,0,1610612751,Brooklyn Nets,0,1,22,27,49,8,26,34,30,53,83,18,4,22,12,43,18,8,13,97,86
2021,2,22100684,1/21/2022,1610612760,Oklahoma City Thunder,0,0,1610612766,Charlotte Hornets,1,1,25,29,54,12,32,44,37,61,98,12,3,15,16,47,20,8,12,102,98
2022,2,22201002,3/10/2023,1610612743,Denver Nuggets,0,0,1610612759,San Antonio Spurs,1,1,31,24,55,13,22,35,44,46,90,19,1,20,8,38,32,10,14,105,120
2022,2,22201001,3/10/2023,1610612750,Minnesota Timberwolves,1,0,1610612751,Brooklyn Nets,0,1,39,29,68,9,21,30,48,50,98,18,11,29,17,40,29,7,14,109,123
2022,2,22201099,3/24/2023,1610612765,Detroit Pistons,0,0,1610612761,Toronto Raptors,1,1,28,20,48,6,19,25,34,39,73,23,7,30,11,31,23,12,22,95,97
2017,2,21700442,12/18/2017,1610612738,Boston Celtics,0,1,1610612754,Indiana Pacers,1,0,28,25,53,16,10,26,44,35,79,8,6,14,8,31,26,12,20,96,112
2017,2,21700442,12/18/2017,1610612754,Indiana Pacers,1,0,1610612738,Boston Celtics,0,1,30,28,58,7,14,21,37,42,79,30,8,38,14,32,14,6,13,97,111
2022,2,22200849,2/11/2023,1610612764,Washington Wizards,1,1,1610612754,Indiana Pacers,0,0,36,13,49,12,14,26,48,27,75,19,3,22,11,17,32,8,18,91,127
2021,2,22100684,1/21/2022,1610612766,Charlotte Hornets,1,1,1610612760,Oklahoma City Thunder,0,0,28,22,50,17,32,49,45,54,99,14,6,20,18,39,34,6,12,100,121
2020,2,22000433,2/16/2021,1610612751,Brooklyn Nets,0,1,1610612756,Phoenix Suns,1,0,27,15,42,20,20,40,47,35,82,14,1,15,4,31,28,7,10,93,128
2020,2,22000433,2/16/2021,1610612756,Phoenix Suns,1,0,1610612751,Brooklyn Nets,0,1,32,19,51,16,21,37,48,40,88,12,0,12,5,35,28,4,6,95,124
2016,2,21600882,2/27/2017,1610612752,New York Knicks,1,0,1610612761,Toronto Raptors,0,1,24,25,49,9,15,24,33,40,73,16,3,19,12,30,17,9,18,90,91
2020,2,22000735,4/1/2021,1610612759,San Antonio Spurs,1,0,1610612737,Atlanta Hawks,0,1,36,34,70,13,27,40,49,61,110,18,6,24,13,51,25,3,6,115,129
2022,2,22201000,3/10/2023,1610612739,Cleveland Cavaliers,0,0,1610612748,Miami Heat,1,1,22,21,43,18,25,43,40,46,86,17,4,21,11,38,25,7,11,96,115
2017,2,21700441,12/18/2017,1610612752,New York Knicks,0,0,1610612766,Charlotte Hornets,1,1,33,35,68,3,15,18,36,50,86,16,4,20,12,38,21,10,17,101,91
2017,2,21700441,12/18/2017,1610612766,Charlotte Hornets,1,1,1610612752,New York Knicks,0,0,34,34,68,9,11,20,43,45,88,14,2,16,15,31,30,10,19,100,109
2022,2,22200084,10/29/2022,1610612741,Chicago Bulls,1,0,1610612755,Philadelphia 76ers,0,1,25,24,49,11,20,31,36,44,80,26,3,29,10,35,22,8,18,102,109
2022,2,22200341,12/3/2022,1610612750,Minnesota Timberwolves,1,0,1610612760,Oklahoma City Thunder,0,1,37,22,59,10,20,30,47,42,89,24,6,30,16,29,25,11,23,114,128
2022,2,22200675,1/18/2023,1610612762,Utah Jazz,1,1,1610612746,LA Clippers,0,0,26,29,55,19,13,32,45,42,87,17,5,22,11,35,26,1,8,94,126
2022,2,22200084,10/29/2022,1610612755,Philadelphia 76ers,0,1,1610612741,Chicago Bulls,1,0,25,25,50,14,15,29,39,40,79,22,5,27,10,34,28,7,19,101,114
2016,2,21600882,2/27/2017,1610612761,Toronto Raptors,0,1,1610612752,New York Knicks,1,0,26,26,52,7,19,26,33,45,78,19,4,23,12,34,12,10,12,89,92
2016,2,21600012,10/26/2016,1610612756,Phoenix Suns,1,0,1610612758,Sacramento Kings,0,1,32,29,61,4,12,16,36,41,77,18,9,27,12,33,20,5,18,95,94
2021,2,22101002,3/11/2022,1610612759,San Antonio Spurs,1,1,1610612762,Utah Jazz,0,0,28,28,56,6,23,29,34,51,85,30,13,43,18,41,15,10,13,100,104
2021,2,22101002,3/11/2022,1610612762,Utah Jazz,0,0,1610612759,San Antonio Spurs,1,1,24,28,52,13,27,40,37,55,92,15,8,23,20,40,20,8,17,98,102
2017,2,21700440,12/17/2017,1610612739,Cleveland Cavaliers,0,1,1610612764,Washington Wizards,1,0,27,26,53,14,20,34,41,46,87,10,2,12,8,38,24,4,9,97,106
2017,2,21700440,12/17/2017,1610612764,Washington Wizards,1,0,1610612739,Cleveland Cavaliers,0,1,27,31,58,12,21,33,39,52,91,9,7,16,16,38,20,6,10,95,99
2014,2,21401050,3/23/2015,1610612752,New York Knicks,1,0,1610612763,Memphis Grizzlies,0,1,28,30,58,4,14,18,32,44,76,14,3,17,16,30,22,4,19,88,82
2022,2,22200817,2/7/2023,1610612751,Brooklyn Nets,1,0,1610612756,Phoenix Suns,0,1,29,22,51,9,19,28,38,41,79,27,4,31,9,34,25,10,17,102,112
2022,2,22200086,10/29/2022,1610612742,Dallas Mavericks,1,0,1610612760,Oklahoma City Thunder,0,1,30,25,55,8,32,40,38,57,95,27,7,34,17,42,17,9,16,107,111
2022,2,22200122,11/4/2022,1610612752,New York Knicks,0,1,1610612755,Philadelphia 76ers,1,0,28,19,47,9,24,33,37,43,80,23,4,27,14,31,24,12,22,102,106
2022,2,22200122,11/4/2022,1610612755,Philadelphia 76ers,1,0,1610612752,New York Knicks,0,1,24,27,51,13,34,47,37,61,98,17,4,21,20,45,27,5,15,103,104
2021,2,22100683,1/20/2022,1610612744,Golden State Warriors,1,0,1610612754,Indiana Pacers,0,1,33,19,52,9,33,42,42,52,94,24,5,29,19,38,28,12,21,108,117
2021,2,22100683,1/20/2022,1610612754,Indiana Pacers,0,1,1610612744,Golden State Warriors,1,0,26,34,60,15,20,35,41,54,95,24,10,34,19,38,23,11,18,109,121
2022,2,22200086,10/29/2022,1610612760,Oklahoma City Thunder,0,1,1610612742,Dallas Mavericks,1,0,39,25,64,5,20,25,44,45,89,24,7,31,12,37,25,8,15,106,117
2022,2,22200927,2/28/2023,1610612747,Los Angeles Lakers,0,0,1610612763,Memphis Grizzlies,1,1,25,27,52,13,21,34,38,48,86,20,3,23,16,35,22,13,26,106,109
2016,2,21600012,10/26/2016,1610612758,Sacramento Kings,0,1,1610612756,Phoenix Suns,1,0,38,27,65,6,15,21,44,42,86,19,7,26,14,32,24,6,14,95,113
2022,2,22201002,3/10/2023,1610612759,San Antonio Spurs,1,1,1610612743,Denver Nuggets,0,0,38,23,61,13,20,33,51,43,94,13,4,17,15,30,31,14,19,104,128
2017,2,21700439,12/17/2017,1610612751,Brooklyn Nets,1,0,1610612754,Indiana Pacers,0,1,22,26,48,12,21,33,34,47,81,17,4,21,11,39,26,6,12,91,97
2017,2,21700439,12/17/2017,1610612754,Indiana Pacers,0,1,1610612751,Brooklyn Nets,1,0,35,23,58,8,10,18,43,33,76,15,4,19,9,25,21,7,15,92,109
2022,2,22200087,10/29/2022,1610612762,Utah Jazz,1,1,1610612763,Memphis Grizzlies,0,0,26,17,43,19,25,44,45,42,87,15,5,20,13,31,30,11,20,102,124
2022,2,22200817,2/7/2023,1610612756,Phoenix Suns,0,1,1610612751,Brooklyn Nets,1,0,34,27,61,9,22,31,43,49,92,21,7,28,18,33,31,11,15,103,116
2022,2,22200087,10/29/2022,1610612763,Memphis Grizzlies,0,0,1610612762,Utah Jazz,1,1,38,23,61,12,15,27,50,38,88,11,4,15,13,27,24,8,20,104,123
2022,2,22200835,2/10/2023,1610612765,Detroit Pistons,1,1,1610612759,San Antonio Spurs,0,0,39,31,70,7,30,37,46,61,107,39,10,49,27,40,29,7,16,121,138
2022,2,22200696,1/21/2023,1610612745,Houston Rockets,0,0,1610612750,Minnesota Timberwolves,1,1,29,26,55,9,15,24,38,41,79,19,14,33,18,32,24,12,23,100,104
2017,2,21700438,12/17/2017,1610612753,Orlando Magic,0,0,1610612765,Detroit Pistons,1,1,24,28,52,17,16,33,41,44,85,11,6,17,12,34,27,11,17,98,110
2017,2,21700438,12/17/2017,1610612765,Detroit Pistons,1,1,1610612753,Orlando Magic,0,0,25,30,55,17,17,34,42,47,89,13,3,16,13,34,27,6,13,98,114
2022,2,22200088,10/30/2022,1610612740,New Orleans Pelicans,0,1,1610612746,LA Clippers,1,0,31,26,57,15,21,36,46,47,93,5,3,8,17,31,32,3,13,93,112
2016,2,21600881,2/26/2017,1610612746,LA Clippers,1,1,1610612766,Charlotte Hornets,0,0,35,30,65,10,22,32,45,52,97,24,10,34,17,41,27,1,9,103,124
2016,2,21600881,2/26/2017,1610612766,Charlotte Hornets,0,0,1610612746,LA Clippers,1,1,20,20,40,18,22,40,38,42,80,27,3,30,7,37,16,14,16,102,121
2022,2,22200088,10/30/2022,1610612746,LA Clippers,1,0,1610612740,New Orleans Pelicans,0,1,25,22,47,11,28,39,36,50,86,8,5,13,14,40,24,9,15,94,91
2021,2,22101001,3/11/2022,1610612740,New Orleans Pelicans,1,0,1610612766,Charlotte Hornets,0,1,28,19,47,15,24,39,43,43,86,19,6,25,15,32,31,11,17,100,120
2021,2,22101001,3/11/2022,1610612766,Charlotte Hornets,0,1,1610612740,New Orleans Pelicans,1,0,30,10,40,22,25,47,52,35,87,16,4,20,10,27,41,9,14,101,142
2017,2,21700437,12/17/2017,1610612758,Sacramento Kings,0,0,1610612761,Toronto Raptors,1,1,27,28,55,11,15,26,38,43,81,6,2,8,10,34,25,8,17,93,93
2017,2,21700437,12/17/2017,1610612761,Toronto Raptors,1,1,1610612758,Sacramento Kings,0,0,23,32,55,13,17,30,36,49,85,23,5,28,19,31,20,9,12,93,108
2022,2,22200121,11/4/2022,1610612748,Miami Heat,0,0,1610612754,Indiana Pacers,1,1,20,22,42,11,28,39,31,50,81,26,0,26,12,38,17,7,19,103,99
2022,2,22200089,10/30/2022,1610612738,Boston Celtics,1,1,1610612764,Washington Wizards,0,0,15,17,32,21,26,47,36,43,79,19,1,20,8,36,29,5,14,96,112
2022,2,22200121,11/4/2022,1610612754,Indiana Pacers,1,1,1610612748,Miami Heat,0,0,25,16,41,12,27,39,37,43,80,15,8,23,8,38,28,10,19,101,101
2021,2,22100682,1/20/2022,1610612742,Dallas Mavericks,1,0,1610612756,Phoenix Suns,0,1,26,22,48,11,26,37,37,48,85,16,4,20,12,38,19,13,19,100,101
2016,2,21600356,12/11/2016,1610612755,Philadelphia 76ers,0,1,1610612765,Detroit Pistons,1,0,31,20,51,7,10,17,38,30,68,14,3,17,6,24,24,15,20,89,97
2021,2,22101000,3/11/2022,1610612752,New York Knicks,0,0,1610612763,Memphis Grizzlies,1,1,28,37,65,10,15,25,38,52,90,28,9,37,17,39,23,8,16,104,114
2022,2,22200835,2/10/2023,1610612759,San Antonio Spurs,0,0,1610612765,Detroit Pistons,1,1,31,34,65,14,28,42,45,62,107,27,7,34,21,44,21,6,19,123,131
2022,2,22201001,3/10/2023,1610612751,Brooklyn Nets,0,1,1610612750,Minnesota Timberwolves,1,0,26,31,57,16,18,34,42,49,91,24,9,33,14,37,20,10,15,107,124
2021,2,22101000,3/11/2022,1610612763,Memphis Grizzlies,1,1,1610612752,New York Knicks,0,0,37,41,78,9,17,26,46,58,104,17,12,29,25,42,23,8,10,103,118
2016,2,21600356,12/11/2016,1610612765,Detroit Pistons,1,0,1610612755,Philadelphia 76ers,0,1,27,36,63,5,14,19,32,50,82,10,4,14,13,39,15,11,15,90,79
2017,2,21700436,12/16/2017,1610612738,Boston Celtics,0,1,1610612763,Memphis Grizzlies,1,0,25,25,50,14,16,30,39,41,80,10,4,14,15,28,21,8,17,87,102
2017,2,21700436,12/16/2017,1610612763,Memphis Grizzlies,1,0,1610612738,Boston Celtics,0,1,18,27,45,14,20,34,32,47,79,15,2,17,15,33,18,6,14,88,93
2014,2,21400122,11/14/2014,1610612754,Indiana Pacers,1,0,1610612743,Denver Nuggets,0,1,26,36,62,8,14,22,34,50,84,11,11,22,17,39,17,8,13,92,87
2022,2,22200802,2/5/2023,1610612766,Charlotte Hornets,1,0,1610612753,Orlando Magic,0,1,33,17,50,12,21,33,45,38,83,11,12,23,9,34,28,6,15,99,113
2022,2,22200089,10/30/2022,1610612764,Washington Wizards,0,0,1610612738,Boston Celtics,1,1,31,35,66,7,25,32,38,60,98,11,5,16,19,44,22,4,10,96,94
2021,2,22100999,3/11/2022,1610612742,Dallas Mavericks,0,1,1610612745,Houston Rockets,1,0,29,23,52,11,25,36,40,48,88,22,6,28,15,37,20,9,14,97,113
2021,2,22100999,3/11/2022,1610612745,Houston Rockets,1,0,1610612742,Dallas Mavericks,0,1,35,21,56,6,24,30,41,45,86,12,7,19,11,37,29,6,13,98,100
2022,2,22200090,10/30/2022,1610612739,Cleveland Cavaliers,1,1,1610612752,New York Knicks,0,0,18,21,39,23,27,50,41,48,89,16,3,19,14,36,33,9,14,98,121
2022,2,22200090,10/30/2022,1610612752,New York Knicks,0,0,1610612739,Cleveland Cavaliers,1,1,35,30,65,10,17,27,45,47,92,8,8,16,16,35,26,3,14,98,108
2022,2,22200120,11/4/2022,1610612739,Cleveland Cavaliers,0,1,1610612765,Detroit Pistons,1,0,33,22,55,11,15,26,44,37,81,13,3,16,13,26,30,10,19,95,112
2022,2,22200120,11/4/2022,1610612765,Detroit Pistons,1,0,1610612739,Cleveland Cavaliers,0,1,18,28,46,13,24,37,31,52,83,13,2,15,12,40,16,5,19,96,88
2021,2,22100682,1/20/2022,1610612756,Phoenix Suns,0,1,1610612742,Dallas Mavericks,1,0,31,19,50,8,28,36,39,47,86,23,2,25,7,41,25,1,7,99,109
2016,2,21600880,2/26/2017,1610612740,New Orleans Pelicans,0,0,1610612760,Oklahoma City Thunder,1,1,28,31,59,8,13,21,36,44,80,30,7,37,9,39,17,4,10,98,110
2016,2,21600880,2/26/2017,1610612760,Oklahoma City Thunder,1,1,1610612740,New Orleans Pelicans,0,0,36,31,67,6,15,21,42,46,88,28,9,37,19,31,17,10,13,98,118
2017,2,21700435,12/16/2017,1610612742,Dallas Mavericks,0,0,1610612759,San Antonio Spurs,1,1,29,23,52,10,18,28,39,41,80,8,1,9,8,33,23,5,10,87,96
2017,2,21700435,12/16/2017,1610612759,San Antonio Spurs,1,1,1610612742,Dallas Mavericks,0,0,34,27,61,5,20,25,39,47,86,15,3,18,15,34,14,4,7,88,98
2022,2,22200670,1/18/2023,1610612742,Dallas Mavericks,1,0,1610612737,Atlanta Hawks,0,1,28,14,42,16,26,42,44,40,84,18,6,24,14,29,26,7,16,98,122
2022,2,22200670,1/18/2023,1610612737,Atlanta Hawks,0,1,1610612742,Dallas Mavericks,1,0,36,24,60,13,13,26,49,37,86,19,1,20,12,25,28,5,12,97,130
2022,2,22200091,10/30/2022,1610612744,Golden State Warriors,0,0,1610612765,Detroit Pistons,1,1,27,26,53,12,27,39,39,53,92,24,1,25,16,38,23,4,15,101,114
2022,2,22201097,3/24/2023,1610612754,Indiana Pacers,0,0,1610612738,Boston Celtics,1,1,35,23,58,4,22,26,39,45,84,13,9,22,8,41,24,11,17,102,95
2020,2,22000432,2/16/2021,1610612757,Portland Trail Blazers,0,1,1610612760,Oklahoma City Thunder,1,0,22,27,49,20,27,47,42,54,96,11,6,17,17,41,26,6,10,97,115
2021,2,22100998,3/11/2022,1610612739,Cleveland Cavaliers,0,0,1610612748,Miami Heat,1,1,27,27,54,8,17,25,35,44,79,27,2,29,10,35,25,9,18,99,105
2021,2,22100998,3/11/2022,1610612748,Miami Heat,1,1,1610612739,Cleveland Cavaliers,0,0,30,21,51,11,24,35,41,45,86,24,3,27,9,37,28,5,9,99,117
2022,2,22200091,10/30/2022,1610612765,Detroit Pistons,1,1,1610612744,Golden State Warriors,0,0,26,24,50,14,19,33,40,43,83,34,4,38,15,31,24,8,16,102,128
2022,2,22200676,1/18/2023,1610612750,Minnesota Timberwolves,0,0,1610612743,Denver Nuggets,1,1,30,19,49,12,20,32,42,39,81,22,6,28,14,29,26,10,19,98,118
2017,2,21700434,12/16/2017,1610612750,Minnesota Timberwolves,1,0,1610612756,Phoenix Suns,0,1,31,37,68,9,18,27,40,55,95,17,7,24,19,40,21,4,7,99,106
2017,2,21700434,12/16/2017,1610612756,Phoenix Suns,0,1,1610612750,Minnesota Timberwolves,1,0,22,26,48,11,13,24,33,39,72,31,4,35,18,24,22,14,27,97,108
2022,2,22200119,11/3/2022,1610612743,Denver Nuggets,0,1,1610612760,Oklahoma City Thunder,1,0,27,26,53,18,13,31,45,39,84,14,2,16,9,31,32,9,20,102,122
2022,2,22200119,11/3/2022,1610612760,Oklahoma City Thunder,1,0,1610612743,Denver Nuggets,0,1,39,25,64,6,23,29,45,48,93,14,5,19,11,39,19,5,10,101,110
2022,2,22201099,3/24/2023,1610612761,Toronto Raptors,1,1,1610612765,Detroit Pistons,0,0,28,27,55,13,24,37,41,51,92,23,6,29,22,31,25,8,11,97,118
2021,2,22100997,3/11/2022,1610612738,Boston Celtics,1,1,1610612765,Detroit Pistons,0,0,36,22,58,6,26,32,42,48,90,24,6,30,19,34,23,4,9,94,114
2021,2,22100997,3/11/2022,1610612765,Detroit Pistons,0,0,1610612738,Boston Celtics,1,1,25,24,49,10,24,34,35,48,83,23,1,24,14,35,21,10,14,95,103
2017,2,21700433,12/16/2017,1610612745,Houston Rockets,1,1,1610612749,Milwaukee Bucks,0,0,24,17,41,11,24,35,35,41,76,34,8,42,8,39,16,12,15,102,115
2017,2,21700433,12/16/2017,1610612749,Milwaukee Bucks,0,0,1610612745,Houston Rockets,1,1,30,25,55,8,19,27,38,44,82,27,6,33,10,36,17,7,14,101,111
2022,2,22200677,1/18/2023,1610612747,Los Angeles Lakers,1,0,1610612758,Sacramento Kings,0,1,32,23,55,11,23,34,43,46,89,14,4,18,12,37,26,3,7,94,111
2022,2,22200802,2/5/2023,1610612753,Orlando Magic,0,1,1610612766,Charlotte Hornets,1,0,34,34,68,8,15,23,42,49,91,27,3,30,20,31,25,8,12,98,119
2020,2,22000432,2/16/2021,1610612760,Oklahoma City Thunder,1,0,1610612757,Portland Trail Blazers,0,1,27,25,52,10,23,33,37,48,85,20,7,27,10,42,23,6,11,97,104
2023,2,22300102,10/30/2023,1610612754,Indiana Pacers,1,0,1610612741,Chicago Bulls,0,1,24,18,42,12,34,46,36,52,88,21,4,25,15,38,26,8,17,103,105
2023,2,22300481,1/5/2024,1610612760,Oklahoma City Thunder,0,0,1610612751,Brooklyn Nets,1,1,36,17,53,9,22,31,45,39,84,16,8,24,9,32,29,9,13,100,115
2023,2,22300477,1/4/2024,1610612749,Milwaukee Bucks,0,1,1610612759,San Antonio Spurs,1,0,37,21,58,12,22,34,49,43,92,15,4,19,11,34,27,10,14,102,125
2022,2,22200093,10/30/2022,1610612742,Dallas Mavericks,1,1,1610612753,Orlando Magic,0,0,30,18,48,11,24,35,41,42,83,21,7,28,8,38,15,2,4,91,114
2017,2,21700432,12/16/2017,1610612746,LA Clippers,0,0,1610612748,Miami Heat,1,1,27,25,52,8,20,28,35,45,80,7,7,14,19,29,18,10,18,88,85
2017,2,21700432,12/16/2017,1610612748,Miami Heat,1,1,1610612746,LA Clippers,0,0,19,28,47,12,23,35,31,51,82,16,5,21,13,39,22,3,9,88,90
2022,2,22200118,11/3/2022,1610612744,Golden State Warriors,0,0,1610612753,Orlando Magic,1,1,31,23,54,19,24,43,50,47,97,10,5,15,15,36,31,9,14,105,129
2016,2,21600355,12/10/2016,1610612740,New Orleans Pelicans,0,0,1610612746,LA Clippers,1,1,32,32,64,8,11,19,40,43,83,17,9,26,12,35,25,10,16,99,105
2022,2,22200840,2/10/2023,1610612748,Miami Heat,1,1,1610612745,Houston Rockets,0,0,20,19,39,12,26,38,32,45,77,21,1,22,8,37,21,11,17,95,97
2022,2,22200093,10/30/2022,1610612753,Orlando Magic,0,0,1610612742,Dallas Mavericks,1,1,26,26,52,11,18,29,37,44,81,20,7,27,16,33,20,10,12,90,105
2016,2,21600355,12/10/2016,1610612746,LA Clippers,1,1,1610612740,New Orleans Pelicans,0,0,37,21,58,17,19,36,54,40,94,8,1,9,10,31,34,3,10,98,133
2022,2,22200848,2/11/2023,1610612748,Miami Heat,0,1,1610612753,Orlando Magic,1,0,25,21,46,12,27,39,37,48,85,21,2,23,17,33,24,12,20,103,107
2022,2,22200118,11/3/2022,1610612753,Orlando Magic,1,1,1610612744,Golden State Warriors,0,0,29,19,48,13,17,30,42,36,78,33,13,46,15,28,20,5,19,103,130
2021,2,22100681,1/20/2022,1610612740,New Orleans Pelicans,0,1,1610612752,New York Knicks,1,0,27,21,48,11,17,28,38,38,76,15,7,22,5,35,27,6,12,93,102
2014,2,21401050,3/23/2015,1610612763,Memphis Grizzlies,0,1,1610612752,New York Knicks,1,0,34,33,67,7,5,12,41,38,79,14,5,19,10,30,22,4,10,87,103
2014,2,21400489,1/2/2015,1610612760,Oklahoma City Thunder,1,1,1610612764,Washington Wizards,0,0,36,28,64,8,11,19,44,39,83,13,6,19,7,34,21,3,10,94,109
2014,2,21400489,1/2/2015,1610612764,Washington Wizards,0,0,1610612760,Oklahoma City Thunder,1,1,28,35,63,11,10,21,39,45,84,13,2,15,11,36,27,8,15,95,102
2017,2,21700431,12/16/2017,1610612752,New York Knicks,1,1,1610612760,Oklahoma City Thunder,0,0,24,22,46,14,9,23,38,31,69,21,5,26,9,27,21,9,16,90,111
2017,2,21700431,12/16/2017,1610612760,Oklahoma City Thunder,0,0,1610612752,New York Knicks,1,1,24,34,58,12,15,27,36,49,85,12,8,20,19,34,18,9,14,90,96
2022,2,22200117,11/2/2022,1610612740,New Orleans Pelicans,0,0,1610612747,Los Angeles Lakers,1,1,39,38,77,8,17,25,47,55,102,15,6,21,12,46,35,6,14,113,117
2022,2,22200117,11/2/2022,1610612747,Los Angeles Lakers,1,1,1610612740,New Orleans Pelicans,0,0,35,27,62,10,26,36,45,53,98,20,3,23,13,42,30,10,18,114,120
2016,2,21600879,2/26/2017,1610612738,Boston Celtics,0,1,1610612765,Detroit Pistons,1,0,22,28,50,12,23,35,34,51,85,24,6,30,16,36,22,8,16,100,104
2022,2,22200672,1/18/2023,1610612763,Memphis Grizzlies,1,1,1610612739,Cleveland Cavaliers,0,0,33,30,63,11,23,34,44,53,97,16,6,22,21,36,22,4,8,97,115
2022,2,22200676,1/18/2023,1610612743,Denver Nuggets,1,1,1610612750,Minnesota Timberwolves,0,0,37,27,64,8,13,21,45,40,85,24,8,32,17,27,27,6,16,98,122
2022,2,22200696,1/21/2023,1610612750,Minnesota Timberwolves,1,1,1610612745,Houston Rockets,0,0,21,21,42,17,24,41,38,45,83,20,4,24,5,42,20,4,12,102,113
2022,2,22200819,2/7/2023,1610612763,Memphis Grizzlies,1,1,1610612741,Chicago Bulls,0,0,28,20,48,11,22,33,39,42,81,15,6,21,5,40,22,9,14,99,104
2022,2,22200848,2/11/2023,1610612753,Orlando Magic,1,0,1610612748,Miami Heat,0,1,26,32,58,11,18,29,37,50,87,18,5,23,15,37,22,7,18,103,103
2022,2,22200841,2/10/2023,1610612750,Minnesota Timberwolves,0,0,1610612763,Memphis Grizzlies,1,1,26,25,51,15,22,37,41,47,88,10,2,12,10,38,25,12,18,104,107
2022,2,22200915,2/26/2023,1610612760,Oklahoma City Thunder,1,0,1610612758,Sacramento Kings,0,1,25,21,46,16,24,40,41,45,86,17,6,23,12,36,24,7,14,100,115
2022,2,22201097,3/24/2023,1610612738,Boston Celtics,1,1,1610612754,Indiana Pacers,0,0,26,25,51,18,24,42,44,49,93,14,5,19,12,40,28,9,15,104,120
2022,2,22200095,10/30/2022,1610612743,Denver Nuggets,0,0,1610612747,Los Angeles Lakers,1,1,26,30,56,15,25,40,41,55,96,13,5,18,16,41,24,5,9,99,110
2022,2,22200677,1/18/2023,1610612758,Sacramento Kings,0,1,1610612747,Los Angeles Lakers,1,0,34,23,57,9,21,30,43,44,87,21,6,27,15,32,23,9,11,94,116
2022,2,22200672,1/18/2023,1610612739,Cleveland Cavaliers,0,0,1610612763,Memphis Grizzlies,1,1,26,21,47,16,19,35,42,40,82,14,7,21,15,30,29,10,19,96,114
2017,2,21700430,12/16/2017,1610612739,Cleveland Cavaliers,1,1,1610612762,Utah Jazz,0,0,32,25,57,10,12,22,42,37,79,15,2,17,10,28,30,9,12,91,109
2017,2,21700430,12/16/2017,1610612762,Utah Jazz,0,0,1610612739,Cleveland Cavaliers,1,1,20,27,47,17,17,34,37,44,81,9,5,14,11,35,24,9,12,89,100
2016,2,21600879,2/26/2017,1610612765,Detroit Pistons,1,0,1610612738,Boston Celtics,0,1,23,25,48,12,21,33,35,46,81,16,19,35,13,44,22,9,17,100,98
2022,2,22201017,3/12/2023,1610612740,New Orleans Pelicans,1,1,1610612757,Portland Trail Blazers,0,0,24,22,46,19,21,40,43,43,86,22,7,29,10,37,35,10,15,105,127
2022,2,22200851,2/11/2023,1610612752,New York Knicks,1,1,1610612762,Utah Jazz,0,0,31,28,59,12,24,36,43,52,95,28,10,38,23,33,18,3,6,97,126
2022,2,22201016,3/12/2023,1610612755,Philadelphia 76ers,1,1,1610612764,Washington Wizards,0,0,30,21,51,11,18,29,41,39,80,19,4,23,11,29,29,4,9,91,112
2022,2,22200095,10/30/2022,1610612747,Los Angeles Lakers,1,1,1610612743,Denver Nuggets,0,0,33,33,66,13,17,30,46,50,96,16,4,20,16,36,24,3,9,98,121
2022,2,22200094,10/30/2022,1610612745,Houston Rockets,0,0,1610612756,Phoenix Suns,1,1,27,26,53,11,23,34,38,49,87,22,4,26,19,32,18,9,15,95,109
2017,2,21700429,12/16/2017,1610612757,Portland Trail Blazers,0,1,1610612766,Charlotte Hornets,1,0,27,28,55,10,14,24,37,42,79,9,9,18,9,38,19,9,20,98,93
2023,2,22300093,10/28/2023,1610612750,Minnesota Timberwolves,1,1,1610612748,Miami Heat,0,0,32,20,52,12,22,34,44,42,86,6,2,8,9,35,30,6,16,98,106
2023,2,22300039,11/21/2023,1610612754,Indiana Pacers,0,1,1610612737,Atlanta Hawks,1,0,35,14,49,22,23,45,57,37,94,21,7,28,12,28,35,8,14,110,157
2022,2,22200094,10/30/2022,1610612756,Phoenix Suns,1,1,1610612745,Houston Rockets,0,0,33,11,44,12,28,40,45,39,84,22,8,30,12,32,29,7,12,95,124
2022,2,22200915,2/26/2023,1610612758,Sacramento Kings,0,1,1610612760,Oklahoma City Thunder,1,0,27,15,42,18,25,43,45,40,85,16,8,24,15,29,32,10,20,100,124
2022,2,22201016,3/12/2023,1610612764,Washington Wizards,0,0,1610612755,Philadelphia 76ers,1,1,28,30,58,6,20,26,34,50,84,19,4,23,13,39,19,6,10,91,93
2022,2,22200096,10/31/2022,1610612758,Sacramento Kings,0,1,1610612766,Charlotte Hornets,1,0,20,21,41,17,27,44,37,48,85,24,4,28,16,32,26,11,19,100,115
2022,2,22200096,10/31/2022,1610612766,Charlotte Hornets,1,0,1610612758,Sacramento Kings,0,1,29,26,55,14,15,29,43,41,84,8,6,14,11,34,31,8,21,101,108
2022,2,22200671,1/18/2023,1610612766,Charlotte Hornets,0,1,1610612745,Houston Rockets,1,0,39,21,60,9,27,36,48,48,96,17,8,25,13,39,27,4,10,105,122
2022,2,22200097,10/31/2022,1610612755,Philadelphia 76ers,0,1,1610612764,Washington Wizards,1,0,34,19,53,12,18,30,46,37,83,14,6,20,7,34,26,8,14,97,118
2017,2,21700429,12/16/2017,1610612766,Charlotte Hornets,1,0,1610612757,Portland Trail Blazers,0,1,26,39,65,7,24,31,33,63,96,18,10,28,19,48,18,2,7,100,91
2022,2,22200674,1/18/2023,1610612760,Oklahoma City Thunder,1,1,1610612754,Indiana Pacers,0,0,31,24,55,16,22,38,47,46,93,16,5,21,16,33,41,9,19,105,126
2022,2,22200097,10/31/2022,1610612764,Washington Wizards,1,0,1610612755,Philadelphia 76ers,0,1,28,28,56,10,15,25,38,43,81,25,1,26,9,34,22,14,16,98,111
2022,2,22200098,10/31/2022,1610612751,Brooklyn Nets,1,1,1610612754,Indiana Pacers,0,0,32,18,50,11,19,30,43,37,80,19,1,20,8,30,26,11,20,104,116
2022,2,22200098,10/31/2022,1610612754,Indiana Pacers,0,0,1610612751,Brooklyn Nets,1,1,30,18,48,11,28,39,41,46,87,16,7,23,17,34,23,11,24,105,109
2022,2,22200100,10/31/2022,1610612749,Milwaukee Bucks,1,1,1610612765,Detroit Pistons,0,0,27,20,47,11,29,40,38,49,87,23,6,29,18,33,20,9,16,99,110
2017,2,21700428,12/15/2017,1610612745,Houston Rockets,1,1,1610612759,San Antonio Spurs,0,0,25,16,41,18,32,50,43,48,91,20,5,25,17,32,20,10,14,100,124
2022,2,22200100,10/31/2022,1610612765,Detroit Pistons,0,0,1610612749,Milwaukee Bucks,1,1,33,30,63,8,21,29,41,51,92,18,3,21,16,36,19,5,12,99,108
2022,2,22200099,10/31/2022,1610612737,Atlanta Hawks,0,0,1610612761,Toronto Raptors,1,1,28,27,55,11,18,29,39,45,84,20,5,25,12,35,28,13,18,101,109
2022,2,22200099,10/31/2022,1610612761,Toronto Raptors,1,1,1610612737,Atlanta Hawks,0,0,32,26,58,14,20,34,46,46,92,33,7,40,16,33,25,1,7,103,139
2022,2,22200102,10/31/2022,1610612745,Houston Rockets,0,0,1610612746,LA Clippers,1,1,26,34,60,8,20,28,34,54,88,17,6,23,16,41,17,7,15,99,93
2017,2,21700428,12/15/2017,1610612759,San Antonio Spurs,0,0,1610612745,Houston Rockets,1,1,36,32,68,10,16,26,46,48,94,7,6,13,16,37,22,15,17,100,109
2021,2,22100681,1/20/2022,1610612752,New York Knicks,1,0,1610612740,New Orleans Pelicans,0,1,20,19,39,9,29,38,29,48,77,24,12,36,17,35,21,10,15,94,91
2020,2,22000431,2/16/2021,1610612747,Los Angeles Lakers,0,1,1610612750,Minnesota Timberwolves,1,0,31,20,51,11,15,26,42,35,77,17,4,21,8,30,20,11,18,96,112
2020,2,22000431,2/16/2021,1610612750,Minnesota Timberwolves,1,0,1610612747,Los Angeles Lakers,0,1,23,36,59,16,18,34,39,54,93,10,3,13,19,36,26,8,15,97,104
2016,2,21600354,12/10/2016,1610612758,Sacramento Kings,0,0,1610612762,Utah Jazz,1,1,25,39,64,9,17,26,34,56,90,7,6,13,18,42,17,9,10,89,84
2016,2,21600354,12/10/2016,1610612762,Utah Jazz,1,1,1610612758,Sacramento Kings,0,0,24,24,48,13,16,29,37,40,77,17,1,18,18,23,23,10,22,89,104
2016,2,21600011,10/26/2016,1610612755,Philadelphia 76ers,1,0,1610612760,Oklahoma City Thunder,0,1,29,31,60,7,17,24,36,48,84,18,7,25,12,40,21,7,14,99,97
2020,2,22000734,4/1/2021,1610612740,New Orleans Pelicans,1,0,1610612753,Orlando Magic,0,1,29,35,64,12,17,29,41,52,93,16,3,19,14,40,26,17,25,113,110
2020,2,22000734,4/1/2021,1610612753,Orlando Magic,0,1,1610612740,New Orleans Pelicans,1,0,40,41,81,5,20,25,45,61,106,20,3,23,16,46,20,7,11,112,115
2022,2,22200674,1/18/2023,1610612754,Indiana Pacers,0,0,1610612760,Oklahoma City Thunder,1,1,27,34,61,12,21,33,39,55,94,16,8,24,27,31,23,12,24,104,106
2022,2,22200102,10/31/2022,1610612746,LA Clippers,1,1,1610612745,Houston Rockets,0,0,28,23,51,9,27,36,37,50,87,12,5,17,12,40,23,9,14,98,95
2021,2,22100996,3/11/2022,1610612737,Atlanta Hawks,1,1,1610612746,LA Clippers,0,0,34,25,59,9,22,31,43,47,90,17,2,19,17,30,28,7,10,92,112
2021,2,22100996,3/11/2022,1610612746,LA Clippers,0,0,1610612737,Atlanta Hawks,1,1,28,22,50,12,20,32,40,42,82,14,3,17,10,34,22,5,12,93,106
2016,2,21600878,2/26/2017,1610612757,Portland Trail Blazers,0,0,1610612761,Toronto Raptors,1,1,26,32,58,9,12,21,35,44,79,27,8,35,12,35,16,7,11,96,106
2022,2,22200673,1/18/2023,1610612748,Miami Heat,0,1,1610612740,New Orleans Pelicans,1,0,38,21,59,12,23,35,50,44,94,12,4,16,16,30,37,5,11,95,124
2022,2,22200747,1/28/2023,1610612764,Washington Wizards,0,1,1610612740,New Orleans Pelicans,1,0,29,23,52,11,25,36,40,48,88,22,7,29,19,34,18,9,18,100,113
2016,2,21600878,2/26/2017,1610612761,Toronto Raptors,1,1,1610612757,Portland Trail Blazers,0,0,35,23,58,7,13,20,42,36,78,21,6,27,7,32,16,6,10,95,112
2022,2,22200851,2/11/2023,1610612762,Utah Jazz,0,0,1610612752,New York Knicks,1,1,36,20,56,9,23,32,45,43,88,21,7,28,13,34,23,6,12,98,120
2022,2,22200103,11/1/2022,1610612741,Chicago Bulls,0,1,1610612751,Brooklyn Nets,1,0,27,32,59,12,18,30,39,50,89,18,3,21,15,36,20,4,10,95,108
2022,2,22200103,11/1/2022,1610612751,Brooklyn Nets,1,0,1610612741,Chicago Bulls,0,1,24,18,42,12,20,32,36,38,74,15,4,19,7,33,27,8,18,94,99
2023,2,22300103,10/30/2023,1610612764,Washington Wizards,1,0,1610612738,Boston Celtics,0,1,28,23,51,11,25,36,39,48,87,18,8,26,13,38,26,11,15,102,107
2023,2,22300328,12/15/2023,1610612754,Indiana Pacers,0,0,1610612764,Washington Wizards,1,1,33,34,67,15,25,40,48,59,107,12,4,16,18,42,35,7,15,111,123
2017,2,21700427,12/15/2017,1610612740,New Orleans Pelicans,0,0,1610612743,Denver Nuggets,1,1,28,29,57,15,19,34,43,48,91,10,4,14,10,39,27,12,20,109,111
2017,2,21700427,12/15/2017,1610612743,Denver Nuggets,1,1,1610612740,New Orleans Pelicans,0,0,30,34,64,16,20,36,46,54,100,9,5,14,15,41,30,8,15,108,117
2022,2,22200673,1/18/2023,1610612740,New Orleans Pelicans,1,0,1610612748,Miami Heat,0,1,24,26,50,13,17,30,37,43,80,11,7,18,12,36,27,11,18,94,98
2021,2,22100680,1/19/2022,1610612747,Los Angeles Lakers,1,0,1610612754,Indiana Pacers,0,1,29,27,56,11,23,34,40,50,90,13,5,18,18,35,23,6,11,94,104
2021,2,22100680,1/19/2022,1610612754,Indiana Pacers,0,1,1610612747,Los Angeles Lakers,1,0,33,27,60,11,19,30,44,46,90,12,3,15,16,32,28,4,13,92,111
2014,2,21401049,3/23/2015,1610612738,Boston Celtics,0,1,1610612751,Brooklyn Nets,1,0,41,29,70,6,16,22,47,45,92,10,4,14,11,36,25,7,10,96,110
2022,2,22200104,11/1/2022,1610612744,Golden State Warriors,0,0,1610612748,Miami Heat,1,1,21,14,35,18,31,49,39,45,84,13,4,17,14,34,31,7,20,98,109
2023,2,22300101,10/30/2023,1610612766,Charlotte Hornets,1,0,1610612751,Brooklyn Nets,0,1,39,26,65,8,23,31,47,49,96,19,1,20,11,39,33,4,10,105,121
2022,2,22200820,2/7/2023,1610612743,Denver Nuggets,1,1,1610612750,Minnesota Timberwolves,0,0,45,21,66,13,14,27,58,35,93,17,5,22,9,29,44,6,11,105,146
2022,2,22200715,1/24/2023,1610612752,New York Knicks,1,1,1610612739,Cleveland Cavaliers,0,0,20,22,42,17,16,33,37,38,75,14,7,21,11,33,25,8,17,91,105
2017,2,21700426,12/15/2017,1610612741,Chicago Bulls,0,1,1610612749,Milwaukee Bucks,1,0,34,30,64,8,14,22,42,44,86,23,12,35,17,35,24,6,12,95,115
2017,2,21700426,12/15/2017,1610612749,Milwaukee Bucks,1,0,1610612741,Chicago Bulls,0,1,31,19,50,9,24,33,40,43,83,20,9,29,12,36,24,8,11,96,109
2016,2,21600011,10/26/2016,1610612760,Oklahoma City Thunder,0,1,1610612755,Philadelphia 76ers,1,0,33,39,72,6,16,22,39,55,94,19,7,26,18,41,19,5,10,100,103
2022,2,22200748,1/28/2023,1610612759,San Antonio Spurs,1,0,1610612756,Phoenix Suns,0,1,38,42,80,10,19,29,48,61,109,12,5,17,25,39,32,7,13,105,118
2022,2,22200819,2/7/2023,1610612741,Chicago Bulls,0,0,1610612763,Memphis Grizzlies,1,1,25,27,52,7,28,35,32,55,87,18,9,27,21,40,24,10,20,99,89
2022,2,22200104,11/1/2022,1610612748,Miami Heat,1,1,1610612744,Golden State Warriors,0,0,24,22,46,16,26,42,40,48,88,20,0,20,14,34,32,8,15,98,116
2022,2,22200820,2/7/2023,1610612750,Minnesota Timberwolves,0,0,1610612743,Denver Nuggets,1,1,30,20,50,10,25,35,40,45,85,22,4,26,9,38,24,12,17,105,112
2021,2,22100995,3/11/2022,1610612750,Minnesota Timberwolves,0,0,1610612753,Orlando Magic,1,1,26,19,45,15,30,45,41,49,90,13,0,13,7,42,24,4,9,97,110
2021,2,22100995,3/11/2022,1610612753,Orlando Magic,1,1,1610612750,Minnesota Timberwolves,0,0,24,22,46,16,24,40,40,46,86,22,3,25,14,33,31,8,12,97,118
2022,2,22200849,2/11/2023,1610612754,Indiana Pacers,0,0,1610612764,Washington Wizards,1,1,29,26,55,14,26,40,43,52,95,13,4,17,22,33,27,5,8,89,113
2021,2,22100679,1/19/2022,1610612758,Sacramento Kings,1,0,1610612765,Detroit Pistons,0,1,32,25,57,12,15,27,44,40,84,31,13,44,14,34,22,3,7,99,131
2022,2,22200916,2/26/2023,1610612750,Minnesota Timberwolves,0,0,1610612744,Golden State Warriors,1,1,21,24,45,17,28,45,38,52,90,11,10,21,15,42,26,11,16,103,104
2017,2,21700425,12/15/2017,1610612737,Atlanta Hawks,0,0,1610612763,Memphis Grizzlies,1,1,22,24,46,12,19,31,34,43,77,14,2,16,9,35,27,12,17,96,94
2022,2,22200105,11/1/2022,1610612753,Orlando Magic,0,0,1610612760,Oklahoma City Thunder,1,1,29,29,58,10,19,29,39,48,87,20,0,20,15,33,20,13,25,106,108
2022,2,22200105,11/1/2022,1610612760,Oklahoma City Thunder,1,1,1610612753,Orlando Magic,0,0,35,26,61,10,24,34,45,50,95,16,4,20,13,40,28,7,17,106,116
2022,2,22200106,11/1/2022,1610612750,Minnesota Timberwolves,0,0,1610612756,Phoenix Suns,1,1,24,29,53,13,21,34,37,50,87,20,4,24,19,33,24,9,18,98,107
2022,2,22200106,11/1/2022,1610612756,Phoenix Suns,1,1,1610612750,Minnesota Timberwolves,0,0,24,22,46,17,26,43,41,48,89,17,5,22,13,36,31,5,11,98,116
2021,2,22100679,1/19/2022,1610612765,Detroit Pistons,0,1,1610612758,Sacramento Kings,1,0,31,24,55,15,21,36,46,45,91,26,4,30,17,31,27,4,9,99,133
2020,2,22000430,2/16/2021,1610612749,Milwaukee Bucks,1,0,1610612761,Toronto Raptors,0,1,26,20,46,14,23,37,40,43,83,19,6,25,7,38,25,8,17,106,113
2017,2,21700425,12/15/2017,1610612763,Memphis Grizzlies,1,1,1610612737,Atlanta Hawks,0,0,24,29,53,12,13,25,36,42,78,12,5,17,13,31,21,12,22,94,96
2023,2,22300103,10/30/2023,1610612738,Boston Celtics,0,1,1610612764,Washington Wizards,1,0,32,17,49,19,34,53,51,51,102,5,2,7,20,32,31,12,18,103,126
2022,2,22200108,11/2/2022,1610612755,Philadelphia 76ers,1,0,1610612764,Washington Wizards,0,1,20,28,48,19,17,36,39,45,84,14,6,20,9,39,25,4,8,93,111
2017,2,21700424,12/15/2017,1610612751,Brooklyn Nets,0,0,1610612761,Toronto Raptors,1,1,25,28,53,7,16,23,32,44,76,16,3,19,11,35,15,11,24,98,87
2022,2,22200821,2/7/2023,1610612747,Los Angeles Lakers,1,0,1610612760,Oklahoma City Thunder,0,1,35,19,54,14,17,31,49,36,85,18,8,26,9,32,27,12,21,109,130
2022,2,22200108,11/2/2022,1610612764,Washington Wizards,0,1,1610612755,Philadelphia 76ers,1,0,40,17,57,5,16,21,45,33,78,26,6,32,7,28,27,3,8,92,121
2022,2,22200918,2/26/2023,1610612743,Denver Nuggets,1,1,1610612746,LA Clippers,0,0,36,21,57,13,26,39,49,47,96,23,8,31,17,34,35,11,16,109,134
2022,2,22200671,1/18/2023,1610612745,Houston Rockets,1,0,1610612766,Charlotte Hornets,0,1,36,23,59,10,22,32,46,45,91,15,5,20,16,30,21,14,20,105,117
2017,2,21700424,12/15/2017,1610612761,Toronto Raptors,1,1,1610612751,Brooklyn Nets,0,0,47,22,69,7,21,28,54,43,97,5,4,9,13,32,26,4,10,97,120
2016,2,21600877,2/26/2017,1610612762,Utah Jazz,0,1,1610612764,Washington Wizards,1,0,23,25,48,11,13,24,34,38,72,23,9,32,13,28,18,16,25,98,102
2022,2,22200895,2/24/2023,1610612764,Washington Wizards,1,0,1610612752,New York Knicks,0,1,20,15,35,19,25,44,39,40,79,12,0,12,9,31,25,9,19,97,109
2022,2,22200109,11/2/2022,1610612748,Miami Heat,1,1,1610612758,Sacramento Kings,0,0,33,22,55,11,23,34,44,45,89,11,2,13,10,36,27,4,11,95,110
2016,2,21600877,2/26/2017,1610612764,Washington Wizards,1,0,1610612762,Utah Jazz,0,1,29,36,65,8,14,22,37,50,87,10,3,13,12,41,21,10,16,100,92
2017,2,21700423,12/15/2017,1610612738,Boston Celtics,1,0,1610612762,Utah Jazz,0,1,26,29,55,9,22,31,35,51,86,16,3,19,7,46,20,6,9,98,95
2022,2,22200821,2/7/2023,1610612760,Oklahoma City Thunder,0,1,1610612747,Los Angeles Lakers,1,0,32,28,60,17,17,34,49,45,94,18,2,20,9,37,32,8,13,109,133
2022,2,22201116,3/26/2023,1610612759,San Antonio Spurs,0,0,1610612738,Boston Celtics,1,1,28,33,61,8,28,36,36,61,97,13,5,18,7,58,22,4,10,109,93
2022,2,22200109,11/2/2022,1610612758,Sacramento Kings,0,0,1610612748,Miami Heat,1,1,28,22,50,13,23,36,41,45,86,12,2,14,9,38,29,5,12,95,107
2021,2,22100678,1/19/2022,1610612743,Denver Nuggets,1,1,1610612746,LA Clippers,0,0,35,25,60,13,25,38,48,50,98,21,4,25,17,35,32,6,12,102,130
2021,2,22100678,1/19/2022,1610612746,LA Clippers,0,0,1610612743,Denver Nuggets,1,1,37,21,58,15,24,39,52,45,97,9,3,12,15,31,35,9,14,102,128
2021,2,22100994,3/10/2022,1610612743,Denver Nuggets,1,0,1610612744,Golden State Warriors,0,1,28,25,53,7,24,31,35,49,84,25,7,32,17,34,19,9,13,95,102
2021,2,22100994,3/10/2022,1610612744,Golden State Warriors,0,1,1610612743,Denver Nuggets,1,0,28,18,46,14,28,42,42,46,88,15,5,20,8,40,26,5,8,94,113
2017,2,21700423,12/15/2017,1610612762,Utah Jazz,0,1,1610612738,Boston Celtics,1,0,27,31,58,13,12,25,40,43,83,14,4,18,10,34,19,10,16,96,107
2022,2,22200916,2/26/2023,1610612744,Golden State Warriors,1,1,1610612750,Minnesota Timberwolves,0,0,24,25,49,15,27,42,39,52,91,16,6,22,19,36,23,11,18,101,109
2022,2,22200847,2/11/2023,1610612766,Charlotte Hornets,1,0,1610612743,Denver Nuggets,0,1,32,21,53,8,24,32,40,45,85,17,12,29,9,41,25,7,14,105,105
2022,2,22200107,11/2/2022,1610612738,Boston Celtics,0,0,1610612739,Cleveland Cavaliers,1,1,27,25,52,11,30,41,38,55,93,26,1,27,12,43,26,6,14,108,113
2016,2,21600353,12/10/2016,1610612751,Brooklyn Nets,0,0,1610612759,San Antonio Spurs,1,1,29,31,60,7,20,27,36,51,87,22,3,25,12,42,21,11,16,102,101
2016,2,21600353,12/10/2016,1610612759,San Antonio Spurs,1,1,1610612751,Brooklyn Nets,0,0,36,32,68,14,12,26,50,44,94,16,2,18,10,36,38,6,10,101,130
2022,2,22201017,3/12/2023,1610612757,Portland Trail Blazers,0,0,1610612740,New Orleans Pelicans,1,1,33,22,55,10,23,33,43,45,88,14,6,20,12,37,26,11,19,105,110
2022,2,22200748,1/28/2023,1610612756,Phoenix Suns,0,1,1610612759,San Antonio Spurs,1,0,42,37,79,8,16,24,50,53,103,20,6,26,20,36,31,6,9,105,128
2022,2,22200850,2/11/2023,1610612759,San Antonio Spurs,0,0,1610612737,Atlanta Hawks,1,1,29,28,57,11,26,37,40,54,94,15,2,17,18,37,25,9,20,105,106
2014,2,21400121,11/13/2014,1610612744,Golden State Warriors,1,1,1610612751,Brooklyn Nets,0,0,30,26,56,11,23,34,41,49,90,14,7,21,15,37,30,5,11,95,107
2022,2,22200107,11/2/2022,1610612739,Cleveland Cavaliers,1,1,1610612738,Boston Celtics,0,0,31,30,61,11,28,39,42,58,100,19,5,24,12,47,24,5,11,110,114
2014,2,21400121,11/13/2014,1610612751,Brooklyn Nets,0,0,1610612744,Golden State Warriors,1,1,36,37,73,3,13,16,39,50,89,18,2,20,15,36,19,7,12,96,99
2022,2,22200110,11/2/2022,1610612737,Atlanta Hawks,0,1,1610612752,New York Knicks,1,0,32,41,73,12,22,34,44,63,107,12,4,16,24,42,28,3,9,100,112
2022,2,22200847,2/11/2023,1610612743,Denver Nuggets,0,1,1610612766,Charlotte Hornets,1,0,45,31,76,5,18,23,50,49,99,14,3,17,17,34,35,11,14,105,119
2022,2,22200841,2/10/2023,1610612763,Memphis Grizzlies,1,1,1610612750,Minnesota Timberwolves,0,0,39,20,59,10,15,25,49,35,84,20,7,27,10,29,27,7,19,104,128
2016,2,21600876,2/26/2017,1610612743,Denver Nuggets,1,0,1610612763,Memphis Grizzlies,0,1,26,24,50,11,23,34,37,47,84,13,4,17,13,36,26,9,13,93,98
2016,2,21600876,2/26/2017,1610612763,Memphis Grizzlies,0,1,1610612743,Denver Nuggets,1,0,25,22,47,11,22,33,36,44,80,22,3,25,16,30,21,9,15,93,105
2021,2,22100677,1/19/2022,1610612745,Houston Rockets,0,1,1610612762,Utah Jazz,1,0,19,32,51,22,23,45,41,55,96,12,5,17,17,40,24,7,9,94,116
2021,2,22100677,1/19/2022,1610612762,Utah Jazz,1,0,1610612745,Houston Rockets,0,1,32,19,51,10,28,38,42,47,89,17,3,20,14,35,26,4,9,95,111
2021,2,22100993,3/10/2022,1610612751,Brooklyn Nets,0,1,1610612755,Philadelphia 76ers,1,0,33,18,51,18,22,40,51,40,91,9,8,17,11,34,29,5,12,99,129
2021,2,22100993,3/10/2022,1610612755,Philadelphia 76ers,1,0,1610612751,Brooklyn Nets,0,1,16,41,57,14,22,36,30,63,93,26,4,30,29,37,19,13,20,98,100
2022,2,22200746,1/28/2023,1610612758,Sacramento Kings,0,0,1610612750,Minnesota Timberwolves,1,1,28,21,49,9,24,33,37,45,82,27,9,36,12,37,23,5,9,100,110
2017,2,21700422,12/15/2017,1610612746,LA Clippers,0,0,1610612764,Washington Wizards,1,1,26,36,62,7,17,24,33,53,86,18,11,29,16,42,17,12,20,105,91
2017,2,21700422,12/15/2017,1610612764,Washington Wizards,1,1,1610612746,LA Clippers,0,0,32,25,57,7,24,31,39,49,88,14,8,22,14,38,21,12,19,104,99
2021,2,22100676,1/19/2022,1610612759,San Antonio Spurs,1,1,1610612760,Oklahoma City Thunder,0,0,32,24,56,15,25,40,47,49,96,9,5,14,13,38,32,5,9,99,118
2021,2,22100992,3/9/2022,1610612746,LA Clippers,1,1,1610612764,Washington Wizards,0,0,27,27,54,16,16,32,43,43,86,13,0,13,9,34,21,10,12,96,115
2021,2,22100992,3/9/2022,1610612764,Washington Wizards,0,0,1610612746,LA Clippers,1,1,31,29,60,10,17,27,41,46,87,17,3,20,13,35,26,6,13,96,109
2022,2,22200110,11/2/2022,1610612752,New York Knicks,1,0,1610612737,Atlanta Hawks,0,1,27,27,54,10,26,36,37,53,90,15,5,20,16,38,23,11,17,100,99
2016,2,21600010,10/26/2016,1610612740,New Orleans Pelicans,1,0,1610612743,Denver Nuggets,0,1,35,38,73,3,16,19,38,54,92,23,3,26,6,49,31,7,11,109,102
2016,2,21600010,10/26/2016,1610612743,Denver Nuggets,0,1,1610612740,New Orleans Pelicans,1,0,29,30,59,8,16,24,37,46,83,25,8,33,14,34,18,16,25,110,107
2023,2,22300255,11/27/2023,1610612747,Los Angeles Lakers,0,0,1610612755,Philadelphia 76ers,1,1,32,23,55,7,21,28,39,44,83,9,4,13,10,36,23,11,17,95,94
2022,2,22200918,2/26/2023,1610612746,LA Clippers,0,0,1610612743,Denver Nuggets,1,1,33,23,56,11,23,34,44,46,90,25,5,30,7,44,24,10,13,108,124
2023,2,22300250,11/26/2023,1610612751,Brooklyn Nets,1,1,1610612741,Chicago Bulls,0,0,16,14,30,25,28,53,41,42,83,11,4,15,10,34,29,3,11,91,118
2022,2,22200850,2/11/2023,1610612737,Atlanta Hawks,1,1,1610612759,San Antonio Spurs,0,0,40,37,77,10,16,26,50,53,103,15,4,19,18,38,29,9,10,104,125
2022,2,22200714,1/24/2023,1610612738,Boston Celtics,0,0,1610612748,Miami Heat,1,1,22,20,42,10,22,32,32,42,74,21,6,27,8,37,21,7,17,94,95
2022,2,22200746,1/28/2023,1610612750,Minnesota Timberwolves,1,1,1610612758,Sacramento Kings,0,0,25,18,43,17,20,37,42,38,80,16,5,21,13,26,25,5,20,98,117
2016,2,21600875,2/26/2017,1610612749,Milwaukee Bucks,1,1,1610612756,Phoenix Suns,0,0,33,23,56,6,14,20,39,37,76,16,2,18,7,32,26,12,20,97,100
2016,2,21600875,2/26/2017,1610612756,Phoenix Suns,0,0,1610612749,Milwaukee Bucks,1,1,35,34,69,5,9,14,40,43,83,11,5,16,14,32,26,10,21,99,96
2021,2,22100991,3/9/2022,1610612743,Denver Nuggets,0,1,1610612758,Sacramento Kings,1,0,31,16,47,9,26,35,40,42,82,17,2,19,13,31,26,11,20,98,106
2021,2,22100991,3/9/2022,1610612758,Sacramento Kings,1,0,1610612743,Denver Nuggets,0,1,26,25,51,12,22,34,38,47,85,12,6,18,9,41,24,11,16,98,100
2022,2,22200111,11/2/2022,1610612766,Charlotte Hornets,0,0,1610612741,Chicago Bulls,1,1,29,31,60,7,25,32,36,56,92,9,7,16,16,44,22,6,17,100,88
2021,2,22100676,1/19/2022,1610612760,Oklahoma City Thunder,0,0,1610612759,San Antonio Spurs,1,1,30,37,67,8,23,31,38,60,98,12,3,15,21,41,20,9,15,101,96
2020,2,22000430,2/16/2021,1610612761,Toronto Raptors,0,1,1610612749,Milwaukee Bucks,1,0,29,19,48,17,26,43,46,45,91,15,6,21,11,36,25,10,15,105,124
2021,2,22100990,3/9/2022,1610612757,Portland Trail Blazers,0,0,1610612762,Utah Jazz,1,1,20,33,53,9,27,36,29,60,89,18,4,22,15,47,19,3,10,96,85
2021,2,22100990,3/9/2022,1610612762,Utah Jazz,1,1,1610612757,Portland Trail Blazers,0,0,25,10,35,17,29,46,42,39,81,22,5,27,10,30,31,4,9,96,123
2017,2,21700421,12/15/2017,1610612755,Philadelphia 76ers,1,0,1610612760,Oklahoma City Thunder,0,1,31,23,54,13,33,46,44,56,100,16,4,20,11,47,35,10,20,118,117
2017,2,21700421,12/15/2017,1610612760,Oklahoma City Thunder,0,1,1610612755,Philadelphia 76ers,1,0,32,46,78,15,20,35,47,66,113,10,9,19,21,49,28,13,18,120,119
2017,2,21700420,12/15/2017,1610612753,Orlando Magic,1,0,1610612757,Portland Trail Blazers,0,1,22,33,55,10,19,29,32,52,84,14,5,19,15,39,15,7,16,97,88
2017,2,21700420,12/15/2017,1610612757,Portland Trail Blazers,0,1,1610612753,Orlando Magic,1,0,29,39,68,8,10,18,37,49,86,13,2,15,11,39,18,7,15,96,95
2022,2,22200895,2/24/2023,1610612752,New York Knicks,0,1,1610612764,Washington Wizards,1,0,33,30,63,12,17,29,45,47,92,13,3,16,16,33,21,6,12,96,115
2022,2,22200713,1/24/2023,1610612754,Indiana Pacers,1,1,1610612741,Chicago Bulls,0,0,32,30,62,10,27,37,42,57,99,22,6,28,21,38,24,5,8,99,116
2022,2,22200840,2/10/2023,1610612745,Houston Rockets,0,0,1610612748,Miami Heat,1,1,28,26,54,7,23,30,35,49,84,18,6,24,17,36,23,11,18,95,95
2022,2,22200112,11/2/2022,1610612745,Houston Rockets,1,0,1610612746,LA Clippers,0,1,26,24,50,11,27,38,37,51,88,16,5,21,19,36,17,10,19,97,101
2022,2,22200112,11/2/2022,1610612746,LA Clippers,0,1,1610612745,Houston Rockets,1,0,29,22,51,12,21,33,41,43,84,15,4,19,10,35,20,9,15,97,109
2022,2,22200113,11/2/2022,1610612749,Milwaukee Bucks,1,1,1610612765,Detroit Pistons,0,0,33,21,54,10,28,38,43,49,92,20,4,24,16,36,24,7,16,102,116
2022,2,22200113,11/2/2022,1610612765,Detroit Pistons,0,0,1610612749,Milwaukee Bucks,1,1,22,26,48,11,20,31,33,46,79,14,1,15,6,40,18,17,21,103,91
2021,2,22100675,1/19/2022,1610612742,Dallas Mavericks,1,1,1610612761,Toronto Raptors,0,0,28,15,43,9,24,33,37,39,76,19,1,20,10,29,23,11,18,93,102
2017,2,21700419,12/15/2017,1610612754,Indiana Pacers,1,0,1610612765,Detroit Pistons,0,1,26,31,57,9,21,30,35,52,87,19,6,25,20,35,21,7,14,93,98
2017,2,21700419,12/15/2017,1610612765,Detroit Pistons,0,1,1610612754,Indiana Pacers,1,0,26,35,61,13,19,32,39,54,93,13,4,17,19,38,22,6,9,92,104
2021,2,22100675,1/19/2022,1610612761,Toronto Raptors,0,0,1610612742,Dallas Mavericks,1,1,27,32,59,8,24,32,35,56,91,20,5,25,22,37,17,5,12,95,98
2022,2,22200713,1/24/2023,1610612741,Chicago Bulls,0,0,1610612754,Indiana Pacers,1,1,38,26,64,5,19,24,43,45,88,19,6,25,16,33,19,9,16,98,110
2014,2,21400120,11/13/2014,1610612742,Dallas Mavericks,1,1,1610612755,Philadelphia 76ers,0,0,30,18,48,11,21,32,41,39,80,30,6,36,11,31,33,7,15,100,123
2022,2,22200115,11/2/2022,1610612742,Dallas Mavericks,1,1,1610612762,Utah Jazz,0,0,31,15,46,11,27,38,42,42,84,8,7,15,12,33,20,6,12,92,103
2022,2,22201119,3/26/2023,1610612761,Toronto Raptors,1,1,1610612764,Washington Wizards,0,0,34,33,67,11,20,31,45,53,98,13,3,16,20,34,22,6,13,98,114
2016,2,21600352,12/10/2016,1610612742,Dallas Mavericks,0,0,1610612745,Houston Rockets,1,1,21,24,45,11,23,34,32,47,79,12,2,14,9,39,18,4,9,86,87
2016,2,21600352,12/10/2016,1610612745,Houston Rockets,1,1,1610612742,Dallas Mavericks,0,0,18,19,37,19,18,37,37,37,74,16,6,22,13,27,31,7,15,84,109
2022,2,22200115,11/2/2022,1610612762,Utah Jazz,0,0,1610612742,Dallas Mavericks,1,1,29,25,54,10,20,30,39,45,84,12,2,14,15,31,28,9,17,92,100
2022,2,22200960,3/4/2023,1610612749,Milwaukee Bucks,1,0,1610612755,Philadelphia 76ers,0,1,27,22,49,17,17,34,44,39,83,25,3,28,13,28,30,5,13,95,130
2017,2,21700418,12/15/2017,1610612748,Miami Heat,0,1,1610612766,Charlotte Hornets,1,0,28,19,47,11,20,31,39,39,78,15,2,17,8,31,25,7,18,96,104
2017,2,21700418,12/15/2017,1610612766,Charlotte Hornets,1,0,1610612748,Miami Heat,0,1,24,32,56,10,17,27,34,49,83,20,7,27,17,35,21,10,17,97,98
2014,2,21400120,11/13/2014,1610612755,Philadelphia 76ers,0,0,1610612742,Dallas Mavericks,1,1,16,34,50,7,20,27,23,54,77,17,16,33,21,42,9,14,28,100,70
2021,2,22100989,3/9/2022,1610612759,San Antonio Spurs,1,0,1610612761,Toronto Raptors,0,1,29,23,52,9,23,32,38,46,84,19,1,20,12,35,24,7,14,97,104
2021,2,22100989,3/9/2022,1610612761,Toronto Raptors,0,1,1610612759,San Antonio Spurs,1,0,30,25,55,11,19,30,41,44,85,26,2,28,13,31,12,5,10,95,119
2022,2,22200114,11/2/2022,1610612759,San Antonio Spurs,1,0,1610612761,Toronto Raptors,0,1,23,28,51,14,29,43,37,57,94,12,2,14,15,42,29,16,23,110,100
2017,2,21700417,12/14/2017,1610612742,Dallas Mavericks,0,0,1610612744,Golden State Warriors,1,1,27,26,53,10,19,29,37,45,82,13,4,17,9,38,25,7,12,93,97
2017,2,21700417,12/14/2017,1610612744,Golden State Warriors,1,1,1610612742,Dallas Mavericks,0,0,36,20,56,11,11,22,47,31,78,7,2,9,6,26,35,7,16,92,112
2022,2,22200114,11/2/2022,1610612761,Toronto Raptors,0,1,1610612759,San Antonio Spurs,1,0,43,30,73,14,19,33,57,49,106,15,1,16,15,34,31,3,11,110,143
2022,2,22201117,3/26/2023,1610612739,Cleveland Cavaliers,1,1,1610612745,Houston Rockets,0,0,30,23,53,9,21,30,39,44,83,21,3,24,16,29,20,6,11,92,108
2022,2,22200944,3/2/2023,1610612754,Indiana Pacers,0,0,1610612759,San Antonio Spurs,1,1,33,34,67,8,15,23,41,49,90,9,2,11,9,41,23,5,14,101,99
2022,2,22200116,11/2/2022,1610612757,Portland Trail Blazers,1,0,1610612763,Memphis Grizzlies,0,1,23,33,56,13,20,33,36,53,89,21,5,26,18,38,27,7,20,100,106
2021,2,22100674,1/19/2022,1610612749,Milwaukee Bucks,1,1,1610612763,Memphis Grizzlies,0,0,33,27,60,13,24,37,46,51,97,21,1,22,15,37,29,10,15,106,126
2021,2,22100674,1/19/2022,1610612763,Memphis Grizzlies,0,0,1610612749,Milwaukee Bucks,1,1,35,31,66,9,31,40,44,62,106,17,8,25,20,47,26,7,10,107,114
2022,2,22201100,3/24/2023,1610612763,Memphis Grizzlies,1,1,1610612745,Houston Rockets,0,0,32,19,51,25,17,42,57,36,93,12,2,14,9,29,36,7,11,101,151
2022,2,22200960,3/4/2023,1610612755,Philadelphia 76ers,0,1,1610612749,Milwaukee Bucks,1,0,24,23,47,18,19,37,42,42,84,31,6,37,12,32,24,3,6,94,133
2023,2,22300101,10/30/2023,1610612751,Brooklyn Nets,0,1,1610612766,Charlotte Hornets,1,0,37,17,54,12,21,33,49,38,87,23,9,32,11,31,25,8,14,104,133
2020,2,22000733,4/1/2021,1610612744,Golden State Warriors,0,0,1610612748,Miami Heat,1,1,21,24,45,15,22,37,36,46,82,22,3,25,14,35,23,10,20,99,109
2020,2,22000733,4/1/2021,1610612748,Miami Heat,1,1,1610612744,Golden State Warriors,0,0,26,17,43,13,26,39,39,43,82,25,5,30,10,35,30,7,12,100,116
2022,2,22200116,11/2/2022,1610612763,Memphis Grizzlies,0,1,1610612757,Portland Trail Blazers,1,0,25,30,55,13,15,28,38,45,83,22,5,27,12,35,28,5,15,99,111
2017,2,21700416,12/14/2017,1610612750,Minnesota Timberwolves,1,1,1610612758,Sacramento Kings,0,0,36,25,61,10,11,21,46,36,82,17,3,20,10,27,29,4,10,89,119
2017,2,21700416,12/14/2017,1610612758,Sacramento Kings,0,0,1610612750,Minnesota Timberwolves,1,1,22,32,54,14,19,33,36,51,87,10,2,12,19,34,24,12,14,88,96
2022,2,22200131,11/4/2022,1610612747,Los Angeles Lakers,1,0,1610612762,Utah Jazz,0,1,29,28,57,11,15,26,40,43,83,25,3,28,12,33,22,8,11,96,116
2023,2,22300982,3/17/2024,1610612746,LA Clippers,1,0,1610612737,Atlanta Hawks,0,1,17,21,38,11,25,36,28,46,74,26,3,29,12,35,17,10,16,92,93
2017,2,21700415,12/14/2017,1610612739,Cleveland Cavaliers,1,1,1610612747,Los Angeles Lakers,0,0,28,22,50,15,21,36,43,43,86,20,5,25,11,34,32,7,17,104,121
2020,2,22000429,2/16/2021,1610612740,New Orleans Pelicans,0,1,1610612763,Memphis Grizzlies,1,0,37,16,53,19,19,38,56,35,91,13,4,17,13,23,33,10,19,103,144
2022,2,22200131,11/4/2022,1610612762,Utah Jazz,0,1,1610612747,Los Angeles Lakers,1,0,35,28,63,17,23,40,52,51,103,9,1,10,19,33,31,6,8,95,130
2017,2,21700415,12/14/2017,1610612747,Los Angeles Lakers,0,0,1610612739,Cleveland Cavaliers,1,1,38,26,64,9,22,31,47,48,95,9,5,14,18,33,33,10,18,103,112
2022,2,22200715,1/24/2023,1610612739,Cleveland Cavaliers,0,0,1610612752,New York Knicks,1,1,28,26,54,12,21,33,40,47,87,11,5,16,13,37,29,4,12,92,103
2021,2,22100988,3/9/2022,1610612742,Dallas Mavericks,1,0,1610612752,New York Knicks,0,1,21,21,42,6,38,44,27,59,86,17,8,25,15,45,11,3,8,93,77
2021,2,22100988,3/9/2022,1610612752,New York Knicks,0,1,1610612742,Dallas Mavericks,1,0,27,23,50,9,25,34,36,48,84,26,7,33,21,29,20,3,13,94,107
2020,2,22000429,2/16/2021,1610612763,Memphis Grizzlies,1,0,1610612740,New Orleans Pelicans,0,1,29,28,57,13,18,31,42,46,88,16,2,18,11,36,23,14,19,103,113
2022,2,22200747,1/28/2023,1610612740,New Orleans Pelicans,1,0,1610612764,Washington Wizards,0,1,31,32,63,8,21,29,39,53,92,17,2,19,13,42,21,5,10,99,103
2016,2,21600874,2/26/2017,1610612747,Los Angeles Lakers,1,0,1610612759,San Antonio Spurs,0,1,33,32,65,7,15,22,40,47,87,11,7,18,14,34,16,12,19,100,98
2016,2,21600874,2/26/2017,1610612759,San Antonio Spurs,0,1,1610612747,Los Angeles Lakers,1,0,39,34,73,10,11,21,49,45,94,11,2,13,14,33,37,8,12,100,119
2022,2,22201100,3/24/2023,1610612745,Houston Rockets,0,0,1610612763,Memphis Grizzlies,1,1,40,24,64,7,16,23,47,40,87,13,8,21,11,33,25,12,16,102,114
2022,2,22201076,3/20/2023,1610612762,Utah Jazz,1,1,1610612758,Sacramento Kings,0,0,30,22,52,16,20,36,46,42,88,20,3,23,7,37,33,5,12,103,128
2022,2,22200133,11/5/2022,1610612751,Brooklyn Nets,0,1,1610612766,Charlotte Hornets,1,0,21,27,48,12,24,36,33,51,84,20,2,22,13,38,23,3,11,92,98
2022,2,22201118,3/26/2023,1610612751,Brooklyn Nets,0,0,1610612753,Orlando Magic,1,1,29,27,56,8,27,35,37,54,91,24,4,28,18,38,17,7,15,98,106
2022,2,22200133,11/5/2022,1610612766,Charlotte Hornets,1,0,1610612751,Brooklyn Nets,0,1,18,26,44,14,28,42,32,54,86,16,7,23,19,36,22,8,15,92,94
2022,2,22201115,3/26/2023,1610612763,Memphis Grizzlies,0,1,1610612737,Atlanta Hawks,1,0,35,21,56,13,20,33,48,41,89,14,5,19,8,36,28,4,11,100,123
2022,2,22200132,11/5/2022,1610612753,Orlando Magic,1,0,1610612758,Sacramento Kings,0,1,46,23,69,4,19,23,50,42,92,19,1,20,9,33,27,5,18,110,123
2022,2,22200132,11/5/2022,1610612758,Sacramento Kings,0,1,1610612753,Orlando Magic,1,0,32,21,53,15,25,40,47,46,93,17,9,26,8,43,24,8,14,111,126
2023,2,22300250,11/26/2023,1610612741,Chicago Bulls,0,0,1610612751,Brooklyn Nets,1,1,28,23,51,12,20,32,40,43,83,17,5,22,14,31,21,7,11,91,109
2022,2,22200714,1/24/2023,1610612748,Miami Heat,1,1,1610612738,Boston Celtics,0,0,22,39,61,12,21,33,34,60,94,18,5,23,21,41,21,5,8,95,98
2022,2,22200134,11/5/2022,1610612737,Atlanta Hawks,1,1,1610612740,New Orleans Pelicans,0,0,38,29,67,9,27,36,47,56,103,21,4,25,16,42,28,8,13,112,124
2021,2,22100673,1/19/2022,1610612739,Cleveland Cavaliers,0,0,1610612741,Chicago Bulls,1,1,31,19,50,9,18,27,40,37,77,15,7,22,9,30,27,7,15,93,104
2021,2,22100673,1/19/2022,1610612741,Chicago Bulls,1,1,1610612739,Cleveland Cavaliers,0,0,37,27,64,10,12,22,47,39,86,13,5,18,8,33,25,7,10,95,117
2021,2,22100987,3/9/2022,1610612740,New Orleans Pelicans,1,0,1610612753,Orlando Magic,0,1,34,28,62,7,24,31,41,52,93,13,5,18,14,41,23,4,11,99,102
2021,2,22100987,3/9/2022,1610612753,Orlando Magic,0,1,1610612740,New Orleans Pelicans,1,0,22,17,39,14,23,37,36,40,76,22,4,26,10,32,25,11,19,98,108
2022,2,22200134,11/5/2022,1610612740,New Orleans Pelicans,0,0,1610612737,Atlanta Hawks,1,1,40,45,85,7,16,23,47,61,108,20,8,28,24,40,23,12,16,113,121
2019,2,21900206,11/20/2019,1610612739,Cleveland Cavaliers,0,0,1610612748,Miami Heat,1,1,25,24,49,12,26,38,37,50,87,14,2,16,13,38,19,8,19,102,100
2019,2,21900206,11/20/2019,1610612748,Miami Heat,1,1,1610612739,Cleveland Cavaliers,0,0,22,19,41,19,18,37,41,37,78,23,8,31,17,25,25,13,24,101,124
2022,2,22200751,1/28/2023,1610612757,Portland Trail Blazers,1,0,1610612761,Toronto Raptors,0,1,33,19,52,7,17,24,40,36,76,18,5,23,7,31,18,6,12,93,105
2022,2,22201119,3/26/2023,1610612764,Washington Wizards,0,0,1610612761,Toronto Raptors,1,1,22,28,50,16,20,36,38,48,86,12,8,20,15,37,25,13,18,99,104
2022,2,22200751,1/28/2023,1610612761,Toronto Raptors,0,1,1610612757,Portland Trail Blazers,1,0,38,24,62,10,20,30,48,44,92,17,1,18,16,28,24,3,8,92,123
2022,2,22200135,11/5/2022,1610612738,Boston Celtics,0,1,1610612752,New York Knicks,1,0,20,17,37,27,24,51,47,41,88,12,0,12,9,32,30,6,13,97,133
2022,2,22200749,1/28/2023,1610612738,Boston Celtics,1,1,1610612747,Los Angeles Lakers,0,0,26,18,44,13,27,40,39,45,84,34,5,39,7,38,18,4,12,107,125
2022,2,22200929,2/28/2023,1610612754,Indiana Pacers,0,1,1610612742,Dallas Mavericks,1,0,30,20,50,11,17,28,41,37,78,31,9,40,6,34,25,5,9,99,124
2022,2,22200135,11/5/2022,1610612752,New York Knicks,1,0,1610612738,Boston Celtics,0,1,35,28,63,11,16,27,46,44,90,15,1,16,14,31,22,5,14,96,118
2022,2,22200961,3/4/2023,1610612758,Sacramento Kings,1,0,1610612750,Minnesota Timberwolves,0,1,35,27,62,14,13,27,49,40,89,22,8,30,11,34,25,4,6,97,134
2023,2,22300055,11/28/2023,1610612739,Cleveland Cavaliers,1,1,1610612737,Atlanta Hawks,0,0,37,20,57,13,23,36,50,43,93,15,2,17,14,30,27,9,17,101,128
2022,2,22200139,11/5/2022,1610612756,Phoenix Suns,1,1,1610612757,Portland Trail Blazers,0,0,24,28,52,11,19,30,35,47,82,21,7,28,15,33,22,5,14,95,102
2017,2,21700414,12/14/2017,1610612751,Brooklyn Nets,1,0,1610612752,New York Knicks,0,1,25,16,41,12,30,42,37,46,83,18,5,23,15,34,21,11,18,97,104
2022,2,22200139,11/5/2022,1610612757,Portland Trail Blazers,0,0,1610612756,Phoenix Suns,1,1,23,41,64,7,8,15,30,49,79,15,9,24,14,38,22,7,18,94,82
2020,2,22000428,3/15/2021,1610612759,San Antonio Spurs,0,1,1610612765,Detroit Pistons,1,0,35,23,58,12,13,25,47,36,83,3,2,5,12,26,29,9,22,95,109
2021,2,22100986,3/9/2022,1610612750,Minnesota Timberwolves,1,1,1610612760,Oklahoma City Thunder,0,0,23,11,34,22,30,52,45,41,86,20,6,26,8,37,34,8,14,103,132
2022,2,22200749,1/28/2023,1610612747,Los Angeles Lakers,0,0,1610612738,Boston Celtics,1,1,35,28,63,12,30,42,47,58,105,15,5,20,18,41,30,8,12,107,121
2021,2,22100986,3/9/2022,1610612760,Oklahoma City Thunder,0,0,1610612750,Minnesota Timberwolves,1,1,22,22,44,14,29,43,36,51,87,16,8,24,11,44,26,10,16,103,102
2022,2,22200137,11/5/2022,1610612745,Houston Rockets,0,0,1610612750,Minnesota Timberwolves,1,1,24,22,46,16,22,38,40,44,84,21,10,31,18,30,27,11,23,103,117
2022,2,22200961,3/4/2023,1610612750,Minnesota Timberwolves,0,1,1610612758,Sacramento Kings,1,0,28,13,41,20,19,39,48,32,80,22,9,31,10,28,31,5,12,98,138
2022,2,22200137,11/5/2022,1610612750,Minnesota Timberwolves,1,1,1610612745,Houston Rockets,0,0,34,13,47,15,18,33,49,31,80,16,4,20,9,24,38,10,24,101,129
2022,2,22201117,3/26/2023,1610612745,Houston Rockets,0,0,1610612739,Cleveland Cavaliers,1,1,29,26,55,6,19,25,35,45,80,15,3,18,16,30,20,5,19,90,91
2022,2,22200750,1/28/2023,1610612742,Dallas Mavericks,0,0,1610612762,Utah Jazz,1,1,17,17,34,18,28,46,35,45,80,12,5,17,11,37,26,9,14,91,100
2022,2,22200138,11/5/2022,1610612743,Denver Nuggets,1,1,1610612759,San Antonio Spurs,0,0,38,20,58,15,14,29,53,34,87,5,5,10,13,24,37,8,18,98,126
2017,2,21700414,12/14/2017,1610612752,New York Knicks,0,1,1610612751,Brooklyn Nets,1,0,31,38,69,10,10,20,41,48,89,19,3,22,16,35,23,10,14,96,111
2022,2,22200750,1/28/2023,1610612762,Utah Jazz,1,1,1610612742,Dallas Mavericks,0,0,26,20,46,13,23,36,39,43,82,17,7,24,18,26,26,7,17,93,108
2021,2,22100672,1/19/2022,1610612748,Miami Heat,1,1,1610612757,Portland Trail Blazers,0,0,25,20,45,12,23,35,37,43,80,18,7,25,12,35,24,7,16,95,104
2021,2,22100672,1/19/2022,1610612757,Portland Trail Blazers,0,0,1610612748,Miami Heat,1,1,19,16,35,14,32,46,33,48,81,12,4,16,14,36,19,12,18,95,92
2017,2,21700413,12/14/2017,1610612737,Atlanta Hawks,1,0,1610612765,Detroit Pistons,0,1,21,18,39,11,20,31,32,38,70,16,10,26,8,35,28,10,17,92,91
2017,2,21700413,12/14/2017,1610612765,Detroit Pistons,0,1,1610612737,Atlanta Hawks,1,0,28,32,60,13,17,30,41,49,90,10,2,12,21,29,26,6,15,92,105
2022,2,22201004,3/11/2023,1610612746,LA Clippers,1,1,1610612752,New York Knicks,0,0,32,25,57,10,20,30,42,45,87,12,4,16,11,36,22,5,10,92,106
2022,2,22200138,11/5/2022,1610612759,San Antonio Spurs,0,0,1610612743,Denver Nuggets,1,1,27,23,50,12,18,30,39,41,80,11,8,19,8,38,28,10,15,96,101
2021,2,22100985,3/9/2022,1610612745,Houston Rockets,1,1,1610612747,Los Angeles Lakers,0,0,35,27,62,17,23,40,52,50,102,18,1,19,12,39,25,10,20,116,139
2021,2,22100985,3/9/2022,1610612747,Los Angeles Lakers,0,0,1610612745,Houston Rockets,1,1,29,25,54,18,29,47,47,54,101,18,8,26,15,43,25,7,16,116,130
2023,2,22300765,2/12/2024,1610612752,New York Knicks,0,0,1610612745,Houston Rockets,1,1,30,26,56,12,24,36,42,50,92,7,5,12,22,31,19,12,17,91,103
2021,2,22100984,3/9/2022,1610612737,Atlanta Hawks,0,0,1610612749,Milwaukee Bucks,1,1,32,16,48,11,27,38,43,43,86,18,4,22,7,39,26,7,9,97,115
2021,2,22100984,3/9/2022,1610612749,Milwaukee Bucks,1,1,1610612737,Atlanta Hawks,0,0,35,24,59,12,23,35,47,47,94,18,5,23,12,39,24,6,9,99,124
2022,2,22201118,3/26/2023,1610612753,Orlando Magic,1,1,1610612751,Brooklyn Nets,0,0,38,25,63,7,15,22,45,40,85,22,6,28,12,31,30,7,11,99,119
2022,2,22200136,11/5/2022,1610612749,Milwaukee Bucks,1,1,1610612760,Oklahoma City Thunder,0,0,21,22,43,17,30,47,38,52,90,15,2,17,21,32,23,6,19,97,108
2022,2,22200136,11/5/2022,1610612760,Oklahoma City Thunder,0,0,1610612749,Milwaukee Bucks,1,1,24,25,49,12,23,35,36,48,84,10,6,16,10,39,22,7,16,96,94
2017,2,21700412,12/13/2017,1610612745,Houston Rockets,1,1,1610612766,Charlotte Hornets,0,0,22,21,43,17,28,45,39,49,88,13,6,19,7,45,24,4,10,98,108
2017,2,21700412,12/13/2017,1610612766,Charlotte Hornets,0,0,1610612745,Houston Rockets,1,1,32,34,66,4,17,21,36,51,87,20,7,27,15,39,14,7,12,99,96
2022,2,22200140,11/6/2022,1610612739,Cleveland Cavaliers,0,1,1610612747,Los Angeles Lakers,1,0,29,23,52,8,24,32,37,47,84,32,4,36,14,35,19,4,14,100,114
2023,2,22300835,2/27/2024,1610612762,Utah Jazz,0,0,1610612737,Atlanta Hawks,1,1,24,32,56,11,27,38,35,59,94,16,3,19,15,44,24,8,18,104,97
2022,2,22201116,3/26/2023,1610612738,Boston Celtics,1,1,1610612759,San Antonio Spurs,0,0,34,13,47,18,26,44,52,39,91,15,6,21,9,36,29,7,15,108,137
2022,2,22200926,2/28/2023,1610612745,Houston Rockets,1,0,1610612743,Denver Nuggets,0,1,39,27,66,9,22,31,48,49,97,7,3,10,15,36,33,8,13,100,112
2022,2,22201003,3/10/2023,1610612761,Toronto Raptors,0,0,1610612747,Los Angeles Lakers,1,1,36,28,64,10,18,28,46,46,92,10,3,13,12,34,29,8,13,100,112
2021,2,22100983,3/9/2022,1610612748,Miami Heat,1,0,1610612756,Phoenix Suns,0,1,25,30,55,10,23,33,35,53,88,10,3,13,9,45,27,8,15,100,90
2021,2,22100983,3/9/2022,1610612756,Phoenix Suns,0,1,1610612748,Miami Heat,1,0,34,28,62,11,26,37,45,54,99,10,0,10,19,35,26,8,15,99,111
2022,2,22200140,11/6/2022,1610612747,Los Angeles Lakers,1,0,1610612739,Cleveland Cavaliers,0,1,32,28,60,8,19,27,40,47,87,12,9,21,12,41,24,7,17,99,100
2022,2,22201003,3/10/2023,1610612747,Los Angeles Lakers,1,1,1610612761,Toronto Raptors,0,0,32,18,50,13,17,30,45,35,80,19,0,19,8,27,28,14,21,99,122
2022,2,22200143,11/6/2022,1610612746,LA Clippers,1,0,1610612762,Utah Jazz,0,1,35,19,54,8,25,33,43,44,87,8,5,13,10,37,22,5,14,99,102
2022,2,22201115,3/26/2023,1610612737,Atlanta Hawks,1,0,1610612763,Memphis Grizzlies,0,1,38,29,67,7,24,31,45,53,98,22,4,26,19,35,27,8,10,100,119
2022,2,22200143,11/6/2022,1610612762,Utah Jazz,0,1,1610612746,LA Clippers,1,0,20,15,35,15,25,40,35,40,75,25,1,26,10,31,18,11,21,98,110
2017,2,21700411,12/13/2017,1610612756,Phoenix Suns,1,0,1610612761,Toronto Raptors,0,1,29,30,59,8,16,24,37,46,83,27,7,34,12,38,20,7,11,98,109
2017,2,21700411,12/13/2017,1610612761,Toronto Raptors,0,1,1610612756,Phoenix Suns,1,0,31,35,66,9,17,26,40,52,92,26,5,31,18,36,16,3,7,99,115
2021,2,22100671,1/19/2022,1610612738,Boston Celtics,1,0,1610612766,Charlotte Hornets,0,1,25,19,44,14,32,46,39,51,90,10,3,13,11,40,27,6,14,97,102
2021,2,22100671,1/19/2022,1610612766,Charlotte Hornets,0,1,1610612738,Boston Celtics,1,0,26,21,47,16,23,39,42,44,86,11,4,15,15,31,27,8,17,97,111
2022,2,22200142,11/6/2022,1610612763,Memphis Grizzlies,1,1,1610612764,Washington Wizards,0,0,30,32,62,9,20,29,39,52,91,16,4,20,16,39,20,5,11,94,103
2020,2,22000428,3/15/2021,1610612765,Detroit Pistons,1,0,1610612759,San Antonio Spurs,0,1,32,26,58,7,18,25,39,44,83,14,11,25,11,37,22,3,10,95,99
2016,2,21600873,2/25/2017,1610612744,Golden State Warriors,1,1,1610612751,Brooklyn Nets,0,0,31,38,69,11,20,31,42,58,100,17,5,22,15,45,30,8,11,106,112
2022,2,22200142,11/6/2022,1610612764,Washington Wizards,0,0,1610612763,Memphis Grizzlies,1,1,33,22,55,8,33,41,41,55,96,7,3,10,16,42,25,8,10,92,97
2017,2,21700410,12/13/2017,1610612740,New Orleans Pelicans,1,1,1610612749,Milwaukee Bucks,0,0,32,23,55,13,12,25,45,35,80,12,3,15,12,24,35,14,21,95,115
2017,2,21700410,12/13/2017,1610612749,Milwaukee Bucks,0,0,1610612740,New Orleans Pelicans,1,1,36,32,68,8,19,27,44,51,95,12,7,19,19,35,23,5,10,96,108
2016,2,21600873,2/25/2017,1610612751,Brooklyn Nets,0,0,1610612744,Golden State Warriors,1,1,30,36,66,8,20,28,38,56,94,11,6,17,16,43,25,10,18,104,95
2022,2,22200720,1/25/2023,1610612753,Orlando Magic,1,1,1610612754,Indiana Pacers,0,0,31,23,54,15,13,28,46,36,82,19,6,25,16,23,34,14,18,96,126
2022,2,22200568,1/4/2023,1610612752,New York Knicks,1,1,1610612759,San Antonio Spurs,0,0,35,28,63,10,21,31,45,49,94,17,9,26,22,31,16,5,14,100,117
2022,2,22200568,1/4/2023,1610612759,San Antonio Spurs,0,0,1610612752,New York Knicks,1,1,30,24,54,11,17,28,41,41,82,21,5,26,10,35,25,7,17,99,114
2022,2,22200141,11/6/2022,1610612741,Chicago Bulls,0,0,1610612761,Toronto Raptors,1,1,27,25,52,13,23,36,40,48,88,11,2,13,17,32,27,11,17,94,104
2022,2,22200897,2/24/2023,1610612748,Miami Heat,0,0,1610612749,Milwaukee Bucks,1,1,27,25,52,9,31,40,36,56,92,18,7,25,10,48,21,6,10,105,99
2022,2,22200917,2/26/2023,1610612745,Houston Rockets,0,0,1610612757,Portland Trail Blazers,1,1,38,36,74,7,19,26,45,55,100,17,8,25,26,34,24,7,14,99,114
2022,2,22200842,2/10/2023,1610612739,Cleveland Cavaliers,0,1,1610612740,New Orleans Pelicans,1,0,38,19,57,10,18,28,48,37,85,12,3,15,14,25,28,8,14,91,118
2022,2,22200141,11/6/2022,1610612761,Toronto Raptors,1,1,1610612741,Chicago Bulls,0,0,34,32,66,10,27,37,44,59,103,15,5,20,26,34,28,5,9,95,113
2022,2,22201083,3/22/2023,1610612743,Denver Nuggets,0,1,1610612764,Washington Wizards,1,0,27,24,51,15,17,32,42,41,83,19,2,21,12,29,28,4,10,90,118
2022,2,22200945,3/2/2023,1610612746,LA Clippers,0,0,1610612744,Golden State Warriors,1,1,23,23,46,9,34,43,32,57,89,18,3,21,12,46,19,9,16,101,91
2022,2,22200724,1/25/2023,1610612750,Minnesota Timberwolves,0,1,1610612740,New Orleans Pelicans,1,0,29,24,53,11,18,29,40,42,82,20,8,28,7,38,23,4,9,95,111
2022,2,22200606,1/9/2023,1610612738,Boston Celtics,1,1,1610612741,Chicago Bulls,0,0,27,19,46,11,30,41,38,49,87,20,1,21,11,39,25,6,9,94,107
2022,2,22200606,1/9/2023,1610612741,Chicago Bulls,0,0,1610612738,Boston Celtics,1,1,27,24,51,12,23,35,39,47,86,9,5,14,7,43,19,2,8,93,99
2021,2,22100670,1/19/2022,1610612737,Atlanta Hawks,1,1,1610612750,Minnesota Timberwolves,0,0,30,18,48,15,23,38,45,41,86,29,4,33,11,31,34,10,12,101,134
2021,2,22100670,1/19/2022,1610612750,Minnesota Timberwolves,0,0,1610612737,Atlanta Hawks,1,1,25,26,51,17,29,46,42,55,97,21,8,29,23,34,21,7,13,101,122
2021,2,22100982,3/9/2022,1610612741,Chicago Bulls,0,1,1610612765,Detroit Pistons,1,0,37,24,61,3,12,15,40,36,76,31,4,35,7,30,19,6,11,98,114
2021,2,22100982,3/9/2022,1610612765,Detroit Pistons,1,0,1610612741,Chicago Bulls,0,1,31,20,51,11,20,31,42,40,82,13,4,17,9,32,25,13,16,97,108
2022,2,22200144,11/7/2022,1610612764,Washington Wizards,0,1,1610612766,Charlotte Hornets,1,0,37,24,61,5,14,19,42,38,80,19,11,30,12,30,21,8,15,96,108
2022,2,22200144,11/7/2022,1610612766,Charlotte Hornets,1,0,1610612764,Washington Wizards,0,1,37,32,69,5,27,32,42,59,101,11,5,16,22,39,27,2,11,97,100
2022,2,22200785,2/3/2023,1610612766,Charlotte Hornets,0,0,1610612765,Detroit Pistons,1,1,31,25,56,9,25,34,40,50,90,23,7,30,12,42,22,7,14,105,112
2022,2,22200785,2/3/2023,1610612765,Detroit Pistons,1,1,1610612766,Charlotte Hornets,0,0,30,24,54,14,18,32,44,42,86,16,7,23,15,31,27,16,23,105,118
2022,2,22200917,2/26/2023,1610612757,Portland Trail Blazers,1,1,1610612745,Houston Rockets,0,0,22,16,38,20,19,39,42,35,77,27,8,35,7,31,20,7,14,99,131
2023,2,22300053,11/28/2023,1610612738,Boston Celtics,1,1,1610612741,Chicago Bulls,0,0,26,15,41,21,28,49,47,43,90,9,3,12,16,29,36,11,16,96,124
2022,2,22200720,1/25/2023,1610612754,Indiana Pacers,0,0,1610612753,Orlando Magic,1,1,26,24,50,15,20,35,41,44,85,23,6,29,20,28,25,8,17,96,120
2022,2,22200987,3/8/2023,1610612748,Miami Heat,1,0,1610612739,Cleveland Cavaliers,0,1,27,14,41,8,21,29,35,35,70,22,7,29,13,25,22,13,24,93,100
2022,2,22200945,3/2/2023,1610612744,Golden State Warriors,1,1,1610612746,LA Clippers,0,0,25,22,47,14,32,46,39,54,93,23,4,27,16,40,25,5,12,101,115
2022,2,22201076,3/20/2023,1610612758,Sacramento Kings,0,0,1610612762,Utah Jazz,1,1,22,23,45,19,33,52,41,56,97,19,6,25,14,47,28,3,6,104,120
2022,2,22201004,3/11/2023,1610612752,New York Knicks,0,0,1610612746,LA Clippers,1,1,25,34,59,7,24,31,32,58,90,24,3,27,22,38,21,3,10,90,95
2022,2,22200145,11/7/2022,1610612745,Houston Rockets,0,1,1610612753,Orlando Magic,1,0,22,17,39,24,24,48,46,41,87,18,7,25,18,28,31,7,22,100,134
2016,2,21600009,10/26/2016,1610612750,Minnesota Timberwolves,0,0,1610612763,Memphis Grizzlies,1,1,30,38,68,6,12,18,36,50,86,20,9,29,19,35,20,6,11,91,98
2016,2,21600009,10/26/2016,1610612763,Memphis Grizzlies,1,1,1610612750,Minnesota Timberwolves,0,0,25,31,56,11,13,24,36,44,80,19,8,27,16,32,19,6,13,92,102
2022,2,22200145,11/7/2022,1610612753,Orlando Magic,1,0,1610612745,Houston Rockets,0,1,33,24,57,12,13,25,45,37,82,25,6,31,15,26,27,9,20,101,127
2017,2,21700409,12/13/2017,1610612741,Chicago Bulls,1,1,1610612762,Utah Jazz,0,0,34,42,76,7,10,17,41,52,93,14,7,21,11,45,21,3,9,101,103
2017,2,21700409,12/13/2017,1610612762,Utah Jazz,0,0,1610612741,Chicago Bulls,1,1,33,28,61,9,21,30,42,49,91,7,0,7,10,39,24,9,17,101,100
2021,2,22100669,1/19/2022,1610612751,Brooklyn Nets,0,1,1610612764,Washington Wizards,1,0,39,25,64,8,17,25,47,42,89,17,3,20,15,28,23,6,15,96,119
2021,2,22100669,1/19/2022,1610612764,Washington Wizards,1,0,1610612751,Brooklyn Nets,0,1,31,26,57,10,19,29,41,45,86,26,6,32,18,31,23,5,13,97,118
2020,2,22000427,2/16/2021,1610612738,Boston Celtics,1,1,1610612743,Denver Nuggets,0,0,24,15,39,15,27,42,39,42,81,19,2,21,16,27,26,12,22,99,112
2020,2,22000427,2/16/2021,1610612743,Denver Nuggets,0,0,1610612738,Boston Celtics,1,1,29,21,50,9,25,34,38,46,84,14,1,15,12,34,25,7,17,98,99
2020,2,22000732,4/1/2021,1610612751,Brooklyn Nets,1,1,1610612766,Charlotte Hornets,0,0,24,22,46,20,25,45,44,47,91,3,1,4,15,33,34,11,15,93,111
2020,2,22000732,4/1/2021,1610612766,Charlotte Hornets,0,0,1610612751,Brooklyn Nets,1,1,17,31,48,13,25,38,30,56,86,16,3,19,12,46,22,8,12,93,89
2022,2,22200146,11/7/2022,1610612760,Oklahoma City Thunder,0,0,1610612765,Detroit Pistons,1,1,31,38,69,10,23,33,41,61,102,11,6,17,19,45,23,6,10,102,103
2021,2,22100981,3/9/2022,1610612738,Boston Celtics,0,1,1610612766,Charlotte Hornets,1,0,34,22,56,12,25,37,46,47,93,11,3,14,16,32,30,8,11,94,115
2022,2,22200146,11/7/2022,1610612765,Detroit Pistons,1,1,1610612760,Oklahoma City Thunder,0,0,30,30,60,9,24,33,39,54,93,25,8,33,24,34,20,9,16,101,112
2021,2,22100981,3/9/2022,1610612766,Charlotte Hornets,1,0,1610612738,Boston Celtics,0,1,28,24,52,8,25,33,36,49,85,21,7,28,20,33,18,10,16,92,101
2023,2,22300139,11/4/2023,1610612743,Denver Nuggets,1,1,1610612741,Chicago Bulls,0,0,26,19,45,16,20,36,42,39,81,23,7,30,11,31,31,7,12,97,123
2021,2,22100668,1/19/2022,1610612753,Orlando Magic,0,0,1610612755,Philadelphia 76ers,1,1,22,33,55,18,17,35,40,50,90,12,4,16,13,39,26,7,11,99,110
2021,2,22100668,1/19/2022,1610612755,Philadelphia 76ers,1,1,1610612753,Orlando Magic,0,0,35,20,55,10,18,28,45,38,83,23,4,27,7,35,21,4,10,98,123
2020,2,22000426,2/15/2021,1610612751,Brooklyn Nets,0,1,1610612758,Sacramento Kings,1,0,24,18,42,27,20,47,51,38,89,7,5,12,12,28,31,6,15,98,136
2020,2,22000426,2/15/2021,1610612758,Sacramento Kings,1,0,1610612751,Brooklyn Nets,0,1,39,24,63,12,21,33,51,45,96,11,2,13,19,27,24,7,15,99,125
2017,2,21700408,12/13/2017,1610612748,Miami Heat,1,0,1610612757,Portland Trail Blazers,0,1,21,21,42,13,17,30,34,38,72,14,9,23,14,28,19,7,16,85,95
2020,2,22000731,4/1/2021,1610612739,Cleveland Cavaliers,1,0,1610612755,Philadelphia 76ers,0,1,24,21,45,10,25,35,34,46,80,16,5,21,6,43,26,11,18,100,94
2020,2,22000731,4/1/2021,1610612755,Philadelphia 76ers,0,1,1610612739,Cleveland Cavaliers,1,0,25,31,56,15,22,37,40,53,93,19,6,25,15,40,27,5,10,100,114
2022,2,22200147,11/7/2022,1610612740,New Orleans Pelicans,0,0,1610612754,Indiana Pacers,1,1,34,29,63,14,20,34,48,49,97,12,5,17,14,36,32,6,10,101,122
2020,2,22000425,2/15/2021,1610612746,LA Clippers,1,1,1610612748,Miami Heat,0,0,32,21,53,15,17,32,47,38,85,16,4,20,10,30,31,7,12,95,125
2021,2,22100980,3/8/2022,1610612744,Golden State Warriors,1,1,1610612746,LA Clippers,0,0,31,27,58,13,21,34,44,48,92,11,2,13,13,35,33,12,16,100,112
2021,2,22100980,3/8/2022,1610612746,LA Clippers,0,0,1610612744,Golden State Warriors,1,1,21,33,54,12,27,39,33,60,93,19,4,23,17,44,23,8,13,102,97
2022,2,22200147,11/7/2022,1610612754,Indiana Pacers,1,1,1610612740,New Orleans Pelicans,0,0,21,17,38,22,26,48,43,43,86,21,2,23,13,32,33,7,17,101,129
2022,2,22200626,1/12/2023,1610612755,Philadelphia 76ers,1,0,1610612760,Oklahoma City Thunder,0,1,28,24,52,11,25,36,39,49,88,25,2,27,13,37,30,7,17,105,114
2022,2,22200626,1/12/2023,1610612760,Oklahoma City Thunder,0,1,1610612755,Philadelphia 76ers,1,0,30,23,53,14,19,33,44,42,86,31,2,33,10,33,28,4,11,104,133
2022,2,22200897,2/24/2023,1610612749,Milwaukee Bucks,1,1,1610612748,Miami Heat,0,0,28,24,52,19,27,46,47,51,98,15,4,19,14,38,27,5,12,104,128
2022,2,22200845,2/10/2023,1610612749,Milwaukee Bucks,0,1,1610612746,LA Clippers,1,0,28,23,51,17,22,39,45,45,90,12,4,16,12,34,28,5,11,96,119
2022,2,22200148,11/7/2022,1610612755,Philadelphia 76ers,1,1,1610612756,Phoenix Suns,0,0,19,29,48,12,20,32,31,49,80,26,5,31,19,32,22,8,16,91,100
2021,2,22100979,3/8/2022,1610612749,Milwaukee Bucks,0,1,1610612760,Oklahoma City Thunder,1,0,33,27,60,20,20,40,53,47,100,16,4,20,18,32,35,6,13,104,142
2021,2,22100979,3/8/2022,1610612760,Oklahoma City Thunder,1,0,1610612749,Milwaukee Bucks,0,1,26,19,45,16,23,39,42,42,84,15,6,21,6,38,26,10,16,103,115
2022,2,22200896,2/24/2023,1610612739,Cleveland Cavaliers,0,0,1610612737,Atlanta Hawks,1,1,27,26,53,13,22,35,40,48,88,26,3,29,10,38,20,7,11,102,119
2022,2,22200148,11/7/2022,1610612756,Phoenix Suns,0,0,1610612755,Philadelphia 76ers,1,1,26,28,54,6,13,19,32,41,73,18,4,22,8,35,19,5,15,92,88
2021,2,22100667,1/18/2022,1610612744,Golden State Warriors,1,1,1610612765,Detroit Pistons,0,0,20,21,41,14,28,42,34,49,83,20,7,27,13,39,26,4,13,96,102
2021,2,22100667,1/18/2022,1610612765,Detroit Pistons,0,0,1610612744,Golden State Warriors,1,1,21,30,51,9,25,34,30,55,85,17,7,24,15,43,18,12,16,97,86
2022,2,22200930,2/28/2023,1610612762,Utah Jazz,1,0,1610612759,San Antonio Spurs,0,1,20,31,51,10,24,34,30,55,85,24,12,36,21,39,15,9,20,101,94
2022,2,22200987,3/8/2023,1610612739,Cleveland Cavaliers,0,1,1610612748,Miami Heat,1,0,30,22,52,9,19,28,39,41,80,17,2,19,11,31,26,7,17,92,104
2021,2,22100978,3/8/2022,1610612740,New Orleans Pelicans,0,0,1610612763,Memphis Grizzlies,1,1,30,24,54,11,23,34,41,47,88,18,9,27,14,38,24,8,15,102,111
2022,2,22200149,11/7/2022,1610612737,Atlanta Hawks,1,1,1610612749,Milwaukee Bucks,0,0,35,35,70,11,18,29,46,53,99,14,3,17,18,38,23,5,11,102,117
2017,2,21700408,12/13/2017,1610612757,Portland Trail Blazers,0,1,1610612748,Miami Heat,1,0,26,18,44,10,18,28,36,36,72,20,3,23,8,29,14,6,11,86,102
2022,2,22200149,11/7/2022,1610612749,Milwaukee Bucks,0,0,1610612737,Atlanta Hawks,1,1,23,24,47,13,27,40,36,51,87,13,3,16,12,39,21,11,20,102,98
2022,2,22200930,2/28/2023,1610612759,San Antonio Spurs,0,1,1610612762,Utah Jazz,1,0,31,34,65,8,18,26,39,52,91,16,9,25,16,40,23,8,14,100,102
2022,2,22200926,2/28/2023,1610612743,Denver Nuggets,0,1,1610612745,Houston Rockets,1,0,37,18,55,16,21,37,53,39,92,11,5,16,11,31,40,5,11,99,133
2022,2,22200101,10/31/2022,1610612762,Utah Jazz,1,1,1610612763,Memphis Grizzlies,0,0,23,19,42,19,28,47,42,47,89,18,4,22,12,38,26,8,16,103,121
2022,2,22200101,10/31/2022,1610612763,Memphis Grizzlies,0,0,1610612762,Utah Jazz,1,1,32,34,66,6,20,26,38,54,92,23,19,42,23,41,14,10,16,104,105
2021,2,22100666,1/18/2022,1610612750,Minnesota Timberwolves,0,1,1610612752,New York Knicks,1,0,22,18,40,13,28,41,35,46,81,29,9,38,14,37,21,6,13,100,112
2021,2,22100666,1/18/2022,1610612752,New York Knicks,1,0,1610612750,Minnesota Timberwolves,0,1,25,17,42,12,26,38,37,43,80,24,9,33,14,32,21,10,18,100,110
2021,2,22100978,3/8/2022,1610612763,Memphis Grizzlies,1,1,1610612740,New Orleans Pelicans,0,0,32,25,57,16,28,44,48,53,101,20,4,24,20,35,30,9,12,101,132
2020,2,22000425,2/15/2021,1610612748,Miami Heat,0,0,1610612746,LA Clippers,1,1,38,17,55,8,28,36,46,45,91,18,4,22,14,33,27,5,8,97,118
2021,2,22100665,1/17/2022,1610612747,Los Angeles Lakers,1,1,1610612762,Utah Jazz,0,0,27,22,49,11,26,37,38,48,86,14,9,23,13,40,15,6,13,96,101
2021,2,22100665,1/17/2022,1610612762,Utah Jazz,0,0,1610612747,Los Angeles Lakers,1,1,19,18,37,12,34,46,31,52,83,21,3,24,16,38,21,7,16,96,95
2022,2,22201083,3/22/2023,1610612764,Washington Wizards,1,0,1610612743,Denver Nuggets,0,1,40,21,61,4,22,26,44,43,87,12,4,16,13,31,20,7,7,90,104
2021,2,22100977,3/8/2022,1610612753,Orlando Magic,1,0,1610612756,Phoenix Suns,0,1,28,25,53,7,32,39,35,57,92,22,3,25,11,46,17,7,12,105,99
2022,2,22200150,11/7/2022,1610612748,Miami Heat,1,0,1610612757,Portland Trail Blazers,0,1,26,19,45,14,25,39,40,44,84,13,2,15,9,37,28,7,12,95,107
2021,2,22100977,3/8/2022,1610612756,Phoenix Suns,0,1,1610612753,Orlando Magic,1,0,22,33,55,13,24,37,35,57,92,19,4,23,9,50,24,6,10,103,102
2022,2,22200843,2/10/2023,1610612757,Portland Trail Blazers,1,0,1610612760,Oklahoma City Thunder,0,1,26,10,36,16,24,40,42,34,76,29,2,31,13,22,29,9,20,96,129
2022,2,22200724,1/25/2023,1610612740,New Orleans Pelicans,1,0,1610612750,Minnesota Timberwolves,0,1,25,22,47,12,26,38,37,48,85,16,5,21,15,34,25,8,15,96,102
2021,2,22100664,1/17/2022,1610612756,Phoenix Suns,0,1,1610612759,San Antonio Spurs,1,0,40,23,63,9,23,32,49,46,95,14,6,20,15,34,29,3,5,96,121
2021,2,22100664,1/17/2022,1610612759,San Antonio Spurs,1,0,1610612756,Phoenix Suns,0,1,32,30,62,9,21,30,41,51,92,16,6,22,19,34,21,9,12,96,107
2022,2,22200787,2/3/2023,1610612757,Portland Trail Blazers,0,1,1610612764,Washington Wizards,1,0,26,21,47,17,24,41,43,45,88,21,2,23,13,33,25,4,7,92,124
2022,2,22200150,11/7/2022,1610612757,Portland Trail Blazers,0,1,1610612748,Miami Heat,1,0,22,13,35,16,21,37,38,34,72,18,3,21,5,30,27,11,19,96,110
2023,2,22300254,11/27/2023,1610612754,Indiana Pacers,1,0,1610612757,Portland Trail Blazers,0,1,34,21,55,8,25,33,42,46,88,18,6,24,14,35,26,6,20,103,110
2022,2,22200151,11/7/2022,1610612741,Chicago Bulls,1,1,1610612761,Toronto Raptors,0,0,33,19,52,9,19,28,42,38,80,18,4,22,10,28,30,10,22,101,111
2023,2,22300830,2/26/2024,1610612751,Brooklyn Nets,0,1,1610612763,Memphis Grizzlies,1,0,29,19,48,15,27,42,44,46,90,8,6,14,15,34,32,6,10,92,111
2022,2,22200151,11/7/2022,1610612761,Toronto Raptors,0,0,1610612741,Chicago Bulls,1,1,27,30,57,9,19,28,36,49,85,16,6,22,8,43,24,7,15,102,97
2023,2,22300102,10/30/2023,1610612741,Chicago Bulls,0,1,1610612754,Indiana Pacers,1,0,34,36,70,6,11,17,40,47,87,26,5,31,13,36,19,7,13,102,112
2021,2,22100663,1/17/2022,1610612742,Dallas Mavericks,1,1,1610612760,Oklahoma City Thunder,0,0,23,28,51,12,25,37,35,53,88,22,6,28,15,39,28,10,11,99,104
2021,2,22100976,3/8/2022,1610612739,Cleveland Cavaliers,0,1,1610612754,Indiana Pacers,1,0,38,24,62,9,23,32,47,47,94,24,3,27,17,32,25,6,8,99,127
2021,2,22100976,3/8/2022,1610612754,Indiana Pacers,1,0,1610612739,Cleveland Cavaliers,0,1,33,26,59,16,16,32,49,42,91,10,5,15,18,27,35,13,18,100,124
2021,2,22100663,1/17/2022,1610612760,Oklahoma City Thunder,0,0,1610612742,Dallas Mavericks,1,1,25,23,48,11,24,35,36,47,83,19,5,24,10,40,20,10,13,99,102
2019,2,21900205,11/20/2019,1610612751,Brooklyn Nets,1,1,1610612766,Charlotte Hornets,0,0,26,25,51,10,29,39,36,54,90,19,4,23,19,37,19,8,17,100,101
2019,2,21900205,11/20/2019,1610612766,Charlotte Hornets,0,0,1610612751,Brooklyn Nets,1,1,19,29,48,11,22,33,30,51,81,20,6,26,10,44,17,11,16,100,91
2022,2,22200152,11/7/2022,1610612738,Boston Celtics,0,1,1610612763,Memphis Grizzlies,1,0,26,19,45,12,25,37,38,44,82,21,7,28,10,38,26,4,15,101,109
2022,2,22200152,11/7/2022,1610612763,Memphis Grizzlies,1,0,1610612738,Boston Celtics,0,1,26,21,47,15,29,44,41,50,91,9,5,14,12,40,27,5,11,99,106
2021,2,22100975,3/8/2022,1610612751,Brooklyn Nets,0,1,1610612766,Charlotte Hornets,1,0,28,19,47,18,17,35,46,36,82,22,7,29,8,31,33,12,16,105,132
2021,2,22100975,3/8/2022,1610612766,Charlotte Hornets,1,0,1610612751,Brooklyn Nets,0,1,32,19,51,13,28,41,45,47,92,18,4,22,14,35,26,8,15,106,121
2022,2,22200836,2/10/2023,1610612756,Phoenix Suns,0,1,1610612754,Indiana Pacers,1,0,33,27,60,10,23,33,43,50,93,21,3,24,23,28,25,9,17,100,117
2021,2,22100662,1/17/2022,1610612748,Miami Heat,1,1,1610612761,Toronto Raptors,0,0,29,30,59,9,15,24,38,45,83,19,3,22,14,33,20,9,12,91,104
2021,2,22100662,1/17/2022,1610612761,Toronto Raptors,0,0,1610612748,Miami Heat,1,1,24,30,54,13,23,36,37,53,90,12,5,17,19,37,24,11,12,92,99
2022,2,22200725,1/25/2023,1610612737,Atlanta Hawks,0,1,1610612760,Oklahoma City Thunder,1,0,39,16,55,11,18,29,50,34,84,26,7,33,12,26,26,12,17,106,137
2020,2,22000424,2/15/2021,1610612739,Cleveland Cavaliers,0,0,1610612744,Golden State Warriors,1,1,29,36,65,8,22,30,37,58,95,16,4,20,21,39,19,9,18,103,98
2020,2,22000424,2/15/2021,1610612744,Golden State Warriors,1,1,1610612739,Cleveland Cavaliers,0,0,29,22,51,17,20,37,46,42,88,20,1,21,8,34,34,10,14,102,129
2016,2,21600872,2/25/2017,1610612745,Houston Rockets,1,1,1610612750,Minnesota Timberwolves,0,0,22,14,36,22,36,58,44,50,94,32,10,42,17,38,32,10,13,109,142
2022,2,22200962,3/5/2023,1610612742,Dallas Mavericks,1,0,1610612756,Phoenix Suns,0,1,23,16,39,15,23,38,38,39,77,35,3,38,7,34,15,5,10,97,126
2020,2,22000730,3/31/2021,1610612741,Chicago Bulls,0,0,1610612756,Phoenix Suns,1,1,32,34,66,11,22,33,43,56,99,19,2,21,26,31,27,6,10,95,116
2020,2,22000730,3/31/2021,1610612756,Phoenix Suns,1,1,1610612741,Chicago Bulls,0,0,35,21,56,11,14,25,46,35,81,18,6,24,6,32,29,6,10,93,121
2022,2,22200962,3/5/2023,1610612756,Phoenix Suns,0,1,1610612742,Dallas Mavericks,1,0,37,18,55,12,22,34,49,40,89,20,5,25,13,28,27,5,9,97,130
2022,2,22200154,11/7/2022,1610612743,Denver Nuggets,0,1,1610612759,San Antonio Spurs,1,0,39,25,64,8,16,24,47,41,88,13,7,20,16,29,33,14,22,103,115
2022,2,22201137,3/29/2023,1610612745,Houston Rockets,0,0,1610612751,Brooklyn Nets,1,1,37,31,68,9,21,30,46,52,98,13,8,21,22,34,21,4,10,97,114
2022,2,22200154,11/7/2022,1610612759,San Antonio Spurs,1,0,1610612743,Denver Nuggets,0,1,31,18,49,12,21,33,43,39,82,11,7,18,11,32,31,14,24,102,109
2022,2,22200721,1/25/2023,1610612755,Philadelphia 76ers,1,1,1610612751,Brooklyn Nets,0,0,24,20,44,18,20,38,42,40,82,35,1,36,15,25,26,3,11,97,137
2022,2,22200153,11/7/2022,1610612750,Minnesota Timberwolves,1,0,1610612752,New York Knicks,0,1,27,13,40,11,30,41,38,43,81,20,4,24,9,35,28,13,18,102,107
2017,2,21700407,12/13/2017,1610612738,Boston Celtics,1,1,1610612743,Denver Nuggets,0,0,36,18,54,11,14,25,47,32,79,19,5,24,6,29,29,8,14,97,124
2017,2,21700407,12/13/2017,1610612743,Denver Nuggets,0,0,1610612738,Boston Celtics,1,1,36,27,63,9,19,28,45,46,91,19,7,26,21,29,22,10,16,98,118
2022,2,22200153,11/7/2022,1610612752,New York Knicks,0,1,1610612750,Minnesota Timberwolves,1,0,20,21,41,19,29,48,39,50,89,23,2,25,16,36,26,7,19,102,120
2023,2,22300094,10/28/2023,1610612762,Utah Jazz,0,0,1610612756,Phoenix Suns,1,1,28,26,54,12,25,37,40,51,91,12,2,14,17,35,26,10,19,101,104
2022,2,22201138,3/29/2023,1610612748,Miami Heat,0,0,1610612752,New York Knicks,1,1,22,18,40,13,26,39,35,44,79,9,5,14,8,38,20,8,11,90,92
2021,2,22100974,3/7/2022,1610612752,New York Knicks,0,1,1610612758,Sacramento Kings,1,0,29,21,50,18,24,42,47,45,92,19,4,23,10,38,19,4,9,100,131
2021,2,22100974,3/7/2022,1610612758,Sacramento Kings,1,0,1610612752,New York Knicks,0,1,28,20,48,11,21,32,39,41,80,26,10,36,6,41,23,7,12,101,115
2022,2,22201092,3/22/2023,1610612756,Phoenix Suns,0,0,1610612747,Los Angeles Lakers,1,1,30,29,59,12,19,31,42,48,90,15,5,20,15,35,23,7,17,101,111
2022,2,22200723,1/25/2023,1610612743,Denver Nuggets,0,0,1610612749,Milwaukee Bucks,1,1,27,36,63,11,23,34,38,59,97,12,4,16,19,42,21,11,19,105,99
2022,2,22200155,11/7/2022,1610612742,Dallas Mavericks,1,1,1610612751,Brooklyn Nets,0,0,20,24,44,12,16,28,32,40,72,20,4,24,18,24,18,13,22,86,96
2022,2,22200844,2/10/2023,1610612758,Sacramento Kings,1,0,1610612742,Dallas Mavericks,0,1,30,15,45,9,18,27,39,33,72,27,5,32,6,30,21,4,14,97,114
2017,2,21700406,12/13/2017,1610612763,Memphis Grizzlies,0,0,1610612764,Washington Wizards,1,1,21,32,53,10,18,28,31,50,81,15,1,16,11,39,18,7,17,94,87
2021,2,22100973,3/7/2022,1610612747,Los Angeles Lakers,0,0,1610612759,San Antonio Spurs,1,1,35,30,65,8,18,26,43,48,91,16,7,23,14,37,19,6,15,102,110
2021,2,22100973,3/7/2022,1610612759,San Antonio Spurs,1,1,1610612747,Los Angeles Lakers,0,0,37,21,58,9,17,26,46,38,84,16,14,30,14,31,28,7,18,102,117
2022,2,22200155,11/7/2022,1610612751,Brooklyn Nets,0,0,1610612742,Dallas Mavericks,1,1,25,26,51,10,19,29,35,45,80,14,5,19,16,31,22,7,14,87,94
2020,2,22000729,3/31/2021,1610612747,Los Angeles Lakers,1,0,1610612749,Milwaukee Bucks,0,1,25,26,51,10,26,36,35,52,87,17,5,22,15,39,22,13,22,103,97
2020,2,22000729,3/31/2021,1610612749,Milwaukee Bucks,0,1,1610612747,Los Angeles Lakers,1,0,28,25,53,14,12,26,42,37,79,14,4,18,9,31,23,9,22,102,112
2022,2,22200156,11/7/2022,1610612744,Golden State Warriors,1,1,1610612758,Sacramento Kings,0,0,30,20,50,14,24,38,44,44,88,14,7,21,10,36,28,9,15,103,116
2021,2,22100661,1/17/2022,1610612753,Orlando Magic,1,0,1610612757,Portland Trail Blazers,0,1,26,32,58,8,24,32,34,56,90,12,8,20,15,45,21,9,16,102,88
2021,2,22100661,1/17/2022,1610612757,Portland Trail Blazers,0,1,1610612753,Orlando Magic,1,0,30,26,56,7,27,34,37,53,90,17,1,18,13,41,20,9,17,100,98
2021,2,22100972,3/7/2022,1610612742,Dallas Mavericks,1,1,1610612762,Utah Jazz,0,0,22,20,42,17,29,46,39,49,88,16,4,20,15,35,19,5,9,95,111
2021,2,22100972,3/7/2022,1610612762,Utah Jazz,0,0,1610612742,Dallas Mavericks,1,1,24,28,52,12,19,31,36,47,83,19,5,24,14,37,22,9,14,94,103
2020,2,22000423,2/15/2021,1610612755,Philadelphia 76ers,0,0,1610612762,Utah Jazz,1,1,39,32,71,8,15,23,47,47,94,21,3,24,16,32,19,9,12,102,123
2020,2,22000423,2/15/2021,1610612762,Utah Jazz,1,1,1610612755,Philadelphia 76ers,0,0,27,14,41,18,27,45,45,41,86,26,5,31,9,32,18,6,11,101,134
2022,2,22200929,2/28/2023,1610612742,Dallas Mavericks,1,0,1610612754,Indiana Pacers,0,1,34,20,54,12,25,37,46,45,91,18,10,28,14,37,28,3,7,101,122
2022,2,22200845,2/10/2023,1610612746,LA Clippers,1,0,1610612749,Milwaukee Bucks,0,1,31,21,52,11,22,33,42,43,85,11,3,14,3,40,17,8,10,97,106
2023,2,22300982,3/17/2024,1610612737,Atlanta Hawks,0,1,1610612746,LA Clippers,1,0,24,26,50,17,17,34,41,43,84,11,1,12,14,30,32,10,16,90,110
2021,2,22100660,1/17/2022,1610612737,Atlanta Hawks,1,1,1610612749,Milwaukee Bucks,0,0,23,27,50,15,21,36,38,48,86,30,2,32,14,34,25,8,13,100,121
2021,2,22100660,1/17/2022,1610612749,Milwaukee Bucks,0,0,1610612737,Atlanta Hawks,1,1,23,27,50,16,22,38,39,49,88,20,4,24,11,41,21,7,13,102,114
2022,2,22200157,11/7/2022,1610612747,Los Angeles Lakers,0,0,1610612762,Utah Jazz,1,1,31,27,58,9,15,24,40,42,82,27,3,30,9,34,15,10,16,102,116
2022,2,22200157,11/7/2022,1610612762,Utah Jazz,1,1,1610612747,Los Angeles Lakers,0,0,37,20,57,16,22,38,53,42,95,17,5,22,16,29,30,7,15,104,139
2017,2,21700406,12/13/2017,1610612764,Washington Wizards,1,1,1610612763,Memphis Grizzlies,0,0,27,28,55,9,13,22,36,41,77,12,12,24,9,37,21,6,15,96,93
2016,2,21600872,2/25/2017,1610612750,Minnesota Timberwolves,0,0,1610612745,Houston Rockets,1,1,40,28,68,9,17,26,49,45,94,23,5,28,24,23,28,15,25,110,130
2021,2,22100971,3/7/2022,1610612750,Minnesota Timberwolves,1,1,1610612757,Portland Trail Blazers,0,0,25,24,49,13,30,43,38,54,92,35,9,44,23,35,21,10,22,110,124
2021,2,22100971,3/7/2022,1610612757,Portland Trail Blazers,0,0,1610612750,Minnesota Timberwolves,1,1,16,39,55,7,21,28,23,60,83,28,10,38,11,52,11,10,18,108,81
2014,2,21401049,3/23/2015,1610612751,Brooklyn Nets,1,0,1610612738,Boston Celtics,0,1,31,41,72,1,16,17,32,57,89,26,4,30,18,40,15,7,12,96,91
2014,2,21400488,1/2/2015,1610612740,New Orleans Pelicans,1,1,1610612745,Houston Rockets,0,0,37,31,68,7,8,15,44,39,83,16,4,20,15,26,24,13,19,95,111
2014,2,21400488,1/2/2015,1610612745,Houston Rockets,0,0,1610612740,New Orleans Pelicans,1,1,29,30,59,6,23,29,35,53,88,7,4,11,18,38,22,12,19,96,83
2020,2,22000728,3/31/2021,1610612758,Sacramento Kings,0,0,1610612759,San Antonio Spurs,1,1,28,29,57,11,24,35,39,53,92,17,2,19,11,43,22,9,12,102,106
2020,2,22000728,3/31/2021,1610612759,San Antonio Spurs,1,1,1610612758,Sacramento Kings,0,0,33,33,66,10,16,26,43,49,92,24,10,34,17,37,24,7,11,102,120
2022,2,22200158,11/7/2022,1610612739,Cleveland Cavaliers,0,0,1610612746,LA Clippers,1,1,27,23,50,16,17,33,43,40,83,15,6,21,13,30,29,8,17,97,117
2021,2,22100659,1/17/2022,1610612746,LA Clippers,1,1,1610612754,Indiana Pacers,0,0,27,19,46,18,18,36,45,37,82,31,5,36,12,28,32,8,13,102,139
2021,2,22100659,1/17/2022,1610612754,Indiana Pacers,0,0,1610612746,LA Clippers,1,1,37,27,64,13,20,33,50,47,97,20,3,23,19,30,30,7,12,102,133
2020,2,22000422,2/15/2021,1610612737,Atlanta Hawks,0,0,1610612752,New York Knicks,1,1,25,27,52,11,22,33,36,49,85,29,3,32,17,34,17,5,11,93,112
2022,2,22200725,1/25/2023,1610612760,Oklahoma City Thunder,1,0,1610612737,Atlanta Hawks,0,1,38,30,68,15,19,34,53,49,102,11,5,16,14,38,31,5,12,106,132
2022,2,22200842,2/10/2023,1610612740,New Orleans Pelicans,1,0,1610612739,Cleveland Cavaliers,0,1,30,28,58,9,15,24,39,43,82,20,5,25,17,30,25,9,14,92,107
2020,2,22000727,3/31/2021,1610612760,Oklahoma City Thunder,1,1,1610612761,Toronto Raptors,0,0,25,28,53,14,19,33,39,47,86,21,7,28,22,30,19,13,20,98,113
2020,2,22000727,3/31/2021,1610612761,Toronto Raptors,0,0,1610612760,Oklahoma City Thunder,1,1,19,25,44,16,30,46,35,55,90,17,3,20,8,49,21,2,7,98,103
2022,2,22200158,11/7/2022,1610612746,LA Clippers,1,1,1610612739,Cleveland Cavaliers,0,0,23,18,41,17,21,38,40,39,79,22,6,28,4,39,19,6,9,97,119
2022,2,22200875,2/15/2023,1610612739,Cleveland Cavaliers,0,0,1610612755,Philadelphia 76ers,1,1,31,21,52,10,20,30,41,41,82,20,5,25,10,33,23,7,8,91,112
2022,2,22200844,2/10/2023,1610612742,Dallas Mavericks,0,1,1610612758,Sacramento Kings,1,0,25,20,45,18,25,43,43,45,88,18,1,19,12,33,34,2,12,97,122
2017,2,21700405,12/13/2017,1610612746,LA Clippers,0,1,1610612753,Orlando Magic,1,0,27,35,62,12,14,26,39,49,88,16,4,20,9,41,25,6,9,99,106
2017,2,21700405,12/13/2017,1610612753,Orlando Magic,1,0,1610612746,LA Clippers,0,1,28,33,61,9,18,27,37,51,88,12,9,21,11,47,24,10,12,100,95
2021,2,22100658,1/17/2022,1610612741,Chicago Bulls,0,0,1610612763,Memphis Grizzlies,1,1,27,34,61,13,18,31,40,52,92,13,2,15,14,39,24,14,18,103,106
2021,2,22100658,1/17/2022,1610612763,Memphis Grizzlies,1,1,1610612741,Chicago Bulls,0,0,37,30,67,10,15,25,47,45,92,15,5,20,13,35,29,10,18,103,119
2021,2,22100970,3/7/2022,1610612745,Houston Rockets,0,0,1610612748,Miami Heat,1,1,26,19,45,13,30,43,39,49,88,15,7,22,12,40,22,3,11,96,106
2021,2,22100970,3/7/2022,1610612748,Miami Heat,1,1,1610612745,Houston Rockets,0,0,35,25,60,14,17,31,49,42,91,11,3,14,15,27,26,8,15,96,123
2022,2,22201092,3/22/2023,1610612747,Los Angeles Lakers,1,1,1610612756,Phoenix Suns,0,0,31,22,53,8,9,17,39,31,70,36,10,46,7,28,27,7,15,100,122
2023,2,22300094,10/28/2023,1610612756,Phoenix Suns,1,1,1610612762,Utah Jazz,0,0,35,13,48,10,27,37,45,40,85,26,2,28,10,31,31,6,11,99,126
2022,2,22200722,1/25/2023,1610612764,Washington Wizards,0,1,1610612745,Houston Rockets,1,0,27,33,60,12,26,38,39,59,98,18,5,23,19,42,27,5,8,98,108
2022,2,22200786,2/3/2023,1610612754,Indiana Pacers,1,1,1610612758,Sacramento Kings,0,0,23,25,48,17,24,41,40,49,89,10,4,14,12,38,28,6,18,104,107
2022,2,22200159,11/9/2022,1610612757,Portland Trail Blazers,0,1,1610612766,Charlotte Hornets,1,0,29,12,41,11,23,34,40,35,75,14,11,25,13,27,28,10,18,92,105
2022,2,22200159,11/9/2022,1610612766,Charlotte Hornets,1,0,1610612757,Portland Trail Blazers,0,1,24,27,51,10,30,40,34,57,91,17,7,24,22,38,21,5,11,91,95
2022,2,22200160,11/9/2022,1610612743,Denver Nuggets,0,1,1610612754,Indiana Pacers,1,0,31,29,60,12,16,28,43,45,88,24,2,26,13,34,27,9,22,109,122
2022,2,22200721,1/25/2023,1610612751,Brooklyn Nets,0,0,1610612755,Philadelphia 76ers,1,1,35,15,50,14,12,26,49,27,76,21,6,27,7,25,29,10,16,97,133
2017,2,21700403,12/12/2017,1610612756,Phoenix Suns,0,0,1610612758,Sacramento Kings,1,1,30,28,58,7,25,32,37,53,90,11,3,14,16,39,22,9,12,92,92
2017,2,21700403,12/12/2017,1610612758,Sacramento Kings,1,1,1610612756,Phoenix Suns,0,0,31,36,67,7,15,22,38,51,89,16,6,22,18,35,21,5,9,93,99
2022,2,22200160,11/9/2022,1610612754,Indiana Pacers,1,0,1610612743,Denver Nuggets,0,1,31,23,54,14,28,42,45,51,96,15,4,19,14,39,28,10,18,109,119
2020,2,22000422,2/15/2021,1610612752,New York Knicks,1,1,1610612737,Atlanta Hawks,0,0,25,24,49,17,17,34,42,41,83,22,5,27,13,32,22,5,9,92,123
2022,2,22200843,2/10/2023,1610612760,Oklahoma City Thunder,0,1,1610612757,Portland Trail Blazers,1,0,35,24,59,12,12,24,47,36,83,32,3,35,13,24,29,3,11,96,138
2021,2,22100969,3/7/2022,1610612741,Chicago Bulls,0,0,1610612755,Philadelphia 76ers,1,1,31,32,63,8,16,24,39,48,87,20,6,26,17,32,22,5,13,97,106
2021,2,22100969,3/7/2022,1610612755,Philadelphia 76ers,1,1,1610612741,Chicago Bulls,0,0,29,25,54,12,18,30,41,43,84,27,7,34,12,35,29,5,10,98,121
2020,2,22000726,3/31/2021,1610612750,Minnesota Timberwolves,1,1,1610612752,New York Knicks,0,0,22,25,47,14,26,40,36,51,87,16,3,19,15,36,25,7,13,95,102
2020,2,22000726,3/31/2021,1610612752,New York Knicks,0,0,1610612750,Minnesota Timberwolves,1,1,28,31,59,11,12,23,39,43,82,12,5,17,12,33,20,9,17,95,101
2022,2,22200723,1/25/2023,1610612749,Milwaukee Bucks,1,1,1610612743,Denver Nuggets,0,0,24,24,48,13,17,30,37,41,78,20,8,28,10,36,16,9,23,104,107
2017,2,21700404,12/13/2017,1610612754,Indiana Pacers,1,0,1610612760,Oklahoma City Thunder,0,1,29,29,58,11,20,31,40,49,89,4,2,6,13,37,18,10,14,93,95
2017,2,21700404,12/13/2017,1610612760,Oklahoma City Thunder,0,1,1610612754,Indiana Pacers,1,0,23,36,59,13,16,29,36,52,88,15,9,24,21,36,26,11,14,93,100
2023,2,22300057,11/28/2023,1610612766,Charlotte Hornets,0,0,1610612752,New York Knicks,1,1,24,34,58,13,18,31,37,52,89,4,3,7,15,39,21,10,17,94,91
2022,2,22200803,2/5/2023,1610612754,Indiana Pacers,1,0,1610612739,Cleveland Cavaliers,0,1,32,28,60,8,24,32,40,52,92,15,7,22,16,40,28,7,13,96,103
2022,2,22200838,2/10/2023,1610612738,Boston Celtics,1,1,1610612766,Charlotte Hornets,0,0,19,15,34,25,30,55,44,45,89,14,3,17,7,40,34,9,15,104,127
2021,2,22100657,1/17/2022,1610612739,Cleveland Cavaliers,1,1,1610612751,Brooklyn Nets,0,0,31,18,49,11,21,32,42,39,81,19,2,21,12,28,26,11,16,96,114
2021,2,22100657,1/17/2022,1610612751,Brooklyn Nets,0,0,1610612739,Cleveland Cavaliers,1,1,29,24,53,12,18,30,41,42,83,13,5,18,9,33,27,7,14,96,107
2022,2,22201101,3/24/2023,1610612742,Dallas Mavericks,1,0,1610612766,Charlotte Hornets,0,1,32,16,48,9,27,36,41,43,84,18,6,24,7,38,25,7,11,99,109
2022,2,22200162,11/9/2022,1610612737,Atlanta Hawks,1,0,1610612762,Utah Jazz,0,1,43,38,81,8,20,28,51,58,109,9,2,11,21,38,24,5,11,103,119
2022,2,22200162,11/9/2022,1610612762,Utah Jazz,0,1,1610612737,Atlanta Hawks,1,0,27,28,55,17,22,39,44,50,94,20,4,24,16,38,27,5,13,103,125
2022,2,22200161,11/9/2022,1610612742,Dallas Mavericks,0,0,1610612753,Orlando Magic,1,1,21,22,43,11,31,42,32,53,85,12,7,19,7,50,17,1,6,93,87
2022,2,22200788,2/3/2023,1610612756,Phoenix Suns,0,1,1610612738,Boston Celtics,1,0,29,34,63,12,20,32,41,54,95,12,2,14,13,42,28,5,9,96,106
2017,2,21700402,12/12/2017,1610612742,Dallas Mavericks,1,1,1610612759,San Antonio Spurs,0,0,29,36,65,9,15,24,38,51,89,10,2,12,11,41,17,4,8,93,95
2017,2,21700402,12/12/2017,1610612759,San Antonio Spurs,0,0,1610612742,Dallas Mavericks,1,1,28,31,59,7,21,28,35,52,87,12,7,19,12,44,20,8,10,94,89
2022,2,22200161,11/9/2022,1610612753,Orlando Magic,1,1,1610612742,Dallas Mavericks,0,0,28,24,52,8,13,21,36,37,73,14,7,21,10,30,20,14,19,94,94
2021,2,22100656,1/17/2022,1610612755,Philadelphia 76ers,0,0,1610612764,Washington Wizards,1,1,28,32,60,7,19,26,35,51,86,21,4,25,11,41,19,7,12,99,98
2021,2,22100968,3/7/2022,1610612737,Atlanta Hawks,0,0,1610612765,Detroit Pistons,1,1,31,24,55,11,27,38,42,51,93,15,7,22,19,33,28,7,14,99,110
2021,2,22100968,3/7/2022,1610612765,Detroit Pistons,1,1,1610612737,Atlanta Hawks,0,0,31,29,60,12,21,33,43,50,93,15,8,23,19,35,27,3,14,100,113
2023,2,22300221,11/20/2023,1610612752,New York Knicks,0,0,1610612750,Minnesota Timberwolves,1,1,23,31,54,9,29,38,32,60,92,27,7,34,20,41,16,7,10,97,100
2023,2,22300139,11/4/2023,1610612741,Chicago Bulls,0,0,1610612743,Denver Nuggets,1,1,32,28,60,7,19,26,39,47,86,16,7,23,10,39,28,10,11,97,101
2022,2,22200836,2/10/2023,1610612754,Indiana Pacers,1,0,1610612756,Phoenix Suns,0,1,25,21,46,11,28,39,36,49,85,21,7,28,14,39,23,13,15,100,104
2022,2,22200164,11/9/2022,1610612751,Brooklyn Nets,1,1,1610612752,New York Knicks,0,0,28,25,53,14,20,34,42,45,87,14,6,20,12,37,30,5,15,100,112
2022,2,22200164,11/9/2022,1610612752,New York Knicks,0,0,1610612751,Brooklyn Nets,1,1,16,28,44,12,31,43,28,59,87,17,9,26,14,49,21,11,15,99,85
2022,2,22200896,2/24/2023,1610612737,Atlanta Hawks,1,1,1610612739,Cleveland Cavaliers,0,0,35,22,57,15,13,28,50,35,85,21,2,23,8,28,28,9,14,102,136
2022,2,22200874,2/15/2023,1610612754,Indiana Pacers,1,1,1610612741,Chicago Bulls,0,0,21,18,39,18,25,43,39,43,82,21,1,22,10,33,27,10,19,102,117
2016,2,21600351,12/10/2016,1610612744,Golden State Warriors,0,0,1610612763,Memphis Grizzlies,1,1,25,25,50,9,18,27,34,43,77,12,8,20,12,36,15,10,23,98,89
2016,2,21600351,12/10/2016,1610612763,Memphis Grizzlies,1,1,1610612744,Golden State Warriors,0,0,30,31,61,8,18,26,38,49,87,26,3,29,17,33,23,6,12,97,110
2022,2,22201211,4/7/2023,1610612744,Golden State Warriors,0,1,1610612758,Sacramento Kings,1,0,25,17,42,16,20,36,41,37,78,21,3,24,15,24,36,10,24,99,119
2022,2,22200786,2/3/2023,1610612758,Sacramento Kings,0,0,1610612754,Indiana Pacers,1,1,24,24,48,13,25,38,37,49,86,17,3,20,12,40,24,13,20,104,104
2017,2,21700401,12/12/2017,1610612750,Minnesota Timberwolves,1,0,1610612755,Philadelphia 76ers,0,1,39,40,79,5,24,29,44,64,108,19,8,27,19,50,19,6,10,112,112
2017,2,21700401,12/12/2017,1610612755,Philadelphia 76ers,0,1,1610612750,Minnesota Timberwolves,1,0,29,25,54,11,15,26,40,40,80,27,5,32,10,34,32,14,26,111,118
2022,2,22200875,2/15/2023,1610612755,Philadelphia 76ers,1,1,1610612739,Cleveland Cavaliers,0,0,26,25,51,13,14,27,39,39,78,27,2,29,11,28,24,7,12,90,118
2022,2,22200163,11/9/2022,1610612738,Boston Celtics,1,1,1610612765,Detroit Pistons,0,0,29,13,42,18,28,46,47,41,88,16,5,21,9,34,31,7,13,102,128
2022,2,22200874,2/15/2023,1610612741,Chicago Bulls,0,0,1610612754,Indiana Pacers,1,1,26,23,49,15,20,35,41,43,84,16,5,21,8,37,23,6,14,101,113
2022,2,22200988,3/8/2023,1610612740,New Orleans Pelicans,1,1,1610612742,Dallas Mavericks,0,0,29,27,56,13,14,27,42,41,83,16,2,18,10,32,32,7,15,96,113
2022,2,22200163,11/9/2022,1610612765,Detroit Pistons,0,0,1610612738,Boston Celtics,1,1,30,26,56,7,26,33,37,52,89,31,9,40,18,37,15,5,10,101,112
2016,2,21600871,2/25/2017,1610612739,Cleveland Cavaliers,1,0,1610612741,Chicago Bulls,0,1,23,20,43,14,23,37,37,43,80,11,4,15,6,38,24,6,12,95,99
2016,2,21600871,2/25/2017,1610612741,Chicago Bulls,0,1,1610612739,Cleveland Cavaliers,1,0,31,32,63,15,15,30,46,47,93,10,6,16,12,38,34,5,7,95,117
2022,2,22201212,4/7/2023,1610612756,Phoenix Suns,0,0,1610612747,Los Angeles Lakers,1,1,34,34,68,9,27,36,43,61,104,12,2,14,17,46,23,6,9,103,107
2022,2,22200931,2/28/2023,1610612757,Portland Trail Blazers,0,0,1610612744,Golden State Warriors,1,1,25,22,47,12,27,39,37,49,86,19,3,22,13,38,26,5,13,98,105
2023,2,22300486,1/5/2024,1610612740,New Orleans Pelicans,1,0,1610612746,LA Clippers,0,1,21,42,63,12,17,29,33,59,92,17,6,23,20,41,22,6,9,93,95
2022,2,22200722,1/25/2023,1610612745,Houston Rockets,1,0,1610612764,Washington Wizards,0,1,37,32,69,5,23,28,42,55,97,14,6,20,23,35,29,13,14,97,103
2017,2,21700400,12/12/2017,1610612751,Brooklyn Nets,1,1,1610612764,Washington Wizards,0,0,24,17,41,10,33,43,34,50,84,25,8,33,12,42,26,8,14,100,103
2017,2,21700400,12/12/2017,1610612764,Washington Wizards,0,0,1610612751,Brooklyn Nets,1,1,34,39,73,4,18,22,38,57,95,18,4,22,14,45,18,4,11,101,98
2022,2,22200787,2/3/2023,1610612764,Washington Wizards,1,0,1610612757,Portland Trail Blazers,0,1,30,21,51,12,21,33,42,42,84,20,2,22,12,31,27,5,11,93,116
2022,2,22200877,2/15/2023,1610612738,Boston Celtics,1,1,1610612765,Detroit Pistons,0,0,28,19,47,21,24,45,49,43,92,8,2,10,12,32,30,6,11,98,127
2022,2,22200165,11/9/2022,1610612745,Houston Rockets,0,0,1610612761,Toronto Raptors,1,1,28,21,49,9,26,35,37,47,84,26,5,31,18,31,29,12,16,96,109
2022,2,22200165,11/9/2022,1610612761,Toronto Raptors,1,1,1610612745,Houston Rockets,0,0,27,31,58,15,29,44,42,60,102,17,3,20,29,34,19,9,13,96,116
2022,2,22201211,4/7/2023,1610612758,Sacramento Kings,1,0,1610612744,Golden State Warriors,0,1,27,32,59,11,28,39,38,60,98,10,8,18,20,42,24,6,12,99,97
2022,2,22200932,2/28/2023,1610612746,LA Clippers,1,0,1610612750,Minnesota Timberwolves,0,1,24,31,55,11,17,28,35,48,83,20,3,23,14,36,24,14,25,104,101
2022,2,22200957,3/4/2023,1610612739,Cleveland Cavaliers,1,1,1610612765,Detroit Pistons,0,0,31,26,57,14,20,34,45,46,91,10,8,18,11,38,29,5,12,101,114
2023,2,22300105,10/30/2023,1610612761,Toronto Raptors,1,0,1610612757,Portland Trail Blazers,0,1,34,31,65,4,25,29,38,56,94,11,4,15,20,40,19,6,12,92,91
2021,2,22100656,1/17/2022,1610612764,Washington Wizards,1,1,1610612755,Philadelphia 76ers,0,0,33,24,57,9,21,30,42,45,87,24,8,32,16,32,25,9,12,99,117
2020,2,22000421,2/15/2021,1610612745,Houston Rockets,0,0,1610612764,Washington Wizards,1,1,35,19,54,8,29,37,43,48,91,25,9,34,14,38,23,14,18,111,119
2020,2,22000421,2/15/2021,1610612764,Washington Wizards,1,1,1610612745,Houston Rockets,0,0,36,26,62,12,18,30,48,44,92,23,8,31,12,35,25,9,15,110,131
2022,2,22200166,11/9/2022,1610612740,New Orleans Pelicans,0,1,1610612741,Chicago Bulls,1,0,39,26,65,3,16,19,42,42,84,28,8,36,16,30,20,5,16,104,115
2022,2,22200166,11/9/2022,1610612741,Chicago Bulls,1,0,1610612740,New Orleans Pelicans,0,1,37,23,60,7,20,27,44,43,87,16,2,18,7,37,23,8,15,102,111
2022,2,22200963,3/5/2023,1610612741,Chicago Bulls,1,0,1610612754,Indiana Pacers,0,1,35,17,52,10,12,22,45,29,74,22,3,25,8,23,18,5,15,91,122
2023,2,22300830,2/26/2024,1610612763,Memphis Grizzlies,1,0,1610612751,Brooklyn Nets,0,1,22,27,49,7,19,26,29,46,75,21,5,26,11,37,16,5,15,91,86
2016,2,21600350,12/10/2016,1610612741,Chicago Bulls,1,1,1610612748,Miami Heat,0,0,37,39,76,1,7,8,38,46,84,28,3,31,14,33,17,5,11,96,105
2016,2,21600350,12/10/2016,1610612748,Miami Heat,0,0,1610612741,Chicago Bulls,1,1,37,34,71,5,15,20,42,49,91,11,7,18,15,38,25,8,12,96,100
2022,2,22200837,2/10/2023,1610612755,Philadelphia 76ers,1,1,1610612752,New York Knicks,0,0,30,16,46,14,24,38,44,40,84,17,5,22,10,32,27,1,8,92,119
2017,2,21700399,12/12/2017,1610612747,Los Angeles Lakers,0,0,1610612752,New York Knicks,1,1,29,38,67,13,22,35,42,60,102,12,3,15,24,37,24,7,16,102,109
2017,2,21700399,12/12/2017,1610612752,New York Knicks,1,1,1610612747,Los Angeles Lakers,0,0,39,40,79,9,13,22,48,53,101,8,3,11,20,35,25,6,14,102,113
2022,2,22200837,2/10/2023,1610612752,New York Knicks,0,0,1610612755,Philadelphia 76ers,1,1,32,17,49,11,21,32,43,38,81,11,5,16,6,35,23,8,12,93,108
2022,2,22200788,2/3/2023,1610612738,Boston Celtics,1,0,1610612756,Phoenix Suns,0,1,19,18,37,10,28,38,29,46,75,26,5,31,6,44,18,6,15,98,94
2022,2,22200167,11/9/2022,1610612750,Minnesota Timberwolves,1,0,1610612756,Phoenix Suns,0,1,32,19,51,9,18,27,41,37,78,26,6,32,8,32,26,10,19,104,117
2022,2,22200877,2/15/2023,1610612765,Detroit Pistons,0,0,1610612738,Boston Celtics,1,1,32,23,55,11,18,29,43,41,84,12,4,16,8,36,24,10,14,97,109
2022,2,22200879,2/15/2023,1610612763,Memphis Grizzlies,1,1,1610612762,Utah Jazz,0,0,29,38,67,14,26,40,43,64,107,17,8,25,21,47,24,2,4,102,117
2022,2,22200931,2/28/2023,1610612744,Golden State Warriors,1,1,1610612757,Portland Trail Blazers,0,0,37,24,61,12,18,30,49,42,91,13,3,16,18,26,34,8,18,97,123
2022,2,22200167,11/9/2022,1610612756,Phoenix Suns,0,1,1610612750,Minnesota Timberwolves,1,0,31,31,62,16,19,35,47,50,97,19,1,20,15,35,31,4,11,105,129
2022,2,22201212,4/7/2023,1610612747,Los Angeles Lakers,1,1,1610612756,Phoenix Suns,0,0,27,29,56,18,18,36,45,47,92,13,4,17,13,35,25,7,16,103,121
2022,2,22200963,3/5/2023,1610612754,Indiana Pacers,0,1,1610612741,Chicago Bulls,1,0,32,18,50,16,28,44,48,46,94,13,3,16,15,32,27,6,9,92,125
2017,2,21700398,12/12/2017,1610612743,Denver Nuggets,0,1,1610612765,Detroit Pistons,1,0,30,19,49,10,20,30,40,39,79,13,1,14,7,32,27,7,17,97,103
2017,2,21700398,12/12/2017,1610612765,Detroit Pistons,1,0,1610612743,Denver Nuggets,0,1,19,35,54,9,16,25,28,51,79,19,3,22,14,38,17,8,21,97,84
2022,2,22200803,2/5/2023,1610612739,Cleveland Cavaliers,0,1,1610612754,Indiana Pacers,1,0,31,20,51,15,22,37,46,42,88,15,1,16,12,31,33,3,13,97,122
2022,2,22200932,2/28/2023,1610612750,Minnesota Timberwolves,0,1,1610612746,LA Clippers,1,0,34,30,64,9,17,26,43,47,90,13,9,22,15,37,22,11,19,103,108
2021,2,22100655,1/17/2022,1610612752,New York Knicks,1,0,1610612766,Charlotte Hornets,0,1,20,26,46,12,22,34,32,48,80,11,10,21,19,35,22,6,15,86,87
2021,2,22100655,1/17/2022,1610612766,Charlotte Hornets,0,1,1610612752,New York Knicks,1,0,22,25,47,14,25,39,36,50,86,11,6,17,12,42,23,7,7,87,97
2020,2,22000420,2/15/2021,1610612741,Chicago Bulls,0,1,1610612754,Indiana Pacers,1,0,31,38,69,13,20,33,44,58,102,19,3,22,16,43,25,9,19,114,120
2021,2,22100967,3/6/2022,1610612740,New Orleans Pelicans,0,0,1610612743,Denver Nuggets,1,1,34,34,68,14,19,33,48,53,101,20,9,29,16,41,30,7,14,111,130
2021,2,22100967,3/6/2022,1610612743,Denver Nuggets,1,1,1610612740,New Orleans Pelicans,0,0,37,17,54,10,23,33,47,40,87,34,9,43,11,36,32,9,15,111,138
2022,2,22200957,3/4/2023,1610612765,Detroit Pistons,0,0,1610612739,Cleveland Cavaliers,1,1,27,30,57,6,18,24,33,48,81,18,7,25,17,35,19,14,24,102,90
2022,2,22200168,11/9/2022,1610612749,Milwaukee Bucks,0,1,1610612760,Oklahoma City Thunder,1,0,33,37,70,17,19,36,50,56,106,19,3,22,16,41,27,9,17,116,136
2017,2,21700397,12/12/2017,1610612737,Atlanta Hawks,0,0,1610612739,Cleveland Cavaliers,1,1,27,29,56,16,20,36,43,49,92,12,1,13,14,36,26,5,10,96,114
2017,2,21700397,12/12/2017,1610612739,Cleveland Cavaliers,1,1,1610612737,Atlanta Hawks,0,0,28,20,48,20,18,38,48,38,86,7,3,10,8,31,35,8,13,95,123
2016,2,21600870,2/25/2017,1610612740,New Orleans Pelicans,0,0,1610612742,Dallas Mavericks,1,1,26,28,54,5,19,24,31,47,78,16,9,25,13,38,21,12,20,96,83
2016,2,21600870,2/25/2017,1610612742,Dallas Mavericks,1,1,1610612740,New Orleans Pelicans,0,0,24,28,52,12,14,26,36,42,78,12,4,16,8,37,24,7,18,95,96
2021,2,22100654,1/17/2022,1610612738,Boston Celtics,1,1,1610612740,New Orleans Pelicans,0,0,28,20,48,10,22,32,38,42,80,18,2,20,7,36,22,10,14,96,104
2022,2,22201136,3/29/2023,1610612754,Indiana Pacers,1,0,1610612749,Milwaukee Bucks,0,1,39,32,71,14,16,30,53,48,101,16,6,22,10,41,36,5,8,108,136
2022,2,22200928,2/28/2023,1610612760,Oklahoma City Thunder,1,0,1610612758,Sacramento Kings,0,1,32,31,63,11,24,35,43,55,98,20,4,24,14,44,28,3,9,103,117
2022,2,22200168,11/9/2022,1610612760,Oklahoma City Thunder,1,0,1610612749,Milwaukee Bucks,0,1,32,34,66,18,27,45,50,61,111,14,5,19,19,45,24,8,13,115,132
2022,2,22200630,1/12/2023,1610612742,Dallas Mavericks,0,1,1610612747,Los Angeles Lakers,1,0,34,20,54,14,28,42,48,48,96,9,8,17,5,45,25,7,19,115,119
2022,2,22200630,1/12/2023,1610612747,Los Angeles Lakers,1,0,1610612742,Dallas Mavericks,0,1,34,37,71,10,31,41,44,68,112,17,10,27,17,56,24,4,10,117,115
2021,2,22100654,1/17/2022,1610612740,New Orleans Pelicans,0,0,1610612738,Boston Celtics,1,1,27,30,57,9,21,30,36,51,87,11,7,18,12,43,23,6,12,97,92
2020,2,22000420,2/15/2021,1610612754,Indiana Pacers,1,0,1610612741,Chicago Bulls,0,1,30,29,59,9,24,33,39,53,92,25,6,31,9,48,18,6,19,115,112
2022,2,22201136,3/29/2023,1610612749,Milwaukee Bucks,0,1,1610612754,Indiana Pacers,1,0,48,20,68,10,15,25,58,35,93,23,7,30,16,22,28,9,19,109,149
2017,2,21700396,12/11/2017,1610612746,LA Clippers,1,1,1610612761,Toronto Raptors,0,0,26,30,56,8,28,36,34,58,92,20,4,24,17,44,18,8,12,98,96
2017,2,21700396,12/11/2017,1610612761,Toronto Raptors,0,0,1610612746,LA Clippers,1,1,25,26,51,7,22,29,32,48,80,20,6,26,6,44,18,6,13,99,91
2022,2,22200170,11/9/2022,1610612746,LA Clippers,1,1,1610612747,Los Angeles Lakers,0,0,29,19,48,12,21,33,41,40,81,20,6,26,8,35,24,7,15,99,114
2022,2,22200170,11/9/2022,1610612747,Los Angeles Lakers,0,0,1610612746,LA Clippers,1,1,30,26,56,10,22,32,40,48,88,11,6,17,12,38,26,10,16,101,101
2016,2,21600008,10/26/2016,1610612749,Milwaukee Bucks,1,0,1610612766,Charlotte Hornets,0,1,36,40,76,3,13,16,39,53,92,15,5,20,14,41,23,5,8,94,96
2016,2,21600008,10/26/2016,1610612766,Charlotte Hornets,0,1,1610612749,Milwaukee Bucks,1,0,33,33,66,7,16,23,40,49,89,20,4,24,15,38,27,4,10,94,107
2014,2,21400119,11/13/2014,1610612741,Chicago Bulls,0,1,1610612761,Toronto Raptors,1,0,33,29,62,4,11,15,37,40,77,22,10,32,18,27,26,11,20,94,100
2022,2,22200876,2/15/2023,1610612752,New York Knicks,0,1,1610612737,Atlanta Hawks,1,0,31,22,53,14,29,43,45,51,96,18,4,22,15,37,16,6,10,100,122
2022,2,22201101,3/24/2023,1610612766,Charlotte Hornets,0,1,1610612742,Dallas Mavericks,1,0,32,29,61,11,17,28,43,46,89,20,7,27,10,40,32,3,8,98,117
2021,2,22100653,1/16/2022,1610612743,Denver Nuggets,1,0,1610612762,Utah Jazz,0,1,31,21,52,11,32,43,42,53,95,7,1,8,8,46,32,8,9,97,102
2021,2,22100653,1/16/2022,1610612762,Utah Jazz,0,1,1610612743,Denver Nuggets,1,0,29,16,45,15,24,39,44,40,84,22,7,29,9,34,26,5,9,96,125
2020,2,22000419,2/14/2021,1610612739,Cleveland Cavaliers,0,0,1610612746,LA Clippers,1,1,36,32,68,7,18,25,43,50,93,18,7,25,16,37,25,8,15,100,111
2020,2,22000419,2/14/2021,1610612746,LA Clippers,1,1,1610612739,Cleveland Cavaliers,0,0,29,29,58,13,17,30,42,46,88,31,5,36,18,30,31,4,14,102,128
2021,2,22100966,3/6/2022,1610612746,LA Clippers,1,0,1610612752,New York Knicks,0,1,22,32,54,11,23,34,33,55,88,16,6,22,13,46,17,4,10,95,93
2021,2,22100966,3/6/2022,1610612752,New York Knicks,0,1,1610612746,LA Clippers,1,0,29,31,60,13,16,29,42,47,89,19,11,30,18,36,19,2,10,94,116
2022,2,22200169,11/9/2022,1610612759,San Antonio Spurs,1,0,1610612763,Memphis Grizzlies,0,1,35,26,61,12,25,37,47,51,98,16,7,23,18,36,30,4,12,105,122
2022,2,22201176,4/4/2023,1610612761,Toronto Raptors,0,1,1610612766,Charlotte Hornets,1,0,27,28,55,15,18,33,42,46,88,21,7,28,12,37,27,3,7,95,120
2022,2,22200169,11/9/2022,1610612763,Memphis Grizzlies,0,1,1610612759,San Antonio Spurs,1,0,36,30,66,14,18,32,50,48,98,10,3,13,20,28,24,8,20,103,124
2014,2,21400119,11/13/2014,1610612761,Toronto Raptors,1,0,1610612741,Chicago Bulls,0,1,27,37,64,8,17,25,35,54,89,15,6,21,16,40,17,7,14,96,93
2016,2,21600869,2/25/2017,1610612748,Miami Heat,1,1,1610612754,Indiana Pacers,0,0,25,22,47,13,18,31,38,40,78,24,7,31,13,31,23,8,17,98,113
2016,2,21600869,2/25/2017,1610612754,Indiana Pacers,0,0,1610612748,Miami Heat,1,1,30,43,73,4,8,12,34,51,85,23,3,26,17,35,21,9,15,97,95
2022,2,22200900,2/24/2023,1610612751,Brooklyn Nets,0,0,1610612741,Chicago Bulls,1,1,18,19,37,12,32,44,30,51,81,15,4,19,8,45,21,6,14,96,87
2022,2,22200838,2/10/2023,1610612766,Charlotte Hornets,0,0,1610612738,Boston Celtics,1,1,37,33,70,8,15,23,45,48,93,18,8,26,13,39,26,7,13,105,116
2016,2,21600007,10/26/2016,1610612761,Toronto Raptors,1,1,1610612765,Detroit Pistons,0,0,38,30,68,3,15,18,41,45,86,24,5,29,15,35,17,8,12,97,109
2022,2,22200873,2/15/2023,1610612766,Charlotte Hornets,1,1,1610612759,San Antonio Spurs,0,0,29,32,61,14,21,35,43,53,96,20,9,29,18,40,26,7,16,107,120
2016,2,21600007,10/26/2016,1610612765,Detroit Pistons,0,0,1610612761,Toronto Raptors,1,1,31,31,62,4,18,22,35,49,84,17,5,22,12,40,17,8,14,97,91
2022,2,22200182,11/11/2022,1610612739,Cleveland Cavaliers,0,0,1610612744,Golden State Warriors,1,1,29,33,62,8,22,30,37,55,92,19,7,26,17,40,25,5,13,97,101
2021,2,22100965,3/6/2022,1610612760,Oklahoma City Thunder,1,0,1610612762,Utah Jazz,0,1,31,21,52,8,32,40,39,53,92,17,2,19,15,38,20,4,8,95,103
2021,2,22100965,3/6/2022,1610612762,Utah Jazz,0,1,1610612760,Oklahoma City Thunder,1,0,17,20,37,23,29,52,40,49,89,13,4,17,14,37,27,11,11,95,116
2022,2,22201104,3/24/2023,1610612741,Chicago Bulls,0,1,1610612757,Portland Trail Blazers,1,0,31,25,56,17,11,28,48,36,84,11,3,14,12,25,33,10,17,96,124
2017,2,21700395,12/11/2017,1610612744,Golden State Warriors,1,1,1610612757,Portland Trail Blazers,0,0,34,26,60,10,10,20,44,36,80,13,4,17,8,28,26,11,14,95,111
2017,2,21700395,12/11/2017,1610612757,Portland Trail Blazers,0,0,1610612744,Golden State Warriors,1,1,30,30,60,7,21,28,37,51,88,23,2,25,15,38,14,5,10,95,104
2022,2,22201019,3/12/2023,1610612747,Los Angeles Lakers,1,0,1610612752,New York Knicks,0,1,31,22,53,12,24,36,43,46,89,10,7,17,14,35,24,8,11,94,108
2022,2,22200182,11/11/2022,1610612744,Golden State Warriors,1,1,1610612739,Cleveland Cavaliers,0,0,25,21,46,15,21,36,40,42,82,11,3,14,8,35,29,6,15,96,106
2023,2,22300104,10/30/2023,1610612750,Minnesota Timberwolves,0,0,1610612737,Atlanta Hawks,1,1,28,29,57,16,17,33,44,46,90,9,6,15,15,33,24,6,14,97,113
2020,2,22000418,2/14/2021,1610612758,Sacramento Kings,1,0,1610612763,Memphis Grizzlies,0,1,33,16,49,8,25,33,41,41,82,20,6,26,9,34,22,10,16,102,110
2020,2,22000418,2/14/2021,1610612763,Memphis Grizzlies,0,1,1610612758,Sacramento Kings,1,0,41,32,73,9,12,21,50,44,94,15,4,19,14,32,31,8,11,101,124
2021,2,22100964,3/6/2022,1610612745,Houston Rockets,1,1,1610612763,Memphis Grizzlies,0,0,30,18,48,13,21,34,43,39,82,24,12,36,14,29,23,12,17,101,123
2021,2,22100964,3/6/2022,1610612763,Memphis Grizzlies,0,0,1610612745,Houston Rockets,1,1,39,32,71,5,21,26,44,53,97,19,8,27,19,38,27,4,11,103,112
2023,2,22300328,12/15/2023,1610612764,Washington Wizards,1,1,1610612754,Indiana Pacers,0,0,39,26,65,13,14,27,52,40,92,20,6,26,13,29,36,7,19,110,137
2017,2,21700394,12/11/2017,1610612760,Oklahoma City Thunder,1,0,1610612766,Charlotte Hornets,0,1,26,33,59,9,17,26,35,50,85,24,1,25,15,35,16,7,14,95,103
2022,2,22200184,11/12/2022,1610612746,LA Clippers,1,0,1610612751,Brooklyn Nets,0,1,23,31,54,11,20,31,34,51,85,16,4,20,15,38,22,9,18,97,95
2017,2,21700394,12/11/2017,1610612766,Charlotte Hornets,0,1,1610612760,Oklahoma City Thunder,1,0,30,26,56,13,12,25,43,38,81,17,7,24,10,30,22,4,14,95,116
2022,2,22200804,2/5/2023,1610612755,Philadelphia 76ers,0,0,1610612752,New York Knicks,1,1,23,26,49,7,18,25,30,44,74,30,6,36,10,38,23,5,12,94,97
2022,2,22201019,3/12/2023,1610612752,New York Knicks,0,1,1610612747,Los Angeles Lakers,1,0,31,20,51,11,26,37,42,46,88,17,4,21,15,32,18,6,11,93,112
2022,2,22200839,2/10/2023,1610612762,Utah Jazz,0,1,1610612761,Toronto Raptors,1,0,41,22,63,6,18,24,47,40,87,22,7,29,14,32,31,11,17,103,122
2023,2,22300137,11/4/2023,1610612745,Houston Rockets,1,1,1610612758,Sacramento Kings,0,0,27,24,51,13,23,36,40,47,87,14,6,20,15,36,28,5,11,94,107
2022,2,22200388,12/10/2022,1610612754,Indiana Pacers,1,0,1610612751,Brooklyn Nets,0,1,26,15,41,21,23,44,47,38,85,18,6,24,10,31,30,7,19,103,133
2022,2,22200184,11/12/2022,1610612751,Brooklyn Nets,0,1,1610612746,LA Clippers,1,0,24,24,48,16,19,35,40,43,83,14,7,21,8,38,27,4,13,97,110
2022,2,22201104,3/24/2023,1610612757,Portland Trail Blazers,1,0,1610612741,Chicago Bulls,0,1,31,24,55,6,25,31,37,49,86,16,2,18,12,38,23,6,14,96,96
2022,2,22200183,11/11/2022,1610612747,Los Angeles Lakers,1,0,1610612758,Sacramento Kings,0,1,32,31,63,10,15,25,42,46,88,20,6,26,17,31,22,10,14,97,114
2017,2,21700393,12/11/2017,1610612748,Miami Heat,0,1,1610612763,Memphis Grizzlies,1,0,23,16,39,14,13,27,37,29,66,19,5,24,5,27,24,6,14,86,107
2022,2,22200806,2/5/2023,1610612743,Denver Nuggets,0,0,1610612750,Minnesota Timberwolves,1,1,28,18,46,6,19,25,34,37,71,24,7,31,7,33,19,7,22,102,98
2022,2,22200839,2/10/2023,1610612761,Toronto Raptors,1,0,1610612762,Utah Jazz,0,1,29,28,57,12,22,34,41,50,91,22,8,30,15,38,28,6,13,103,116
2021,2,22100652,1/16/2022,1610612744,Golden State Warriors,0,0,1610612750,Minnesota Timberwolves,1,1,19,21,40,13,29,42,32,50,82,22,7,29,10,41,20,8,15,103,99
2022,2,22200900,2/24/2023,1610612741,Chicago Bulls,1,1,1610612751,Brooklyn Nets,0,0,38,24,62,12,14,26,50,38,88,19,9,28,13,31,25,6,11,98,131
2022,2,22200878,2/15/2023,1610612748,Miami Heat,0,0,1610612751,Brooklyn Nets,1,1,30,25,55,8,20,28,38,45,83,21,8,29,16,33,19,3,8,90,105
2022,2,22200183,11/11/2022,1610612758,Sacramento Kings,0,1,1610612747,Los Angeles Lakers,1,0,33,18,51,12,24,36,45,42,87,18,3,21,13,29,27,11,15,98,120
2021,2,22100963,3/6/2022,1610612754,Indiana Pacers,0,0,1610612764,Washington Wizards,1,1,34,20,54,10,21,31,44,41,85,25,4,29,10,33,28,6,10,99,123
2021,2,22100963,3/6/2022,1610612764,Washington Wizards,1,1,1610612754,Indiana Pacers,0,0,28,16,44,17,25,42,45,41,86,26,6,32,8,36,33,3,6,99,133
2022,2,22200928,2/28/2023,1610612758,Sacramento Kings,0,1,1610612760,Oklahoma City Thunder,1,0,28,12,40,15,27,42,43,39,82,22,8,30,13,31,34,9,21,103,123
2017,2,21700393,12/11/2017,1610612763,Memphis Grizzlies,1,0,1610612748,Miami Heat,0,1,20,25,45,8,19,27,28,44,72,18,9,27,13,35,17,8,15,88,82
2022,2,22200185,11/12/2022,1610612762,Utah Jazz,0,0,1610612764,Washington Wizards,1,1,30,24,54,14,26,40,44,50,94,10,1,11,11,40,33,6,12,101,112
2016,2,21600868,2/25/2017,1610612752,New York Knicks,1,1,1610612755,Philadelphia 76ers,0,0,37,33,70,6,15,21,43,48,91,18,5,23,15,37,21,6,12,97,110
2022,2,22200805,2/5/2023,1610612763,Memphis Grizzlies,1,0,1610612761,Toronto Raptors,0,1,28,23,51,10,17,27,38,40,78,17,6,23,9,33,25,11,20,98,103
2023,2,22300137,11/4/2023,1610612758,Sacramento Kings,0,0,1610612745,Houston Rockets,1,1,21,22,43,11,30,41,32,52,84,14,5,19,9,46,20,4,11,94,89
2021,2,22100652,1/16/2022,1610612750,Minnesota Timberwolves,1,1,1610612744,Golden State Warriors,0,0,29,19,48,16,27,43,45,46,91,13,7,20,10,40,30,6,16,102,119
2016,2,21600868,2/25/2017,1610612755,Philadelphia 76ers,0,0,1610612752,New York Knicks,1,1,33,31,64,7,24,31,40,55,95,22,5,27,21,36,19,6,12,98,109
2021,2,22100962,3/6/2022,1610612739,Cleveland Cavaliers,1,1,1610612761,Toronto Raptors,0,0,28,21,49,11,25,36,39,46,85,15,8,23,19,33,24,13,19,95,104
2022,2,22200946,3/3/2023,1610612753,Orlando Magic,0,1,1610612766,Charlotte Hornets,1,0,36,24,60,10,16,26,46,40,86,15,4,19,15,27,21,11,20,99,117
2021,2,22100962,3/6/2022,1610612761,Toronto Raptors,0,0,1610612739,Cleveland Cavaliers,1,1,31,39,70,6,18,24,37,57,94,16,10,26,16,46,17,5,7,97,96
2022,2,22200185,11/12/2022,1610612764,Washington Wizards,1,1,1610612762,Utah Jazz,0,0,28,24,52,16,20,36,44,44,88,17,3,20,7,38,27,4,9,99,121
2017,2,21700392,12/11/2017,1610612740,New Orleans Pelicans,0,0,1610612745,Houston Rockets,1,1,31,21,52,18,15,33,49,36,85,7,6,13,7,32,32,12,18,104,123
2017,2,21700392,12/11/2017,1610612745,Houston Rockets,1,1,1610612740,New Orleans Pelicans,0,0,31,12,43,17,28,45,48,40,88,17,8,25,6,38,30,6,9,105,130
2022,2,22200186,11/12/2022,1610612738,Boston Celtics,0,1,1610612765,Detroit Pistons,1,0,21,22,43,18,30,48,39,52,91,21,3,24,12,42,27,4,7,98,117
2022,2,22200186,11/12/2022,1610612765,Detroit Pistons,1,0,1610612738,Boston Celtics,0,1,21,30,51,16,22,38,37,52,89,18,3,21,15,37,23,6,14,98,108
2016,2,21600349,12/10/2016,1610612739,Cleveland Cavaliers,1,1,1610612766,Charlotte Hornets,0,0,29,13,42,13,18,31,42,31,73,19,9,28,9,27,25,5,18,96,116
2022,2,22200807,2/5/2023,1610612740,New Orleans Pelicans,1,1,1610612758,Sacramento Kings,0,0,34,25,59,14,12,26,48,37,85,26,8,34,15,27,26,5,11,96,136
2016,2,21600349,12/10/2016,1610612766,Charlotte Hornets,0,0,1610612739,Cleveland Cavaliers,1,1,29,30,59,10,17,27,39,47,86,17,7,24,16,35,24,8,14,97,105
2022,2,22201084,3/22/2023,1610612748,Miami Heat,1,1,1610612752,New York Knicks,0,0,29,22,51,16,12,28,45,34,79,21,5,26,3,33,28,7,10,99,127
2020,2,22000725,3/31/2021,1610612762,Utah Jazz,0,1,1610612763,Memphis Grizzlies,1,0,22,18,40,16,33,49,38,51,89,19,6,25,17,37,20,10,15,102,111
2020,2,22000725,3/31/2021,1610612763,Memphis Grizzlies,1,0,1610612762,Utah Jazz,0,1,37,35,72,5,13,18,42,48,90,18,5,23,12,38,23,10,11,101,107
2014,2,21400118,11/13/2014,1610612758,Sacramento Kings,0,0,1610612763,Memphis Grizzlies,1,1,30,34,64,7,6,13,37,40,77,29,5,34,16,26,12,9,15,93,110
2016,2,21600867,2/25/2017,1610612737,Atlanta Hawks,0,0,1610612753,Orlando Magic,1,1,24,36,60,8,17,25,32,53,85,14,12,26,16,42,21,11,18,100,86
2022,2,22200807,2/5/2023,1610612758,Sacramento Kings,0,0,1610612740,New Orleans Pelicans,1,1,24,16,40,11,31,42,35,47,82,23,4,27,13,37,23,11,15,95,104
2016,2,21600867,2/25/2017,1610612753,Orlando Magic,1,1,1610612737,Atlanta Hawks,0,0,29,25,54,8,19,27,37,44,81,23,1,24,7,37,21,4,14,99,105
2022,2,22200804,2/5/2023,1610612752,New York Knicks,1,1,1610612755,Philadelphia 76ers,0,0,22,21,43,12,24,36,34,45,79,28,11,39,15,37,21,4,12,94,108
2022,2,22200898,2/24/2023,1610612750,Minnesota Timberwolves,1,0,1610612766,Charlotte Hornets,0,1,35,25,60,11,22,33,46,47,93,10,6,16,10,42,25,10,16,104,113
2022,2,22200878,2/15/2023,1610612751,Brooklyn Nets,1,1,1610612748,Miami Heat,0,0,24,14,38,17,22,39,41,36,77,17,3,20,7,30,26,4,11,89,116
2022,2,22200985,3/8/2023,1610612764,Washington Wizards,1,0,1610612737,Atlanta Hawks,0,1,35,19,54,12,17,29,47,36,83,14,3,17,9,28,34,11,19,101,120
2022,2,22200187,11/12/2022,1610612754,Indiana Pacers,1,1,1610612761,Toronto Raptors,0,0,22,17,39,19,24,43,41,41,82,17,6,23,15,28,33,12,21,99,118
2022,2,22200187,11/12/2022,1610612761,Toronto Raptors,0,0,1610612754,Indiana Pacers,1,1,30,29,59,7,28,35,37,57,94,23,6,29,18,42,14,4,12,100,104
2023,2,22300095,10/29/2023,1610612743,Denver Nuggets,0,1,1610612760,Oklahoma City Thunder,1,0,42,19,61,11,16,27,53,35,88,11,2,13,12,24,34,8,13,94,128
2022,2,22200188,11/12/2022,1610612737,Atlanta Hawks,0,0,1610612755,Philadelphia 76ers,1,1,34,31,65,6,18,24,40,49,89,23,4,27,20,32,20,10,19,102,109
2017,2,21700391,12/11/2017,1610612738,Boston Celtics,0,0,1610612741,Chicago Bulls,1,1,23,20,43,10,30,40,33,50,83,9,5,14,14,38,22,9,16,93,85
2021,2,22100651,1/16/2022,1610612745,Houston Rockets,0,1,1610612758,Sacramento Kings,1,0,25,11,36,16,24,40,41,35,76,20,4,24,5,31,22,16,23,104,118
2021,2,22100651,1/16/2022,1610612758,Sacramento Kings,1,0,1610612745,Houston Rockets,0,1,29,24,53,12,26,38,41,50,91,18,6,24,9,44,26,6,12,104,112
2020,2,22000417,2/14/2021,1610612753,Orlando Magic,0,0,1610612756,Phoenix Suns,1,1,27,27,54,6,29,35,33,56,89,18,4,22,11,48,13,6,10,97,90
2021,2,22100961,3/6/2022,1610612749,Milwaukee Bucks,1,1,1610612756,Phoenix Suns,0,0,32,23,55,15,17,32,47,40,87,23,6,29,16,25,31,8,15,98,132
2021,2,22100961,3/6/2022,1610612756,Phoenix Suns,0,0,1610612749,Milwaukee Bucks,1,1,36,26,62,14,17,31,50,43,93,8,3,11,10,35,33,9,11,99,122
2022,2,22200806,2/5/2023,1610612750,Minnesota Timberwolves,1,1,1610612743,Denver Nuggets,0,0,38,22,60,10,17,27,48,39,87,22,8,30,8,35,33,6,11,102,128
2018,2,21801108,3/26/2019,1610612738,Boston Celtics,0,1,1610612739,Cleveland Cavaliers,1,0,36,30,66,10,15,25,46,45,91,14,5,19,12,36,23,4,10,97,116
2017,2,21700391,12/11/2017,1610612741,Chicago Bulls,1,1,1610612738,Boston Celtics,0,0,27,25,52,12,17,29,39,42,81,18,7,25,10,35,23,2,9,92,108
2022,2,22200188,11/12/2022,1610612755,Philadelphia 76ers,1,1,1610612737,Atlanta Hawks,0,0,36,20,56,8,16,24,44,36,80,25,6,31,6,32,24,4,12,101,121
2014,2,21400118,11/13/2014,1610612763,Memphis Grizzlies,1,1,1610612758,Sacramento Kings,0,0,33,35,68,6,3,9,39,38,77,27,7,34,10,32,24,6,9,93,111
2022,2,22200805,2/5/2023,1610612761,Toronto Raptors,0,1,1610612763,Memphis Grizzlies,1,0,33,32,65,11,25,36,44,57,101,7,5,12,21,38,24,10,11,99,106
2020,2,22000417,2/14/2021,1610612756,Phoenix Suns,1,1,1610612753,Orlando Magic,0,0,29,26,55,12,25,37,41,51,92,15,1,16,12,39,24,4,8,97,109
2019,2,21900204,11/20/2019,1610612737,Atlanta Hawks,1,0,1610612749,Milwaukee Bucks,0,1,30,35,65,14,17,31,44,52,96,25,6,31,12,42,27,6,13,112,127
2019,2,21900204,11/20/2019,1610612749,Milwaukee Bucks,0,1,1610612737,Atlanta Hawks,1,0,29,15,44,17,26,43,46,41,87,26,8,34,10,37,25,8,19,111,135
2017,2,21700390,12/10/2017,1610612737,Atlanta Hawks,0,0,1610612752,New York Knicks,1,1,28,18,46,9,22,31,37,40,77,24,6,30,11,32,22,9,16,99,107
2017,2,21700390,12/10/2017,1610612752,New York Knicks,1,1,1610612737,Atlanta Hawks,0,0,34,29,63,5,12,17,39,41,80,28,6,34,10,34,16,5,12,98,111
2016,2,21600866,2/25/2017,1610612758,Sacramento Kings,1,0,1610612766,Charlotte Hornets,0,1,20,31,51,11,17,28,31,48,79,12,3,15,11,38,18,10,14,89,85
2016,2,21600866,2/25/2017,1610612766,Charlotte Hornets,0,1,1610612758,Sacramento Kings,1,0,20,27,47,14,24,38,34,51,85,17,1,18,15,36,26,3,11,89,99
2016,2,21600348,12/10/2016,1610612754,Indiana Pacers,1,1,1610612757,Portland Trail Blazers,0,0,25,29,54,15,14,29,40,43,83,23,5,28,13,32,24,6,13,95,118
2022,2,22200876,2/15/2023,1610612737,Atlanta Hawks,1,0,1610612752,New York Knicks,0,1,35,36,71,5,21,26,40,57,97,16,5,21,10,49,25,2,5,101,101
2022,2,22200946,3/3/2023,1610612766,Charlotte Hornets,1,0,1610612753,Orlando Magic,0,1,29,25,54,9,15,24,38,40,78,21,4,25,12,30,25,9,21,97,106
2021,2,22100650,1/15/2022,1610612742,Dallas Mavericks,1,1,1610612753,Orlando Magic,0,0,20,24,44,12,22,34,32,46,78,32,6,38,14,34,16,7,10,92,108
2021,2,22100960,3/6/2022,1610612738,Boston Celtics,1,1,1610612751,Brooklyn Nets,0,0,23,24,47,17,19,36,40,43,83,29,9,38,11,35,25,6,10,99,126
2021,2,22100960,3/6/2022,1610612751,Brooklyn Nets,0,0,1610612738,Boston Celtics,1,1,33,29,62,12,15,27,45,44,89,18,2,20,15,30,24,9,16,99,120
2022,2,22200986,3/8/2023,1610612738,Boston Celtics,1,1,1610612757,Portland Trail Blazers,0,0,24,15,39,18,31,49,42,46,88,13,7,20,6,43,26,5,11,102,115
2022,2,22200190,11/12/2022,1610612742,Dallas Mavericks,1,1,1610612757,Portland Trail Blazers,0,0,27,11,38,14,29,43,41,40,81,21,5,26,10,34,26,6,11,94,117
2022,2,22201120,3/26/2023,1610612760,Oklahoma City Thunder,0,1,1610612757,Portland Trail Blazers,1,0,29,30,59,12,23,35,41,53,94,24,4,28,17,37,23,5,11,100,118
2022,2,22201103,3/24/2023,1610612744,Golden State Warriors,1,1,1610612755,Philadelphia 76ers,0,0,24,14,38,18,32,50,42,46,88,18,6,24,11,38,27,8,11,99,120
2022,2,22200190,11/12/2022,1610612757,Portland Trail Blazers,0,0,1610612742,Dallas Mavericks,1,1,23,26,49,13,18,31,36,44,80,27,8,35,14,34,20,8,12,94,112
2017,2,21700389,12/10/2017,1610612740,New Orleans Pelicans,1,1,1610612755,Philadelphia 76ers,0,0,31,25,56,15,9,24,46,34,80,24,8,32,8,29,31,5,15,102,131
2017,2,21700389,12/10/2017,1610612755,Philadelphia 76ers,0,0,1610612740,New Orleans Pelicans,1,1,35,32,67,9,20,29,44,52,96,27,3,30,23,30,26,11,17,102,124
2021,2,22100650,1/15/2022,1610612753,Orlando Magic,0,0,1610612742,Dallas Mavericks,1,1,30,21,51,7,19,26,37,40,77,11,5,16,8,35,16,6,17,92,92
2022,2,22200189,11/12/2022,1610612748,Miami Heat,1,1,1610612766,Charlotte Hornets,0,0,33,19,52,16,25,41,49,44,93,18,3,21,12,34,32,4,12,100,132
2014,2,21400117,11/12/2014,1610612745,Houston Rockets,0,1,1610612750,Minnesota Timberwolves,1,0,30,31,61,13,15,28,43,46,89,14,5,19,15,34,25,6,13,95,113
2022,2,22200873,2/15/2023,1610612759,San Antonio Spurs,0,0,1610612766,Charlotte Hornets,1,1,28,41,69,13,25,38,41,66,107,15,5,20,26,43,24,8,15,108,110
2022,2,22200189,11/12/2022,1610612766,Charlotte Hornets,0,0,1610612748,Miami Heat,1,1,37,22,59,9,22,31,46,44,90,14,2,16,7,39,25,7,12,101,115
2017,2,21700388,12/10/2017,1610612742,Dallas Mavericks,0,0,1610612750,Minnesota Timberwolves,1,1,26,24,50,11,20,31,37,44,81,7,2,9,8,36,23,7,11,88,92
2017,2,21700388,12/10/2017,1610612750,Minnesota Timberwolves,1,1,1610612742,Dallas Mavericks,0,0,29,24,53,7,12,19,36,36,72,18,5,23,12,27,19,6,18,88,97
2016,2,21600348,12/10/2016,1610612757,Portland Trail Blazers,0,0,1610612754,Indiana Pacers,1,1,24,21,45,16,21,37,40,42,82,15,1,16,12,30,22,11,19,96,111
2022,2,22200191,11/12/2022,1610612740,New Orleans Pelicans,1,1,1610612745,Houston Rockets,0,0,34,23,57,8,21,29,42,44,86,27,4,31,13,33,28,7,12,100,119
2022,2,22200988,3/8/2023,1610612742,Dallas Mavericks,0,0,1610612740,New Orleans Pelicans,1,1,22,20,42,16,30,46,38,50,88,14,5,19,9,44,24,4,9,97,106
2022,2,22200898,2/24/2023,1610612766,Charlotte Hornets,0,1,1610612750,Minnesota Timberwolves,1,0,33,31,64,10,18,28,43,49,92,25,3,28,12,39,25,6,11,104,121
2022,2,22200947,3/3/2023,1610612757,Portland Trail Blazers,0,0,1610612737,Atlanta Hawks,1,1,28,20,48,13,26,39,41,46,87,16,4,20,13,34,22,10,18,102,111
2021,2,22100649,1/15/2022,1610612743,Denver Nuggets,1,1,1610612747,Los Angeles Lakers,0,0,24,27,51,23,17,40,47,44,91,16,1,17,11,33,35,4,6,94,133
2021,2,22100649,1/15/2022,1610612747,Los Angeles Lakers,0,0,1610612743,Denver Nuggets,1,1,26,26,52,10,20,30,36,46,82,14,5,19,8,42,21,9,11,94,96
2014,2,21400487,1/2/2015,1610612752,New York Knicks,1,0,1610612765,Detroit Pistons,0,1,22,45,67,10,14,24,32,59,91,7,7,14,21,43,18,10,14,90,81
2014,2,21400487,1/2/2015,1610612765,Detroit Pistons,0,1,1610612752,New York Knicks,1,0,25,18,43,13,20,33,38,38,76,8,6,14,10,32,24,13,17,91,97
2022,2,22200958,3/4/2023,1610612748,Miami Heat,1,1,1610612737,Atlanta Hawks,0,0,29,19,48,13,22,35,42,41,83,20,3,23,14,29,31,12,20,99,117
2022,2,22200191,11/12/2022,1610612745,Houston Rockets,0,0,1610612740,New Orleans Pelicans,1,1,28,15,43,12,24,36,40,39,79,14,4,18,13,29,24,13,26,100,106
2022,2,22201084,3/22/2023,1610612752,New York Knicks,0,0,1610612748,Miami Heat,1,1,26,16,42,16,24,40,42,40,82,20,5,25,13,29,29,9,17,100,120
2022,2,22201103,3/24/2023,1610612755,Philadelphia 76ers,0,0,1610612744,Golden State Warriors,1,1,30,19,49,8,21,29,38,40,78,28,6,34,4,39,23,3,10,98,112
2022,2,22200727,1/25/2023,1610612762,Utah Jazz,0,0,1610612757,Portland Trail Blazers,1,1,27,22,49,20,21,41,47,43,90,10,5,15,10,35,32,9,13,98,124
2014,2,21400117,11/12/2014,1610612750,Minnesota Timberwolves,1,0,1610612745,Houston Rockets,0,1,30,39,69,6,6,12,36,45,81,23,7,30,16,31,22,7,14,96,101
2016,2,21600865,2/24/2017,1610612746,LA Clippers,1,0,1610612759,San Antonio Spurs,0,1,28,28,56,7,16,23,35,44,79,20,4,24,12,36,18,9,12,90,97
2022,2,22201098,3/24/2023,1610612759,San Antonio Spurs,0,0,1610612764,Washington Wizards,1,1,38,25,63,13,25,38,51,50,101,9,6,15,15,38,35,3,5,98,124
2016,2,21600865,2/24/2017,1610612759,San Antonio Spurs,0,1,1610612746,LA Clippers,1,0,26,30,56,9,17,26,35,47,82,26,4,30,21,30,23,9,15,90,105
2022,2,22200880,2/15/2023,1610612760,Oklahoma City Thunder,1,1,1610612745,Houston Rockets,0,0,33,20,53,9,25,34,42,45,87,40,7,47,13,36,21,5,11,106,133
2022,2,22201098,3/24/2023,1610612764,Washington Wizards,1,1,1610612759,San Antonio Spurs,0,0,36,19,55,15,15,30,51,34,85,19,7,26,7,32,29,4,10,99,136
2022,2,22201085,3/22/2023,1610612754,Indiana Pacers,0,1,1610612761,Toronto Raptors,1,0,32,24,56,11,10,21,43,34,77,21,4,25,10,27,27,11,18,96,118
2022,2,22200192,11/13/2022,1610612752,New York Knicks,1,0,1610612760,Oklahoma City Thunder,0,1,38,28,66,10,21,31,48,49,97,29,4,33,16,35,25,9,13,108,135
2022,2,22200192,11/13/2022,1610612760,Oklahoma City Thunder,0,1,1610612752,New York Knicks,1,0,38,19,57,17,14,31,55,33,88,18,2,20,9,25,31,13,19,108,145
2017,2,21700387,12/10/2017,1610612743,Denver Nuggets,0,0,1610612754,Indiana Pacers,1,1,26,27,53,17,25,42,43,52,95,13,3,16,24,30,24,6,22,104,116
2017,2,21700387,12/10/2017,1610612754,Indiana Pacers,1,1,1610612743,Denver Nuggets,0,0,39,29,68,10,15,25,49,44,93,18,4,22,13,33,24,7,11,103,126
2014,2,21400116,11/12/2014,1610612751,Brooklyn Nets,0,0,1610612756,Phoenix Suns,1,1,26,27,53,9,12,21,35,39,74,25,7,32,9,34,17,10,19,99,104
2022,2,22201120,3/26/2023,1610612757,Portland Trail Blazers,1,0,1610612760,Oklahoma City Thunder,0,1,25,25,50,14,18,32,39,43,82,20,7,27,12,32,18,13,18,101,112
2022,2,22200728,1/25/2023,1610612758,Sacramento Kings,1,0,1610612761,Toronto Raptors,0,1,22,19,41,13,19,32,35,38,73,12,1,13,6,33,29,12,19,94,95
2022,2,22201121,3/26/2023,1610612750,Minnesota Timberwolves,0,1,1610612744,Golden State Warriors,1,0,17,23,40,17,23,40,34,46,80,14,11,25,13,37,25,9,17,97,99
2021,2,22100648,1/15/2022,1610612746,LA Clippers,0,0,1610612759,San Antonio Spurs,1,1,26,36,62,12,26,38,38,62,100,6,2,8,25,39,24,6,15,95,94
2021,2,22100648,1/15/2022,1610612759,San Antonio Spurs,1,1,1610612746,LA Clippers,0,0,23,23,46,11,26,37,34,49,83,22,5,27,18,34,19,8,15,94,101
2021,2,22100959,3/5/2022,1610612744,Golden State Warriors,0,0,1610612747,Los Angeles Lakers,1,1,31,27,58,15,19,34,46,46,92,9,10,19,13,38,22,10,16,102,116
2022,2,22200879,2/15/2023,1610612762,Utah Jazz,0,0,1610612763,Memphis Grizzlies,1,1,30,25,55,12,24,36,42,49,91,15,4,19,21,30,24,13,24,103,111
2021,2,22100959,3/5/2022,1610612747,Los Angeles Lakers,1,1,1610612744,Golden State Warriors,0,0,26,22,48,18,23,41,44,45,89,18,3,21,15,31,25,11,20,103,124
2022,2,22200964,3/5/2023,1610612744,Golden State Warriors,0,0,1610612747,Los Angeles Lakers,1,1,18,21,39,18,34,52,36,55,91,15,3,18,14,43,27,3,13,99,105
2022,2,22200857,2/13/2023,1610612766,Charlotte Hornets,1,1,1610612737,Atlanta Hawks,0,0,33,14,47,20,17,37,53,31,84,18,5,23,6,27,36,9,17,108,144
2022,2,22201177,4/4/2023,1610612748,Miami Heat,0,1,1610612765,Detroit Pistons,1,0,28,16,44,13,23,36,41,39,80,23,3,26,9,30,26,5,8,91,118
2022,2,22200193,11/13/2022,1610612739,Cleveland Cavaliers,1,0,1610612750,Minnesota Timberwolves,0,1,23,32,55,17,17,34,40,49,89,27,12,39,17,38,22,5,10,101,124
2022,2,22200193,11/13/2022,1610612750,Minnesota Timberwolves,0,1,1610612739,Cleveland Cavaliers,1,0,34,24,58,12,12,24,46,36,82,25,9,34,11,28,30,6,13,100,129
2017,2,21700386,12/10/2017,1610612738,Boston Celtics,0,1,1610612765,Detroit Pistons,1,0,22,27,49,11,19,30,33,46,79,14,4,18,12,35,16,7,14,92,91
2017,2,21700386,12/10/2017,1610612765,Detroit Pistons,1,0,1610612738,Boston Celtics,0,1,18,33,51,10,23,33,28,56,84,15,4,19,16,43,14,4,10,91,81
2016,2,21600006,10/26/2016,1610612738,Boston Celtics,1,1,1610612751,Brooklyn Nets,0,0,37,20,57,11,21,32,48,41,89,15,3,18,14,29,36,8,19,103,122
2016,2,21600006,10/26/2016,1610612751,Brooklyn Nets,0,0,1610612738,Boston Celtics,1,1,28,25,53,15,29,44,43,54,97,16,4,20,19,36,22,13,16,104,117
2022,2,22200194,11/13/2022,1610612763,Memphis Grizzlies,0,0,1610612764,Washington Wizards,1,1,29,39,68,9,19,28,38,58,96,7,3,10,20,40,21,9,17,98,92
2014,2,21401048,3/23/2015,1610612745,Houston Rockets,0,1,1610612754,Indiana Pacers,1,0,18,23,41,13,11,24,31,34,65,35,2,37,6,28,16,7,19,95,110
2014,2,21401048,3/23/2015,1610612754,Indiana Pacers,1,0,1610612745,Houston Rockets,0,1,32,34,66,8,16,24,40,50,90,12,7,19,21,33,21,11,18,96,100
2022,2,22201121,3/26/2023,1610612744,Golden State Warriors,1,0,1610612750,Minnesota Timberwolves,0,1,19,23,42,15,25,40,34,48,82,13,4,17,8,41,25,10,16,98,96
2022,2,22200986,3/8/2023,1610612757,Portland Trail Blazers,0,0,1610612738,Boston Celtics,1,1,19,24,43,11,28,39,30,52,82,22,5,27,9,45,18,9,16,102,93
2016,2,21600864,2/24/2017,1610612743,Denver Nuggets,1,1,1610612751,Brooklyn Nets,0,0,35,31,66,14,17,31,49,48,97,17,7,24,15,37,32,7,14,108,129
2016,2,21600864,2/24/2017,1610612751,Brooklyn Nets,0,0,1610612743,Denver Nuggets,1,1,31,22,53,10,20,30,41,42,83,17,14,31,7,42,27,11,19,108,109
2017,2,21700385,12/10/2017,1610612758,Sacramento Kings,1,0,1610612761,Toronto Raptors,0,1,25,25,50,10,13,23,35,38,73,7,7,14,7,34,15,8,21,93,87
2017,2,21700385,12/10/2017,1610612761,Toronto Raptors,0,1,1610612758,Sacramento Kings,1,0,28,22,50,11,26,37,39,48,87,13,6,19,15,35,22,7,13,95,102
2014,2,21400116,11/12/2014,1610612756,Phoenix Suns,1,1,1610612751,Brooklyn Nets,0,0,31,26,57,8,16,24,39,42,81,26,3,29,15,30,20,9,20,99,112
2016,2,21600347,12/10/2016,1610612743,Denver Nuggets,0,1,1610612753,Orlando Magic,1,0,39,25,64,8,11,19,47,36,83,19,6,25,12,28,25,7,12,94,121
2016,2,21600347,12/10/2016,1610612753,Orlando Magic,1,0,1610612743,Denver Nuggets,0,1,32,29,61,11,16,27,43,45,88,16,8,24,7,41,27,2,5,96,113
2014,2,21400486,1/2/2015,1610612738,Boston Celtics,1,0,1610612742,Dallas Mavericks,0,1,26,29,55,12,22,34,38,51,89,13,6,19,16,39,22,8,14,97,101
2014,2,21400486,1/2/2015,1610612742,Dallas Mavericks,0,1,1610612738,Boston Celtics,1,0,32,37,69,13,14,27,45,51,96,16,1,17,19,32,24,6,12,97,119
2017,2,21700384,12/9/2017,1610612745,Houston Rockets,0,1,1610612757,Portland Trail Blazers,1,0,30,20,50,10,15,25,40,35,75,34,8,42,11,29,14,4,12,97,124
2017,2,21700384,12/9/2017,1610612757,Portland Trail Blazers,1,0,1610612745,Houston Rockets,0,1,27,20,47,18,23,41,45,43,88,9,3,12,14,30,19,13,16,98,117
2016,2,21600863,2/24/2017,1610612737,Atlanta Hawks,1,0,1610612748,Miami Heat,0,1,24,35,59,6,14,20,30,49,79,24,12,36,9,45,14,7,10,99,90
2016,2,21600863,2/24/2017,1610612748,Miami Heat,0,1,1610612737,Atlanta Hawks,1,0,23,39,62,17,20,37,40,59,99,11,2,13,20,39,30,7,13,98,108
2014,2,21400485,1/2/2015,1610612751,Brooklyn Nets,0,1,1610612753,Orlando Magic,1,0,34,18,52,7,13,20,41,31,72,11,7,18,5,29,26,13,22,96,100
2014,2,21400485,1/2/2015,1610612753,Orlando Magic,1,0,1610612751,Brooklyn Nets,0,1,26,40,66,11,11,22,37,51,88,13,7,20,12,43,22,7,11,98,98
2017,2,21700383,12/9/2017,1610612756,Phoenix Suns,1,0,1610612759,San Antonio Spurs,0,1,28,27,55,7,18,25,35,45,80,24,6,30,14,35,11,5,11,94,101
2017,2,21700383,12/9/2017,1610612759,San Antonio Spurs,0,1,1610612756,Phoenix Suns,1,0,34,34,68,6,13,19,40,47,87,18,7,25,21,30,18,4,15,93,104
2016,2,21600346,12/10/2016,1610612749,Milwaukee Bucks,0,0,1610612764,Washington Wizards,1,1,27,27,54,13,12,25,40,39,79,12,3,15,10,30,22,10,20,98,105
2016,2,21600346,12/10/2016,1610612764,Washington Wizards,1,1,1610612749,Milwaukee Bucks,0,0,32,35,67,8,13,21,40,48,88,22,6,28,16,35,29,1,10,97,110
2017,2,21700382,12/9/2017,1610612760,Oklahoma City Thunder,0,1,1610612763,Memphis Grizzlies,1,0,24,34,58,12,22,34,36,56,92,18,13,31,24,37,18,5,10,94,102
2017,2,21700382,12/9/2017,1610612763,Memphis Grizzlies,1,0,1610612760,Oklahoma City Thunder,0,1,26,29,55,13,20,33,39,49,88,10,7,17,19,34,23,7,14,93,101
2016,2,21600862,2/24/2017,1610612742,Dallas Mavericks,0,0,1610612750,Minnesota Timberwolves,1,1,27,23,50,8,25,33,35,48,83,6,3,9,12,38,16,9,16,91,84
2016,2,21600862,2/24/2017,1610612750,Minnesota Timberwolves,1,1,1610612742,Dallas Mavericks,0,0,36,29,65,5,8,13,41,37,78,10,4,14,10,30,24,9,16,89,97
2022,2,22200194,11/13/2022,1610612764,Washington Wizards,1,1,1610612763,Memphis Grizzlies,0,0,17,29,46,19,21,40,36,50,86,11,10,21,13,41,26,7,15,99,102
2014,2,21401047,3/22/2015,1610612747,Los Angeles Lakers,1,1,1610612755,Philadelphia 76ers,0,0,34,33,67,5,9,14,39,42,81,18,4,22,16,29,21,4,14,90,101
2014,2,21401047,3/22/2015,1610612755,Philadelphia 76ers,0,0,1610612747,Los Angeles Lakers,1,1,23,39,62,9,18,27,32,57,89,14,7,21,18,43,22,4,10,90,87
2017,2,21700381,12/9/2017,1610612749,Milwaukee Bucks,1,1,1610612762,Utah Jazz,0,0,37,27,64,7,10,17,44,37,81,22,4,26,9,30,22,7,11,95,117
2017,2,21700381,12/9/2017,1610612762,Utah Jazz,0,0,1610612749,Milwaukee Bucks,1,1,25,28,53,8,15,23,33,43,76,26,11,37,14,35,20,8,16,95,100
2014,2,21400115,11/12/2014,1610612743,Denver Nuggets,1,0,1610612757,Portland Trail Blazers,0,1,31,36,67,8,15,23,39,51,90,27,6,33,19,36,21,7,12,100,113
2014,2,21400115,11/12/2014,1610612757,Portland Trail Blazers,0,1,1610612743,Denver Nuggets,1,0,29,26,55,16,17,33,45,43,88,24,5,29,15,32,30,10,15,99,130
2016,2,21600345,12/9/2016,1610612752,New York Knicks,0,1,1610612758,Sacramento Kings,1,0,26,29,55,10,19,29,36,48,84,21,4,25,13,37,22,10,17,100,103
2016,2,21600345,12/9/2016,1610612758,Sacramento Kings,1,0,1610612752,New York Knicks,0,1,28,31,59,7,21,28,35,52,87,23,4,27,8,47,24,3,7,99,100
2016,2,21600005,10/26/2016,1610612742,Dallas Mavericks,0,0,1610612754,Indiana Pacers,1,1,27,29,56,18,30,48,45,59,104,13,5,18,15,46,26,11,15,115,121
2016,2,21600005,10/26/2016,1610612754,Indiana Pacers,1,1,1610612742,Dallas Mavericks,0,0,37,37,74,10,9,19,47,46,93,26,8,34,11,40,30,8,16,115,130
2017,2,21700380,12/9/2017,1610612741,Chicago Bulls,1,1,1610612752,New York Knicks,0,0,35,22,57,7,18,25,42,40,82,13,10,23,12,34,28,6,15,95,104
2017,2,21700380,12/9/2017,1610612752,New York Knicks,0,0,1610612741,Chicago Bulls,1,1,36,31,67,7,17,24,43,48,91,9,0,9,15,33,25,10,15,96,102
2021,2,22100647,1/15/2022,1610612738,Boston Celtics,1,1,1610612741,Chicago Bulls,0,0,35,29,64,9,17,26,44,46,90,17,2,19,20,26,27,3,11,90,114
2014,2,21400114,11/12/2014,1610612740,New Orleans Pelicans,1,1,1610612747,Los Angeles Lakers,0,0,37,26,63,8,11,19,45,37,82,11,7,18,11,28,27,8,14,92,109
2014,2,21400114,11/12/2014,1610612747,Los Angeles Lakers,0,0,1610612740,New Orleans Pelicans,1,1,28,35,63,7,14,21,35,49,84,25,7,32,15,37,15,3,9,94,102
2016,2,21600344,12/9/2016,1610612747,Los Angeles Lakers,1,0,1610612756,Phoenix Suns,0,1,31,30,61,9,17,26,40,47,87,26,8,34,14,37,18,8,16,104,115
2016,2,21600344,12/9/2016,1610612756,Phoenix Suns,0,1,1610612747,Los Angeles Lakers,1,0,32,33,65,13,17,30,45,50,95,16,4,20,10,43,26,4,8,103,119
2014,2,21400484,1/2/2015,1610612739,Cleveland Cavaliers,0,1,1610612766,Charlotte Hornets,1,0,29,43,72,4,11,15,33,54,87,21,9,30,17,41,16,5,7,92,91
2014,2,21400484,1/2/2015,1610612766,Charlotte Hornets,1,0,1610612739,Cleveland Cavaliers,0,1,26,33,59,6,22,28,32,55,87,17,9,26,24,37,20,8,15,92,87
2016,2,21600861,2/24/2017,1610612747,Los Angeles Lakers,0,0,1610612760,Oklahoma City Thunder,1,1,33,33,66,7,28,35,40,61,101,6,8,14,18,47,23,9,13,103,93
2016,2,21600861,2/24/2017,1610612760,Oklahoma City Thunder,1,1,1610612747,Los Angeles Lakers,0,0,34,39,73,10,14,24,44,53,97,12,5,17,18,39,28,15,17,103,110
2014,2,21401046,3/22/2015,1610612742,Dallas Mavericks,0,0,1610612756,Phoenix Suns,1,1,32,45,77,5,14,19,37,59,96,13,9,22,19,43,21,10,12,98,92
2014,2,21401046,3/22/2015,1610612756,Phoenix Suns,1,1,1610612742,Dallas Mavericks,0,0,33,22,55,6,15,21,39,37,76,14,9,23,12,29,22,9,21,97,98
2016,2,21600004,10/26/2016,1610612748,Miami Heat,0,1,1610612753,Orlando Magic,1,0,43,38,81,4,12,16,47,50,97,10,6,16,22,31,27,5,12,94,108
2016,2,21600004,10/26/2016,1610612753,Orlando Magic,1,0,1610612748,Miami Heat,0,1,28,43,71,6,12,18,34,55,89,22,6,28,18,38,20,5,11,95,96
2014,2,21400483,1/1/2015,1610612750,Minnesota Timberwolves,1,0,1610612758,Sacramento Kings,0,1,35,32,67,7,17,24,42,49,91,16,6,22,19,33,22,7,14,97,107
2014,2,21400483,1/1/2015,1610612758,Sacramento Kings,0,1,1610612750,Minnesota Timberwolves,1,0,35,27,62,5,7,12,40,34,74,25,4,29,13,24,23,12,20,97,110
2014,2,21400113,11/12/2014,1610612752,New York Knicks,1,0,1610612753,Orlando Magic,0,1,29,34,63,8,15,23,37,49,86,13,1,14,14,36,17,4,9,88,95
2014,2,21400113,11/12/2014,1610612753,Orlando Magic,0,1,1610612752,New York Knicks,1,0,27,31,58,6,6,12,33,37,70,25,7,32,9,31,20,2,11,87,97
2017,2,21700379,12/9/2017,1610612739,Cleveland Cavaliers,1,1,1610612755,Philadelphia 76ers,0,0,22,24,46,14,15,29,36,39,75,19,6,25,8,33,26,10,18,97,105
2017,2,21700379,12/9/2017,1610612755,Philadelphia 76ers,0,0,1610612739,Cleveland Cavaliers,1,1,26,19,45,11,22,33,37,41,78,13,0,13,8,33,31,12,19,97,98
2016,2,21600860,2/24/2017,1610612749,Milwaukee Bucks,1,0,1610612762,Utah Jazz,0,1,25,31,56,7,11,18,32,42,74,24,5,29,11,33,15,8,15,91,95
2016,2,21600860,2/24/2017,1610612762,Utah Jazz,0,1,1610612749,Milwaukee Bucks,1,0,29,22,51,8,15,23,37,37,74,27,3,30,13,27,23,5,16,92,109
2017,2,21700378,12/9/2017,1610612737,Atlanta Hawks,1,1,1610612753,Orlando Magic,0,0,24,23,47,17,16,33,41,39,80,18,7,25,10,32,33,7,12,94,117
2017,2,21700378,12/9/2017,1610612753,Orlando Magic,0,0,1610612737,Atlanta Hawks,1,1,32,26,58,13,21,34,45,47,92,7,1,8,14,33,39,7,12,95,110
2014,2,21401045,3/22/2015,1610612750,Minnesota Timberwolves,1,0,1610612766,Charlotte Hornets,0,1,37,26,63,4,7,11,41,33,74,12,4,16,6,29,24,8,13,88,98
2014,2,21401045,3/22/2015,1610612766,Charlotte Hornets,0,1,1610612750,Minnesota Timberwolves,1,0,39,32,71,6,12,18,45,44,89,13,3,16,16,30,21,5,8,88,109
2016,2,21600343,12/9/2016,1610612742,Dallas Mavericks,1,1,1610612754,Indiana Pacers,0,0,24,24,48,15,17,32,39,41,80,18,6,24,7,36,23,5,9,92,111
2016,2,21600343,12/9/2016,1610612754,Indiana Pacers,0,0,1610612742,Dallas Mavericks,1,1,18,26,44,14,11,25,32,37,69,25,1,26,5,32,21,8,13,93,103
2016,2,21600859,2/24/2017,1610612741,Chicago Bulls,1,1,1610612756,Phoenix Suns,0,0,34,38,72,12,14,26,46,52,98,24,7,31,14,42,31,8,12,112,128
2016,2,21600859,2/24/2017,1610612756,Phoenix Suns,0,0,1610612741,Chicago Bulls,1,1,41,28,69,8,16,24,49,44,93,15,10,25,11,38,27,14,19,113,121
2016,2,21600342,12/9/2016,1610612750,Minnesota Timberwolves,1,0,1610612765,Detroit Pistons,0,1,34,28,62,3,13,16,37,41,78,13,7,20,10,34,19,6,11,90,90
2016,2,21600342,12/9/2016,1610612765,Detroit Pistons,0,1,1610612750,Minnesota Timberwolves,1,0,28,27,55,14,15,29,42,42,84,19,4,23,12,31,23,4,8,89,117
2021,2,22100647,1/15/2022,1610612741,Chicago Bulls,0,0,1610612738,Boston Celtics,1,1,32,26,58,12,17,29,44,43,87,12,3,15,11,34,31,6,6,89,112
2016,2,21600003,10/25/2016,1610612744,Golden State Warriors,1,0,1610612759,San Antonio Spurs,0,1,33,19,52,7,26,33,40,45,85,13,5,18,10,38,24,13,16,99,100
2016,2,21600003,10/25/2016,1610612759,San Antonio Spurs,0,1,1610612744,Golden State Warriors,1,0,35,39,74,12,12,24,47,51,98,23,3,26,25,28,25,11,14,100,129
2022,2,22200196,11/13/2022,1610612741,Chicago Bulls,1,0,1610612743,Denver Nuggets,0,1,34,25,59,6,16,22,40,41,81,17,4,21,10,32,24,11,19,100,103
2014,2,21400112,11/12/2014,1610612748,Miami Heat,1,0,1610612754,Indiana Pacers,0,1,20,28,48,9,11,20,29,39,68,8,10,18,6,38,18,5,11,81,75
2014,2,21400112,11/12/2014,1610612754,Indiana Pacers,0,1,1610612748,Miami Heat,1,0,22,32,54,8,18,26,30,50,80,13,2,15,24,28,13,11,16,82,81
2017,2,21700377,12/9/2017,1610612747,Los Angeles Lakers,0,1,1610612766,Charlotte Hornets,1,0,34,24,58,9,18,27,43,42,85,15,6,21,10,35,24,7,14,97,110
2017,2,21700377,12/9/2017,1610612766,Charlotte Hornets,1,0,1610612747,Los Angeles Lakers,0,1,33,35,68,8,17,25,41,52,93,9,5,14,13,41,21,7,11,98,99
2014,2,21400482,1/1/2015,1610612741,Chicago Bulls,1,1,1610612743,Denver Nuggets,0,0,30,46,76,8,7,15,38,53,91,22,3,25,14,40,22,4,7,97,106
2014,2,21400482,1/1/2015,1610612743,Denver Nuggets,0,0,1610612741,Chicago Bulls,1,1,32,46,78,5,9,14,37,55,92,22,5,27,20,39,19,7,13,98,101
2022,2,22200491,12/23/2022,1610612758,Sacramento Kings,1,0,1610612764,Washington Wizards,0,1,27,25,52,10,22,32,37,47,84,27,8,35,14,38,19,9,13,100,111
2022,2,22200491,12/23/2022,1610612764,Washington Wizards,0,1,1610612758,Sacramento Kings,1,0,39,17,56,10,22,32,49,39,88,17,7,24,8,35,30,5,10,100,125
2017,2,21700376,12/9/2017,1610612748,Miami Heat,0,1,1610612751,Brooklyn Nets,1,0,34,29,63,8,19,27,42,48,90,9,4,13,13,37,15,3,6,92,101
2017,2,21700376,12/9/2017,1610612751,Brooklyn Nets,1,0,1610612748,Miami Heat,0,1,26,28,54,7,20,27,33,48,81,16,3,19,11,39,16,6,14,92,89
2022,2,22200196,11/13/2022,1610612743,Denver Nuggets,0,1,1610612741,Chicago Bulls,1,0,35,18,53,13,14,27,48,32,80,17,4,21,5,30,33,9,16,99,126
2014,2,21400481,12/31/2014,1610612740,New Orleans Pelicans,0,0,1610612759,San Antonio Spurs,1,1,26,35,61,8,20,28,34,55,89,17,3,20,14,43,15,5,17,101,93
2014,2,21400481,12/31/2014,1610612759,San Antonio Spurs,1,1,1610612740,New Orleans Pelicans,0,0,33,32,65,6,18,24,39,50,89,11,7,18,10,43,24,8,14,102,95
2016,2,21600858,2/24/2017,1610612738,Boston Celtics,0,0,1610612761,Toronto Raptors,1,1,21,19,40,12,26,38,33,45,78,19,3,22,8,38,19,7,12,92,97
2016,2,21600858,2/24/2017,1610612761,Toronto Raptors,1,1,1610612738,Boston Celtics,0,0,35,31,66,5,10,15,40,41,81,22,7,29,14,31,15,4,11,92,107
2016,2,21600002,10/25/2016,1610612757,Portland Trail Blazers,1,1,1610612762,Utah Jazz,0,0,26,30,56,13,6,19,39,36,75,22,0,22,8,28,22,9,13,89,113
2016,2,21600002,10/25/2016,1610612762,Utah Jazz,0,0,1610612757,Portland Trail Blazers,1,1,32,26,58,8,16,24,40,42,82,16,0,16,11,31,19,5,14,91,104
2014,2,21400480,12/31/2014,1610612756,Phoenix Suns,0,0,1610612760,Oklahoma City Thunder,1,1,33,30,63,13,14,27,46,44,90,29,6,35,8,37,17,6,14,111,134
2014,2,21400480,12/31/2014,1610612760,Oklahoma City Thunder,1,1,1610612756,Phoenix Suns,0,0,30,34,64,11,24,35,41,58,99,44,5,49,24,36,22,7,14,110,137
2017,2,21700375,12/9/2017,1610612746,LA Clippers,1,1,1610612764,Washington Wizards,0,0,25,23,48,14,18,32,39,41,80,21,3,24,7,37,22,5,10,94,113
2017,2,21700375,12/9/2017,1610612764,Washington Wizards,0,0,1610612746,LA Clippers,1,1,29,21,50,13,19,32,42,40,82,15,8,23,11,32,33,8,14,95,112
2014,2,21401044,3/22/2015,1610612743,Denver Nuggets,0,1,1610612753,Orlando Magic,1,0,30,32,62,12,16,28,42,48,90,23,7,30,19,33,30,7,14,98,119
2014,2,21401044,3/22/2015,1610612753,Orlando Magic,1,0,1610612743,Denver Nuggets,0,1,37,31,68,4,13,17,41,44,85,14,3,17,14,32,26,11,19,98,100
2014,2,21400479,12/31/2014,1610612739,Cleveland Cavaliers,1,0,1610612749,Milwaukee Bucks,0,1,21,33,54,8,23,31,29,56,85,14,2,16,15,43,19,10,13,91,80
2014,2,21400479,12/31/2014,1610612749,Milwaukee Bucks,0,1,1610612739,Cleveland Cavaliers,1,0,29,36,65,11,14,25,40,50,90,5,5,10,15,37,25,5,10,92,96
2017,2,21700374,12/8/2017,1610612738,Boston Celtics,0,0,1610612759,San Antonio Spurs,1,1,27,18,45,11,27,38,38,45,83,15,2,17,12,34,14,6,14,93,102
2017,2,21700374,12/8/2017,1610612759,San Antonio Spurs,1,1,1610612738,Boston Celtics,0,0,30,24,54,8,19,27,38,43,81,21,3,24,15,28,16,10,13,92,105
2016,2,21600857,2/24/2017,1610612754,Indiana Pacers,1,1,1610612763,Memphis Grizzlies,0,0,29,23,52,11,15,26,40,38,78,11,0,11,9,29,23,11,17,91,102
2014,2,21400111,11/12/2014,1610612738,Boston Celtics,1,0,1610612760,Oklahoma City Thunder,0,1,28,22,50,9,24,33,37,46,83,11,2,13,9,38,28,1,9,89,94
2014,2,21400111,11/12/2014,1610612760,Oklahoma City Thunder,0,1,1610612738,Boston Celtics,1,0,30,28,58,10,14,24,40,42,82,19,3,22,12,31,23,5,8,89,109
2016,2,21600857,2/24/2017,1610612763,Memphis Grizzlies,0,0,1610612754,Indiana Pacers,1,1,26,31,57,9,18,27,35,49,84,13,10,23,13,42,20,8,11,93,92
2017,2,21700373,12/8/2017,1610612740,New Orleans Pelicans,1,0,1610612758,Sacramento Kings,0,1,31,30,61,10,18,28,41,48,89,17,2,19,10,38,19,12,17,104,109
2017,2,21700373,12/8/2017,1610612758,Sacramento Kings,0,1,1610612740,New Orleans Pelicans,1,0,34,33,67,13,17,30,47,50,97,9,5,14,21,31,21,7,20,105,116
2014,2,21400110,11/12/2014,1610612737,Atlanta Hawks,1,1,1610612762,Utah Jazz,0,0,30,26,56,9,11,20,39,37,76,13,5,18,17,23,23,12,22,89,100
2014,2,21400110,11/12/2014,1610612762,Utah Jazz,0,0,1610612737,Atlanta Hawks,1,1,38,25,63,5,18,23,43,43,86,6,6,12,12,36,28,8,11,91,97
2016,2,21600341,12/9/2016,1610612745,Houston Rockets,0,1,1610612760,Oklahoma City Thunder,1,0,25,25,50,11,31,42,36,56,92,19,11,30,21,42,26,9,15,102,102
2014,2,21401043,3/22/2015,1610612738,Boston Celtics,1,0,1610612765,Detroit Pistons,0,1,30,48,78,8,19,27,38,67,105,13,4,17,22,47,24,5,13,105,97
2016,2,21600341,12/9/2016,1610612760,Oklahoma City Thunder,1,0,1610612745,Houston Rockets,0,1,27,26,53,7,21,28,34,47,81,24,7,31,12,39,18,9,18,101,99
2016,2,21600001,10/25/2016,1610612739,Cleveland Cavaliers,1,1,1610612752,New York Knicks,0,0,32,27,59,13,22,35,45,49,94,14,5,19,18,33,31,6,15,99,117
2014,2,21401043,3/22/2015,1610612765,Detroit Pistons,0,1,1610612738,Boston Celtics,1,0,30,33,63,9,17,26,39,50,89,18,12,30,14,41,24,7,14,104,105
2014,2,21400478,12/31/2014,1610612745,Houston Rockets,1,1,1610612766,Charlotte Hornets,0,0,21,24,45,17,26,43,38,50,88,9,5,14,15,37,22,6,15,94,102
2016,2,21600001,10/25/2016,1610612752,New York Knicks,0,0,1610612739,Cleveland Cavaliers,1,1,23,37,60,9,18,27,32,55,87,15,5,20,16,43,17,12,18,101,88
2014,2,21400478,12/31/2014,1610612766,Charlotte Hornets,0,0,1610612745,Houston Rockets,1,1,26,32,58,3,15,18,29,47,76,22,4,26,14,34,15,10,18,94,83
2017,2,21700372,12/8/2017,1610612742,Dallas Mavericks,0,0,1610612749,Milwaukee Bucks,1,1,25,26,51,10,14,24,35,40,75,22,4,26,8,34,18,10,12,96,102
2017,2,21700372,12/8/2017,1610612749,Milwaukee Bucks,1,1,1610612742,Dallas Mavericks,0,0,28,27,55,8,16,24,36,43,79,29,5,34,10,36,20,6,10,95,109
2014,2,21400477,12/31/2014,1610612746,LA Clippers,1,1,1610612752,New York Knicks,0,0,21,27,48,15,19,34,36,46,82,12,8,20,12,38,28,6,10,91,99
2014,2,21400477,12/31/2014,1610612752,New York Knicks,0,0,1610612746,LA Clippers,1,1,28,39,67,4,13,17,32,52,84,10,5,15,9,46,24,6,8,90,78
2021,2,22100646,1/15/2022,1610612739,Cleveland Cavaliers,0,1,1610612760,Oklahoma City Thunder,1,0,31,21,52,9,26,35,40,47,87,18,7,25,12,39,28,4,9,95,107
2021,2,22100958,3/5/2022,1610612750,Minnesota Timberwolves,1,1,1610612757,Portland Trail Blazers,0,0,33,15,48,15,22,37,48,37,85,24,5,29,9,32,36,5,11,98,135
2022,2,22200959,3/4/2023,1610612759,San Antonio Spurs,1,0,1610612745,Houston Rockets,0,1,23,26,49,15,22,37,38,48,86,19,1,20,15,34,24,9,15,95,110
2022,2,22200964,3/5/2023,1610612747,Los Angeles Lakers,1,1,1610612744,Golden State Warriors,0,0,31,31,62,11,22,33,42,53,95,18,4,22,17,38,29,2,9,98,113
2022,2,22200726,1/25/2023,1610612763,Memphis Grizzlies,0,0,1610612744,Golden State Warriors,1,1,32,25,57,10,21,31,42,46,88,26,11,37,15,36,26,7,14,103,120
2021,2,22100958,3/5/2022,1610612757,Portland Trail Blazers,0,0,1610612750,Minnesota Timberwolves,1,1,24,23,47,16,22,38,40,45,85,25,5,30,14,35,24,10,16,99,121
2021,2,22100646,1/15/2022,1610612760,Oklahoma City Thunder,1,0,1610612739,Cleveland Cavaliers,0,1,26,30,56,10,17,27,36,47,83,20,2,22,16,31,17,6,16,93,102
2022,2,22201138,3/29/2023,1610612752,New York Knicks,1,1,1610612748,Miami Heat,0,0,25,20,45,13,18,31,38,38,76,12,11,23,11,32,22,5,16,90,101
2022,2,22201145,3/29/2023,1610612758,Sacramento Kings,0,1,1610612757,Portland Trail Blazers,1,0,24,20,44,18,30,48,42,50,92,18,6,24,13,39,30,5,10,102,120
2022,2,22201204,4/7/2023,1610612748,Miami Heat,0,0,1610612764,Washington Wizards,1,1,28,23,51,15,32,47,43,55,98,7,5,12,16,42,26,4,16,104,108
2022,2,22200195,11/13/2022,1610612755,Philadelphia 76ers,1,1,1610612762,Utah Jazz,0,0,36,24,60,4,19,23,40,43,83,21,5,26,11,35,21,3,12,96,105
2022,2,22200195,11/13/2022,1610612762,Utah Jazz,0,0,1610612755,Philadelphia 76ers,1,1,26,31,57,11,26,37,37,57,94,13,10,23,28,34,23,12,18,97,98
2023,2,22300136,11/4/2023,1610612738,Boston Celtics,0,1,1610612751,Brooklyn Nets,1,0,28,17,45,15,30,45,43,47,90,23,4,27,15,35,22,4,11,100,124
2021,2,22100645,1/15/2022,1610612748,Miami Heat,1,0,1610612755,Philadelphia 76ers,0,1,24,27,51,9,26,35,33,53,86,23,7,30,16,41,24,5,10,94,98
2021,2,22100645,1/15/2022,1610612755,Philadelphia 76ers,0,1,1610612748,Miami Heat,1,0,27,20,47,13,19,32,40,39,79,16,5,21,9,32,24,10,15,94,109
2020,2,22000416,2/14/2021,1610612743,Denver Nuggets,1,1,1610612747,Los Angeles Lakers,0,0,20,18,38,19,28,47,39,46,85,25,9,34,13,39,28,4,10,98,122
2020,2,22000416,2/14/2021,1610612747,Los Angeles Lakers,0,0,1610612743,Denver Nuggets,1,1,34,25,59,6,22,28,40,47,87,19,10,29,11,43,27,6,10,98,105
2021,2,22100957,3/5/2022,1610612753,Orlando Magic,0,0,1610612763,Memphis Grizzlies,1,1,26,25,51,11,24,35,37,49,86,11,5,16,3,49,25,7,12,103,96
2017,2,21700371,12/8/2017,1610612761,Toronto Raptors,0,1,1610612763,Memphis Grizzlies,1,0,24,23,47,13,18,31,37,41,78,29,4,33,11,33,21,8,11,93,116
2017,2,21700371,12/8/2017,1610612763,Memphis Grizzlies,1,0,1610612761,Toronto Raptors,0,1,32,23,55,9,18,27,41,41,82,16,6,22,16,27,24,8,17,92,107
2022,2,22200727,1/25/2023,1610612757,Portland Trail Blazers,1,1,1610612762,Utah Jazz,0,0,34,19,53,17,19,36,51,38,89,15,3,18,9,29,26,5,10,99,134
2022,2,22200880,2/15/2023,1610612745,Houston Rockets,0,0,1610612760,Oklahoma City Thunder,1,1,20,32,52,10,27,37,30,59,89,26,12,38,19,41,20,8,18,105,96
2022,2,22200985,3/8/2023,1610612737,Atlanta Hawks,0,1,1610612764,Washington Wizards,1,0,33,23,56,12,17,29,45,40,85,20,6,26,9,34,26,9,11,99,122
2022,2,22200198,11/13/2022,1610612747,Los Angeles Lakers,1,1,1610612751,Brooklyn Nets,0,0,33,31,64,11,16,27,44,47,91,17,3,20,15,33,25,5,9,94,116
2022,2,22200921,2/27/2023,1610612738,Boston Celtics,0,0,1610612752,New York Knicks,1,1,28,14,42,9,33,42,37,47,84,11,3,14,9,39,21,6,12,97,94
2021,2,22100957,3/5/2022,1610612763,Memphis Grizzlies,1,1,1610612753,Orlando Magic,0,0,32,26,58,14,20,34,46,46,92,18,9,27,11,41,25,7,8,104,124
2022,2,22200198,11/13/2022,1610612751,Brooklyn Nets,0,0,1610612747,Los Angeles Lakers,1,1,29,24,53,7,20,27,36,44,80,24,7,31,12,36,22,3,13,95,103
2022,2,22201105,3/24/2023,1610612758,Sacramento Kings,1,1,1610612756,Phoenix Suns,0,0,34,16,50,13,26,39,47,42,89,28,4,32,10,33,29,2,4,97,135
2022,2,22200726,1/25/2023,1610612744,Golden State Warriors,1,1,1610612763,Memphis Grizzlies,0,0,29,24,53,14,18,32,43,42,85,22,6,28,18,27,33,10,22,102,122
2022,2,22201145,3/29/2023,1610612757,Portland Trail Blazers,1,0,1610612758,Sacramento Kings,0,1,21,33,54,9,30,39,30,63,93,11,1,12,11,53,18,9,14,102,80
2021,2,22100644,1/15/2022,1610612740,New Orleans Pelicans,0,0,1610612751,Brooklyn Nets,1,1,31,25,56,9,22,31,40,47,87,16,8,24,14,37,27,5,12,96,105
2021,2,22100644,1/15/2022,1610612751,Brooklyn Nets,1,1,1610612740,New Orleans Pelicans,0,0,34,23,57,12,15,27,46,38,84,16,1,17,11,27,30,9,16,96,120
2020,2,22000415,2/14/2021,1610612749,Milwaukee Bucks,0,0,1610612760,Oklahoma City Thunder,1,1,32,27,59,13,25,38,45,52,97,6,3,9,14,39,24,8,15,101,109
2020,2,22000415,2/14/2021,1610612760,Oklahoma City Thunder,1,1,1610612749,Milwaukee Bucks,0,0,30,29,59,15,21,36,45,50,95,9,7,16,17,36,32,9,15,101,114
2016,2,21600856,2/24/2017,1610612755,Philadelphia 76ers,1,1,1610612764,Washington Wizards,0,0,33,25,58,10,19,29,43,44,87,24,6,30,11,33,28,8,17,110,120
2021,2,22100956,3/5/2022,1610612748,Miami Heat,1,1,1610612755,Philadelphia 76ers,0,0,22,22,44,13,15,28,35,37,72,16,3,19,7,30,20,9,14,89,99
2021,2,22100956,3/5/2022,1610612755,Philadelphia 76ers,0,0,1610612748,Miami Heat,1,1,21,20,41,7,34,41,28,54,82,19,4,23,17,39,13,6,12,90,82
2020,2,22000723,3/31/2021,1610612738,Boston Celtics,1,0,1610612742,Dallas Mavericks,0,1,28,19,47,11,36,47,39,55,94,19,4,23,14,43,20,6,9,102,108
2020,2,22000723,3/31/2021,1610612742,Dallas Mavericks,0,1,1610612738,Boston Celtics,1,0,19,19,38,19,20,39,38,39,77,18,7,25,9,30,20,11,20,100,113
2016,2,21600856,2/24/2017,1610612764,Washington Wizards,0,0,1610612755,Philadelphia 76ers,1,1,33,33,66,5,19,24,38,52,90,31,9,40,17,40,19,9,17,111,112
2020,2,22000414,2/14/2021,1610612759,San Antonio Spurs,0,1,1610612766,Charlotte Hornets,1,0,38,24,62,10,24,34,48,48,96,16,3,19,12,38,31,6,9,100,122
2020,2,22000414,2/14/2021,1610612766,Charlotte Hornets,1,0,1610612759,San Antonio Spurs,0,1,33,28,61,12,22,34,45,50,95,8,3,11,18,35,23,13,17,101,110
2021,2,22100955,3/5/2022,1610612759,San Antonio Spurs,0,0,1610612766,Charlotte Hornets,1,1,34,27,61,11,26,37,45,53,98,16,4,20,14,41,28,8,10,101,117
2021,2,22100955,3/5/2022,1610612766,Charlotte Hornets,1,1,1610612759,San Antonio Spurs,0,0,26,23,49,16,26,42,42,49,91,23,6,29,12,40,29,7,9,102,123
2017,2,21700370,12/8/2017,1610612743,Denver Nuggets,0,1,1610612753,Orlando Magic,1,0,36,28,64,6,15,21,42,43,85,12,2,14,11,33,21,5,13,96,102
2017,2,21700370,12/8/2017,1610612753,Orlando Magic,1,0,1610612743,Denver Nuggets,0,1,28,34,62,5,16,21,33,50,83,18,5,23,14,38,18,7,15,95,89
2023,2,22300138,11/4/2023,1610612750,Minnesota Timberwolves,1,1,1610612762,Utah Jazz,0,0,36,21,57,9,15,24,45,36,81,24,7,31,11,29,25,3,11,95,123
2023,2,22300251,11/26/2023,1610612739,Cleveland Cavaliers,1,1,1610612761,Toronto Raptors,0,0,35,31,66,10,21,31,45,52,97,5,1,6,16,36,29,9,14,98,105
2019,2,21900203,11/20/2019,1610612759,San Antonio Spurs,0,0,1610612764,Washington Wizards,1,1,37,24,61,12,20,32,49,44,93,22,7,29,14,33,32,4,12,105,132
2019,2,21900203,11/20/2019,1610612764,Washington Wizards,1,1,1610612759,San Antonio Spurs,0,0,36,26,62,18,12,30,54,38,92,12,3,15,10,30,37,8,17,105,138
2022,2,22200080,10/28/2022,1610612745,Houston Rockets,0,0,1610612757,Portland Trail Blazers,1,1,26,30,56,14,24,38,40,54,94,17,4,21,19,38,23,9,17,101,111
2022,2,22200080,10/28/2022,1610612757,Portland Trail Blazers,1,1,1610612745,Houston Rockets,0,0,35,20,55,13,22,35,48,42,90,16,4,20,13,33,30,10,16,101,125
2021,2,22100643,1/15/2022,1610612737,Atlanta Hawks,1,0,1610612752,New York Knicks,0,1,24,12,36,16,28,44,40,40,80,12,5,17,6,35,23,2,9,91,108
2021,2,22100643,1/15/2022,1610612752,New York Knicks,0,1,1610612737,Atlanta Hawks,1,0,29,23,52,13,18,31,42,41,83,20,6,26,15,30,24,5,11,90,117
2020,2,22000413,2/14/2021,1610612750,Minnesota Timberwolves,0,1,1610612761,Toronto Raptors,1,0,27,16,43,16,23,39,43,39,82,14,5,19,9,32,28,6,18,100,116
2022,2,22200947,3/3/2023,1610612737,Atlanta Hawks,1,1,1610612757,Portland Trail Blazers,0,0,40,25,65,12,14,26,52,39,91,13,3,16,15,26,30,11,17,103,129
2020,2,22000722,3/31/2021,1610612748,Miami Heat,0,1,1610612754,Indiana Pacers,1,0,22,24,46,10,22,32,32,46,78,18,10,28,11,40,22,7,12,93,92
2020,2,22000722,3/31/2021,1610612754,Indiana Pacers,1,0,1610612748,Miami Heat,0,1,23,25,48,11,26,37,34,51,85,8,4,12,14,38,23,5,15,93,87
2020,2,22000413,2/14/2021,1610612761,Toronto Raptors,1,0,1610612750,Minnesota Timberwolves,0,1,28,30,58,10,23,33,38,53,91,26,5,31,17,37,24,6,12,101,112
2021,2,22100954,3/5/2022,1610612742,Dallas Mavericks,1,1,1610612758,Sacramento Kings,0,0,26,22,48,14,22,36,40,44,84,20,7,27,11,36,22,5,10,97,114
2022,2,22200197,11/13/2022,1610612744,Golden State Warriors,0,0,1610612758,Sacramento Kings,1,1,26,17,43,16,31,47,42,48,90,15,1,16,11,38,27,8,18,104,115
2022,2,22200197,11/13/2022,1610612758,Sacramento Kings,1,1,1610612744,Golden State Warriors,0,0,31,23,54,16,21,37,47,44,91,12,7,19,13,35,31,5,16,103,122
2022,2,22201106,3/24/2023,1610612760,Oklahoma City Thunder,0,0,1610612747,Los Angeles Lakers,1,1,26,30,56,14,22,36,40,52,92,17,2,19,14,38,21,9,10,98,111
2021,2,22100954,3/5/2022,1610612758,Sacramento Kings,0,0,1610612742,Dallas Mavericks,1,1,37,32,69,9,16,25,46,48,94,12,6,18,19,31,24,7,16,99,113
2022,2,22200728,1/25/2023,1610612761,Toronto Raptors,0,1,1610612758,Sacramento Kings,1,0,36,21,57,12,28,40,48,49,97,5,2,7,18,32,28,6,10,95,113
2022,2,22200563,1/3/2023,1610612758,Sacramento Kings,0,1,1610612762,Utah Jazz,1,0,37,17,54,9,23,32,46,40,86,16,2,18,10,32,23,9,18,101,117
2022,2,22200563,1/3/2023,1610612762,Utah Jazz,1,0,1610612758,Sacramento Kings,0,1,25,19,44,13,31,44,38,50,88,26,3,29,16,35,21,7,16,99,115
2021,2,22100642,1/15/2022,1610612757,Portland Trail Blazers,0,1,1610612764,Washington Wizards,1,0,26,20,46,13,26,39,39,46,85,24,11,35,12,40,19,4,13,102,115
2021,2,22100642,1/15/2022,1610612764,Washington Wizards,1,0,1610612757,Portland Trail Blazers,0,1,27,26,53,12,25,37,39,51,90,20,3,23,16,36,20,13,20,104,110
2020,2,22000412,2/12/2021,1610612738,Boston Celtics,1,0,1610612765,Detroit Pistons,0,1,28,27,55,8,19,27,36,46,82,22,8,30,11,38,15,3,10,95,102
2020,2,22000412,2/12/2021,1610612765,Detroit Pistons,0,1,1610612738,Boston Celtics,1,0,19,22,41,15,23,38,34,45,79,25,5,30,9,39,25,9,13,97,108
2022,2,22200078,10/28/2022,1610612743,Denver Nuggets,1,1,1610612762,Utah Jazz,0,0,22,26,48,17,20,37,39,46,85,22,12,34,19,35,18,7,12,94,117
2022,2,22200078,10/28/2022,1610612762,Utah Jazz,0,0,1610612743,Denver Nuggets,1,1,28,24,52,10,29,39,38,53,91,15,4,19,13,42,24,2,10,95,101
2022,2,22200729,1/25/2023,1610612747,Los Angeles Lakers,1,1,1610612759,San Antonio Spurs,0,0,30,27,57,10,23,33,40,50,90,23,7,30,18,34,25,11,20,107,113
2022,2,22200199,11/14/2022,1610612761,Toronto Raptors,0,1,1610612765,Detroit Pistons,1,0,32,23,55,8,19,27,40,42,82,27,1,28,13,29,27,8,17,99,115
2022,2,22200989,3/8/2023,1610612741,Chicago Bulls,0,1,1610612743,Denver Nuggets,1,0,38,27,65,8,16,24,46,43,89,17,1,18,10,33,26,5,9,96,117
2022,2,22200199,11/14/2022,1610612765,Detroit Pistons,1,0,1610612761,Toronto Raptors,0,1,25,21,46,10,21,31,35,42,77,31,12,43,18,30,23,7,19,100,111
2022,2,22201144,3/29/2023,1610612750,Minnesota Timberwolves,0,0,1610612756,Phoenix Suns,1,1,28,27,55,12,23,35,40,50,90,8,4,12,19,34,24,11,21,97,100
2022,2,22201144,3/29/2023,1610612756,Phoenix Suns,1,1,1610612750,Minnesota Timberwolves,0,0,34,42,76,6,14,20,40,56,96,21,6,27,18,41,23,4,8,98,107
2022,2,22200079,10/28/2022,1610612740,New Orleans Pelicans,0,0,1610612756,Phoenix Suns,1,1,23,26,49,15,22,37,38,48,86,20,2,22,13,35,25,7,14,99,111
2022,2,22200079,10/28/2022,1610612756,Phoenix Suns,1,1,1610612740,New Orleans Pelicans,0,0,38,21,59,10,23,33,48,44,92,18,2,20,17,27,33,10,12,99,124
2022,2,22200881,2/15/2023,1610612742,Dallas Mavericks,0,0,1610612743,Denver Nuggets,1,1,25,20,45,14,25,39,39,45,84,17,3,20,7,39,25,7,12,96,109
2022,2,22200200,11/14/2022,1610612753,Orlando Magic,1,0,1610612766,Charlotte Hornets,0,1,22,30,52,14,22,36,36,52,88,19,4,23,26,28,23,15,22,94,105
2022,2,22200882,2/15/2023,1610612740,New Orleans Pelicans,0,0,1610612747,Los Angeles Lakers,1,1,32,32,64,7,18,25,39,50,89,17,7,24,16,39,24,5,15,99,102
2022,2,22200729,1/25/2023,1610612759,San Antonio Spurs,0,0,1610612747,Los Angeles Lakers,1,1,32,40,72,8,26,34,40,66,106,16,2,18,22,46,22,12,14,106,104
2021,2,22100641,1/15/2022,1610612749,Milwaukee Bucks,1,0,1610612761,Toronto Raptors,0,1,14,24,38,12,27,39,26,51,77,32,3,35,12,39,19,7,13,94,96
2022,2,22200959,3/4/2023,1610612745,Houston Rockets,0,1,1610612759,San Antonio Spurs,1,0,41,23,64,8,15,23,49,38,87,16,6,22,15,29,26,9,16,97,122
2021,2,22100953,3/4/2022,1610612752,New York Knicks,0,0,1610612756,Phoenix Suns,1,1,27,30,57,13,16,29,40,46,86,21,9,30,15,36,23,7,14,99,114
2021,2,22100953,3/4/2022,1610612756,Phoenix Suns,1,1,1610612752,New York Knicks,0,0,21,30,51,17,17,34,38,47,85,22,5,27,7,41,28,7,10,100,115
2022,2,22200200,11/14/2022,1610612766,Charlotte Hornets,0,1,1610612753,Orlando Magic,1,0,35,18,53,7,28,35,42,46,88,21,3,24,18,30,22,3,13,94,112
2022,2,22201061,3/18/2023,1610612744,Golden State Warriors,0,0,1610612763,Memphis Grizzlies,1,1,26,30,56,13,22,35,39,52,91,28,6,34,24,30,27,5,13,97,119
2021,2,22100641,1/15/2022,1610612761,Toronto Raptors,0,1,1610612749,Milwaukee Bucks,1,0,28,28,56,12,23,35,40,51,91,11,9,20,21,34,25,8,15,94,103
2020,2,22000411,2/14/2021,1610612742,Dallas Mavericks,1,0,1610612757,Portland Trail Blazers,0,1,26,14,40,14,27,41,40,41,81,24,1,25,13,29,19,7,14,94,118
2022,2,22200201,11/14/2022,1610612738,Boston Celtics,1,1,1610612760,Oklahoma City Thunder,0,0,36,23,59,10,27,37,46,50,96,24,5,29,11,42,25,4,14,112,126
2022,2,22200882,2/15/2023,1610612747,Los Angeles Lakers,1,1,1610612740,New Orleans Pelicans,0,0,34,12,46,10,27,37,44,39,83,22,14,36,8,39,32,5,11,101,120
2022,2,22200201,11/14/2022,1610612760,Oklahoma City Thunder,0,0,1610612738,Boston Celtics,1,1,36,32,68,11,19,30,47,51,98,17,4,21,14,39,21,15,20,113,122
2022,2,22200989,3/8/2023,1610612743,Denver Nuggets,1,0,1610612741,Chicago Bulls,0,1,22,26,48,15,25,40,37,51,88,7,8,15,12,42,26,9,11,95,96
2022,2,22201180,4/4/2023,1610612750,Minnesota Timberwolves,0,1,1610612751,Brooklyn Nets,1,0,33,28,61,8,16,24,41,44,85,17,5,22,13,34,21,6,12,93,107
2021,2,22100952,3/4/2022,1610612743,Denver Nuggets,1,1,1610612745,Houston Rockets,0,0,26,27,53,13,20,33,39,47,86,25,6,31,12,37,27,4,10,96,116
2021,2,22100952,3/4/2022,1610612745,Houston Rockets,0,0,1610612743,Denver Nuggets,1,1,28,19,47,10,26,36,38,45,83,15,7,22,13,34,25,10,15,97,101
2023,2,22300138,11/4/2023,1610612762,Utah Jazz,0,0,1610612750,Minnesota Timberwolves,1,1,23,25,48,12,31,43,35,56,91,13,4,17,22,36,20,10,18,95,95
2020,2,22000721,3/31/2021,1610612757,Portland Trail Blazers,0,1,1610612765,Detroit Pistons,1,0,26,26,52,16,14,30,42,40,82,24,2,26,9,33,27,7,13,97,124
2020,2,22000721,3/31/2021,1610612765,Detroit Pistons,1,0,1610612757,Portland Trail Blazers,0,1,31,28,59,9,18,27,40,46,86,12,5,17,12,38,29,11,17,98,101
2022,2,22200077,10/28/2022,1610612741,Chicago Bulls,0,0,1610612759,San Antonio Spurs,1,1,38,34,72,9,18,27,47,52,99,21,5,26,20,34,20,7,13,105,124
2022,2,22200077,10/28/2022,1610612759,San Antonio Spurs,1,1,1610612741,Chicago Bulls,0,0,30,18,48,16,22,38,46,40,86,21,5,26,14,28,37,13,21,106,129
2021,2,22100640,1/14/2022,1610612745,Houston Rockets,0,0,1610612758,Sacramento Kings,1,1,31,27,58,13,30,43,44,57,101,13,3,16,17,42,25,8,17,107,114
2021,2,22100640,1/14/2022,1610612758,Sacramento Kings,1,1,1610612745,Houston Rockets,0,0,35,24,59,13,24,37,48,48,96,17,7,24,14,37,33,7,14,106,126
2021,2,22100951,3/4/2022,1610612750,Minnesota Timberwolves,0,1,1610612760,Oklahoma City Thunder,1,0,27,17,44,22,25,47,49,42,91,18,5,23,12,32,35,12,18,106,138
2022,2,22200203,11/14/2022,1610612745,Houston Rockets,1,0,1610612746,LA Clippers,0,1,30,26,56,9,21,30,39,47,86,19,12,31,15,38,20,6,14,100,106
2021,2,22100951,3/4/2022,1610612760,Oklahoma City Thunder,1,0,1610612750,Minnesota Timberwolves,0,1,28,23,51,9,26,35,37,49,86,18,3,21,14,36,19,17,23,106,101
2020,2,22000411,2/14/2021,1610612757,Portland Trail Blazers,0,1,1610612742,Dallas Mavericks,1,0,27,18,45,18,22,40,45,40,85,13,6,19,16,28,15,5,15,94,121
2017,2,21700369,12/8/2017,1610612739,Cleveland Cavaliers,0,0,1610612754,Indiana Pacers,1,1,26,23,49,11,25,36,37,48,85,17,5,22,11,39,23,7,13,96,102
2017,2,21700369,12/8/2017,1610612754,Indiana Pacers,1,1,1610612739,Cleveland Cavaliers,0,0,23,24,47,15,24,39,38,48,86,15,9,24,13,38,21,4,10,94,106
2016,2,21600855,2/23/2017,1610612743,Denver Nuggets,0,0,1610612758,Sacramento Kings,1,1,27,26,53,12,23,35,39,49,88,10,4,14,12,39,23,8,16,100,100
2022,2,22200958,3/4/2023,1610612737,Atlanta Hawks,0,0,1610612748,Miami Heat,1,1,28,21,49,9,21,30,37,42,79,26,4,30,11,33,22,5,16,98,109
2022,2,22200203,11/14/2022,1610612746,LA Clippers,0,1,1610612745,Houston Rockets,1,0,27,16,43,14,24,38,41,40,81,26,7,33,12,30,25,11,17,101,122
2022,2,22201207,4/7/2023,1610612753,Orlando Magic,0,0,1610612751,Brooklyn Nets,1,1,24,25,49,7,31,38,31,56,87,15,2,17,20,37,17,14,21,97,84
2022,2,22201106,3/24/2023,1610612747,Los Angeles Lakers,1,1,1610612760,Oklahoma City Thunder,0,0,30,27,57,12,22,34,42,49,91,20,8,28,18,34,20,6,11,97,116
2022,2,22200076,10/28/2022,1610612747,Los Angeles Lakers,0,0,1610612750,Minnesota Timberwolves,1,1,28,32,60,9,20,29,37,52,89,19,8,27,16,38,20,13,22,108,102
2022,2,22200076,10/28/2022,1610612750,Minnesota Timberwolves,1,1,1610612747,Los Angeles Lakers,0,0,28,31,59,13,27,40,41,58,99,16,8,24,15,46,27,8,10,109,111
2021,2,22100639,1/14/2022,1610612742,Dallas Mavericks,0,1,1610612763,Memphis Grizzlies,1,0,39,20,59,8,24,32,47,44,91,10,6,16,15,32,30,8,15,98,112
2021,2,22100639,1/14/2022,1610612763,Memphis Grizzlies,1,0,1610612742,Dallas Mavericks,0,1,27,31,58,7,24,31,34,55,89,10,3,13,12,45,19,8,15,98,85
2021,2,22100950,3/4/2022,1610612740,New Orleans Pelicans,1,1,1610612762,Utah Jazz,0,0,39,22,61,11,25,36,50,47,97,13,4,17,19,31,29,7,11,99,124
2021,2,22100950,3/4/2022,1610612762,Utah Jazz,0,0,1610612740,New Orleans Pelicans,1,1,20,28,48,11,30,41,31,58,89,17,9,26,27,38,15,11,21,100,90
2022,2,22200202,11/14/2022,1610612748,Miami Heat,1,1,1610612756,Phoenix Suns,0,0,23,27,50,15,18,33,38,45,83,22,3,25,20,26,23,9,15,89,113
2022,2,22200075,10/28/2022,1610612749,Milwaukee Bucks,1,1,1610612752,New York Knicks,0,0,29,35,64,13,32,45,42,67,109,22,5,27,24,45,23,6,7,101,119
2022,2,22200075,10/28/2022,1610612752,New York Knicks,0,0,1610612749,Milwaukee Bucks,1,1,25,33,58,12,23,35,37,56,93,22,10,32,19,44,19,8,13,102,108
2021,2,22100638,1/14/2022,1610612739,Cleveland Cavaliers,0,1,1610612759,San Antonio Spurs,1,0,38,37,75,8,12,20,46,49,95,14,10,24,14,43,24,6,9,100,114
2021,2,22100638,1/14/2022,1610612759,San Antonio Spurs,1,0,1610612739,Cleveland Cavaliers,0,1,27,31,58,15,19,34,42,50,92,10,3,13,13,38,22,7,15,100,109
2022,2,22200991,3/8/2023,1610612746,LA Clippers,1,1,1610612761,Toronto Raptors,0,0,33,18,51,6,14,20,39,32,71,24,7,31,9,27,23,12,17,94,108
2022,2,22201059,3/18/2023,1610612758,Sacramento Kings,0,1,1610612764,Washington Wizards,1,0,26,23,49,22,15,37,48,38,86,14,9,23,7,35,34,6,8,97,132
2021,2,22100949,3/4/2022,1610612741,Chicago Bulls,1,0,1610612749,Milwaukee Bucks,0,1,37,31,68,10,16,26,47,47,94,8,3,11,9,41,25,5,12,102,112
2021,2,22100949,3/4/2022,1610612749,Milwaukee Bucks,0,1,1610612741,Chicago Bulls,1,0,33,24,57,10,21,31,43,45,88,22,11,33,16,36,20,5,14,101,118
2022,2,22201105,3/24/2023,1610612756,Phoenix Suns,0,0,1610612758,Sacramento Kings,1,1,39,21,60,9,20,29,48,41,89,22,7,29,17,29,33,6,12,97,127
2022,2,22200202,11/14/2022,1610612756,Phoenix Suns,0,0,1610612748,Miami Heat,1,1,34,29,63,14,22,36,48,51,99,2,2,4,25,27,22,6,14,90,112
2023,2,22300642,1/27/2024,1610612765,Detroit Pistons,1,0,1610612764,Washington Wizards,0,1,28,25,53,9,23,32,37,48,85,21,6,27,15,35,22,10,17,101,104
2021,2,22100637,1/14/2022,1610612741,Chicago Bulls,1,0,1610612744,Golden State Warriors,0,1,27,22,49,10,28,38,37,50,87,12,6,18,14,39,26,12,14,95,96
2021,2,22100637,1/14/2022,1610612744,Golden State Warriors,0,1,1610612741,Chicago Bulls,1,0,34,18,52,19,23,42,53,41,94,13,4,17,14,29,39,4,7,96,138
2017,2,21700368,12/8/2017,1610612744,Golden State Warriors,0,1,1610612765,Detroit Pistons,1,0,32,23,55,7,19,26,39,42,81,17,5,22,6,38,29,8,14,98,102
2017,2,21700368,12/8/2017,1610612765,Detroit Pistons,1,0,1610612744,Golden State Warriors,0,1,26,39,65,12,15,27,38,54,92,10,9,19,17,41,20,5,13,98,98
2016,2,21600855,2/23/2017,1610612758,Sacramento Kings,1,1,1610612743,Denver Nuggets,0,0,39,35,74,7,7,14,46,42,88,17,2,19,11,33,26,10,14,99,116
2016,2,21600340,12/9/2016,1610612737,Atlanta Hawks,0,1,1610612749,Milwaukee Bucks,1,0,28,22,50,12,22,34,40,44,84,22,7,29,12,36,32,11,18,101,114
2019,2,21900202,11/20/2019,1610612752,New York Knicks,0,0,1610612755,Philadelphia 76ers,1,1,27,32,59,13,12,25,40,44,84,11,4,15,11,35,17,5,14,95,104
2019,2,21900202,11/20/2019,1610612755,Philadelphia 76ers,1,1,1610612752,New York Knicks,0,0,26,31,57,13,19,32,39,50,89,18,8,26,14,39,30,8,10,95,109
2016,2,21600340,12/9/2016,1610612749,Milwaukee Bucks,1,0,1610612737,Atlanta Hawks,0,1,32,34,66,12,16,28,44,50,94,10,4,14,13,38,26,7,15,103,110
2020,2,22000720,3/30/2021,1610612746,LA Clippers,1,0,1610612753,Orlando Magic,0,1,25,27,52,12,25,37,37,52,89,10,0,10,15,37,25,10,17,95,96
2020,2,22000720,3/30/2021,1610612753,Orlando Magic,0,1,1610612746,LA Clippers,1,0,33,42,75,5,12,17,38,54,92,22,3,25,17,38,23,3,9,95,103
2022,2,22200204,11/14/2022,1610612737,Atlanta Hawks,0,1,1610612749,Milwaukee Bucks,1,0,37,35,72,7,13,20,44,48,92,26,4,30,14,36,23,4,9,100,121
2022,2,22200204,11/14/2022,1610612749,Milwaukee Bucks,1,0,1610612737,Atlanta Hawks,0,1,28,25,53,6,23,29,34,48,82,32,9,41,17,35,21,4,17,101,106
2022,2,22200074,10/28/2022,1610612764,Washington Wizards,1,0,1610612754,Indiana Pacers,0,1,29,27,56,12,18,30,41,45,86,23,5,28,11,36,25,4,13,101,117
2022,2,22200074,10/28/2022,1610612754,Indiana Pacers,0,1,1610612764,Washington Wizards,1,0,26,26,52,15,14,29,41,40,81,30,3,33,10,30,30,5,14,100,127
2022,2,22201203,4/7/2023,1610612754,Indiana Pacers,1,0,1610612765,Detroit Pistons,0,1,30,22,52,11,20,31,41,42,83,22,6,28,12,34,29,12,19,105,115
2023,2,22300105,10/30/2023,1610612757,Portland Trail Blazers,0,1,1610612761,Toronto Raptors,1,0,27,23,50,11,24,35,38,47,85,12,3,15,16,33,20,10,16,91,99
2022,2,22201180,4/4/2023,1610612751,Brooklyn Nets,1,0,1610612750,Minnesota Timberwolves,0,1,26,29,55,13,22,35,39,51,90,11,3,14,14,39,21,7,10,93,102
2021,2,22100948,3/4/2022,1610612737,Atlanta Hawks,0,1,1610612764,Washington Wizards,1,0,25,30,55,13,23,36,38,53,91,28,6,34,18,37,18,2,4,94,117
2021,2,22100948,3/4/2022,1610612764,Washington Wizards,1,0,1610612737,Atlanta Hawks,0,1,32,24,56,14,15,29,46,39,85,8,1,9,9,30,37,6,14,94,114
2023,2,22300642,1/27/2024,1610612764,Washington Wizards,0,1,1610612765,Detroit Pistons,1,0,34,32,66,11,23,34,45,55,100,17,4,21,19,38,26,2,10,100,118
2017,2,21700367,12/8/2017,1610612741,Chicago Bulls,0,1,1610612766,Charlotte Hornets,1,0,42,39,81,6,12,18,48,51,99,17,5,22,13,41,23,7,14,111,119
2017,2,21700367,12/8/2017,1610612766,Charlotte Hornets,1,0,1610612741,Chicago Bulls,0,1,30,41,71,10,19,29,40,60,100,21,8,29,15,50,22,5,11,109,111
2015,2,21501207,4/11/2016,1610612745,Houston Rockets,0,1,1610612750,Minnesota Timberwolves,1,0,33,23,56,15,15,30,48,38,86,18,8,26,11,32,28,12,18,103,129
2015,2,21501207,4/11/2016,1610612750,Minnesota Timberwolves,1,0,1610612745,Houston Rockets,0,1,33,29,62,5,16,21,38,45,83,24,9,33,11,38,25,12,14,102,105
2018,2,21801108,3/26/2019,1610612739,Cleveland Cavaliers,1,0,1610612738,Boston Celtics,0,1,30,22,52,9,19,28,39,41,80,19,6,25,9,35,24,8,15,98,106
2022,2,22200073,10/28/2022,1610612755,Philadelphia 76ers,0,1,1610612761,Toronto Raptors,1,0,27,17,44,16,22,38,43,39,82,10,1,11,8,31,25,9,15,93,112
2022,2,22200205,11/14/2022,1610612744,Golden State Warriors,1,1,1610612759,San Antonio Spurs,0,0,24,19,43,23,22,45,47,41,88,15,1,16,8,33,35,6,13,100,132
2022,2,22200205,11/14/2022,1610612759,San Antonio Spurs,0,0,1610612744,Golden State Warriors,1,1,26,34,60,10,30,40,36,64,100,13,6,19,28,39,18,9,19,100,95
2022,2,22200073,10/28/2022,1610612761,Toronto Raptors,1,0,1610612755,Philadelphia 76ers,0,1,24,23,47,9,30,39,33,53,86,15,9,24,22,37,20,11,17,92,90
2022,2,22201061,3/18/2023,1610612763,Memphis Grizzlies,1,1,1610612744,Golden State Warriors,0,0,34,23,57,18,20,38,52,43,95,11,6,17,15,29,35,3,7,96,133
2022,2,22200991,3/8/2023,1610612761,Toronto Raptors,0,0,1610612746,LA Clippers,1,1,24,40,64,13,19,32,37,59,96,13,1,14,20,40,21,9,12,94,100
2021,2,22100947,3/4/2022,1610612739,Cleveland Cavaliers,0,0,1610612755,Philadelphia 76ers,1,1,34,20,54,10,18,28,44,38,82,21,3,24,10,30,30,8,12,96,119
2021,2,22100947,3/4/2022,1610612755,Philadelphia 76ers,1,1,1610612739,Cleveland Cavaliers,0,0,27,15,42,14,19,33,41,34,75,29,3,32,3,32,23,5,12,96,125
2021,2,22100636,1/14/2022,1610612737,Atlanta Hawks,0,0,1610612748,Miami Heat,1,1,22,19,41,16,22,38,38,41,79,26,4,30,15,29,26,6,16,94,118
2021,2,22100636,1/14/2022,1610612748,Miami Heat,1,1,1610612737,Atlanta Hawks,0,0,27,20,47,14,16,30,41,36,77,28,2,30,13,25,30,6,16,94,124
2020,2,22000410,2/13/2021,1610612748,Miami Heat,0,0,1610612762,Utah Jazz,1,1,23,27,50,12,24,36,35,51,86,12,5,17,10,43,24,11,17,101,94
2020,2,22000410,2/13/2021,1610612762,Utah Jazz,1,1,1610612748,Miami Heat,0,0,27,12,39,12,34,46,39,46,85,22,7,29,14,37,26,11,16,103,112
2017,2,21700366,12/7/2017,1610612745,Houston Rockets,0,1,1610612762,Utah Jazz,1,0,20,19,39,18,24,42,38,43,81,18,6,24,14,32,22,10,17,97,112
2022,2,22200922,2/27/2023,1610612740,New Orleans Pelicans,1,0,1610612753,Orlando Magic,0,1,28,21,49,6,21,27,34,42,76,19,4,23,11,33,23,9,17,94,93
2022,2,22200990,3/8/2023,1610612756,Phoenix Suns,1,1,1610612760,Oklahoma City Thunder,0,0,29,22,51,20,23,43,49,45,94,14,2,16,16,31,31,9,15,99,132
2022,2,22200990,3/8/2023,1610612760,Oklahoma City Thunder,0,0,1610612756,Phoenix Suns,1,1,18,27,45,15,28,43,33,55,88,20,1,21,14,42,23,10,16,99,101
2022,2,22201137,3/29/2023,1610612751,Brooklyn Nets,1,1,1610612745,Houston Rockets,0,0,27,20,47,17,18,35,44,38,82,18,9,27,9,34,33,9,12,96,123
2022,2,22201060,3/18/2023,1610612748,Miami Heat,0,0,1610612741,Chicago Bulls,1,1,25,20,45,10,27,37,35,47,82,19,5,24,19,30,23,8,14,88,99
2022,2,22201202,4/7/2023,1610612766,Charlotte Hornets,1,0,1610612745,Houston Rockets,0,1,25,22,47,13,28,41,38,50,88,20,7,27,14,38,22,11,17,104,109
2021,2,22100635,1/14/2022,1610612738,Boston Celtics,0,0,1610612755,Philadelphia 76ers,1,1,26,21,47,11,20,31,37,41,78,14,4,18,10,35,20,12,20,99,99
2021,2,22100635,1/14/2022,1610612755,Philadelphia 76ers,1,1,1610612738,Boston Celtics,0,0,24,20,44,14,27,41,38,47,85,21,4,25,8,39,26,4,10,98,111
2017,2,21700366,12/7/2017,1610612762,Utah Jazz,1,0,1610612745,Houston Rockets,0,1,23,24,47,11,19,30,34,43,77,22,5,27,6,40,17,10,13,97,101
2021,2,22100946,3/4/2022,1610612754,Indiana Pacers,0,0,1610612765,Detroit Pistons,1,1,29,31,60,10,30,40,39,61,100,18,10,28,31,34,24,5,14,96,106
2021,2,22100946,3/4/2022,1610612765,Detroit Pistons,1,1,1610612754,Indiana Pacers,0,0,27,37,64,15,15,30,42,52,94,12,6,18,20,36,28,4,13,95,111
2022,2,22200072,10/28/2022,1610612738,Boston Celtics,1,0,1610612739,Cleveland Cavaliers,0,1,29,20,49,13,20,33,42,40,82,26,6,32,9,35,28,5,19,108,123
2022,2,22200072,10/28/2022,1610612739,Cleveland Cavaliers,0,1,1610612738,Boston Celtics,1,0,29,23,52,16,19,35,45,42,87,26,8,34,11,35,18,9,16,107,132
2021,2,22100634,1/14/2022,1610612754,Indiana Pacers,1,0,1610612756,Phoenix Suns,0,1,21,24,45,13,30,43,34,54,88,13,5,18,13,42,20,8,12,98,94
2021,2,22100634,1/14/2022,1610612756,Phoenix Suns,0,1,1610612754,Indiana Pacers,1,0,29,31,60,11,17,28,40,48,88,21,2,23,16,34,24,9,15,97,112
2021,2,22100945,3/3/2022,1610612746,LA Clippers,1,1,1610612747,Los Angeles Lakers,0,0,34,32,66,17,10,27,51,42,93,13,2,15,16,28,32,8,12,96,132
2021,2,22100945,3/3/2022,1610612747,Los Angeles Lakers,0,0,1610612746,LA Clippers,1,1,29,20,49,12,23,35,41,43,84,17,5,22,10,34,26,10,14,96,111
2020,2,22000409,2/13/2021,1610612744,Golden State Warriors,1,0,1610612751,Brooklyn Nets,0,1,35,21,56,9,25,34,44,46,90,20,5,25,9,40,25,9,13,106,117
2020,2,22000409,2/13/2021,1610612751,Brooklyn Nets,0,1,1610612744,Golden State Warriors,1,0,34,20,54,16,23,39,50,43,93,18,2,20,10,34,35,6,13,105,134
2022,2,22200207,11/15/2022,1610612742,Dallas Mavericks,1,1,1610612746,LA Clippers,0,0,18,19,37,17,26,43,35,45,80,16,8,24,9,42,20,8,12,93,103
2022,2,22200881,2/15/2023,1610612743,Denver Nuggets,1,1,1610612742,Dallas Mavericks,0,0,37,16,53,11,20,31,48,36,84,11,4,15,7,30,34,8,13,96,118
2022,2,22200463,12/20/2022,1610612752,New York Knicks,1,1,1610612744,Golden State Warriors,0,0,28,19,47,17,23,40,45,42,87,25,7,32,18,26,27,3,12,96,132
2020,2,22000719,3/30/2021,1610612743,Denver Nuggets,1,1,1610612755,Philadelphia 76ers,0,0,27,23,50,12,19,31,39,42,81,14,3,17,13,30,26,14,20,95,104
2020,2,22000719,3/30/2021,1610612755,Philadelphia 76ers,0,0,1610612743,Denver Nuggets,1,1,24,23,47,11,24,35,35,47,82,14,1,15,6,42,18,9,12,95,95
2022,2,22200071,10/28/2022,1610612753,Orlando Magic,1,1,1610612766,Charlotte Hornets,0,0,32,16,48,10,27,37,42,43,85,19,7,26,7,39,28,3,12,99,113
2022,2,22200071,10/28/2022,1610612766,Charlotte Hornets,0,0,1610612753,Orlando Magic,1,1,22,26,48,11,27,38,33,53,86,16,8,24,12,47,21,8,15,99,93
2020,2,22000408,2/13/2021,1610612745,Houston Rockets,0,0,1610612752,New York Knicks,1,1,25,20,45,8,35,43,33,55,88,25,5,30,16,41,17,4,9,96,99
2020,2,22000408,2/13/2021,1610612752,New York Knicks,1,1,1610612745,Houston Rockets,0,0,33,25,58,12,16,28,45,41,86,19,4,23,8,35,21,5,8,95,121
2021,2,22100944,3/3/2022,1610612758,Sacramento Kings,0,1,1610612759,San Antonio Spurs,1,0,29,24,53,10,22,32,39,46,85,27,5,32,10,36,26,8,14,104,115
2021,2,22100944,3/3/2022,1610612759,San Antonio Spurs,1,0,1610612758,Sacramento Kings,0,1,34,27,61,12,20,32,46,47,93,8,8,16,9,41,28,6,11,105,112
2016,2,21600854,2/23/2017,1610612744,Golden State Warriors,1,1,1610612746,LA Clippers,0,0,30,26,56,13,12,25,43,38,81,24,2,26,10,28,31,11,21,106,123
2016,2,21600854,2/23/2017,1610612746,LA Clippers,0,0,1610612744,Golden State Warriors,1,1,27,38,65,11,17,28,38,55,93,26,11,37,19,44,23,11,15,107,113
2022,2,22200885,2/16/2023,1610612756,Phoenix Suns,1,0,1610612746,LA Clippers,0,1,31,27,58,11,20,31,42,47,89,12,4,16,12,37,30,8,14,99,107
2021,2,22100633,1/14/2022,1610612761,Toronto Raptors,0,0,1610612765,Detroit Pistons,1,1,17,32,49,11,27,38,28,59,87,20,6,26,21,39,18,7,11,88,87
2021,2,22100633,1/14/2022,1610612765,Detroit Pistons,1,1,1610612761,Toronto Raptors,0,0,30,24,54,8,19,27,38,43,81,19,4,23,11,33,22,5,8,88,103
2020,2,22000407,2/13/2021,1610612737,Atlanta Hawks,1,0,1610612754,Indiana Pacers,0,1,34,25,59,9,22,31,43,47,90,18,5,23,10,40,35,8,11,101,113
2020,2,22000407,2/13/2021,1610612754,Indiana Pacers,0,1,1610612737,Atlanta Hawks,1,0,33,25,58,12,19,31,45,44,89,23,4,27,10,35,34,5,9,101,125
2017,2,21700365,12/7/2017,1610612751,Brooklyn Nets,1,1,1610612760,Oklahoma City Thunder,0,0,24,19,43,11,26,37,35,45,80,19,11,30,12,39,24,6,16,98,100
2022,2,22200883,2/16/2023,1610612749,Milwaukee Bucks,0,1,1610612741,Chicago Bulls,1,0,22,19,41,18,29,47,40,48,88,14,4,18,11,38,24,4,9,95,112
2019,2,21900201,11/19/2019,1610612747,Los Angeles Lakers,1,1,1610612760,Oklahoma City Thunder,0,0,29,29,58,14,17,31,43,46,89,12,7,19,16,34,29,10,16,96,112
2019,2,21900201,11/19/2019,1610612760,Oklahoma City Thunder,0,0,1610612747,Los Angeles Lakers,1,1,29,23,52,9,19,28,38,42,80,22,3,25,12,32,22,9,16,96,107
2022,2,22201042,3/16/2023,1610612765,Detroit Pistons,1,0,1610612743,Denver Nuggets,0,1,27,31,58,12,15,27,39,46,85,10,8,18,16,34,24,9,17,95,100
2022,2,22200883,2/16/2023,1610612741,Chicago Bulls,1,0,1610612749,Milwaukee Bucks,0,1,27,38,65,10,22,32,37,60,97,16,5,21,19,43,19,4,6,94,100
2020,2,22000718,3/30/2021,1610612764,Washington Wizards,1,0,1610612766,Charlotte Hornets,0,1,31,32,63,10,27,37,41,59,100,12,3,15,17,43,22,6,13,102,104
2022,2,22201203,4/7/2023,1610612765,Detroit Pistons,0,1,1610612754,Indiana Pacers,1,0,31,28,59,13,18,31,44,46,90,21,5,26,12,37,24,7,13,103,122
2020,2,22000718,3/30/2021,1610612766,Charlotte Hornets,0,1,1610612764,Washington Wizards,1,0,28,28,56,14,20,34,42,48,90,16,3,19,14,36,24,5,14,101,114
2022,2,22200070,10/28/2022,1610612737,Atlanta Hawks,0,1,1610612765,Detroit Pistons,1,0,43,25,68,12,17,29,55,42,97,14,4,18,15,30,31,2,7,97,136
2022,2,22200070,10/28/2022,1610612765,Detroit Pistons,1,0,1610612737,Atlanta Hawks,0,1,30,24,54,7,25,32,37,49,86,31,7,38,19,35,18,5,11,99,112
2021,2,22100632,1/14/2022,1610612753,Orlando Magic,0,1,1610612766,Charlotte Hornets,1,0,30,12,42,15,30,45,45,42,87,11,4,15,8,34,32,9,20,106,116
2021,2,22100632,1/14/2022,1610612766,Charlotte Hornets,1,0,1610612753,Orlando Magic,0,1,28,27,55,12,30,42,40,57,97,17,4,21,18,40,28,9,17,108,109
2020,2,22000406,2/13/2021,1610612755,Philadelphia 76ers,0,0,1610612756,Phoenix Suns,1,1,31,25,56,7,10,17,38,35,73,28,5,33,8,30,19,8,13,94,111
2020,2,22000406,2/13/2021,1610612756,Phoenix Suns,1,1,1610612755,Philadelphia 76ers,0,0,38,16,54,10,15,25,48,31,79,14,3,17,6,27,25,7,14,94,120
2017,2,21700365,12/7/2017,1610612760,Oklahoma City Thunder,0,0,1610612751,Brooklyn Nets,1,1,31,43,74,7,17,24,38,60,98,12,12,24,23,44,18,3,12,99,95
2014,2,21401042,3/22/2015,1610612758,Sacramento Kings,1,1,1610612764,Washington Wizards,0,0,32,30,62,8,9,17,40,39,79,21,2,23,11,29,24,7,17,94,109
2014,2,21401042,3/22/2015,1610612764,Washington Wizards,0,0,1610612758,Sacramento Kings,1,1,32,38,70,3,14,17,35,52,87,13,5,18,20,35,21,12,17,94,86
2022,2,22200484,12/23/2022,1610612739,Cleveland Cavaliers,1,0,1610612761,Toronto Raptors,0,1,28,15,43,11,22,33,39,37,76,18,12,30,8,34,27,10,15,96,107
2022,2,22200484,12/23/2022,1610612761,Toronto Raptors,0,1,1610612739,Cleveland Cavaliers,1,0,23,24,47,19,18,37,42,42,84,15,3,18,13,31,25,9,19,97,118
2021,2,22100631,1/13/2022,1610612743,Denver Nuggets,1,1,1610612757,Portland Trail Blazers,0,0,31,10,41,21,21,42,52,31,83,15,5,20,8,25,35,11,16,100,140
2021,2,22100631,1/13/2022,1610612757,Portland Trail Blazers,0,0,1610612743,Denver Nuggets,1,1,26,20,46,13,27,40,39,47,86,17,11,28,13,39,28,7,15,99,108
2020,2,22000405,2/12/2021,1610612753,Orlando Magic,0,1,1610612758,Sacramento Kings,1,0,31,26,57,15,19,34,46,45,91,16,4,20,10,37,25,8,10,98,123
2022,2,22200207,11/15/2022,1610612746,LA Clippers,0,0,1610612742,Dallas Mavericks,1,1,22,14,36,12,16,28,34,30,64,21,5,26,4,29,23,12,21,93,101
2022,2,22201202,4/7/2023,1610612745,Houston Rockets,0,1,1610612766,Charlotte Hornets,1,0,35,33,68,7,14,21,42,47,89,21,7,28,16,35,21,10,19,104,112
2020,2,22000717,3/29/2021,1610612746,LA Clippers,1,1,1610612749,Milwaukee Bucks,0,0,32,29,61,19,15,34,51,44,95,8,2,10,16,29,25,8,14,97,129
2020,2,22000717,3/29/2021,1610612749,Milwaukee Bucks,0,0,1610612746,LA Clippers,1,1,27,24,51,11,19,30,38,43,81,18,3,21,7,36,18,5,12,97,105
2021,2,22100630,1/13/2022,1610612751,Brooklyn Nets,1,0,1610612760,Oklahoma City Thunder,0,1,34,32,66,7,25,32,41,57,98,20,2,22,25,34,16,8,12,96,109
2021,2,22100630,1/13/2022,1610612760,Oklahoma City Thunder,0,1,1610612751,Brooklyn Nets,1,0,27,19,46,20,25,45,47,44,91,16,2,18,14,31,32,7,11,96,130
2020,2,22000405,2/12/2021,1610612758,Sacramento Kings,1,0,1610612753,Orlando Magic,0,1,31,19,50,12,21,33,43,40,83,14,5,19,11,32,33,8,18,100,112
2022,2,22200493,12/25/2022,1610612752,New York Knicks,1,0,1610612755,Philadelphia 76ers,0,1,31,27,58,12,20,32,43,47,90,14,3,17,18,31,30,5,8,91,112
2022,2,22200493,12/25/2022,1610612755,Philadelphia 76ers,0,1,1610612752,New York Knicks,1,0,21,17,38,18,21,39,39,38,77,23,6,29,7,35,22,4,8,90,119
2017,2,21700364,12/7/2017,1610612756,Phoenix Suns,1,0,1610612764,Washington Wizards,0,1,29,26,55,7,16,23,36,42,78,20,8,28,11,34,22,6,14,92,99
2017,2,21700364,12/7/2017,1610612764,Washington Wizards,0,1,1610612756,Phoenix Suns,1,0,33,27,60,8,13,21,41,40,81,19,6,25,11,33,25,5,11,92,109
2022,2,22200482,12/23/2022,1610612738,Boston Celtics,1,1,1610612750,Minnesota Timberwolves,0,0,31,23,54,13,33,46,44,56,100,20,6,26,21,36,28,3,12,101,121
2022,2,22201060,3/18/2023,1610612741,Chicago Bulls,1,1,1610612748,Miami Heat,0,0,28,18,46,17,17,34,45,35,80,6,0,6,8,27,34,4,14,88,113
2022,2,22201085,3/22/2023,1610612761,Toronto Raptors,1,0,1610612754,Indiana Pacers,0,1,32,23,55,7,27,34,39,50,89,29,10,39,18,36,21,4,10,98,114
2016,2,21600339,12/9/2016,1610612738,Boston Celtics,1,0,1610612761,Toronto Raptors,0,1,14,27,41,17,25,42,31,52,83,15,7,22,12,44,24,9,14,96,94
2016,2,21600339,12/9/2016,1610612761,Toronto Raptors,0,1,1610612738,Boston Celtics,1,0,25,37,62,9,11,20,34,48,82,24,3,27,10,39,12,5,11,96,101
2022,2,22200069,10/27/2022,1610612758,Sacramento Kings,1,0,1610612763,Memphis Grizzlies,0,1,28,17,45,12,26,38,40,43,83,18,4,22,9,35,28,5,13,97,110
2022,2,22200069,10/27/2022,1610612763,Memphis Grizzlies,0,1,1610612758,Sacramento Kings,1,0,35,24,59,14,19,33,49,43,92,13,5,18,14,32,27,5,14,99,125
2021,2,22100629,1/13/2022,1610612740,New Orleans Pelicans,1,1,1610612746,LA Clippers,0,0,29,29,58,14,25,39,43,54,97,13,3,16,13,43,23,2,6,97,113
2021,2,22100629,1/13/2022,1610612746,LA Clippers,0,0,1610612740,New Orleans Pelicans,1,1,21,26,47,10,24,34,31,50,81,17,3,20,7,44,19,8,15,96,89
2020,2,22000404,2/12/2021,1610612739,Cleveland Cavaliers,0,0,1610612757,Portland Trail Blazers,1,1,30,34,64,8,15,23,38,49,87,26,11,37,15,37,20,3,11,100,110
2020,2,22000404,2/12/2021,1610612757,Portland Trail Blazers,1,1,1610612739,Cleveland Cavaliers,0,0,30,18,48,13,22,35,43,40,83,30,3,33,10,32,16,6,14,100,129
2022,2,22200497,12/25/2022,1610612743,Denver Nuggets,1,1,1610612756,Phoenix Suns,0,0,32,26,58,13,23,36,45,49,94,25,9,34,17,35,29,7,13,107,128
2022,2,22200497,12/25/2022,1610612756,Phoenix Suns,0,0,1610612743,Denver Nuggets,1,1,28,31,59,17,18,35,45,49,94,18,8,26,14,40,32,8,14,106,125
2017,2,21700363,12/7/2017,1610612747,Los Angeles Lakers,0,1,1610612755,Philadelphia 76ers,1,0,31,37,68,11,17,28,42,54,96,12,12,24,20,40,22,3,12,98,107
2022,2,22201059,3/18/2023,1610612764,Washington Wizards,1,0,1610612758,Sacramento Kings,0,1,28,27,55,13,23,36,41,50,91,23,4,27,14,39,27,7,10,99,118
2020,2,22000716,3/29/2021,1610612741,Chicago Bulls,0,0,1610612744,Golden State Warriors,1,1,38,22,60,6,18,24,44,40,84,8,3,11,11,30,33,9,20,97,102
2020,2,22000716,3/29/2021,1610612744,Golden State Warriors,1,1,1610612741,Chicago Bulls,0,0,30,24,54,16,22,38,46,46,92,8,1,9,14,33,28,8,15,98,116
2020,2,22000403,2/12/2021,1610612747,Los Angeles Lakers,1,1,1610612763,Memphis Grizzlies,0,0,37,18,55,6,24,30,43,42,85,23,10,33,18,28,26,9,18,99,115
2020,2,22000403,2/12/2021,1610612763,Memphis Grizzlies,0,0,1610612747,Los Angeles Lakers,1,1,27,24,51,12,17,29,39,41,80,15,4,19,7,36,31,9,17,99,105
2017,2,21700363,12/7/2017,1610612755,Philadelphia 76ers,1,0,1610612747,Los Angeles Lakers,0,1,29,26,55,10,16,26,39,42,81,16,5,21,11,34,29,13,18,99,104
2022,2,22200498,12/26/2022,1610612739,Cleveland Cavaliers,1,0,1610612751,Brooklyn Nets,0,1,26,20,46,13,23,36,39,43,82,26,4,30,11,34,21,7,12,97,117
2022,2,22200498,12/26/2022,1610612751,Brooklyn Nets,0,1,1610612739,Cleveland Cavaliers,1,0,29,23,52,18,12,30,47,35,82,13,4,17,12,26,27,8,17,95,125
2022,2,22200884,2/16/2023,1610612764,Washington Wizards,0,1,1610612750,Minnesota Timberwolves,1,0,29,31,60,14,21,35,43,52,95,14,3,17,16,38,25,8,16,104,114
2022,2,22200902,2/24/2023,1610612746,LA Clippers,1,0,1610612758,Sacramento Kings,0,1,33,20,53,26,19,45,59,39,98,31,5,36,10,32,39,18,25,130,175
2022,2,22201176,4/4/2023,1610612766,Charlotte Hornets,1,0,1610612761,Toronto Raptors,0,1,24,22,46,12,19,31,36,41,77,16,3,19,9,32,27,13,18,94,100
2022,2,22201093,3/23/2023,1610612752,New York Knicks,0,0,1610612753,Orlando Magic,1,1,25,23,48,12,28,40,37,51,88,20,6,26,15,37,26,8,13,98,106
2020,2,22000715,3/29/2021,1610612739,Cleveland Cavaliers,0,0,1610612762,Utah Jazz,1,1,22,27,49,7,27,34,29,54,83,10,6,16,8,49,17,6,10,92,75
2020,2,22000715,3/29/2021,1610612762,Utah Jazz,1,1,1610612739,Cleveland Cavaliers,0,0,19,22,41,19,22,41,38,44,82,19,4,23,13,34,29,5,12,93,114
2022,2,22200509,12/27/2022,1610612746,LA Clippers,0,1,1610612761,Toronto Raptors,1,0,30,25,55,15,23,38,45,48,93,19,4,23,19,31,27,6,11,98,124
2022,2,22200509,12/27/2022,1610612761,Toronto Raptors,1,0,1610612746,LA Clippers,0,1,37,24,61,6,17,23,43,41,84,21,5,26,12,33,24,8,12,97,113
2022,2,22200068,10/27/2022,1610612744,Golden State Warriors,1,1,1610612748,Miami Heat,0,0,28,18,46,18,28,46,46,46,92,13,2,15,21,26,30,16,21,99,123
2022,2,22200068,10/27/2022,1610612748,Miami Heat,0,0,1610612744,Golden State Warriors,1,1,25,20,45,14,29,43,39,49,88,18,4,22,12,39,25,4,12,100,110
2021,2,22100628,1/13/2022,1610612750,Minnesota Timberwolves,0,0,1610612763,Memphis Grizzlies,1,1,26,22,48,15,33,48,41,55,96,11,3,14,18,40,23,10,18,103,108
2022,2,22200206,11/15/2022,1610612740,New Orleans Pelicans,1,1,1610612763,Memphis Grizzlies,0,0,25,28,53,18,20,38,43,48,91,9,3,12,10,40,31,6,10,96,113
2022,2,22200884,2/16/2023,1610612750,Minnesota Timberwolves,1,0,1610612764,Washington Wizards,0,1,31,35,66,8,21,29,39,56,95,20,2,22,20,37,21,13,18,105,106
2022,2,22200862,2/13/2023,1610612751,Brooklyn Nets,0,0,1610612752,New York Knicks,1,1,23,26,49,12,17,29,35,43,78,24,9,33,14,34,18,4,10,91,106
2022,2,22200948,3/3/2023,1610612751,Brooklyn Nets,0,1,1610612738,Boston Celtics,1,0,26,25,51,14,30,44,40,55,95,21,5,26,17,41,25,8,13,104,115
2022,2,22200948,3/3/2023,1610612738,Boston Celtics,1,0,1610612751,Brooklyn Nets,0,1,32,23,55,9,20,29,41,43,84,14,6,20,10,37,26,9,19,102,105
2022,2,22200902,2/24/2023,1610612758,Sacramento Kings,0,1,1610612746,LA Clippers,1,0,47,23,70,18,23,41,65,46,111,28,7,35,14,36,33,8,15,128,176
2022,2,22201044,3/16/2023,1610612760,Oklahoma City Thunder,0,0,1610612761,Toronto Raptors,1,1,27,36,63,13,18,31,40,54,94,18,2,20,16,40,18,10,13,100,111
2022,2,22200206,11/15/2022,1610612763,Memphis Grizzlies,0,0,1610612740,New Orleans Pelicans,1,1,29,28,57,9,26,35,38,54,92,17,8,25,17,40,16,2,11,97,102
2022,2,22201045,3/16/2023,1610612754,Indiana Pacers,0,1,1610612749,Milwaukee Bucks,1,0,32,19,51,22,24,46,54,43,97,9,6,15,10,36,36,5,10,104,139
2022,2,22201178,4/4/2023,1610612739,Cleveland Cavaliers,0,1,1610612753,Orlando Magic,1,0,27,26,53,15,16,31,42,42,84,18,2,20,9,35,23,6,9,96,117
2022,2,22201178,4/4/2023,1610612753,Orlando Magic,1,0,1610612739,Cleveland Cavaliers,0,1,35,31,66,10,13,23,45,44,89,13,4,17,15,29,25,3,13,95,113
2022,2,22201207,4/7/2023,1610612751,Brooklyn Nets,1,1,1610612753,Orlando Magic,0,0,26,21,47,9,33,42,35,54,89,22,3,25,12,42,27,6,10,97,101
2021,2,22100628,1/13/2022,1610612763,Memphis Grizzlies,1,1,1610612750,Minnesota Timberwolves,0,0,34,26,60,8,24,32,42,50,92,24,11,35,19,36,22,4,14,103,116
2022,2,22200859,2/13/2023,1610612762,Utah Jazz,0,1,1610612754,Indiana Pacers,1,0,28,24,52,15,18,33,43,42,85,22,3,25,16,28,24,11,19,101,123
2022,2,22201206,4/7/2023,1610612738,Boston Celtics,1,1,1610612761,Toronto Raptors,0,0,30,7,37,15,29,44,45,36,81,16,5,21,16,23,37,12,21,95,121
2022,2,22200922,2/27/2023,1610612753,Orlando Magic,0,1,1610612740,New Orleans Pelicans,1,0,27,18,45,9,25,34,36,43,79,20,6,26,15,32,21,9,17,93,101
2020,2,22000402,2/12/2021,1610612749,Milwaukee Bucks,0,0,1610612762,Utah Jazz,1,1,30,29,59,12,21,33,42,50,92,19,8,27,8,44,19,4,10,104,115
2020,2,22000402,2/12/2021,1610612762,Utah Jazz,1,1,1610612749,Milwaukee Bucks,0,0,29,15,44,14,24,38,43,39,82,29,5,34,13,30,22,8,17,105,129
2017,2,21700362,12/6/2017,1610612746,LA Clippers,1,0,1610612750,Minnesota Timberwolves,0,1,34,33,67,10,22,32,44,55,99,9,6,15,19,39,23,4,9,95,107
2017,2,21700362,12/6/2017,1610612750,Minnesota Timberwolves,0,1,1610612746,LA Clippers,1,0,38,25,63,7,12,19,45,37,82,16,5,21,12,28,29,6,15,94,113
2016,2,21600853,2/23/2017,1610612739,Cleveland Cavaliers,1,1,1610612752,New York Knicks,0,0,31,18,49,15,23,38,46,41,87,12,3,15,8,34,29,4,13,99,119
2022,2,22201179,4/4/2023,1610612749,Milwaukee Bucks,0,1,1610612764,Washington Wizards,1,0,27,23,50,23,19,42,50,42,92,17,12,29,16,35,33,7,18,108,140
2022,2,22201204,4/7/2023,1610612764,Washington Wizards,1,1,1610612748,Miami Heat,0,0,32,19,51,7,26,33,39,45,84,29,8,37,14,35,23,7,17,103,114
2022,2,22200954,3/3/2023,1610612746,LA Clippers,0,0,1610612758,Sacramento Kings,1,1,33,13,46,14,27,41,47,40,87,19,8,27,9,36,31,3,7,98,127
2022,2,22200067,10/27/2022,1610612746,LA Clippers,0,0,1610612760,Oklahoma City Thunder,1,1,35,19,54,9,19,28,44,38,82,13,5,18,12,28,21,10,20,99,110
2022,2,22200067,10/27/2022,1610612760,Oklahoma City Thunder,1,1,1610612746,LA Clippers,0,0,30,27,57,17,21,38,47,48,95,7,1,8,14,35,27,6,12,97,118
2021,2,22100627,1/13/2022,1610612744,Golden State Warriors,0,0,1610612749,Milwaukee Bucks,1,1,17,30,47,16,32,48,33,62,95,17,7,24,15,50,20,10,15,106,99
2021,2,22100627,1/13/2022,1610612749,Milwaukee Bucks,1,1,1610612744,Golden State Warriors,0,0,26,19,45,18,23,41,44,42,86,12,6,18,5,39,29,9,17,106,118
2022,2,22200208,11/15/2022,1610612752,New York Knicks,0,1,1610612762,Utah Jazz,1,0,33,28,61,11,21,32,44,49,93,19,6,25,17,36,26,7,14,101,118
2022,2,22201093,3/23/2023,1610612753,Orlando Magic,1,1,1610612752,New York Knicks,0,0,27,28,55,13,19,32,40,47,87,18,3,21,13,37,25,8,16,99,111
2020,2,22000714,3/29/2021,1610612758,Sacramento Kings,0,1,1610612759,San Antonio Spurs,1,0,29,19,48,18,18,36,47,37,84,20,5,25,6,32,29,5,7,97,132
2020,2,22000714,3/29/2021,1610612759,San Antonio Spurs,1,0,1610612758,Sacramento Kings,0,1,37,29,66,10,17,27,47,46,93,11,3,14,13,35,24,9,11,97,115
2021,2,22100626,1/12/2022,1610612747,Los Angeles Lakers,0,0,1610612758,Sacramento Kings,1,1,26,25,51,16,31,47,42,56,98,16,8,24,20,40,25,8,9,100,116
2021,2,22100626,1/12/2022,1610612758,Sacramento Kings,1,1,1610612747,Los Angeles Lakers,0,0,38,21,59,11,19,30,49,40,89,16,3,19,12,30,28,6,13,98,125
2014,2,21400109,11/12/2014,1610612764,Washington Wizards,1,1,1610612765,Detroit Pistons,0,0,37,35,72,3,8,11,40,43,83,24,9,33,15,33,27,5,11,95,107
2014,2,21400109,11/12/2014,1610612765,Detroit Pistons,0,0,1610612764,Washington Wizards,1,1,29,30,59,9,13,22,38,43,81,18,4,22,10,36,19,10,14,95,103
2016,2,21600853,2/23/2017,1610612752,New York Knicks,0,0,1610612739,Cleveland Cavaliers,1,1,34,41,75,8,18,26,42,59,101,12,5,17,22,39,24,5,13,101,104
2021,2,22100625,1/12/2022,1610612741,Chicago Bulls,1,0,1610612751,Brooklyn Nets,0,1,27,24,51,11,19,30,38,43,81,25,6,31,12,35,22,11,17,100,112
2021,2,22100625,1/12/2022,1610612751,Brooklyn Nets,0,1,1610612741,Chicago Bulls,1,0,32,23,55,17,15,32,49,38,87,23,5,28,9,30,35,5,10,100,138
2020,2,22000401,2/12/2021,1610612743,Denver Nuggets,1,1,1610612760,Oklahoma City Thunder,0,0,30,17,47,10,30,40,40,47,87,7,3,10,10,39,24,8,13,96,97
2020,2,22000401,2/12/2021,1610612760,Oklahoma City Thunder,0,0,1610612743,Denver Nuggets,1,1,26,32,58,10,22,32,36,54,90,13,4,17,17,38,26,6,14,95,95
2017,2,21700361,12/6/2017,1610612748,Miami Heat,0,0,1610612759,San Antonio Spurs,1,1,21,17,38,18,16,34,39,33,72,9,3,12,9,25,28,6,19,88,105
2017,2,21700361,12/6/2017,1610612759,San Antonio Spurs,1,1,1610612748,Miami Heat,0,0,33,29,62,13,12,25,46,41,87,12,2,14,17,26,30,7,11,89,117
2019,2,21900200,11/19/2019,1610612756,Phoenix Suns,0,0,1610612758,Sacramento Kings,1,1,26,27,53,12,24,36,38,51,89,28,6,34,17,37,24,7,12,102,116
2019,2,21900200,11/19/2019,1610612758,Sacramento Kings,1,1,1610612756,Phoenix Suns,0,0,29,19,48,13,18,31,42,37,79,23,2,25,9,28,28,11,19,101,120
2016,2,21600852,2/23/2017,1610612740,New Orleans Pelicans,1,0,1610612745,Houston Rockets,0,1,30,25,55,6,25,31,36,50,86,21,5,26,13,37,24,12,20,104,99
2016,2,21600852,2/23/2017,1610612745,Houston Rockets,0,1,1610612740,New Orleans Pelicans,1,0,25,15,40,20,31,51,45,46,91,19,5,24,15,35,28,10,17,104,129
2014,2,21400108,11/11/2014,1610612744,Golden State Warriors,1,0,1610612759,San Antonio Spurs,0,1,31,19,50,7,13,20,38,32,70,17,3,20,4,30,23,9,20,94,100
2014,2,21400108,11/11/2014,1610612759,San Antonio Spurs,0,1,1610612744,Golden State Warriors,1,0,36,32,68,10,15,25,46,47,93,11,4,15,12,37,28,5,8,95,113
2022,2,22200066,10/27/2022,1610612742,Dallas Mavericks,0,1,1610612751,Brooklyn Nets,1,0,21,20,41,20,20,40,41,40,81,27,8,35,10,34,25,10,18,106,129
2022,2,22200066,10/27/2022,1610612751,Brooklyn Nets,1,0,1610612742,Dallas Mavericks,0,1,31,27,58,12,23,35,43,50,93,27,3,30,18,34,20,8,15,106,125
2022,2,22200208,11/15/2022,1610612762,Utah Jazz,1,0,1610612752,New York Knicks,0,1,22,18,40,14,29,43,36,47,83,25,5,30,16,33,29,10,21,101,111
2022,2,22201044,3/16/2023,1610612761,Toronto Raptors,1,1,1610612760,Oklahoma City Thunder,0,0,33,32,65,14,18,32,47,50,97,20,8,28,23,31,29,5,10,99,128
2022,2,22200921,2/27/2023,1610612752,New York Knicks,1,1,1610612738,Boston Celtics,0,0,25,22,47,12,19,31,37,41,78,23,11,34,14,30,20,5,15,96,109
2022,2,22200885,2/16/2023,1610612746,LA Clippers,0,1,1610612756,Phoenix Suns,1,0,29,19,48,11,23,34,40,42,82,25,2,27,11,32,29,10,14,98,116
2022,2,22201206,4/7/2023,1610612761,Toronto Raptors,0,0,1610612738,Boston Celtics,1,1,31,31,62,9,22,31,40,53,93,13,4,17,15,41,21,4,8,95,102
2022,2,22200825,2/8/2023,1610612754,Indiana Pacers,0,0,1610612748,Miami Heat,1,1,23,22,45,15,18,33,38,40,78,20,8,28,8,38,24,7,11,94,111
2022,2,22200984,3/7/2023,1610612763,Memphis Grizzlies,0,0,1610612747,Los Angeles Lakers,1,1,27,29,56,9,28,37,36,57,93,22,7,29,7,53,18,4,7,105,103
2022,2,22201094,3/23/2023,1610612739,Cleveland Cavaliers,0,1,1610612751,Brooklyn Nets,1,0,30,27,57,12,20,32,42,47,89,20,6,26,16,34,24,7,10,97,116
2023,2,22300077,10/27/2023,1610612766,Charlotte Hornets,1,0,1610612765,Detroit Pistons,0,1,26,34,60,7,21,28,33,55,88,26,8,34,16,44,20,7,18,107,99
2019,2,21900199,11/19/2019,1610612740,New Orleans Pelicans,1,1,1610612757,Portland Trail Blazers,0,0,28,29,57,13,23,36,41,52,93,20,4,24,16,37,24,5,13,102,115
2023,2,22301101,4/2/2024,1610612746,LA Clippers,0,0,1610612758,Sacramento Kings,1,1,20,29,49,11,16,27,31,45,76,22,5,27,11,38,18,10,16,92,95
2023,2,22300484,1/5/2024,1610612741,Chicago Bulls,1,1,1610612766,Charlotte Hornets,0,0,30,16,46,10,18,28,40,34,74,14,3,17,5,32,29,7,15,91,104
2022,2,22201094,3/23/2023,1610612751,Brooklyn Nets,1,0,1610612739,Cleveland Cavaliers,0,1,27,20,47,12,22,34,39,42,81,24,3,27,15,29,24,7,16,97,114
2019,2,21900199,11/19/2019,1610612757,Portland Trail Blazers,0,0,1610612740,New Orleans Pelicans,1,1,24,39,63,16,13,29,40,52,92,8,5,13,14,40,20,10,17,102,104
2020,2,22000713,3/29/2021,1610612742,Dallas Mavericks,0,1,1610612760,Oklahoma City Thunder,1,0,35,17,52,16,28,44,51,45,96,9,4,13,8,39,30,8,9,102,127
2020,2,22000713,3/29/2021,1610612760,Oklahoma City Thunder,1,0,1610612742,Dallas Mavericks,0,1,29,26,55,9,17,26,38,43,81,21,12,33,12,36,17,11,16,102,106
2021,2,22100623,1/12/2022,1610612745,Houston Rockets,0,1,1610612759,San Antonio Spurs,1,0,29,17,46,16,20,36,45,37,82,22,10,32,8,34,23,10,14,104,128
2021,2,22100623,1/12/2022,1610612759,San Antonio Spurs,1,0,1610612745,Houston Rockets,0,1,26,27,53,17,29,46,43,56,99,21,6,27,14,44,27,5,9,104,124
2020,2,22000400,2/12/2021,1610612741,Chicago Bulls,1,0,1610612746,LA Clippers,0,1,28,25,53,12,20,32,40,45,85,14,1,15,10,35,23,11,13,96,106
2020,2,22000400,2/12/2021,1610612746,LA Clippers,0,1,1610612741,Chicago Bulls,1,0,37,19,56,13,17,30,50,36,86,12,3,15,5,34,20,4,9,96,125
2017,2,21700360,12/6/2017,1610612740,New Orleans Pelicans,1,1,1610612743,Denver Nuggets,0,0,34,21,55,12,19,31,46,40,86,19,10,29,13,32,28,7,13,98,123
2017,2,21700360,12/6/2017,1610612743,Denver Nuggets,0,0,1610612740,New Orleans Pelicans,1,1,25,34,59,16,19,35,41,53,94,16,6,22,15,41,22,4,9,97,114
2020,2,22000399,2/12/2021,1610612740,New Orleans Pelicans,0,0,1610612742,Dallas Mavericks,1,1,31,22,53,17,20,37,48,42,90,17,6,23,12,34,31,4,10,97,130
2020,2,22000399,2/12/2021,1610612742,Dallas Mavericks,1,1,1610612740,New Orleans Pelicans,0,0,26,17,43,25,20,45,51,37,88,16,5,21,8,31,30,5,6,97,143
2022,2,22200209,11/15/2022,1610612757,Portland Trail Blazers,1,1,1610612759,San Antonio Spurs,0,0,26,21,47,15,17,32,41,38,79,20,6,26,11,29,22,7,17,96,117
2022,2,22200824,2/8/2023,1610612755,Philadelphia 76ers,0,0,1610612738,Boston Celtics,1,1,27,25,52,10,21,31,37,46,83,15,5,20,10,41,20,2,7,88,99
2022,2,22200209,11/15/2022,1610612759,San Antonio Spurs,0,0,1610612757,Portland Trail Blazers,1,1,35,21,56,9,20,29,44,41,85,13,4,17,13,32,34,6,19,98,110
2017,2,21700359,12/6/2017,1610612749,Milwaukee Bucks,1,1,1610612765,Detroit Pistons,0,0,31,26,57,8,14,22,39,40,79,18,8,26,13,33,22,5,12,90,104
2017,2,21700359,12/6/2017,1610612765,Detroit Pistons,0,0,1610612749,Milwaukee Bucks,1,1,26,31,57,10,20,30,36,51,87,18,9,27,20,35,20,7,12,90,100
2022,2,22200950,3/3/2023,1610612756,Phoenix Suns,0,1,1610612741,Chicago Bulls,1,0,22,15,37,20,27,47,42,42,84,21,4,25,17,27,29,7,11,91,125
2022,2,22200861,2/13/2023,1610612748,Miami Heat,1,0,1610612743,Denver Nuggets,0,1,27,27,54,12,23,35,39,50,89,18,2,20,18,33,25,3,9,89,108
2022,2,22200863,2/13/2023,1610612753,Orlando Magic,0,1,1610612741,Chicago Bulls,1,0,30,24,54,8,19,27,38,43,81,16,3,19,9,36,24,8,18,99,100
2022,2,22201029,3/14/2023,1610612743,Denver Nuggets,0,0,1610612761,Toronto Raptors,1,1,36,15,51,6,19,25,42,34,76,20,5,25,7,30,29,10,14,95,110
2022,2,22201043,3/16/2023,1610612758,Sacramento Kings,0,1,1610612751,Brooklyn Nets,1,0,19,22,41,13,28,41,32,50,82,24,8,32,17,39,22,8,12,92,101
2022,2,22201062,3/18/2023,1610612738,Boston Celtics,0,0,1610612762,Utah Jazz,1,1,20,17,37,22,29,51,42,46,88,11,5,16,7,40,30,3,8,94,117
2022,2,22200858,2/13/2023,1610612759,San Antonio Spurs,0,0,1610612739,Cleveland Cavaliers,1,1,35,29,64,8,13,21,43,42,85,15,5,20,18,25,27,8,18,95,109
2022,2,22200864,2/13/2023,1610612740,New Orleans Pelicans,0,1,1610612760,Oklahoma City Thunder,1,0,30,14,44,9,21,30,39,35,74,16,2,18,7,29,19,8,19,94,103
2021,2,22100622,1/12/2022,1610612742,Dallas Mavericks,0,0,1610612752,New York Knicks,1,1,24,17,41,8,29,37,32,46,78,13,6,19,7,44,16,5,13,92,85
2023,2,22301101,4/2/2024,1610612758,Sacramento Kings,1,1,1610612746,LA Clippers,0,0,27,23,50,12,30,42,39,53,92,19,6,25,21,35,29,6,10,93,109
2023,2,22300401,12/25/2023,1610612752,New York Knicks,1,1,1610612749,Milwaukee Bucks,0,0,42,24,66,8,18,26,50,42,92,21,5,26,16,30,27,7,12,100,129
2022,2,22200210,11/15/2022,1610612758,Sacramento Kings,1,1,1610612751,Brooklyn Nets,0,0,36,17,53,20,21,41,56,38,94,21,4,25,14,27,39,5,17,109,153
2022,2,22201042,3/16/2023,1610612743,Denver Nuggets,0,1,1610612765,Detroit Pistons,1,0,39,26,65,8,16,24,47,42,89,17,8,25,17,28,29,8,10,94,119
2016,2,21600338,12/9/2016,1610612739,Cleveland Cavaliers,1,1,1610612748,Miami Heat,0,0,37,22,59,9,15,24,46,37,83,13,6,19,14,25,23,6,11,89,114
2016,2,21600338,12/9/2016,1610612748,Miami Heat,0,0,1610612739,Cleveland Cavaliers,1,1,25,38,63,6,21,27,31,59,90,16,5,21,25,36,18,7,15,90,84
2022,2,22200860,2/13/2023,1610612755,Philadelphia 76ers,1,1,1610612745,Houston Rockets,0,0,31,17,48,15,19,34,46,36,82,16,1,17,8,29,26,10,16,98,123
2022,2,22201102,3/24/2023,1610612749,Milwaukee Bucks,0,1,1610612762,Utah Jazz,1,0,33,16,49,22,28,50,55,44,99,12,4,16,13,34,42,6,13,110,144
2022,2,22201043,3/16/2023,1610612751,Brooklyn Nets,1,0,1610612758,Sacramento Kings,0,1,19,22,41,14,25,39,33,47,80,16,7,23,4,48,20,2,7,93,96
2022,2,22201177,4/4/2023,1610612765,Detroit Pistons,1,0,1610612748,Miami Heat,0,1,25,20,45,11,17,28,36,37,73,22,5,27,8,30,21,12,14,91,105
2021,2,22100622,1/12/2022,1610612752,New York Knicks,1,1,1610612742,Dallas Mavericks,0,0,30,33,63,12,15,27,42,48,90,12,3,15,14,35,24,6,9,93,108
2022,2,22200826,2/8/2023,1610612761,Toronto Raptors,1,1,1610612759,San Antonio Spurs,0,0,33,27,60,10,18,28,43,45,88,16,5,21,12,35,21,11,17,104,112
2020,2,22000398,2/11/2021,1610612738,Boston Celtics,1,1,1610612761,Toronto Raptors,0,0,19,28,47,20,19,39,39,47,86,22,6,28,20,30,30,7,19,101,120
2020,2,22000398,2/11/2021,1610612761,Toronto Raptors,0,0,1610612738,Boston Celtics,1,1,32,23,55,9,19,28,41,42,83,15,4,19,4,39,26,8,13,100,106
2017,2,21700358,12/6/2017,1610612744,Golden State Warriors,0,1,1610612766,Charlotte Hornets,1,0,29,25,54,11,19,30,40,44,84,10,3,13,9,36,26,5,15,97,101
2017,2,21700358,12/6/2017,1610612766,Charlotte Hornets,1,0,1610612744,Golden State Warriors,0,1,28,50,78,6,13,19,34,63,97,13,4,17,20,43,17,8,12,97,87
2022,2,22200858,2/13/2023,1610612739,Cleveland Cavaliers,1,1,1610612759,San Antonio Spurs,0,0,35,15,50,9,19,28,44,34,78,20,5,25,11,25,21,10,14,94,117
2022,2,22201062,3/18/2023,1610612762,Utah Jazz,1,1,1610612738,Boston Celtics,0,0,25,31,56,17,24,41,42,55,97,17,5,22,19,38,29,2,7,93,118
2022,2,22200952,3/3/2023,1610612743,Denver Nuggets,1,1,1610612763,Memphis Grizzlies,0,0,32,24,56,8,23,31,40,47,87,25,6,31,16,34,28,6,10,96,113
2022,2,22201102,3/24/2023,1610612762,Utah Jazz,1,0,1610612749,Milwaukee Bucks,0,1,29,35,64,11,29,40,40,64,104,25,9,34,23,46,28,6,11,109,116
2020,2,22000712,3/29/2021,1610612745,Houston Rockets,1,0,1610612763,Memphis Grizzlies,0,1,29,23,52,11,31,42,40,54,94,19,3,22,15,41,28,8,12,101,110
2020,2,22000712,3/29/2021,1610612763,Memphis Grizzlies,0,1,1610612745,Houston Rockets,1,0,35,19,54,11,20,31,46,39,85,17,7,24,10,33,31,9,16,99,120
2022,2,22201179,4/4/2023,1610612764,Washington Wizards,1,0,1610612749,Milwaukee Bucks,0,1,37,35,72,13,14,27,50,49,99,15,6,21,10,45,30,6,9,108,128
2022,2,22200865,2/13/2023,1610612750,Minnesota Timberwolves,0,1,1610612742,Dallas Mavericks,1,0,39,15,54,9,20,29,48,35,83,19,7,26,12,27,28,5,12,94,124
2021,2,22100621,1/12/2022,1610612737,Atlanta Hawks,1,0,1610612748,Miami Heat,0,1,18,19,37,13,32,45,31,51,82,16,7,23,9,45,20,7,14,99,91
2017,2,21700357,12/6/2017,1610612752,New York Knicks,1,1,1610612763,Memphis Grizzlies,0,0,26,27,53,9,5,14,35,32,67,20,7,27,12,24,22,8,19,87,99
2017,2,21700357,12/6/2017,1610612763,Memphis Grizzlies,0,0,1610612752,New York Knicks,1,1,17,25,42,12,16,28,29,41,70,18,4,22,7,36,14,8,15,88,88
2022,2,22200824,2/8/2023,1610612738,Boston Celtics,1,1,1610612755,Philadelphia 76ers,0,0,21,20,41,19,16,35,40,36,76,7,3,10,8,30,25,9,15,88,106
2023,2,22300078,10/27/2023,1610612743,Denver Nuggets,0,1,1610612763,Memphis Grizzlies,1,0,27,24,51,14,23,37,41,47,88,12,6,18,14,37,27,13,19,102,108
2022,2,22200211,11/16/2022,1610612754,Indiana Pacers,0,1,1610612766,Charlotte Hornets,1,0,33,21,54,11,17,28,44,38,82,26,5,31,8,31,27,8,14,103,125
2017,2,21700356,12/6/2017,1610612738,Boston Celtics,1,1,1610612742,Dallas Mavericks,0,0,24,29,53,12,22,34,36,51,87,13,4,17,11,41,25,7,12,96,97
2017,2,21700356,12/6/2017,1610612742,Dallas Mavericks,0,0,1610612738,Boston Celtics,1,1,25,33,58,9,19,28,34,52,86,13,4,17,8,46,19,8,11,97,90
2021,2,22100621,1/12/2022,1610612748,Miami Heat,0,1,1610612737,Atlanta Hawks,1,0,27,18,45,16,29,45,43,47,90,13,1,14,13,34,28,8,15,99,115
2020,2,22000397,2/12/2021,1610612737,Atlanta Hawks,1,0,1610612759,San Antonio Spurs,0,1,28,30,58,11,21,32,39,51,90,25,8,33,15,39,22,6,12,104,114
2022,2,22200211,11/16/2022,1610612766,Charlotte Hornets,1,0,1610612754,Indiana Pacers,0,1,31,30,61,12,21,33,43,51,94,15,3,18,19,32,29,11,18,102,113
2022,2,22200857,2/13/2023,1610612737,Atlanta Hawks,0,0,1610612766,Charlotte Hornets,1,1,42,38,80,11,17,28,53,55,108,21,0,21,20,35,26,5,12,108,138
2021,2,22100620,1/12/2022,1610612753,Orlando Magic,0,0,1610612764,Washington Wizards,1,1,30,34,64,11,24,35,41,58,99,13,3,16,22,36,31,6,9,94,106
2021,2,22100620,1/12/2022,1610612764,Washington Wizards,1,1,1610612753,Orlando Magic,0,0,33,18,51,10,21,31,43,39,82,16,5,21,8,34,26,6,10,92,112
2023,2,22300220,11/20/2023,1610612748,Miami Heat,0,1,1610612741,Chicago Bulls,1,0,25,24,49,17,18,35,42,42,84,17,3,20,12,31,31,2,10,90,118
2020,2,22000397,2/12/2021,1610612759,San Antonio Spurs,0,1,1610612737,Atlanta Hawks,1,0,33,21,54,12,19,31,45,40,85,23,5,28,9,33,27,10,14,103,125
2017,2,21700355,12/6/2017,1610612737,Atlanta Hawks,0,0,1610612753,Orlando Magic,1,1,29,37,66,11,16,27,40,53,93,15,5,20,15,40,25,9,19,105,106
2017,2,21700355,12/6/2017,1610612753,Orlando Magic,1,1,1610612737,Atlanta Hawks,0,0,40,30,70,6,22,28,46,52,98,12,6,18,18,38,17,7,17,106,110
2020,2,22000711,3/29/2021,1610612761,Toronto Raptors,0,0,1610612765,Detroit Pistons,1,1,24,26,50,11,25,36,35,51,86,23,5,28,15,38,21,6,13,97,104
2020,2,22000711,3/29/2021,1610612765,Detroit Pistons,1,1,1610612761,Toronto Raptors,0,0,23,22,45,15,15,30,38,37,75,27,7,34,13,29,26,5,19,97,118
2022,2,22200212,11/16/2022,1610612750,Minnesota Timberwolves,0,1,1610612753,Orlando Magic,1,0,34,18,52,12,24,36,46,42,88,22,6,28,10,35,28,6,11,100,126
2022,2,22200212,11/16/2022,1610612753,Orlando Magic,1,0,1610612750,Minnesota Timberwolves,0,1,33,25,58,9,26,35,42,51,93,15,2,17,16,35,21,15,16,101,108
2023,2,22300078,10/27/2023,1610612763,Memphis Grizzlies,1,0,1610612743,Denver Nuggets,0,1,27,25,52,10,23,33,37,48,85,20,4,24,15,35,22,11,21,102,104
2021,2,22100619,1/12/2022,1610612755,Philadelphia 76ers,1,0,1610612766,Charlotte Hornets,0,1,22,21,43,12,18,30,34,39,73,18,10,28,7,35,18,9,17,96,98
2017,2,21700354,12/6/2017,1610612741,Chicago Bulls,0,0,1610612754,Indiana Pacers,1,1,29,28,57,10,16,26,39,44,83,8,8,16,13,35,18,7,16,95,96
2017,2,21700354,12/6/2017,1610612754,Indiana Pacers,1,1,1610612741,Chicago Bulls,0,0,27,26,53,12,22,34,39,48,87,8,2,10,12,37,21,3,13,95,98
2021,2,22100619,1/12/2022,1610612766,Charlotte Hornets,0,1,1610612755,Philadelphia 76ers,1,0,36,19,55,10,24,34,46,43,89,7,1,8,9,35,29,3,12,95,109
2020,2,22000396,2/12/2021,1610612752,New York Knicks,0,1,1610612764,Washington Wizards,1,0,38,36,74,6,18,24,44,54,98,15,7,22,20,37,22,5,12,102,109
2022,2,22200901,2/24/2023,1610612745,Houston Rockets,0,0,1610612744,Golden State Warriors,1,1,25,32,57,11,24,35,36,56,92,18,4,22,15,44,23,3,7,95,101
2020,2,22000396,2/12/2021,1610612764,Washington Wizards,1,0,1610612752,New York Knicks,0,1,25,30,55,9,25,34,34,55,89,14,6,20,9,51,20,11,14,101,91
2017,2,21700353,12/6/2017,1610612739,Cleveland Cavaliers,1,1,1610612758,Sacramento Kings,0,0,23,16,39,14,25,39,37,41,78,13,8,21,9,36,28,15,15,94,101
2022,2,22200860,2/13/2023,1610612745,Houston Rockets,0,0,1610612755,Philadelphia 76ers,1,1,29,33,62,6,18,24,35,51,86,28,3,31,19,34,17,11,17,98,104
2022,2,22200863,2/13/2023,1610612741,Chicago Bulls,1,0,1610612753,Orlando Magic,0,1,32,33,65,3,18,21,35,51,86,18,1,19,13,38,17,8,16,98,91
2022,2,22200920,2/27/2023,1610612755,Philadelphia 76ers,1,0,1610612748,Miami Heat,0,1,22,24,46,10,17,27,32,41,73,25,3,28,18,26,20,10,20,91,99
2022,2,22201029,3/14/2023,1610612761,Toronto Raptors,1,1,1610612743,Denver Nuggets,0,0,37,26,63,12,18,30,49,44,93,15,2,17,17,29,25,9,11,94,125
2022,2,22201031,3/14/2023,1610612760,Oklahoma City Thunder,1,1,1610612751,Brooklyn Nets,0,0,34,32,66,11,22,33,45,54,99,20,3,23,18,38,22,3,11,103,121
2022,2,22200899,2/24/2023,1610612760,Oklahoma City Thunder,0,0,1610612756,Phoenix Suns,1,1,26,31,57,15,23,38,41,54,95,18,6,24,17,40,27,5,9,100,115
2022,2,22200953,3/3/2023,1610612740,New Orleans Pelicans,0,0,1610612744,Golden State Warriors,1,1,24,24,48,10,19,29,34,43,77,21,6,27,9,36,20,7,13,95,99
2023,2,22301074,3/30/2024,1610612738,Boston Celtics,0,1,1610612740,New Orleans Pelicans,1,0,24,21,45,15,22,37,39,43,82,11,1,12,11,32,27,9,13,91,104
2021,2,22100618,1/12/2022,1610612738,Boston Celtics,0,1,1610612754,Indiana Pacers,1,0,22,18,40,18,20,38,40,38,78,21,4,25,13,27,23,6,13,90,119
2021,2,22100618,1/12/2022,1610612754,Indiana Pacers,1,0,1610612738,Boston Celtics,0,1,33,17,50,7,29,36,40,46,86,13,7,20,18,30,27,6,12,90,100
2017,2,21700353,12/6/2017,1610612758,Sacramento Kings,0,0,1610612739,Cleveland Cavaliers,1,1,29,25,54,10,22,32,39,47,86,7,6,13,13,38,25,5,14,95,95
2023,2,22300401,12/25/2023,1610612749,Milwaukee Bucks,0,0,1610612752,New York Knicks,1,1,32,21,53,13,29,42,45,50,95,19,5,24,19,34,26,7,11,99,122
2016,2,21600337,12/9/2016,1610612753,Orlando Magic,0,0,1610612766,Charlotte Hornets,1,1,25,32,57,9,25,34,34,57,91,11,3,14,11,49,22,4,8,94,88
2016,2,21600337,12/9/2016,1610612766,Charlotte Hornets,1,1,1610612753,Orlando Magic,0,0,32,31,63,9,13,22,41,44,85,18,5,23,15,31,23,6,13,95,109
2020,2,22000710,3/29/2021,1610612748,Miami Heat,0,1,1610612752,New York Knicks,1,0,27,25,52,10,24,34,37,49,86,14,3,17,14,37,22,4,12,92,98
2020,2,22000710,3/29/2021,1610612752,New York Knicks,1,0,1610612748,Miami Heat,0,1,23,21,44,10,26,36,33,47,80,12,8,20,12,39,15,7,14,94,88
2017,2,21700352,12/5/2017,1610612757,Portland Trail Blazers,1,0,1610612764,Washington Wizards,0,1,20,31,51,12,15,27,32,46,78,16,5,21,13,36,18,16,19,93,92
2017,2,21700352,12/5/2017,1610612764,Washington Wizards,0,1,1610612757,Portland Trail Blazers,1,0,31,33,64,11,14,25,42,47,89,11,3,14,13,35,20,2,9,93,106
2017,2,21700351,12/5/2017,1610612760,Oklahoma City Thunder,1,1,1610612762,Utah Jazz,0,0,35,28,63,4,14,18,39,42,81,18,8,26,17,27,18,16,19,97,100
2017,2,21700351,12/5/2017,1610612762,Utah Jazz,0,0,1610612760,Oklahoma City Thunder,1,1,23,23,46,11,22,33,34,45,79,15,6,21,11,35,18,11,18,96,94
2016,2,21600851,2/23/2017,1610612765,Detroit Pistons,1,1,1610612766,Charlotte Hornets,0,0,29,41,70,15,22,37,44,63,107,11,1,12,16,47,29,5,9,107,114
2016,2,21600851,2/23/2017,1610612766,Charlotte Hornets,0,0,1610612765,Detroit Pistons,1,1,31,31,62,7,23,30,38,54,92,25,1,26,7,48,19,5,8,106,108
2017,2,21700350,12/5/2017,1610612756,Phoenix Suns,0,0,1610612761,Toronto Raptors,1,1,28,23,51,9,15,24,37,38,75,30,8,38,4,37,23,13,17,109,113
2017,2,21700350,12/5/2017,1610612761,Toronto Raptors,1,1,1610612756,Phoenix Suns,0,0,29,27,56,15,21,36,44,48,92,23,3,26,13,36,30,7,18,109,126
2022,2,22200899,2/24/2023,1610612756,Phoenix Suns,1,1,1610612760,Oklahoma City Thunder,0,0,28,24,52,14,24,38,42,48,90,26,6,32,15,36,23,5,11,100,124
2021,2,22100617,1/16/2022,1610612756,Phoenix Suns,0,1,1610612765,Detroit Pistons,1,0,40,20,60,11,16,27,51,36,87,22,8,30,13,27,30,6,15,101,135
2021,2,22100617,1/16/2022,1610612765,Detroit Pistons,1,0,1610612756,Phoenix Suns,0,1,29,28,57,9,16,25,38,44,82,23,11,34,9,42,25,4,11,101,108
2022,2,22200954,3/3/2023,1610612758,Sacramento Kings,1,1,1610612746,LA Clippers,0,0,36,18,54,10,23,33,46,41,87,26,0,26,11,30,26,7,11,98,128
2023,2,22300448,12/31/2023,1610612759,San Antonio Spurs,1,0,1610612738,Boston Celtics,0,1,28,21,49,12,33,45,40,54,94,9,3,12,11,45,28,6,16,103,101
2020,2,22000709,3/29/2021,1610612750,Minnesota Timberwolves,0,0,1610612751,Brooklyn Nets,1,1,26,33,59,14,30,44,40,63,103,13,4,17,22,44,23,10,15,104,107
2020,2,22000709,3/29/2021,1610612751,Brooklyn Nets,1,1,1610612750,Minnesota Timberwolves,0,0,30,25,55,10,20,30,40,45,85,22,3,25,10,36,31,10,16,103,112
2017,2,21700349,12/4/2017,1610612762,Utah Jazz,1,1,1610612764,Washington Wizards,0,0,27,15,42,16,18,34,43,33,76,14,4,18,11,22,29,8,16,89,116
2017,2,21700349,12/4/2017,1610612764,Washington Wizards,0,0,1610612762,Utah Jazz,1,1,19,41,60,4,16,20,23,57,80,19,4,23,14,46,9,9,13,90,69
2022,2,22200981,3/7/2023,1610612745,Houston Rockets,1,0,1610612751,Brooklyn Nets,0,1,29,28,57,7,19,26,36,47,83,17,7,24,16,33,14,12,19,98,96
2022,2,22201057,3/18/2023,1610612754,Indiana Pacers,1,0,1610612755,Philadelphia 76ers,0,1,33,23,56,12,19,31,45,42,87,19,1,20,16,27,28,11,17,98,121
2022,2,22200825,2/8/2023,1610612748,Miami Heat,1,1,1610612754,Indiana Pacers,0,0,31,29,60,6,13,19,37,42,79,36,3,39,15,28,21,3,13,94,116
2022,2,22200823,2/8/2023,1610612766,Charlotte Hornets,0,0,1610612764,Washington Wizards,1,1,30,32,62,9,22,31,39,54,93,17,4,21,14,42,23,4,7,95,104
2022,2,22201184,4/4/2023,1610612763,Memphis Grizzlies,1,1,1610612757,Portland Trail Blazers,0,0,24,15,39,18,30,48,42,45,87,17,5,22,9,38,30,7,12,101,119
2022,2,22200978,3/7/2023,1610612753,Orlando Magic,1,0,1610612749,Milwaukee Bucks,0,1,41,29,70,9,21,30,50,50,100,14,5,19,16,36,24,5,13,106,123
2022,2,22200862,2/13/2023,1610612752,New York Knicks,1,1,1610612751,Brooklyn Nets,0,0,30,18,48,15,19,34,45,37,82,19,7,26,10,30,18,3,8,90,124
2022,2,22200213,11/16/2022,1610612760,Oklahoma City Thunder,0,1,1610612764,Washington Wizards,1,0,28,22,50,16,15,31,44,37,81,17,9,26,9,31,24,8,15,99,121
2022,2,22200213,11/16/2022,1610612764,Washington Wizards,1,0,1610612760,Oklahoma City Thunder,0,1,27,25,52,17,17,34,44,42,86,15,2,17,13,29,32,4,19,99,120
2023,2,22300104,10/30/2023,1610612737,Atlanta Hawks,1,1,1610612750,Minnesota Timberwolves,0,0,34,22,56,14,16,30,48,38,86,17,1,18,7,31,28,5,11,97,127
2023,2,22300095,10/29/2023,1610612760,Oklahoma City Thunder,1,0,1610612743,Denver Nuggets,0,1,31,27,58,6,26,32,37,53,90,15,3,18,14,39,22,8,10,94,95
2021,2,22100616,1/11/2022,1610612743,Denver Nuggets,0,0,1610612746,LA Clippers,1,1,28,19,47,4,29,33,32,48,80,17,3,20,17,31,24,12,20,94,85
2021,2,22100616,1/11/2022,1610612746,LA Clippers,1,1,1610612743,Denver Nuggets,0,0,24,26,50,10,24,34,34,50,84,9,3,12,5,46,23,4,9,93,87
2020,2,22000395,2/12/2021,1610612750,Minnesota Timberwolves,0,0,1610612766,Charlotte Hornets,1,1,29,29,58,16,25,41,45,54,99,8,6,14,12,45,28,4,8,102,114
2020,2,22000395,2/12/2021,1610612766,Charlotte Hornets,1,1,1610612750,Minnesota Timberwolves,0,0,31,23,54,13,23,36,44,46,90,19,0,19,14,32,20,10,20,102,120
2023,2,22300160,11/8/2023,1610612751,Brooklyn Nets,1,1,1610612746,LA Clippers,0,0,22,29,51,15,26,41,37,55,92,11,2,13,15,42,22,10,14,96,100
2023,2,22300237,11/22/2023,1610612757,Portland Trail Blazers,1,1,1610612762,Utah Jazz,0,0,30,23,53,17,22,39,47,45,92,10,5,15,16,33,31,7,14,97,121
2016,2,21600850,2/23/2017,1610612753,Orlando Magic,1,0,1610612757,Portland Trail Blazers,0,1,27,37,64,7,15,22,34,52,86,28,11,39,19,36,18,8,14,100,103
2016,2,21600850,2/23/2017,1610612757,Portland Trail Blazers,0,1,1610612753,Orlando Magic,1,0,32,31,63,9,9,18,41,40,81,21,6,27,15,29,20,8,20,100,112
2021,2,22100615,1/11/2022,1610612740,New Orleans Pelicans,1,1,1610612750,Minnesota Timberwolves,0,0,26,17,43,16,17,33,42,34,76,28,9,37,13,24,33,11,21,101,128
2021,2,22100615,1/11/2022,1610612750,Minnesota Timberwolves,0,0,1610612740,New Orleans Pelicans,1,1,24,23,47,18,21,39,42,44,86,23,8,31,14,34,27,6,13,101,125
2020,2,22000708,3/29/2021,1610612738,Boston Celtics,1,0,1610612740,New Orleans Pelicans,0,1,26,24,50,14,29,43,40,53,93,15,4,19,16,41,21,8,14,100,109
2021,2,22100614,1/11/2022,1610612744,Golden State Warriors,0,0,1610612763,Memphis Grizzlies,1,1,22,24,46,13,23,36,35,47,82,25,4,29,8,41,25,11,17,103,108
2021,2,22100614,1/11/2022,1610612763,Memphis Grizzlies,1,1,1610612744,Golden State Warriors,0,0,30,36,66,14,20,34,44,56,100,14,4,18,15,42,30,8,11,103,116
2017,2,21700348,12/4/2017,1610612759,San Antonio Spurs,1,1,1610612765,Detroit Pistons,0,0,21,30,51,14,17,31,35,47,82,12,0,12,11,36,30,8,17,93,96
2022,2,22200901,2/24/2023,1610612744,Golden State Warriors,1,1,1610612745,Houston Rockets,0,0,11,13,24,26,28,54,37,41,78,16,2,18,9,33,27,12,19,95,116
2022,2,22200859,2/13/2023,1610612754,Indiana Pacers,1,0,1610612762,Utah Jazz,0,1,35,22,57,11,23,34,46,45,91,14,6,20,9,40,30,5,11,100,117
2022,2,22200865,2/13/2023,1610612742,Dallas Mavericks,1,0,1610612750,Minnesota Timberwolves,0,1,30,15,45,13,26,39,43,41,84,22,7,29,14,32,21,8,11,95,121
2023,2,22300589,4/2/2024,1610612744,Golden State Warriors,1,1,1610612742,Dallas Mavericks,0,0,26,32,58,15,17,32,41,49,90,7,0,7,11,38,29,8,17,99,104
2017,2,21700348,12/4/2017,1610612765,Detroit Pistons,0,0,1610612759,San Antonio Spurs,1,1,27,31,58,8,19,27,35,50,85,15,9,24,12,43,15,2,10,94,93
2020,2,22000708,3/29/2021,1610612740,New Orleans Pelicans,0,1,1610612738,Boston Celtics,1,0,25,26,51,16,15,31,41,41,82,17,13,30,11,37,30,5,15,99,115
2023,2,22300225,11/22/2023,1610612766,Charlotte Hornets,1,1,1610612764,Washington Wizards,0,0,27,27,54,16,21,37,43,48,91,15,6,21,14,39,27,7,13,99,117
2021,2,22100613,1/11/2022,1610612756,Phoenix Suns,0,1,1610612761,Toronto Raptors,1,0,24,18,42,11,21,32,35,39,74,18,4,22,13,27,25,11,20,91,99
2021,2,22100613,1/11/2022,1610612761,Toronto Raptors,1,0,1610612756,Phoenix Suns,0,1,28,24,52,8,29,37,36,53,89,15,10,25,27,31,15,10,16,90,95
2020,2,22000394,2/11/2021,1610612755,Philadelphia 76ers,0,0,1610612757,Portland Trail Blazers,1,1,36,23,59,6,21,27,42,44,86,24,5,29,15,32,20,5,9,94,114
2020,2,22000394,2/11/2021,1610612757,Portland Trail Blazers,1,1,1610612755,Philadelphia 76ers,0,0,23,32,55,17,21,38,40,53,93,21,2,23,18,37,15,6,8,93,118
2022,2,22200581,1/6/2023,1610612741,Chicago Bulls,0,1,1610612755,Philadelphia 76ers,1,0,28,22,50,20,14,34,48,36,84,10,7,17,9,30,33,6,12,94,126
2022,2,22200581,1/6/2023,1610612755,Philadelphia 76ers,1,0,1610612741,Chicago Bulls,0,1,22,29,51,18,23,41,40,52,92,14,4,18,14,39,28,3,7,95,112
2022,2,22200861,2/13/2023,1610612743,Denver Nuggets,0,1,1610612748,Miami Heat,1,0,33,15,48,11,17,28,44,32,76,13,2,15,8,26,34,9,13,88,112
2022,2,22200934,3/1/2023,1610612765,Detroit Pistons,1,0,1610612741,Chicago Bulls,0,1,25,18,43,14,21,35,39,39,78,23,5,28,9,31,23,9,17,100,115
2022,2,22200950,3/3/2023,1610612741,Chicago Bulls,1,0,1610612756,Phoenix Suns,0,1,32,28,60,7,16,23,39,44,83,19,6,25,13,32,24,6,9,90,104
2023,2,22300014,11/10/2023,1610612746,LA Clippers,0,0,1610612742,Dallas Mavericks,1,1,35,26,61,8,19,27,43,45,88,32,4,36,20,27,21,7,14,97,126
2021,2,22100612,1/11/2022,1610612760,Oklahoma City Thunder,0,0,1610612764,Washington Wizards,1,1,36,23,59,11,28,39,47,51,98,13,2,15,13,39,23,3,5,99,118
2021,2,22100612,1/11/2022,1610612764,Washington Wizards,1,1,1610612760,Oklahoma City Thunder,0,0,36,18,54,11,22,33,47,40,87,17,6,23,8,35,29,5,8,97,122
2022,2,22200827,2/8/2023,1610612745,Houston Rockets,1,0,1610612758,Sacramento Kings,0,1,37,27,64,10,12,22,47,39,86,24,4,28,17,22,25,10,19,101,128
2022,2,22200919,2/27/2023,1610612765,Detroit Pistons,0,0,1610612766,Charlotte Hornets,1,1,39,27,66,3,23,26,42,50,92,19,8,27,15,39,18,8,9,99,106
2022,2,22200949,3/3/2023,1610612752,New York Knicks,0,1,1610612748,Miami Heat,1,0,30,10,40,17,24,41,47,34,81,11,6,17,7,30,23,7,12,93,122
2022,2,22200953,3/3/2023,1610612744,Golden State Warriors,1,1,1610612740,New Orleans Pelicans,0,0,30,17,47,10,21,31,40,38,78,18,2,20,12,26,28,9,18,95,108
2022,2,22200822,2/8/2023,1610612739,Cleveland Cavaliers,1,1,1610612765,Detroit Pistons,0,0,37,24,61,6,20,26,43,44,87,21,4,25,21,26,30,8,13,92,113
2022,2,22200980,3/7/2023,1610612750,Minnesota Timberwolves,1,0,1610612755,Philadelphia 76ers,0,1,23,27,50,11,25,36,34,52,86,15,6,21,9,47,19,8,11,96,94
2019,2,21900198,11/19/2019,1610612744,Golden State Warriors,0,1,1610612763,Memphis Grizzlies,1,0,34,27,61,9,20,29,43,47,90,19,3,22,18,31,33,6,15,99,114
2019,2,21900198,11/19/2019,1610612763,Memphis Grizzlies,1,0,1610612744,Golden State Warriors,0,1,27,36,63,9,16,25,36,52,88,14,5,19,11,43,26,5,14,98,95
2020,2,22000707,3/29/2021,1610612754,Indiana Pacers,0,0,1610612764,Washington Wizards,1,1,32,31,63,12,18,30,44,49,93,24,9,33,9,46,32,5,14,112,124
2020,2,22000707,3/29/2021,1610612764,Washington Wizards,1,1,1610612754,Indiana Pacers,0,0,45,35,80,10,9,19,55,44,99,12,6,18,16,33,30,11,19,112,132
2022,2,22201028,3/14/2023,1610612765,Detroit Pistons,0,0,1610612764,Washington Wizards,1,1,28,37,65,10,24,34,38,61,99,11,1,12,22,40,18,9,11,95,97
2021,2,22100611,1/10/2022,1610612739,Cleveland Cavaliers,0,1,1610612758,Sacramento Kings,1,0,33,20,53,10,24,34,43,44,87,13,2,15,15,29,29,10,17,96,109
2021,2,22100611,1/10/2022,1610612758,Sacramento Kings,1,0,1610612739,Cleveland Cavaliers,0,1,25,36,61,14,16,30,39,52,91,16,6,22,20,35,20,6,12,95,108
2020,2,22000393,2/11/2021,1610612744,Golden State Warriors,1,1,1610612753,Orlando Magic,0,0,21,17,38,20,30,50,41,47,88,9,3,12,12,37,29,7,17,99,111
2020,2,22000393,2/11/2021,1610612753,Orlando Magic,0,0,1610612744,Golden State Warriors,1,1,23,41,64,15,18,33,38,59,97,14,4,18,19,42,19,6,15,100,105
2022,2,22200823,2/8/2023,1610612764,Washington Wizards,1,1,1610612766,Charlotte Hornets,0,0,29,21,50,15,22,37,44,43,87,15,2,17,15,29,29,11,17,95,118
2022,2,22200982,3/7/2023,1610612744,Golden State Warriors,0,0,1610612760,Oklahoma City Thunder,1,1,27,11,38,20,31,51,47,42,89,14,2,16,11,33,36,10,21,107,128
2022,2,22200955,3/3/2023,1610612750,Minnesota Timberwolves,0,1,1610612747,Los Angeles Lakers,1,0,28,27,55,14,20,34,42,47,89,12,4,16,14,35,29,8,14,99,110
2020,2,22000392,2/11/2021,1610612745,Houston Rockets,1,0,1610612748,Miami Heat,0,1,17,16,33,15,35,50,32,51,83,15,5,20,10,44,24,6,15,98,94
2020,2,22000392,2/11/2021,1610612748,Miami Heat,0,1,1610612745,Houston Rockets,1,0,19,18,37,15,27,42,34,45,79,18,2,20,12,34,24,7,21,99,101
2017,2,21700347,12/4/2017,1610612742,Dallas Mavericks,1,1,1610612743,Denver Nuggets,0,0,37,23,60,12,14,26,49,37,86,12,5,17,6,35,26,5,7,94,122
2017,2,21700347,12/4/2017,1610612743,Denver Nuggets,0,0,1610612742,Dallas Mavericks,1,1,24,31,55,14,22,36,38,53,91,15,8,23,17,40,25,4,7,94,105
2022,2,22200903,2/25/2023,1610612761,Toronto Raptors,0,1,1610612765,Detroit Pistons,1,0,26,36,62,7,19,26,33,55,88,22,12,34,15,48,22,4,8,96,95
2022,2,22201057,3/18/2023,1610612755,Philadelphia 76ers,0,1,1610612754,Indiana Pacers,1,0,39,14,53,15,20,35,54,34,88,18,4,22,7,30,31,5,8,99,141
2022,2,22200983,3/7/2023,1610612762,Utah Jazz,0,0,1610612742,Dallas Mavericks,1,1,26,22,48,15,29,44,41,51,92,19,6,25,11,44,23,10,16,110,116
2022,2,22200952,3/3/2023,1610612763,Memphis Grizzlies,0,0,1610612743,Denver Nuggets,1,1,20,32,52,11,21,32,31,53,84,24,7,31,13,44,24,6,11,95,97
2020,2,22000706,3/28/2021,1610612747,Los Angeles Lakers,1,1,1610612753,Orlando Magic,0,0,23,19,42,11,29,40,34,48,82,17,6,23,10,42,25,5,12,96,96
2020,2,22000706,3/28/2021,1610612753,Orlando Magic,0,0,1610612747,Los Angeles Lakers,1,1,23,32,55,11,22,33,34,54,88,14,3,17,12,45,19,9,11,95,93
2021,2,22100610,1/10/2022,1610612752,New York Knicks,1,1,1610612759,San Antonio Spurs,0,0,27,23,50,13,19,32,40,42,82,18,6,24,14,31,23,7,15,95,111
2021,2,22100610,1/10/2022,1610612759,San Antonio Spurs,0,0,1610612752,New York Knicks,1,1,31,35,66,8,21,29,39,56,95,10,5,15,16,42,19,7,10,95,96
2020,2,22000391,2/11/2021,1610612754,Indiana Pacers,0,1,1610612765,Detroit Pistons,1,0,30,25,55,14,17,31,44,42,86,9,1,10,11,31,26,5,9,88,111
2020,2,22000391,2/11/2021,1610612765,Detroit Pistons,1,0,1610612754,Indiana Pacers,0,1,33,24,57,5,23,28,38,47,85,14,5,19,17,34,21,10,12,89,95
2017,2,21700346,12/4/2017,1610612740,New Orleans Pelicans,1,0,1610612744,Golden State Warriors,0,1,29,23,52,16,23,39,45,46,91,9,6,15,12,35,33,14,21,106,115
2017,2,21700346,12/4/2017,1610612744,Golden State Warriors,0,1,1610612740,New Orleans Pelicans,1,0,29,25,54,16,17,33,45,42,87,19,8,27,8,39,36,11,17,107,125
2014,2,21400107,11/11/2014,1610612757,Portland Trail Blazers,1,1,1610612766,Charlotte Hornets,0,0,32,36,68,8,17,25,40,53,93,14,2,16,19,35,25,5,12,95,102
2020,2,22000390,2/10/2021,1610612747,Los Angeles Lakers,1,1,1610612760,Oklahoma City Thunder,0,0,32,22,54,10,25,35,42,47,89,20,4,24,10,40,22,11,17,106,114
2020,2,22000390,2/10/2021,1610612760,Oklahoma City Thunder,0,0,1610612747,Los Angeles Lakers,1,1,40,29,69,7,24,31,47,53,100,12,2,14,11,43,32,6,13,107,113
2022,2,22200903,2/25/2023,1610612765,Detroit Pistons,1,0,1610612761,Toronto Raptors,0,1,32,38,70,6,18,24,38,56,94,9,5,14,20,39,26,9,16,96,91
2023,2,22300160,11/8/2023,1610612746,LA Clippers,0,0,1610612751,Brooklyn Nets,1,1,28,27,55,8,28,36,36,55,91,13,0,13,17,38,22,10,16,97,93
2017,2,21700345,12/4/2017,1610612750,Minnesota Timberwolves,0,0,1610612763,Memphis Grizzlies,1,1,31,31,62,4,13,17,35,44,79,18,1,19,8,36,17,6,9,90,92
2017,2,21700345,12/4/2017,1610612763,Memphis Grizzlies,1,1,1610612750,Minnesota Timberwolves,0,0,28,23,51,6,15,21,34,38,72,21,3,24,11,28,22,9,16,91,95
2021,2,22100609,1/10/2022,1610612738,Boston Celtics,1,1,1610612754,Indiana Pacers,0,0,27,33,60,8,20,28,35,53,88,23,5,28,14,41,17,10,20,105,101
2021,2,22100609,1/10/2022,1610612754,Indiana Pacers,0,0,1610612738,Boston Celtics,1,1,25,32,57,11,26,37,36,58,94,15,2,17,17,42,22,10,20,105,98
2020,2,22000389,2/10/2021,1610612749,Milwaukee Bucks,0,0,1610612756,Phoenix Suns,1,1,27,21,48,16,21,37,43,42,85,22,8,30,12,35,23,7,10,98,124
2020,2,22000389,2/10/2021,1610612756,Phoenix Suns,1,1,1610612749,Milwaukee Bucks,0,0,31,25,56,15,16,31,46,41,87,18,7,25,14,30,25,6,11,96,125
2022,2,22200920,2/27/2023,1610612748,Miami Heat,0,1,1610612755,Philadelphia 76ers,1,0,20,24,44,15,22,37,35,46,81,16,6,22,15,33,21,7,13,90,101
2022,2,22200826,2/8/2023,1610612759,San Antonio Spurs,0,0,1610612761,Toronto Raptors,1,1,26,29,55,9,23,32,35,52,87,19,8,27,12,43,24,11,16,104,98
2022,2,22200949,3/3/2023,1610612748,Miami Heat,1,0,1610612752,New York Knicks,0,1,27,29,56,12,13,25,39,42,81,30,2,32,15,28,23,8,12,93,120
2022,2,22200955,3/3/2023,1610612747,Los Angeles Lakers,1,0,1610612750,Minnesota Timberwolves,0,1,26,30,56,10,21,31,36,51,87,20,4,24,14,39,23,10,15,99,102
2022,2,22201095,3/23/2023,1610612740,New Orleans Pelicans,1,1,1610612766,Charlotte Hornets,0,0,34,30,64,11,23,34,45,53,98,14,1,15,15,38,26,8,11,101,115
2016,2,21600849,2/16/2017,1610612738,Boston Celtics,0,0,1610612741,Chicago Bulls,1,1,22,18,40,14,23,37,36,41,77,17,3,20,6,37,24,2,7,89,103
2016,2,21600849,2/16/2017,1610612741,Chicago Bulls,1,1,1610612738,Boston Celtics,0,0,32,33,65,6,19,25,38,52,90,22,0,22,21,31,23,2,8,89,104
2020,2,22000705,3/28/2021,1610612737,Atlanta Hawks,0,0,1610612743,Denver Nuggets,1,1,24,18,42,12,22,34,36,40,76,18,3,21,5,37,18,7,12,93,102
2020,2,22000705,3/28/2021,1610612743,Denver Nuggets,1,1,1610612737,Atlanta Hawks,0,0,35,21,56,15,21,36,50,42,92,11,5,16,16,29,32,7,10,93,126
2020,2,22000388,2/10/2021,1610612739,Cleveland Cavaliers,0,0,1610612743,Denver Nuggets,1,1,28,29,57,8,29,37,36,58,94,15,5,20,22,39,25,12,17,99,95
2020,2,22000388,2/10/2021,1610612743,Denver Nuggets,1,1,1610612739,Cleveland Cavaliers,0,0,35,14,49,16,20,36,51,34,85,15,6,21,8,31,31,7,12,99,133
2017,2,21700344,12/4/2017,1610612739,Cleveland Cavaliers,0,1,1610612741,Chicago Bulls,1,0,29,16,45,13,23,36,42,39,81,16,1,17,7,33,22,4,8,89,113
2019,2,21900197,11/18/2019,1610612746,LA Clippers,1,1,1610612760,Oklahoma City Thunder,0,0,25,26,51,10,26,36,35,52,87,10,4,14,17,39,23,12,17,95,90
2019,2,21900197,11/18/2019,1610612760,Oklahoma City Thunder,0,0,1610612746,LA Clippers,1,1,21,27,48,7,20,27,28,47,75,25,3,28,11,37,17,7,17,94,88
2021,2,22100608,1/10/2022,1610612762,Utah Jazz,0,0,1610612765,Detroit Pistons,1,1,33,20,53,11,22,33,44,42,86,17,5,22,12,32,23,9,16,99,116
2021,2,22100608,1/10/2022,1610612765,Detroit Pistons,1,1,1610612762,Utah Jazz,0,0,29,27,56,19,18,37,48,45,93,11,1,12,11,34,30,9,12,100,126
2022,2,22200822,2/8/2023,1610612765,Detroit Pistons,0,0,1610612739,Cleveland Cavaliers,1,1,22,27,49,8,24,32,30,51,81,17,1,18,13,39,19,8,14,92,85
2022,2,22200919,2/27/2023,1610612766,Charlotte Hornets,1,1,1610612765,Detroit Pistons,0,0,30,27,57,13,13,26,43,40,83,18,4,22,12,31,24,12,17,99,117
2017,2,21700344,12/4/2017,1610612741,Chicago Bulls,1,0,1610612739,Cleveland Cavaliers,0,1,25,23,48,9,25,34,34,48,82,14,4,18,11,41,21,6,11,90,91
2022,2,22200935,3/1/2023,1610612739,Cleveland Cavaliers,0,0,1610612738,Boston Celtics,1,1,35,25,60,10,22,32,45,47,92,13,8,21,16,36,21,5,7,92,113
2016,2,21600848,2/16/2017,1610612754,Indiana Pacers,1,0,1610612764,Washington Wizards,0,1,36,26,62,4,14,18,40,40,80,14,4,18,9,34,21,5,12,90,98
2016,2,21600848,2/16/2017,1610612764,Washington Wizards,0,1,1610612754,Indiana Pacers,1,0,28,26,54,15,14,29,43,40,83,10,5,15,10,33,23,7,11,90,111
2022,2,22200864,2/13/2023,1610612760,Oklahoma City Thunder,1,0,1610612740,New Orleans Pelicans,0,1,29,28,57,9,24,33,38,52,90,15,3,18,22,30,20,13,17,96,100
2022,2,22200934,3/1/2023,1610612741,Chicago Bulls,0,1,1610612765,Detroit Pistons,1,0,29,29,58,12,15,27,41,44,85,23,8,31,14,34,27,8,15,100,117
2022,2,22201045,3/16/2023,1610612749,Milwaukee Bucks,1,0,1610612754,Indiana Pacers,0,1,36,21,57,11,21,32,47,42,89,18,8,26,11,35,26,5,12,105,123
2022,2,22200982,3/7/2023,1610612760,Oklahoma City Thunder,1,1,1610612744,Golden State Warriors,0,0,33,24,57,17,20,37,50,44,94,20,4,24,17,27,28,8,18,108,137
2022,2,22201095,3/23/2023,1610612766,Charlotte Hornets,0,0,1610612740,New Orleans Pelicans,1,1,29,17,46,9,28,37,38,45,83,11,5,16,5,42,24,11,17,101,96
2022,2,22200888,2/23/2023,1610612765,Detroit Pistons,0,0,1610612753,Orlando Magic,1,1,20,27,47,17,17,34,37,44,81,15,4,19,11,36,22,7,21,100,106
2022,2,22200769,3/7/2023,1610612764,Washington Wizards,0,1,1610612765,Detroit Pistons,1,0,35,21,56,12,13,25,47,34,81,13,4,17,13,22,27,6,15,91,119
2022,2,22201028,3/14/2023,1610612764,Washington Wizards,1,1,1610612765,Detroit Pistons,0,0,37,16,53,7,25,32,44,41,85,22,0,22,15,26,24,8,15,94,117
2022,2,22200983,3/7/2023,1610612742,Dallas Mavericks,1,1,1610612762,Utah Jazz,0,0,23,21,44,19,26,45,42,47,89,17,5,22,7,44,24,10,17,110,120
2022,2,22201077,3/21/2023,1610612764,Washington Wizards,0,0,1610612753,Orlando Magic,1,1,32,19,51,10,22,32,42,41,83,18,5,23,8,37,30,7,14,101,112
2022,2,22201027,3/14/2023,1610612766,Charlotte Hornets,1,0,1610612739,Cleveland Cavaliers,0,1,37,16,53,6,17,23,43,33,76,12,3,15,10,23,28,8,22,95,104
2022,2,22201005,3/11/2023,1610612762,Utah Jazz,0,1,1610612766,Charlotte Hornets,1,0,37,34,71,9,23,32,46,57,103,18,2,20,26,33,22,5,11,98,119
2022,2,22201058,3/18/2023,1610612761,Toronto Raptors,1,1,1610612750,Minnesota Timberwolves,0,0,39,24,63,9,18,27,48,42,90,17,4,21,10,35,23,5,15,103,122
2022,2,22201139,3/29/2023,1610612755,Philadelphia 76ers,1,1,1610612742,Dallas Mavericks,0,0,20,24,44,17,19,36,37,43,80,25,5,30,14,32,26,3,11,90,116
2022,2,22201205,4/7/2023,1610612755,Philadelphia 76ers,0,1,1610612737,Atlanta Hawks,1,0,40,40,80,11,11,22,51,51,102,23,6,29,17,37,33,11,20,119,136
2022,2,22200889,2/23/2023,1610612763,Memphis Grizzlies,0,0,1610612755,Philadelphia 76ers,1,1,27,28,55,7,25,32,34,53,87,30,6,36,17,39,22,3,11,98,105
2022,2,22200214,11/16/2022,1610612737,Atlanta Hawks,1,0,1610612738,Boston Celtics,0,1,35,34,69,7,25,32,42,59,101,10,3,13,16,45,21,4,9,99,101
2022,2,22200980,3/7/2023,1610612755,Philadelphia 76ers,0,1,1610612750,Minnesota Timberwolves,1,0,25,31,56,15,10,25,40,41,81,22,1,23,12,29,21,9,16,95,117
2022,2,22200981,3/7/2023,1610612751,Brooklyn Nets,0,1,1610612745,Houston Rockets,1,0,25,16,41,15,25,40,40,41,81,23,6,29,7,36,23,6,12,98,118
2022,2,22201077,3/21/2023,1610612753,Orlando Magic,1,1,1610612764,Washington Wizards,0,0,31,22,53,12,15,27,43,37,80,24,1,25,8,29,27,7,16,101,122
2022,2,22200828,2/8/2023,1610612762,Utah Jazz,1,0,1610612750,Minnesota Timberwolves,0,1,32,39,71,12,22,34,44,61,105,18,3,21,22,40,27,6,8,100,118
2022,2,22200933,3/1/2023,1610612756,Phoenix Suns,0,1,1610612766,Charlotte Hornets,1,0,33,31,64,9,16,25,42,47,89,12,3,15,8,40,30,3,13,101,105
2022,2,22200828,2/8/2023,1610612750,Minnesota Timberwolves,0,1,1610612762,Utah Jazz,1,0,33,22,55,23,20,43,56,42,98,8,0,8,12,30,35,2,11,101,143
2022,2,22200827,2/8/2023,1610612758,Sacramento Kings,0,1,1610612745,Houston Rockets,1,0,36,26,62,10,20,30,46,46,92,28,2,30,13,35,29,4,9,101,130
2022,2,22200886,2/23/2023,1610612739,Cleveland Cavaliers,1,0,1610612743,Denver Nuggets,0,1,37,27,64,6,20,26,43,47,90,17,3,20,16,32,24,7,11,92,109
2022,2,22200214,11/16/2022,1610612738,Boston Celtics,0,1,1610612737,Atlanta Hawks,1,0,27,15,42,21,25,46,48,40,88,9,1,10,7,33,29,5,15,101,126
2022,2,22200215,11/16/2022,1610612748,Miami Heat,0,0,1610612761,Toronto Raptors,1,1,23,8,31,13,22,35,36,30,66,19,3,22,6,27,19,5,23,93,104
2022,2,22200979,3/7/2023,1610612766,Charlotte Hornets,0,1,1610612752,New York Knicks,1,0,30,23,53,12,20,32,42,43,85,16,5,21,14,32,27,3,12,93,112
2022,2,22200887,2/23/2023,1610612738,Boston Celtics,0,1,1610612754,Indiana Pacers,1,0,33,27,60,18,21,39,51,48,99,22,4,26,22,29,31,10,15,102,142
2022,2,22200888,2/23/2023,1610612753,Orlando Magic,1,1,1610612765,Detroit Pistons,0,0,27,37,64,12,19,31,39,56,95,18,5,23,18,41,27,5,14,101,108
2022,2,22200215,11/16/2022,1610612761,Toronto Raptors,1,1,1610612748,Miami Heat,0,0,37,23,60,7,19,26,44,42,86,17,5,22,19,26,23,5,14,92,112
2021,2,22100607,1/10/2022,1610612749,Milwaukee Bucks,0,0,1610612766,Charlotte Hornets,1,1,24,17,41,13,30,43,37,47,84,12,4,16,12,36,25,12,20,100,99
2021,2,22100607,1/10/2022,1610612766,Charlotte Hornets,1,1,1610612749,Milwaukee Bucks,0,0,25,27,52,13,31,44,38,58,96,14,2,16,16,42,23,7,14,101,103
2020,2,22000387,2/10/2021,1610612746,LA Clippers,0,1,1610612750,Minnesota Timberwolves,1,0,29,30,59,12,11,23,41,41,82,25,4,29,14,28,23,8,16,97,119
2020,2,22000387,2/10/2021,1610612750,Minnesota Timberwolves,1,0,1610612746,LA Clippers,0,1,26,28,54,15,26,41,41,54,95,15,4,19,21,37,29,9,15,98,112
2019,2,21900196,11/18/2019,1610612750,Minnesota Timberwolves,0,1,1610612762,Utah Jazz,1,0,27,24,51,14,24,38,41,48,89,16,3,19,6,43,22,5,15,106,112
2019,2,21900196,11/18/2019,1610612762,Utah Jazz,1,0,1610612750,Minnesota Timberwolves,0,1,23,42,65,12,19,31,35,61,96,20,6,26,15,50,20,6,14,106,102
2022,2,22201005,3/11/2023,1610612766,Charlotte Hornets,1,0,1610612762,Utah Jazz,0,1,23,35,58,17,23,40,40,58,98,14,1,15,15,44,24,4,7,98,111
2022,2,22201027,3/14/2023,1610612739,Cleveland Cavaliers,0,1,1610612766,Charlotte Hornets,1,0,31,27,58,14,16,30,45,43,88,16,3,19,9,36,29,3,9,97,120
2022,2,22201184,4/4/2023,1610612757,Portland Trail Blazers,0,0,1610612763,Memphis Grizzlies,1,1,28,27,55,14,28,42,42,55,97,11,6,17,15,43,23,5,10,101,109
2022,2,22200216,11/16/2022,1610612739,Cleveland Cavaliers,0,0,1610612749,Milwaukee Bucks,1,1,24,32,56,12,16,28,36,48,84,14,3,17,8,41,22,5,8,94,98
2022,2,22201122,3/27/2023,1610612765,Detroit Pistons,1,0,1610612749,Milwaukee Bucks,0,1,34,34,68,7,17,24,41,51,92,28,8,36,19,35,22,5,10,100,117
2020,2,22000704,3/28/2021,1610612757,Portland Trail Blazers,0,1,1610612761,Toronto Raptors,1,0,36,27,63,10,24,34,46,51,97,20,4,24,17,35,24,3,8,97,122
2022,2,22200216,11/16/2022,1610612749,Milwaukee Bucks,1,1,1610612739,Cleveland Cavaliers,0,0,25,22,47,16,23,39,41,45,86,15,12,27,20,31,26,7,14,94,113
2020,2,22000704,3/28/2021,1610612761,Toronto Raptors,1,0,1610612757,Portland Trail Blazers,0,1,25,20,45,14,28,42,39,48,87,25,8,33,17,37,17,7,13,98,117
2021,2,22100606,1/9/2022,1610612747,Los Angeles Lakers,1,0,1610612763,Memphis Grizzlies,0,1,31,33,64,14,19,33,45,52,97,15,4,19,16,37,26,10,12,99,119
2021,2,22100606,1/9/2022,1610612763,Memphis Grizzlies,0,1,1610612747,Los Angeles Lakers,1,0,36,20,56,11,19,30,47,39,86,22,10,32,15,29,33,6,14,100,127
2022,2,22200887,2/23/2023,1610612754,Indiana Pacers,1,0,1610612738,Boston Celtics,0,1,27,18,45,22,27,49,49,45,94,18,4,22,14,32,33,7,15,105,138
2022,2,22200978,3/7/2023,1610612749,Milwaukee Bucks,0,1,1610612753,Orlando Magic,1,0,36,14,50,10,18,28,46,32,78,32,2,34,3,30,28,7,17,106,134
2022,2,22200967,3/5/2023,1610612745,Houston Rockets,1,1,1610612759,San Antonio Spurs,0,0,39,22,61,13,11,24,52,33,85,25,4,29,10,24,29,5,12,102,142
2022,2,22201143,3/29/2023,1610612759,San Antonio Spurs,1,0,1610612762,Utah Jazz,0,1,35,25,60,10,25,35,45,50,95,17,4,21,14,38,31,5,15,106,117
2022,2,22201186,4/4/2023,1610612762,Utah Jazz,1,0,1610612747,Los Angeles Lakers,0,1,32,25,57,15,18,33,47,43,90,24,7,31,9,37,29,6,14,111,133
2022,2,22201032,3/14/2023,1610612759,San Antonio Spurs,1,1,1610612753,Orlando Magic,0,0,26,18,44,22,19,41,48,37,85,14,4,18,9,30,39,7,15,99,132
2023,2,22300222,11/20/2023,1610612758,Sacramento Kings,0,0,1610612740,New Orleans Pelicans,1,1,22,20,42,11,34,45,33,54,87,16,8,24,13,47,27,8,13,100,93
2023,2,22300178,11/12/2023,1610612764,Washington Wizards,0,0,1610612751,Brooklyn Nets,1,1,23,24,47,10,31,41,33,55,88,18,7,25,11,48,20,6,12,101,94
2023,2,22300222,11/20/2023,1610612740,New Orleans Pelicans,1,1,1610612758,Sacramento Kings,0,0,38,26,64,12,16,28,50,42,92,17,4,21,16,28,38,4,12,99,129
2021,2,22100605,1/9/2022,1610612757,Portland Trail Blazers,1,1,1610612758,Sacramento Kings,0,0,20,28,48,17,23,40,37,51,88,12,3,15,14,39,26,8,17,99,103
2021,2,22100605,1/9/2022,1610612758,Sacramento Kings,0,0,1610612757,Portland Trail Blazers,1,1,26,28,54,7,24,31,33,52,85,15,6,21,10,44,20,6,12,98,88
2017,2,21700343,12/4/2017,1610612738,Boston Celtics,1,1,1610612749,Milwaukee Bucks,0,0,33,23,56,10,12,22,43,35,78,15,4,19,10,26,25,6,15,92,111
2017,2,21700343,12/4/2017,1610612749,Milwaukee Bucks,0,0,1610612738,Boston Celtics,1,1,26,31,57,9,12,21,35,43,78,21,3,24,7,39,17,5,10,93,100
2014,2,21400107,11/11/2014,1610612766,Charlotte Hornets,0,0,1610612757,Portland Trail Blazers,1,1,28,31,59,7,9,16,35,40,75,23,4,27,7,34,16,6,13,93,100
2023,2,22300237,11/22/2023,1610612762,Utah Jazz,0,0,1610612757,Portland Trail Blazers,1,1,27,21,48,10,21,31,37,42,79,21,5,26,18,26,25,9,24,97,105
2021,2,22100604,1/9/2022,1610612739,Cleveland Cavaliers,0,0,1610612744,Golden State Warriors,1,1,25,26,51,7,17,24,32,43,75,11,7,18,12,34,21,16,19,91,82
2021,2,22100604,1/9/2022,1610612744,Golden State Warriors,1,1,1610612739,Cleveland Cavaliers,0,0,29,26,55,10,32,42,39,58,97,8,2,10,26,34,24,9,15,92,96
2020,2,22000386,2/10/2021,1610612763,Memphis Grizzlies,1,1,1610612766,Charlotte Hornets,0,0,24,21,45,23,26,49,47,47,94,13,5,18,24,27,34,11,17,96,130
2022,2,22200979,3/7/2023,1610612752,New York Knicks,1,0,1610612766,Charlotte Hornets,0,1,27,22,49,11,29,40,38,51,89,18,6,24,13,42,18,2,8,93,105
2022,2,22200890,2/23/2023,1610612740,New Orleans Pelicans,0,0,1610612761,Toronto Raptors,1,1,26,28,54,13,17,30,39,45,84,19,6,25,9,39,23,10,13,102,110
2022,2,22200867,2/13/2023,1610612747,Los Angeles Lakers,0,0,1610612757,Portland Trail Blazers,1,1,30,28,58,12,25,37,42,53,95,19,2,21,18,37,24,7,13,101,115
2022,2,22201141,3/29/2023,1610612763,Memphis Grizzlies,1,0,1610612746,LA Clippers,0,1,38,25,63,11,21,32,49,46,95,23,5,28,17,32,26,8,13,107,132
2022,2,22200217,11/16/2022,1610612740,New Orleans Pelicans,1,1,1610612741,Chicago Bulls,0,0,26,26,52,17,16,33,43,42,85,21,3,24,14,30,30,2,15,97,124
2020,2,22000386,2/10/2021,1610612766,Charlotte Hornets,0,0,1610612763,Memphis Grizzlies,1,1,31,22,53,14,15,29,45,37,82,10,2,12,10,29,23,10,19,98,114
2017,2,21700342,12/4/2017,1610612737,Atlanta Hawks,1,0,1610612751,Brooklyn Nets,0,1,21,31,52,9,21,30,30,52,82,21,6,27,11,43,18,7,18,101,90
2017,2,21700342,12/4/2017,1610612751,Brooklyn Nets,0,1,1610612737,Atlanta Hawks,1,0,26,23,49,15,21,36,41,44,85,13,2,15,14,31,29,9,24,102,110
2016,2,21600847,2/15/2017,1610612744,Golden State Warriors,1,1,1610612758,Sacramento Kings,0,0,28,20,48,13,23,36,41,43,84,14,7,21,9,38,32,4,8,94,109
2016,2,21600847,2/15/2017,1610612758,Sacramento Kings,0,0,1610612744,Golden State Warriors,1,1,26,39,65,7,17,24,33,56,89,13,4,17,19,40,23,10,18,95,86
2014,2,21400106,11/11/2014,1610612742,Dallas Mavericks,1,1,1610612758,Sacramento Kings,0,0,28,25,53,10,17,27,38,42,80,20,4,24,9,34,23,5,11,93,106
2014,2,21400106,11/11/2014,1610612758,Sacramento Kings,0,0,1610612742,Dallas Mavericks,1,1,23,30,53,9,10,19,32,40,72,25,7,32,16,27,17,8,22,94,98
2014,2,21400476,12/31/2014,1610612748,Miami Heat,0,0,1610612754,Indiana Pacers,1,1,33,28,61,5,11,16,38,39,77,14,4,18,11,30,20,4,12,88,95
2014,2,21400476,12/31/2014,1610612754,Indiana Pacers,1,1,1610612748,Miami Heat,0,0,25,36,61,10,8,18,35,44,79,26,4,30,18,28,23,5,12,87,106
2020,2,22000703,3/28/2021,1610612756,Phoenix Suns,0,1,1610612766,Charlotte Hornets,1,0,26,30,56,8,32,40,34,62,96,25,4,29,26,39,17,8,14,98,101
2020,2,22000703,3/28/2021,1610612766,Charlotte Hornets,1,0,1610612756,Phoenix Suns,0,1,21,21,42,13,30,43,34,51,85,16,7,23,21,33,16,15,21,100,97
2022,2,22200769,3/7/2023,1610612765,Detroit Pistons,1,0,1610612764,Washington Wizards,0,1,30,24,54,13,17,30,43,41,84,18,4,22,15,29,29,9,12,91,117
2022,2,22200866,2/13/2023,1610612744,Golden State Warriors,1,1,1610612764,Washington Wizards,0,0,32,17,49,20,20,40,52,37,89,11,4,15,15,25,40,10,16,98,135
2022,2,22201058,3/18/2023,1610612750,Minnesota Timberwolves,0,0,1610612761,Toronto Raptors,1,1,34,28,62,5,18,23,39,46,85,24,4,28,11,37,27,11,15,102,107
2021,2,22100603,1/9/2022,1610612741,Chicago Bulls,0,0,1610612742,Dallas Mavericks,1,1,28,29,57,11,22,33,39,51,90,10,3,13,11,41,23,4,7,92,99
2021,2,22100603,1/9/2022,1610612742,Dallas Mavericks,1,1,1610612741,Chicago Bulls,0,0,28,24,52,16,20,36,44,44,88,9,0,9,10,34,28,8,10,93,113
2020,2,22000385,2/10/2021,1610612740,New Orleans Pelicans,0,0,1610612741,Chicago Bulls,1,1,28,17,45,13,23,36,41,40,81,21,5,26,10,33,27,4,12,95,116
2020,2,22000385,2/10/2021,1610612741,Chicago Bulls,1,1,1610612740,New Orleans Pelicans,0,0,23,11,34,25,22,47,48,33,81,8,3,11,7,27,36,11,17,96,129
2020,2,22000384,2/10/2021,1610612737,Atlanta Hawks,0,0,1610612742,Dallas Mavericks,1,1,26,23,49,14,25,39,40,48,88,23,5,28,14,37,27,3,9,97,117
2020,2,22000384,2/10/2021,1610612742,Dallas Mavericks,1,1,1610612737,Atlanta Hawks,0,0,29,20,49,14,21,35,43,41,84,18,2,20,8,34,25,7,11,97,118
2017,2,21700341,12/4/2017,1610612755,Philadelphia 76ers,1,0,1610612756,Phoenix Suns,0,1,32,29,61,7,23,30,39,52,91,16,0,16,18,34,23,10,14,97,101
2017,2,21700341,12/4/2017,1610612756,Phoenix Suns,0,1,1610612755,Philadelphia 76ers,1,0,34,35,69,10,12,22,44,47,91,17,5,22,15,36,25,9,11,95,115
2016,2,21600846,2/15/2017,1610612737,Atlanta Hawks,0,0,1610612746,LA Clippers,1,1,25,28,53,7,19,26,32,47,79,13,6,19,14,36,20,18,23,97,84
2016,2,21600846,2/15/2017,1610612746,LA Clippers,1,1,1610612737,Atlanta Hawks,0,0,23,19,42,14,23,37,37,42,79,11,1,12,5,37,24,5,16,96,99
2016,2,21600336,12/8/2016,1610612741,Chicago Bulls,1,1,1610612759,San Antonio Spurs,0,0,31,32,63,4,13,17,35,45,80,21,6,27,16,35,24,12,20,97,95
2016,2,21600336,12/8/2016,1610612759,San Antonio Spurs,0,0,1610612741,Chicago Bulls,1,1,30,39,69,9,19,28,39,58,97,4,1,5,16,41,21,7,14,98,91
2020,2,22000702,3/27/2021,1610612739,Cleveland Cavaliers,0,0,1610612758,Sacramento Kings,1,1,28,30,58,9,17,26,37,47,84,15,8,23,10,38,20,4,10,94,98
2020,2,22000702,3/27/2021,1610612758,Sacramento Kings,1,1,1610612739,Cleveland Cavaliers,0,0,34,16,50,7,23,30,41,39,80,11,3,14,9,31,16,11,18,95,100
2018,2,21801107,3/26/2019,1610612759,San Antonio Spurs,0,0,1610612766,Charlotte Hornets,1,1,31,38,69,13,26,39,44,64,108,15,6,21,22,43,24,9,13,109,116
2018,2,21801107,3/26/2019,1610612766,Charlotte Hornets,1,1,1610612759,San Antonio Spurs,0,0,33,25,58,13,29,42,46,54,100,20,8,28,11,46,30,4,6,109,125
2022,2,22200866,2/13/2023,1610612764,Washington Wizards,0,0,1610612744,Golden State Warriors,1,1,36,16,52,12,16,28,48,32,80,18,3,21,10,24,26,10,17,97,126
2022,2,22200829,2/8/2023,1610612742,Dallas Mavericks,0,1,1610612746,LA Clippers,1,0,24,19,43,17,18,35,41,37,78,11,6,17,8,33,26,10,18,96,110
2022,2,22200937,3/1/2023,1610612752,New York Knicks,1,1,1610612751,Brooklyn Nets,0,0,34,20,54,20,15,35,54,35,89,14,7,21,11,27,28,6,16,103,142
2021,2,22100602,1/9/2022,1610612751,Brooklyn Nets,1,1,1610612759,San Antonio Spurs,0,0,39,31,70,8,20,28,47,51,98,19,3,22,17,36,26,12,22,113,121
2022,2,22201139,3/29/2023,1610612742,Dallas Mavericks,0,0,1610612755,Philadelphia 76ers,1,1,20,17,37,18,28,46,38,45,83,14,4,18,12,34,24,9,14,91,108
2021,2,22100602,1/9/2022,1610612759,San Antonio Spurs,0,0,1610612751,Brooklyn Nets,1,1,33,42,75,13,19,32,46,61,107,14,4,18,17,47,33,8,15,114,119
2020,2,22000383,2/10/2021,1610612751,Brooklyn Nets,1,1,1610612754,Indiana Pacers,0,0,23,22,45,9,22,31,32,44,76,31,4,35,13,34,20,4,13,94,104
2020,2,22000383,2/10/2021,1610612754,Indiana Pacers,0,0,1610612751,Brooklyn Nets,1,1,21,33,54,15,23,38,36,56,92,7,4,11,15,43,26,2,10,93,94
2022,2,22200830,2/8/2023,1610612757,Portland Trail Blazers,1,1,1610612744,Golden State Warriors,0,0,35,16,51,8,19,27,43,35,78,31,1,32,13,22,25,11,21,98,125
2022,2,22200867,2/13/2023,1610612757,Portland Trail Blazers,1,1,1610612747,Los Angeles Lakers,0,0,23,27,50,23,24,47,46,51,97,12,1,13,9,43,27,6,7,101,127
2022,2,22200936,3/1/2023,1610612755,Philadelphia 76ers,0,1,1610612748,Miami Heat,1,0,26,18,44,15,24,39,41,42,83,22,0,22,11,31,25,3,9,92,119
2022,2,22200968,3/5/2023,1610612760,Oklahoma City Thunder,1,1,1610612762,Utah Jazz,0,0,30,20,50,14,23,37,44,43,87,27,6,33,14,29,24,5,12,101,129
2022,2,22200969,3/5/2023,1610612738,Boston Celtics,1,0,1610612752,New York Knicks,0,1,22,28,50,21,38,59,43,66,109,22,3,25,23,45,27,7,16,114,129
2020,2,22000382,2/10/2021,1610612761,Toronto Raptors,0,1,1610612764,Washington Wizards,1,0,30,31,61,19,13,32,49,44,93,20,3,23,10,36,28,7,12,104,137
2020,2,22000382,2/10/2021,1610612764,Washington Wizards,1,0,1610612761,Toronto Raptors,0,1,30,22,52,12,29,41,42,51,93,19,4,23,13,38,26,5,14,106,115
2022,2,22201022,3/13/2023,1610612762,Utah Jazz,0,0,1610612748,Miami Heat,1,1,27,25,52,16,22,38,43,47,90,13,5,18,18,31,31,12,18,100,115
2019,2,21900195,11/18/2019,1610612738,Boston Celtics,0,1,1610612756,Phoenix Suns,1,0,25,23,48,12,29,41,37,52,89,13,4,17,15,39,22,7,17,101,99
2022,2,22201030,3/14/2023,1610612740,New Orleans Pelicans,1,0,1610612747,Los Angeles Lakers,0,1,31,24,55,11,32,43,42,56,98,13,7,20,21,39,23,8,12,99,108
2022,2,22201078,3/21/2023,1610612737,Atlanta Hawks,1,1,1610612765,Detroit Pistons,0,0,30,27,57,14,24,38,44,51,95,27,9,36,26,30,26,8,11,99,129
2020,2,22000701,3/27/2021,1610612746,LA Clippers,1,1,1610612755,Philadelphia 76ers,0,0,34,25,59,11,15,26,45,40,85,21,6,27,13,31,26,5,12,99,122
2020,2,22000701,3/27/2021,1610612755,Philadelphia 76ers,0,0,1610612746,LA Clippers,1,1,29,22,51,10,16,26,39,38,77,24,9,33,11,30,17,9,16,98,112
2022,2,22200829,2/8/2023,1610612746,LA Clippers,1,0,1610612742,Dallas Mavericks,0,1,26,27,53,12,21,33,38,48,86,16,5,21,11,37,21,7,11,97,104
2022,2,22200969,3/5/2023,1610612752,New York Knicks,0,1,1610612738,Boston Celtics,1,0,32,22,54,15,26,41,47,48,95,22,10,32,15,39,18,8,20,115,131
2022,2,22200933,3/1/2023,1610612766,Charlotte Hornets,1,0,1610612756,Phoenix Suns,0,1,23,32,55,9,24,33,32,56,88,18,10,28,16,45,20,8,14,99,91
2022,2,22200968,3/5/2023,1610612762,Utah Jazz,0,0,1610612760,Oklahoma City Thunder,1,1,32,19,51,11,26,37,43,45,88,22,5,27,15,31,30,9,16,102,119
2021,2,22100601,1/9/2022,1610612743,Denver Nuggets,0,1,1610612760,Oklahoma City Thunder,1,0,24,29,53,13,23,36,37,52,89,12,4,16,22,33,28,9,15,89,99
2022,2,22200984,3/7/2023,1610612747,Los Angeles Lakers,1,1,1610612763,Memphis Grizzlies,0,0,34,28,62,7,21,28,41,49,90,23,6,29,13,40,27,6,15,106,112
2021,2,22100601,1/9/2022,1610612760,Oklahoma City Thunder,1,0,1610612743,Denver Nuggets,0,1,29,21,50,9,29,38,38,50,88,10,2,12,13,39,29,7,9,89,95
2020,2,22000381,2/9/2021,1610612755,Philadelphia 76ers,0,1,1610612758,Sacramento Kings,1,0,32,33,65,9,11,20,41,44,85,28,7,35,14,34,24,6,17,106,119
2022,2,22201086,3/22/2023,1610612742,Dallas Mavericks,1,0,1610612744,Golden State Warriors,0,1,27,22,49,17,23,40,44,45,89,20,8,28,14,37,27,7,10,98,125
2022,2,22201107,3/25/2023,1610612754,Indiana Pacers,0,0,1610612737,Atlanta Hawks,1,1,38,21,59,14,23,37,52,44,96,12,0,12,16,28,33,10,17,102,130
2022,2,22200217,11/16/2022,1610612741,Chicago Bulls,0,0,1610612740,New Orleans Pelicans,1,1,33,24,57,11,21,32,44,45,89,11,6,17,11,36,25,4,12,98,110
2023,2,22300053,11/28/2023,1610612741,Chicago Bulls,0,0,1610612738,Boston Celtics,1,1,30,32,62,9,19,28,39,51,90,10,8,18,12,44,25,6,8,95,97
2021,2,22100600,1/9/2022,1610612745,Houston Rockets,1,0,1610612750,Minnesota Timberwolves,0,1,32,22,54,14,29,43,46,51,97,17,11,28,15,41,31,10,13,110,123
2021,2,22100600,1/9/2022,1610612750,Minnesota Timberwolves,0,1,1610612745,Houston Rockets,1,0,40,26,66,15,27,42,55,53,108,16,5,21,19,38,37,5,11,109,141
2020,2,22000381,2/9/2021,1610612758,Sacramento Kings,1,0,1610612755,Philadelphia 76ers,0,1,29,28,57,14,28,42,43,56,99,11,8,19,13,48,24,4,11,106,111
2022,2,22200830,2/8/2023,1610612744,Golden State Warriors,0,0,1610612757,Portland Trail Blazers,1,1,25,23,48,21,28,49,46,51,97,9,1,10,14,38,31,6,11,100,122
2022,2,22200936,3/1/2023,1610612748,Miami Heat,1,0,1610612755,Philadelphia 76ers,0,1,27,22,49,7,22,29,34,44,78,21,2,23,10,35,18,6,13,93,96
2019,2,21900195,11/18/2019,1610612756,Phoenix Suns,1,0,1610612738,Boston Celtics,0,1,23,23,46,10,26,36,33,49,82,9,3,12,8,42,22,12,19,99,85
2022,2,22200890,2/23/2023,1610612761,Toronto Raptors,1,1,1610612740,New Orleans Pelicans,0,0,34,27,61,9,22,31,43,49,92,20,5,25,13,38,17,6,12,102,115
2022,2,22201079,3/21/2023,1610612751,Brooklyn Nets,1,0,1610612739,Cleveland Cavaliers,0,1,32,27,59,9,24,33,41,51,92,18,5,23,26,27,25,6,17,94,109
2022,2,22200967,3/5/2023,1610612759,San Antonio Spurs,0,0,1610612745,Houston Rockets,1,1,32,27,59,11,23,34,43,50,93,13,8,21,13,40,23,10,15,102,110
2022,2,22201123,3/27/2023,1610612742,Dallas Mavericks,0,1,1610612754,Indiana Pacers,1,0,29,17,46,18,19,37,47,36,83,15,2,17,7,30,29,6,12,96,127
2022,2,22201143,3/29/2023,1610612762,Utah Jazz,0,1,1610612759,San Antonio Spurs,1,0,37,22,59,12,19,31,49,41,90,18,2,20,9,33,28,10,16,106,128
2022,2,22201020,3/13/2023,1610612754,Indiana Pacers,0,0,1610612765,Detroit Pistons,1,1,26,26,52,10,24,34,36,50,86,15,9,24,16,37,23,10,16,96,97
2020,2,22000700,3/27/2021,1610612762,Utah Jazz,1,1,1610612763,Memphis Grizzlies,0,0,27,20,47,19,26,45,46,46,92,15,5,20,15,33,22,16,22,109,126
2020,2,22000700,3/27/2021,1610612763,Memphis Grizzlies,0,0,1610612762,Utah Jazz,1,1,30,34,64,9,24,33,39,58,97,23,7,30,18,42,24,8,15,108,110
2022,2,22200218,11/16/2022,1610612742,Dallas Mavericks,1,0,1610612745,Houston Rockets,0,1,19,28,47,12,43,55,31,71,102,18,1,19,19,52,21,1,6,97,92
2022,2,22200218,11/16/2022,1610612745,Houston Rockets,0,1,1610612742,Dallas Mavericks,1,0,25,28,53,10,12,22,35,40,75,21,3,24,12,29,21,9,23,96,101
2021,2,22100599,1/9/2022,1610612740,New Orleans Pelicans,0,0,1610612761,Toronto Raptors,1,1,22,20,42,12,21,33,34,41,75,21,4,25,10,32,20,8,13,89,101
2021,2,22100599,1/9/2022,1610612761,Toronto Raptors,1,1,1610612740,New Orleans Pelicans,0,0,22,29,51,14,20,34,36,49,85,19,1,20,18,32,18,5,13,89,105
2017,2,21700340,12/4/2017,1610612752,New York Knicks,0,0,1610612754,Indiana Pacers,1,1,34,34,68,6,17,23,40,51,91,10,5,15,16,37,26,10,18,100,96
2017,2,21700340,12/4/2017,1610612754,Indiana Pacers,1,1,1610612752,New York Knicks,0,0,35,25,60,11,15,26,46,40,86,12,3,15,11,31,28,4,16,100,115
2016,2,21600845,2/15/2017,1610612752,New York Knicks,0,0,1610612760,Oklahoma City Thunder,1,1,30,35,65,11,10,21,41,45,86,12,2,14,8,38,19,10,15,98,105
2022,2,22200935,3/1/2023,1610612738,Boston Celtics,1,1,1610612739,Cleveland Cavaliers,0,0,23,23,46,16,16,32,39,39,78,23,5,28,11,29,27,8,13,92,117
2016,2,21600845,2/15/2017,1610612760,Oklahoma City Thunder,1,1,1610612752,New York Knicks,0,0,29,36,65,12,11,23,41,47,88,22,9,31,17,33,21,8,12,98,116
2014,2,21400105,11/11/2014,1610612749,Milwaukee Bucks,1,1,1610612760,Oklahoma City Thunder,0,0,30,36,66,3,12,15,33,48,81,16,8,24,19,34,18,6,16,90,85
2014,2,21400105,11/11/2014,1610612760,Oklahoma City Thunder,0,0,1610612749,Milwaukee Bucks,1,1,23,44,67,6,14,20,29,58,87,14,5,19,21,39,15,5,16,90,78
2022,2,22200937,3/1/2023,1610612751,Brooklyn Nets,0,0,1610612752,New York Knicks,1,1,27,24,51,15,24,39,42,48,90,19,1,20,8,40,26,5,14,105,118
2022,2,22201079,3/21/2023,1610612739,Cleveland Cavaliers,0,1,1610612751,Brooklyn Nets,1,0,28,26,54,14,15,29,42,41,83,17,4,21,11,30,23,6,14,94,115
2022,2,22201107,3/25/2023,1610612737,Atlanta Hawks,1,1,1610612754,Indiana Pacers,0,0,38,28,66,15,15,30,53,43,96,22,3,25,21,22,33,7,13,102,143
2018,2,21800586,1/6/2019,1610612746,LA Clippers,1,1,1610612753,Orlando Magic,0,0,32,39,71,8,14,22,40,53,93,18,5,23,13,43,20,6,8,99,106
2018,2,21800586,1/6/2019,1610612753,Orlando Magic,0,0,1610612746,LA Clippers,1,1,24,34,58,9,22,31,33,56,89,21,8,29,15,44,24,5,12,99,96
2021,2,22100598,1/9/2022,1610612753,Orlando Magic,1,0,1610612764,Washington Wizards,0,1,29,38,67,9,19,28,38,57,95,15,1,16,15,43,18,1,8,97,100
2021,2,22100598,1/9/2022,1610612764,Washington Wizards,0,1,1610612753,Orlando Magic,1,0,25,34,59,11,18,29,36,52,88,19,5,24,17,37,23,9,13,96,102
2022,2,22200973,3/5/2023,1610612749,Milwaukee Bucks,0,1,1610612764,Washington Wizards,1,0,17,17,34,22,27,49,39,44,83,17,5,22,7,39,30,8,12,98,117
2020,2,22000380,2/9/2021,1610612753,Orlando Magic,0,0,1610612757,Portland Trail Blazers,1,1,26,27,53,11,24,35,37,51,88,12,10,22,11,47,22,6,11,97,97
2020,2,22000380,2/9/2021,1610612757,Portland Trail Blazers,1,1,1610612753,Orlando Magic,0,0,17,27,44,18,28,46,35,55,90,18,1,19,11,45,18,7,9,97,106
2019,2,21900194,11/18/2019,1610612742,Dallas Mavericks,1,1,1610612759,San Antonio Spurs,0,0,25,18,43,17,24,41,42,42,84,16,7,23,12,34,28,6,13,97,117
2019,2,21900194,11/18/2019,1610612759,San Antonio Spurs,0,0,1610612742,Dallas Mavericks,1,1,36,36,72,8,16,24,44,52,96,14,2,16,18,34,18,4,10,95,110
2020,2,22000699,3/27/2021,1610612738,Boston Celtics,0,1,1610612760,Oklahoma City Thunder,1,0,32,26,58,12,26,38,44,52,96,11,3,14,13,41,22,7,12,100,111
2020,2,22000699,3/27/2021,1610612760,Oklahoma City Thunder,1,0,1610612738,Boston Celtics,0,1,23,22,45,11,27,38,34,49,83,15,9,24,12,42,16,10,18,102,94
2022,2,22200045,10/24/2022,1610612748,Miami Heat,1,0,1610612761,Toronto Raptors,0,1,21,28,49,8,26,34,29,54,83,24,3,27,11,44,19,6,12,95,90
2022,2,22200045,10/24/2022,1610612761,Toronto Raptors,0,1,1610612748,Miami Heat,1,0,20,34,54,14,18,32,34,52,86,16,4,20,12,41,22,5,12,96,98
2021,2,22100597,1/9/2022,1610612737,Atlanta Hawks,0,0,1610612746,LA Clippers,1,1,28,24,52,7,19,26,35,43,78,16,3,19,8,36,19,5,13,94,93
2021,2,22100597,1/9/2022,1610612746,LA Clippers,1,1,1610612737,Atlanta Hawks,0,0,32,27,59,12,21,33,44,48,92,6,1,7,16,33,24,6,13,93,106
2014,2,21400104,11/11/2014,1610612747,Los Angeles Lakers,0,0,1610612763,Memphis Grizzlies,1,1,34,31,65,7,15,22,41,46,87,13,4,17,17,31,22,8,13,91,102
2014,2,21400104,11/11/2014,1610612763,Memphis Grizzlies,1,1,1610612747,Los Angeles Lakers,0,0,37,30,67,4,7,11,41,37,78,21,5,26,15,25,21,8,16,92,107
2016,2,21600844,2/15/2017,1610612747,Los Angeles Lakers,0,0,1610612756,Phoenix Suns,1,1,26,41,67,9,17,26,35,58,93,22,6,28,10,52,16,7,12,107,101
2016,2,21600844,2/15/2017,1610612756,Phoenix Suns,1,1,1610612747,Los Angeles Lakers,0,0,39,25,64,10,14,24,49,39,88,29,5,34,12,30,32,9,15,106,137
2020,2,22000379,2/9/2021,1610612738,Boston Celtics,0,0,1610612762,Utah Jazz,1,1,25,32,57,13,16,29,38,48,86,19,4,23,16,35,18,4,9,90,108
2020,2,22000379,2/9/2021,1610612762,Utah Jazz,1,1,1610612738,Boston Celtics,0,0,22,14,36,18,30,48,40,44,84,24,3,27,18,26,28,2,11,90,122
2022,2,22201140,3/29/2023,1610612747,Los Angeles Lakers,0,1,1610612741,Chicago Bulls,1,0,38,28,66,7,13,20,45,41,86,24,6,30,17,26,22,10,16,97,121
2017,2,21700339,12/4/2017,1610612753,Orlando Magic,0,0,1610612766,Charlotte Hornets,1,1,26,24,50,10,22,32,36,46,82,12,2,14,6,41,24,13,20,100,94
2020,2,22000698,3/27/2021,1610612740,New Orleans Pelicans,1,1,1610612742,Dallas Mavericks,0,0,33,22,55,9,17,26,42,39,81,19,10,29,12,32,20,2,7,90,112
2020,2,22000698,3/27/2021,1610612742,Dallas Mavericks,0,0,1610612740,New Orleans Pelicans,1,1,27,25,52,10,21,31,37,46,83,19,5,24,12,37,19,2,7,90,103
2021,2,22100596,1/8/2022,1610612748,Miami Heat,0,1,1610612756,Phoenix Suns,1,0,22,22,44,22,22,44,44,44,88,13,2,15,13,32,33,10,16,97,123
2021,2,22100596,1/8/2022,1610612756,Phoenix Suns,1,0,1610612748,Miami Heat,0,1,16,29,45,14,20,34,30,49,79,26,3,29,10,40,24,9,16,98,100
2017,2,21700339,12/4/2017,1610612766,Charlotte Hornets,1,1,1610612753,Orlando Magic,0,0,31,36,67,3,14,17,34,50,84,33,7,40,15,39,17,5,15,100,104
2016,2,21600843,2/15/2017,1610612757,Portland Trail Blazers,0,0,1610612762,Utah Jazz,1,1,23,34,57,9,13,22,32,47,79,15,5,20,11,39,14,9,17,95,88
2019,2,21900487,12/29/2019,1610612763,Memphis Grizzlies,1,1,1610612766,Charlotte Hornets,0,0,35,23,58,10,25,35,45,48,93,17,0,17,16,32,30,8,14,100,117
2019,2,21900487,12/29/2019,1610612766,Charlotte Hornets,0,0,1610612763,Memphis Grizzlies,1,1,28,27,55,9,22,31,37,49,86,21,11,32,14,39,23,5,14,101,104
2019,2,21900193,11/18/2019,1610612745,Houston Rockets,1,1,1610612757,Portland Trail Blazers,0,0,30,25,55,17,28,45,47,53,100,21,5,26,20,36,24,7,16,109,132
2019,2,21900193,11/18/2019,1610612757,Portland Trail Blazers,0,0,1610612745,Houston Rockets,1,1,29,31,60,11,25,36,40,56,96,17,6,23,17,44,28,9,17,108,108
2016,2,21600843,2/15/2017,1610612762,Utah Jazz,1,1,1610612757,Portland Trail Blazers,0,0,31,28,59,11,11,22,42,39,81,16,7,23,10,33,19,9,14,94,111
2020,2,22000378,2/9/2021,1610612744,Golden State Warriors,0,1,1610612759,San Antonio Spurs,1,0,25,26,51,17,23,40,42,49,91,13,6,19,13,39,26,2,11,99,114
2020,2,22000378,2/9/2021,1610612759,San Antonio Spurs,1,0,1610612744,Golden State Warriors,0,1,24,38,62,8,16,24,32,54,86,19,2,21,13,42,20,8,14,98,91
2019,2,21900486,12/29/2019,1610612760,Oklahoma City Thunder,0,1,1610612761,Toronto Raptors,1,0,24,21,45,10,23,33,34,44,78,20,3,23,11,35,15,7,17,95,98
2022,2,22200939,3/1/2023,1610612749,Milwaukee Bucks,1,1,1610612753,Orlando Magic,0,0,23,15,38,26,30,56,49,45,94,15,4,19,8,39,29,3,8,103,139
2022,2,22200941,3/1/2023,1610612740,New Orleans Pelicans,0,1,1610612757,Portland Trail Blazers,1,0,37,27,64,9,16,25,46,43,89,20,3,23,15,29,23,5,6,94,121
2020,2,22000697,3/27/2021,1610612741,Chicago Bulls,0,0,1610612759,San Antonio Spurs,1,1,33,28,61,8,26,34,41,54,95,14,4,18,15,40,28,9,14,102,104
2020,2,22000697,3/27/2021,1610612759,San Antonio Spurs,1,1,1610612741,Chicago Bulls,0,0,36,24,60,10,15,25,46,39,85,18,10,28,7,37,29,6,11,101,120
2021,2,22100595,1/8/2022,1610612738,Boston Celtics,1,1,1610612752,New York Knicks,0,0,24,23,47,12,17,29,36,40,76,15,2,17,12,30,26,8,12,84,99
2021,2,22100595,1/8/2022,1610612752,New York Knicks,0,0,1610612738,Boston Celtics,1,1,18,30,48,11,20,31,29,50,79,6,9,15,16,38,13,8,14,84,75
2020,2,22000377,2/9/2021,1610612740,New Orleans Pelicans,1,1,1610612745,Houston Rockets,0,0,35,26,61,12,19,31,47,45,92,24,4,28,20,27,31,5,12,98,130
2020,2,22000377,2/9/2021,1610612745,Houston Rockets,0,0,1610612740,New Orleans Pelicans,1,1,25,23,48,13,30,43,38,53,91,12,9,21,14,43,24,7,12,98,101
2019,2,21900486,12/29/2019,1610612761,Toronto Raptors,1,0,1610612760,Oklahoma City Thunder,0,1,20,23,43,15,25,40,35,48,83,12,0,12,12,36,21,8,17,93,97
2020,2,22000696,3/27/2021,1610612745,Houston Rockets,0,1,1610612750,Minnesota Timberwolves,1,0,32,21,53,18,21,39,50,42,92,11,2,13,13,30,29,8,12,95,129
2020,2,22000696,3/27/2021,1610612750,Minnesota Timberwolves,1,0,1610612745,Houston Rockets,0,1,23,22,45,13,27,40,36,49,85,22,6,28,14,38,26,7,13,96,107
2022,2,22200940,3/1/2023,1610612747,Los Angeles Lakers,0,1,1610612760,Oklahoma City Thunder,1,0,22,23,45,16,19,35,38,42,80,31,8,39,14,33,22,8,13,98,123
2022,2,22201124,3/27/2023,1610612752,New York Knicks,1,1,1610612745,Houston Rockets,0,0,33,14,47,17,22,39,50,36,86,20,8,28,8,32,35,6,11,99,137
2022,2,22200941,3/1/2023,1610612757,Portland Trail Blazers,1,0,1610612740,New Orleans Pelicans,0,1,25,18,43,11,27,38,36,45,81,27,2,29,14,32,18,9,14,93,110
2022,2,22201031,3/14/2023,1610612751,Brooklyn Nets,0,0,1610612760,Oklahoma City Thunder,1,1,23,18,41,12,29,41,35,47,82,25,9,34,13,37,25,9,17,102,107
2022,2,22201140,3/29/2023,1610612741,Chicago Bulls,1,0,1610612747,Los Angeles Lakers,0,1,36,19,55,9,24,33,45,43,88,11,2,13,9,35,31,10,14,97,110
2020,2,22000376,2/9/2021,1610612748,Miami Heat,1,1,1610612752,New York Knicks,0,0,12,25,37,14,19,33,26,44,70,32,7,39,9,37,21,8,11,91,98
2017,2,21700338,12/3/2017,1610612745,Houston Rockets,0,1,1610612747,Los Angeles Lakers,1,0,31,22,53,14,23,37,45,45,90,14,3,17,10,37,17,9,15,103,118
2017,2,21700338,12/3/2017,1610612747,Los Angeles Lakers,1,0,1610612745,Houston Rockets,0,1,23,33,56,9,19,28,32,52,84,22,8,30,18,37,16,10,21,102,95
2022,2,22200970,3/5/2023,1610612763,Memphis Grizzlies,0,0,1610612746,LA Clippers,1,1,32,26,58,18,16,34,50,42,92,11,4,15,3,42,32,6,8,101,129
2022,2,22200938,3/1/2023,1610612763,Memphis Grizzlies,0,1,1610612745,Houston Rockets,1,0,23,19,42,17,24,41,40,43,83,16,3,19,8,35,27,4,8,92,113
2022,2,22201087,3/22/2023,1610612741,Chicago Bulls,1,0,1610612755,Philadelphia 76ers,0,1,28,30,58,6,19,25,34,49,83,17,5,22,18,33,18,9,19,94,91
2022,2,22200973,3/5/2023,1610612764,Washington Wizards,1,0,1610612749,Milwaukee Bucks,0,1,38,39,77,8,23,31,46,62,108,11,1,12,21,41,21,5,9,100,111
2022,2,22201030,3/14/2023,1610612747,Los Angeles Lakers,0,1,1610612740,New Orleans Pelicans,1,0,22,21,43,18,21,39,40,42,82,25,3,28,16,27,24,9,18,98,123
2022,2,22201034,3/14/2023,1610612752,New York Knicks,0,1,1610612757,Portland Trail Blazers,1,0,27,19,46,15,20,35,42,39,81,24,10,34,11,31,23,8,13,101,123
2022,2,22201209,4/7/2023,1610612752,New York Knicks,0,0,1610612740,New Orleans Pelicans,1,1,24,21,45,14,29,43,38,50,88,15,5,20,12,42,19,4,10,94,105
2022,2,22200219,11/16/2022,1610612743,Denver Nuggets,1,0,1610612752,New York Knicks,0,1,22,22,44,14,24,38,36,46,82,17,3,20,12,36,18,12,15,95,103
2022,2,22200219,11/16/2022,1610612752,New York Knicks,0,1,1610612743,Denver Nuggets,1,0,29,21,50,8,26,34,37,47,84,24,7,31,12,39,24,3,8,94,106
2021,2,22100594,1/8/2022,1610612754,Indiana Pacers,1,1,1610612762,Utah Jazz,0,0,30,21,51,14,15,29,44,36,80,23,9,32,8,31,30,6,10,98,125
2021,2,22100594,1/8/2022,1610612762,Utah Jazz,0,0,1610612754,Indiana Pacers,1,1,25,24,49,15,20,35,40,44,84,18,1,19,10,35,20,9,15,98,113
2020,2,22000376,2/9/2021,1610612752,New York Knicks,0,0,1610612748,Miami Heat,1,1,27,32,59,10,18,28,37,50,87,12,4,16,18,34,22,5,14,91,96
2019,2,21900485,12/28/2019,1610612746,LA Clippers,1,0,1610612762,Utah Jazz,0,1,23,32,55,12,28,40,35,60,95,25,2,27,19,42,22,4,8,96,107
2019,2,21900485,12/28/2019,1610612762,Utah Jazz,0,1,1610612746,LA Clippers,1,0,28,23,51,17,18,35,45,41,86,13,4,17,11,31,25,9,13,97,120
2017,2,21700337,12/3/2017,1610612759,San Antonio Spurs,0,0,1610612760,Oklahoma City Thunder,1,1,23,25,48,8,20,28,31,45,76,17,6,23,13,34,14,8,17,92,87
2017,2,21700337,12/3/2017,1610612760,Oklahoma City Thunder,1,1,1610612759,San Antonio Spurs,0,0,31,34,65,6,16,22,37,50,87,10,11,21,23,33,21,11,20,91,90
2023,2,22301013,3/22/2024,1610612740,New Orleans Pelicans,0,1,1610612748,Miami Heat,1,0,24,22,46,18,18,36,42,40,82,9,3,12,13,28,25,3,13,89,111
2016,2,21600335,12/8/2016,1610612744,Golden State Warriors,0,1,1610612762,Utah Jazz,1,0,27,24,51,12,17,29,39,41,80,16,7,23,10,35,26,8,17,97,106
2022,2,22200940,3/1/2023,1610612760,Oklahoma City Thunder,1,0,1610612747,Los Angeles Lakers,0,1,33,18,51,11,29,40,44,47,91,18,6,24,17,34,29,8,13,99,117
2016,2,21600335,12/8/2016,1610612762,Utah Jazz,1,0,1610612744,Golden State Warriors,0,1,27,24,51,10,28,38,37,52,89,15,6,21,15,40,20,10,15,99,99
2022,2,22201123,3/27/2023,1610612754,Indiana Pacers,1,0,1610612742,Dallas Mavericks,0,1,31,34,65,8,20,28,39,54,93,18,5,23,22,34,20,7,15,95,104
2022,2,22201124,3/27/2023,1610612745,Houston Rockets,0,0,1610612752,New York Knicks,1,1,35,26,61,7,19,26,42,45,87,24,5,29,14,35,24,11,14,100,115
2022,2,22201086,3/22/2023,1610612744,Golden State Warriors,0,1,1610612742,Dallas Mavericks,1,0,38,13,51,12,27,39,50,40,90,15,3,18,12,29,33,7,13,98,127
2014,2,21401041,3/22/2015,1610612752,New York Knicks,0,0,1610612761,Toronto Raptors,1,1,27,38,65,8,11,19,35,49,84,11,5,16,14,38,24,4,12,91,89
2014,2,21401041,3/22/2015,1610612761,Toronto Raptors,1,1,1610612752,New York Knicks,0,0,35,29,64,4,7,11,39,36,75,24,5,29,12,28,22,9,16,91,106
2014,2,21400475,12/31/2014,1610612738,Boston Celtics,1,1,1610612758,Sacramento Kings,0,0,39,34,73,5,16,21,44,50,94,13,2,15,12,39,32,9,11,101,106
2014,2,21400475,12/31/2014,1610612758,Sacramento Kings,0,0,1610612738,Boston Celtics,1,1,30,42,72,2,13,15,32,55,87,18,10,28,17,43,12,9,16,102,84
2022,2,22201142,3/29/2023,1610612760,Oklahoma City Thunder,1,1,1610612765,Detroit Pistons,0,0,29,29,58,10,19,29,39,48,87,19,6,25,14,35,19,1,10,93,107
2022,2,22200234,11/18/2022,1610612747,Los Angeles Lakers,1,1,1610612765,Detroit Pistons,0,0,36,22,58,7,13,20,43,35,78,35,5,40,8,30,29,9,16,104,128
2022,2,22200234,11/18/2022,1610612765,Detroit Pistons,0,0,1610612747,Los Angeles Lakers,1,1,32,26,58,11,23,34,43,49,92,24,8,32,12,38,27,2,11,104,121
2023,2,22301048,3/27/2024,1610612739,Cleveland Cavaliers,0,0,1610612766,Charlotte Hornets,1,1,23,18,41,19,25,44,42,43,85,8,6,14,14,31,33,8,15,94,111
2021,2,22100593,1/8/2022,1610612753,Orlando Magic,0,0,1610612765,Detroit Pistons,1,1,15,25,40,14,32,46,29,57,86,20,3,23,16,44,25,7,13,95,92
2021,2,22100593,1/8/2022,1610612765,Detroit Pistons,1,1,1610612753,Orlando Magic,0,0,28,26,54,10,23,33,38,49,87,11,5,16,12,40,23,6,13,95,97
2020,2,22000375,2/9/2021,1610612751,Brooklyn Nets,0,0,1610612765,Detroit Pistons,1,1,32,24,56,11,19,30,43,43,86,14,2,16,13,31,30,10,15,95,111
2020,2,22000375,2/9/2021,1610612765,Detroit Pistons,1,1,1610612751,Brooklyn Nets,0,0,34,21,55,13,16,29,47,37,84,15,6,21,12,27,28,8,13,95,122
2019,2,21900484,12/28/2019,1610612747,Los Angeles Lakers,0,1,1610612757,Portland Trail Blazers,1,0,36,23,59,11,21,32,47,44,91,23,5,28,13,33,32,4,11,100,128
2022,2,22201032,3/14/2023,1610612753,Orlando Magic,0,0,1610612759,San Antonio Spurs,1,1,34,34,68,10,19,29,44,53,97,16,5,21,16,41,24,6,9,99,114
2022,2,22200970,3/5/2023,1610612746,LA Clippers,1,1,1610612763,Memphis Grizzlies,0,0,33,23,56,12,17,29,45,40,85,33,2,35,18,24,25,13,17,102,135
2022,2,22201033,3/14/2023,1610612756,Phoenix Suns,1,0,1610612749,Milwaukee Bucks,0,1,33,39,72,8,15,23,41,54,95,14,2,16,14,41,23,8,11,100,104
2022,2,22201142,3/29/2023,1610612765,Detroit Pistons,0,0,1610612760,Oklahoma City Thunder,1,1,24,23,47,16,17,33,40,40,80,10,4,14,12,30,27,7,18,92,106
2019,2,21900484,12/28/2019,1610612757,Portland Trail Blazers,1,0,1610612747,Los Angeles Lakers,0,1,26,25,51,15,20,35,41,45,86,23,4,27,14,34,18,6,16,101,120
2020,2,22000694,3/27/2021,1610612764,Washington Wizards,1,1,1610612765,Detroit Pistons,0,0,35,35,70,9,12,21,44,47,91,9,0,9,9,38,24,9,18,103,106
2020,2,22000694,3/27/2021,1610612765,Detroit Pistons,0,0,1610612764,Washington Wizards,1,1,23,33,56,10,19,29,33,52,85,16,3,19,10,43,19,7,19,103,92
2022,2,22201126,3/27/2023,1610612743,Denver Nuggets,1,1,1610612755,Philadelphia 76ers,0,0,32,21,53,11,21,32,43,42,85,19,3,22,12,30,34,10,12,96,116
2021,2,22100592,1/8/2022,1610612749,Milwaukee Bucks,0,0,1610612766,Charlotte Hornets,1,1,23,30,53,12,25,37,35,55,90,24,2,26,15,40,21,10,15,101,106
2021,2,22100592,1/8/2022,1610612766,Charlotte Hornets,1,1,1610612749,Milwaukee Bucks,0,0,28,23,51,16,32,48,44,55,99,10,7,17,17,43,29,6,11,101,114
2020,2,22000374,2/8/2021,1610612747,Los Angeles Lakers,1,1,1610612760,Oklahoma City Thunder,0,0,35,22,57,9,29,38,44,51,95,22,7,29,12,42,28,6,15,111,119
2020,2,22000374,2/8/2021,1610612760,Oklahoma City Thunder,0,0,1610612747,Los Angeles Lakers,1,1,31,41,72,12,26,38,43,67,110,14,5,19,20,51,23,7,13,110,112
2019,2,21900483,12/28/2019,1610612756,Phoenix Suns,0,1,1610612758,Sacramento Kings,1,0,36,24,60,9,17,26,45,41,86,13,2,15,11,31,30,3,14,96,112
2019,2,21900483,12/28/2019,1610612758,Sacramento Kings,1,0,1610612756,Phoenix Suns,0,1,29,24,53,12,19,31,41,43,84,16,8,24,11,35,19,10,12,96,110
2019,2,21900192,11/18/2019,1610612741,Chicago Bulls,1,0,1610612749,Milwaukee Bucks,0,1,27,36,63,12,22,34,39,58,97,11,3,14,15,43,25,12,15,103,101
2019,2,21900192,11/18/2019,1610612749,Milwaukee Bucks,0,1,1610612741,Chicago Bulls,1,0,23,18,41,15,26,41,38,44,82,24,11,35,10,38,24,6,15,102,115
2023,2,22301181,4/12/2024,1610612765,Detroit Pistons,0,1,1610612742,Dallas Mavericks,1,0,38,26,64,8,23,31,46,49,95,7,2,9,7,43,23,5,7,99,107
2020,2,22000693,3/26/2021,1610612739,Cleveland Cavaliers,0,0,1610612747,Los Angeles Lakers,1,1,26,28,54,5,21,26,31,49,80,19,9,28,13,40,24,15,21,100,86
2020,2,22000693,3/26/2021,1610612747,Los Angeles Lakers,1,1,1610612739,Cleveland Cavaliers,0,0,32,20,52,6,20,26,38,40,78,18,7,25,13,29,23,11,23,101,100
2017,2,21700336,12/3/2017,1610612746,LA Clippers,0,0,1610612750,Minnesota Timberwolves,1,1,22,17,39,15,19,34,37,36,73,17,5,22,8,31,21,9,16,89,106
2017,2,21700336,12/3/2017,1610612750,Minnesota Timberwolves,1,1,1610612746,LA Clippers,0,0,30,32,62,8,18,26,38,50,88,28,3,31,20,33,22,3,7,90,112
2021,2,22100591,1/8/2022,1610612746,LA Clippers,1,0,1610612763,Memphis Grizzlies,0,1,29,35,64,10,22,32,39,57,96,20,4,24,19,41,16,9,13,102,108
2021,2,22100591,1/8/2022,1610612763,Memphis Grizzlies,0,1,1610612746,LA Clippers,1,0,32,30,62,12,26,38,44,56,100,23,8,31,22,36,26,7,10,102,123
2022,2,22200965,3/5/2023,1610612766,Charlotte Hornets,0,0,1610612751,Brooklyn Nets,1,1,25,33,58,8,22,30,33,55,88,12,3,15,6,50,17,5,10,99,86
2022,2,22200939,3/1/2023,1610612753,Orlando Magic,0,0,1610612749,Milwaukee Bucks,1,1,34,27,61,9,24,33,43,51,94,22,7,29,15,39,22,4,13,104,117
2022,2,22200235,11/19/2022,1610612737,Atlanta Hawks,1,1,1610612761,Toronto Raptors,0,0,39,28,67,7,18,25,46,46,92,25,7,32,12,38,23,11,15,110,124
2022,2,22201034,3/14/2023,1610612757,Portland Trail Blazers,1,0,1610612752,New York Knicks,0,1,21,33,54,17,28,45,38,61,99,14,4,18,19,45,22,8,12,101,107
2020,2,22000373,2/8/2021,1610612743,Denver Nuggets,1,0,1610612749,Milwaukee Bucks,0,1,26,32,58,15,21,36,41,53,94,15,1,16,13,40,22,7,9,96,112
2020,2,22000373,2/8/2021,1610612749,Milwaukee Bucks,0,1,1610612743,Denver Nuggets,1,0,29,20,49,16,24,40,45,44,89,19,3,22,14,31,24,5,11,96,125
2017,2,21700335,12/3/2017,1610612744,Golden State Warriors,0,1,1610612748,Miami Heat,1,0,36,18,54,11,19,30,47,37,84,18,6,24,13,26,32,5,10,92,123
2022,2,22200235,11/19/2022,1610612761,Toronto Raptors,0,0,1610612737,Atlanta Hawks,1,1,40,31,71,8,29,37,48,60,108,18,4,22,20,42,27,5,14,111,122
2022,2,22201122,3/27/2023,1610612749,Milwaukee Bucks,0,1,1610612765,Detroit Pistons,1,0,31,19,50,14,31,45,45,50,95,22,4,26,18,35,28,5,9,99,126
2023,2,22300178,11/12/2023,1610612751,Brooklyn Nets,1,1,1610612764,Washington Wizards,0,0,25,24,49,12,37,49,37,61,98,16,4,20,25,37,22,14,19,101,102
2021,2,22100590,1/7/2022,1610612739,Cleveland Cavaliers,0,1,1610612757,Portland Trail Blazers,1,0,22,19,41,17,22,39,39,41,80,19,10,29,11,35,22,8,9,92,114
2021,2,22100590,1/7/2022,1610612757,Portland Trail Blazers,1,0,1610612739,Cleveland Cavaliers,0,1,21,36,57,16,19,35,37,55,92,11,8,19,22,38,22,7,12,93,101
2017,2,21700335,12/3/2017,1610612748,Miami Heat,1,0,1610612744,Golden State Warriors,0,1,19,25,44,14,23,37,33,48,81,15,2,17,9,39,17,4,12,94,95
2016,2,21600842,2/15/2017,1610612743,Denver Nuggets,1,0,1610612750,Minnesota Timberwolves,0,1,27,33,60,11,23,34,38,56,94,12,6,18,19,40,25,12,15,99,99
2016,2,21600842,2/15/2017,1610612750,Minnesota Timberwolves,0,1,1610612743,Denver Nuggets,1,0,35,33,68,6,12,18,41,45,86,24,4,28,9,37,20,4,7,98,112
2020,2,22000692,3/26/2021,1610612737,Atlanta Hawks,0,1,1610612744,Golden State Warriors,1,0,33,18,51,13,20,33,46,38,84,19,5,24,10,29,31,7,10,95,124
2020,2,22000692,3/26/2021,1610612744,Golden State Warriors,1,0,1610612737,Atlanta Hawks,0,1,27,24,51,12,16,28,39,40,79,18,8,26,6,39,29,6,13,96,108
2018,2,21800961,3/5/2019,1610612745,Houston Rockets,0,1,1610612761,Toronto Raptors,1,0,23,28,51,15,19,34,38,47,85,16,2,18,12,36,22,1,10,91,107
2018,2,21800961,3/5/2019,1610612761,Toronto Raptors,1,0,1610612745,Houston Rockets,0,1,28,29,57,9,23,32,37,52,89,12,4,16,18,37,16,11,13,92,95
2018,2,21800662,1/16/2019,1610612739,Cleveland Cavaliers,0,0,1610612757,Portland Trail Blazers,1,1,39,37,76,6,13,19,45,50,95,16,3,19,15,37,17,1,3,93,112
2018,2,21800662,1/16/2019,1610612757,Portland Trail Blazers,1,1,1610612739,Cleveland Cavaliers,0,0,31,29,60,16,13,29,47,42,89,19,4,23,12,31,28,0,4,92,129
2020,2,22000372,2/8/2021,1610612739,Cleveland Cavaliers,0,0,1610612756,Phoenix Suns,1,1,36,26,62,8,16,24,44,42,86,17,8,25,15,30,23,7,10,93,113
2020,2,22000372,2/8/2021,1610612756,Phoenix Suns,1,1,1610612739,Cleveland Cavaliers,0,0,36,30,66,11,13,24,47,43,90,14,5,19,15,31,29,5,11,93,119
2022,2,22201033,3/14/2023,1610612749,Milwaukee Bucks,0,1,1610612756,Phoenix Suns,1,0,28,18,46,12,27,39,40,45,85,24,13,37,14,36,24,7,13,100,116
2022,2,22201141,3/29/2023,1610612746,LA Clippers,0,1,1610612763,Memphis Grizzlies,1,0,26,15,41,22,15,37,48,30,78,23,8,31,3,33,28,8,16,105,141
2019,2,21900482,12/28/2019,1610612742,Dallas Mavericks,0,1,1610612744,Golden State Warriors,1,0,24,17,41,24,27,51,48,44,92,21,0,21,10,34,35,4,13,105,141
2019,2,21900482,12/28/2019,1610612744,Golden State Warriors,1,0,1610612742,Dallas Mavericks,0,1,27,27,54,18,21,39,45,48,93,13,4,17,11,40,28,11,13,106,121
2022,2,22200236,11/19/2022,1610612753,Orlando Magic,0,0,1610612754,Indiana Pacers,1,1,23,26,49,16,26,42,39,52,91,19,7,26,19,37,16,5,11,96,113
2022,2,22200236,11/19/2022,1610612754,Indiana Pacers,1,1,1610612753,Orlando Magic,0,0,23,21,44,18,28,46,41,49,90,14,5,19,18,33,27,8,15,97,114
2017,2,21700334,12/3/2017,1610612752,New York Knicks,1,0,1610612753,Orlando Magic,0,1,38,40,78,5,10,15,43,50,93,9,1,10,14,37,18,8,14,98,100
2021,2,22100589,1/7/2022,1610612737,Atlanta Hawks,0,0,1610612747,Los Angeles Lakers,1,1,30,30,60,13,23,36,43,53,96,19,8,27,17,41,29,14,15,106,118
2021,2,22100589,1/7/2022,1610612747,Los Angeles Lakers,1,1,1610612737,Atlanta Hawks,0,0,33,27,60,17,24,41,50,51,101,17,2,19,10,42,37,3,8,105,134
2017,2,21700334,12/3/2017,1610612753,Orlando Magic,0,1,1610612752,New York Knicks,1,0,31,23,54,6,22,28,37,45,82,25,4,29,11,35,19,4,12,96,105
2016,2,21600841,2/15/2017,1610612745,Houston Rockets,1,0,1610612748,Miami Heat,0,1,23,24,47,13,27,40,36,51,87,24,7,31,16,37,22,3,8,92,109
2019,2,21900481,12/28/2019,1610612759,San Antonio Spurs,1,1,1610612765,Detroit Pistons,0,0,35,23,58,18,17,35,53,40,93,12,3,15,8,34,30,9,11,102,136
2019,2,21900481,12/28/2019,1610612765,Detroit Pistons,0,0,1610612759,San Antonio Spurs,1,1,28,26,54,12,24,36,40,50,90,17,13,30,13,46,20,8,11,102,109
2020,2,22000691,3/26/2021,1610612762,Utah Jazz,1,1,1610612763,Memphis Grizzlies,0,0,33,32,65,12,21,33,45,53,98,15,3,18,17,38,25,3,7,97,117
2020,2,22000691,3/26/2021,1610612763,Memphis Grizzlies,0,0,1610612762,Utah Jazz,1,1,32,35,67,12,18,30,44,53,97,14,4,18,14,41,27,5,7,98,114
2020,2,22000371,2/8/2021,1610612744,Golden State Warriors,0,0,1610612759,San Antonio Spurs,1,1,25,24,49,13,24,37,38,48,86,11,4,15,12,37,29,12,20,104,100
2020,2,22000371,2/8/2021,1610612759,San Antonio Spurs,1,1,1610612744,Golden State Warriors,0,0,28,37,65,11,20,31,39,57,96,16,3,19,13,45,24,4,11,102,105
2022,2,22201020,3/13/2023,1610612765,Detroit Pistons,1,1,1610612754,Indiana Pacers,0,0,34,30,64,14,22,36,48,52,100,7,3,10,23,30,28,7,15,97,117
2017,2,21700333,12/2/2017,1610612740,New Orleans Pelicans,0,1,1610612757,Portland Trail Blazers,1,0,30,25,55,15,16,31,45,41,86,18,7,25,8,37,22,6,11,100,123
2022,2,22201186,4/4/2023,1610612747,Los Angeles Lakers,0,1,1610612762,Utah Jazz,1,0,36,26,62,12,22,34,48,48,96,27,8,35,15,37,27,4,12,111,135
2022,2,22200237,11/19/2022,1610612750,Minnesota Timberwolves,0,1,1610612755,Philadelphia 76ers,1,0,28,21,49,12,24,36,40,45,85,20,4,24,11,37,28,10,20,102,112
2022,2,22200237,11/19/2022,1610612755,Philadelphia 76ers,1,0,1610612750,Minnesota Timberwolves,0,1,20,19,39,14,18,32,34,37,71,27,5,32,4,36,21,9,22,103,109
2022,2,22200938,3/1/2023,1610612745,Houston Rockets,1,0,1610612763,Memphis Grizzlies,0,1,25,31,56,11,23,34,36,54,90,16,9,25,23,36,17,6,13,92,99
2017,2,21700333,12/2/2017,1610612757,Portland Trail Blazers,1,0,1610612740,New Orleans Pelicans,0,1,36,34,70,11,24,35,47,58,105,11,0,11,14,44,20,2,4,102,116
2021,2,22100588,1/7/2022,1610612743,Denver Nuggets,1,1,1610612758,Sacramento Kings,0,0,35,16,51,12,22,34,47,38,85,15,9,24,5,36,32,6,8,98,121
2021,2,22100588,1/7/2022,1610612758,Sacramento Kings,0,0,1610612743,Denver Nuggets,1,1,29,34,63,11,18,29,40,52,92,20,4,24,16,38,21,5,12,100,111
2016,2,21600841,2/15/2017,1610612748,Miami Heat,0,1,1610612745,Houston Rockets,1,0,31,18,49,13,22,35,44,40,84,16,8,24,15,30,27,6,12,90,117
2014,2,21400103,11/11/2014,1610612753,Orlando Magic,0,0,1610612761,Toronto Raptors,1,1,27,29,56,12,13,25,39,42,81,10,6,16,8,36,26,9,17,95,100
2020,2,22000370,2/8/2021,1610612742,Dallas Mavericks,1,1,1610612750,Minnesota Timberwolves,0,0,33,20,53,12,22,34,45,42,87,25,5,30,11,35,30,9,14,102,127
2020,2,22000370,2/8/2021,1610612750,Minnesota Timberwolves,0,0,1610612742,Dallas Mavericks,1,1,24,25,49,18,24,42,42,49,91,20,8,28,11,40,27,4,9,103,122
2019,2,21900480,12/28/2019,1610612749,Milwaukee Bucks,1,1,1610612753,Orlando Magic,0,0,30,17,47,13,24,37,43,41,84,12,6,18,17,29,30,16,25,100,111
2022,2,22201096,3/23/2023,1610612746,LA Clippers,1,1,1610612760,Oklahoma City Thunder,0,0,29,18,47,18,19,37,47,37,84,15,5,20,12,27,34,6,15,96,127
2022,2,22201126,3/27/2023,1610612755,Philadelphia 76ers,0,0,1610612743,Denver Nuggets,1,1,35,24,59,8,22,30,43,46,89,17,5,22,13,35,18,8,11,96,111
2022,2,22200238,11/19/2022,1610612757,Portland Trail Blazers,1,0,1610612762,Utah Jazz,0,1,26,15,41,13,29,42,39,44,83,22,5,27,14,33,27,6,18,99,113
2022,2,22200238,11/19/2022,1610612762,Utah Jazz,0,1,1610612757,Portland Trail Blazers,1,0,28,24,52,14,25,39,42,49,91,20,3,23,14,35,23,11,13,100,118
2020,2,22000690,3/26/2021,1610612742,Dallas Mavericks,1,0,1610612754,Indiana Pacers,0,1,31,29,60,8,27,35,39,56,95,8,6,14,21,38,17,9,16,96,94
2020,2,22000690,3/26/2021,1610612754,Indiana Pacers,0,1,1610612742,Dallas Mavericks,1,0,18,22,40,20,27,47,38,49,87,13,5,18,13,40,26,4,12,95,109
2021,2,22100587,1/7/2022,1610612750,Minnesota Timberwolves,0,1,1610612760,Oklahoma City Thunder,1,0,33,16,49,17,24,41,50,40,90,18,7,25,13,32,39,10,15,103,135
2021,2,22100587,1/7/2022,1610612760,Oklahoma City Thunder,1,0,1610612750,Minnesota Timberwolves,0,1,21,24,45,15,29,44,36,53,89,18,5,23,17,39,26,12,20,103,105
2020,2,22000369,2/8/2021,1610612761,Toronto Raptors,0,1,1610612763,Memphis Grizzlies,1,0,22,18,40,20,17,37,42,35,77,24,2,26,10,26,28,7,16,96,128
2020,2,22000369,2/8/2021,1610612763,Memphis Grizzlies,1,0,1610612761,Toronto Raptors,0,1,24,24,48,13,26,39,37,50,87,26,3,29,21,31,27,11,15,96,113
2016,2,21600840,2/15/2017,1610612740,New Orleans Pelicans,0,1,1610612763,Memphis Grizzlies,1,0,29,28,57,8,10,18,37,38,75,13,9,22,5,36,18,8,12,93,95
2016,2,21600840,2/15/2017,1610612763,Memphis Grizzlies,1,0,1610612740,New Orleans Pelicans,0,1,27,29,56,6,27,33,33,56,89,19,6,25,23,37,22,10,15,94,91
2020,2,22000689,3/26/2021,1610612740,New Orleans Pelicans,1,0,1610612743,Denver Nuggets,0,1,27,22,49,12,17,29,39,39,78,18,2,20,13,26,30,7,15,90,108
2020,2,22000689,3/26/2021,1610612743,Denver Nuggets,0,1,1610612740,New Orleans Pelicans,1,0,33,32,65,14,14,28,47,46,93,5,2,7,14,34,28,7,8,90,113
2022,2,22200886,2/23/2023,1610612743,Denver Nuggets,0,1,1610612739,Cleveland Cavaliers,1,0,22,26,48,17,19,36,39,45,84,20,3,23,19,29,30,10,16,94,115
2017,2,21700332,12/2/2017,1610612743,Denver Nuggets,1,1,1610612747,Los Angeles Lakers,0,0,28,28,56,12,19,31,40,47,87,23,5,28,13,37,26,5,12,99,115
2017,2,21700332,12/2/2017,1610612747,Los Angeles Lakers,0,0,1610612743,Denver Nuggets,1,1,29,27,56,9,21,30,38,48,86,15,6,21,20,31,21,8,21,97,100
2014,2,21400474,12/30/2014,1610612744,Golden State Warriors,1,1,1610612755,Philadelphia 76ers,0,0,34,20,54,12,16,28,46,36,82,22,5,27,9,30,38,11,14,100,126
2014,2,21400474,12/30/2014,1610612755,Philadelphia 76ers,0,0,1610612744,Golden State Warriors,1,1,27,39,66,6,14,20,33,53,86,14,9,23,22,37,16,19,28,102,86
2022,2,22201182,4/4/2023,1610612737,Atlanta Hawks,0,1,1610612741,Chicago Bulls,1,0,38,20,58,10,18,28,48,38,86,17,2,19,11,28,26,8,17,100,123
2022,2,22201078,3/21/2023,1610612765,Detroit Pistons,0,0,1610612737,Atlanta Hawks,1,1,24,27,51,13,27,40,37,54,91,20,4,24,12,44,20,5,10,99,107
2022,2,22200239,11/19/2022,1610612746,LA Clippers,1,1,1610612759,San Antonio Spurs,0,0,23,18,41,21,19,40,44,37,81,10,9,19,10,30,32,4,13,96,119
2022,2,22201096,3/23/2023,1610612760,Oklahoma City Thunder,0,0,1610612746,LA Clippers,1,1,28,26,54,13,26,39,41,52,93,10,1,11,18,35,24,9,14,97,105
2021,2,22100586,1/7/2022,1610612742,Dallas Mavericks,0,1,1610612745,Houston Rockets,1,0,32,20,52,17,21,38,49,41,90,15,13,28,14,34,34,6,16,103,130
2021,2,22100586,1/7/2022,1610612745,Houston Rockets,1,0,1610612742,Dallas Mavericks,0,1,25,19,44,12,31,43,37,50,87,20,9,29,9,47,17,6,13,103,106
2017,2,21700331,12/2/2017,1610612749,Milwaukee Bucks,1,1,1610612758,Sacramento Kings,0,0,28,22,50,6,13,19,34,35,69,35,7,42,12,28,20,7,15,94,109
2017,2,21700331,12/2/2017,1610612758,Sacramento Kings,0,0,1610612749,Milwaukee Bucks,1,1,26,27,53,11,13,24,37,40,77,19,2,21,12,29,20,9,17,94,104
2022,2,22200239,11/19/2022,1610612759,San Antonio Spurs,0,0,1610612746,LA Clippers,1,1,29,32,61,7,19,26,36,51,87,18,3,21,17,34,22,9,15,95,97
2022,2,22200240,11/20/2022,1610612752,New York Knicks,0,0,1610612756,Phoenix Suns,1,1,27,33,60,7,18,25,34,51,85,20,5,25,14,39,20,3,11,95,95
2022,2,22200240,11/20/2022,1610612756,Phoenix Suns,1,1,1610612752,New York Knicks,0,0,26,36,62,17,22,39,43,58,101,13,5,18,27,33,35,4,13,95,116
2017,2,21700330,12/2/2017,1610612755,Philadelphia 76ers,1,1,1610612765,Detroit Pistons,0,0,25,33,58,10,18,28,35,51,86,28,4,32,21,31,27,8,18,100,108
2017,2,21700330,12/2/2017,1610612765,Detroit Pistons,0,0,1610612755,Philadelphia 76ers,1,1,25,22,47,9,22,31,34,44,78,26,6,32,13,33,20,7,19,100,103
2017,2,21700329,12/2/2017,1610612739,Cleveland Cavaliers,1,1,1610612763,Memphis Grizzlies,0,0,31,20,51,11,13,24,42,33,75,21,2,23,3,32,24,6,11,91,116
2017,2,21700329,12/2/2017,1610612763,Memphis Grizzlies,0,0,1610612739,Cleveland Cavaliers,1,1,30,31,61,13,10,23,43,41,84,12,2,14,11,32,31,8,13,91,111
2016,2,21600839,2/15/2017,1610612742,Dallas Mavericks,0,0,1610612765,Detroit Pistons,1,1,25,30,55,10,27,37,35,57,92,11,0,11,6,51,22,2,6,96,91
2022,2,22200241,11/20/2022,1610612764,Washington Wizards,1,1,1610612766,Charlotte Hornets,0,0,27,32,59,13,21,34,40,53,93,13,5,18,18,37,19,5,17,101,106
2022,2,22200965,3/5/2023,1610612751,Brooklyn Nets,1,1,1610612766,Charlotte Hornets,0,0,24,25,49,12,31,43,36,56,92,18,4,22,10,47,21,2,8,100,102
2016,2,21600839,2/15/2017,1610612765,Detroit Pistons,1,1,1610612742,Dallas Mavericks,0,0,30,33,63,6,13,19,36,46,82,20,2,22,13,34,15,10,15,97,98
2016,2,21600334,12/8/2016,1610612740,New Orleans Pelicans,1,0,1610612755,Philadelphia 76ers,0,1,26,33,59,7,18,25,33,51,84,15,7,22,14,38,18,8,12,92,88
2022,2,22201181,4/4/2023,1610612755,Philadelphia 76ers,1,1,1610612738,Boston Celtics,0,0,28,21,49,11,18,29,39,39,78,14,2,16,9,31,21,4,12,89,103
2022,2,22200241,11/20/2022,1610612766,Charlotte Hornets,0,0,1610612764,Washington Wizards,1,1,31,37,68,8,24,32,39,61,100,16,7,23,25,38,19,6,13,102,102
2022,2,22201090,3/22/2023,1610612750,Minnesota Timberwolves,1,1,1610612737,Atlanta Hawks,0,0,34,32,66,11,15,26,45,47,92,24,5,29,15,34,27,6,11,103,125
2022,2,22201208,4/7/2023,1610612749,Milwaukee Bucks,1,0,1610612763,Memphis Grizzlies,0,1,21,22,43,21,28,49,42,50,92,9,2,11,16,35,30,9,19,102,114
2014,2,21400103,11/11/2014,1610612761,Toronto Raptors,1,1,1610612753,Orlando Magic,0,0,26,30,56,9,12,21,35,42,77,25,5,30,9,35,16,8,12,97,104
2016,2,21600334,12/8/2016,1610612755,Philadelphia 76ers,0,1,1610612740,New Orleans Pelicans,1,0,27,24,51,12,28,40,39,52,91,9,4,13,15,39,27,3,10,93,99
2022,2,22201128,3/27/2023,1610612750,Minnesota Timberwolves,0,1,1610612758,Sacramento Kings,1,0,35,27,62,9,15,24,44,42,86,22,12,34,15,30,33,4,6,95,119
2021,2,22100585,1/7/2022,1610612741,Chicago Bulls,1,1,1610612764,Washington Wizards,0,0,33,25,58,15,18,33,48,43,91,19,2,21,12,33,34,8,15,104,130
2021,2,22100585,1/7/2022,1610612764,Washington Wizards,0,0,1610612741,Chicago Bulls,1,1,38,26,64,7,17,24,45,43,88,25,1,26,11,33,28,11,15,103,122
2017,2,21700328,12/2/2017,1610612737,Atlanta Hawks,0,1,1610612751,Brooklyn Nets,1,0,37,35,72,10,17,27,47,52,99,10,4,14,17,37,18,1,10,96,114
2017,2,21700328,12/2/2017,1610612751,Brooklyn Nets,1,0,1610612737,Atlanta Hawks,0,1,17,23,40,17,25,42,34,48,82,17,4,21,14,35,26,12,19,96,102
2016,2,21600838,2/15/2017,1610612749,Milwaukee Bucks,0,1,1610612751,Brooklyn Nets,1,0,43,30,73,7,8,15,50,38,88,22,10,32,8,33,27,7,10,103,129
2022,2,22200242,11/20/2022,1610612758,Sacramento Kings,1,1,1610612765,Detroit Pistons,0,0,35,15,50,12,23,35,47,38,85,31,4,35,12,27,29,4,11,100,137
2022,2,22200242,11/20/2022,1610612765,Detroit Pistons,0,0,1610612758,Sacramento Kings,1,1,32,28,60,15,14,29,47,42,89,20,3,23,10,34,20,4,12,100,129
2022,2,22201129,3/27/2023,1610612741,Chicago Bulls,0,0,1610612746,LA Clippers,1,1,35,24,59,9,14,23,44,38,82,15,6,21,10,31,26,10,15,96,112
2020,2,22000688,3/26/2021,1610612745,Houston Rockets,0,0,1610612750,Minnesota Timberwolves,1,1,20,23,43,17,27,44,37,50,87,10,3,13,13,38,26,12,21,102,101
2020,2,22000688,3/26/2021,1610612750,Minnesota Timberwolves,1,1,1610612745,Houston Rockets,0,0,29,36,65,10,28,38,39,64,103,19,5,24,22,45,30,5,9,102,107
2022,2,22200572,1/4/2023,1610612740,New Orleans Pelicans,1,1,1610612745,Houston Rockets,0,0,27,24,51,14,24,38,41,48,89,23,3,26,18,32,25,10,15,96,119
2022,2,22200572,1/4/2023,1610612745,Houston Rockets,0,0,1610612740,New Orleans Pelicans,1,1,27,23,50,12,26,38,39,49,88,18,9,27,15,38,25,6,13,97,108
2022,2,22200891,2/23/2023,1610612742,Dallas Mavericks,1,1,1610612759,San Antonio Spurs,0,0,24,16,40,22,20,42,46,36,82,28,8,36,5,36,27,4,7,101,142
2017,2,21700327,12/2/2017,1610612742,Dallas Mavericks,1,1,1610612746,LA Clippers,0,0,20,24,44,16,19,35,36,43,79,20,6,26,18,29,24,8,17,91,108
2017,2,21700327,12/2/2017,1610612746,LA Clippers,0,0,1610612742,Dallas Mavericks,1,1,24,40,64,6,16,22,30,56,86,16,7,23,19,41,16,4,11,92,82
2022,2,22201129,3/27/2023,1610612746,LA Clippers,1,1,1610612741,Chicago Bulls,0,0,28,13,41,20,20,40,48,33,81,8,8,16,10,28,41,9,18,97,124
2022,2,22200966,3/5/2023,1610612757,Portland Trail Blazers,0,1,1610612753,Orlando Magic,1,0,23,13,36,16,31,47,39,44,83,28,4,32,14,32,27,11,17,102,122
2017,2,21700326,12/2/2017,1610612738,Boston Celtics,1,1,1610612756,Phoenix Suns,0,0,28,21,49,14,17,31,42,38,80,18,5,23,7,34,32,8,9,94,116
2017,2,21700326,12/2/2017,1610612756,Phoenix Suns,0,0,1610612738,Boston Celtics,1,1,41,36,77,7,17,24,48,53,101,8,3,11,25,30,24,8,12,92,111
2021,2,22100584,1/7/2022,1610612761,Toronto Raptors,1,1,1610612762,Utah Jazz,0,0,33,26,59,12,29,41,45,55,100,20,5,25,23,35,26,3,9,95,122
2016,2,21600838,2/15/2017,1610612751,Brooklyn Nets,1,0,1610612749,Milwaukee Bucks,0,1,32,20,52,14,22,36,46,42,88,19,4,23,11,33,30,16,17,104,125
2014,2,21400102,11/10/2014,1610612746,LA Clippers,1,0,1610612759,San Antonio Spurs,0,1,28,24,52,5,17,22,33,41,74,14,3,17,11,31,26,11,17,89,85
2023,2,22300905,3/7/2024,1610612761,Toronto Raptors,0,0,1610612756,Phoenix Suns,1,1,27,23,50,16,28,44,43,51,94,11,4,15,12,41,30,6,9,98,113
2014,2,21400102,11/10/2014,1610612759,San Antonio Spurs,0,1,1610612746,LA Clippers,1,0,31,33,64,2,17,19,33,50,83,21,6,27,14,39,20,6,8,89,89
2023,2,22300928,3/10/2024,1610612754,Indiana Pacers,0,1,1610612753,Orlando Magic,1,0,30,25,55,8,15,23,38,40,78,27,6,33,7,37,20,7,13,98,111
2022,2,22201006,3/11/2023,1610612754,Indiana Pacers,0,1,1610612765,Detroit Pistons,1,0,34,24,58,9,26,35,43,50,93,26,8,34,19,35,24,7,14,104,121
2021,2,22100584,1/7/2022,1610612762,Utah Jazz,0,0,1610612761,Toronto Raptors,1,1,22,21,43,17,21,38,39,42,81,13,5,18,12,32,23,11,21,97,108
2020,2,22000368,2/8/2021,1610612741,Chicago Bulls,1,0,1610612764,Washington Wizards,0,1,27,28,55,9,21,30,36,49,85,20,4,24,13,38,23,8,16,100,101
2022,2,22201146,3/30/2023,1610612738,Boston Celtics,0,1,1610612749,Milwaukee Bucks,1,0,29,19,48,22,21,43,51,40,91,16,4,20,10,32,28,4,9,99,140
2022,2,22201090,3/22/2023,1610612737,Atlanta Hawks,0,0,1610612750,Minnesota Timberwolves,1,1,33,26,59,12,14,26,45,40,85,22,3,25,11,31,28,7,17,102,124
2014,2,21401040,3/22/2015,1610612740,New Orleans Pelicans,0,0,1610612746,LA Clippers,1,1,26,27,53,12,10,22,38,37,75,12,4,16,10,29,21,10,18,91,100
2014,2,21401040,3/22/2015,1610612746,LA Clippers,1,1,1610612740,New Orleans Pelicans,0,0,35,33,68,7,16,23,42,49,91,16,7,23,19,34,25,7,10,91,107
2022,2,22201209,4/7/2023,1610612740,New Orleans Pelicans,1,1,1610612752,New York Knicks,0,0,32,19,51,10,18,28,42,37,79,19,1,20,6,32,27,5,12,95,113
2022,2,22200243,11/20/2022,1610612751,Brooklyn Nets,1,1,1610612763,Memphis Grizzlies,0,0,34,15,49,16,18,34,50,33,83,11,4,15,5,31,33,13,19,103,127
2022,2,22200243,11/20/2022,1610612763,Memphis Grizzlies,0,0,1610612751,Brooklyn Nets,1,1,31,31,62,12,25,37,43,56,99,17,14,31,18,46,28,5,10,103,115
2022,2,22201089,3/22/2023,1610612749,Milwaukee Bucks,1,1,1610612759,San Antonio Spurs,0,0,36,19,55,15,28,43,51,47,98,13,11,24,14,40,24,7,15,109,130
2022,2,22201205,4/7/2023,1610612737,Atlanta Hawks,1,0,1610612755,Philadelphia 76ers,0,1,41,18,59,10,23,33,51,41,92,19,9,28,6,41,32,10,21,119,131
2020,2,22000368,2/8/2021,1610612764,Washington Wizards,0,1,1610612741,Chicago Bulls,1,0,30,30,60,6,20,26,36,50,86,27,9,36,13,41,23,6,13,101,105
2019,2,21900480,12/28/2019,1610612753,Orlando Magic,0,0,1610612749,Milwaukee Bucks,1,1,21,31,52,14,21,35,35,52,87,16,3,19,8,46,21,6,11,100,100
2022,2,22201146,3/30/2023,1610612749,Milwaukee Bucks,1,0,1610612738,Boston Celtics,0,1,24,34,58,14,29,43,38,63,101,9,4,13,22,43,22,8,13,99,99
2019,2,21900191,11/18/2019,1610612761,Toronto Raptors,1,1,1610612766,Charlotte Hornets,0,0,30,24,54,20,23,43,50,47,97,12,3,15,18,30,40,3,11,97,132
2017,2,21700325,12/1/2017,1610612740,New Orleans Pelicans,0,0,1610612762,Utah Jazz,1,1,27,30,57,15,15,30,42,45,87,9,6,15,9,39,28,7,10,95,108
2017,2,21700325,12/1/2017,1610612762,Utah Jazz,1,1,1610612740,New Orleans Pelicans,0,0,30,25,55,12,18,30,42,43,85,18,7,25,10,36,25,4,8,94,114
2016,2,21600837,2/15/2017,1610612761,Toronto Raptors,1,1,1610612766,Charlotte Hornets,0,0,20,32,52,12,20,32,32,52,84,14,5,19,16,40,19,9,16,93,90
2016,2,21600837,2/15/2017,1610612766,Charlotte Hornets,0,0,1610612761,Toronto Raptors,1,1,19,19,38,13,25,38,32,44,76,8,1,9,5,39,21,8,18,93,85
2016,2,21600333,12/8/2016,1610612757,Portland Trail Blazers,0,0,1610612763,Memphis Grizzlies,1,1,18,36,54,7,21,28,25,57,82,29,11,40,16,46,13,8,12,95,86
2022,2,22201181,4/4/2023,1610612738,Boston Celtics,0,0,1610612755,Philadelphia 76ers,1,1,23,23,46,15,30,45,38,53,91,10,6,16,19,37,28,3,8,89,101
2020,2,22000687,3/26/2021,1610612753,Orlando Magic,1,0,1610612757,Portland Trail Blazers,0,1,30,38,68,12,15,27,42,53,95,9,8,17,17,40,29,7,12,97,105
2020,2,22000687,3/26/2021,1610612757,Portland Trail Blazers,0,1,1610612753,Orlando Magic,1,0,22,23,45,18,22,40,40,45,85,14,7,21,14,33,21,7,16,96,112
2022,2,22200891,2/23/2023,1610612759,San Antonio Spurs,0,0,1610612742,Dallas Mavericks,1,1,35,26,61,10,15,25,45,41,86,16,7,23,12,35,30,10,17,100,116
2022,2,22201208,4/7/2023,1610612763,Memphis Grizzlies,0,1,1610612749,Milwaukee Bucks,1,0,33,18,51,20,22,42,53,40,93,11,4,15,12,30,39,5,12,100,137
2017,2,21700324,12/1/2017,1610612750,Minnesota Timberwolves,0,0,1610612760,Oklahoma City Thunder,1,1,27,25,52,12,12,24,39,37,76,17,4,21,11,29,26,7,17,94,107
2017,2,21700324,12/1/2017,1610612760,Oklahoma City Thunder,1,1,1610612750,Minnesota Timberwolves,0,0,33,20,53,8,18,26,41,38,79,21,1,22,16,22,28,7,19,93,111
2022,2,22200244,11/20/2022,1610612739,Cleveland Cavaliers,1,1,1610612748,Miami Heat,0,0,31,15,46,13,24,37,44,39,83,12,4,16,17,22,31,6,20,94,113
2022,2,22200244,11/20/2022,1610612748,Miami Heat,0,0,1610612739,Cleveland Cavaliers,1,1,25,24,49,6,25,31,31,49,80,19,3,22,13,37,17,7,16,93,87
2022,2,22200966,3/5/2023,1610612753,Orlando Magic,1,0,1610612757,Portland Trail Blazers,0,1,31,22,53,11,20,31,42,42,84,24,7,31,8,40,29,9,11,102,119
2022,2,22201046,3/16/2023,1610612753,Orlando Magic,0,0,1610612756,Phoenix Suns,1,1,35,23,58,8,20,28,43,43,86,19,4,23,13,31,25,7,19,103,113
2022,2,22200246,11/20/2022,1610612742,Dallas Mavericks,1,0,1610612743,Denver Nuggets,0,1,20,16,36,15,27,42,35,43,78,12,9,21,8,40,24,10,13,94,97
2022,2,22201022,3/13/2023,1610612748,Miami Heat,1,1,1610612762,Utah Jazz,0,0,23,22,45,14,20,34,37,42,79,31,5,36,10,34,20,7,13,98,119
2021,2,22100583,1/7/2022,1610612749,Milwaukee Bucks,0,1,1610612751,Brooklyn Nets,1,0,28,23,51,16,29,45,44,52,96,17,4,21,20,35,21,8,11,96,121
2016,2,21600836,2/15/2017,1610612738,Boston Celtics,1,1,1610612755,Philadelphia 76ers,0,0,25,27,52,13,15,28,38,42,80,27,9,36,11,36,21,16,24,108,116
2016,2,21600836,2/15/2017,1610612755,Philadelphia 76ers,0,0,1610612738,Boston Celtics,1,1,36,26,62,8,23,31,44,49,93,12,6,18,16,36,23,13,22,107,108
2016,2,21600333,12/8/2016,1610612763,Memphis Grizzlies,1,1,1610612757,Portland Trail Blazers,0,0,25,42,67,6,14,20,31,56,87,20,10,30,19,41,13,6,13,96,88
2022,2,22200246,11/20/2022,1610612743,Denver Nuggets,0,1,1610612742,Dallas Mavericks,1,0,28,23,51,9,18,27,37,41,78,15,4,19,10,33,22,5,16,94,98
2022,2,22201185,4/4/2023,1610612758,Sacramento Kings,0,1,1610612740,New Orleans Pelicans,1,0,29,20,49,17,25,42,46,45,91,12,3,15,13,32,35,6,12,97,121
2022,2,22201046,3/16/2023,1610612756,Phoenix Suns,1,1,1610612753,Orlando Magic,0,0,30,25,55,13,22,35,43,47,90,17,0,17,9,38,26,7,14,103,116
2017,2,21700323,12/1/2017,1610612759,San Antonio Spurs,0,1,1610612763,Memphis Grizzlies,1,0,20,23,43,11,16,27,31,39,70,22,10,32,13,31,20,8,15,88,95
2017,2,21700323,12/1/2017,1610612763,Memphis Grizzlies,1,0,1610612759,San Antonio Spurs,0,1,25,34,59,5,10,15,30,44,74,14,4,18,10,37,19,8,16,87,79
2016,2,21600835,2/15/2017,1610612739,Cleveland Cavaliers,1,1,1610612754,Indiana Pacers,0,0,21,22,43,18,21,39,39,43,82,17,2,19,11,32,23,2,8,90,113
2016,2,21600835,2/15/2017,1610612754,Indiana Pacers,0,0,1610612739,Cleveland Cavaliers,1,1,28,34,62,12,12,24,40,46,86,12,2,14,14,33,30,6,12,90,104
2014,2,21400101,11/10/2014,1610612741,Chicago Bulls,1,1,1610612765,Detroit Pistons,0,0,32,36,68,7,13,20,39,49,88,17,3,20,12,38,22,5,10,95,102
2014,2,21400101,11/10/2014,1610612765,Detroit Pistons,0,0,1610612741,Chicago Bulls,1,1,27,39,66,7,7,14,34,46,80,16,9,25,11,40,19,6,15,96,91
2022,2,22200889,2/23/2023,1610612755,Philadelphia 76ers,1,1,1610612763,Memphis Grizzlies,0,0,21,27,48,13,23,36,34,50,84,29,7,36,14,38,25,5,12,99,110
2022,2,22201182,4/4/2023,1610612741,Chicago Bulls,1,0,1610612737,Atlanta Hawks,0,1,34,24,58,7,24,31,41,48,89,16,4,20,6,42,16,5,8,100,105
2022,2,22200245,11/20/2022,1610612744,Golden State Warriors,0,1,1610612745,Houston Rockets,1,0,22,17,39,24,23,47,46,40,86,11,4,15,9,34,38,13,17,103,127
2021,2,22100583,1/7/2022,1610612751,Brooklyn Nets,1,0,1610612749,Milwaukee Bucks,0,1,36,29,65,6,21,27,42,50,92,19,1,20,16,34,23,6,11,95,109
2020,2,22000367,2/8/2021,1610612745,Houston Rockets,0,0,1610612766,Charlotte Hornets,1,1,22,17,39,13,34,47,35,51,86,11,5,16,9,44,20,5,12,96,94
2017,2,21700322,12/1/2017,1610612741,Chicago Bulls,1,0,1610612758,Sacramento Kings,0,1,29,25,54,13,23,36,42,48,90,9,4,13,15,35,30,5,9,92,106
2017,2,21700322,12/1/2017,1610612758,Sacramento Kings,0,1,1610612741,Chicago Bulls,1,0,39,28,67,6,12,18,45,40,85,11,3,14,12,31,29,8,12,91,107
2022,2,22201023,3/13/2023,1610612763,Memphis Grizzlies,0,1,1610612742,Dallas Mavericks,1,0,26,20,46,12,25,37,38,45,83,16,3,19,11,35,23,3,16,97,104
2017,2,21700321,12/1/2017,1610612748,Miami Heat,1,1,1610612766,Charlotte Hornets,0,0,25,20,45,14,21,35,39,41,80,13,8,21,13,32,25,9,22,102,105
2017,2,21700321,12/1/2017,1610612766,Charlotte Hornets,0,0,1610612748,Miami Heat,1,1,33,26,59,5,15,20,38,41,79,19,2,21,10,32,21,8,22,101,100
2016,2,21600834,2/15/2017,1610612753,Orlando Magic,1,0,1610612759,San Antonio Spurs,0,1,26,32,58,4,14,18,30,46,76,15,4,19,10,39,15,12,17,91,79
2016,2,21600834,2/15/2017,1610612759,San Antonio Spurs,0,1,1610612753,Orlando Magic,1,0,34,24,58,8,23,31,42,47,89,15,4,19,19,32,25,5,13,91,107
2022,2,22200892,2/23/2023,1610612760,Oklahoma City Thunder,0,0,1610612762,Utah Jazz,1,1,37,38,75,8,29,37,45,67,112,21,6,27,25,45,23,8,11,111,119
2022,2,22201185,4/4/2023,1610612740,New Orleans Pelicans,1,0,1610612758,Sacramento Kings,0,1,30,34,64,7,13,20,37,47,84,22,5,27,15,34,20,8,14,96,103
2022,2,22201040,3/15/2023,1610612759,San Antonio Spurs,1,0,1610612742,Dallas Mavericks,0,1,34,39,73,15,19,34,49,58,107,15,11,26,20,43,26,4,10,109,128
2022,2,22201188,4/4/2023,1610612756,Phoenix Suns,1,1,1610612759,San Antonio Spurs,0,0,33,23,56,10,23,33,43,46,89,19,7,26,20,29,25,7,14,96,115
2023,2,22300872,3/3/2024,1610612744,Golden State Warriors,0,0,1610612738,Boston Celtics,1,1,29,22,51,7,34,41,36,56,92,9,4,13,14,45,24,10,17,100,88
2023,2,22300238,11/22/2023,1610612747,Los Angeles Lakers,1,0,1610612742,Dallas Mavericks,0,1,28,27,55,11,18,29,39,45,84,12,7,19,12,38,26,5,13,95,101
2023,2,22300254,11/27/2023,1610612757,Portland Trail Blazers,0,1,1610612754,Indiana Pacers,1,0,31,36,67,9,9,18,40,45,85,25,6,31,13,34,20,10,16,103,114
2021,2,22100582,1/7/2022,1610612755,Philadelphia 76ers,1,1,1610612759,San Antonio Spurs,0,0,37,27,64,8,15,23,45,42,87,21,6,27,16,30,28,6,13,97,119
2017,2,21700320,12/1/2017,1610612764,Washington Wizards,1,1,1610612765,Detroit Pistons,0,0,36,32,68,7,14,21,43,46,89,16,3,19,17,31,28,7,11,91,109
2017,2,21700320,12/1/2017,1610612765,Detroit Pistons,0,0,1610612764,Washington Wizards,1,1,26,23,49,9,21,30,35,44,79,12,7,19,9,37,20,12,15,92,91
2014,2,21400100,11/10/2014,1610612737,Atlanta Hawks,0,1,1610612752,New York Knicks,1,0,17,27,44,10,17,27,27,44,71,27,1,28,12,32,20,4,16,89,91
2014,2,21400100,11/10/2014,1610612752,New York Knicks,1,0,1610612737,Atlanta Hawks,0,1,30,27,57,6,20,26,36,47,83,7,5,12,17,33,23,7,16,91,85
2016,2,21600332,12/8/2016,1610612743,Denver Nuggets,0,0,1610612764,Washington Wizards,1,1,24,20,44,7,25,32,31,45,76,16,8,24,18,31,24,11,29,98,85
2016,2,21600332,12/8/2016,1610612764,Washington Wizards,1,1,1610612743,Denver Nuggets,0,0,29,30,59,6,13,19,35,43,78,16,1,17,10,33,21,8,19,97,92
2016,2,21600833,2/14/2017,1610612747,Los Angeles Lakers,1,0,1610612758,Sacramento Kings,0,1,26,28,54,12,17,29,38,45,83,8,7,15,14,34,22,9,17,94,96
2016,2,21600833,2/14/2017,1610612758,Sacramento Kings,0,1,1610612747,Los Angeles Lakers,1,0,29,20,49,7,17,24,36,37,73,18,7,25,9,32,23,10,17,95,97
2022,2,22201210,4/7/2023,1610612741,Chicago Bulls,0,1,1610612742,Dallas Mavericks,1,0,35,22,57,11,20,31,46,42,88,12,6,18,8,37,24,7,12,99,115
2022,2,22201188,4/4/2023,1610612759,San Antonio Spurs,0,0,1610612756,Phoenix Suns,1,1,22,28,50,13,27,40,35,55,90,11,3,14,13,44,25,7,12,97,94
2022,2,22201089,3/22/2023,1610612759,San Antonio Spurs,0,0,1610612749,Milwaukee Bucks,1,1,27,27,54,9,30,39,36,57,93,13,7,20,11,51,26,10,19,108,94
2022,2,22200245,11/20/2022,1610612745,Houston Rockets,1,0,1610612744,Golden State Warriors,0,1,26,19,45,15,30,45,41,49,90,23,4,27,16,35,24,8,14,102,120
2017,2,21700319,12/1/2017,1610612754,Indiana Pacers,0,0,1610612761,Toronto Raptors,1,1,37,39,76,8,18,26,45,57,102,17,5,22,22,37,21,6,10,105,115
2017,2,21700319,12/1/2017,1610612761,Toronto Raptors,1,1,1610612754,Indiana Pacers,0,0,38,27,65,10,22,32,48,49,97,14,7,21,16,36,29,7,12,104,120
2022,2,22201183,4/4/2023,1610612743,Denver Nuggets,0,0,1610612745,Houston Rockets,1,1,30,21,51,11,25,36,41,46,87,10,8,18,14,37,26,12,20,101,103
2014,2,21401039,3/22/2015,1610612737,Atlanta Hawks,1,0,1610612759,San Antonio Spurs,0,1,26,30,56,12,12,24,38,42,80,7,0,7,7,35,25,8,19,96,95
2014,2,21401039,3/22/2015,1610612759,San Antonio Spurs,0,1,1610612737,Atlanta Hawks,1,0,39,26,65,7,10,17,46,36,82,15,2,17,11,25,30,13,16,96,114
2022,2,22201023,3/13/2023,1610612742,Dallas Mavericks,1,0,1610612763,Memphis Grizzlies,0,1,23,21,44,12,34,46,35,55,90,6,2,8,11,45,23,9,13,97,88
2021,2,22100582,1/7/2022,1610612759,San Antonio Spurs,0,0,1610612755,Philadelphia 76ers,1,1,29,33,62,9,21,30,38,54,92,15,5,20,17,38,22,7,12,98,100
2020,2,22000367,2/8/2021,1610612766,Charlotte Hornets,1,1,1610612745,Houston Rockets,0,0,25,24,49,19,22,41,44,46,90,12,1,13,15,31,28,9,15,97,119
2022,2,22201210,4/7/2023,1610612742,Dallas Mavericks,1,0,1610612741,Chicago Bulls,0,1,24,14,38,18,37,55,42,51,93,10,3,13,10,44,23,6,10,99,112
2017,2,21700318,12/1/2017,1610612744,Golden State Warriors,0,1,1610612753,Orlando Magic,1,0,43,21,64,12,12,24,55,33,88,11,0,11,11,22,46,9,19,102,133
2017,2,21700318,12/1/2017,1610612753,Orlando Magic,1,0,1610612744,Golden State Warriors,0,1,33,35,68,11,17,28,44,52,96,13,5,18,17,38,23,9,15,103,112
2022,2,22201040,3/15/2023,1610612742,Dallas Mavericks,0,1,1610612759,San Antonio Spurs,1,0,27,26,53,17,16,33,44,42,86,32,5,37,13,32,23,7,19,108,137
2023,2,22300905,3/7/2024,1610612756,Phoenix Suns,1,1,1610612761,Toronto Raptors,0,0,29,22,51,15,20,35,44,42,86,17,3,20,15,28,29,5,16,98,120
2022,2,22201041,3/15/2023,1610612744,Golden State Warriors,0,0,1610612746,LA Clippers,1,1,32,20,52,17,19,36,49,39,88,11,4,15,10,32,28,11,16,103,126
2023,2,22300180,11/12/2023,1610612754,Indiana Pacers,0,0,1610612755,Philadelphia 76ers,1,1,31,20,51,16,23,39,47,43,90,16,3,19,11,33,31,5,10,100,126
2020,2,22000686,3/26/2021,1610612748,Miami Heat,0,0,1610612766,Charlotte Hornets,1,1,25,19,44,15,28,43,40,47,87,10,10,20,14,37,28,6,10,94,105
2020,2,22000686,3/26/2021,1610612766,Charlotte Hornets,1,1,1610612748,Miami Heat,0,0,21,15,36,18,25,43,39,40,79,14,5,19,10,32,30,9,16,93,110
2022,2,22201021,3/13/2023,1610612750,Minnesota Timberwolves,0,1,1610612737,Atlanta Hawks,1,0,42,22,64,12,16,28,54,38,92,16,7,23,7,34,39,6,13,108,136
2017,2,21700317,11/30/2017,1610612746,LA Clippers,1,0,1610612762,Utah Jazz,0,1,28,13,41,10,19,29,38,32,70,21,9,30,12,25,23,13,19,92,107
2017,2,21700317,11/30/2017,1610612762,Utah Jazz,0,1,1610612746,LA Clippers,1,0,32,18,50,17,18,35,49,36,85,11,3,14,13,26,38,8,13,91,126
2022,2,22201183,4/4/2023,1610612745,Houston Rockets,1,1,1610612743,Denver Nuggets,0,0,35,36,71,12,19,31,47,55,102,18,6,24,25,35,23,9,13,102,124
2022,2,22201187,4/4/2023,1610612744,Golden State Warriors,1,1,1610612760,Oklahoma City Thunder,0,0,27,21,48,20,27,47,47,48,95,22,8,30,23,29,25,4,14,103,136
2022,2,22201088,3/22/2023,1610612763,Memphis Grizzlies,1,1,1610612745,Houston Rockets,0,0,33,18,51,12,24,36,45,42,87,28,5,33,15,29,27,6,11,97,130
2016,2,21600832,2/14/2017,1610612739,Cleveland Cavaliers,0,1,1610612750,Minnesota Timberwolves,1,0,31,16,47,13,26,39,44,42,86,15,7,22,12,34,27,6,10,93,116
2022,2,22201082,3/21/2023,1610612760,Oklahoma City Thunder,0,1,1610612746,LA Clippers,1,0,29,27,56,10,27,37,39,54,93,13,1,14,17,37,19,9,12,93,101
2022,2,22200247,11/20/2022,1610612747,Los Angeles Lakers,1,1,1610612759,San Antonio Spurs,0,0,33,18,51,12,22,34,45,40,85,21,3,24,8,33,29,7,15,103,123
2022,2,22200247,11/20/2022,1610612759,San Antonio Spurs,0,0,1610612747,Los Angeles Lakers,1,1,34,37,71,7,27,34,41,64,105,3,7,10,16,53,26,5,10,103,92
2022,2,22201021,3/13/2023,1610612737,Atlanta Hawks,1,0,1610612750,Minnesota Timberwolves,0,1,40,35,75,4,18,22,44,53,97,23,5,28,20,34,17,12,16,107,115
2022,2,22201087,3/22/2023,1610612755,Philadelphia 76ers,0,1,1610612741,Chicago Bulls,1,0,23,22,45,16,21,37,39,43,82,22,4,26,16,28,30,7,18,95,116
2022,2,22200030,10/22/2022,1610612738,Boston Celtics,0,1,1610612753,Orlando Magic,1,0,23,17,40,19,28,47,42,45,87,23,5,28,9,38,24,5,8,99,126
2022,2,22200030,10/22/2022,1610612753,Orlando Magic,1,0,1610612738,Boston Celtics,0,1,30,31,61,15,19,34,45,50,95,15,8,23,17,36,21,5,9,99,120
2017,2,21700316,11/30/2017,1610612749,Milwaukee Bucks,0,1,1610612757,Portland Trail Blazers,1,0,36,31,67,6,14,20,42,45,87,13,2,15,7,40,19,5,9,96,103
2017,2,21700316,11/30/2017,1610612757,Portland Trail Blazers,1,0,1610612749,Milwaukee Bucks,0,1,29,31,60,6,17,23,35,48,83,15,2,17,14,35,17,11,19,96,91
2016,2,21600832,2/14/2017,1610612750,Minnesota Timberwolves,1,0,1610612739,Cleveland Cavaliers,0,1,33,30,63,9,14,23,42,44,86,15,4,19,11,37,27,3,11,94,108
2016,2,21600331,12/8/2016,1610612750,Minnesota Timberwolves,0,0,1610612761,Toronto Raptors,1,1,36,24,60,9,19,28,45,43,88,11,4,15,19,27,19,5,14,92,110
2016,2,21600331,12/8/2016,1610612761,Toronto Raptors,1,1,1610612750,Minnesota Timberwolves,0,0,31,29,60,12,15,27,43,44,87,26,7,33,20,27,25,3,9,92,124
2022,2,22200248,11/21/2022,1610612737,Atlanta Hawks,0,0,1610612739,Cleveland Cavaliers,1,1,27,26,53,11,23,34,38,49,87,15,2,17,15,35,24,8,17,98,102
2022,2,22200892,2/23/2023,1610612762,Utah Jazz,1,1,1610612760,Oklahoma City Thunder,0,0,29,23,52,13,35,48,42,58,100,23,4,27,25,35,26,8,22,111,120
2017,2,21700315,11/30/2017,1610612741,Chicago Bulls,0,0,1610612743,Denver Nuggets,1,1,35,23,58,9,15,24,44,38,82,13,8,21,8,34,25,7,11,95,110
2017,2,21700315,11/30/2017,1610612743,Denver Nuggets,1,1,1610612741,Chicago Bulls,0,0,26,26,52,12,19,31,38,45,83,23,8,31,15,35,22,4,12,95,111
2016,2,21600831,2/14/2017,1610612741,Chicago Bulls,1,1,1610612761,Toronto Raptors,0,0,28,28,56,7,10,17,35,38,73,28,7,35,15,26,22,9,17,94,105
2022,2,22201088,3/22/2023,1610612745,Houston Rockets,0,0,1610612763,Memphis Grizzlies,1,1,36,24,60,12,21,33,48,45,93,17,6,23,22,26,27,8,16,97,125
2022,2,22200029,10/22/2022,1610612754,Indiana Pacers,1,1,1610612765,Detroit Pistons,0,0,29,32,61,16,26,42,45,58,103,18,6,24,23,39,28,5,11,102,124
2022,2,22200029,10/22/2022,1610612765,Detroit Pistons,0,0,1610612754,Indiana Pacers,1,1,19,34,53,18,24,42,37,58,95,23,7,30,23,39,26,7,14,101,115
2021,2,22100581,1/6/2022,1610612746,LA Clippers,0,0,1610612756,Phoenix Suns,1,1,25,33,58,6,22,28,31,55,86,21,4,25,14,43,20,5,13,97,89
2021,2,22100581,1/6/2022,1610612756,Phoenix Suns,1,1,1610612746,LA Clippers,0,0,34,42,76,10,21,31,44,63,107,8,2,10,23,42,22,5,8,97,106
2016,2,21600831,2/14/2017,1610612761,Toronto Raptors,0,0,1610612741,Chicago Bulls,1,1,30,27,57,5,15,20,35,42,77,19,5,24,13,31,15,8,18,93,94
2014,2,21400473,12/30/2014,1610612757,Portland Trail Blazers,1,1,1610612761,Toronto Raptors,0,0,26,33,59,12,24,36,38,57,95,14,4,18,20,38,21,10,15,100,102
2014,2,21400473,12/30/2014,1610612761,Toronto Raptors,0,0,1610612757,Portland Trail Blazers,1,1,36,41,77,4,18,22,40,59,99,13,2,15,18,42,14,5,10,98,97
2017,2,21700314,11/30/2017,1610612738,Boston Celtics,1,1,1610612755,Philadelphia 76ers,0,0,28,22,50,12,17,29,40,39,79,16,4,20,10,31,25,11,17,94,108
2017,2,21700314,11/30/2017,1610612755,Philadelphia 76ers,0,0,1610612738,Boston Celtics,1,1,19,33,52,16,16,32,35,49,84,11,7,18,19,34,24,7,19,93,97
2016,2,21600830,2/13/2017,1610612737,Atlanta Hawks,0,1,1610612757,Portland Trail Blazers,1,0,24,31,55,8,20,28,32,51,83,37,11,48,10,46,20,4,9,104,109
2016,2,21600830,2/13/2017,1610612757,Portland Trail Blazers,1,0,1610612737,Atlanta Hawks,0,1,21,40,61,16,26,42,37,66,103,14,11,25,29,45,22,9,17,104,104
2022,2,22201187,4/4/2023,1610612760,Oklahoma City Thunder,0,0,1610612744,Golden State Warriors,1,1,33,28,61,11,21,32,44,49,93,26,9,35,15,40,23,6,10,103,125
2022,2,22201081,3/21/2023,1610612738,Boston Celtics,0,1,1610612758,Sacramento Kings,1,0,31,17,48,18,26,44,49,43,92,16,7,23,14,33,33,3,6,94,132
2022,2,22200248,11/21/2022,1610612739,Cleveland Cavaliers,1,1,1610612737,Atlanta Hawks,0,0,32,19,51,10,9,19,42,28,70,20,3,23,4,25,24,11,20,96,114
2022,2,22201041,3/15/2023,1610612746,LA Clippers,1,1,1610612744,Golden State Warriors,0,0,30,32,62,16,18,34,46,50,96,26,6,32,19,31,30,5,8,102,134
2022,2,22201008,3/11/2023,1610612738,Boston Celtics,0,1,1610612737,Atlanta Hawks,1,0,32,21,53,20,22,42,52,43,95,10,2,12,9,35,35,4,9,103,134
2022,2,22200250,11/21/2022,1610612738,Boston Celtics,0,0,1610612741,Chicago Bulls,1,1,19,18,37,19,31,50,38,49,87,12,5,17,7,45,28,10,15,101,107
2022,2,22200250,11/21/2022,1610612741,Chicago Bulls,1,1,1610612738,Boston Celtics,0,0,32,28,60,14,15,29,46,43,89,15,5,20,13,34,26,3,15,102,121
2022,2,22200028,10/22/2022,1610612755,Philadelphia 76ers,1,0,1610612759,San Antonio Spurs,0,1,27,26,53,10,21,31,37,47,84,21,7,28,17,32,26,5,12,93,105
2022,2,22200028,10/22/2022,1610612759,San Antonio Spurs,0,1,1610612755,Philadelphia 76ers,1,0,27,24,51,16,22,38,43,46,89,12,3,15,17,32,27,6,14,93,114
2021,2,22100580,1/6/2022,1610612740,New Orleans Pelicans,1,1,1610612744,Golden State Warriors,0,0,27,22,49,8,26,34,35,48,83,23,6,29,14,38,20,12,17,101,101
2017,2,21700313,11/30/2017,1610612737,Atlanta Hawks,1,0,1610612739,Cleveland Cavaliers,0,1,29,19,48,12,19,31,41,38,79,20,4,24,11,30,24,9,18,99,114
2017,2,21700313,11/30/2017,1610612739,Cleveland Cavaliers,0,1,1610612737,Atlanta Hawks,1,0,23,17,40,18,21,39,41,38,79,21,6,27,13,25,30,9,20,98,121
2021,2,22100580,1/6/2022,1610612744,Golden State Warriors,0,0,1610612740,New Orleans Pelicans,1,1,30,24,54,7,26,33,37,50,87,15,3,18,11,39,22,7,14,100,96
2017,2,21700312,11/29/2017,1610612744,Golden State Warriors,0,1,1610612747,Los Angeles Lakers,1,0,35,29,64,12,18,30,47,47,94,21,7,28,18,32,30,12,22,112,127
2017,2,21700312,11/29/2017,1610612747,Los Angeles Lakers,1,0,1610612744,Golden State Warriors,0,1,38,33,71,9,15,24,47,48,95,20,5,25,10,40,30,10,17,114,123
2022,2,22200253,11/21/2022,1610612740,New Orleans Pelicans,1,1,1610612744,Golden State Warriors,0,0,34,15,49,15,27,42,49,42,91,15,6,21,14,33,30,9,14,101,128
2022,2,22200253,11/21/2022,1610612744,Golden State Warriors,0,0,1610612740,New Orleans Pelicans,1,1,18,13,31,10,33,43,28,46,74,17,2,19,8,39,17,15,27,100,83
2022,2,22201081,3/21/2023,1610612758,Sacramento Kings,1,0,1610612738,Boston Celtics,0,1,22,15,37,17,27,44,39,42,81,14,7,21,12,33,25,9,14,93,109
2022,2,22200252,11/21/2022,1610612748,Miami Heat,0,0,1610612750,Minnesota Timberwolves,1,1,24,28,52,11,27,38,35,55,90,20,10,30,17,40,26,9,15,104,101
2017,2,21700311,11/29/2017,1610612759,San Antonio Spurs,1,1,1610612763,Memphis Grizzlies,0,0,30,25,55,8,12,20,38,37,75,20,4,24,12,26,22,4,11,87,104
2017,2,21700311,11/29/2017,1610612763,Memphis Grizzlies,0,0,1610612759,San Antonio Spurs,1,1,24,31,55,11,11,22,35,42,77,14,2,16,15,29,21,9,17,87,95
2016,2,21600829,2/13/2017,1610612740,New Orleans Pelicans,0,1,1610612756,Phoenix Suns,1,0,29,21,50,8,20,28,37,41,78,28,7,35,10,32,19,7,16,99,110
2016,2,21600829,2/13/2017,1610612756,Phoenix Suns,1,0,1610612740,New Orleans Pelicans,0,1,32,38,70,8,15,23,40,53,93,20,4,24,22,33,14,8,19,100,108
2022,2,22201082,3/21/2023,1610612746,LA Clippers,1,0,1610612760,Oklahoma City Thunder,0,1,35,20,55,6,25,31,41,45,86,12,9,21,16,36,21,2,14,94,100
2022,2,22201127,3/27/2023,1610612740,New Orleans Pelicans,0,1,1610612757,Portland Trail Blazers,1,0,37,21,58,12,16,28,49,37,86,14,3,17,12,25,31,6,17,100,124
2022,2,22200252,11/21/2022,1610612750,Minnesota Timberwolves,1,1,1610612748,Miami Heat,0,0,23,15,38,14,33,47,37,48,85,17,3,20,9,39,30,9,18,104,105
2023,2,22300221,11/20/2023,1610612750,Minnesota Timberwolves,1,1,1610612752,New York Knicks,0,0,30,16,46,11,23,34,41,39,80,24,8,32,9,35,30,8,14,98,117
2014,2,21400099,11/10/2014,1610612754,Indiana Pacers,1,1,1610612762,Utah Jazz,0,0,33,42,75,6,9,15,39,51,90,13,2,15,17,34,16,5,7,88,97
2022,2,22200894,2/23/2023,1610612757,Portland Trail Blazers,0,0,1610612758,Sacramento Kings,1,1,27,28,55,16,22,38,43,50,93,14,3,17,13,38,26,9,13,102,116
2022,2,22201127,3/27/2023,1610612757,Portland Trail Blazers,1,0,1610612740,New Orleans Pelicans,0,1,28,29,57,7,26,33,35,55,90,13,2,15,11,45,15,5,12,99,90
2022,2,22200251,11/21/2022,1610612749,Milwaukee Bucks,1,1,1610612757,Portland Trail Blazers,0,0,38,20,58,9,19,28,47,39,86,16,9,25,11,31,31,5,14,100,119
2022,2,22200251,11/21/2022,1610612757,Portland Trail Blazers,0,0,1610612749,Milwaukee Bucks,1,1,36,28,64,8,21,29,44,49,93,15,4,19,15,36,19,12,16,102,111
2016,2,21600828,2/13/2017,1610612746,LA Clippers,0,1,1610612762,Utah Jazz,1,0,27,29,56,9,16,25,36,45,81,7,4,11,8,40,16,5,13,92,88
2016,2,21600828,2/13/2017,1610612762,Utah Jazz,1,0,1610612746,LA Clippers,0,1,24,40,64,4,19,23,28,59,87,12,6,18,17,45,14,7,11,93,72
2016,2,21600330,12/7/2016,1610612744,Golden State Warriors,0,1,1610612746,LA Clippers,1,0,35,23,58,7,24,31,42,47,89,24,5,29,16,34,32,3,10,99,115
2016,2,21600330,12/7/2016,1610612746,LA Clippers,1,0,1610612744,Golden State Warriors,0,1,28,38,66,8,18,26,36,56,92,18,6,24,20,36,15,11,13,98,98
2023,2,22300014,11/10/2023,1610612742,Dallas Mavericks,1,1,1610612746,LA Clippers,0,0,32,24,56,19,23,42,51,47,98,23,3,26,19,29,30,7,9,99,144
2023,2,22300220,11/20/2023,1610612741,Chicago Bulls,1,0,1610612748,Miami Heat,0,1,26,18,44,11,26,37,37,44,81,15,1,16,8,36,21,7,11,90,100
2022,2,22200894,2/23/2023,1610612758,Sacramento Kings,1,1,1610612757,Portland Trail Blazers,0,0,33,18,51,14,20,34,47,38,85,25,6,31,14,27,27,12,18,102,133
2022,2,22201080,3/21/2023,1610612759,San Antonio Spurs,0,0,1610612740,New Orleans Pelicans,1,1,17,29,46,13,28,41,30,57,87,11,8,19,13,48,22,8,16,98,84
2017,2,21700310,11/29/2017,1610612742,Dallas Mavericks,1,0,1610612751,Brooklyn Nets,0,1,30,27,57,9,18,27,39,45,84,17,4,21,7,41,26,5,11,98,104
2017,2,21700310,11/29/2017,1610612751,Brooklyn Nets,0,1,1610612742,Dallas Mavericks,1,0,31,30,61,11,18,29,42,48,90,14,11,25,17,38,25,5,14,98,109
2022,2,22200249,11/21/2022,1610612754,Indiana Pacers,1,1,1610612753,Orlando Magic,0,0,30,10,40,13,33,46,43,43,86,24,3,27,15,30,32,10,21,99,123
2023,2,22300223,11/20/2023,1610612759,San Antonio Spurs,1,0,1610612746,LA Clippers,0,1,29,23,52,10,28,38,39,51,90,11,3,14,13,41,23,15,16,99,99
2022,2,22200249,11/21/2022,1610612753,Orlando Magic,0,0,1610612754,Indiana Pacers,1,1,25,25,50,11,24,35,36,49,85,19,6,25,14,37,20,9,17,101,102
2022,2,22200254,11/21/2022,1610612752,New York Knicks,0,1,1610612760,Oklahoma City Thunder,1,0,40,23,63,11,23,34,51,46,97,16,4,20,19,31,21,5,15,105,129
2022,2,22200254,11/21/2022,1610612760,Oklahoma City Thunder,1,0,1610612752,New York Knicks,0,1,35,29,64,8,16,24,43,45,88,25,7,32,14,36,25,10,14,104,119
2022,2,22200893,2/23/2023,1610612744,Golden State Warriors,0,0,1610612747,Los Angeles Lakers,1,1,26,30,56,14,35,49,40,65,105,17,4,21,20,48,24,8,10,104,111
2022,2,22201006,3/11/2023,1610612765,Detroit Pistons,1,0,1610612754,Indiana Pacers,0,1,32,28,60,11,23,34,43,51,94,18,9,27,15,41,25,7,12,105,115
2017,2,21700309,11/29/2017,1610612740,New Orleans Pelicans,1,0,1610612750,Minnesota Timberwolves,0,1,25,24,49,14,21,35,39,45,84,10,1,11,10,35,27,10,17,94,102
2022,2,22201130,3/28/2023,1610612764,Washington Wizards,1,1,1610612738,Boston Celtics,0,0,41,21,62,13,24,37,54,45,99,9,4,13,15,32,33,5,11,101,130
2017,2,21700309,11/29/2017,1610612750,Minnesota Timberwolves,0,1,1610612740,New Orleans Pelicans,1,0,38,20,58,9,14,23,47,34,81,17,2,19,12,23,30,8,18,94,120
2022,2,22200255,11/21/2022,1610612746,LA Clippers,1,1,1610612762,Utah Jazz,0,0,38,29,67,9,15,24,47,44,91,18,1,19,16,29,26,8,16,97,121
2022,2,22200027,10/21/2022,1610612756,Phoenix Suns,0,0,1610612757,Portland Trail Blazers,1,1,33,34,67,10,17,27,43,51,94,15,6,21,15,38,31,8,17,107,111
2022,2,22200027,10/21/2022,1610612757,Portland Trail Blazers,1,1,1610612756,Phoenix Suns,0,0,26,27,53,10,19,29,36,46,82,31,5,36,15,34,14,14,21,105,113
2021,2,22100579,1/6/2022,1610612763,Memphis Grizzlies,1,1,1610612765,Detroit Pistons,0,0,38,28,66,10,22,32,48,50,98,12,7,19,22,31,31,7,19,103,118
2021,2,22100579,1/6/2022,1610612765,Detroit Pistons,0,0,1610612763,Memphis Grizzlies,1,1,24,31,55,10,34,44,34,65,99,10,3,13,14,53,23,8,13,103,88
2014,2,21400099,11/10/2014,1610612762,Utah Jazz,0,0,1610612754,Indiana Pacers,1,1,26,27,53,6,15,21,32,42,74,16,5,21,9,36,18,3,12,87,86
2022,2,22201024,3/13/2023,1610612745,Houston Rockets,1,1,1610612738,Boston Celtics,0,0,29,26,55,11,24,35,40,50,90,20,7,27,18,35,27,7,11,95,111
2022,2,22201024,3/13/2023,1610612738,Boston Celtics,0,0,1610612745,Houston Rockets,1,1,27,18,45,12,30,42,39,48,87,19,2,21,14,35,19,9,14,96,109
2021,2,22100578,1/6/2022,1610612738,Boston Celtics,0,0,1610612752,New York Knicks,1,1,21,14,35,17,28,45,38,42,80,12,1,13,10,33,22,8,13,89,105
2021,2,22100578,1/6/2022,1610612752,New York Knicks,1,1,1610612738,Boston Celtics,0,0,22,32,54,18,18,36,40,50,90,10,5,15,18,34,23,5,11,90,108
2019,2,21900479,12/28/2019,1610612739,Cleveland Cavaliers,0,1,1610612750,Minnesota Timberwolves,1,0,28,29,57,4,16,20,32,45,77,26,10,36,22,28,13,17,29,103,94
2022,2,22200255,11/21/2022,1610612762,Utah Jazz,0,0,1610612746,LA Clippers,1,1,28,23,51,12,26,38,40,49,89,22,2,24,20,30,22,6,17,98,114
2014,2,21401038,3/22/2015,1610612748,Miami Heat,0,0,1610612760,Oklahoma City Thunder,1,1,29,34,63,3,15,18,32,49,81,8,7,15,18,34,13,11,19,90,75
2022,2,22200893,2/23/2023,1610612747,Los Angeles Lakers,1,1,1610612744,Golden State Warriors,0,0,26,30,56,16,14,30,42,44,86,24,10,34,16,33,30,10,16,104,124
2022,2,22201007,3/11/2023,1610612748,Miami Heat,0,0,1610612753,Orlando Magic,1,1,31,26,57,11,26,37,42,52,94,19,1,20,13,40,19,10,18,110,114
2022,2,22200256,11/22/2022,1610612751,Brooklyn Nets,0,0,1610612755,Philadelphia 76ers,1,1,35,17,52,9,19,28,44,36,80,9,4,13,8,30,31,9,15,92,106
2022,2,22200256,11/22/2022,1610612755,Philadelphia 76ers,1,1,1610612751,Brooklyn Nets,0,0,27,40,67,16,16,32,43,56,99,13,3,16,24,33,19,5,10,93,115
2014,2,21401038,3/22/2015,1610612760,Oklahoma City Thunder,1,1,1610612748,Miami Heat,0,0,34,38,72,6,12,18,40,50,90,7,6,13,26,29,25,7,20,91,93
2014,2,21400472,12/30/2014,1610612750,Minnesota Timberwolves,0,0,1610612762,Utah Jazz,1,1,30,35,65,8,9,17,38,44,82,10,4,14,11,36,26,5,11,88,94
2023,2,22300872,3/3/2024,1610612738,Boston Celtics,1,1,1610612744,Golden State Warriors,0,0,28,19,47,25,24,49,53,43,96,9,2,11,9,35,35,2,8,101,140
2022,2,22200258,11/22/2022,1610612743,Denver Nuggets,1,0,1610612765,Detroit Pistons,0,1,38,29,67,5,14,19,43,43,86,17,9,26,19,29,28,7,18,95,108
2022,2,22201008,3/11/2023,1610612737,Atlanta Hawks,1,0,1610612738,Boston Celtics,0,1,40,26,66,10,24,34,50,50,100,15,1,16,14,37,24,6,10,103,125
2022,2,22200026,10/21/2022,1610612743,Denver Nuggets,0,1,1610612744,Golden State Warriors,1,0,31,21,52,15,19,34,46,40,86,21,4,25,12,30,30,10,20,106,128
2022,2,22200026,10/21/2022,1610612744,Golden State Warriors,1,0,1610612743,Denver Nuggets,0,1,27,17,44,15,29,44,42,46,88,24,3,27,14,34,34,10,19,107,123
2020,2,22000366,2/7/2021,1610612746,LA Clippers,1,0,1610612758,Sacramento Kings,0,1,33,38,71,8,20,28,41,58,99,20,3,23,18,42,19,5,10,101,110
2020,2,22000366,2/7/2021,1610612758,Sacramento Kings,0,1,1610612746,LA Clippers,1,0,36,29,65,10,19,29,46,48,94,11,4,15,13,38,25,8,12,101,113
2019,2,21900479,12/28/2019,1610612750,Minnesota Timberwolves,1,0,1610612739,Cleveland Cavaliers,0,1,25,31,56,8,29,37,33,60,93,14,5,19,17,47,17,9,18,104,88
2019,2,21900191,11/18/2019,1610612766,Charlotte Hornets,0,0,1610612761,Toronto Raptors,1,1,18,15,33,15,30,45,33,45,78,15,9,24,12,37,26,13,20,98,96
2017,2,21700308,11/29/2017,1610612745,Houston Rockets,1,1,1610612754,Indiana Pacers,0,0,24,22,46,18,22,40,42,44,86,16,5,21,13,32,26,9,15,99,118
2022,2,22200258,11/22/2022,1610612765,Detroit Pistons,0,1,1610612743,Denver Nuggets,1,0,37,23,60,8,20,28,45,43,88,12,2,14,15,28,27,7,16,95,110
2022,2,22200257,11/22/2022,1610612758,Sacramento Kings,0,1,1610612763,Memphis Grizzlies,1,0,24,21,45,15,30,45,39,51,90,20,7,27,15,38,27,12,20,108,113
2022,2,22200257,11/22/2022,1610612763,Memphis Grizzlies,1,0,1610612758,Sacramento Kings,0,1,33,28,61,8,22,30,41,50,91,19,11,30,15,40,26,11,18,107,109
2017,2,21700308,11/29/2017,1610612754,Indiana Pacers,0,0,1610612745,Houston Rockets,1,1,35,25,60,7,21,28,42,46,88,6,0,6,6,40,18,9,14,98,97
2022,2,22201007,3/11/2023,1610612753,Orlando Magic,1,1,1610612748,Miami Heat,0,0,35,27,62,13,24,37,48,51,99,17,3,20,18,35,34,8,18,110,126
2022,2,22201128,3/27/2023,1610612758,Sacramento Kings,1,0,1610612750,Minnesota Timberwolves,0,1,34,23,57,5,22,27,39,45,84,32,8,40,17,31,16,6,10,96,115
2022,2,22200259,11/22/2022,1610612747,Los Angeles Lakers,0,0,1610612756,Phoenix Suns,1,1,32,31,63,4,18,22,36,49,85,29,6,35,10,42,19,8,17,108,105
2021,2,22100577,1/5/2022,1610612737,Atlanta Hawks,0,1,1610612758,Sacramento Kings,1,0,31,25,56,8,22,30,39,47,86,22,8,30,12,39,20,6,10,98,108
2021,2,22100577,1/5/2022,1610612758,Sacramento Kings,1,0,1610612737,Atlanta Hawks,0,1,27,36,63,11,16,27,38,52,90,15,5,20,12,42,15,8,11,98,102
2022,2,22200259,11/22/2022,1610612756,Phoenix Suns,1,1,1610612747,Los Angeles Lakers,0,0,32,36,68,16,18,34,48,54,102,3,2,5,12,43,23,8,15,109,115
2020,2,22000685,3/26/2021,1610612738,Boston Celtics,0,1,1610612749,Milwaukee Bucks,1,0,21,20,41,22,25,47,43,45,88,14,2,16,10,37,27,7,15,100,122
2020,2,22000685,3/26/2021,1610612749,Milwaukee Bucks,1,0,1610612738,Boston Celtics,0,1,25,27,52,19,28,47,44,55,99,7,4,11,20,37,24,10,16,100,114
2022,2,22200260,11/23/2022,1610612755,Philadelphia 76ers,0,0,1610612766,Charlotte Hornets,1,1,29,19,48,9,29,38,38,48,86,16,2,18,13,36,20,8,19,101,101
2023,2,22300818,2/25/2024,1610612747,Los Angeles Lakers,0,0,1610612756,Phoenix Suns,1,1,32,23,55,15,20,35,47,43,90,4,4,8,8,38,28,6,12,99,113
2022,2,22200025,10/21/2022,1610612750,Minnesota Timberwolves,1,0,1610612762,Utah Jazz,0,1,38,36,74,11,22,33,49,58,107,17,6,23,25,36,20,11,20,112,126
2022,2,22200025,10/21/2022,1610612762,Utah Jazz,0,1,1610612750,Minnesota Timberwolves,1,0,29,32,61,20,30,50,49,62,111,14,7,21,24,43,39,5,13,112,132
2016,2,21600827,2/13/2017,1610612743,Denver Nuggets,1,1,1610612744,Golden State Warriors,0,0,24,23,47,24,17,41,48,40,88,12,4,16,15,26,34,12,22,101,132
2016,2,21600827,2/13/2017,1610612744,Golden State Warriors,0,0,1610612743,Denver Nuggets,1,1,37,23,60,8,24,32,45,47,92,12,1,13,5,42,25,6,9,102,110
2016,2,21600329,12/7/2016,1610612754,Indiana Pacers,0,1,1610612756,Phoenix Suns,1,0,28,27,55,7,16,23,35,43,78,32,9,41,14,33,16,14,18,103,109
2022,2,22200260,11/23/2022,1610612766,Charlotte Hornets,1,1,1610612755,Philadelphia 76ers,0,0,38,31,69,6,17,23,44,48,92,13,8,21,16,39,25,9,16,102,107
2022,2,22200024,10/21/2022,1610612745,Houston Rockets,1,0,1610612763,Memphis Grizzlies,0,1,28,30,58,16,19,35,44,49,93,18,12,30,20,36,18,8,14,102,122
2017,2,21700307,11/29/2017,1610612761,Toronto Raptors,1,1,1610612766,Charlotte Hornets,0,0,38,28,66,14,18,32,52,46,98,8,3,11,17,31,24,6,9,95,126
2017,2,21700307,11/29/2017,1610612766,Charlotte Hornets,0,0,1610612761,Toronto Raptors,1,1,28,32,60,9,10,19,37,42,79,30,5,35,14,31,26,6,13,96,113
2016,2,21600826,2/13/2017,1610612738,Boston Celtics,0,1,1610612742,Dallas Mavericks,1,0,24,23,47,16,18,34,40,41,81,15,3,18,9,33,28,7,12,92,111
2016,2,21600826,2/13/2017,1610612742,Dallas Mavericks,1,0,1610612738,Boston Celtics,0,1,26,24,50,9,18,27,35,42,77,19,6,25,8,38,21,5,12,93,98
2022,2,22200261,11/23/2022,1610612739,Cleveland Cavaliers,1,1,1610612757,Portland Trail Blazers,0,0,29,18,47,12,15,27,41,33,74,20,3,23,12,23,22,9,17,89,114
2022,2,22200261,11/23/2022,1610612757,Portland Trail Blazers,0,0,1610612739,Cleveland Cavaliers,1,1,22,25,47,13,18,31,35,43,78,13,0,13,12,31,28,4,17,87,96
2022,2,22201130,3/28/2023,1610612738,Boston Celtics,0,0,1610612764,Washington Wizards,1,1,34,15,49,11,33,44,45,48,93,10,1,11,11,37,29,7,12,100,111
2023,2,22300837,2/27/2024,1610612740,New Orleans Pelicans,0,1,1610612752,New York Knicks,1,0,21,22,43,18,16,34,39,38,77,19,4,23,12,28,23,6,15,90,115
2017,2,21700306,11/29/2017,1610612748,Miami Heat,0,0,1610612752,New York Knicks,1,1,22,24,46,10,28,38,32,52,84,12,8,20,13,45,21,10,15,96,86
2017,2,21700306,11/29/2017,1610612752,New York Knicks,1,1,1610612748,Miami Heat,0,0,39,21,60,5,8,13,44,29,73,22,4,26,8,23,26,13,20,96,115
2022,2,22200024,10/21/2022,1610612763,Memphis Grizzlies,0,1,1610612745,Houston Rockets,1,0,26,30,56,19,23,42,45,53,98,20,9,29,22,35,26,4,12,101,129
2021,2,22100576,1/5/2022,1610612748,Miami Heat,0,1,1610612757,Portland Trail Blazers,1,0,18,23,41,19,22,41,37,45,82,22,7,29,18,30,29,8,11,91,115
2021,2,22100576,1/5/2022,1610612757,Portland Trail Blazers,1,0,1610612748,Miami Heat,0,1,18,22,40,15,23,38,33,45,78,28,8,36,11,38,18,3,6,91,109
2016,2,21600329,12/7/2016,1610612756,Phoenix Suns,1,0,1610612754,Indiana Pacers,0,1,25,27,52,9,24,33,34,51,85,17,1,18,11,41,17,11,21,104,94
2019,2,21900478,12/28/2019,1610612745,Houston Rockets,1,1,1610612751,Brooklyn Nets,0,0,31,28,59,13,29,42,44,57,101,7,9,16,19,43,16,7,14,102,108
2019,2,21900478,12/28/2019,1610612751,Brooklyn Nets,0,0,1610612745,Houston Rockets,1,1,26,27,53,11,28,39,37,55,92,13,8,21,16,43,24,7,15,103,98
2022,2,22200262,11/23/2022,1610612750,Minnesota Timberwolves,0,1,1610612754,Indiana Pacers,1,0,39,16,55,8,14,22,47,30,77,13,4,17,10,21,31,16,23,99,115
2022,2,22201133,3/28/2023,1610612763,Memphis Grizzlies,1,1,1610612753,Orlando Magic,0,0,30,24,54,12,22,34,42,46,88,17,6,23,12,39,26,9,18,105,113
2022,2,22200262,11/23/2022,1610612754,Indiana Pacers,1,0,1610612750,Minnesota Timberwolves,0,1,21,31,52,16,28,44,37,59,96,11,5,16,18,42,25,9,13,100,101
2023,2,22300837,2/27/2024,1610612752,New York Knicks,1,0,1610612740,New Orleans Pelicans,0,1,17,20,37,14,32,46,31,52,83,16,7,23,17,37,27,4,13,90,92
2022,2,22200023,10/21/2022,1610612752,New York Knicks,1,1,1610612765,Detroit Pistons,0,0,34,23,57,16,22,38,50,45,95,14,8,22,14,36,29,6,12,103,130
2022,2,22200023,10/21/2022,1610612765,Detroit Pistons,0,0,1610612752,New York Knicks,1,1,30,24,54,9,27,36,39,51,90,19,13,32,18,40,26,4,15,103,106
2021,2,22100575,1/5/2022,1610612743,Denver Nuggets,1,0,1610612762,Utah Jazz,0,1,31,21,52,11,25,36,42,46,88,14,1,15,9,37,27,7,12,99,109
2021,2,22100575,1/5/2022,1610612762,Utah Jazz,0,1,1610612743,Denver Nuggets,1,0,29,22,51,14,27,41,43,49,92,15,3,18,9,40,22,2,7,99,115
2017,2,21700305,11/29/2017,1610612755,Philadelphia 76ers,1,1,1610612764,Washington Wizards,0,0,34,29,63,3,15,18,37,44,81,41,23,64,24,32,23,8,17,107,118
2022,2,22200263,11/23/2022,1610612737,Atlanta Hawks,1,1,1610612758,Sacramento Kings,0,0,30,32,62,11,19,30,41,51,92,22,1,23,13,39,23,6,13,102,115
2022,2,22200022,10/21/2022,1610612738,Boston Celtics,0,1,1610612748,Miami Heat,1,0,27,19,46,14,19,33,41,38,79,15,0,15,13,25,17,8,20,93,111
2022,2,22200022,10/21/2022,1610612748,Miami Heat,1,0,1610612738,Boston Celtics,0,1,34,32,66,8,18,26,42,50,92,12,3,15,16,35,23,4,10,94,104
2021,2,22100574,1/5/2022,1610612750,Minnesota Timberwolves,1,1,1610612760,Oklahoma City Thunder,0,0,24,22,46,12,32,44,36,54,90,14,6,20,19,38,23,11,16,96,98
2021,2,22100574,1/5/2022,1610612760,Oklahoma City Thunder,0,0,1610612750,Minnesota Timberwolves,1,1,24,31,55,9,26,35,33,57,90,15,3,18,19,40,21,11,18,97,90
2020,2,22000365,2/7/2021,1610612738,Boston Celtics,0,0,1610612756,Phoenix Suns,1,1,16,33,49,17,27,44,33,60,93,8,4,12,18,43,19,4,6,87,91
2022,2,22200263,11/23/2022,1610612758,Sacramento Kings,0,0,1610612737,Atlanta Hawks,1,1,32,26,58,9,22,31,41,48,89,15,6,21,15,39,27,9,19,103,106
2023,2,22300079,10/27/2023,1610612737,Atlanta Hawks,1,0,1610612752,New York Knicks,0,1,30,25,55,12,20,32,42,45,87,24,6,30,12,35,28,9,14,105,120
2022,2,22200021,10/21/2022,1610612751,Brooklyn Nets,1,1,1610612761,Toronto Raptors,0,0,25,20,45,13,22,35,38,42,80,20,9,29,13,34,26,9,13,94,109
2022,2,22200021,10/21/2022,1610612761,Toronto Raptors,0,0,1610612751,Brooklyn Nets,1,1,30,26,56,11,17,28,41,43,84,12,6,18,14,34,25,3,15,93,105
2021,2,22100573,1/5/2022,1610612749,Milwaukee Bucks,1,0,1610612761,Toronto Raptors,0,1,21,25,46,17,22,39,38,47,85,18,8,26,14,34,22,8,18,102,111
2021,2,22100573,1/5/2022,1610612761,Toronto Raptors,0,1,1610612749,Milwaukee Bucks,1,0,26,27,53,16,20,36,42,47,89,17,8,25,14,36,24,10,15,103,117
2020,2,22000684,3/26/2021,1610612756,Phoenix Suns,0,1,1610612761,Toronto Raptors,1,0,34,20,54,9,27,36,43,47,90,9,0,9,11,36,26,5,13,98,104
2020,2,22000684,3/26/2021,1610612761,Toronto Raptors,1,0,1610612756,Phoenix Suns,0,1,25,20,45,12,33,45,37,53,90,14,2,16,13,40,20,4,12,98,100
2017,2,21700305,11/29/2017,1610612764,Washington Wizards,0,0,1610612755,Philadelphia 76ers,1,1,27,40,67,9,13,22,36,53,89,32,5,37,11,44,22,6,11,106,113
2022,2,22200264,11/23/2022,1610612738,Boston Celtics,1,1,1610612742,Dallas Mavericks,0,0,28,22,50,17,17,34,45,39,84,18,3,21,8,31,29,4,12,97,125
2021,2,22100572,1/5/2022,1610612742,Dallas Mavericks,1,1,1610612744,Golden State Warriors,0,0,21,26,47,12,28,40,33,54,87,21,5,26,17,42,22,10,12,96,99
2021,2,22100572,1/5/2022,1610612744,Golden State Warriors,0,0,1610612742,Dallas Mavericks,1,1,28,25,53,5,23,28,33,48,81,11,5,16,11,40,20,6,17,94,82
2020,2,22000365,2/7/2021,1610612756,Phoenix Suns,1,1,1610612738,Boston Celtics,0,0,32,21,53,8,21,29,40,42,82,12,0,12,10,32,25,6,10,87,100
2016,2,21600825,2/13/2017,1610612754,Indiana Pacers,1,0,1610612759,San Antonio Spurs,0,1,29,29,58,9,11,20,38,40,78,21,9,30,7,38,21,7,11,96,106
2022,2,22200264,11/23/2022,1610612742,Dallas Mavericks,0,0,1610612738,Boston Celtics,1,1,33,18,51,11,20,31,44,38,82,13,8,21,9,33,20,4,14,96,112
2014,2,21400098,11/10/2014,1610612739,Cleveland Cavaliers,1,1,1610612740,New Orleans Pelicans,0,0,27,27,54,13,14,27,40,41,81,25,5,30,14,29,26,8,10,92,118
2022,2,22200020,10/21/2022,1610612737,Atlanta Hawks,1,1,1610612753,Orlando Magic,0,0,27,31,58,13,18,31,40,49,89,15,1,16,14,35,26,9,17,100,108
2022,2,22200020,10/21/2022,1610612753,Orlando Magic,0,0,1610612737,Atlanta Hawks,1,1,25,21,46,8,26,34,33,47,80,24,6,30,11,38,16,10,19,100,98
2023,2,22300230,11/22/2023,1610612761,Toronto Raptors,0,1,1610612754,Indiana Pacers,1,0,37,26,63,11,16,27,48,42,90,25,5,30,17,27,26,10,19,105,132
2014,2,21400098,11/10/2014,1610612740,New Orleans Pelicans,0,0,1610612739,Cleveland Cavaliers,1,1,29,37,66,12,15,27,41,52,93,17,3,20,18,36,31,3,7,92,111
2022,2,22201025,3/13/2023,1610612756,Phoenix Suns,0,0,1610612744,Golden State Warriors,1,1,42,32,74,4,17,21,46,49,95,16,6,22,20,32,25,8,14,98,112
2022,2,22201080,3/21/2023,1610612740,New Orleans Pelicans,1,1,1610612759,San Antonio Spurs,0,0,35,22,57,10,14,24,45,36,81,19,4,23,9,29,31,8,16,99,119
2022,2,22200265,11/23/2022,1610612748,Miami Heat,1,1,1610612764,Washington Wizards,0,0,23,29,52,16,25,41,39,54,93,19,3,22,18,38,20,7,13,99,113
2022,2,22200265,11/23/2022,1610612764,Washington Wizards,0,0,1610612748,Miami Heat,1,1,32,19,51,10,28,38,42,47,89,11,8,19,12,41,27,7,14,99,105
2014,2,21400472,12/30/2014,1610612762,Utah Jazz,1,1,1610612750,Minnesota Timberwolves,0,0,31,29,60,7,12,19,38,41,79,17,5,22,15,27,16,7,14,89,100
2022,2,22200266,11/23/2022,1610612751,Brooklyn Nets,0,1,1610612761,Toronto Raptors,1,0,28,16,44,17,21,38,45,37,82,5,2,7,9,29,32,12,21,97,112
2022,2,22200266,11/23/2022,1610612761,Toronto Raptors,1,0,1610612751,Brooklyn Nets,0,1,29,43,72,7,22,29,36,65,101,19,6,25,30,39,16,10,14,97,98
2022,2,22201026,3/13/2023,1610612758,Sacramento Kings,1,0,1610612749,Milwaukee Bucks,0,1,25,29,54,21,29,50,46,58,104,11,4,15,19,40,31,2,9,101,124
2022,2,22200267,11/23/2022,1610612741,Chicago Bulls,0,1,1610612749,Milwaukee Bucks,1,0,25,20,45,18,24,42,43,44,87,14,4,18,7,39,30,5,13,102,118
2022,2,22200267,11/23/2022,1610612749,Milwaukee Bucks,1,0,1610612741,Chicago Bulls,0,1,29,23,52,12,26,38,41,49,90,19,6,25,18,36,24,9,20,102,113
2016,2,21600825,2/13/2017,1610612759,San Antonio Spurs,0,1,1610612754,Indiana Pacers,1,0,33,39,72,7,8,15,40,47,87,23,4,27,16,33,18,8,11,95,110
2016,2,21600328,12/7/2016,1610612742,Dallas Mavericks,1,0,1610612758,Sacramento Kings,0,1,22,26,48,10,20,30,32,46,78,15,5,20,11,38,17,10,23,98,89
2016,2,21600328,12/7/2016,1610612758,Sacramento Kings,0,1,1610612742,Dallas Mavericks,1,0,37,25,62,10,12,22,47,37,84,16,5,21,8,30,28,7,14,99,120
2022,2,22200268,11/23/2022,1610612743,Denver Nuggets,0,1,1610612760,Oklahoma City Thunder,1,0,28,22,50,14,24,38,42,46,88,33,8,41,20,30,31,6,19,106,131
2022,2,22200268,11/23/2022,1610612760,Oklahoma City Thunder,1,0,1610612743,Denver Nuggets,0,1,24,33,57,18,22,40,42,55,97,24,4,28,16,40,26,4,10,104,126
2022,2,22200906,2/25/2023,1610612752,New York Knicks,1,1,1610612740,New Orleans Pelicans,0,0,26,14,40,19,29,48,45,43,88,19,4,23,14,30,24,11,19,104,128
2022,2,22201026,3/13/2023,1610612749,Milwaukee Bucks,0,1,1610612758,Sacramento Kings,1,0,35,18,53,15,18,33,50,36,86,18,4,22,7,32,29,4,13,102,133
2022,2,22200269,11/23/2022,1610612740,New Orleans Pelicans,0,1,1610612759,San Antonio Spurs,1,0,33,16,49,14,19,33,47,35,82,21,9,30,11,30,33,11,21,106,129
2022,2,22200269,11/23/2022,1610612759,San Antonio Spurs,1,0,1610612740,New Orleans Pelicans,0,1,31,20,51,10,24,34,41,44,85,18,10,28,13,37,31,8,20,106,110
2017,2,21700304,11/29/2017,1610612753,Orlando Magic,1,1,1610612760,Oklahoma City Thunder,0,0,32,14,46,13,17,30,45,31,76,18,8,26,5,30,28,8,14,97,121
2022,2,22201131,3/28/2023,1610612739,Cleveland Cavaliers,0,0,1610612737,Atlanta Hawks,1,1,38,30,68,9,16,25,47,46,93,15,7,22,13,37,20,5,8,100,118
2014,2,21400097,11/9/2014,1610612747,Los Angeles Lakers,1,1,1610612766,Charlotte Hornets,0,0,36,29,65,6,11,17,42,40,82,17,5,22,10,33,28,5,11,94,107
2014,2,21400097,11/9/2014,1610612766,Charlotte Hornets,0,0,1610612747,Los Angeles Lakers,1,1,32,33,65,3,11,14,35,44,79,19,8,27,14,31,15,8,14,93,92
2022,2,22200270,11/23/2022,1610612762,Utah Jazz,1,0,1610612765,Detroit Pistons,0,1,23,19,42,18,23,41,41,42,83,16,3,19,13,31,31,9,16,96,116
2019,2,21900477,12/28/2019,1610612737,Atlanta Hawks,0,0,1610612741,Chicago Bulls,1,1,23,29,52,9,25,34,32,54,86,8,3,11,14,42,24,13,21,100,81
2019,2,21900477,12/28/2019,1610612741,Chicago Bulls,1,1,1610612737,Atlanta Hawks,0,0,28,28,56,15,16,31,43,44,87,15,4,19,13,32,22,8,17,100,116
2020,2,22000683,3/26/2021,1610612751,Brooklyn Nets,0,1,1610612765,Detroit Pistons,1,0,24,27,51,13,20,33,37,47,84,26,8,34,18,33,19,6,10,93,113
2020,2,22000683,3/26/2021,1610612765,Detroit Pistons,1,0,1610612751,Brooklyn Nets,0,1,22,20,42,11,20,31,33,40,73,34,13,47,13,35,19,3,11,93,111
2022,2,22200569,1/4/2023,1610612749,Milwaukee Bucks,0,1,1610612761,Toronto Raptors,1,0,22,27,49,13,26,39,35,53,88,21,9,30,18,39,26,10,27,113,104
2022,2,22200569,1/4/2023,1610612761,Toronto Raptors,1,0,1610612749,Milwaukee Bucks,0,1,29,41,70,9,37,46,38,78,116,16,4,20,21,60,22,4,10,113,101
2022,2,22200270,11/23/2022,1610612765,Detroit Pistons,0,1,1610612762,Utah Jazz,1,0,32,33,65,12,12,24,44,45,89,25,2,27,14,32,24,4,7,94,125
2022,2,22200019,10/21/2022,1610612741,Chicago Bulls,0,0,1610612764,Washington Wizards,1,1,26,26,52,7,20,27,33,46,79,27,6,33,11,37,19,8,13,97,100
2022,2,22200019,10/21/2022,1610612764,Washington Wizards,1,1,1610612741,Chicago Bulls,0,0,31,23,54,10,16,26,41,39,80,10,1,11,7,32,26,8,17,96,102
2022,2,22201025,3/13/2023,1610612744,Golden State Warriors,1,1,1610612756,Phoenix Suns,0,0,26,18,44,19,20,39,45,38,83,14,10,24,11,33,28,8,16,98,123
2021,2,22100571,1/5/2022,1610612751,Brooklyn Nets,0,1,1610612754,Indiana Pacers,1,0,44,21,65,5,16,21,49,37,86,26,3,29,10,29,28,3,12,100,129
2021,2,22100571,1/5/2022,1610612754,Indiana Pacers,1,0,1610612751,Brooklyn Nets,0,1,28,15,43,13,26,39,41,41,82,26,2,28,10,31,26,13,17,101,121
2020,2,22000682,3/25/2021,1610612744,Golden State Warriors,0,0,1610612758,Sacramento Kings,1,1,28,28,56,17,15,32,45,43,88,12,0,12,10,33,24,6,12,97,119
2020,2,22000682,3/25/2021,1610612758,Sacramento Kings,1,1,1610612744,Golden State Warriors,0,0,34,17,51,19,19,38,53,36,89,16,3,19,7,31,28,4,6,96,141
2022,2,22201133,3/28/2023,1610612753,Orlando Magic,0,0,1610612763,Memphis Grizzlies,1,1,27,24,51,14,35,49,41,59,100,12,3,15,16,44,24,11,15,105,108
2022,2,22200271,11/23/2022,1610612744,Golden State Warriors,1,1,1610612746,LA Clippers,0,0,29,17,46,19,32,51,48,49,97,9,4,13,15,35,36,5,13,100,124
2014,2,21400096,11/9/2014,1610612743,Denver Nuggets,0,0,1610612757,Portland Trail Blazers,1,1,31,47,78,5,8,13,36,55,91,23,7,30,19,37,14,7,15,100,100
2022,2,22200271,11/23/2022,1610612746,LA Clippers,0,0,1610612744,Golden State Warriors,1,1,28,29,57,11,18,29,39,47,86,18,9,27,16,34,22,11,17,101,107
2014,2,21400096,11/9/2014,1610612757,Portland Trail Blazers,1,1,1610612743,Denver Nuggets,0,0,29,40,69,16,15,31,45,55,100,10,4,14,18,40,27,5,11,99,116
2022,2,22200272,11/25/2022,1610612750,Minnesota Timberwolves,0,0,1610612766,Charlotte Hornets,1,1,32,23,55,9,32,41,41,55,96,17,1,18,13,43,24,6,16,107,108
2020,2,22000364,2/7/2021,1610612748,Miami Heat,0,1,1610612752,New York Knicks,1,0,27,21,48,13,22,35,40,43,83,16,4,20,10,36,25,8,11,92,109
2020,2,22000364,2/7/2021,1610612752,New York Knicks,1,0,1610612748,Miami Heat,0,1,22,21,43,16,26,42,38,47,85,11,4,15,11,38,23,6,13,93,103
2017,2,21700304,11/29/2017,1610612760,Oklahoma City Thunder,0,0,1610612753,Orlando Magic,1,1,26,38,64,12,20,32,38,58,96,20,10,30,27,36,17,9,13,98,108
2020,2,22000681,3/25/2021,1610612747,Los Angeles Lakers,1,0,1610612755,Philadelphia 76ers,0,1,25,27,52,9,17,26,34,44,78,24,9,33,13,32,22,13,22,102,101
2020,2,22000681,3/25/2021,1610612755,Philadelphia 76ers,0,1,1610612747,Los Angeles Lakers,1,0,22,13,35,17,28,45,39,41,80,14,7,21,10,37,24,10,21,103,109
2022,2,22200272,11/25/2022,1610612766,Charlotte Hornets,1,1,1610612750,Minnesota Timberwolves,0,0,32,32,64,8,17,25,40,49,89,22,10,32,15,37,24,7,18,106,110
2014,2,21401037,3/22/2015,1610612739,Cleveland Cavaliers,0,1,1610612749,Milwaukee Bucks,1,0,29,24,53,13,18,31,42,42,84,11,5,16,10,34,22,10,13,94,108
2022,2,22200018,10/21/2022,1610612754,Indiana Pacers,1,0,1610612759,San Antonio Spurs,0,1,40,29,69,11,24,35,51,53,104,21,1,22,20,33,32,9,16,111,134
2014,2,21401037,3/22/2015,1610612749,Milwaukee Bucks,1,0,1610612739,Cleveland Cavaliers,0,1,35,23,58,3,9,12,38,32,70,11,3,14,7,28,23,14,23,93,90
2022,2,22201134,3/28/2023,1610612766,Charlotte Hornets,0,1,1610612760,Oklahoma City Thunder,1,0,38,21,59,14,21,35,52,42,94,19,11,30,15,33,34,11,18,109,137
2022,2,22200286,11/26/2022,1610612742,Dallas Mavericks,0,0,1610612761,Toronto Raptors,1,1,24,10,34,11,28,39,35,38,73,19,5,24,7,33,28,10,16,93,100
2022,2,22200286,11/26/2022,1610612761,Toronto Raptors,1,1,1610612742,Dallas Mavericks,0,0,30,32,62,8,18,26,38,50,88,21,5,26,20,33,20,7,13,93,105
2022,2,22200018,10/21/2022,1610612759,San Antonio Spurs,0,1,1610612754,Indiana Pacers,1,0,27,23,50,17,14,31,44,37,81,32,12,44,9,34,34,8,17,111,137
2021,2,22100570,1/5/2022,1610612738,Boston Celtics,1,0,1610612759,San Antonio Spurs,0,1,31,31,62,9,19,28,40,50,90,8,1,9,14,37,19,6,10,91,97
2021,2,22100570,1/5/2022,1610612759,San Antonio Spurs,0,1,1610612738,Boston Celtics,1,0,32,30,62,10,16,26,42,46,88,5,0,5,15,31,20,10,18,92,99
2023,2,22300251,11/26/2023,1610612761,Toronto Raptors,0,0,1610612739,Cleveland Cavaliers,1,1,29,28,57,8,24,32,37,52,89,20,9,29,17,39,17,2,12,98,102
2022,2,22201131,3/28/2023,1610612737,Atlanta Hawks,1,1,1610612739,Cleveland Cavaliers,0,0,29,33,62,12,15,27,41,48,89,26,7,33,19,32,25,5,15,99,120
2022,2,22200285,11/25/2022,1610612743,Denver Nuggets,0,1,1610612746,LA Clippers,1,0,34,25,59,10,20,30,44,45,89,16,7,23,14,33,27,1,6,92,114
2022,2,22200905,2/25/2023,1610612754,Indiana Pacers,0,1,1610612753,Orlando Magic,1,0,33,26,59,15,25,40,48,51,99,10,4,14,14,41,35,4,10,99,121
2014,2,21400095,11/9/2014,1610612744,Golden State Warriors,0,0,1610612756,Phoenix Suns,1,1,22,23,45,11,13,24,33,36,69,18,3,21,5,32,16,9,27,102,95
2014,2,21400095,11/9/2014,1610612756,Phoenix Suns,1,1,1610612744,Golden State Warriors,0,0,22,27,49,12,18,30,34,45,79,27,6,33,13,35,17,9,21,101,107
2022,2,22200285,11/25/2022,1610612746,LA Clippers,1,0,1610612743,Denver Nuggets,0,1,26,20,46,11,11,22,37,31,68,19,15,34,7,29,22,9,14,93,104
2022,2,22201132,3/28/2023,1610612761,Toronto Raptors,1,1,1610612748,Miami Heat,0,0,37,20,57,8,28,36,45,48,93,8,1,9,16,33,32,6,9,91,106
2022,2,22200287,11/26/2022,1610612745,Houston Rockets,1,1,1610612760,Oklahoma City Thunder,0,0,27,23,50,18,18,36,45,41,86,10,4,14,13,28,25,12,25,103,118
2022,2,22200287,11/26/2022,1610612760,Oklahoma City Thunder,0,0,1610612745,Houston Rockets,1,1,28,25,53,10,34,44,38,59,97,19,4,23,18,43,19,9,15,104,105
2022,2,22200905,2/25/2023,1610612753,Orlando Magic,1,0,1610612754,Indiana Pacers,0,1,29,32,61,6,23,29,35,55,90,32,6,38,21,36,16,9,14,100,108
2022,2,22200017,10/21/2022,1610612740,New Orleans Pelicans,0,1,1610612766,Charlotte Hornets,1,0,34,33,67,8,14,22,42,47,89,32,5,37,20,28,23,9,16,105,124
2022,2,22200017,10/21/2022,1610612766,Charlotte Hornets,1,0,1610612740,New Orleans Pelicans,0,1,31,32,63,13,21,34,44,53,97,11,3,14,14,39,30,9,14,103,112
2021,2,22100569,1/5/2022,1610612745,Houston Rockets,0,1,1610612764,Washington Wizards,1,0,31,28,59,9,17,26,40,45,85,25,7,32,13,35,15,9,21,107,114
2022,2,22201132,3/28/2023,1610612748,Miami Heat,0,0,1610612761,Toronto Raptors,1,1,22,25,47,10,23,33,32,48,80,18,1,19,15,33,18,8,16,91,92
2022,2,22201134,3/28/2023,1610612760,Oklahoma City Thunder,1,0,1610612766,Charlotte Hornets,0,1,39,27,66,11,19,30,50,46,96,23,6,29,11,38,25,6,11,110,134
2022,2,22200288,11/26/2022,1610612747,Los Angeles Lakers,0,1,1610612759,San Antonio Spurs,1,0,30,18,48,17,16,33,47,34,81,32,5,37,6,30,25,8,17,107,143
2014,2,21400094,11/9/2014,1610612742,Dallas Mavericks,1,0,1610612748,Miami Heat,0,1,26,28,54,9,20,29,35,48,83,17,7,24,18,32,22,7,13,92,96
2014,2,21400094,11/9/2014,1610612748,Miami Heat,0,1,1610612742,Dallas Mavericks,1,0,33,20,53,9,14,23,42,34,76,12,8,20,11,26,31,8,15,91,105
2021,2,22100569,1/5/2022,1610612764,Washington Wizards,1,0,1610612745,Houston Rockets,0,1,30,22,52,10,29,39,40,51,91,21,5,26,13,41,18,10,15,107,111
2020,2,22000363,2/7/2021,1610612754,Indiana Pacers,1,0,1610612762,Utah Jazz,0,1,29,35,64,8,21,29,37,56,93,13,5,18,14,46,23,2,9,97,95
2022,2,22200904,2/25/2023,1610612766,Charlotte Hornets,1,1,1610612748,Miami Heat,0,0,28,29,57,10,21,31,38,50,88,22,5,27,12,39,20,7,15,104,108
2014,2,21400093,11/9/2014,1610612755,Philadelphia 76ers,0,0,1610612761,Toronto Raptors,1,1,23,30,53,10,24,34,33,54,87,12,6,18,18,40,19,12,20,97,88
2022,2,22200288,11/26/2022,1610612759,San Antonio Spurs,1,0,1610612747,Los Angeles Lakers,0,1,35,33,68,18,19,37,53,52,105,14,6,20,18,37,33,4,10,106,138
2022,2,22200906,2/25/2023,1610612740,New Orleans Pelicans,0,0,1610612752,New York Knicks,1,1,32,32,64,8,30,38,40,62,102,18,3,21,16,49,25,1,7,102,106
2022,2,22200904,2/25/2023,1610612748,Miami Heat,0,0,1610612766,Charlotte Hornets,1,1,21,23,44,11,25,36,32,48,80,28,6,34,11,39,24,10,18,104,103
2022,2,22200289,11/26/2022,1610612756,Phoenix Suns,1,1,1610612762,Utah Jazz,0,0,36,34,70,6,16,22,42,50,92,23,7,30,19,35,23,5,6,93,113
2014,2,21400093,11/9/2014,1610612761,Toronto Raptors,1,1,1610612755,Philadelphia 76ers,0,0,36,23,59,7,10,17,43,33,76,27,3,30,12,22,23,11,20,97,120
2022,2,22200289,11/26/2022,1610612762,Utah Jazz,0,0,1610612756,Phoenix Suns,1,1,27,20,47,13,19,32,40,39,79,19,6,25,10,33,20,8,12,93,112
2017,2,21700303,11/29/2017,1610612756,Phoenix Suns,0,0,1610612765,Detroit Pistons,1,1,32,30,62,7,15,22,39,45,84,22,6,28,10,38,21,11,21,108,107
2021,2,22100568,1/5/2022,1610612753,Orlando Magic,1,0,1610612755,Philadelphia 76ers,0,1,28,23,51,12,27,39,40,50,90,14,6,20,17,35,22,8,19,100,106
2022,2,22200290,11/27/2022,1610612751,Brooklyn Nets,1,1,1610612757,Portland Trail Blazers,0,0,26,17,43,15,20,35,41,37,78,14,4,18,5,33,27,4,8,89,111
2022,2,22201038,3/15/2023,1610612745,Houston Rockets,1,1,1610612747,Los Angeles Lakers,0,0,39,21,60,8,21,29,47,42,89,12,7,19,17,28,22,7,18,102,114
2022,2,22200290,11/27/2022,1610612757,Portland Trail Blazers,0,0,1610612751,Brooklyn Nets,1,1,23,23,46,12,21,33,35,44,79,15,7,22,14,34,27,6,13,89,97
2021,2,22100568,1/5/2022,1610612755,Philadelphia 76ers,0,1,1610612753,Orlando Magic,1,0,31,26,57,12,16,28,43,42,85,18,6,24,11,35,26,9,17,101,116
2020,2,22000363,2/7/2021,1610612762,Utah Jazz,0,1,1610612754,Indiana Pacers,1,0,25,25,50,13,29,42,38,54,92,14,7,21,18,39,22,9,14,97,103
2019,2,21900476,12/28/2019,1610612752,New York Knicks,0,1,1610612764,Washington Wizards,1,0,27,27,54,11,20,31,38,47,85,20,6,26,15,36,25,15,22,103,107
2019,2,21900476,12/28/2019,1610612764,Washington Wizards,1,0,1610612752,New York Knicks,0,1,23,48,71,10,15,25,33,63,96,24,7,31,18,47,16,5,12,105,100
2017,2,21700303,11/29/2017,1610612765,Detroit Pistons,1,1,1610612756,Phoenix Suns,0,0,38,23,61,13,15,28,51,38,89,16,5,21,9,33,31,11,19,109,131
2014,2,21400092,11/9/2014,1610612758,Sacramento Kings,0,0,1610612760,Oklahoma City Thunder,1,1,30,26,56,6,18,24,36,44,80,15,7,22,12,35,23,5,12,90,93
2014,2,21400092,11/9/2014,1610612760,Oklahoma City Thunder,1,1,1610612758,Sacramento Kings,0,0,30,30,60,6,12,18,36,42,78,23,4,27,12,32,16,11,14,91,101
2020,2,22000680,3/25/2021,1610612746,LA Clippers,0,1,1610612759,San Antonio Spurs,1,0,21,34,55,13,21,34,34,55,89,17,1,18,17,39,16,4,10,91,98
2020,2,22000680,3/25/2021,1610612759,San Antonio Spurs,1,0,1610612746,LA Clippers,0,1,25,34,59,8,15,23,33,49,82,11,2,13,3,47,16,6,7,92,85
2021,2,22100567,1/5/2022,1610612765,Detroit Pistons,0,0,1610612766,Charlotte Hornets,1,1,29,21,50,14,28,42,43,49,92,11,9,20,11,41,26,6,13,103,111
2021,2,22100567,1/5/2022,1610612766,Charlotte Hornets,1,1,1610612765,Detroit Pistons,0,0,24,15,39,24,18,42,48,33,81,20,9,29,10,28,39,12,17,103,140
2020,2,22000362,4/18/2021,1610612757,Portland Trail Blazers,0,0,1610612766,Charlotte Hornets,1,1,26,29,55,10,26,36,36,55,91,19,9,28,17,43,18,6,9,95,101
2022,2,22200291,11/27/2022,1610612744,Golden State Warriors,0,1,1610612750,Minnesota Timberwolves,1,0,30,10,40,20,27,47,50,37,87,17,3,20,9,29,36,7,16,104,137
2022,2,22200291,11/27/2022,1610612750,Minnesota Timberwolves,1,0,1610612744,Golden State Warriors,0,1,25,28,53,14,21,35,39,49,88,22,7,29,10,42,22,7,14,104,114
2023,2,22300179,11/12/2023,1610612763,Memphis Grizzlies,0,1,1610612746,LA Clippers,1,0,24,23,47,13,28,41,37,51,88,18,6,24,18,34,25,9,16,97,105
2023,2,22300236,11/22/2023,1610612744,Golden State Warriors,0,0,1610612756,Phoenix Suns,1,1,33,25,58,10,22,32,43,47,90,19,10,29,19,34,29,9,16,101,115
2022,2,22200292,11/27/2022,1610612746,LA Clippers,1,1,1610612754,Indiana Pacers,0,0,36,26,62,6,26,32,42,52,94,24,8,32,21,33,33,14,18,106,114
2022,2,22201213,4/8/2023,1610612743,Denver Nuggets,0,0,1610612762,Utah Jazz,1,1,26,18,44,15,31,46,41,49,90,17,7,24,8,44,32,9,14,105,114
2022,2,22200292,11/27/2022,1610612754,Indiana Pacers,0,0,1610612746,LA Clippers,1,1,27,25,52,9,33,42,36,58,94,19,4,23,12,47,23,7,13,107,100
2020,2,22000362,4/18/2021,1610612766,Charlotte Hornets,1,1,1610612757,Portland Trail Blazers,0,0,21,19,40,18,25,43,39,44,83,13,4,17,11,35,26,7,14,95,109
2023,2,22300115,11/1/2023,1610612765,Detroit Pistons,1,0,1610612757,Portland Trail Blazers,0,1,29,32,61,11,18,29,40,50,90,10,1,11,9,42,24,10,18,105,101
2023,2,22300801,2/22/2024,1610612766,Charlotte Hornets,0,1,1610612762,Utah Jazz,1,0,20,30,50,20,22,42,40,52,92,15,7,22,16,40,28,3,10,97,115
2023,2,22300228,11/22/2023,1610612749,Milwaukee Bucks,0,0,1610612738,Boston Celtics,1,1,32,35,67,13,21,34,45,56,101,13,4,17,17,40,23,3,9,101,116
2022,2,22201035,3/15/2023,1610612755,Philadelphia 76ers,0,1,1610612739,Cleveland Cavaliers,1,0,22,17,39,17,19,36,39,36,75,23,4,27,16,21,24,6,20,91,118
2022,2,22201010,3/11/2023,1610612763,Memphis Grizzlies,1,1,1610612742,Dallas Mavericks,0,0,31,17,48,10,28,38,41,45,86,20,4,24,12,35,25,4,11,95,112
2022,2,22200293,11/27/2022,1610612737,Atlanta Hawks,1,0,1610612748,Miami Heat,0,1,25,27,52,10,26,36,35,53,88,18,1,19,11,43,24,8,12,97,98
2022,2,22200293,11/27/2022,1610612748,Miami Heat,0,1,1610612737,Atlanta Hawks,1,0,31,18,49,9,24,33,40,42,82,17,2,19,7,37,28,6,14,97,106
2014,2,21400091,11/9/2014,1610612762,Utah Jazz,0,1,1610612765,Detroit Pistons,1,0,27,30,57,6,9,15,33,39,72,25,10,35,10,33,20,6,12,91,97
2014,2,21400091,11/9/2014,1610612765,Detroit Pistons,1,0,1610612762,Utah Jazz,0,1,30,40,70,6,17,23,36,57,93,18,7,25,26,36,19,7,11,92,96
2022,2,22200294,11/27/2022,1610612738,Boston Celtics,1,1,1610612764,Washington Wizards,0,0,28,18,46,16,18,34,44,36,80,26,0,26,13,23,25,8,14,93,130
2021,2,22100566,1/4/2022,1610612747,Los Angeles Lakers,1,1,1610612758,Sacramento Kings,0,0,38,29,67,11,21,32,49,50,99,13,7,20,17,37,24,2,5,98,122
2021,2,22100566,1/4/2022,1610612758,Sacramento Kings,0,0,1610612747,Los Angeles Lakers,1,1,29,20,49,14,20,34,43,40,83,14,4,18,11,31,31,6,18,99,114
2020,2,22000361,2/6/2021,1610612747,Los Angeles Lakers,1,1,1610612765,Detroit Pistons,0,0,42,30,72,9,10,19,51,40,91,24,4,28,13,27,32,13,24,116,135
2020,2,22000361,2/6/2021,1610612765,Detroit Pistons,0,0,1610612747,Los Angeles Lakers,1,1,29,23,52,16,26,42,45,49,94,23,5,28,16,33,31,12,23,116,129
2022,2,22200294,11/27/2022,1610612764,Washington Wizards,0,0,1610612738,Boston Celtics,1,1,37,17,54,7,21,28,44,38,82,26,7,33,9,32,23,2,4,94,121
2022,2,22201039,3/15/2023,1610612750,Minnesota Timberwolves,1,0,1610612738,Boston Celtics,0,1,25,23,48,12,24,36,37,47,84,16,6,22,13,38,27,7,13,96,102
2014,2,21400471,12/30/2014,1610612743,Denver Nuggets,1,0,1610612747,Los Angeles Lakers,0,1,31,30,61,8,18,26,39,48,87,17,10,27,14,40,25,6,11,96,103
2014,2,21400471,12/30/2014,1610612747,Los Angeles Lakers,0,1,1610612743,Denver Nuggets,1,0,26,25,51,14,11,25,40,36,76,17,9,26,12,29,31,13,20,96,111
2020,2,22000679,3/25/2021,1610612752,New York Knicks,1,1,1610612764,Washington Wizards,0,0,27,38,65,7,21,28,34,59,93,31,11,42,24,41,14,8,15,103,106
2020,2,22000679,3/25/2021,1610612764,Washington Wizards,0,0,1610612752,New York Knicks,1,1,29,25,54,8,18,26,37,43,80,20,13,33,11,39,26,12,17,102,102
2023,2,22300161,11/8/2023,1610612752,New York Knicks,1,1,1610612759,San Antonio Spurs,0,0,27,31,58,19,23,42,46,54,100,15,7,22,18,37,28,2,4,97,126
2022,2,22201035,3/15/2023,1610612739,Cleveland Cavaliers,1,0,1610612755,Philadelphia 76ers,0,1,26,18,44,14,27,41,40,45,85,15,7,22,15,34,20,8,12,90,109
2022,2,22201091,3/22/2023,1610612757,Portland Trail Blazers,0,1,1610612762,Utah Jazz,1,0,32,20,52,13,28,41,45,48,93,24,6,30,9,41,28,4,9,108,127
2022,2,22200295,11/27/2022,1610612739,Cleveland Cavaliers,0,1,1610612765,Detroit Pistons,1,0,25,24,49,8,20,28,33,44,77,28,5,33,15,32,14,9,14,93,102
2022,2,22200295,11/27/2022,1610612765,Detroit Pistons,1,0,1610612739,Cleveland Cavaliers,0,1,28,23,51,8,20,28,36,43,79,14,12,26,15,34,14,3,16,93,94
2020,2,22000360,2/6/2021,1610612742,Dallas Mavericks,1,1,1610612744,Golden State Warriors,0,0,23,26,49,21,26,47,44,52,96,25,5,30,17,38,27,11,14,105,134
2020,2,22000360,2/6/2021,1610612744,Golden State Warriors,0,0,1610612742,Dallas Mavericks,1,1,26,15,41,20,25,45,46,40,86,20,3,23,7,35,27,5,16,105,132
2019,2,21900475,12/28/2019,1610612748,Miami Heat,1,1,1610612755,Philadelphia 76ers,0,0,32,34,66,10,18,28,42,52,94,23,6,29,13,41,26,5,8,102,117
2023,2,22300079,10/27/2023,1610612752,New York Knicks,0,1,1610612737,Atlanta Hawks,1,0,23,23,46,20,24,44,43,47,90,20,8,28,15,36,30,7,16,105,126
2022,2,22201010,3/11/2023,1610612742,Dallas Mavericks,0,0,1610612763,Memphis Grizzlies,1,1,24,18,42,15,28,43,39,46,85,15,8,23,13,36,25,7,11,95,108
2022,2,22200296,11/27/2022,1610612752,New York Knicks,1,0,1610612763,Memphis Grizzlies,0,1,34,23,57,10,20,30,44,43,87,25,5,30,12,35,30,4,8,97,123
2023,2,22300784,2/14/2024,1610612740,New Orleans Pelicans,1,1,1610612764,Washington Wizards,0,0,40,17,57,10,22,32,50,39,89,23,6,29,11,30,36,7,10,102,133
2022,2,22200296,11/27/2022,1610612763,Memphis Grizzlies,0,1,1610612752,New York Knicks,1,0,34,29,63,12,20,32,46,49,95,23,8,31,21,32,32,3,11,98,127
2022,2,22201037,3/15/2023,1610612741,Chicago Bulls,1,0,1610612758,Sacramento Kings,0,1,22,33,55,16,26,42,38,59,97,22,3,25,20,42,28,6,15,103,114
2021,2,22100565,1/4/2022,1610612740,New Orleans Pelicans,1,0,1610612756,Phoenix Suns,0,1,26,30,56,10,23,33,36,53,89,28,4,32,19,37,28,7,12,98,110
2021,2,22100565,1/4/2022,1610612756,Phoenix Suns,0,1,1610612740,New Orleans Pelicans,1,0,29,25,54,17,14,31,46,39,85,14,6,20,7,34,32,7,11,98,123
2020,2,22000359,2/6/2021,1610612750,Minnesota Timberwolves,0,0,1610612760,Oklahoma City Thunder,1,1,35,22,57,12,24,36,47,46,93,12,10,22,15,38,27,8,14,101,118
2020,2,22000359,2/6/2021,1610612760,Oklahoma City Thunder,1,1,1610612750,Minnesota Timberwolves,0,0,34,23,57,12,21,33,46,44,90,16,4,20,15,30,25,12,16,102,120
2019,2,21900475,12/28/2019,1610612755,Philadelphia 76ers,0,0,1610612748,Miami Heat,1,1,32,27,59,10,20,30,42,47,89,22,7,29,11,38,24,6,11,103,116
2014,2,21400470,12/30/2014,1610612742,Dallas Mavericks,1,1,1610612764,Washington Wizards,0,0,35,32,67,8,7,15,43,39,82,20,9,29,5,39,21,5,7,97,114
2014,2,21400470,12/30/2014,1610612764,Washington Wizards,0,0,1610612742,Dallas Mavericks,1,1,29,33,62,4,8,12,33,41,74,17,10,27,13,34,22,11,23,96,87
2023,2,22300116,11/1/2023,1610612749,Milwaukee Bucks,0,0,1610612761,Toronto Raptors,1,1,22,20,42,13,21,34,35,41,76,28,10,38,10,36,19,7,12,95,111
2020,2,22000678,3/25/2021,1610612748,Miami Heat,1,0,1610612757,Portland Trail Blazers,0,1,31,19,50,16,18,34,47,37,84,12,1,13,6,32,34,3,11,94,122
2020,2,22000678,3/25/2021,1610612757,Portland Trail Blazers,0,1,1610612748,Miami Heat,1,0,24,22,46,20,26,46,44,48,92,17,2,19,14,35,24,3,11,95,125
2023,2,22300179,11/12/2023,1610612746,LA Clippers,1,0,1610612763,Memphis Grizzlies,0,1,25,26,51,12,22,34,37,48,85,15,8,23,17,33,26,7,16,97,101
2022,2,22201009,3/11/2023,1610612745,Houston Rockets,1,0,1610612741,Chicago Bulls,0,1,25,26,51,16,18,34,41,44,85,13,4,17,12,35,28,7,16,98,111
2022,2,22200297,11/27/2022,1610612753,Orlando Magic,1,0,1610612755,Philadelphia 76ers,0,1,24,15,39,12,28,40,36,43,79,19,6,25,9,38,21,10,16,97,103
2022,2,22201091,3/22/2023,1610612762,Utah Jazz,1,0,1610612757,Portland Trail Blazers,0,1,28,19,47,11,24,35,39,43,82,26,10,36,8,40,24,9,17,107,115
2022,2,22200297,11/27/2022,1610612755,Philadelphia 76ers,0,1,1610612753,Orlando Magic,1,0,39,11,50,11,16,27,50,27,77,22,5,27,7,22,32,9,16,98,133
2017,2,21700302,11/28/2017,1610612749,Milwaukee Bucks,0,1,1610612758,Sacramento Kings,1,0,33,16,49,9,13,22,42,29,71,19,12,31,2,32,27,5,12,95,112
2020,2,22000677,3/24/2021,1610612737,Atlanta Hawks,0,0,1610612758,Sacramento Kings,1,1,34,26,60,7,18,25,41,44,85,19,4,23,13,32,17,5,13,97,108
2020,2,22000677,3/24/2021,1610612758,Sacramento Kings,1,1,1610612737,Atlanta Hawks,0,0,30,24,54,10,20,30,40,44,84,20,2,22,13,33,21,5,16,97,110
2022,2,22200298,11/27/2022,1610612742,Dallas Mavericks,0,0,1610612749,Milwaukee Bucks,1,1,24,15,39,17,24,41,41,39,80,16,9,25,9,34,23,8,13,96,115
2022,2,22200298,11/27/2022,1610612749,Milwaukee Bucks,1,1,1610612742,Dallas Mavericks,0,0,31,18,49,17,20,37,48,38,86,11,4,15,11,29,28,6,14,96,124
2021,2,22100564,1/4/2022,1610612752,New York Knicks,1,1,1610612754,Indiana Pacers,0,0,33,19,52,6,22,28,39,41,80,20,8,28,14,28,17,3,10,88,104
2021,2,22100564,1/4/2022,1610612754,Indiana Pacers,0,0,1610612752,New York Knicks,1,1,23,15,38,9,29,38,32,44,76,21,11,32,13,38,22,6,12,89,94
2017,2,21700302,11/28/2017,1610612758,Sacramento Kings,1,0,1610612749,Milwaukee Bucks,0,1,26,34,60,5,12,17,31,46,77,20,9,29,13,37,15,13,18,96,87
2014,2,21400090,11/9/2014,1610612751,Brooklyn Nets,1,1,1610612753,Orlando Magic,0,0,36,33,69,4,10,14,40,43,83,20,3,23,17,28,23,7,15,93,104
2022,2,22200604,1/8/2023,1610612737,Atlanta Hawks,0,1,1610612746,LA Clippers,1,0,36,27,63,8,18,26,44,45,89,16,4,20,8,40,22,6,9,100,112
2022,2,22200604,1/8/2023,1610612746,LA Clippers,1,0,1610612737,Atlanta Hawks,0,1,27,38,65,10,20,30,37,58,95,24,7,31,22,38,25,7,11,100,108
2016,2,21600327,12/7/2016,1610612739,Cleveland Cavaliers,0,1,1610612752,New York Knicks,1,0,17,23,40,22,18,40,39,41,80,26,5,31,12,31,23,6,12,96,126
2016,2,21600327,12/7/2016,1610612752,New York Knicks,1,0,1610612739,Cleveland Cavaliers,0,1,24,32,56,11,20,31,35,52,87,13,2,15,16,38,22,11,16,95,94
2020,2,22000676,3/24/2021,1610612751,Brooklyn Nets,0,0,1610612762,Utah Jazz,1,1,28,34,62,7,28,35,35,62,97,11,4,15,17,47,19,6,9,97,88
2020,2,22000676,3/24/2021,1610612762,Utah Jazz,1,1,1610612751,Brooklyn Nets,0,0,18,18,36,23,32,55,41,50,91,13,1,14,13,38,24,9,13,97,118
2022,2,22201135,3/28/2023,1610612744,Golden State Warriors,1,1,1610612740,New Orleans Pelicans,0,0,25,17,42,18,22,40,43,39,82,16,6,22,12,31,32,6,19,97,120
2014,2,21400090,11/9/2014,1610612753,Orlando Magic,0,0,1610612751,Brooklyn Nets,1,1,31,29,60,8,7,15,39,36,75,10,6,16,7,32,25,10,17,92,96
2022,2,22201009,3/11/2023,1610612741,Chicago Bulls,0,1,1610612745,Houston Rockets,1,0,29,25,54,15,17,32,44,42,86,16,6,22,14,29,25,10,14,96,119
2022,2,22200299,11/28/2022,1610612737,Atlanta Hawks,0,0,1610612755,Philadelphia 76ers,1,1,25,22,47,12,15,27,37,37,74,15,7,22,11,28,26,10,20,94,101
2022,2,22200299,11/28/2022,1610612755,Philadelphia 76ers,1,1,1610612737,Atlanta Hawks,0,0,29,29,58,10,18,28,39,47,86,16,2,18,11,36,23,7,12,95,104
2021,2,22100563,1/4/2022,1610612759,San Antonio Spurs,0,0,1610612761,Toronto Raptors,1,1,32,28,60,9,26,35,41,54,95,13,6,19,19,37,27,13,20,105,104
2021,2,22100563,1/4/2022,1610612761,Toronto Raptors,1,1,1610612759,San Antonio Spurs,0,0,27,25,52,18,26,44,45,51,96,21,8,29,18,39,30,6,12,105,129
2023,2,22300228,11/22/2023,1610612738,Boston Celtics,1,1,1610612749,Milwaukee Bucks,0,0,27,15,42,17,25,42,44,40,84,14,3,17,6,36,27,9,15,101,119
2022,2,22201135,3/28/2023,1610612740,New Orleans Pelicans,0,0,1610612744,Golden State Warriors,1,1,30,33,63,12,15,27,42,48,90,13,1,14,15,33,30,11,19,99,109
2023,2,22300238,11/22/2023,1610612742,Dallas Mavericks,0,1,1610612747,Los Angeles Lakers,1,0,22,24,46,16,34,50,38,58,96,12,4,16,13,47,21,1,4,95,104
2023,2,22300259,11/29/2023,1610612753,Orlando Magic,1,1,1610612764,Washington Wizards,0,0,34,23,57,17,10,27,51,33,84,20,4,24,12,22,34,14,19,101,139
2023,2,22300784,2/14/2024,1610612764,Washington Wizards,0,0,1610612740,New Orleans Pelicans,1,1,23,24,47,21,24,45,44,48,92,17,3,20,18,32,35,14,19,102,126
2020,2,22000675,3/24/2021,1610612746,LA Clippers,0,1,1610612759,San Antonio Spurs,1,0,32,23,55,17,16,33,49,39,88,19,11,30,8,37,23,6,8,101,134
2020,2,22000675,3/24/2021,1610612759,San Antonio Spurs,1,0,1610612746,LA Clippers,0,1,32,31,63,7,15,22,39,46,85,16,3,19,8,39,22,10,16,101,101
2022,2,22200300,11/28/2022,1610612750,Minnesota Timberwolves,0,0,1610612764,Washington Wizards,1,1,35,22,57,7,20,27,42,42,84,36,6,42,18,28,20,12,18,104,127
2021,2,22100562,1/4/2022,1610612739,Cleveland Cavaliers,1,0,1610612763,Memphis Grizzlies,0,1,30,28,58,10,24,34,40,52,92,16,5,21,19,35,28,6,13,96,106
2017,2,21700301,11/28/2017,1610612743,Denver Nuggets,0,0,1610612762,Utah Jazz,1,1,21,23,44,7,27,34,28,50,78,14,2,16,14,38,13,7,18,90,77
2017,2,21700301,11/28/2017,1610612762,Utah Jazz,1,1,1610612743,Denver Nuggets,0,0,28,27,55,14,18,32,42,45,87,8,1,9,12,33,24,6,11,90,106
2021,2,22100562,1/4/2022,1610612763,Memphis Grizzlies,0,1,1610612739,Cleveland Cavaliers,1,0,33,30,63,9,18,27,42,48,90,17,5,22,14,36,21,2,9,96,110
2020,2,22000358,2/6/2021,1610612745,Houston Rockets,1,0,1610612759,San Antonio Spurs,0,1,26,24,50,12,26,38,38,50,88,18,7,25,14,39,21,6,14,102,106
2020,2,22000358,2/6/2021,1610612759,San Antonio Spurs,0,1,1610612745,Houston Rockets,1,0,29,33,62,8,17,25,37,50,87,29,7,36,12,41,22,5,10,102,111
2019,2,21900474,12/28/2019,1610612740,New Orleans Pelicans,1,1,1610612754,Indiana Pacers,0,0,25,26,51,18,24,42,43,50,93,16,4,20,13,38,25,6,13,104,120
2019,2,21900474,12/28/2019,1610612754,Indiana Pacers,0,0,1610612740,New Orleans Pelicans,1,1,27,30,57,6,22,28,33,52,85,26,3,29,13,40,17,9,18,103,98
2016,2,21600824,2/13/2017,1610612749,Milwaukee Bucks,1,1,1610612765,Detroit Pistons,0,0,34,24,58,6,15,21,40,39,79,16,0,16,7,32,26,4,11,90,102
2016,2,21600824,2/13/2017,1610612765,Detroit Pistons,0,0,1610612749,Milwaukee Bucks,1,1,27,30,57,7,14,21,34,44,78,14,5,19,15,31,17,9,17,91,89
2022,2,22201213,4/8/2023,1610612762,Utah Jazz,1,1,1610612743,Denver Nuggets,0,0,33,32,65,11,24,35,44,56,100,19,4,23,20,38,30,7,16,105,118
2022,2,22200300,11/28/2022,1610612764,Washington Wizards,1,1,1610612750,Minnesota Timberwolves,0,0,37,23,60,15,16,31,52,39,91,23,4,27,8,32,31,4,7,102,142
2020,2,22000674,3/24/2021,1610612760,Oklahoma City Thunder,1,0,1610612763,Memphis Grizzlies,0,1,33,27,60,10,25,35,43,52,95,11,6,17,13,42,26,12,15,106,107
2023,2,22300116,11/1/2023,1610612761,Toronto Raptors,1,1,1610612749,Milwaukee Bucks,0,0,36,17,53,15,23,38,51,40,91,13,1,14,17,23,35,9,18,98,130
2020,2,22000674,3/24/2021,1610612763,Memphis Grizzlies,0,1,1610612760,Oklahoma City Thunder,1,0,36,33,69,11,19,30,47,52,99,11,2,13,16,36,19,13,18,106,116
2022,2,22201125,3/27/2023,1610612762,Utah Jazz,1,0,1610612756,Phoenix Suns,0,1,29,21,50,9,27,36,38,48,86,18,9,27,17,34,25,7,13,98,103
2022,2,22200301,11/28/2022,1610612738,Boston Celtics,1,1,1610612766,Charlotte Hornets,0,0,31,10,41,24,28,52,55,38,93,6,1,7,13,25,40,7,16,100,140
2022,2,22200301,11/28/2022,1610612766,Charlotte Hornets,0,0,1610612738,Boston Celtics,1,1,31,26,57,11,18,29,42,44,86,10,5,15,15,31,28,10,20,98,105
2021,2,22100561,1/3/2022,1610612746,LA Clippers,1,0,1610612750,Minnesota Timberwolves,0,1,28,18,46,11,21,32,39,39,78,15,2,17,8,31,22,9,21,98,104
2021,2,22100561,1/3/2022,1610612750,Minnesota Timberwolves,0,1,1610612746,LA Clippers,1,0,33,15,48,16,29,45,49,44,93,8,1,9,15,30,34,12,17,98,122
2017,2,21700300,11/28/2017,1610612750,Minnesota Timberwolves,1,0,1610612764,Washington Wizards,0,1,25,30,55,10,20,30,35,50,85,9,5,14,15,38,27,5,10,88,89
2023,2,22300236,11/22/2023,1610612756,Phoenix Suns,1,1,1610612744,Golden State Warriors,0,0,23,25,48,11,17,28,34,42,76,44,8,52,13,35,22,10,15,100,123
2014,2,21400089,11/8/2014,1610612740,New Orleans Pelicans,0,1,1610612759,San Antonio Spurs,1,0,32,32,64,8,13,21,40,45,85,12,2,14,8,38,22,4,11,94,100
2017,2,21700300,11/28/2017,1610612764,Washington Wizards,0,1,1610612750,Minnesota Timberwolves,1,0,26,29,55,10,18,28,36,47,83,10,7,17,11,39,23,3,7,87,92
2014,2,21400089,11/8/2014,1610612759,San Antonio Spurs,1,0,1610612740,New Orleans Pelicans,0,1,31,31,62,5,13,18,36,44,80,22,7,29,20,26,15,11,19,94,99
2022,2,22200907,2/25/2023,1610612763,Memphis Grizzlies,1,1,1610612743,Denver Nuggets,0,0,30,21,51,15,29,44,45,50,95,7,1,8,14,37,25,4,12,99,112
2022,2,22200302,11/28/2022,1610612751,Brooklyn Nets,1,1,1610612753,Orlando Magic,0,0,35,18,53,9,19,28,44,37,81,12,2,14,10,29,20,9,18,94,109
2022,2,22200302,11/28/2022,1610612753,Orlando Magic,0,0,1610612751,Brooklyn Nets,1,1,25,24,49,13,18,31,38,42,80,13,9,22,12,35,18,7,18,95,102
2023,2,22300926,3/10/2024,1610612764,Washington Wizards,0,1,1610612748,Miami Heat,1,0,23,19,42,16,23,39,39,42,81,16,6,22,9,35,35,9,15,98,110
2023,2,22300926,3/10/2024,1610612748,Miami Heat,1,0,1610612764,Washington Wizards,0,1,33,29,62,10,23,33,43,52,95,12,6,18,20,35,20,5,13,98,108
2017,2,21700299,11/28/2017,1610612741,Chicago Bulls,1,0,1610612756,Phoenix Suns,0,1,22,32,54,16,24,40,38,56,94,7,3,10,11,46,27,4,9,97,99
2022,2,22200303,11/28/2022,1610612739,Cleveland Cavaliers,0,0,1610612761,Toronto Raptors,1,1,27,25,52,7,31,38,34,56,90,13,3,16,16,42,21,4,10,92,88
2021,2,22100560,1/3/2022,1610612737,Atlanta Hawks,0,0,1610612757,Portland Trail Blazers,1,1,34,13,47,14,27,41,48,40,88,21,3,24,12,30,31,10,13,98,131
2021,2,22100560,1/3/2022,1610612757,Portland Trail Blazers,1,1,1610612737,Atlanta Hawks,0,0,29,19,48,18,23,41,47,42,89,24,4,28,14,30,29,6,10,97,136
2020,2,22000357,2/6/2021,1610612739,Cleveland Cavaliers,1,0,1610612749,Milwaukee Bucks,0,1,33,25,58,6,22,28,39,47,86,15,6,21,11,39,21,10,15,97,99
2020,2,22000357,2/6/2021,1610612749,Milwaukee Bucks,0,1,1610612739,Cleveland Cavaliers,1,0,31,21,52,16,18,34,47,39,86,14,9,23,9,33,25,4,9,98,124
2022,2,22200303,11/28/2022,1610612761,Toronto Raptors,1,1,1610612739,Cleveland Cavaliers,0,0,25,31,56,12,16,28,37,47,84,14,3,17,12,35,23,7,12,92,100
2020,2,22000673,3/24/2021,1610612742,Dallas Mavericks,0,1,1610612750,Minnesota Timberwolves,1,0,32,23,55,16,28,44,48,51,99,16,6,22,19,32,27,6,10,103,128
2020,2,22000673,3/24/2021,1610612750,Minnesota Timberwolves,1,0,1610612742,Dallas Mavericks,0,1,26,22,48,12,26,38,38,48,86,20,6,26,8,42,24,5,12,103,108
2022,2,22200304,11/28/2022,1610612740,New Orleans Pelicans,1,1,1610612760,Oklahoma City Thunder,0,0,30,25,55,9,23,32,39,48,87,18,2,20,17,32,21,11,22,101,105
2014,2,21400088,11/8/2014,1610612749,Milwaukee Bucks,1,1,1610612763,Memphis Grizzlies,0,0,35,35,70,5,13,18,40,48,88,8,3,11,20,29,24,9,17,89,93
2020,2,22000356,2/6/2021,1610612737,Atlanta Hawks,1,1,1610612761,Toronto Raptors,0,0,23,15,38,19,17,36,42,32,74,29,4,33,9,26,31,9,19,98,132
2020,2,22000356,2/6/2021,1610612761,Toronto Raptors,0,0,1610612737,Atlanta Hawks,1,1,28,31,59,13,25,38,41,56,97,26,8,34,18,41,24,1,7,100,121
2019,2,21900473,12/28/2019,1610612738,Boston Celtics,1,0,1610612761,Toronto Raptors,0,1,24,22,46,7,25,32,31,47,78,28,8,36,11,39,18,8,15,100,97
2019,2,21900473,12/28/2019,1610612761,Toronto Raptors,0,1,1610612738,Boston Celtics,1,0,30,20,50,14,20,34,44,40,84,11,6,17,16,25,27,11,22,99,113
2017,2,21700299,11/28/2017,1610612756,Phoenix Suns,0,1,1610612741,Chicago Bulls,1,0,27,30,57,11,19,30,38,49,87,17,6,23,15,34,25,11,15,98,104
2016,2,21600823,2/13/2017,1610612748,Miami Heat,1,0,1610612753,Orlando Magic,0,1,33,28,61,6,16,22,39,44,83,23,4,27,6,39,14,9,15,102,107
2014,2,21401036,3/21/2015,1610612744,Golden State Warriors,1,1,1610612762,Utah Jazz,0,0,30,30,60,8,10,18,38,40,78,22,4,26,14,29,25,5,12,91,106
2016,2,21600823,2/13/2017,1610612753,Orlando Magic,0,1,1610612748,Miami Heat,1,0,36,40,76,8,6,14,44,46,90,20,9,29,17,33,18,7,14,101,116
2014,2,21401036,3/21/2015,1610612762,Utah Jazz,0,0,1610612744,Golden State Warriors,1,1,22,29,51,10,12,22,32,41,73,17,4,21,9,34,19,11,16,90,91
2022,2,22200907,2/25/2023,1610612743,Denver Nuggets,0,0,1610612763,Memphis Grizzlies,1,1,25,27,52,11,26,37,36,53,89,11,3,14,12,43,22,10,15,98,94
2022,2,22201011,3/11/2023,1610612760,Oklahoma City Thunder,0,1,1610612740,New Orleans Pelicans,1,0,28,24,52,9,19,28,37,43,80,27,5,32,9,35,17,3,12,99,110
2014,2,21400088,11/8/2014,1610612763,Memphis Grizzlies,0,0,1610612749,Milwaukee Bucks,1,1,26,42,68,3,11,14,29,53,82,31,3,34,22,31,15,7,13,90,92
2022,2,22200304,11/28/2022,1610612760,Oklahoma City Thunder,0,0,1610612740,New Orleans Pelicans,1,1,22,32,54,12,26,38,34,58,92,21,2,23,21,37,16,12,19,101,101
2023,2,22300330,12/15/2023,1610612761,Toronto Raptors,1,0,1610612737,Atlanta Hawks,0,1,30,16,46,10,21,31,40,37,77,14,11,25,3,41,30,4,14,99,104
2022,2,22201011,3/11/2023,1610612740,New Orleans Pelicans,1,0,1610612760,Oklahoma City Thunder,0,1,22,25,47,12,22,34,34,47,81,16,3,19,12,37,23,11,22,98,96
2022,2,22200305,11/28/2022,1610612743,Denver Nuggets,1,1,1610612745,Houston Rockets,0,0,38,20,58,12,18,30,50,38,88,17,3,20,14,27,31,4,14,96,129
2022,2,22200305,11/28/2022,1610612745,Houston Rockets,0,0,1610612743,Denver Nuggets,1,1,23,18,41,16,28,44,39,46,85,19,6,25,17,33,25,8,17,96,113
2021,2,22100559,1/3/2022,1610612744,Golden State Warriors,1,1,1610612748,Miami Heat,0,0,31,23,54,14,24,38,45,47,92,11,2,13,9,39,39,5,12,102,115
2021,2,22100559,1/3/2022,1610612748,Miami Heat,0,0,1610612744,Golden State Warriors,1,1,20,28,48,17,25,42,37,53,90,17,2,19,17,37,24,11,19,102,108
2020,2,22000355,2/6/2021,1610612740,New Orleans Pelicans,1,1,1610612763,Memphis Grizzlies,0,0,30,24,54,15,18,33,45,42,87,13,8,21,11,35,27,5,10,96,118
2020,2,22000355,2/6/2021,1610612763,Memphis Grizzlies,0,0,1610612740,New Orleans Pelicans,1,1,27,24,51,13,26,39,40,50,90,16,3,19,14,36,27,3,10,95,109
2019,2,21900472,12/28/2019,1610612743,Denver Nuggets,1,1,1610612763,Memphis Grizzlies,0,0,36,28,64,9,20,29,45,48,93,20,7,27,16,36,28,5,10,100,119
2019,2,21900472,12/28/2019,1610612763,Memphis Grizzlies,0,0,1610612743,Denver Nuggets,1,1,32,22,54,9,21,30,41,43,84,19,6,25,12,33,32,9,17,100,110
2017,2,21700298,11/28/2017,1610612739,Cleveland Cavaliers,1,1,1610612748,Miami Heat,0,0,29,19,48,11,22,33,40,41,81,17,6,23,8,36,21,7,14,98,108
2014,2,21400087,11/8/2014,1610612744,Golden State Warriors,0,1,1610612745,Houston Rockets,1,0,30,29,59,9,19,28,39,48,87,11,6,17,21,31,22,14,26,102,98
2014,2,21400087,11/8/2014,1610612745,Houston Rockets,1,0,1610612744,Golden State Warriors,0,1,20,24,44,10,32,42,30,56,86,17,4,21,18,41,13,11,23,101,87
2020,2,22000672,3/24/2021,1610612745,Houston Rockets,1,0,1610612766,Charlotte Hornets,0,1,17,20,37,16,33,49,33,53,86,15,7,22,13,43,24,4,7,92,97
2020,2,22000672,3/24/2021,1610612766,Charlotte Hornets,0,1,1610612745,Houston Rockets,1,0,23,19,42,18,20,38,41,39,80,22,7,29,14,29,27,6,14,93,122
2017,2,21700298,11/28/2017,1610612748,Miami Heat,0,0,1610612739,Cleveland Cavaliers,1,1,27,26,53,10,21,31,37,47,84,13,7,20,9,42,24,12,15,99,97
2022,2,22200306,11/28/2022,1610612741,Chicago Bulls,0,1,1610612762,Utah Jazz,1,0,37,34,71,6,16,22,43,50,93,22,3,25,16,36,21,5,8,96,114
2022,2,22200306,11/28/2022,1610612762,Utah Jazz,1,0,1610612741,Chicago Bulls,0,1,22,14,36,19,30,49,41,44,85,6,9,15,10,37,30,6,14,96,107
2020,2,22000354,2/6/2021,1610612751,Brooklyn Nets,0,0,1610612755,Philadelphia 76ers,1,1,24,23,47,15,26,41,39,49,88,15,2,17,12,38,21,12,17,104,108
2020,2,22000354,2/6/2021,1610612755,Philadelphia 76ers,1,1,1610612751,Brooklyn Nets,0,0,38,29,67,10,17,27,48,46,94,18,4,22,19,29,27,6,16,104,124
2016,2,21600822,2/13/2017,1610612751,Brooklyn Nets,1,0,1610612763,Memphis Grizzlies,0,1,26,19,45,12,25,37,38,44,82,15,3,18,7,38,23,7,12,95,103
2016,2,21600822,2/13/2017,1610612763,Memphis Grizzlies,0,1,1610612751,Brooklyn Nets,1,0,30,25,55,9,13,22,39,38,77,25,2,27,7,31,25,8,12,95,112
2023,2,22300200,11/16/2023,1610612748,Miami Heat,1,1,1610612751,Brooklyn Nets,0,0,27,19,46,15,20,35,42,39,81,23,1,24,9,31,26,5,9,91,122
2023,2,22300818,2/25/2024,1610612756,Phoenix Suns,1,1,1610612747,Los Angeles Lakers,0,0,27,26,53,17,23,40,44,49,93,18,1,19,18,32,32,7,15,98,123
2020,2,22000671,3/24/2021,1610612739,Cleveland Cavaliers,0,1,1610612741,Chicago Bulls,1,0,31,32,63,11,18,29,42,50,92,8,2,10,13,38,28,6,11,94,103
2020,2,22000671,3/24/2021,1610612741,Chicago Bulls,1,0,1610612739,Cleveland Cavaliers,0,1,29,26,55,8,20,28,37,46,83,12,2,14,12,36,21,8,15,94,94
2023,2,22300439,12/30/2023,1610612748,Miami Heat,0,0,1610612762,Utah Jazz,1,1,25,22,47,9,22,31,34,44,78,32,8,40,11,36,20,8,16,103,109
2022,2,22200309,11/29/2022,1610612752,New York Knicks,0,1,1610612765,Detroit Pistons,1,0,38,23,61,16,19,35,54,42,96,16,5,21,18,26,31,7,14,101,140
2022,2,22200615,1/10/2023,1610612744,Golden State Warriors,1,0,1610612756,Phoenix Suns,0,1,19,29,48,18,30,48,37,59,96,21,6,27,19,42,24,5,17,107,113
2022,2,22200615,1/10/2023,1610612756,Phoenix Suns,0,1,1610612744,Golden State Warriors,1,0,27,32,59,14,17,31,41,49,90,29,2,31,20,30,26,13,22,107,125
2021,2,22100558,1/3/2022,1610612742,Dallas Mavericks,1,1,1610612743,Denver Nuggets,0,0,21,20,41,14,23,37,35,43,78,19,2,21,5,39,23,6,11,93,103
2021,2,22100558,1/3/2022,1610612743,Denver Nuggets,0,0,1610612742,Dallas Mavericks,1,1,25,17,42,6,19,25,31,36,67,21,8,29,15,24,21,12,26,93,89
2020,2,22000353,2/6/2021,1610612741,Chicago Bulls,0,1,1610612753,Orlando Magic,1,0,32,29,61,15,15,30,47,44,91,9,4,13,13,32,28,5,12,94,118
2020,2,22000353,2/6/2021,1610612753,Orlando Magic,1,0,1610612741,Chicago Bulls,0,1,31,37,68,6,21,27,37,58,95,12,0,12,21,37,17,6,13,94,92
2019,2,21900471,12/27/2019,1610612744,Golden State Warriors,1,1,1610612756,Phoenix Suns,0,0,29,36,65,9,18,27,38,54,92,20,5,25,14,41,22,6,11,102,105
2016,2,21600326,12/7/2016,1610612745,Houston Rockets,1,1,1610612747,Los Angeles Lakers,0,0,36,22,58,15,21,36,51,43,94,17,4,21,16,29,35,13,20,109,134
2016,2,21600326,12/7/2016,1610612747,Los Angeles Lakers,0,0,1610612745,Houston Rockets,1,1,29,38,67,5,15,20,34,53,87,22,5,27,18,38,14,20,28,110,95
2022,2,22200571,1/4/2023,1610612750,Minnesota Timberwolves,1,1,1610612757,Portland Trail Blazers,0,0,30,22,52,9,15,24,39,37,76,26,10,36,14,28,25,8,15,94,113
2022,2,22200571,1/4/2023,1610612757,Portland Trail Blazers,0,0,1610612750,Minnesota Timberwolves,1,1,24,22,46,9,20,29,33,42,75,31,11,42,17,30,18,8,18,94,106
2023,2,22301212,12/6/2023,1610612745,Houston Rockets,1,1,1610612760,Oklahoma City Thunder,0,0,25,25,50,15,18,33,40,43,83,15,7,22,16,29,28,14,21,99,110
2023,2,22300256,11/27/2023,1610612740,New Orleans Pelicans,0,0,1610612762,Utah Jazz,1,1,37,29,66,7,15,22,44,44,88,17,8,25,13,36,27,6,8,94,112
2021,2,22100557,1/3/2022,1610612740,New Orleans Pelicans,1,0,1610612762,Utah Jazz,0,1,27,24,51,12,34,46,39,58,97,14,8,22,21,41,21,6,10,97,104
2021,2,22100557,1/3/2022,1610612762,Utah Jazz,0,1,1610612740,New Orleans Pelicans,1,0,22,24,46,19,20,39,41,44,85,14,3,17,11,34,22,7,15,96,115
2014,2,21400086,11/8/2014,1610612738,Boston Celtics,0,1,1610612741,Chicago Bulls,1,0,35,27,62,7,12,19,42,39,81,15,5,20,9,30,25,5,12,94,106
2019,2,21900471,12/27/2019,1610612756,Phoenix Suns,0,0,1610612744,Golden State Warriors,1,1,28,14,42,7,26,33,35,40,75,19,5,24,12,31,22,10,27,101,96
2019,2,21900190,11/18/2019,1610612751,Brooklyn Nets,1,0,1610612754,Indiana Pacers,0,1,19,31,50,11,23,34,30,54,84,15,9,24,10,48,18,5,10,96,86
2019,2,21900190,11/18/2019,1610612754,Indiana Pacers,0,1,1610612751,Brooklyn Nets,1,0,30,38,68,14,19,33,44,57,101,13,4,17,22,37,26,2,10,96,115
2020,2,22000670,3/24/2021,1610612753,Orlando Magic,1,1,1610612756,Phoenix Suns,0,0,29,24,53,13,24,37,42,48,90,15,4,19,11,38,18,9,11,98,112
2022,2,22200617,1/10/2023,1610612742,Dallas Mavericks,0,0,1610612746,LA Clippers,1,1,18,13,31,12,26,38,30,39,69,29,7,36,9,34,15,7,12,91,101
2022,2,22200617,1/10/2023,1610612746,LA Clippers,1,1,1610612742,Dallas Mavericks,0,0,27,28,55,12,19,31,39,47,86,23,7,30,18,33,20,5,10,91,113
2020,2,22000670,3/24/2021,1610612756,Phoenix Suns,0,0,1610612753,Orlando Magic,1,1,29,28,57,11,22,33,40,50,90,20,2,22,12,40,22,3,9,99,111
2021,2,22100556,1/3/2022,1610612749,Milwaukee Bucks,1,0,1610612765,Detroit Pistons,0,1,28,18,46,11,35,46,39,53,92,17,5,22,12,42,21,6,8,100,106
2021,2,22100556,1/3/2022,1610612765,Detroit Pistons,0,1,1610612749,Milwaukee Bucks,1,0,26,22,48,18,25,43,44,47,91,9,5,14,13,37,31,9,14,99,115
2020,2,22000352,2/6/2021,1610612743,Denver Nuggets,0,0,1610612758,Sacramento Kings,1,1,32,30,62,13,22,35,45,52,97,11,3,14,17,36,30,5,10,96,114
2014,2,21400086,11/8/2014,1610612741,Chicago Bulls,1,0,1610612738,Boston Celtics,0,1,34,40,74,8,10,18,42,50,92,9,6,15,14,39,26,6,8,94,101
2020,2,22000352,2/6/2021,1610612758,Sacramento Kings,1,1,1610612743,Denver Nuggets,0,0,30,26,56,14,21,35,44,47,91,17,7,24,13,35,30,3,7,98,119
2019,2,21900470,12/27/2019,1610612748,Miami Heat,1,1,1610612754,Indiana Pacers,0,0,24,27,51,16,22,38,40,49,89,17,2,19,16,34,29,8,13,97,113
2019,2,21900470,12/27/2019,1610612754,Indiana Pacers,0,0,1610612748,Miami Heat,1,1,30,29,59,14,17,31,44,46,90,10,2,12,4,43,27,3,4,97,112
2020,2,22000669,3/24/2021,1610612738,Boston Celtics,0,0,1610612749,Milwaukee Bucks,1,1,26,21,47,19,28,47,45,49,94,10,0,10,13,36,24,8,13,101,119
2020,2,22000669,3/24/2021,1610612749,Milwaukee Bucks,1,1,1610612738,Boston Celtics,0,0,28,25,53,17,20,37,45,45,90,14,6,20,16,31,19,9,16,99,121
2014,2,21400085,11/8/2014,1610612748,Miami Heat,1,1,1610612750,Minnesota Timberwolves,0,0,36,29,65,5,8,13,41,37,78,15,2,17,6,32,26,9,14,94,102
2014,2,21400085,11/8/2014,1610612750,Minnesota Timberwolves,0,0,1610612748,Miami Heat,1,1,31,40,71,4,12,16,35,52,87,18,5,23,19,36,13,8,16,95,92
2022,2,22201063,3/19/2023,1610612751,Brooklyn Nets,1,0,1610612743,Denver Nuggets,0,1,26,21,47,12,23,35,38,44,82,14,2,16,10,35,26,5,12,91,102
2022,2,22200309,11/29/2022,1610612765,Detroit Pistons,1,0,1610612752,New York Knicks,0,1,29,15,44,13,26,39,42,41,83,13,7,20,8,37,28,9,16,102,110
2023,2,22300184,11/12/2023,1610612748,Miami Heat,0,1,1610612759,San Antonio Spurs,1,0,27,31,58,12,19,31,39,50,89,28,2,30,13,39,26,3,7,97,118
2022,2,22200464,12/20/2022,1610612756,Phoenix Suns,1,0,1610612764,Washington Wizards,0,1,28,29,57,13,19,32,41,48,89,15,4,19,17,33,26,9,14,96,110
2023,2,22300185,11/12/2023,1610612760,Oklahoma City Thunder,0,1,1610612756,Phoenix Suns,1,0,30,25,55,10,17,27,40,42,82,21,4,25,8,36,23,4,9,96,111
2022,2,22200464,12/20/2022,1610612764,Washington Wizards,0,1,1610612756,Phoenix Suns,1,0,27,26,53,11,16,27,38,42,80,26,11,37,13,34,22,2,10,95,113
2020,2,22000668,3/24/2021,1610612743,Denver Nuggets,0,0,1610612761,Toronto Raptors,1,1,27,28,55,14,29,43,41,57,98,15,3,18,21,38,25,3,12,97,111
2020,2,22000668,3/24/2021,1610612761,Toronto Raptors,1,1,1610612743,Denver Nuggets,0,0,21,20,41,24,24,48,45,44,89,21,2,23,13,32,31,5,10,97,135
2022,2,22200307,11/28/2022,1610612756,Phoenix Suns,0,1,1610612758,Sacramento Kings,1,0,40,22,62,10,22,32,50,44,94,12,2,14,14,31,26,9,17,104,122
2021,2,22100555,1/3/2022,1610612741,Chicago Bulls,1,1,1610612753,Orlando Magic,0,0,26,29,55,11,20,31,37,49,86,17,6,23,11,40,17,5,13,97,102
2021,2,22100555,1/3/2022,1610612753,Orlando Magic,0,0,1610612741,Chicago Bulls,1,1,26,32,58,10,17,27,36,49,85,16,2,18,9,41,24,10,13,98,98
2020,2,22000351,2/6/2021,1610612752,New York Knicks,1,1,1610612757,Portland Trail Blazers,0,0,31,27,58,13,17,30,44,44,88,9,4,13,14,32,20,7,14,93,110
2020,2,22000351,2/6/2021,1610612757,Portland Trail Blazers,0,0,1610612752,New York Knicks,1,1,20,22,42,17,30,47,37,52,89,8,8,16,13,43,15,5,11,94,99
2019,2,21900469,12/27/2019,1610612737,Atlanta Hawks,1,0,1610612749,Milwaukee Bucks,0,1,21,29,50,12,29,41,33,58,91,8,6,14,9,52,20,9,18,107,86
2019,2,21900469,12/27/2019,1610612749,Milwaukee Bucks,0,1,1610612737,Atlanta Hawks,1,0,35,28,63,11,17,28,46,45,91,9,4,13,9,39,29,10,18,106,112
2019,2,21900189,11/18/2019,1610612739,Cleveland Cavaliers,0,0,1610612752,New York Knicks,1,1,19,21,40,17,19,36,36,40,76,16,14,30,15,31,18,8,20,95,105
2019,2,21900189,11/18/2019,1610612752,New York Knicks,1,1,1610612739,Cleveland Cavaliers,0,0,36,39,75,8,15,23,44,54,98,27,8,35,26,33,17,2,7,95,123
2022,2,22200307,11/28/2022,1610612758,Sacramento Kings,1,0,1610612756,Phoenix Suns,0,1,37,26,63,9,16,25,46,42,88,16,2,18,9,35,32,9,16,103,117
2022,2,22201125,3/27/2023,1610612756,Phoenix Suns,0,1,1610612762,Utah Jazz,1,0,32,33,65,11,25,36,43,58,101,20,2,22,21,38,31,2,7,96,117
2021,2,22100554,1/3/2022,1610612751,Brooklyn Nets,1,0,1610612763,Memphis Grizzlies,0,1,28,23,51,9,22,31,37,45,82,21,5,26,10,39,28,11,13,97,104
2014,2,21400084,11/8/2014,1610612737,Atlanta Hawks,1,1,1610612752,New York Knicks,0,0,24,35,59,9,13,22,33,48,81,28,8,36,19,33,18,2,9,88,103
2014,2,21400084,11/8/2014,1610612752,New York Knicks,0,0,1610612737,Atlanta Hawks,1,1,32,31,63,8,13,21,40,44,84,8,3,11,16,30,26,10,15,88,96
2021,2,22100554,1/3/2022,1610612763,Memphis Grizzlies,0,1,1610612751,Brooklyn Nets,1,0,38,29,67,10,25,35,48,54,102,12,9,21,27,31,24,10,13,98,118
2023,2,22301212,12/6/2023,1610612760,Oklahoma City Thunder,0,0,1610612745,Houston Rockets,1,1,29,29,58,8,21,29,37,50,87,19,5,24,8,44,22,6,9,97,101
2023,2,22300168,11/8/2023,1610612742,Dallas Mavericks,1,0,1610612761,Toronto Raptors,0,1,23,20,43,17,24,41,40,44,84,19,12,31,11,38,25,10,16,103,116
2020,2,22000667,3/24/2021,1610612754,Indiana Pacers,1,1,1610612765,Detroit Pistons,0,0,30,33,63,15,19,34,45,52,97,11,3,14,15,38,25,8,10,98,116
2020,2,22000667,3/24/2021,1610612765,Detroit Pistons,0,0,1610612754,Indiana Pacers,1,1,33,22,55,11,17,28,44,39,83,12,7,19,10,29,29,7,15,98,111
2022,2,22200308,11/28/2022,1610612747,Los Angeles Lakers,1,0,1610612754,Indiana Pacers,0,1,29,33,62,11,20,31,40,53,93,24,7,31,18,38,23,6,14,102,115
2022,2,22200308,11/28/2022,1610612754,Indiana Pacers,0,1,1610612747,Los Angeles Lakers,1,0,26,30,56,17,32,49,43,62,105,13,3,16,21,42,29,3,10,103,116
2022,2,22201039,3/15/2023,1610612738,Boston Celtics,0,1,1610612750,Minnesota Timberwolves,1,0,22,22,44,12,28,40,34,50,84,24,6,30,12,40,20,3,11,95,104
2017,2,21700297,11/27/2017,1610612746,LA Clippers,1,1,1610612747,Los Angeles Lakers,0,0,31,26,57,10,18,28,41,44,85,28,2,30,12,33,19,10,17,104,120
2017,2,21700297,11/27/2017,1610612747,Los Angeles Lakers,0,0,1610612746,LA Clippers,1,1,33,28,61,11,19,30,44,47,91,16,8,24,14,36,23,7,16,105,115
2016,2,21600821,2/13/2017,1610612755,Philadelphia 76ers,0,1,1610612766,Charlotte Hornets,1,0,29,24,53,12,21,33,41,45,86,11,6,17,12,34,24,11,19,100,105
2023,2,22300252,11/26/2023,1610612759,San Antonio Spurs,0,0,1610612743,Denver Nuggets,1,1,28,28,56,14,23,37,42,51,93,22,4,26,14,38,34,8,15,104,120
2022,2,22200310,11/29/2022,1610612742,Dallas Mavericks,1,1,1610612744,Golden State Warriors,0,0,27,20,47,15,29,44,42,49,91,17,10,27,14,43,21,6,14,103,116
2014,2,21400083,11/8/2014,1610612754,Indiana Pacers,1,0,1610612764,Washington Wizards,0,1,25,28,53,8,16,24,33,44,77,16,9,25,11,37,11,8,18,94,90
2017,2,21700296,11/27/2017,1610612744,Golden State Warriors,1,0,1610612758,Sacramento Kings,0,1,24,19,43,16,21,37,40,40,80,10,4,14,14,26,31,7,15,91,106
2017,2,21700296,11/27/2017,1610612758,Sacramento Kings,0,1,1610612744,Golden State Warriors,1,0,33,29,62,9,8,17,42,37,79,17,4,21,13,28,27,9,15,90,110
2022,2,22200310,11/29/2022,1610612744,Golden State Warriors,0,0,1610612742,Dallas Mavericks,1,1,31,14,45,11,32,43,42,46,88,18,5,23,11,36,27,7,18,103,113
2022,2,22201063,3/19/2023,1610612743,Denver Nuggets,0,1,1610612751,Brooklyn Nets,1,0,30,27,57,12,11,23,42,38,80,12,1,13,13,26,31,10,17,90,108
2021,2,22100553,1/3/2022,1610612764,Washington Wizards,1,1,1610612766,Charlotte Hornets,0,0,24,25,49,16,22,38,40,47,87,28,3,31,12,35,26,14,15,105,124
2021,2,22100553,1/3/2022,1610612766,Charlotte Hornets,0,0,1610612764,Washington Wizards,1,1,36,30,66,14,24,38,50,54,104,7,6,13,14,43,28,5,9,105,121
2016,2,21600821,2/13/2017,1610612766,Charlotte Hornets,1,0,1610612755,Philadelphia 76ers,0,1,23,24,47,11,20,31,34,44,78,20,6,26,3,45,19,9,15,100,99
2023,2,22300115,11/1/2023,1610612757,Portland Trail Blazers,0,1,1610612765,Detroit Pistons,1,0,31,30,61,7,13,20,38,43,81,27,6,33,9,35,23,12,17,104,110
2020,2,22000666,3/23/2021,1610612751,Brooklyn Nets,0,1,1610612757,Portland Trail Blazers,1,0,34,23,57,9,21,30,43,44,87,21,6,27,15,32,25,4,11,96,116
2020,2,22000666,3/23/2021,1610612757,Portland Trail Blazers,1,0,1610612751,Brooklyn Nets,0,1,17,18,35,19,36,55,36,54,90,21,2,23,14,41,25,5,8,95,112
2022,2,22200311,11/29/2022,1610612746,LA Clippers,0,1,1610612757,Portland Trail Blazers,1,0,28,30,58,13,18,31,41,48,89,23,5,28,19,34,26,6,13,95,118
2022,2,22200311,11/29/2022,1610612757,Portland Trail Blazers,1,0,1610612746,LA Clippers,0,1,25,30,55,17,18,35,42,48,90,11,4,15,14,36,24,6,11,95,112
2021,2,22100552,1/3/2022,1610612745,Houston Rockets,0,0,1610612755,Philadelphia 76ers,1,1,22,23,45,15,29,44,37,52,89,24,9,33,13,44,25,7,11,102,113
2021,2,22100552,1/3/2022,1610612755,Philadelphia 76ers,1,1,1610612745,Houston Rockets,0,0,33,23,56,17,23,40,50,46,96,16,1,17,15,32,33,6,14,102,133
2020,2,22000350,2/5/2021,1610612738,Boston Celtics,0,1,1610612746,LA Clippers,1,0,27,25,52,16,22,38,43,47,90,17,4,21,11,39,21,5,7,95,119
2020,2,22000350,2/5/2021,1610612746,LA Clippers,1,0,1610612738,Boston Celtics,0,1,28,21,49,14,18,32,42,39,81,17,4,21,13,27,26,8,16,94,115
2019,2,21900468,12/27/2019,1610612753,Orlando Magic,1,1,1610612755,Philadelphia 76ers,0,0,27,31,58,10,20,30,37,51,88,14,9,23,15,41,26,10,16,100,98
2019,2,21900468,12/27/2019,1610612755,Philadelphia 76ers,0,0,1610612753,Orlando Magic,1,1,25,33,58,10,19,29,35,52,87,17,4,21,13,41,23,4,16,101,97
2017,2,21700295,11/27/2017,1610612742,Dallas Mavericks,0,0,1610612759,San Antonio Spurs,1,1,27,26,53,14,18,32,41,44,85,12,5,17,6,40,25,7,11,98,108
2017,2,21700295,11/27/2017,1610612759,San Antonio Spurs,1,1,1610612742,Dallas Mavericks,0,0,33,25,58,10,14,24,43,39,82,19,2,21,4,36,27,7,10,96,115
2022,2,22201037,3/15/2023,1610612758,Sacramento Kings,0,1,1610612741,Chicago Bulls,1,0,20,16,36,18,24,42,38,40,78,23,6,29,9,37,26,13,20,103,117
2022,2,22201012,3/11/2023,1610612744,Golden State Warriors,1,1,1610612749,Milwaukee Bucks,0,0,23,34,57,23,32,55,46,66,112,10,1,11,21,46,33,9,15,112,125
2023,2,22300252,11/26/2023,1610612743,Denver Nuggets,1,1,1610612759,San Antonio Spurs,0,0,38,23,61,12,16,28,50,39,89,20,5,25,15,28,38,10,20,103,132
2023,2,22300080,10/27/2023,1610612738,Boston Celtics,1,1,1610612748,Miami Heat,0,0,29,27,56,16,23,39,45,50,95,13,6,19,21,34,20,8,15,98,119
2022,2,22200580,1/6/2023,1610612754,Indiana Pacers,1,1,1610612757,Portland Trail Blazers,0,0,31,28,59,7,18,25,38,46,84,25,3,28,7,41,22,5,14,106,108
2022,2,22200580,1/6/2023,1610612757,Portland Trail Blazers,0,0,1610612754,Indiana Pacers,1,1,29,32,61,9,24,33,38,56,94,14,3,17,15,42,30,11,18,105,99
2023,2,22300256,11/27/2023,1610612762,Utah Jazz,1,1,1610612740,New Orleans Pelicans,0,0,20,20,40,17,31,48,37,51,88,23,5,28,15,39,31,5,10,94,114
2021,2,22100551,1/2/2022,1610612747,Los Angeles Lakers,1,1,1610612750,Minnesota Timberwolves,0,0,23,11,34,13,28,41,36,39,75,23,6,29,7,37,20,9,18,99,108
2021,2,22100551,1/2/2022,1610612750,Minnesota Timberwolves,0,0,1610612747,Los Angeles Lakers,1,1,32,22,54,9,29,38,41,51,92,12,4,16,23,30,21,13,24,100,103
2020,2,22000349,2/5/2021,1610612756,Phoenix Suns,1,1,1610612765,Detroit Pistons,0,0,30,23,53,12,20,32,42,43,85,13,3,16,16,29,26,8,22,97,109
2020,2,22000349,2/5/2021,1610612765,Detroit Pistons,0,0,1610612756,Phoenix Suns,1,1,27,28,55,7,29,36,34,57,91,17,11,28,21,41,20,7,13,98,92
2017,2,21700294,11/27/2017,1610612745,Houston Rockets,1,1,1610612751,Brooklyn Nets,0,0,22,14,36,20,30,50,42,44,86,13,7,20,8,40,31,5,15,99,117
2017,2,21700294,11/27/2017,1610612751,Brooklyn Nets,0,0,1610612745,Houston Rockets,1,1,30,17,47,10,29,39,40,46,86,13,4,17,7,42,24,8,14,99,103
2020,2,22000665,3/23/2021,1610612744,Golden State Warriors,1,0,1610612755,Philadelphia 76ers,0,1,28,30,58,8,17,25,36,47,83,18,8,26,12,39,22,5,13,99,98
2020,2,22000665,3/23/2021,1610612755,Philadelphia 76ers,0,1,1610612744,Golden State Warriors,1,0,32,30,62,7,17,24,39,47,86,23,12,35,19,35,15,5,14,99,108
2015,2,21501103,3/28/2016,1610612742,Dallas Mavericks,0,1,1610612743,Denver Nuggets,1,0,25,31,56,11,21,32,36,52,88,14,1,15,11,41,23,3,4,90,97
2015,2,21501103,3/28/2016,1610612743,Denver Nuggets,1,0,1610612742,Dallas Mavericks,0,1,22,24,46,9,15,24,31,39,70,17,2,19,11,29,20,14,21,90,88
2022,2,22200312,11/30/2022,1610612739,Cleveland Cavaliers,1,1,1610612755,Philadelphia 76ers,0,0,30,15,45,15,14,29,45,29,74,8,2,10,7,23,28,7,19,90,113
2014,2,21401035,3/21/2015,1610612757,Portland Trail Blazers,0,0,1610612763,Memphis Grizzlies,1,1,27,27,54,6,16,22,33,43,76,14,1,15,8,35,15,10,17,92,86
2021,2,22100550,1/2/2022,1610612742,Dallas Mavericks,0,1,1610612760,Oklahoma City Thunder,1,0,24,22,46,14,25,39,38,47,85,5,2,7,12,35,28,11,16,94,95
2021,2,22100550,1/2/2022,1610612760,Oklahoma City Thunder,1,0,1610612742,Dallas Mavericks,0,1,25,30,55,10,20,30,35,50,85,6,3,9,8,44,20,9,11,92,86
2020,2,22000348,2/5/2021,1610612750,Minnesota Timberwolves,0,1,1610612760,Oklahoma City Thunder,1,0,25,29,54,16,24,40,41,53,94,8,1,9,15,39,27,10,17,100,106
2020,2,22000348,2/5/2021,1610612760,Oklahoma City Thunder,1,0,1610612750,Minnesota Timberwolves,0,1,26,25,51,13,21,34,39,46,85,12,5,17,12,35,28,10,17,102,103
2019,2,21900467,12/27/2019,1610612760,Oklahoma City Thunder,0,1,1610612766,Charlotte Hornets,1,0,35,23,58,5,26,31,40,49,89,19,12,31,14,39,19,8,14,105,104
2019,2,21900467,12/27/2019,1610612766,Charlotte Hornets,1,0,1610612760,Oklahoma City Thunder,0,1,35,27,62,7,32,39,42,59,101,11,7,18,21,42,26,8,15,104,102
2014,2,21401035,3/21/2015,1610612763,Memphis Grizzlies,1,1,1610612757,Portland Trail Blazers,0,0,26,45,71,11,7,18,37,52,89,12,4,16,14,41,21,6,10,91,97
2020,2,22000664,3/23/2021,1610612748,Miami Heat,1,0,1610612756,Phoenix Suns,0,1,23,27,50,13,23,36,36,50,86,15,2,17,18,32,23,5,14,91,100
2020,2,22000664,3/23/2021,1610612756,Phoenix Suns,0,1,1610612748,Miami Heat,1,0,33,21,54,12,25,37,45,46,91,8,1,9,11,35,29,3,7,91,110
2022,2,22200312,11/30/2022,1610612755,Philadelphia 76ers,0,0,1610612739,Cleveland Cavaliers,1,1,26,25,51,6,20,26,32,45,77,15,3,18,10,36,19,10,16,90,85
2021,2,22100549,1/2/2022,1610612756,Phoenix Suns,0,1,1610612766,Charlotte Hornets,1,0,35,27,62,17,24,41,52,51,103,12,0,12,21,30,36,10,17,103,133
2021,2,22100549,1/2/2022,1610612766,Charlotte Hornets,1,0,1610612756,Phoenix Suns,0,1,30,20,50,9,26,35,39,46,85,12,9,21,9,41,27,15,18,105,99
2020,2,22000347,2/5/2021,1610612748,Miami Heat,1,1,1610612764,Washington Wizards,0,0,27,23,50,16,20,36,43,43,86,20,3,23,14,30,27,7,17,99,122
2020,2,22000347,2/5/2021,1610612764,Washington Wizards,0,0,1610612748,Miami Heat,1,1,25,31,56,8,25,33,33,56,89,21,3,24,18,40,19,9,18,101,95
2019,2,21900466,12/27/2019,1610612738,Boston Celtics,1,1,1610612739,Cleveland Cavaliers,0,0,35,20,55,14,26,40,49,46,95,17,2,19,15,33,28,7,11,100,129
2019,2,21900466,12/27/2019,1610612739,Cleveland Cavaliers,0,0,1610612738,Boston Celtics,1,1,35,27,62,9,14,23,44,41,85,20,9,29,10,35,22,4,11,100,117
2014,2,21400083,11/8/2014,1610612764,Washington Wizards,0,1,1610612754,Indiana Pacers,1,0,37,33,70,2,9,11,39,42,81,17,6,23,14,31,23,5,14,92,97
2016,2,21600820,2/13/2017,1610612760,Oklahoma City Thunder,0,0,1610612764,Washington Wizards,1,1,27,35,62,7,27,34,34,62,96,23,7,30,26,40,16,4,15,100,98
2020,2,22000663,3/23/2021,1610612740,New Orleans Pelicans,1,1,1610612747,Los Angeles Lakers,0,0,37,24,61,10,19,29,47,43,90,24,2,26,14,30,28,10,14,103,128
2020,2,22000663,3/23/2021,1610612747,Los Angeles Lakers,0,0,1610612740,New Orleans Pelicans,1,1,18,30,48,18,19,37,36,49,85,21,9,30,9,44,25,9,13,102,111
2016,2,21600820,2/13/2017,1610612764,Washington Wizards,1,1,1610612760,Oklahoma City Thunder,0,0,29,24,53,13,7,20,42,31,73,23,5,28,7,27,27,10,23,100,120
2022,2,22201038,3/15/2023,1610612747,Los Angeles Lakers,0,0,1610612745,Houston Rockets,1,1,23,23,46,11,33,44,34,56,90,31,6,37,16,40,21,5,10,102,110
2023,2,22300022,11/14/2023,1610612740,New Orleans Pelicans,1,1,1610612742,Dallas Mavericks,0,0,35,21,56,14,24,38,49,45,94,19,7,26,14,35,33,4,13,104,131
2023,2,22300180,11/12/2023,1610612755,Philadelphia 76ers,1,1,1610612754,Indiana Pacers,0,0,39,33,72,14,19,33,53,52,105,17,3,20,28,25,28,8,12,99,137
2023,2,22300186,11/12/2023,1610612744,Golden State Warriors,1,0,1610612750,Minnesota Timberwolves,0,1,25,28,53,12,31,43,37,59,96,24,4,28,22,40,24,8,14,99,110
2022,2,22200313,11/30/2022,1610612737,Atlanta Hawks,0,1,1610612753,Orlando Magic,1,0,43,19,62,8,24,32,51,43,94,15,4,19,15,30,25,5,12,100,125
2022,2,22200313,11/30/2022,1610612753,Orlando Magic,1,0,1610612737,Atlanta Hawks,0,1,31,21,52,8,19,27,39,40,79,22,3,25,7,36,26,8,18,102,108
2023,2,22300117,11/1/2023,1610612737,Atlanta Hawks,1,1,1610612764,Washington Wizards,0,0,37,23,60,9,23,32,46,46,92,29,3,32,17,30,26,14,21,110,130
2021,2,22100548,1/2/2022,1610612748,Miami Heat,0,0,1610612758,Sacramento Kings,1,1,37,35,72,9,24,33,46,59,105,12,0,12,24,35,26,3,9,97,113
2021,2,22100548,1/2/2022,1610612758,Sacramento Kings,1,1,1610612748,Miami Heat,0,0,27,17,44,13,21,34,40,38,78,22,5,27,9,31,31,4,16,97,115
2020,2,22000346,2/5/2021,1610612739,Cleveland Cavaliers,1,0,1610612749,Milwaukee Bucks,0,1,30,30,60,11,21,32,41,51,92,12,4,16,10,43,23,6,11,101,105
2020,2,22000346,2/5/2021,1610612749,Milwaukee Bucks,0,1,1610612739,Cleveland Cavaliers,1,0,43,32,75,7,15,22,50,47,97,16,6,22,17,31,28,7,13,102,123
2019,2,21900465,12/26/2019,1610612757,Portland Trail Blazers,0,0,1610612762,Utah Jazz,1,1,28,27,55,15,19,34,43,46,89,14,5,19,15,34,14,3,12,95,115
2019,2,21900465,12/26/2019,1610612762,Utah Jazz,1,1,1610612757,Portland Trail Blazers,0,0,32,13,45,14,22,36,46,35,81,15,7,22,9,32,22,4,11,95,121
2023,2,22300351,12/18/2023,1610612741,Chicago Bulls,0,1,1610612755,Philadelphia 76ers,1,0,30,30,60,12,17,29,42,47,89,12,3,15,12,36,24,8,10,94,108
2020,2,22000662,3/23/2021,1610612752,New York Knicks,1,1,1610612764,Washington Wizards,0,0,31,31,62,16,14,30,47,45,92,21,3,24,13,34,23,5,10,99,131
2020,2,22000662,3/23/2021,1610612764,Washington Wizards,0,0,1610612752,New York Knicks,1,1,29,27,56,9,14,23,38,41,79,28,7,35,13,32,25,6,17,100,113
2023,2,22300402,12/25/2023,1610612744,Golden State Warriors,0,0,1610612743,Denver Nuggets,1,1,26,21,47,14,26,40,40,47,87,20,3,23,12,36,23,6,13,100,114
2022,2,22200314,11/30/2022,1610612738,Boston Celtics,1,1,1610612748,Miami Heat,0,0,24,14,38,22,23,45,46,37,83,20,3,23,12,26,32,8,18,98,134
2022,2,22200314,11/30/2022,1610612748,Miami Heat,0,0,1610612738,Boston Celtics,1,1,29,21,50,18,22,40,47,43,90,9,0,9,12,31,25,7,15,97,121
2017,2,21700293,11/27/2017,1610612752,New York Knicks,1,0,1610612757,Portland Trail Blazers,0,1,30,43,73,5,10,15,35,53,88,16,6,22,16,42,13,10,13,95,91
2017,2,21700293,11/27/2017,1610612757,Portland Trail Blazers,0,1,1610612752,New York Knicks,1,0,30,32,62,7,14,21,37,46,83,22,4,26,10,38,18,3,12,96,103
2019,2,21900464,12/26/2019,1610612750,Minnesota Timberwolves,0,1,1610612758,Sacramento Kings,1,0,26,32,58,10,36,46,36,68,104,23,6,29,18,54,23,8,15,114,105
2019,2,21900464,12/26/2019,1610612758,Sacramento Kings,1,0,1610612750,Minnesota Timberwolves,0,1,28,40,68,9,30,39,37,70,107,21,4,25,19,53,20,7,12,114,104
2016,2,21600819,2/12/2017,1610612740,New Orleans Pelicans,0,0,1610612758,Sacramento Kings,1,1,21,30,51,13,18,31,34,48,82,18,3,21,9,41,23,11,18,101,99
2016,2,21600819,2/12/2017,1610612758,Sacramento Kings,1,1,1610612740,New Orleans Pelicans,0,0,24,23,47,11,20,31,35,43,78,24,3,27,10,33,23,10,20,101,105
2020,2,22000661,3/23/2021,1610612743,Denver Nuggets,0,1,1610612753,Orlando Magic,1,0,37,24,61,8,22,30,45,46,91,12,1,13,16,30,25,8,12,94,110
2020,2,22000661,3/23/2021,1610612753,Orlando Magic,1,0,1610612743,Denver Nuggets,0,1,28,26,54,11,23,34,39,49,88,10,4,14,12,39,27,12,13,94,99
2021,2,22100547,1/2/2022,1610612739,Cleveland Cavaliers,1,1,1610612754,Indiana Pacers,0,0,35,27,62,6,20,26,41,47,88,20,8,28,17,33,26,6,11,94,108
2021,2,22100547,1/2/2022,1610612754,Indiana Pacers,0,0,1610612739,Cleveland Cavaliers,1,1,18,19,37,19,27,46,37,46,83,11,3,14,12,36,24,6,14,94,104
2014,2,21400082,11/8/2014,1610612746,LA Clippers,1,1,1610612757,Portland Trail Blazers,0,0,35,34,69,5,7,12,40,41,81,21,9,30,9,37,17,2,7,93,106
2014,2,21400082,11/8/2014,1610612757,Portland Trail Blazers,0,0,1610612746,LA Clippers,1,1,26,29,55,10,15,25,36,44,80,20,5,25,15,31,25,8,16,94,102
2020,2,22000345,2/5/2021,1610612751,Brooklyn Nets,1,0,1610612761,Toronto Raptors,0,1,22,16,38,17,25,42,39,41,80,22,7,29,13,32,29,10,18,100,117
2020,2,22000345,2/5/2021,1610612761,Toronto Raptors,0,1,1610612751,Brooklyn Nets,1,0,36,29,65,13,19,32,49,48,97,12,2,14,14,35,22,5,10,100,123
2019,2,21900188,11/17/2019,1610612737,Atlanta Hawks,0,0,1610612747,Los Angeles Lakers,1,1,29,29,58,8,20,28,37,49,86,19,6,25,17,34,16,10,20,100,101
2019,2,21900188,11/17/2019,1610612747,Los Angeles Lakers,1,1,1610612737,Atlanta Hawks,0,0,32,22,54,15,20,35,47,42,89,13,3,16,13,31,26,11,17,100,122
2014,2,21400469,12/30/2014,1610612740,New Orleans Pelicans,1,1,1610612756,Phoenix Suns,0,0,34,29,63,8,10,18,42,39,81,18,11,29,16,28,19,7,12,91,110
2014,2,21400469,12/30/2014,1610612756,Phoenix Suns,0,0,1610612740,New Orleans Pelicans,1,1,32,33,65,9,12,21,41,45,86,15,4,19,11,37,17,4,6,91,106
2022,2,22200315,11/30/2022,1610612751,Brooklyn Nets,1,1,1610612764,Washington Wizards,0,0,28,30,58,11,15,26,39,45,84,24,2,26,5,40,22,6,9,99,113
2019,2,21900463,12/26/2019,1610612742,Dallas Mavericks,1,1,1610612759,San Antonio Spurs,0,0,22,28,50,16,24,40,38,52,90,10,5,15,14,41,22,9,14,98,102
2019,2,21900463,12/26/2019,1610612759,San Antonio Spurs,0,0,1610612742,Dallas Mavericks,1,1,32,22,54,8,21,29,40,43,83,10,5,15,5,41,18,7,13,98,98
2022,2,22200315,11/30/2022,1610612764,Washington Wizards,0,0,1610612751,Brooklyn Nets,1,1,33,32,65,6,18,24,39,50,89,23,11,34,20,34,19,8,14,100,107
2023,2,22300022,11/14/2023,1610612742,Dallas Mavericks,0,0,1610612740,New Orleans Pelicans,1,1,24,24,48,14,28,42,38,52,90,20,6,26,19,35,25,17,20,104,110
2023,2,22300200,11/16/2023,1610612751,Brooklyn Nets,0,0,1610612748,Miami Heat,1,1,26,23,49,14,22,36,40,45,85,21,6,27,20,26,29,8,15,93,115
2020,2,22000660,3/22/2021,1610612737,Atlanta Hawks,0,0,1610612746,LA Clippers,1,1,31,30,61,12,22,34,43,52,95,12,4,16,18,36,21,4,7,92,110
2020,2,22000660,3/22/2021,1610612746,LA Clippers,1,1,1610612737,Atlanta Hawks,0,0,25,22,47,17,21,38,42,43,85,18,2,20,9,34,26,3,8,91,119
2014,2,21400468,12/30/2014,1610612759,San Antonio Spurs,0,0,1610612763,Memphis Grizzlies,1,1,30,26,56,5,17,22,35,43,78,12,5,17,11,33,17,10,16,93,87
2014,2,21400468,12/30/2014,1610612763,Memphis Grizzlies,1,1,1610612759,San Antonio Spurs,0,0,28,29,57,7,8,15,35,37,72,18,4,22,11,28,25,9,20,93,95
2023,2,22300186,11/12/2023,1610612750,Minnesota Timberwolves,0,1,1610612744,Golden State Warriors,1,0,34,21,55,9,18,27,43,39,82,21,9,30,11,33,27,9,14,98,116
2014,2,21400081,11/7/2014,1610612739,Cleveland Cavaliers,0,1,1610612743,Denver Nuggets,1,0,34,27,61,6,17,23,40,44,84,24,9,33,11,37,25,5,9,95,110
2014,2,21400081,11/7/2014,1610612743,Denver Nuggets,1,0,1610612739,Cleveland Cavaliers,0,1,29,27,56,11,18,29,40,45,85,10,5,15,10,38,22,5,13,95,101
2022,2,22201012,3/11/2023,1610612749,Milwaukee Bucks,0,0,1610612744,Golden State Warriors,1,1,22,27,49,21,30,51,43,57,100,9,2,11,9,49,28,12,17,114,116
2021,2,22100546,1/2/2022,1610612738,Boston Celtics,1,1,1610612753,Orlando Magic,0,0,26,24,50,13,23,36,39,47,86,25,3,28,12,38,25,12,22,108,116
2021,2,22100546,1/2/2022,1610612753,Orlando Magic,0,0,1610612738,Boston Celtics,1,1,31,37,68,9,18,27,40,55,95,22,5,27,15,42,17,5,16,109,111
2020,2,22000344,2/5/2021,1610612741,Chicago Bulls,0,0,1610612753,Orlando Magic,1,1,37,29,66,9,21,30,46,50,96,18,2,20,12,40,27,5,8,100,119
2020,2,22000344,2/5/2021,1610612753,Orlando Magic,1,1,1610612741,Chicago Bulls,0,0,31,23,54,11,16,27,42,39,81,28,9,37,13,32,27,9,16,100,123
2017,2,21700292,11/27/2017,1610612738,Boston Celtics,1,0,1610612765,Detroit Pistons,0,1,24,20,44,16,17,33,40,37,77,12,9,21,9,33,27,8,17,95,108
2017,2,21700292,11/27/2017,1610612765,Detroit Pistons,0,1,1610612738,Boston Celtics,1,0,33,27,60,11,14,25,44,41,85,19,4,23,9,33,26,2,8,94,118
2016,2,21600325,12/7/2016,1610612749,Milwaukee Bucks,1,1,1610612757,Portland Trail Blazers,0,0,30,23,53,10,14,24,40,37,77,25,12,37,8,35,19,7,10,99,115
2016,2,21600325,12/7/2016,1610612757,Portland Trail Blazers,0,0,1610612749,Milwaukee Bucks,1,1,20,25,45,17,23,40,37,48,85,16,3,19,11,38,25,8,16,99,107
2014,2,21400467,12/30/2014,1610612741,Chicago Bulls,1,0,1610612751,Brooklyn Nets,0,1,25,36,61,8,17,25,33,53,86,8,7,15,16,40,22,9,13,93,82
2014,2,21400467,12/30/2014,1610612751,Brooklyn Nets,0,1,1610612741,Chicago Bulls,1,0,30,39,69,6,8,14,36,47,83,18,3,21,12,36,21,5,11,93,96
2019,2,21900462,12/26/2019,1610612760,Oklahoma City Thunder,1,0,1610612763,Memphis Grizzlies,0,1,28,29,57,10,25,35,38,54,92,11,2,13,11,43,23,6,9,96,97
2019,2,21900462,12/26/2019,1610612763,Memphis Grizzlies,0,1,1610612760,Oklahoma City Thunder,1,0,36,23,59,10,15,25,46,38,84,8,3,11,9,29,26,11,16,95,110
2023,2,22300106,10/30/2023,1610612763,Memphis Grizzlies,1,0,1610612742,Dallas Mavericks,0,1,28,27,55,14,23,37,42,50,92,12,8,20,12,44,22,4,12,101,110
2020,2,22000659,3/22/2021,1610612749,Milwaukee Bucks,1,1,1610612754,Indiana Pacers,0,0,29,26,55,24,15,39,53,41,94,10,5,15,11,32,35,8,16,106,140
2020,2,22000659,3/22/2021,1610612754,Indiana Pacers,0,0,1610612749,Milwaukee Bucks,1,1,33,28,61,12,38,50,45,66,111,11,1,12,18,48,27,3,6,106,113
2014,2,21400080,11/7/2014,1610612742,Dallas Mavericks,0,1,1610612762,Utah Jazz,1,0,33,31,64,9,15,24,42,46,88,12,2,14,15,33,23,4,9,88,105
2014,2,21400080,11/7/2014,1610612762,Utah Jazz,1,0,1610612742,Dallas Mavericks,0,1,20,20,40,9,19,28,29,39,68,15,4,19,11,30,19,12,23,88,82
2021,2,22100545,1/2/2022,1610612752,New York Knicks,0,0,1610612761,Toronto Raptors,1,1,23,19,42,12,24,36,35,43,78,23,5,28,11,34,22,9,18,98,105
2021,2,22100545,1/2/2022,1610612761,Toronto Raptors,1,1,1610612752,New York Knicks,0,0,28,24,52,13,21,34,41,45,86,25,5,30,20,26,21,11,17,98,120
2020,2,22000343,2/5/2021,1610612740,New Orleans Pelicans,0,1,1610612754,Indiana Pacers,1,0,28,23,51,13,12,25,41,35,76,19,7,26,13,27,23,9,20,94,114
2020,2,22000343,2/5/2021,1610612754,Indiana Pacers,1,0,1610612740,New Orleans Pelicans,0,1,21,30,51,20,22,42,41,52,93,11,5,16,16,39,31,5,10,95,113
2022,2,22201215,4/8/2023,1610612746,LA Clippers,1,1,1610612757,Portland Trail Blazers,0,0,37,21,58,12,23,35,49,44,93,26,4,30,17,29,30,8,12,102,136
2022,2,22200908,2/25/2023,1610612738,Boston Celtics,0,1,1610612755,Philadelphia 76ers,1,0,27,23,50,16,20,36,43,43,86,8,4,12,10,35,20,8,13,94,110
2023,2,22300260,11/29/2023,1610612761,Toronto Raptors,1,1,1610612756,Phoenix Suns,0,0,32,34,66,10,17,27,42,51,93,18,3,21,16,37,25,3,10,97,112
2023,2,22300439,12/30/2023,1610612762,Utah Jazz,1,1,1610612748,Miami Heat,0,0,32,20,52,11,30,41,43,50,93,20,8,28,13,40,29,8,10,102,117
2023,2,22300111,10/30/2023,1610612747,Los Angeles Lakers,1,1,1610612753,Orlando Magic,0,0,34,18,52,8,19,27,42,37,79,14,4,18,5,35,28,10,16,98,106
2023,2,22300107,10/30/2023,1610612749,Milwaukee Bucks,1,1,1610612748,Miami Heat,0,0,32,18,50,12,25,37,44,43,87,22,8,30,12,34,24,7,15,102,122
2021,2,22100544,1/1/2022,1610612744,Golden State Warriors,0,1,1610612762,Utah Jazz,1,0,29,25,54,17,15,32,46,40,86,14,7,21,11,33,39,7,15,99,123
2023,2,22300402,12/25/2023,1610612743,Denver Nuggets,1,1,1610612744,Golden State Warriors,0,0,26,22,48,14,20,34,40,42,82,26,6,32,13,32,25,7,14,99,120
2021,2,22100544,1/1/2022,1610612762,Utah Jazz,1,0,1610612744,Golden State Warriors,0,1,26,22,48,14,30,44,40,52,92,22,6,28,19,35,19,10,13,100,116
2020,2,22000342,2/5/2021,1610612762,Utah Jazz,0,1,1610612766,Charlotte Hornets,1,0,22,15,37,26,24,50,48,39,87,16,2,18,9,31,32,9,16,103,138
2020,2,22000342,2/5/2021,1610612766,Charlotte Hornets,1,0,1610612762,Utah Jazz,0,1,37,32,69,11,24,35,48,56,104,14,3,17,17,39,26,5,7,103,121
2017,2,21700291,11/27/2017,1610612739,Cleveland Cavaliers,0,1,1610612755,Philadelphia 76ers,1,0,26,23,49,15,22,37,41,45,86,16,4,20,14,34,25,6,12,94,113
2017,2,21700291,11/27/2017,1610612755,Philadelphia 76ers,1,0,1610612739,Cleveland Cavaliers,0,1,33,35,68,3,25,28,36,60,96,16,4,20,25,36,15,7,14,94,91
2016,2,21600818,2/12/2017,1610612761,Toronto Raptors,1,0,1610612765,Detroit Pistons,0,1,30,29,59,8,8,16,38,37,75,17,8,25,9,31,18,8,11,90,101
2016,2,21600818,2/12/2017,1610612765,Detroit Pistons,0,1,1610612761,Toronto Raptors,1,0,28,25,53,8,23,31,36,48,84,22,7,29,17,34,12,4,7,90,102
2023,2,22300111,10/30/2023,1610612753,Orlando Magic,0,0,1610612747,Los Angeles Lakers,1,1,24,36,60,14,21,35,38,57,95,13,5,18,18,42,28,7,11,99,103
2021,2,22100543,1/1/2022,1610612743,Denver Nuggets,0,1,1610612745,Houston Rockets,1,0,36,18,54,10,22,32,46,40,86,22,5,27,15,25,33,10,18,101,124
2021,2,22100543,1/1/2022,1610612745,Houston Rockets,1,0,1610612743,Denver Nuggets,0,1,21,22,43,16,26,42,37,48,85,21,3,24,15,35,20,10,18,100,111
2020,2,22000341,2/4/2021,1610612743,Denver Nuggets,0,0,1610612747,Los Angeles Lakers,1,1,28,36,64,8,20,28,36,56,92,13,2,15,20,37,19,10,17,96,93
2020,2,22000341,2/4/2021,1610612747,Los Angeles Lakers,1,1,1610612743,Denver Nuggets,0,0,38,19,57,8,16,24,46,35,81,14,8,22,11,28,29,9,16,95,114
2019,2,21900187,11/17/2019,1610612740,New Orleans Pelicans,1,1,1610612744,Golden State Warriors,0,0,19,24,43,18,28,46,37,52,89,16,4,20,14,39,24,7,15,98,108
2022,2,22200908,2/25/2023,1610612755,Philadelphia 76ers,1,0,1610612738,Boston Celtics,0,1,26,25,51,9,18,27,35,43,78,28,7,35,11,36,19,6,10,93,107
2022,2,22201013,3/11/2023,1610612756,Phoenix Suns,1,0,1610612758,Sacramento Kings,0,1,31,14,45,13,31,44,44,45,89,18,4,22,9,37,30,10,14,105,119
2023,2,22300083,10/27/2023,1610612759,San Antonio Spurs,1,1,1610612745,Houston Rockets,0,0,33,19,52,13,29,42,46,48,94,21,7,28,15,38,32,7,18,108,126
2019,2,21900187,11/17/2019,1610612744,Golden State Warriors,0,0,1610612740,New Orleans Pelicans,1,1,30,36,66,7,18,25,37,54,91,19,4,23,17,39,23,3,12,100,100
2020,2,22000658,3/22/2021,1610612738,Boston Celtics,0,0,1610612763,Memphis Grizzlies,1,1,30,25,55,17,18,35,47,43,90,15,9,24,8,40,31,8,13,105,126
2020,2,22000658,3/22/2021,1610612763,Memphis Grizzlies,1,1,1610612738,Boston Celtics,0,0,43,32,75,12,23,35,55,55,110,10,5,15,21,38,38,3,10,106,132
2023,2,22300168,11/8/2023,1610612761,Toronto Raptors,0,1,1610612742,Dallas Mavericks,1,0,38,25,63,11,25,36,49,50,99,18,9,27,19,36,27,4,12,104,127
2023,2,22300258,11/29/2023,1610612765,Detroit Pistons,1,0,1610612747,Los Angeles Lakers,0,1,25,36,61,15,21,36,40,57,97,12,2,14,12,46,28,7,14,105,107
2023,2,22300108,10/30/2023,1610612740,New Orleans Pelicans,1,0,1610612744,Golden State Warriors,0,1,28,26,54,10,29,39,38,55,93,16,10,26,15,45,23,6,11,100,102
2023,2,22300187,11/12/2023,1610612757,Portland Trail Blazers,0,0,1610612747,Los Angeles Lakers,1,1,32,21,53,13,24,37,45,45,90,7,2,9,10,35,29,8,16,101,110
2021,2,22100542,1/1/2022,1610612746,LA Clippers,0,1,1610612751,Brooklyn Nets,1,0,28,22,50,14,22,36,42,44,86,22,9,31,9,41,23,9,11,102,120
2021,2,22100542,1/1/2022,1610612751,Brooklyn Nets,1,0,1610612746,LA Clippers,0,1,31,33,64,11,22,33,42,55,97,21,4,25,19,37,26,7,15,103,116
2020,2,22000340,2/4/2021,1610612745,Houston Rockets,0,1,1610612763,Memphis Grizzlies,1,0,22,20,42,19,26,45,41,46,87,14,3,17,12,35,26,10,15,99,115
2020,2,22000340,2/4/2021,1610612763,Memphis Grizzlies,1,0,1610612745,Houston Rockets,0,1,25,27,52,12,23,35,37,50,87,17,7,24,14,38,28,8,13,98,103
2019,2,21900461,12/26/2019,1610612751,Brooklyn Nets,1,0,1610612752,New York Knicks,0,1,8,20,28,13,37,50,21,57,78,27,9,36,10,50,17,6,13,99,82
2023,2,22300187,11/12/2023,1610612747,Los Angeles Lakers,1,1,1610612757,Portland Trail Blazers,0,0,37,28,65,4,15,19,41,43,84,30,7,37,9,36,27,2,9,100,116
2023,2,22300785,2/14/2024,1610612742,Dallas Mavericks,1,1,1610612759,San Antonio Spurs,0,0,38,24,62,11,19,30,49,43,92,7,3,10,12,32,28,8,16,104,116
2019,2,21900461,12/26/2019,1610612752,New York Knicks,0,1,1610612751,Brooklyn Nets,1,0,28,35,63,9,20,29,37,55,92,11,4,15,14,43,16,3,14,98,94
2017,2,21700290,11/27/2017,1610612753,Orlando Magic,0,0,1610612754,Indiana Pacers,1,1,24,27,51,16,25,41,40,52,92,13,3,16,16,39,22,7,15,99,109
2023,2,22300211,11/19/2023,1610612761,Toronto Raptors,1,1,1610612765,Detroit Pistons,0,0,41,25,66,14,22,36,55,47,102,18,11,29,18,35,44,3,8,105,142
2017,2,21700290,11/27/2017,1610612754,Indiana Pacers,1,1,1610612753,Orlando Magic,0,0,27,26,53,15,11,26,42,37,79,22,4,26,10,28,25,4,16,98,121
2014,2,21400079,11/7/2014,1610612756,Phoenix Suns,1,0,1610612758,Sacramento Kings,0,1,32,35,67,10,21,31,42,56,98,18,7,25,13,49,19,6,12,110,112
2014,2,21400079,11/7/2014,1610612758,Sacramento Kings,0,1,1610612756,Phoenix Suns,1,0,36,39,75,3,13,16,39,52,91,33,6,39,18,36,16,7,16,107,114
2020,2,22000657,3/22/2021,1610612745,Houston Rockets,1,1,1610612761,Toronto Raptors,0,0,27,27,54,14,22,36,41,49,90,21,5,26,15,37,28,6,12,100,117
2020,2,22000657,3/22/2021,1610612761,Toronto Raptors,0,0,1610612745,Houston Rockets,1,1,27,20,47,10,30,40,37,50,87,15,4,19,12,39,19,7,15,99,99
2014,2,21401034,3/21/2015,1610612745,Houston Rockets,1,0,1610612756,Phoenix Suns,0,1,31,22,53,10,24,34,41,46,87,10,2,12,8,39,28,10,18,103,102
2014,2,21401034,3/21/2015,1610612756,Phoenix Suns,0,1,1610612745,Houston Rockets,1,0,38,39,77,8,7,15,46,46,92,17,7,24,16,35,20,7,15,103,117
2014,2,21400466,12/30/2014,1610612737,Atlanta Hawks,1,1,1610612739,Cleveland Cavaliers,0,0,30,20,50,10,19,29,40,39,79,19,7,26,9,34,23,10,15,97,109
2014,2,21400466,12/30/2014,1610612739,Cleveland Cavaliers,0,0,1610612737,Atlanta Hawks,1,1,24,29,53,13,18,31,37,47,84,14,7,21,14,38,23,13,20,98,101
2022,2,22201013,3/11/2023,1610612758,Sacramento Kings,0,1,1610612756,Phoenix Suns,1,0,26,24,50,15,20,35,41,44,85,31,6,37,13,33,19,11,15,105,128
2020,2,22000339,2/4/2021,1610612742,Dallas Mavericks,1,0,1610612744,Golden State Warriors,0,1,18,24,42,20,30,50,38,54,92,20,3,23,12,44,26,6,10,101,116
2020,2,22000339,2/4/2021,1610612744,Golden State Warriors,0,1,1610612742,Dallas Mavericks,1,0,29,17,46,22,21,43,51,38,89,23,4,27,8,32,37,2,10,101,147
2019,2,21900186,11/17/2019,1610612743,Denver Nuggets,0,1,1610612763,Memphis Grizzlies,1,0,31,26,57,18,14,32,49,40,89,15,8,23,9,38,36,4,12,102,131
2019,2,21900186,11/17/2019,1610612763,Memphis Grizzlies,1,0,1610612743,Denver Nuggets,0,1,23,25,48,16,20,36,39,45,84,20,4,24,10,35,29,10,16,103,114
2023,2,22300258,11/29/2023,1610612747,Los Angeles Lakers,0,1,1610612765,Detroit Pistons,1,0,33,21,54,12,22,34,45,43,88,31,7,38,13,33,28,8,12,105,133
2022,2,22200909,2/25/2023,1610612762,Utah Jazz,1,1,1610612759,San Antonio Spurs,0,0,33,31,64,10,18,28,43,49,92,22,6,28,17,35,29,5,16,102,118
2020,2,22000656,3/22/2021,1610612741,Chicago Bulls,1,0,1610612762,Utah Jazz,0,1,33,37,70,6,20,26,39,57,96,11,1,12,19,38,21,9,14,98,95
2020,2,22000656,3/22/2021,1610612762,Utah Jazz,0,1,1610612741,Chicago Bulls,1,0,28,25,53,17,22,39,45,47,92,13,2,15,11,37,25,5,9,96,120
2022,2,22200909,2/25/2023,1610612759,San Antonio Spurs,0,0,1610612762,Utah Jazz,1,1,29,34,63,9,25,34,38,59,97,17,4,21,16,44,21,5,10,102,102
2021,2,22100541,1/1/2022,1610612741,Chicago Bulls,0,1,1610612764,Washington Wizards,1,0,24,26,50,17,17,34,41,43,84,21,4,25,7,38,17,9,15,103,120
2021,2,22100541,1/1/2022,1610612764,Washington Wizards,1,0,1610612741,Chicago Bulls,0,1,40,20,60,6,21,27,46,41,87,21,5,26,8,38,26,4,12,104,119
2017,2,21700289,11/26/2017,1610612751,Brooklyn Nets,0,1,1610612763,Memphis Grizzlies,1,0,20,25,45,13,16,29,33,41,74,19,4,23,15,27,19,8,19,89,98
2017,2,21700289,11/26/2017,1610612763,Memphis Grizzlies,1,0,1610612751,Brooklyn Nets,0,1,24,31,55,8,17,25,32,48,80,16,2,18,15,35,15,7,14,90,88
2022,2,22201215,4/8/2023,1610612757,Portland Trail Blazers,0,0,1610612746,LA Clippers,1,1,33,24,57,14,18,32,47,42,89,17,6,23,7,39,32,7,10,101,125
2023,2,22300082,10/27/2023,1610612741,Chicago Bulls,1,1,1610612761,Toronto Raptors,0,0,29,31,60,8,31,39,37,62,99,22,6,28,20,47,18,5,17,108,104
2023,2,22300379,12/21/2023,1610612746,LA Clippers,0,0,1610612760,Oklahoma City Thunder,1,1,27,23,50,17,26,43,44,49,93,10,2,12,15,34,23,9,16,98,115
2023,2,22300109,10/30/2023,1610612760,Oklahoma City Thunder,1,1,1610612765,Detroit Pistons,0,0,31,23,54,13,16,29,44,39,83,23,5,28,9,31,21,6,15,102,124
2023,2,22300596,1/20/2024,1610612761,Toronto Raptors,0,0,1610612752,New York Knicks,1,1,27,31,58,11,23,34,38,54,92,13,10,23,12,48,29,4,10,101,100
2020,2,22000655,3/22/2021,1610612759,San Antonio Spurs,1,0,1610612766,Charlotte Hornets,0,1,25,21,46,11,21,32,36,42,78,14,3,17,8,35,17,5,14,93,97
2020,2,22000655,3/22/2021,1610612766,Charlotte Hornets,0,1,1610612759,San Antonio Spurs,1,0,22,27,49,12,20,32,34,47,81,20,3,23,15,34,27,5,15,93,100
2020,2,22000338,2/4/2021,1610612737,Atlanta Hawks,1,0,1610612762,Utah Jazz,0,1,23,44,67,9,22,31,32,66,98,18,1,19,21,45,19,7,11,96,91
2020,2,22000338,2/4/2021,1610612762,Utah Jazz,0,1,1610612737,Atlanta Hawks,1,0,31,33,64,13,14,27,44,47,91,11,2,13,16,32,19,8,14,96,112
2019,2,21900460,12/26/2019,1610612764,Washington Wizards,0,0,1610612765,Detroit Pistons,1,1,31,37,68,7,17,24,38,54,92,19,8,27,18,40,18,5,12,98,102
2019,2,21900460,12/26/2019,1610612765,Detroit Pistons,1,1,1610612764,Washington Wizards,0,0,27,11,38,19,29,48,46,40,86,21,5,26,15,28,32,7,15,98,132
2014,2,21400465,12/30/2014,1610612753,Orlando Magic,1,0,1610612765,Detroit Pistons,0,1,34,31,65,4,16,20,38,47,85,6,4,10,12,38,19,9,16,95,86
2014,2,21400465,12/30/2014,1610612765,Detroit Pistons,0,1,1610612753,Orlando Magic,1,0,26,27,53,14,19,33,40,46,86,15,14,29,17,37,22,7,11,94,109
2020,2,22000654,3/22/2021,1610612750,Minnesota Timberwolves,1,0,1610612760,Oklahoma City Thunder,0,1,24,29,53,14,25,39,38,54,92,13,5,18,16,39,24,8,12,97,103
2020,2,22000654,3/22/2021,1610612760,Oklahoma City Thunder,0,1,1610612750,Minnesota Timberwolves,1,0,20,30,50,21,16,37,41,46,87,9,1,10,13,33,27,11,17,97,112
2018,2,21801106,3/25/2019,1610612751,Brooklyn Nets,0,0,1610612757,Portland Trail Blazers,1,1,34,27,61,15,27,42,49,54,103,31,13,44,18,43,25,9,16,122,144
2018,2,21801106,3/25/2019,1610612757,Portland Trail Blazers,1,1,1610612751,Brooklyn Nets,0,0,39,37,76,14,31,45,53,68,121,28,8,36,25,45,35,3,5,122,148
2021,2,22100540,1/1/2022,1610612759,San Antonio Spurs,0,0,1610612765,Detroit Pistons,1,1,30,32,62,12,28,40,42,60,102,20,8,28,21,43,30,12,17,111,116
2021,2,22100540,1/1/2022,1610612765,Detroit Pistons,1,1,1610612759,San Antonio Spurs,0,0,32,34,66,9,26,35,41,60,101,26,7,33,26,37,18,8,21,111,117
2014,2,21400078,11/7/2014,1610612760,Oklahoma City Thunder,1,0,1610612763,Memphis Grizzlies,0,1,25,29,54,12,13,25,37,42,79,3,8,11,15,33,16,10,20,89,89
2014,2,21400078,11/7/2014,1610612763,Memphis Grizzlies,0,1,1610612760,Oklahoma City Thunder,1,0,25,38,63,9,9,18,34,47,81,14,3,17,10,40,21,3,8,87,91
2019,2,21900459,12/25/2019,1610612740,New Orleans Pelicans,0,1,1610612743,Denver Nuggets,1,0,23,24,47,18,25,43,41,49,90,12,0,12,18,31,23,10,19,96,112
2023,2,22300108,10/30/2023,1610612744,Golden State Warriors,0,1,1610612740,New Orleans Pelicans,1,0,36,21,57,15,26,41,51,47,98,13,7,20,23,27,28,8,15,100,130
2019,2,21900459,12/25/2019,1610612743,Denver Nuggets,1,0,1610612740,New Orleans Pelicans,0,1,25,30,55,12,25,37,37,55,92,14,4,18,17,39,24,9,12,97,100
2016,2,21600324,12/7/2016,1610612737,Atlanta Hawks,1,1,1610612748,Miami Heat,0,0,39,30,69,4,15,19,43,45,88,13,2,15,19,26,27,6,14,93,103
2016,2,21600324,12/7/2016,1610612748,Miami Heat,0,0,1610612737,Atlanta Hawks,1,1,23,30,53,11,16,27,34,46,80,16,4,20,14,35,20,9,17,92,95
2014,2,21401032,3/21/2015,1610612751,Brooklyn Nets,0,1,1610612754,Indiana Pacers,1,0,40,23,63,6,6,12,46,29,75,25,6,31,3,28,21,3,9,94,123
2014,2,21401032,3/21/2015,1610612754,Indiana Pacers,1,0,1610612751,Brooklyn Nets,0,1,37,30,67,8,15,23,45,45,90,13,5,18,13,34,22,4,9,95,111
2021,2,22100539,1/1/2022,1610612740,New Orleans Pelicans,0,0,1610612749,Milwaukee Bucks,1,1,23,21,44,16,35,51,39,56,95,19,11,30,15,45,28,10,15,107,113
2021,2,22100539,1/1/2022,1610612749,Milwaukee Bucks,1,1,1610612740,New Orleans Pelicans,0,0,26,18,44,23,25,48,49,43,92,15,3,18,9,36,27,10,14,107,136
2020,2,22000337,2/4/2021,1610612755,Philadelphia 76ers,1,0,1610612757,Portland Trail Blazers,0,1,32,22,54,7,20,27,39,42,81,20,4,24,11,34,19,8,18,101,105
2020,2,22000337,2/4/2021,1610612757,Portland Trail Blazers,0,1,1610612755,Philadelphia 76ers,1,0,32,35,67,13,18,31,45,53,98,18,5,23,21,32,17,6,12,101,121
2014,2,21401033,3/21/2015,1610612741,Chicago Bulls,0,0,1610612765,Detroit Pistons,1,1,27,29,56,6,15,21,33,44,77,19,5,24,10,38,22,9,12,91,91
2014,2,21401033,3/21/2015,1610612765,Detroit Pistons,1,1,1610612741,Chicago Bulls,0,0,33,31,64,11,15,26,44,46,90,8,2,10,8,39,28,2,4,91,107
2022,2,22201214,4/8/2023,1610612759,San Antonio Spurs,1,0,1610612750,Minnesota Timberwolves,0,1,37,29,66,13,16,29,50,45,95,18,6,24,13,34,34,8,13,105,131
2023,2,22300106,10/30/2023,1610612742,Dallas Mavericks,0,1,1610612763,Memphis Grizzlies,1,0,19,18,37,23,24,47,42,42,84,18,6,24,9,37,24,9,15,101,125
2020,2,22000653,3/22/2021,1610612739,Cleveland Cavaliers,1,0,1610612758,Sacramento Kings,0,1,37,42,79,4,13,17,41,55,96,19,4,23,16,41,22,6,10,102,105
2020,2,22000653,3/22/2021,1610612758,Sacramento Kings,0,1,1610612739,Cleveland Cavaliers,1,0,36,24,60,13,17,30,49,41,90,8,4,12,12,31,26,13,17,101,119
2021,2,22100538,12/31/2021,1610612747,Los Angeles Lakers,1,1,1610612757,Portland Trail Blazers,0,0,28,16,44,19,22,41,47,38,85,26,4,30,6,34,27,4,7,99,139
2021,2,22100538,12/31/2021,1610612757,Portland Trail Blazers,0,0,1610612747,Los Angeles Lakers,1,1,24,36,60,12,30,42,36,66,102,22,5,27,25,43,19,6,9,99,106
2019,2,21900458,12/25/2019,1610612746,LA Clippers,0,1,1610612747,Los Angeles Lakers,1,0,30,30,60,9,16,25,39,46,85,24,8,32,17,32,24,11,16,99,111
2019,2,21900458,12/25/2019,1610612747,Los Angeles Lakers,1,0,1610612746,LA Clippers,0,1,27,24,51,12,33,45,39,57,96,16,5,21,19,42,24,6,13,101,106
2022,2,22201066,3/19/2023,1610612765,Detroit Pistons,1,0,1610612748,Miami Heat,0,1,28,22,50,10,22,32,38,44,82,14,3,17,11,36,26,4,13,91,100
2022,2,22201214,4/8/2023,1610612750,Minnesota Timberwolves,0,1,1610612759,San Antonio Spurs,1,0,32,26,58,24,19,43,56,45,101,15,6,21,12,37,42,5,7,105,151
2022,2,22200528,12/29/2022,1610612742,Dallas Mavericks,1,1,1610612745,Houston Rockets,0,0,29,17,46,18,27,45,47,44,91,17,8,25,10,39,30,5,9,100,129
2022,2,22200528,12/29/2022,1610612745,Houston Rockets,0,0,1610612742,Dallas Mavericks,1,1,26,26,52,12,22,34,38,48,86,26,11,37,16,41,21,7,13,99,114
2021,2,22100537,12/31/2021,1610612750,Minnesota Timberwolves,0,0,1610612762,Utah Jazz,1,1,26,26,52,14,27,41,40,53,93,14,8,22,14,44,23,4,10,100,108
2021,2,22100537,12/31/2021,1610612762,Utah Jazz,1,1,1610612750,Minnesota Timberwolves,0,0,26,23,49,11,18,29,37,41,78,35,6,41,15,30,18,9,18,99,120
2020,2,22000336,2/3/2021,1610612738,Boston Celtics,0,0,1610612758,Sacramento Kings,1,1,28,25,53,11,22,33,39,47,86,22,7,29,13,36,28,7,13,99,111
2023,2,22300224,11/20/2023,1610612745,Houston Rockets,0,0,1610612744,Golden State Warriors,1,1,31,23,54,13,28,41,44,51,95,15,4,19,17,37,28,3,8,94,116
2020,2,22000336,2/3/2021,1610612758,Sacramento Kings,1,1,1610612738,Boston Celtics,0,0,29,26,55,13,24,37,42,50,92,19,4,23,14,37,23,9,11,100,116
2020,2,22000652,3/21/2021,1610612742,Dallas Mavericks,0,1,1610612757,Portland Trail Blazers,1,0,29,20,49,19,18,37,48,38,86,17,3,20,13,26,23,7,11,96,132
2020,2,22000652,3/21/2021,1610612757,Portland Trail Blazers,1,0,1610612742,Dallas Mavericks,0,1,25,23,48,9,32,41,34,55,89,15,4,19,12,47,17,4,7,94,92
2023,2,22300107,10/30/2023,1610612748,Miami Heat,0,0,1610612749,Milwaukee Bucks,1,1,28,24,52,13,21,34,41,45,86,19,1,20,9,36,27,8,15,102,114
2023,2,22300230,11/22/2023,1610612754,Indiana Pacers,1,0,1610612761,Toronto Raptors,0,1,32,20,52,18,21,39,50,41,91,13,3,16,8,34,33,7,15,106,131
2021,2,22100536,12/31/2021,1610612752,New York Knicks,0,0,1610612760,Oklahoma City Thunder,1,1,22,18,40,8,33,41,30,51,81,12,10,22,9,46,12,6,10,93,80
2021,2,22100536,12/31/2021,1610612760,Oklahoma City Thunder,1,1,1610612752,New York Knicks,0,0,18,26,44,18,25,43,36,51,87,5,2,7,8,44,21,6,10,92,95
2020,2,22000335,2/3/2021,1610612740,New Orleans Pelicans,1,1,1610612756,Phoenix Suns,0,0,32,25,57,14,19,33,46,44,90,17,4,21,16,29,30,3,7,92,123
2020,2,22000335,2/3/2021,1610612756,Phoenix Suns,0,0,1610612740,New Orleans Pelicans,1,1,30,17,47,8,27,35,38,44,82,17,3,20,12,33,26,7,15,94,101
2017,2,21700288,11/26/2017,1610612750,Minnesota Timberwolves,1,1,1610612756,Phoenix Suns,0,0,40,32,72,9,12,21,49,44,93,12,5,17,21,26,24,6,14,94,119
2020,2,22000651,3/21/2021,1610612747,Los Angeles Lakers,0,0,1610612756,Phoenix Suns,1,1,30,30,60,5,20,25,35,50,85,19,9,28,9,44,20,7,11,100,94
2020,2,22000651,3/21/2021,1610612756,Phoenix Suns,1,1,1610612747,Los Angeles Lakers,0,0,33,22,55,9,23,32,42,45,87,18,5,23,12,36,30,3,11,101,111
2014,2,21400077,11/7/2014,1610612761,Toronto Raptors,1,1,1610612764,Washington Wizards,0,0,26,32,58,9,13,22,35,45,80,24,7,31,14,36,19,7,13,93,103
2014,2,21400077,11/7/2014,1610612764,Washington Wizards,0,0,1610612761,Toronto Raptors,1,1,27,37,64,3,16,19,30,53,83,21,11,32,18,41,19,5,13,93,84
2020,2,22000334,2/3/2021,1610612750,Minnesota Timberwolves,0,0,1610612759,San Antonio Spurs,1,1,30,31,61,13,20,33,43,51,94,9,2,11,11,40,22,5,10,100,108
2020,2,22000334,2/3/2021,1610612759,San Antonio Spurs,1,1,1610612750,Minnesota Timberwolves,0,0,36,34,70,7,19,26,43,53,96,18,6,24,13,43,28,6,7,100,111
2017,2,21700288,11/26/2017,1610612756,Phoenix Suns,0,0,1610612750,Minnesota Timberwolves,1,1,30,29,59,13,13,26,43,42,85,9,3,12,13,31,25,12,16,93,108
2016,2,21600817,2/12/2017,1610612752,New York Knicks,1,1,1610612759,San Antonio Spurs,0,0,25,29,54,9,5,14,34,34,68,17,4,21,8,27,18,11,20,91,94
2016,2,21600817,2/12/2017,1610612759,San Antonio Spurs,0,0,1610612752,New York Knicks,1,1,27,35,62,6,23,29,33,58,91,18,4,22,21,39,17,5,11,91,90
2023,2,22300928,3/10/2024,1610612753,Orlando Magic,1,0,1610612754,Indiana Pacers,0,1,24,28,52,9,27,36,33,55,88,22,7,29,16,44,18,5,13,100,97
2023,2,22300083,10/27/2023,1610612745,Houston Rockets,0,0,1610612759,San Antonio Spurs,1,1,44,24,68,8,24,32,52,48,100,10,10,20,18,36,30,11,18,111,122
2023,2,22300190,11/13/2023,1610612741,Chicago Bulls,0,0,1610612749,Milwaukee Bucks,1,1,24,34,58,14,28,42,38,62,100,19,2,21,20,43,24,3,8,96,109
2023,2,22300259,11/29/2023,1610612764,Washington Wizards,0,0,1610612753,Orlando Magic,1,1,30,28,58,11,18,29,41,46,87,27,8,35,11,39,28,5,10,101,120
2023,2,22301213,12/6/2023,1610612742,Dallas Mavericks,1,1,1610612762,Utah Jazz,0,0,34,18,52,22,27,49,56,45,101,13,6,19,15,34,37,6,8,104,147
2023,2,22300930,3/10/2024,1610612751,Brooklyn Nets,0,1,1610612739,Cleveland Cavaliers,1,0,24,20,44,18,17,35,42,37,79,18,2,20,11,27,33,8,15,92,120
2021,2,22100535,12/31/2021,1610612759,San Antonio Spurs,0,0,1610612763,Memphis Grizzlies,1,1,27,28,55,12,23,35,39,51,90,15,9,24,13,43,24,7,11,98,105
2021,2,22100535,12/31/2021,1610612763,Memphis Grizzlies,1,1,1610612759,San Antonio Spurs,0,0,39,37,76,10,16,26,49,53,102,10,6,16,19,37,28,3,10,99,118
2020,2,22000333,2/3/2021,1610612745,Houston Rockets,0,0,1610612760,Oklahoma City Thunder,1,1,21,19,40,12,34,46,33,53,86,9,4,13,6,48,21,13,21,108,87
2020,2,22000333,2/3/2021,1610612760,Oklahoma City Thunder,1,1,1610612745,Houston Rockets,0,0,26,24,50,10,23,33,36,47,83,22,4,26,9,40,19,11,21,109,104
2019,2,21900457,12/25/2019,1610612744,Golden State Warriors,1,1,1610612745,Houston Rockets,0,0,32,27,59,9,19,28,41,46,87,25,3,28,13,36,27,8,16,103,116
2019,2,21900457,12/25/2019,1610612745,Houston Rockets,0,0,1610612744,Golden State Warriors,1,1,21,28,49,16,35,51,37,63,100,14,2,16,16,48,19,7,12,102,104
2023,2,22300082,10/27/2023,1610612761,Toronto Raptors,0,0,1610612741,Chicago Bulls,1,1,30,18,48,9,27,36,39,45,84,16,9,25,10,39,25,10,23,106,103
2019,2,21900185,11/17/2019,1610612753,Orlando Magic,1,1,1610612764,Washington Wizards,0,0,28,21,49,15,23,38,43,44,87,24,2,26,13,31,25,7,14,100,125
2019,2,21900185,11/17/2019,1610612764,Washington Wizards,0,0,1610612753,Orlando Magic,1,1,27,29,56,19,22,41,46,51,97,10,2,12,10,42,31,5,9,101,121
2014,2,21400076,11/7/2014,1610612749,Milwaukee Bucks,0,0,1610612765,Detroit Pistons,1,1,31,26,57,5,15,20,36,41,77,18,5,23,12,30,26,7,13,91,95
2014,2,21400076,11/7/2014,1610612765,Detroit Pistons,1,1,1610612749,Milwaukee Bucks,0,0,26,26,52,11,12,23,37,38,75,13,11,24,16,26,18,10,19,90,98
2020,2,22000649,3/21/2021,1610612741,Chicago Bulls,0,1,1610612765,Detroit Pistons,1,0,23,29,52,14,14,28,37,43,80,12,2,14,12,32,26,11,21,95,100
2020,2,22000649,3/21/2021,1610612765,Detroit Pistons,1,0,1610612741,Chicago Bulls,0,1,28,29,57,4,21,25,32,50,82,18,7,25,11,44,20,8,15,97,86
2020,2,22000332,2/3/2021,1610612741,Chicago Bulls,1,0,1610612752,New York Knicks,0,1,37,15,52,6,30,36,43,45,88,11,5,16,8,40,25,5,9,97,103
2020,2,22000332,2/3/2021,1610612752,New York Knicks,0,1,1610612741,Chicago Bulls,1,0,32,35,67,11,11,22,43,46,89,10,5,15,16,34,19,11,17,97,107
2017,2,21700287,11/26/2017,1610612741,Chicago Bulls,1,0,1610612748,Miami Heat,0,1,19,37,56,14,19,33,33,56,89,13,3,16,14,46,25,9,14,98,93
2017,2,21700287,11/26/2017,1610612748,Miami Heat,0,1,1610612741,Chicago Bulls,1,0,21,22,43,13,19,32,34,41,75,19,4,23,1,39,19,10,13,96,100
2022,2,22201165,4/2/2023,1610612763,Memphis Grizzlies,0,0,1610612741,Chicago Bulls,1,1,20,21,41,19,24,43,39,45,84,10,2,12,11,35,29,9,18,98,107
2016,2,21600816,2/12/2017,1610612741,Chicago Bulls,0,0,1610612750,Minnesota Timberwolves,1,1,25,34,59,10,15,25,35,49,84,9,4,13,13,38,22,11,18,96,89
2016,2,21600816,2/12/2017,1610612750,Minnesota Timberwolves,1,1,1610612741,Chicago Bulls,0,0,38,19,57,6,18,24,44,37,81,23,3,26,12,27,27,7,15,94,117
2016,2,21600323,12/7/2016,1610612743,Denver Nuggets,0,0,1610612751,Brooklyn Nets,1,1,31,37,68,11,26,37,42,63,105,16,5,21,30,35,18,11,17,104,111
2020,2,22000648,3/21/2021,1610612739,Cleveland Cavaliers,1,1,1610612761,Toronto Raptors,0,0,22,22,44,17,16,33,39,38,77,21,7,28,11,30,29,13,27,106,116
2023,2,22300084,10/27/2023,1610612742,Dallas Mavericks,1,1,1610612751,Brooklyn Nets,0,0,29,26,55,15,21,36,44,47,91,22,6,28,12,38,20,5,9,100,125
2020,2,22000648,3/21/2021,1610612761,Toronto Raptors,0,0,1610612739,Cleveland Cavaliers,1,1,22,27,49,15,31,46,37,58,95,16,3,19,13,47,19,8,14,108,105
2023,2,22300084,10/27/2023,1610612751,Brooklyn Nets,0,0,1610612742,Dallas Mavericks,1,1,24,25,49,21,22,43,45,47,92,9,1,10,13,34,30,5,16,101,120
2023,2,22300109,10/30/2023,1610612765,Detroit Pistons,0,0,1610612760,Oklahoma City Thunder,1,1,24,39,63,15,13,28,39,52,91,19,5,24,16,40,31,9,17,102,112
2023,2,22300224,11/20/2023,1610612744,Golden State Warriors,1,1,1610612745,Houston Rockets,0,0,15,19,34,21,22,43,36,41,77,28,5,33,8,36,26,6,8,92,121
2023,2,22300120,11/1/2023,1610612739,Cleveland Cavaliers,0,1,1610612752,New York Knicks,1,0,20,22,42,12,20,32,32,42,74,19,1,20,7,36,22,10,18,94,95
2021,2,22100534,12/31/2021,1610612746,LA Clippers,0,0,1610612761,Toronto Raptors,1,1,23,21,44,15,19,34,38,40,78,17,2,19,5,36,27,8,13,95,108
2021,2,22100534,12/31/2021,1610612761,Toronto Raptors,1,1,1610612746,LA Clippers,0,0,29,32,61,11,24,35,40,56,96,25,8,33,24,35,19,6,7,95,116
2017,2,21700286,11/25/2017,1610612746,LA Clippers,0,1,1610612758,Sacramento Kings,1,0,29,23,52,9,19,28,38,42,80,12,1,13,12,30,23,9,18,91,97
2017,2,21700286,11/25/2017,1610612758,Sacramento Kings,1,0,1610612746,LA Clippers,0,1,27,35,62,11,10,21,38,45,83,8,1,9,13,33,19,11,18,92,95
2023,2,22300183,11/12/2023,1610612742,Dallas Mavericks,0,1,1610612740,New Orleans Pelicans,1,0,30,19,49,20,33,53,50,52,102,16,5,21,10,44,29,2,6,107,136
2019,2,21900456,12/25/2019,1610612749,Milwaukee Bucks,0,0,1610612755,Philadelphia 76ers,1,1,32,30,62,13,20,33,45,50,95,6,2,8,13,38,23,9,10,96,109
2019,2,21900456,12/25/2019,1610612755,Philadelphia 76ers,1,1,1610612749,Milwaukee Bucks,0,0,23,34,57,21,23,44,44,57,101,12,3,15,19,41,29,6,8,96,121
2014,2,21400075,11/7/2014,1610612751,Brooklyn Nets,1,1,1610612752,New York Knicks,0,0,24,26,50,14,10,24,38,36,74,20,6,26,8,30,18,7,17,94,110
2021,2,22100533,12/31/2021,1610612737,Atlanta Hawks,0,1,1610612739,Cleveland Cavaliers,1,0,27,32,59,16,22,38,43,54,97,19,2,21,14,40,23,1,2,93,121
2021,2,22100533,12/31/2021,1610612739,Cleveland Cavaliers,1,0,1610612737,Atlanta Hawks,0,1,40,19,59,8,17,25,48,36,84,14,10,24,10,30,27,8,9,94,118
2020,2,22000331,2/3/2021,1610612748,Miami Heat,1,0,1610612764,Washington Wizards,0,1,24,24,48,12,23,35,36,47,83,16,6,22,13,36,24,6,16,97,100
2020,2,22000331,2/3/2021,1610612764,Washington Wizards,0,1,1610612748,Miami Heat,1,0,20,27,47,15,22,37,35,49,84,18,7,25,17,35,20,11,17,98,103
2017,2,21700285,11/25/2017,1610612749,Milwaukee Bucks,0,0,1610612762,Utah Jazz,1,1,33,23,56,8,13,21,41,36,77,18,5,23,13,26,19,8,17,93,108
2017,2,21700285,11/25/2017,1610612762,Utah Jazz,1,1,1610612749,Milwaukee Bucks,0,0,28,21,49,18,14,32,46,35,81,11,8,19,8,33,31,5,10,91,121
2016,2,21600323,12/7/2016,1610612751,Brooklyn Nets,1,1,1610612743,Denver Nuggets,0,0,32,27,59,9,17,26,41,44,85,25,6,31,11,34,18,7,15,102,116
2020,2,22000647,3/21/2021,1610612751,Brooklyn Nets,1,1,1610612764,Washington Wizards,0,0,35,26,61,9,20,29,44,46,90,16,6,22,13,35,24,5,7,94,113
2020,2,22000647,3/21/2021,1610612764,Washington Wizards,0,0,1610612751,Brooklyn Nets,1,1,35,23,58,7,14,21,42,37,79,15,4,19,12,26,24,11,19,94,106
2023,2,22300169,11/8/2023,1610612743,Denver Nuggets,1,1,1610612744,Golden State Warriors,0,0,30,27,57,11,24,35,41,51,92,15,7,22,14,40,24,5,6,95,108
2021,2,22100532,12/31/2021,1610612745,Houston Rockets,1,0,1610612748,Miami Heat,0,1,27,24,51,14,28,42,41,52,93,14,3,17,17,35,21,7,18,101,110
2021,2,22100532,12/31/2021,1610612748,Miami Heat,0,1,1610612745,Houston Rockets,1,0,26,27,53,14,19,33,40,46,86,26,5,31,13,34,21,9,14,101,120
2014,2,21400075,11/7/2014,1610612752,New York Knicks,0,0,1610612751,Brooklyn Nets,1,1,29,42,71,8,11,19,37,53,90,17,4,21,20,36,22,6,15,95,99
2019,2,21900184,11/17/2019,1610612738,Boston Celtics,0,0,1610612758,Sacramento Kings,1,1,24,28,52,10,20,30,34,48,82,21,3,24,13,37,26,8,15,96,99
2019,2,21900184,11/17/2019,1610612758,Sacramento Kings,1,1,1610612738,Boston Celtics,0,0,24,30,54,14,21,35,38,51,89,10,2,12,13,40,22,7,12,95,100
2014,2,21400464,12/29/2014,1610612746,LA Clippers,1,1,1610612762,Utah Jazz,0,0,27,31,58,10,13,23,37,44,81,17,5,22,13,34,24,7,14,95,101
2014,2,21400464,12/29/2014,1610612762,Utah Jazz,0,0,1610612746,LA Clippers,1,1,30,43,73,8,11,19,38,54,92,13,9,22,21,35,26,7,13,95,97
2021,2,22100531,12/31/2021,1610612742,Dallas Mavericks,0,1,1610612758,Sacramento Kings,1,0,33,26,59,9,13,22,42,39,81,19,3,22,11,28,30,7,13,92,112
2021,2,22100531,12/31/2021,1610612758,Sacramento Kings,1,0,1610612742,Dallas Mavericks,0,1,28,34,62,10,19,29,38,53,91,10,2,12,13,40,25,5,10,93,96
2020,2,22000330,2/3/2021,1610612737,Atlanta Hawks,1,0,1610612742,Dallas Mavericks,0,1,31,21,52,14,24,38,45,45,90,12,5,17,15,33,31,8,16,100,116
2020,2,22000330,2/3/2021,1610612742,Dallas Mavericks,0,1,1610612737,Atlanta Hawks,1,0,30,23,53,13,27,40,43,50,93,23,2,25,15,35,27,6,10,100,122
2022,2,22201165,4/2/2023,1610612741,Chicago Bulls,1,1,1610612763,Memphis Grizzlies,0,0,41,22,63,9,22,31,50,44,94,19,3,22,6,41,29,1,3,98,128
2023,2,22300110,10/30/2023,1610612743,Denver Nuggets,1,1,1610612762,Utah Jazz,0,0,38,18,56,9,19,28,47,37,84,7,10,17,8,34,32,6,13,97,110
2019,2,21900455,12/25/2019,1610612738,Boston Celtics,0,1,1610612761,Toronto Raptors,1,0,32,27,59,14,19,33,46,46,92,12,2,14,19,29,26,13,19,99,118
2019,2,21900455,12/25/2019,1610612761,Toronto Raptors,1,0,1610612738,Boston Celtics,0,1,30,27,57,8,15,23,38,42,80,18,4,22,8,36,17,7,17,100,102
2020,2,22000646,3/21/2021,1610612740,New Orleans Pelicans,0,1,1610612743,Denver Nuggets,1,0,33,24,57,8,20,28,41,44,85,23,7,30,18,28,26,9,16,98,113
2020,2,22000646,3/21/2021,1610612743,Denver Nuggets,1,0,1610612740,New Orleans Pelicans,0,1,32,22,54,12,22,34,44,44,88,8,2,10,13,32,30,8,15,96,108
2023,2,22300211,11/19/2023,1610612765,Detroit Pistons,0,0,1610612761,Toronto Raptors,1,1,30,27,57,9,17,26,39,44,83,26,9,35,11,38,25,10,17,105,113
2023,2,22300120,11/1/2023,1610612752,New York Knicks,1,0,1610612739,Cleveland Cavaliers,0,1,27,35,62,5,25,30,32,60,92,20,10,30,23,43,18,7,14,95,89
2021,2,22100530,12/31/2021,1610612741,Chicago Bulls,0,1,1610612754,Indiana Pacers,1,0,23,36,59,12,15,27,35,51,86,26,4,30,12,39,22,7,11,101,108
2021,2,22100530,12/31/2021,1610612754,Indiana Pacers,1,0,1610612741,Chicago Bulls,0,1,30,30,60,8,23,31,38,53,91,22,7,29,21,36,23,11,17,101,106
2020,2,22000329,2/3/2021,1610612749,Milwaukee Bucks,1,1,1610612754,Indiana Pacers,0,0,27,27,54,21,27,48,48,54,102,13,1,14,13,41,33,7,13,106,130
2020,2,22000329,2/3/2021,1610612754,Indiana Pacers,0,0,1610612749,Milwaukee Bucks,1,1,32,29,61,11,23,34,43,52,95,13,2,15,11,42,28,13,14,107,110
2019,2,21900454,12/23/2019,1610612744,Golden State Warriors,1,1,1610612750,Minnesota Timberwolves,0,0,26,31,57,12,18,30,38,49,87,25,5,30,16,35,27,10,20,104,113
2014,2,21400463,12/29/2014,1610612745,Houston Rockets,1,0,1610612764,Washington Wizards,0,1,31,26,57,9,20,29,40,46,86,14,9,23,18,33,19,11,20,99,103
2020,2,22000645,3/21/2021,1610612748,Miami Heat,1,0,1610612754,Indiana Pacers,0,1,30,30,60,9,28,37,39,58,97,19,4,23,22,39,27,8,16,102,106
2020,2,22000645,3/21/2021,1610612754,Indiana Pacers,0,1,1610612748,Miami Heat,1,0,23,30,53,15,30,45,38,60,98,18,2,20,22,39,27,7,15,102,109
2014,2,21400463,12/29/2014,1610612764,Washington Wizards,0,1,1610612745,Houston Rockets,1,0,27,28,55,8,10,18,35,38,73,26,2,28,9,29,21,11,21,98,104
2023,2,22300110,10/30/2023,1610612762,Utah Jazz,0,0,1610612743,Denver Nuggets,1,1,31,30,61,11,26,37,42,56,98,7,8,15,21,38,30,4,13,97,102
2023,2,22300596,1/20/2024,1610612752,New York Knicks,1,1,1610612761,Toronto Raptors,0,0,34,15,49,14,25,39,48,40,88,16,4,20,18,22,27,10,22,102,126
2020,2,22000328,2/3/2021,1610612739,Cleveland Cavaliers,1,0,1610612746,LA Clippers,0,1,37,45,82,4,6,10,41,51,92,13,4,17,14,39,21,4,8,93,99
2020,2,22000328,2/3/2021,1610612746,LA Clippers,0,1,1610612739,Cleveland Cavaliers,1,0,24,21,45,20,14,34,44,35,79,13,4,17,9,26,22,8,16,95,121
2019,2,21900454,12/23/2019,1610612750,Minnesota Timberwolves,0,0,1610612744,Golden State Warriors,1,1,24,29,53,11,23,34,35,52,87,23,6,29,12,43,16,11,16,105,104
2019,2,21900183,11/17/2019,1610612739,Cleveland Cavaliers,1,0,1610612755,Philadelphia 76ers,0,1,28,37,65,6,19,25,34,56,90,21,3,24,16,42,14,6,15,101,95
2019,2,21900183,11/17/2019,1610612755,Philadelphia 76ers,0,1,1610612739,Cleveland Cavaliers,1,0,37,24,61,9,14,23,46,38,84,13,4,17,5,35,33,9,14,100,114
2017,2,21700284,11/25/2017,1610612740,New Orleans Pelicans,0,0,1610612744,Golden State Warriors,1,1,23,30,53,11,20,31,34,50,84,16,7,23,12,41,24,11,17,99,95
2017,2,21700284,11/25/2017,1610612744,Golden State Warriors,1,1,1610612740,New Orleans Pelicans,0,0,29,32,61,10,23,33,39,55,94,22,5,27,18,38,30,2,10,100,110
2016,2,21600815,2/11/2017,1610612738,Boston Celtics,0,1,1610612762,Utah Jazz,1,0,29,12,41,13,17,30,42,29,71,15,8,23,4,29,20,9,16,92,112
2016,2,21600815,2/11/2017,1610612762,Utah Jazz,1,0,1610612738,Boston Celtics,0,1,27,28,55,8,23,31,35,51,86,26,4,30,18,35,16,6,11,92,104
2014,2,21400074,11/7/2014,1610612738,Boston Celtics,1,1,1610612754,Indiana Pacers,0,0,30,28,58,9,18,27,39,46,85,14,2,16,16,30,26,2,12,91,101
2020,2,22000644,3/20/2021,1610612746,LA Clippers,1,1,1610612766,Charlotte Hornets,0,0,33,19,52,12,22,34,45,41,86,23,0,23,12,29,26,5,10,93,125
2020,2,22000644,3/20/2021,1610612766,Charlotte Hornets,0,0,1610612746,LA Clippers,1,1,16,23,39,15,26,41,31,49,80,21,7,28,15,37,25,9,14,93,98
2014,2,21400074,11/7/2014,1610612754,Indiana Pacers,0,0,1610612738,Boston Celtics,1,1,35,34,69,5,14,19,40,48,88,13,0,13,17,31,18,6,13,89,98
2014,2,21400462,12/29/2014,1610612748,Miami Heat,1,0,1610612753,Orlando Magic,0,1,26,23,49,7,7,14,33,30,63,28,12,40,8,27,18,9,14,88,101
2014,2,21400462,12/29/2014,1610612753,Orlando Magic,0,1,1610612748,Miami Heat,1,0,30,22,52,11,14,25,41,36,77,9,4,13,10,30,21,9,14,88,102
2021,2,22100529,12/31/2021,1610612738,Boston Celtics,1,1,1610612756,Phoenix Suns,0,0,35,21,56,10,17,27,45,38,83,23,3,26,15,24,28,10,18,99,123
2021,2,22100529,12/31/2021,1610612756,Phoenix Suns,0,0,1610612738,Boston Celtics,1,1,30,35,65,11,24,35,41,59,100,15,1,16,20,40,20,6,10,98,108
2020,2,22000327,2/3/2021,1610612755,Philadelphia 76ers,0,1,1610612766,Charlotte Hornets,1,0,31,24,55,10,14,24,41,38,79,26,6,32,12,29,23,5,19,102,118
2020,2,22000327,2/3/2021,1610612766,Charlotte Hornets,1,0,1610612755,Philadelphia 76ers,0,1,25,25,50,14,23,37,39,48,87,19,4,23,15,37,28,9,19,103,111
2019,2,21900453,12/23/2019,1610612745,Houston Rockets,0,1,1610612758,Sacramento Kings,1,0,24,24,48,15,24,39,39,48,87,20,3,23,8,42,18,4,11,101,113
2019,2,21900453,12/23/2019,1610612758,Sacramento Kings,1,0,1610612745,Houston Rockets,0,1,34,23,57,7,23,30,41,46,87,15,8,23,15,34,20,10,19,102,104
2023,2,22300118,11/1/2023,1610612754,Indiana Pacers,0,0,1610612738,Boston Celtics,1,1,41,23,64,5,32,37,46,55,101,7,5,12,10,47,26,5,9,105,104
2014,2,21400073,11/7/2014,1610612741,Chicago Bulls,0,1,1610612755,Philadelphia 76ers,1,0,28,26,54,12,12,24,40,38,78,26,8,34,16,26,25,7,17,94,118
2020,2,22000643,3/20/2021,1610612749,Milwaukee Bucks,1,1,1610612759,San Antonio Spurs,0,0,31,23,54,14,24,38,45,47,92,16,2,18,9,39,24,6,11,103,120
2023,2,22300112,10/31/2023,1610612752,New York Knicks,0,1,1610612739,Cleveland Cavaliers,1,0,25,27,52,13,21,34,38,48,86,20,5,25,17,33,18,6,14,95,109
2020,2,22000643,3/20/2021,1610612759,San Antonio Spurs,0,0,1610612749,Milwaukee Bucks,1,1,34,29,63,12,21,33,46,50,96,9,1,10,7,43,29,5,9,102,113
2014,2,21400073,11/7/2014,1610612755,Philadelphia 76ers,1,0,1610612741,Chicago Bulls,0,1,31,30,61,12,18,30,43,48,91,17,8,25,22,29,29,4,13,94,115
2014,2,21401031,3/20/2015,1610612746,LA Clippers,1,1,1610612764,Washington Wizards,0,0,33,30,63,12,11,23,45,41,86,11,6,17,13,29,33,6,16,95,113
2014,2,21401031,3/20/2015,1610612764,Washington Wizards,0,0,1610612746,LA Clippers,1,1,31,36,67,6,13,19,37,49,86,19,4,23,11,40,27,5,9,95,99
2014,2,21400461,12/29/2014,1610612751,Brooklyn Nets,1,1,1610612758,Sacramento Kings,0,0,28,31,59,8,13,21,36,44,80,27,12,39,15,33,20,5,9,92,107
2014,2,21400461,12/29/2014,1610612758,Sacramento Kings,0,0,1610612751,Brooklyn Nets,1,1,28,28,56,9,11,20,37,39,76,16,4,20,13,27,22,12,21,93,99
2020,2,22000642,3/20/2021,1610612744,Golden State Warriors,0,0,1610612763,Memphis Grizzlies,1,1,18,31,49,13,28,41,31,59,90,28,6,34,13,49,23,8,12,105,103
2020,2,22000642,3/20/2021,1610612763,Memphis Grizzlies,1,1,1610612744,Golden State Warriors,0,0,27,36,63,10,22,32,37,58,95,27,4,31,16,44,25,8,12,105,111
2023,2,22300112,10/31/2023,1610612739,Cleveland Cavaliers,1,0,1610612752,New York Knicks,0,1,26,28,54,10,28,38,36,56,92,9,3,12,17,41,19,9,15,96,91
2023,2,22300446,12/31/2023,1610612740,New Orleans Pelicans,1,1,1610612747,Los Angeles Lakers,0,0,28,25,53,17,17,34,45,42,87,22,5,27,13,32,33,8,13,99,129
2021,2,22100528,3/7/2022,1610612743,Denver Nuggets,1,1,1610612744,Golden State Warriors,0,0,36,16,52,10,22,32,46,38,84,29,12,41,10,33,39,5,9,102,131
2021,2,22100528,3/7/2022,1610612744,Golden State Warriors,0,0,1610612743,Denver Nuggets,1,1,28,20,48,17,23,40,45,43,88,17,6,23,9,36,29,8,14,102,124
2020,2,22000326,2/2/2021,1610612738,Boston Celtics,0,1,1610612744,Golden State Warriors,1,0,26,24,50,13,21,34,39,45,84,20,7,27,16,32,16,9,16,97,111
2020,2,22000326,2/2/2021,1610612744,Golden State Warriors,1,0,1610612738,Boston Celtics,0,1,23,23,46,15,22,37,38,45,83,16,7,23,8,42,30,3,11,97,107
2019,2,21900452,12/23/2019,1610612740,New Orleans Pelicans,0,1,1610612757,Portland Trail Blazers,1,0,23,35,58,15,20,35,38,55,93,11,5,16,14,43,23,6,13,99,102
2019,2,21900452,12/23/2019,1610612757,Portland Trail Blazers,1,0,1610612740,New Orleans Pelicans,0,1,33,29,62,4,25,29,37,54,91,16,2,18,12,44,17,6,11,99,94
2017,2,21700283,11/25/2017,1610612742,Dallas Mavericks,1,1,1610612760,Oklahoma City Thunder,0,0,22,18,40,15,20,35,37,38,75,8,3,11,9,32,25,12,17,90,97
2017,2,21700283,11/25/2017,1610612760,Oklahoma City Thunder,0,0,1610612742,Dallas Mavericks,1,1,16,29,45,13,22,35,29,51,80,10,3,13,13,39,24,11,17,91,81
2020,2,22000641,3/20/2021,1610612755,Philadelphia 76ers,1,1,1610612758,Sacramento Kings,0,0,37,26,63,11,12,23,48,38,86,22,7,29,12,30,24,4,11,98,129
2020,2,22000641,3/20/2021,1610612758,Sacramento Kings,0,0,1610612755,Philadelphia 76ers,1,1,29,28,57,10,18,28,39,46,85,17,10,27,8,43,28,7,8,98,105
2018,2,21801105,3/25/2019,1610612756,Phoenix Suns,0,0,1610612762,Utah Jazz,1,1,24,29,53,7,16,23,31,45,76,23,5,28,12,35,12,11,22,98,92
2021,2,22100527,12/30/2021,1610612739,Cleveland Cavaliers,0,0,1610612764,Washington Wizards,1,1,27,28,55,8,20,28,35,48,83,15,8,23,13,40,20,7,13,95,93
2021,2,22100527,12/30/2021,1610612764,Washington Wizards,1,1,1610612739,Cleveland Cavaliers,0,0,36,25,61,9,20,29,45,45,90,11,6,17,12,36,27,4,8,94,110
2020,2,22000325,2/2/2021,1610612762,Utah Jazz,1,1,1610612765,Detroit Pistons,0,0,22,18,40,16,26,42,38,44,82,25,4,29,10,35,23,7,13,99,117
2020,2,22000325,2/2/2021,1610612765,Detroit Pistons,0,0,1610612762,Utah Jazz,1,1,30,36,66,9,18,27,39,54,93,18,2,20,17,37,18,9,15,100,105
2019,2,21900451,12/23/2019,1610612743,Denver Nuggets,0,1,1610612756,Phoenix Suns,1,0,28,22,50,15,13,28,43,35,78,12,3,15,7,30,31,10,21,100,113
2019,2,21900451,12/23/2019,1610612756,Phoenix Suns,1,0,1610612743,Denver Nuggets,0,1,29,21,50,13,24,37,42,45,87,14,4,18,12,35,29,10,17,101,111
2017,2,21700282,11/25/2017,1610612745,Houston Rockets,1,1,1610612752,New York Knicks,0,0,23,24,47,18,29,47,41,53,94,17,5,22,13,41,30,4,8,99,117
2017,2,21700282,11/25/2017,1610612752,New York Knicks,0,0,1610612745,Houston Rockets,1,1,38,30,68,4,13,17,42,43,85,14,5,19,12,34,29,12,18,99,102
2022,2,22201166,4/2/2023,1610612757,Portland Trail Blazers,0,1,1610612750,Minnesota Timberwolves,1,0,34,29,63,9,21,30,43,50,93,12,8,20,14,43,29,3,10,97,107
2016,2,21600322,12/7/2016,1610612738,Boston Celtics,0,1,1610612753,Orlando Magic,1,0,36,22,58,7,19,26,43,41,84,24,5,29,15,29,29,7,10,92,117
2016,2,21600322,12/7/2016,1610612753,Orlando Magic,1,0,1610612738,Boston Celtics,0,1,19,36,55,11,15,26,30,51,81,16,8,24,15,40,20,7,14,92,87
2023,2,22300169,11/8/2023,1610612744,Golden State Warriors,0,0,1610612743,Denver Nuggets,1,1,26,25,51,11,24,35,37,49,86,20,6,26,12,39,21,7,9,96,105
2023,2,22300182,11/12/2023,1610612745,Houston Rockets,1,1,1610612743,Denver Nuggets,0,0,27,28,55,10,22,32,37,50,87,23,6,29,16,37,20,3,9,94,107
2023,2,22300330,12/15/2023,1610612737,Atlanta Hawks,0,1,1610612761,Toronto Raptors,1,0,36,24,60,16,25,41,52,49,101,5,1,6,19,31,34,8,14,100,125
2021,2,22100525,12/30/2021,1610612751,Brooklyn Nets,1,0,1610612755,Philadelphia 76ers,0,1,30,24,54,7,20,27,37,44,81,21,6,27,15,31,21,10,18,94,102
2022,2,22201066,3/19/2023,1610612748,Miami Heat,0,1,1610612765,Detroit Pistons,1,0,25,15,40,13,26,39,38,41,79,23,2,25,11,32,33,4,10,91,112
2021,2,22100525,12/30/2021,1610612755,Philadelphia 76ers,0,1,1610612751,Brooklyn Nets,1,0,29,39,68,13,19,32,42,58,100,13,7,20,22,41,22,4,8,95,110
2020,2,22000324,2/2/2021,1610612746,LA Clippers,0,0,1610612751,Brooklyn Nets,1,1,30,33,63,15,21,36,45,54,99,15,2,17,16,39,21,6,8,98,120
2020,2,22000324,2/2/2021,1610612751,Brooklyn Nets,1,1,1610612746,LA Clippers,0,0,32,16,48,13,18,31,45,34,79,21,5,26,8,28,25,12,17,98,124
2017,2,21700281,11/25/2017,1610612738,Boston Celtics,0,1,1610612754,Indiana Pacers,1,0,35,20,55,10,15,25,45,35,80,8,1,9,6,29,22,9,15,93,108
2017,2,21700281,11/25/2017,1610612754,Indiana Pacers,1,0,1610612738,Boston Celtics,0,1,31,24,55,7,16,23,38,40,78,15,0,15,13,27,20,8,19,91,98
2016,2,21600814,2/11/2017,1610612742,Dallas Mavericks,1,1,1610612753,Orlando Magic,0,0,28,28,56,17,18,35,45,46,91,5,1,6,15,31,32,8,14,94,112
2020,2,22000640,3/20/2021,1610612737,Atlanta Hawks,0,1,1610612747,Los Angeles Lakers,1,0,26,35,61,13,24,37,39,59,98,8,1,9,17,43,26,6,8,94,99
2020,2,22000640,3/20/2021,1610612747,Los Angeles Lakers,1,0,1610612737,Atlanta Hawks,0,1,26,29,55,8,18,26,34,47,81,18,6,24,15,35,18,13,16,94,94
2021,2,22100526,12/30/2021,1610612749,Milwaukee Bucks,0,1,1610612753,Orlando Magic,1,0,32,26,58,13,20,33,45,46,91,33,3,36,19,27,24,5,13,101,136
2021,2,22100526,12/30/2021,1610612753,Orlando Magic,1,0,1610612749,Milwaukee Bucks,0,1,29,22,51,13,23,36,42,45,87,21,6,27,9,38,26,7,10,103,118
2020,2,22000323,2/2/2021,1610612753,Orlando Magic,1,0,1610612761,Toronto Raptors,0,1,27,24,51,14,24,38,41,48,89,12,2,14,11,37,24,14,17,100,108
2020,2,22000323,2/2/2021,1610612761,Toronto Raptors,0,1,1610612753,Orlando Magic,1,0,20,18,38,20,25,45,40,43,83,23,2,25,7,37,32,4,11,98,123
2022,2,22201166,4/2/2023,1610612750,Minnesota Timberwolves,1,0,1610612757,Portland Trail Blazers,0,1,27,26,53,11,15,26,38,41,79,18,5,23,9,34,29,12,18,99,105
2014,2,21400072,11/7/2014,1610612750,Minnesota Timberwolves,0,0,1610612753,Orlando Magic,1,1,36,39,75,4,14,18,40,53,93,19,5,24,13,42,24,5,13,106,103
2019,2,21900450,12/23/2019,1610612759,San Antonio Spurs,0,1,1610612763,Memphis Grizzlies,1,0,45,20,65,15,9,24,60,29,89,10,4,14,5,25,36,7,12,103,145
2019,2,21900450,12/23/2019,1610612763,Memphis Grizzlies,1,0,1610612759,San Antonio Spurs,0,1,30,29,59,15,22,37,45,51,96,10,6,16,12,43,28,9,13,103,115
2019,2,21900182,11/16/2019,1610612737,Atlanta Hawks,0,0,1610612746,LA Clippers,1,1,28,38,66,6,18,24,34,56,90,27,10,37,18,43,19,10,19,107,101
2019,2,21900182,11/16/2019,1610612746,LA Clippers,1,1,1610612737,Atlanta Hawks,0,0,33,27,60,17,16,33,50,43,93,33,2,35,21,24,30,11,21,108,150
2023,2,22300181,11/12/2023,1610612741,Chicago Bulls,1,1,1610612765,Detroit Pistons,0,0,33,28,61,11,19,30,44,47,91,20,5,25,13,36,22,4,7,96,119
2023,2,22301213,12/6/2023,1610612762,Utah Jazz,0,0,1610612742,Dallas Mavericks,1,1,23,31,54,12,21,33,35,52,87,15,3,18,13,41,22,11,19,103,97
2021,2,22100524,12/29/2021,1610612742,Dallas Mavericks,0,0,1610612758,Sacramento Kings,1,1,29,28,57,9,15,24,38,43,81,9,4,13,12,33,23,5,13,88,94
2021,2,22100524,12/29/2021,1610612758,Sacramento Kings,1,1,1610612742,Dallas Mavericks,0,0,26,23,49,10,16,26,36,39,75,13,2,15,8,32,21,7,15,89,95
2020,2,22000322,2/2/2021,1610612754,Indiana Pacers,1,1,1610612763,Memphis Grizzlies,0,0,33,20,53,16,13,29,49,33,82,20,9,29,12,27,30,11,18,103,134
2020,2,22000322,2/2/2021,1610612763,Memphis Grizzlies,0,0,1610612754,Indiana Pacers,1,1,33,35,68,9,16,25,42,51,93,23,1,24,16,36,27,8,16,105,116
2019,2,21900449,12/23/2019,1610612748,Miami Heat,1,1,1610612762,Utah Jazz,0,0,28,37,65,9,16,25,37,53,90,24,3,27,18,36,16,10,14,99,107
2019,2,21900449,12/23/2019,1610612762,Utah Jazz,0,0,1610612748,Miami Heat,1,1,27,27,54,12,24,36,39,51,90,14,4,18,11,44,17,8,12,100,104
2023,2,22300960,3/14/2024,1610612757,Portland Trail Blazers,1,0,1610612752,New York Knicks,0,1,23,28,51,11,22,33,34,50,84,14,2,16,15,36,19,11,18,96,93
2019,2,21900181,11/16/2019,1610612757,Portland Trail Blazers,0,1,1610612759,San Antonio Spurs,1,0,29,25,54,13,26,39,42,51,93,24,2,26,11,40,21,8,12,104,121
2020,2,22000639,3/19/2021,1610612742,Dallas Mavericks,0,0,1610612757,Portland Trail Blazers,1,1,25,14,39,19,23,42,44,37,81,12,1,13,7,30,25,5,12,94,119
2020,2,22000639,3/19/2021,1610612757,Portland Trail Blazers,1,1,1610612742,Dallas Mavericks,0,0,22,24,46,22,25,47,44,49,93,15,2,17,13,37,17,4,6,94,125
2022,2,22201164,4/2/2023,1610612751,Brooklyn Nets,1,1,1610612762,Utah Jazz,0,0,29,25,54,9,23,32,38,48,86,26,8,34,9,42,25,5,9,101,111
2022,2,22201164,4/2/2023,1610612762,Utah Jazz,0,0,1610612751,Brooklyn Nets,1,1,32,27,59,8,24,32,40,51,91,22,8,30,16,38,24,6,11,102,110
2021,2,22100523,12/29/2021,1610612757,Portland Trail Blazers,1,0,1610612762,Utah Jazz,0,1,23,25,48,14,26,40,37,51,88,17,7,24,16,38,23,6,11,95,105
2021,2,22100523,12/29/2021,1610612762,Utah Jazz,0,1,1610612757,Portland Trail Blazers,1,0,38,20,58,8,21,29,46,41,87,20,12,32,15,34,22,6,11,95,120
2022,2,22201067,3/19/2023,1610612740,New Orleans Pelicans,0,1,1610612745,Houston Rockets,1,0,29,25,54,13,18,31,42,43,85,20,4,24,14,29,28,4,10,91,117
2017,2,21700280,11/25/2017,1610612737,Atlanta Hawks,1,0,1610612761,Toronto Raptors,0,1,20,28,48,6,21,27,26,49,75,20,3,23,13,37,18,10,19,92,78
2017,2,21700280,11/25/2017,1610612761,Toronto Raptors,0,1,1610612737,Atlanta Hawks,1,0,33,19,52,13,19,32,46,38,84,7,2,9,13,26,31,9,16,92,112
2019,2,21900448,12/23/2019,1610612741,Chicago Bulls,0,0,1610612753,Orlando Magic,1,1,22,29,51,13,24,37,35,53,88,12,3,15,13,41,20,10,17,99,95
2019,2,21900448,12/23/2019,1610612753,Orlando Magic,1,1,1610612741,Chicago Bulls,0,0,29,26,55,10,16,26,39,42,81,15,8,23,8,38,23,7,13,99,103
2019,2,21900181,11/16/2019,1610612759,San Antonio Spurs,1,0,1610612757,Portland Trail Blazers,0,1,36,34,70,5,13,18,41,47,88,29,5,34,9,40,25,2,10,105,116
2016,2,21600814,2/11/2017,1610612753,Orlando Magic,0,0,1610612742,Dallas Mavericks,1,1,29,30,59,3,20,23,32,50,82,13,5,18,12,41,16,10,15,94,80
2023,2,22301211,12/6/2023,1610612741,Chicago Bulls,1,1,1610612766,Charlotte Hornets,0,0,26,39,65,12,13,25,38,52,90,23,6,29,23,33,23,9,16,98,111
2020,2,22000638,3/19/2021,1610612750,Minnesota Timberwolves,0,0,1610612756,Phoenix Suns,1,1,24,20,44,13,22,35,37,42,79,14,4,18,6,38,22,8,20,101,101
2020,2,22000638,3/19/2021,1610612756,Phoenix Suns,1,1,1610612750,Minnesota Timberwolves,0,0,29,30,59,14,13,27,43,43,86,13,4,17,10,35,29,8,18,101,113
2023,2,22300930,3/10/2024,1610612739,Cleveland Cavaliers,1,0,1610612751,Brooklyn Nets,0,1,23,21,44,14,18,32,37,39,76,13,7,20,6,35,25,7,12,91,101
2023,2,22300948,3/13/2024,1610612754,Indiana Pacers,1,0,1610612741,Chicago Bulls,0,1,32,22,54,14,31,45,46,53,99,23,5,28,13,43,30,6,9,109,129
2023,2,22301060,3/28/2024,1610612737,Atlanta Hawks,1,1,1610612738,Boston Celtics,0,0,36,24,60,15,29,44,51,53,104,6,4,10,20,36,24,7,11,101,123
2023,2,22300873,3/3/2024,1610612750,Minnesota Timberwolves,1,0,1610612746,LA Clippers,0,1,22,25,47,9,24,33,31,49,80,17,1,18,14,36,24,7,15,90,88
2020,2,22000321,4/6/2021,1610612743,Denver Nuggets,1,1,1610612765,Detroit Pistons,0,0,42,21,63,14,17,31,56,38,94,8,1,9,15,23,36,4,11,95,134
2020,2,22000321,4/6/2021,1610612765,Detroit Pistons,0,0,1610612743,Denver Nuggets,1,1,29,17,46,15,20,35,44,37,81,16,4,20,7,31,27,7,13,94,119
2014,2,21400072,11/7/2014,1610612753,Orlando Magic,1,1,1610612750,Minnesota Timberwolves,0,0,41,40,81,5,5,10,46,45,91,15,4,19,15,32,19,9,21,106,112
2020,2,22000637,3/19/2021,1610612741,Chicago Bulls,0,0,1610612743,Denver Nuggets,1,1,30,25,55,17,18,35,47,43,90,16,7,23,12,36,32,10,18,107,127
2020,2,22000637,3/19/2021,1610612743,Denver Nuggets,1,1,1610612741,Chicago Bulls,0,0,34,23,57,14,20,34,48,43,91,21,6,27,11,36,29,6,13,107,131
2023,2,22300119,11/1/2023,1610612751,Brooklyn Nets,0,1,1610612748,Miami Heat,1,0,21,25,46,16,20,36,37,45,82,19,7,26,12,36,27,10,18,102,109
2018,2,21801105,3/25/2019,1610612762,Utah Jazz,1,1,1610612756,Phoenix Suns,0,0,38,27,65,10,11,21,48,38,86,19,4,23,12,28,31,8,14,97,125
2021,2,22100522,12/29/2021,1610612756,Phoenix Suns,1,1,1610612760,Oklahoma City Thunder,0,0,29,26,55,12,22,34,41,48,89,21,7,28,19,31,22,6,15,97,115
2022,2,22201067,3/19/2023,1610612745,Houston Rockets,1,0,1610612740,New Orleans Pelicans,0,1,22,21,43,9,24,33,31,45,76,36,2,38,16,30,15,7,13,92,107
2021,2,22100522,12/29/2021,1610612760,Oklahoma City Thunder,0,0,1610612756,Phoenix Suns,1,1,31,30,61,7,28,35,38,58,96,14,2,16,20,38,19,7,12,96,97
2019,2,21900447,12/23/2019,1610612752,New York Knicks,1,0,1610612764,Washington Wizards,0,1,29,28,57,15,21,36,44,49,93,12,3,15,14,36,29,12,14,99,115
2019,2,21900447,12/23/2019,1610612764,Washington Wizards,0,1,1610612752,New York Knicks,1,0,37,33,70,10,20,30,47,53,100,17,13,30,24,33,27,4,9,99,121
2023,2,22300117,11/1/2023,1610612764,Washington Wizards,0,0,1610612737,Atlanta Hawks,1,1,41,20,61,10,30,40,51,50,101,9,5,14,9,43,32,8,11,110,121
2020,2,22000636,3/19/2021,1610612744,Golden State Warriors,0,1,1610612763,Memphis Grizzlies,1,0,29,21,50,15,26,41,44,47,91,13,5,18,11,38,31,10,13,103,116
2020,2,22000636,3/19/2021,1610612763,Memphis Grizzlies,1,0,1610612744,Golden State Warriors,0,1,31,27,58,8,18,26,39,45,84,17,4,21,11,38,24,13,21,103,103
2023,2,22300015,11/10/2023,1610612756,Phoenix Suns,1,0,1610612747,Los Angeles Lakers,0,1,27,30,57,15,22,37,42,52,94,20,7,27,20,34,22,9,13,97,119
2023,2,22300183,11/12/2023,1610612740,New Orleans Pelicans,1,0,1610612742,Dallas Mavericks,0,1,30,26,56,17,19,36,47,45,92,13,9,22,14,35,31,7,18,106,124
2023,2,22300836,2/27/2024,1610612738,Boston Celtics,1,1,1610612755,Philadelphia 76ers,0,0,34,18,52,5,17,22,39,35,74,34,3,37,10,26,21,6,14,96,117
2020,2,22000320,2/1/2021,1610612759,San Antonio Spurs,1,0,1610612763,Memphis Grizzlies,0,1,24,28,52,13,24,37,37,52,89,15,7,22,13,44,28,11,15,100,102
2020,2,22000320,2/1/2021,1610612763,Memphis Grizzlies,0,1,1610612759,San Antonio Spurs,1,0,37,26,63,15,15,30,52,41,93,14,4,18,12,32,37,8,11,99,133
2023,2,22300170,11/8/2023,1610612758,Sacramento Kings,1,1,1610612757,Portland Trail Blazers,0,0,30,22,52,11,26,37,41,48,89,28,10,38,21,33,32,10,21,106,121
2021,2,22100521,2/3/2022,1610612748,Miami Heat,0,1,1610612759,San Antonio Spurs,1,0,30,23,53,12,18,30,42,41,83,16,2,18,11,31,27,9,14,98,112
2021,2,22100521,2/3/2022,1610612759,San Antonio Spurs,1,0,1610612748,Miami Heat,0,1,22,25,47,8,25,33,30,50,80,27,11,38,17,37,21,13,17,97,95
2020,2,22000319,2/1/2021,1610612742,Dallas Mavericks,1,0,1610612756,Phoenix Suns,0,1,27,27,54,10,22,32,37,49,86,24,1,25,13,36,16,7,14,99,108
2020,2,22000635,3/19/2021,1610612745,Houston Rockets,1,0,1610612765,Detroit Pistons,0,1,30,26,56,9,23,32,39,49,88,13,3,16,13,38,21,7,16,98,100
2020,2,22000635,3/19/2021,1610612765,Detroit Pistons,0,1,1610612745,Houston Rockets,1,0,23,33,56,14,15,29,37,48,85,25,3,28,14,35,28,7,12,97,113
2022,2,22201047,3/17/2023,1610612755,Philadelphia 76ers,0,1,1610612766,Charlotte Hornets,1,0,36,24,60,10,22,32,46,46,92,19,6,25,17,31,24,10,15,101,121
2021,2,22100520,12/29/2021,1610612747,Los Angeles Lakers,0,0,1610612763,Memphis Grizzlies,1,1,24,21,45,15,26,41,39,47,86,6,2,8,14,34,24,13,18,94,99
2022,2,22201064,3/19/2023,1610612756,Phoenix Suns,0,0,1610612760,Oklahoma City Thunder,1,1,29,27,56,15,21,36,44,48,92,17,7,24,10,40,31,8,14,105,120
2022,2,22201064,3/19/2023,1610612760,Oklahoma City Thunder,1,1,1610612756,Phoenix Suns,0,0,31,25,56,11,17,28,42,42,84,29,7,36,12,34,20,7,16,105,124
2021,2,22100520,12/29/2021,1610612763,Memphis Grizzlies,1,1,1610612747,Los Angeles Lakers,0,0,25,30,55,10,20,30,35,50,85,24,5,29,16,37,18,5,13,95,104
2020,2,22000319,2/1/2021,1610612756,Phoenix Suns,0,1,1610612742,Dallas Mavericks,1,0,30,27,57,13,22,35,43,49,92,10,2,12,16,35,19,9,16,98,109
2019,2,21900446,12/23/2019,1610612754,Indiana Pacers,1,1,1610612761,Toronto Raptors,0,0,27,26,53,18,24,42,45,50,95,12,8,20,15,38,34,6,14,103,120
2019,2,21900446,12/23/2019,1610612761,Toronto Raptors,0,0,1610612754,Indiana Pacers,1,1,32,22,54,11,29,40,43,51,94,18,6,24,18,35,30,7,16,106,115
2017,2,21700279,11/25/2017,1610612757,Portland Trail Blazers,0,1,1610612764,Washington Wizards,1,0,32,24,56,9,15,24,41,39,80,17,5,22,8,34,18,9,16,98,108
2017,2,21700279,11/25/2017,1610612764,Washington Wizards,1,0,1610612757,Portland Trail Blazers,0,1,33,33,66,8,15,23,41,48,89,15,1,16,11,37,20,3,11,98,105
2014,2,21400071,11/7/2014,1610612737,Atlanta Hawks,0,0,1610612766,Charlotte Hornets,1,1,30,30,60,13,20,33,43,50,93,20,6,26,12,42,28,6,19,112,119
2014,2,21400071,11/7/2014,1610612766,Charlotte Hornets,1,1,1610612737,Atlanta Hawks,0,0,42,34,76,6,15,21,48,49,97,20,7,27,19,33,31,8,21,113,122
2014,2,21401030,3/20/2015,1610612740,New Orleans Pelicans,0,0,1610612744,Golden State Warriors,1,1,22,33,55,11,11,22,33,44,77,19,3,22,13,32,22,9,21,94,96
2014,2,21401030,3/20/2015,1610612744,Golden State Warriors,1,1,1610612740,New Orleans Pelicans,0,0,39,30,69,5,14,19,44,44,88,19,4,23,14,33,29,4,10,95,112
2014,2,21400460,12/29/2014,1610612741,Chicago Bulls,0,1,1610612754,Indiana Pacers,1,0,24,47,71,5,8,13,29,55,84,29,4,33,18,39,17,5,11,93,92
2014,2,21400460,12/29/2014,1610612754,Indiana Pacers,1,0,1610612741,Chicago Bulls,0,1,31,39,70,5,8,13,36,47,83,13,8,21,12,40,18,8,14,94,90
2021,2,22100519,12/29/2021,1610612737,Atlanta Hawks,0,0,1610612741,Chicago Bulls,1,1,33,33,66,11,15,26,44,48,92,18,8,26,15,37,26,9,11,102,117
2021,2,22100519,12/29/2021,1610612741,Chicago Bulls,1,1,1610612737,Atlanta Hawks,0,0,42,20,62,10,12,22,52,32,84,17,5,22,7,27,38,6,15,103,131
2020,2,22000318,2/1/2021,1610612745,Houston Rockets,0,1,1610612760,Oklahoma City Thunder,1,0,21,29,50,28,24,52,49,53,102,10,1,11,15,39,30,8,13,104,136
2020,2,22000318,2/1/2021,1610612760,Oklahoma City Thunder,1,0,1610612745,Houston Rockets,0,1,26,29,55,13,21,34,39,50,89,15,4,19,11,40,21,8,17,105,106
2017,2,21700278,11/25/2017,1610612753,Orlando Magic,0,0,1610612755,Philadelphia 76ers,1,1,27,28,55,12,19,31,39,47,86,21,10,31,9,43,22,7,10,104,111
2022,2,22201048,3/17/2023,1610612737,Atlanta Hawks,1,1,1610612744,Golden State Warriors,0,0,31,28,59,16,25,41,47,53,100,17,8,25,17,40,27,6,11,106,127
2023,2,22300118,11/1/2023,1610612738,Boston Celtics,1,1,1610612754,Indiana Pacers,0,0,34,26,60,20,15,35,54,41,95,27,1,28,15,26,27,6,13,107,155
2023,2,22300184,11/12/2023,1610612759,San Antonio Spurs,1,0,1610612748,Miami Heat,0,1,23,24,47,19,25,44,42,49,91,10,2,12,15,35,35,7,17,99,113
2020,2,22000634,3/19/2021,1610612761,Toronto Raptors,1,0,1610612762,Utah Jazz,0,1,19,20,39,21,23,44,40,43,83,11,3,14,6,39,31,7,11,94,112
2020,2,22000634,3/19/2021,1610612762,Utah Jazz,0,1,1610612761,Toronto Raptors,1,0,22,15,37,12,25,37,34,40,74,35,6,41,12,29,21,9,13,93,115
2021,2,22100518,12/29/2021,1610612738,Boston Celtics,1,0,1610612746,LA Clippers,0,1,31,28,59,4,38,42,35,66,101,8,3,11,26,41,19,5,8,87,82
2022,2,22201049,3/17/2023,1610612739,Cleveland Cavaliers,1,1,1610612764,Washington Wizards,0,0,44,24,68,4,15,19,48,39,87,17,5,22,10,33,31,5,11,94,117
2021,2,22100518,12/29/2021,1610612746,LA Clippers,0,1,1610612738,Boston Celtics,1,0,22,31,53,11,17,28,33,48,81,14,3,17,19,30,17,8,16,88,91
2017,2,21700278,11/25/2017,1610612755,Philadelphia 76ers,1,1,1610612753,Orlando Magic,0,0,32,29,61,16,18,34,48,47,95,18,2,20,12,36,35,8,11,103,130
2014,2,21400070,11/6/2014,1610612742,Dallas Mavericks,0,0,1610612757,Portland Trail Blazers,1,1,28,39,67,5,18,23,33,57,90,16,0,16,12,45,14,3,7,91,87
2019,2,21900445,12/23/2019,1610612755,Philadelphia 76ers,0,1,1610612765,Detroit Pistons,1,0,40,25,65,12,18,30,52,43,95,9,2,11,17,26,33,9,12,95,125
2019,2,21900445,12/23/2019,1610612765,Detroit Pistons,1,0,1610612755,Philadelphia 76ers,0,1,33,21,54,10,20,30,43,41,84,13,5,18,10,32,27,8,14,96,109
2014,2,21400070,11/6/2014,1610612757,Portland Trail Blazers,1,1,1610612742,Dallas Mavericks,0,0,28,19,47,12,18,30,40,37,77,16,3,19,12,28,25,6,18,91,108
2016,2,21600321,12/7/2016,1610612765,Detroit Pistons,0,0,1610612766,Charlotte Hornets,1,1,30,32,62,4,23,27,34,55,89,5,3,8,8,49,21,7,13,97,77
2016,2,21600321,12/7/2016,1610612766,Charlotte Hornets,1,1,1610612765,Detroit Pistons,0,0,24,43,67,6,15,21,30,58,88,21,8,29,10,52,13,3,6,99,87
2020,2,22000633,3/19/2021,1610612751,Brooklyn Nets,0,0,1610612753,Orlando Magic,1,1,33,21,54,10,27,37,43,48,91,17,6,23,12,37,24,4,8,98,113
2020,2,22000633,3/19/2021,1610612753,Orlando Magic,1,1,1610612751,Brooklyn Nets,0,0,22,22,44,21,19,40,43,41,84,14,6,20,12,33,26,9,17,98,121
2023,2,22300182,11/12/2023,1610612743,Denver Nuggets,0,0,1610612745,Houston Rockets,1,1,33,26,59,9,23,32,42,49,91,11,3,14,16,34,24,7,11,94,104
2023,2,22300119,11/1/2023,1610612748,Miami Heat,1,0,1610612751,Brooklyn Nets,0,1,26,27,53,13,25,38,39,52,91,14,4,18,14,40,22,11,18,102,105
2023,2,22300873,3/3/2024,1610612746,LA Clippers,0,1,1610612750,Minnesota Timberwolves,1,0,22,29,51,10,24,34,32,53,85,15,2,17,11,42,17,4,9,90,89
2021,2,22100517,12/29/2021,1610612754,Indiana Pacers,1,0,1610612766,Charlotte Hornets,0,1,19,22,41,17,28,45,36,50,86,19,10,29,15,40,25,12,18,103,108
2022,2,22201065,3/19/2023,1610612759,San Antonio Spurs,1,1,1610612737,Atlanta Hawks,0,0,37,29,66,14,14,28,51,43,94,10,6,16,15,31,26,4,11,98,126
2022,2,22200543,12/31/2022,1610612740,New Orleans Pelicans,0,0,1610612763,Memphis Grizzlies,1,1,24,37,61,8,22,30,32,59,91,29,7,36,23,40,16,14,20,106,101
2022,2,22200543,12/31/2022,1610612763,Memphis Grizzlies,1,1,1610612740,New Orleans Pelicans,0,0,42,21,63,5,24,29,47,45,92,17,5,22,15,33,26,6,19,105,116
2021,2,22100517,12/29/2021,1610612766,Charlotte Hornets,0,1,1610612754,Indiana Pacers,1,0,35,24,59,9,17,26,44,41,85,19,13,32,10,37,27,8,14,104,116
2020,2,22000317,2/1/2021,1610612740,New Orleans Pelicans,1,0,1610612758,Sacramento Kings,0,1,31,40,71,9,21,30,40,61,101,20,4,24,21,41,22,3,10,102,109
2020,2,22000317,2/1/2021,1610612758,Sacramento Kings,0,1,1610612740,New Orleans Pelicans,1,0,28,17,45,14,29,43,42,46,88,20,6,26,18,31,31,11,20,100,118
2023,2,22300181,11/12/2023,1610612765,Detroit Pistons,0,0,1610612741,Chicago Bulls,1,1,27,29,56,11,21,32,38,50,88,21,5,26,22,30,26,12,16,96,108
2019,2,21900180,11/16/2019,1610612742,Dallas Mavericks,1,1,1610612761,Toronto Raptors,0,0,28,21,49,9,30,39,37,51,88,27,6,33,16,37,24,7,13,101,110
2019,2,21900180,11/16/2019,1610612761,Toronto Raptors,0,0,1610612742,Dallas Mavericks,1,1,20,28,48,17,24,41,37,52,89,11,4,15,9,45,21,7,15,102,102
2020,2,22000632,3/19/2021,1610612748,Miami Heat,1,0,1610612754,Indiana Pacers,0,1,32,26,58,9,25,34,41,51,92,19,1,20,14,38,22,7,11,100,110
2020,2,22000632,3/19/2021,1610612754,Indiana Pacers,0,1,1610612748,Miami Heat,1,0,32,21,53,20,16,36,52,37,89,13,6,19,14,26,38,10,17,99,137
2023,2,22300170,11/8/2023,1610612757,Portland Trail Blazers,0,0,1610612758,Sacramento Kings,1,1,36,29,65,8,14,22,44,43,87,22,7,29,10,36,26,11,18,107,118
2021,2,22100516,12/29/2021,1610612752,New York Knicks,0,1,1610612765,Detroit Pistons,1,0,23,27,50,8,23,31,31,50,81,24,3,27,13,38,19,11,17,95,94
2021,2,22100516,12/29/2021,1610612765,Detroit Pistons,1,0,1610612752,New York Knicks,0,1,18,28,46,12,23,35,30,51,81,13,4,17,11,41,19,11,17,95,85
2020,2,22000316,2/1/2021,1610612749,Milwaukee Bucks,1,1,1610612757,Portland Trail Blazers,0,0,32,22,54,21,21,42,53,43,96,7,5,12,10,36,38,8,13,104,134
2022,2,22201047,3/17/2023,1610612766,Charlotte Hornets,1,0,1610612755,Philadelphia 76ers,0,1,24,27,51,5,30,35,29,57,86,19,7,26,13,49,20,9,14,100,82
2020,2,22000316,2/1/2021,1610612757,Portland Trail Blazers,0,0,1610612749,Milwaukee Bucks,1,1,24,38,62,15,27,42,39,65,104,13,0,13,18,47,19,10,11,103,106
2020,2,22000631,3/19/2021,1610612738,Boston Celtics,1,0,1610612758,Sacramento Kings,0,1,27,33,60,12,19,31,39,52,91,6,1,7,17,35,22,6,16,95,96
2020,2,22000631,3/19/2021,1610612758,Sacramento Kings,0,1,1610612738,Boston Celtics,1,0,25,26,51,12,18,30,37,44,81,21,5,26,13,34,22,8,14,93,107
2023,2,22300201,11/16/2023,1610612744,Golden State Warriors,1,0,1610612760,Oklahoma City Thunder,0,1,26,31,57,14,27,41,40,58,98,15,4,19,24,37,27,10,16,99,109
2017,2,21700277,11/25/2017,1610612759,San Antonio Spurs,0,1,1610612766,Charlotte Hornets,1,0,33,23,56,6,19,25,39,42,81,22,3,25,12,31,22,7,11,94,106
2023,2,22300080,10/27/2023,1610612748,Miami Heat,0,0,1610612738,Boston Celtics,1,1,22,34,56,16,17,33,38,51,89,19,4,23,12,40,24,7,12,99,111
2017,2,21700277,11/25/2017,1610612766,Charlotte Hornets,1,0,1610612759,San Antonio Spurs,0,1,27,32,59,4,21,25,31,53,84,20,6,26,17,38,20,8,14,92,86
2019,2,21900444,12/23/2019,1610612737,Atlanta Hawks,0,0,1610612739,Cleveland Cavaliers,1,1,30,23,53,15,27,42,45,50,95,13,4,17,9,42,23,8,16,113,118
2019,2,21900444,12/23/2019,1610612739,Cleveland Cavaliers,1,1,1610612737,Atlanta Hawks,0,0,39,28,67,11,18,29,50,46,96,10,2,12,12,35,19,11,23,111,121
2016,2,21600813,2/11/2017,1610612744,Golden State Warriors,0,1,1610612760,Oklahoma City Thunder,1,0,33,23,56,13,18,31,46,41,87,25,10,35,14,33,28,7,12,103,130
2016,2,21600813,2/11/2017,1610612760,Oklahoma City Thunder,1,0,1610612744,Golden State Warriors,0,1,34,25,59,6,18,24,40,43,83,28,8,36,16,31,20,10,19,103,114
2020,2,22000630,3/18/2021,1610612747,Los Angeles Lakers,1,1,1610612766,Charlotte Hornets,0,0,31,22,53,13,26,39,44,48,92,15,5,20,13,38,23,7,11,100,116
2020,2,22000630,3/18/2021,1610612766,Charlotte Hornets,0,0,1610612747,Los Angeles Lakers,1,1,30,24,54,11,18,29,41,42,83,12,8,20,8,39,26,7,19,99,105
2016,2,21600320,12/6/2016,1610612756,Phoenix Suns,0,0,1610612762,Utah Jazz,1,1,33,33,66,6,12,18,39,45,84,21,4,25,14,32,14,7,17,98,105
2018,2,21801104,3/25/2019,1610612760,Oklahoma City Thunder,0,0,1610612763,Memphis Grizzlies,1,1,26,33,59,12,24,36,38,57,95,15,5,20,13,45,17,8,10,99,103
2018,2,21801104,3/25/2019,1610612763,Memphis Grizzlies,1,1,1610612760,Oklahoma City Thunder,0,0,29,27,56,11,22,33,40,49,89,24,7,31,20,32,31,8,15,101,115
2021,2,22100515,12/28/2021,1610612758,Sacramento Kings,1,1,1610612760,Oklahoma City Thunder,0,0,23,33,56,17,22,39,40,55,95,20,7,27,14,42,25,6,10,103,117
2021,2,22100515,12/28/2021,1610612760,Oklahoma City Thunder,0,0,1610612758,Sacramento Kings,1,1,24,33,57,11,22,33,35,55,90,30,6,36,10,48,16,3,9,105,111
2020,2,22000315,2/1/2021,1610612741,Chicago Bulls,1,1,1610612752,New York Knicks,0,0,31,23,54,11,23,34,42,46,88,15,5,20,13,36,30,6,12,98,110
2020,2,22000315,2/1/2021,1610612752,New York Knicks,0,0,1610612741,Chicago Bulls,1,1,31,27,58,6,23,29,37,50,87,22,4,26,14,37,21,3,12,97,102
2014,2,21400069,11/6/2014,1610612745,Houston Rockets,1,1,1610612759,San Antonio Spurs,0,0,24,21,45,10,17,27,34,38,72,20,13,33,11,33,18,12,21,97,98
2016,2,21600812,2/11/2017,1610612745,Houston Rockets,1,1,1610612756,Phoenix Suns,0,0,24,25,49,18,18,36,42,43,85,31,8,39,18,31,27,8,21,105,133
2016,2,21600812,2/11/2017,1610612756,Phoenix Suns,0,0,1610612745,Houston Rockets,1,1,29,43,72,8,14,22,37,57,94,20,6,26,18,41,20,8,19,107,102
2016,2,21600320,12/6/2016,1610612762,Utah Jazz,1,1,1610612756,Phoenix Suns,0,0,24,22,46,12,15,27,36,37,73,28,4,32,9,30,23,5,16,98,112
2023,2,22300190,11/13/2023,1610612749,Milwaukee Bucks,1,1,1610612741,Chicago Bulls,0,0,27,15,42,15,32,47,42,47,89,19,8,27,21,31,23,9,17,98,118
2022,2,22201065,3/19/2023,1610612737,Atlanta Hawks,0,0,1610612759,San Antonio Spurs,1,1,43,36,79,5,17,22,48,53,101,17,3,20,21,33,21,9,13,99,118
2021,2,22100514,12/28/2021,1610612743,Denver Nuggets,0,1,1610612744,Golden State Warriors,1,0,26,24,50,8,25,33,34,49,83,13,7,20,16,37,24,8,16,92,89
2021,2,22100514,12/28/2021,1610612744,Golden State Warriors,1,0,1610612743,Denver Nuggets,0,1,20,20,40,10,22,32,30,42,72,16,15,31,12,37,20,10,17,93,86
2017,2,21700276,11/24/2017,1610612741,Chicago Bulls,0,0,1610612744,Golden State Warriors,1,1,22,41,63,13,23,36,35,64,99,11,4,15,20,46,18,11,15,102,94
2017,2,21700276,11/24/2017,1610612744,Golden State Warriors,1,1,1610612741,Chicago Bulls,0,0,37,18,55,16,20,36,53,38,91,21,0,21,7,31,36,7,11,102,143
2019,2,21900179,11/16/2019,1610612745,Houston Rockets,0,1,1610612750,Minnesota Timberwolves,1,0,24,21,45,19,30,49,43,51,94,20,2,22,17,35,15,7,12,99,125
2019,2,21900179,11/16/2019,1610612750,Minnesota Timberwolves,1,0,1610612745,Houston Rockets,0,1,26,20,46,12,26,38,38,46,84,17,6,23,16,32,23,7,19,99,105
2020,2,22000629,3/18/2021,1610612740,New Orleans Pelicans,0,0,1610612757,Portland Trail Blazers,1,1,23,23,46,10,27,37,33,50,83,17,8,25,15,39,24,8,12,92,93
2020,2,22000629,3/18/2021,1610612757,Portland Trail Blazers,1,1,1610612740,New Orleans Pelicans,0,0,19,25,44,14,29,43,33,54,87,21,4,25,18,36,11,6,14,92,101
2014,2,21400069,11/6/2014,1610612759,San Antonio Spurs,0,0,1610612745,Houston Rockets,1,1,29,41,70,2,18,20,31,59,90,17,2,19,18,41,17,7,17,97,81
2017,2,21700275,11/24/2017,1610612740,New Orleans Pelicans,0,1,1610612756,Phoenix Suns,1,0,36,28,64,9,18,27,45,46,91,16,6,22,18,33,29,9,15,101,115
2021,2,22100513,12/28/2021,1610612739,Cleveland Cavaliers,0,0,1610612740,New Orleans Pelicans,1,1,23,24,47,14,27,41,37,51,88,16,3,19,12,41,27,3,8,93,104
2023,2,22300016,11/10/2023,1610612758,Sacramento Kings,1,1,1610612760,Oklahoma City Thunder,0,0,25,19,44,13,34,47,38,53,91,16,5,21,21,34,28,9,18,99,105
2023,2,22300201,11/16/2023,1610612760,Oklahoma City Thunder,0,1,1610612744,Golden State Warriors,1,0,25,30,55,19,13,32,44,43,87,21,2,23,13,30,31,5,13,97,128
2023,2,22300052,11/24/2023,1610612740,New Orleans Pelicans,0,1,1610612746,LA Clippers,1,0,33,31,64,10,14,24,43,45,88,20,7,27,15,33,26,11,15,100,116
2023,2,22300320,12/14/2023,1610612741,Chicago Bulls,0,1,1610612748,Miami Heat,1,0,31,26,57,14,22,36,45,48,93,20,10,30,15,37,32,2,5,98,124
2022,2,22200993,3/9/2023,1610612754,Indiana Pacers,1,1,1610612745,Houston Rockets,0,0,30,25,55,18,27,45,48,52,100,20,1,21,11,42,34,6,12,110,134
2021,2,22100513,12/28/2021,1610612740,New Orleans Pelicans,1,1,1610612739,Cleveland Cavaliers,0,0,20,24,44,16,20,36,36,44,80,20,6,26,12,35,24,6,13,93,108
2020,2,22000314,2/1/2021,1610612748,Miami Heat,1,0,1610612766,Charlotte Hornets,0,1,24,21,45,19,27,46,43,48,91,16,9,25,14,36,28,6,17,107,121
2020,2,22000314,2/1/2021,1610612766,Charlotte Hornets,0,1,1610612748,Miami Heat,1,0,22,32,54,21,20,41,43,52,95,22,4,26,14,39,31,8,12,105,129
2019,2,21900443,12/22/2019,1610612743,Denver Nuggets,0,1,1610612747,Los Angeles Lakers,1,0,34,26,60,11,21,32,45,47,92,27,3,30,21,28,31,7,10,95,128
2019,2,21900443,12/22/2019,1610612747,Los Angeles Lakers,1,0,1610612743,Denver Nuggets,0,1,29,25,54,10,19,29,39,44,83,16,6,22,18,28,18,13,19,95,104
2017,2,21700275,11/24/2017,1610612756,Phoenix Suns,1,0,1610612740,New Orleans Pelicans,0,1,35,39,74,2,18,20,37,57,94,15,3,18,19,41,12,10,17,100,91
2023,2,22300171,11/9/2023,1610612754,Indiana Pacers,1,1,1610612749,Milwaukee Bucks,0,0,24,20,44,20,28,48,44,48,92,18,2,20,12,38,27,6,13,100,126
2014,2,21401029,3/20/2015,1610612758,Sacramento Kings,1,1,1610612766,Charlotte Hornets,0,0,28,29,57,9,12,21,37,41,78,18,7,25,12,33,21,10,22,97,101
2014,2,21401029,3/20/2015,1610612766,Charlotte Hornets,0,0,1610612758,Sacramento Kings,1,1,30,43,73,6,12,18,36,55,91,13,3,16,15,42,16,4,13,98,91
2023,2,22300319,12/14/2023,1610612738,Boston Celtics,1,1,1610612739,Cleveland Cavaliers,0,0,30,19,49,13,23,36,43,42,85,17,3,20,13,31,22,7,13,95,116
2014,2,21400068,11/5/2014,1610612744,Golden State Warriors,1,1,1610612746,LA Clippers,0,0,28,21,49,15,10,25,43,31,74,20,0,20,6,25,29,12,23,101,121
2021,2,22100512,12/28/2021,1610612750,Minnesota Timberwolves,1,0,1610612752,New York Knicks,0,1,27,20,47,7,31,38,34,51,85,13,7,20,15,41,22,5,11,91,88
2021,2,22100512,12/28/2021,1610612752,New York Knicks,0,1,1610612750,Minnesota Timberwolves,1,0,21,29,50,16,24,40,37,53,90,6,10,16,22,37,20,6,16,91,96
2014,2,21400068,11/5/2014,1610612746,LA Clippers,0,0,1610612744,Golden State Warriors,1,1,31,32,63,7,12,19,38,44,82,21,6,27,8,38,26,7,16,103,104
2020,2,22000313,2/1/2021,1610612737,Atlanta Hawks,1,0,1610612747,Los Angeles Lakers,0,1,26,23,49,11,18,29,37,41,78,14,3,17,12,30,27,10,19,94,99
2022,2,22201048,3/17/2023,1610612744,Golden State Warriors,0,0,1610612737,Atlanta Hawks,1,1,36,22,58,11,29,40,47,51,98,14,6,20,19,35,28,7,17,106,119
2020,2,22000628,3/18/2021,1610612750,Minnesota Timberwolves,0,1,1610612756,Phoenix Suns,1,0,33,26,59,11,23,34,44,49,93,24,11,35,17,38,22,6,12,103,123
2020,2,22000628,3/18/2021,1610612756,Phoenix Suns,1,0,1610612750,Minnesota Timberwolves,0,1,30,19,49,15,21,36,45,40,85,14,5,19,13,30,29,14,22,104,119
2021,2,22100511,12/28/2021,1610612745,Houston Rockets,1,0,1610612747,Los Angeles Lakers,0,1,28,20,48,16,19,35,44,39,83,19,6,25,8,34,24,8,14,100,123
2021,2,22100511,12/28/2021,1610612747,Los Angeles Lakers,0,1,1610612745,Houston Rockets,1,0,34,24,58,14,20,34,48,44,92,22,7,29,18,30,27,10,12,101,132
2014,2,21400067,11/5/2014,1610612743,Denver Nuggets,0,0,1610612758,Sacramento Kings,1,1,28,26,54,9,19,28,37,45,82,26,5,31,9,36,24,8,14,101,109
2014,2,21400067,11/5/2014,1610612758,Sacramento Kings,1,1,1610612743,Denver Nuggets,0,0,34,22,56,8,12,20,42,34,76,39,11,50,13,28,21,4,13,100,131
2020,2,22000313,2/1/2021,1610612747,Los Angeles Lakers,0,1,1610612737,Atlanta Hawks,1,0,33,21,54,7,16,23,40,37,77,20,4,24,7,31,24,8,13,93,107
2019,2,21900442,12/22/2019,1610612746,LA Clippers,0,0,1610612760,Oklahoma City Thunder,1,1,29,30,59,11,16,27,40,46,86,21,3,24,13,34,22,10,17,100,112
2019,2,21900442,12/22/2019,1610612760,Oklahoma City Thunder,1,1,1610612746,LA Clippers,0,0,37,33,70,9,18,27,46,51,97,17,3,20,17,35,24,7,12,101,118
2019,2,21900178,11/16/2019,1610612740,New Orleans Pelicans,0,0,1610612748,Miami Heat,1,1,21,26,47,16,19,35,37,45,82,4,2,6,10,36,23,13,18,94,94
2019,2,21900178,11/16/2019,1610612748,Miami Heat,1,1,1610612740,New Orleans Pelicans,0,0,35,22,57,9,15,24,44,37,81,12,1,13,13,24,25,10,21,95,109
2017,2,21700274,11/24/2017,1610612743,Denver Nuggets,1,1,1610612763,Memphis Grizzlies,0,0,31,16,47,9,23,32,40,39,79,15,11,26,18,25,24,10,20,94,104
2017,2,21700274,11/24/2017,1610612763,Memphis Grizzlies,0,0,1610612743,Denver Nuggets,1,1,27,22,49,9,15,24,36,37,73,11,5,16,4,36,28,9,18,94,92
2014,2,21400459,12/29/2014,1610612749,Milwaukee Bucks,0,1,1610612766,Charlotte Hornets,1,0,34,30,64,6,15,21,40,45,85,18,3,21,6,40,21,13,20,109,104
2014,2,21400459,12/29/2014,1610612766,Charlotte Hornets,1,0,1610612749,Milwaukee Bucks,0,1,26,39,65,7,18,25,33,57,90,21,5,26,13,46,20,8,19,107,94
2021,2,22100510,12/28/2021,1610612755,Philadelphia 76ers,0,1,1610612761,Toronto Raptors,1,0,20,27,47,14,16,30,34,43,77,32,6,38,9,36,23,7,8,94,114
2022,2,22201049,3/17/2023,1610612764,Washington Wizards,0,0,1610612739,Cleveland Cavaliers,1,1,27,26,53,8,15,23,35,41,76,16,4,20,9,34,22,9,17,94,94
2021,2,22100510,12/28/2021,1610612761,Toronto Raptors,1,0,1610612755,Philadelphia 76ers,0,1,23,23,46,15,26,41,38,49,87,18,4,22,15,35,24,6,10,94,109
2020,2,22000312,2/1/2021,1610612739,Cleveland Cavaliers,1,1,1610612750,Minnesota Timberwolves,0,0,28,34,62,7,15,22,35,49,84,23,8,31,19,32,26,4,15,95,100
2020,2,22000312,2/1/2021,1610612750,Minnesota Timberwolves,0,0,1610612739,Cleveland Cavaliers,1,1,29,35,64,11,27,38,40,62,102,7,4,11,20,42,20,4,8,95,98
2017,2,21700273,11/24/2017,1610612760,Oklahoma City Thunder,1,0,1610612765,Detroit Pistons,0,1,34,32,66,8,24,32,42,56,98,6,2,8,20,37,22,6,15,97,98
2017,2,21700273,11/24/2017,1610612765,Detroit Pistons,0,1,1610612760,Oklahoma City Thunder,1,0,25,22,47,14,23,37,39,45,84,7,2,9,11,36,22,13,20,97,99
2023,2,22300171,11/9/2023,1610612749,Milwaukee Bucks,0,0,1610612754,Indiana Pacers,1,1,37,23,60,9,18,27,46,41,87,23,3,26,10,34,23,6,14,100,124
2016,2,21600811,2/11/2017,1610612739,Cleveland Cavaliers,1,1,1610612743,Denver Nuggets,0,0,31,23,54,15,15,30,46,38,84,18,4,22,10,30,30,8,16,101,125
2016,2,21600811,2/11/2017,1610612743,Denver Nuggets,0,0,1610612739,Cleveland Cavaliers,1,1,27,33,60,12,25,37,39,58,97,19,3,22,18,40,23,9,12,102,109
2020,2,22000627,3/18/2021,1610612752,New York Knicks,1,1,1610612753,Orlando Magic,0,0,23,29,52,14,20,34,37,49,86,6,5,11,8,42,24,6,7,91,94
2020,2,22000627,3/18/2021,1610612753,Orlando Magic,0,0,1610612752,New York Knicks,1,1,25,23,48,10,24,34,35,47,82,13,3,16,9,39,21,6,11,90,93
2023,2,22300052,11/24/2023,1610612746,LA Clippers,1,0,1610612740,New Orleans Pelicans,0,1,31,24,55,11,26,37,42,50,92,11,6,17,12,40,27,6,11,99,106
2020,2,22000311,1/31/2021,1610612739,Cleveland Cavaliers,0,0,1610612750,Minnesota Timberwolves,1,1,37,31,68,4,12,16,41,43,84,18,5,23,15,30,20,10,19,100,104
2020,2,22000311,1/31/2021,1610612750,Minnesota Timberwolves,1,1,1610612739,Cleveland Cavaliers,0,0,25,26,51,16,24,40,41,50,91,11,4,15,8,45,24,3,10,101,109
2019,2,21900441,12/22/2019,1610612749,Milwaukee Bucks,1,1,1610612754,Indiana Pacers,0,0,29,31,60,15,29,44,44,60,104,14,3,17,22,40,31,7,10,100,117
2019,2,21900441,12/22/2019,1610612754,Indiana Pacers,0,0,1610612749,Milwaukee Bucks,1,1,25,35,60,12,28,40,37,63,100,3,2,5,15,48,27,10,13,100,89
2017,2,21700272,11/24/2017,1610612748,Miami Heat,0,1,1610612750,Minnesota Timberwolves,1,0,19,22,41,19,20,39,38,42,80,14,2,16,12,32,29,9,14,90,109
2017,2,21700272,11/24/2017,1610612750,Minnesota Timberwolves,1,0,1610612748,Miami Heat,0,1,30,37,67,7,10,17,37,47,84,16,10,26,16,35,21,4,10,91,97
2014,2,21400066,11/5/2014,1610612739,Cleveland Cavaliers,0,0,1610612762,Utah Jazz,1,1,24,32,56,6,10,16,30,42,72,34,6,40,13,32,6,3,12,87,100
2020,2,22000626,3/18/2021,1610612737,Atlanta Hawks,1,1,1610612760,Oklahoma City Thunder,0,0,36,18,54,11,22,33,47,40,87,11,2,13,12,28,26,5,14,96,116
2020,2,22000626,3/18/2021,1610612760,Oklahoma City Thunder,0,0,1610612737,Atlanta Hawks,1,1,21,38,59,13,21,34,34,59,93,12,4,16,14,48,18,6,10,96,93
2022,2,22200996,3/9/2023,1610612744,Golden State Warriors,0,0,1610612763,Memphis Grizzlies,1,1,21,16,37,15,30,45,36,46,82,23,1,24,11,36,25,6,17,101,110
2021,2,22100509,12/28/2021,1610612748,Miami Heat,1,1,1610612764,Washington Wizards,0,0,25,33,58,16,18,34,41,51,92,21,2,23,16,37,26,5,8,93,119
2021,2,22100509,12/28/2021,1610612764,Washington Wizards,0,0,1610612748,Miami Heat,1,1,25,18,43,17,25,42,42,43,85,11,3,14,15,30,27,14,18,92,112
2022,2,22201036,3/15/2023,1610612763,Memphis Grizzlies,0,0,1610612748,Miami Heat,1,1,28,17,45,18,28,46,46,45,91,9,5,14,13,36,29,8,16,101,119
2017,2,21700271,11/24/2017,1610612754,Indiana Pacers,1,1,1610612761,Toronto Raptors,0,0,27,30,57,11,15,26,38,45,83,20,7,27,12,36,19,14,16,99,107
2014,2,21400458,12/28/2014,1610612747,Los Angeles Lakers,1,0,1610612756,Phoenix Suns,0,1,30,31,61,12,8,20,42,39,81,11,9,20,6,37,22,12,17,102,107
2014,2,21400458,12/28/2014,1610612756,Phoenix Suns,0,1,1610612747,Los Angeles Lakers,1,0,35,30,65,9,13,22,44,43,87,19,5,24,11,33,24,8,13,101,116
2020,2,22000625,3/17/2021,1610612742,Dallas Mavericks,1,1,1610612746,LA Clippers,0,0,25,20,45,15,19,34,40,39,79,10,2,12,9,31,14,12,18,95,105
2023,2,22300015,11/10/2023,1610612747,Los Angeles Lakers,0,1,1610612756,Phoenix Suns,1,0,30,27,57,12,15,27,42,42,84,26,8,34,11,35,27,9,11,97,122
2023,2,22300051,11/24/2023,1610612759,San Antonio Spurs,0,0,1610612744,Golden State Warriors,1,1,33,20,53,12,35,47,45,55,100,10,2,12,20,35,28,7,20,107,112
2023,2,22300166,11/8/2023,1610612740,New Orleans Pelicans,0,0,1610612750,Minnesota Timberwolves,1,1,28,37,65,8,20,28,36,57,93,21,1,22,17,41,23,9,17,102,101
2020,2,22000625,3/17/2021,1610612746,LA Clippers,0,0,1610612742,Dallas Mavericks,1,1,28,28,56,9,23,32,37,51,88,6,5,11,13,40,22,7,13,94,89
2023,2,22300309,12/12/2023,1610612758,Sacramento Kings,0,0,1610612746,LA Clippers,1,1,26,23,49,10,27,37,36,50,86,17,7,24,10,43,27,6,13,101,99
2023,2,22300260,11/29/2023,1610612756,Phoenix Suns,0,0,1610612761,Toronto Raptors,1,1,31,37,68,7,19,26,38,56,94,22,1,23,20,37,25,7,10,95,105
2022,2,22200993,3/9/2023,1610612745,Houston Rockets,0,0,1610612754,Indiana Pacers,1,1,43,47,90,6,11,17,49,58,107,21,8,29,28,36,18,12,17,111,125
2023,2,22300016,11/10/2023,1610612760,Oklahoma City Thunder,0,0,1610612758,Sacramento Kings,1,1,32,25,57,7,23,30,39,48,87,13,3,16,11,38,22,10,16,98,98
2020,2,22000310,1/31/2021,1610612751,Brooklyn Nets,0,0,1610612764,Washington Wizards,1,1,31,21,52,19,17,36,50,38,88,27,6,33,9,31,33,10,17,112,146
2020,2,22000310,1/31/2021,1610612764,Washington Wizards,1,1,1610612751,Brooklyn Nets,0,0,44,25,69,12,27,39,56,52,108,25,7,32,16,42,24,6,7,114,149
2019,2,21900440,12/22/2019,1610612738,Boston Celtics,1,1,1610612766,Charlotte Hornets,0,0,32,24,56,14,18,32,46,42,88,13,3,16,16,27,25,3,13,92,119
2019,2,21900440,12/22/2019,1610612766,Charlotte Hornets,0,0,1610612738,Boston Celtics,1,1,23,25,48,10,24,34,33,49,82,17,6,23,6,48,26,2,6,92,93
2017,2,21700271,11/24/2017,1610612761,Toronto Raptors,0,0,1610612754,Indiana Pacers,1,1,31,20,51,9,21,30,40,41,81,15,5,20,11,33,17,10,20,99,104
2023,2,22300319,12/14/2023,1610612739,Cleveland Cavaliers,0,0,1610612738,Boston Celtics,1,1,29,21,50,11,22,33,40,43,83,16,1,17,12,32,21,7,16,95,107
2020,2,22000624,3/17/2021,1610612743,Denver Nuggets,1,1,1610612766,Charlotte Hornets,0,0,36,10,46,16,28,44,52,38,90,9,4,13,10,29,37,11,16,103,129
2020,2,22000624,3/17/2021,1610612766,Charlotte Hornets,0,0,1610612743,Denver Nuggets,1,1,24,18,42,12,26,38,36,44,80,20,8,28,8,42,25,12,17,102,104
2017,2,21700270,11/24/2017,1610612739,Cleveland Cavaliers,1,1,1610612766,Charlotte Hornets,0,0,25,19,44,13,26,39,38,45,83,11,4,15,5,42,25,4,12,97,100
2021,2,22100508,12/28/2021,1610612749,Milwaukee Bucks,0,1,1610612753,Orlando Magic,1,0,30,18,48,17,20,37,47,38,85,16,6,22,9,32,31,7,13,100,127
2021,2,22100508,12/28/2021,1610612753,Orlando Magic,1,0,1610612749,Milwaukee Bucks,0,1,26,18,44,12,27,39,38,45,83,22,4,26,9,36,24,4,13,99,110
2017,2,21700270,11/24/2017,1610612766,Charlotte Hornets,0,0,1610612739,Cleveland Cavaliers,1,1,25,40,65,11,18,29,36,58,94,16,11,27,20,46,25,4,9,98,99
2016,2,21600319,12/6/2016,1610612750,Minnesota Timberwolves,1,0,1610612759,San Antonio Spurs,0,1,29,33,62,7,13,20,36,46,82,12,6,18,16,34,19,8,15,91,91
2016,2,21600319,12/6/2016,1610612759,San Antonio Spurs,0,1,1610612750,Minnesota Timberwolves,1,0,28,22,50,11,13,24,39,35,74,16,3,19,6,30,21,4,11,90,105
2020,2,22000623,3/17/2021,1610612748,Miami Heat,0,0,1610612763,Memphis Grizzlies,1,1,24,31,55,8,26,34,32,57,89,13,5,18,15,45,17,5,11,95,85
2020,2,22000623,3/17/2021,1610612763,Memphis Grizzlies,1,1,1610612748,Miami Heat,0,0,20,23,43,10,32,42,30,55,85,19,6,25,13,46,22,4,10,94,89
2014,2,21400066,11/5/2014,1610612762,Utah Jazz,1,1,1610612739,Cleveland Cavaliers,0,0,32,24,56,7,14,21,39,38,77,17,5,22,16,25,26,8,15,88,102
2020,2,22000309,1/31/2021,1610612753,Orlando Magic,0,0,1610612761,Toronto Raptors,1,1,20,26,46,13,23,36,33,49,82,23,5,28,10,41,22,8,11,97,102
2020,2,22000309,1/31/2021,1610612761,Toronto Raptors,1,1,1610612753,Orlando Magic,0,0,29,22,51,12,27,39,41,49,90,21,1,22,14,36,27,8,11,97,115
2022,2,22200996,3/9/2023,1610612763,Memphis Grizzlies,1,1,1610612744,Golden State Warriors,0,0,32,21,53,18,22,40,50,43,93,13,5,18,13,31,36,9,14,102,131
2019,2,21900439,12/22/2019,1610612742,Dallas Mavericks,0,0,1610612761,Toronto Raptors,1,1,20,24,44,15,31,46,35,55,90,22,5,27,18,39,27,12,17,103,107
2019,2,21900439,12/22/2019,1610612761,Toronto Raptors,1,1,1610612742,Dallas Mavericks,0,0,27,33,60,10,24,34,37,57,94,26,5,31,19,40,21,6,12,102,110
2019,2,21900177,11/16/2019,1610612752,New York Knicks,1,0,1610612766,Charlotte Hornets,0,1,33,33,66,6,14,20,39,47,86,18,5,23,18,33,22,5,11,90,102
2019,2,21900177,11/16/2019,1610612766,Charlotte Hornets,0,1,1610612752,New York Knicks,1,0,19,20,39,17,31,48,36,51,87,14,5,19,17,37,22,5,10,90,103
2022,2,22201070,3/19/2023,1610612747,Los Angeles Lakers,1,1,1610612753,Orlando Magic,0,0,23,23,46,13,19,32,36,42,78,26,6,32,10,35,25,8,15,96,111
2014,2,21401028,3/20/2015,1610612738,Boston Celtics,0,0,1610612759,San Antonio Spurs,1,1,30,38,68,5,15,20,35,53,88,14,6,20,17,39,19,11,16,95,89
2014,2,21401028,3/20/2015,1610612759,San Antonio Spurs,1,1,1610612738,Boston Celtics,0,0,33,25,58,5,18,23,38,43,81,20,3,23,9,35,31,10,13,96,101
2023,2,22301211,12/6/2023,1610612766,Charlotte Hornets,0,0,1610612741,Chicago Bulls,1,1,29,24,53,10,27,37,39,51,90,12,0,12,13,38,25,6,17,97,100
2023,2,22300051,11/24/2023,1610612744,Golden State Warriors,1,1,1610612759,San Antonio Spurs,0,0,21,18,39,19,23,42,40,41,81,19,5,24,11,32,35,10,24,106,118
2021,2,22100507,12/27/2021,1610612746,LA Clippers,1,0,1610612751,Brooklyn Nets,0,1,23,37,60,14,23,37,37,60,97,20,7,27,21,42,25,7,12,98,108
2021,2,22100507,12/27/2021,1610612751,Brooklyn Nets,0,1,1610612746,LA Clippers,1,0,37,17,54,13,21,34,50,38,88,11,5,16,11,29,31,7,15,98,124
2020,2,22000308,1/31/2021,1610612746,LA Clippers,0,1,1610612752,New York Knicks,1,0,27,16,43,17,21,38,44,37,81,24,4,28,11,27,26,5,7,93,129
2020,2,22000308,1/31/2021,1610612752,New York Knicks,1,0,1610612746,LA Clippers,0,1,31,27,58,10,17,27,41,44,85,23,5,28,13,35,21,2,8,93,115
2014,2,21400065,11/5/2014,1610612756,Phoenix Suns,1,0,1610612763,Memphis Grizzlies,0,1,24,24,48,8,13,21,32,37,69,19,2,21,8,31,13,10,21,92,91
2020,2,22000622,3/17/2021,1610612744,Golden State Warriors,0,1,1610612745,Houston Rockets,1,0,25,20,45,16,29,45,41,49,90,10,2,12,8,43,32,7,13,101,108
2020,2,22000622,3/17/2021,1610612745,Houston Rockets,1,0,1610612744,Golden State Warriors,0,1,26,27,53,7,20,27,33,47,80,21,19,40,14,42,19,7,16,101,94
2022,2,22200994,3/9/2023,1610612753,Orlando Magic,1,0,1610612762,Utah Jazz,0,1,28,32,60,16,18,34,44,50,94,20,11,31,19,34,21,7,10,100,124
2021,2,22100506,12/27/2021,1610612742,Dallas Mavericks,0,1,1610612757,Portland Trail Blazers,1,0,36,15,51,12,21,33,48,36,84,24,9,33,15,26,38,4,13,97,132
2021,2,22100506,12/27/2021,1610612757,Portland Trail Blazers,1,0,1610612742,Dallas Mavericks,0,1,23,19,42,12,28,40,35,47,82,35,7,42,15,36,19,6,11,98,117
2022,2,22201036,3/15/2023,1610612748,Miami Heat,1,1,1610612763,Memphis Grizzlies,0,0,36,17,53,13,16,29,49,33,82,27,6,33,8,27,33,6,13,100,138
2023,2,22300172,11/9/2023,1610612753,Orlando Magic,1,0,1610612737,Atlanta Hawks,0,1,32,31,63,10,17,27,42,48,90,25,10,35,20,32,19,13,19,104,119
2023,2,22300257,11/27/2023,1610612743,Denver Nuggets,0,1,1610612746,LA Clippers,1,0,34,36,70,10,12,22,44,48,92,15,13,28,20,36,28,6,11,96,113
2020,2,22001080,5/16/2021,1610612764,Washington Wizards,1,1,1610612766,Charlotte Hornets,0,0,34,26,60,10,21,31,44,47,91,17,4,21,13,35,22,8,14,101,115
2020,2,22001080,5/16/2021,1610612766,Charlotte Hornets,0,0,1610612764,Washington Wizards,1,1,23,26,49,14,31,45,37,57,94,22,2,24,15,44,25,4,13,103,110
2014,2,21400065,11/5/2014,1610612763,Memphis Grizzlies,0,1,1610612756,Phoenix Suns,1,0,31,32,63,9,8,17,40,40,80,13,4,17,10,33,25,11,16,91,102
2020,2,22000307,1/31/2021,1610612754,Indiana Pacers,1,0,1610612755,Philadelphia 76ers,0,1,31,25,56,10,18,28,41,43,84,18,4,22,13,32,21,9,18,99,110
2022,2,22200994,3/9/2023,1610612762,Utah Jazz,0,1,1610612753,Orlando Magic,1,0,36,18,54,13,21,34,49,39,88,20,1,21,14,26,27,9,18,99,131
2020,2,22000307,1/31/2021,1610612755,Philadelphia 76ers,0,1,1610612754,Indiana Pacers,1,0,37,29,66,8,18,26,45,47,92,21,10,31,18,33,20,6,12,99,119
2023,2,22300257,11/27/2023,1610612746,LA Clippers,1,0,1610612743,Denver Nuggets,0,1,29,36,65,6,14,20,35,50,85,28,6,34,17,36,18,8,13,96,104
2023,2,22300446,12/31/2023,1610612747,Los Angeles Lakers,0,0,1610612740,New Orleans Pelicans,1,1,29,21,50,10,22,32,39,43,82,21,4,25,8,38,26,9,13,99,109
2021,2,22100505,12/27/2021,1610612756,Phoenix Suns,1,0,1610612763,Memphis Grizzlies,0,1,30,29,59,11,20,31,41,49,90,20,3,23,13,36,25,10,11,97,113
2021,2,22100505,12/27/2021,1610612763,Memphis Grizzlies,0,1,1610612756,Phoenix Suns,1,0,34,25,59,11,18,29,45,43,88,13,4,17,18,28,22,11,19,98,114
2020,2,22000306,1/31/2021,1610612743,Denver Nuggets,1,1,1610612762,Utah Jazz,0,0,29,30,59,18,10,28,47,40,87,16,3,19,8,33,28,3,8,97,128
2020,2,22000306,1/31/2021,1610612762,Utah Jazz,0,0,1610612743,Denver Nuggets,1,1,12,16,28,20,27,47,32,43,75,33,6,39,12,33,28,8,15,98,117
2019,2,21900438,12/21/2019,1610612750,Minnesota Timberwolves,0,0,1610612757,Portland Trail Blazers,1,1,23,27,50,15,22,37,38,49,87,15,1,16,8,41,16,9,17,105,106
2019,2,21900438,12/21/2019,1610612757,Portland Trail Blazers,1,1,1610612750,Minnesota Timberwolves,0,0,27,32,59,13,22,35,40,54,94,20,5,25,17,39,19,8,15,104,113
2019,2,21900176,11/16/2019,1610612749,Milwaukee Bucks,0,1,1610612754,Indiana Pacers,1,0,32,25,57,11,28,39,43,53,96,5,2,7,13,41,23,8,15,101,102
2019,2,21900176,11/16/2019,1610612754,Indiana Pacers,1,0,1610612749,Milwaukee Bucks,0,1,20,46,66,12,22,34,32,68,100,7,2,9,19,51,19,6,15,101,83
2017,2,21700269,11/24/2017,1610612738,Boston Celtics,1,1,1610612753,Orlando Magic,0,0,25,24,49,17,25,42,42,49,91,17,8,25,17,37,27,6,9,94,118
2014,2,21400064,11/5/2014,1610612737,Atlanta Hawks,0,0,1610612759,San Antonio Spurs,1,1,30,37,67,8,17,25,38,54,92,8,3,11,15,40,26,7,14,96,92
2020,2,22000621,3/17/2021,1610612741,Chicago Bulls,1,0,1610612759,San Antonio Spurs,0,1,29,29,58,11,22,33,40,51,91,8,1,9,18,33,24,5,17,96,99
2020,2,22000621,3/17/2021,1610612759,San Antonio Spurs,0,1,1610612741,Chicago Bulls,1,0,30,28,58,8,23,31,38,51,89,22,8,30,15,39,19,6,9,96,106
2014,2,21400064,11/5/2014,1610612759,San Antonio Spurs,1,1,1610612737,Atlanta Hawks,0,0,26,26,52,5,12,17,31,38,69,27,11,38,12,29,25,14,21,96,94
2023,2,22300113,10/31/2023,1610612759,San Antonio Spurs,0,1,1610612756,Phoenix Suns,1,0,29,26,55,14,23,37,43,49,92,15,5,20,13,39,25,8,12,99,115
2017,2,21700269,11/24/2017,1610612753,Orlando Magic,0,0,1610612738,Boston Celtics,1,1,32,39,71,9,15,24,41,54,95,12,7,19,21,35,21,6,12,95,103
2021,2,22100504,12/27/2021,1610612759,San Antonio Spurs,1,0,1610612762,Utah Jazz,0,1,35,35,70,10,20,30,45,55,100,4,5,9,10,48,26,9,10,104,104
2021,2,22100504,12/27/2021,1610612762,Utah Jazz,0,1,1610612759,San Antonio Spurs,1,0,30,25,55,9,22,31,39,47,86,23,7,30,12,38,19,8,15,103,110
2020,2,22000305,1/30/2021,1610612744,Golden State Warriors,1,1,1610612765,Detroit Pistons,0,0,30,23,53,17,19,36,47,42,89,7,3,10,10,33,34,7,14,99,118
2020,2,22000305,1/30/2021,1610612765,Detroit Pistons,0,0,1610612744,Golden State Warriors,1,1,20,21,41,9,27,36,29,48,77,24,8,32,11,41,17,6,16,98,91
2016,2,21600810,2/11/2017,1610612748,Miami Heat,0,0,1610612755,Philadelphia 76ers,1,1,32,29,61,7,17,24,39,46,85,24,4,28,17,31,15,15,20,101,109
2022,2,22201069,3/19/2023,1610612746,LA Clippers,0,1,1610612757,Portland Trail Blazers,1,0,31,35,66,12,16,28,43,51,94,19,4,23,21,32,26,7,10,96,117
2022,2,22200992,3/9/2023,1610612765,Detroit Pistons,1,0,1610612766,Charlotte Hornets,0,1,33,35,68,7,14,21,40,49,89,16,4,20,18,33,20,11,19,99,103
2016,2,21600810,2/11/2017,1610612755,Philadelphia 76ers,1,1,1610612748,Miami Heat,0,0,30,31,61,9,16,25,39,47,86,30,8,38,13,39,27,4,10,100,117
2014,2,21400063,11/5/2014,1610612754,Indiana Pacers,0,0,1610612764,Washington Wizards,1,1,27,36,63,8,19,27,35,55,90,16,4,20,20,38,22,7,19,100,94
2014,2,21400063,11/5/2014,1610612764,Washington Wizards,1,1,1610612754,Indiana Pacers,0,0,27,47,74,7,10,17,34,57,91,21,2,23,14,44,24,3,12,101,96
2023,2,22300243,11/25/2023,1610612740,New Orleans Pelicans,0,0,1610612762,Utah Jazz,1,1,28,29,57,11,25,36,39,54,93,11,7,18,15,42,31,8,13,100,100
2023,2,22300114,10/31/2023,1610612753,Orlando Magic,0,0,1610612746,LA Clippers,1,1,31,20,51,7,23,30,38,43,81,19,14,33,9,39,23,10,16,103,102
2023,2,22300353,12/18/2023,1610612750,Minnesota Timberwolves,0,1,1610612748,Miami Heat,1,0,31,25,56,11,18,29,42,43,85,17,2,19,12,32,27,10,14,96,112
2023,2,22300499,1/7/2024,1610612753,Orlando Magic,1,1,1610612737,Atlanta Hawks,0,0,26,31,57,17,24,41,43,55,98,14,8,22,16,43,25,9,13,105,117
2021,2,22100503,12/27/2021,1610612738,Boston Celtics,0,0,1610612750,Minnesota Timberwolves,1,1,17,25,42,16,31,47,33,56,89,21,7,28,18,43,23,7,14,98,103
2021,2,22100503,12/27/2021,1610612750,Minnesota Timberwolves,1,1,1610612738,Boston Celtics,0,0,26,30,56,14,20,34,40,50,90,14,5,19,14,39,30,8,14,100,108
2014,2,21400062,11/5/2014,1610612741,Chicago Bulls,0,1,1610612749,Milwaukee Bucks,1,0,29,28,57,5,11,16,34,39,73,22,8,30,10,33,24,10,16,93,95
2019,2,21900437,12/21/2019,1610612745,Houston Rockets,0,1,1610612756,Phoenix Suns,1,0,32,14,46,19,22,41,51,36,87,18,5,23,6,35,23,5,10,101,139
2019,2,21900437,12/21/2019,1610612756,Phoenix Suns,1,0,1610612745,Houston Rockets,0,1,39,24,63,8,20,28,47,44,91,23,7,30,14,33,26,4,10,101,125
2023,2,22300320,12/14/2023,1610612748,Miami Heat,1,0,1610612741,Chicago Bulls,0,1,22,24,46,15,19,34,37,43,80,27,8,35,12,34,26,8,11,98,116
2020,2,22000620,3/17/2021,1610612738,Boston Celtics,0,0,1610612739,Cleveland Cavaliers,1,1,30,20,50,10,28,38,40,48,88,20,9,29,18,34,19,6,12,96,110
2020,2,22000620,3/17/2021,1610612739,Cleveland Cavaliers,1,1,1610612738,Boston Celtics,0,0,30,21,51,10,13,23,40,34,74,27,6,33,11,25,23,10,17,96,117
2014,2,21400457,12/28/2014,1610612743,Denver Nuggets,1,0,1610612761,Toronto Raptors,0,1,33,37,70,4,13,17,37,50,87,24,10,34,20,33,18,4,10,93,102
2014,2,21400457,12/28/2014,1610612761,Toronto Raptors,0,1,1610612743,Denver Nuggets,1,0,33,32,65,10,13,23,43,45,88,20,12,32,16,36,23,3,6,93,116
2021,2,22100502,12/27/2021,1610612737,Atlanta Hawks,1,0,1610612741,Chicago Bulls,0,1,25,30,55,15,19,34,40,49,89,23,3,26,14,36,22,5,10,97,118
2022,2,22201069,3/19/2023,1610612757,Portland Trail Blazers,1,0,1610612746,LA Clippers,0,1,31,22,53,6,23,29,37,45,82,22,2,24,13,33,24,11,15,96,102
2021,2,22100502,12/27/2021,1610612741,Chicago Bulls,0,1,1610612737,Atlanta Hawks,1,0,33,24,57,18,19,37,51,43,94,10,4,14,11,34,29,3,10,97,130
2020,2,22001079,5/16/2021,1610612754,Indiana Pacers,0,1,1610612761,Toronto Raptors,1,0,33,25,58,15,22,37,48,47,95,14,4,18,13,35,34,8,13,104,125
2020,2,22001079,5/16/2021,1610612761,Toronto Raptors,1,0,1610612754,Indiana Pacers,0,1,27,32,59,12,26,38,39,58,97,23,6,29,19,40,21,8,12,104,113
2023,2,22300085,10/27/2023,1610612762,Utah Jazz,1,1,1610612746,LA Clippers,0,0,26,29,55,16,25,41,42,54,96,20,2,22,22,33,27,8,14,99,120
2020,2,22000619,3/17/2021,1610612758,Sacramento Kings,0,1,1610612764,Washington Wizards,1,0,31,29,60,10,23,33,41,52,93,29,6,35,11,44,25,5,10,107,121
2023,2,22300114,10/31/2023,1610612746,LA Clippers,1,1,1610612753,Orlando Magic,0,0,30,28,58,14,17,31,44,45,89,16,7,23,13,34,29,9,16,104,118
2014,2,21400062,11/5/2014,1610612749,Milwaukee Bucks,1,0,1610612741,Chicago Bulls,0,1,30,44,74,3,12,15,33,56,89,17,3,20,20,38,19,8,15,93,86
2020,2,22000304,1/30/2021,1610612759,San Antonio Spurs,1,0,1610612763,Memphis Grizzlies,0,1,26,28,54,13,16,29,39,44,83,21,5,26,11,35,25,7,14,98,112
2023,2,22300113,10/31/2023,1610612756,Phoenix Suns,1,0,1610612759,San Antonio Spurs,0,1,24,20,44,18,21,39,42,41,83,12,3,15,10,31,29,10,19,100,114
2020,2,22000304,1/30/2021,1610612763,Memphis Grizzlies,0,1,1610612759,San Antonio Spurs,1,0,34,22,56,17,18,35,51,40,91,10,5,15,13,30,34,7,15,99,129
2019,2,21900175,11/16/2019,1610612741,Chicago Bulls,1,0,1610612751,Brooklyn Nets,0,1,23,29,52,9,30,39,32,59,91,38,3,41,23,38,15,10,20,108,111
2019,2,21900175,11/16/2019,1610612751,Brooklyn Nets,0,1,1610612741,Chicago Bulls,1,0,30,15,45,10,33,43,40,48,88,27,4,31,9,42,30,8,15,108,117
2014,2,21400456,12/28/2014,1610612752,New York Knicks,0,0,1610612757,Portland Trail Blazers,1,1,24,42,66,7,20,27,31,62,93,10,5,15,19,45,19,8,11,92,79
2014,2,21400456,12/28/2014,1610612757,Portland Trail Blazers,1,1,1610612752,New York Knicks,0,0,22,23,45,16,20,36,38,43,81,9,3,12,8,36,25,6,11,91,101
2020,2,22000619,3/17/2021,1610612764,Washington Wizards,1,0,1610612758,Sacramento Kings,0,1,42,27,69,4,21,25,46,48,94,23,5,28,13,37,25,10,15,108,119
2021,2,22100501,12/27/2021,1610612745,Houston Rockets,0,0,1610612766,Charlotte Hornets,1,1,21,20,41,15,31,46,36,51,87,12,6,18,14,38,20,13,21,103,99
2021,2,22100501,12/27/2021,1610612766,Charlotte Hornets,1,1,1610612745,Houston Rockets,0,0,29,18,47,18,23,41,47,41,88,11,3,14,8,34,33,9,16,103,123
2020,2,22000303,1/30/2021,1610612742,Dallas Mavericks,1,0,1610612756,Phoenix Suns,0,1,35,19,54,9,20,29,44,39,83,8,6,14,9,34,22,9,16,96,105
2020,2,22000303,1/30/2021,1610612756,Phoenix Suns,0,1,1610612742,Dallas Mavericks,1,0,27,32,59,10,12,22,37,44,81,27,4,31,12,33,22,5,13,96,111
2022,2,22201070,3/19/2023,1610612753,Orlando Magic,0,0,1610612747,Los Angeles Lakers,1,1,31,33,64,10,28,38,41,61,102,13,4,17,18,45,24,2,8,98,105
2020,2,22001078,5/16/2021,1610612756,Phoenix Suns,0,1,1610612759,San Antonio Spurs,1,0,40,29,69,13,22,35,53,51,104,4,0,4,13,38,36,5,8,102,123
2020,2,22001078,5/16/2021,1610612759,San Antonio Spurs,1,0,1610612756,Phoenix Suns,0,1,43,31,74,7,17,24,50,48,98,14,5,19,13,38,30,7,10,103,121
2020,2,22000618,3/17/2021,1610612749,Milwaukee Bucks,0,1,1610612755,Philadelphia 76ers,1,0,32,30,62,9,30,39,41,60,101,18,6,24,14,49,22,14,22,122,109
2020,2,22000618,3/17/2021,1610612755,Philadelphia 76ers,1,0,1610612749,Milwaukee Bucks,0,1,29,39,68,14,27,41,43,66,109,5,3,8,15,51,28,11,20,120,105
2023,2,22300243,11/25/2023,1610612762,Utah Jazz,1,1,1610612740,New Orleans Pelicans,0,0,23,21,44,15,28,43,38,49,87,14,3,17,18,31,23,15,24,100,105
2021,2,22100500,12/26/2021,1610612743,Denver Nuggets,0,1,1610612746,LA Clippers,1,0,24,30,54,15,26,41,39,56,95,10,1,11,16,41,29,8,14,97,103
2021,2,22100500,12/26/2021,1610612746,LA Clippers,1,0,1610612743,Denver Nuggets,0,1,32,28,60,8,18,26,40,46,86,12,6,18,11,38,26,7,14,97,100
2020,2,22000302,1/30/2021,1610612738,Boston Celtics,1,0,1610612747,Los Angeles Lakers,0,1,34,27,61,6,15,21,40,42,82,9,5,14,13,32,24,8,15,93,95
2020,2,22000302,1/30/2021,1610612747,Los Angeles Lakers,0,1,1610612738,Boston Celtics,1,0,28,25,53,9,22,31,37,47,84,13,6,19,14,35,20,10,14,93,96
2019,2,21900436,12/21/2019,1610612746,LA Clippers,0,1,1610612759,San Antonio Spurs,1,0,42,21,63,12,24,36,54,45,99,14,5,19,14,33,32,5,12,103,134
2019,2,21900436,12/21/2019,1610612759,San Antonio Spurs,1,0,1610612746,LA Clippers,0,1,32,22,54,10,18,28,42,40,82,15,4,19,7,34,24,11,18,104,109
2017,2,21700268,11/24/2017,1610612737,Atlanta Hawks,1,1,1610612752,New York Knicks,0,0,34,34,68,13,18,31,47,52,99,9,3,12,17,36,30,1,10,98,116
2017,2,21700268,11/24/2017,1610612752,New York Knicks,0,0,1610612737,Atlanta Hawks,1,1,28,20,48,12,18,30,40,38,78,12,2,14,8,31,30,7,20,97,104
2020,2,22000617,3/17/2021,1610612751,Brooklyn Nets,0,1,1610612754,Indiana Pacers,1,0,33,27,60,9,18,27,42,45,87,31,9,40,18,32,22,10,18,105,124
2020,2,22000617,3/17/2021,1610612754,Indiana Pacers,1,0,1610612751,Brooklyn Nets,0,1,34,18,52,9,23,32,43,41,84,20,5,25,7,37,29,10,16,106,115
2016,2,21600318,12/6/2016,1610612755,Philadelphia 76ers,0,0,1610612763,Memphis Grizzlies,1,1,18,23,41,14,27,41,32,50,82,13,13,26,12,45,21,8,16,97,91
2016,2,21600318,12/6/2016,1610612763,Memphis Grizzlies,1,1,1610612755,Philadelphia 76ers,0,0,31,38,69,2,15,17,33,53,86,28,7,35,19,38,18,5,13,98,96
2021,2,22100499,12/26/2021,1610612741,Chicago Bulls,1,1,1610612754,Indiana Pacers,0,0,32,21,53,11,12,23,43,33,76,16,6,22,5,31,17,9,15,96,113
2021,2,22100499,12/26/2021,1610612754,Indiana Pacers,0,0,1610612741,Chicago Bulls,1,1,33,31,64,8,22,30,41,53,94,15,6,21,16,41,23,5,9,97,105
2020,2,22000301,1/30/2021,1610612748,Miami Heat,1,1,1610612758,Sacramento Kings,0,0,25,20,45,11,21,32,36,41,77,22,4,26,13,29,25,12,16,93,105
2020,2,22000301,1/30/2021,1610612758,Sacramento Kings,0,0,1610612748,Miami Heat,1,1,24,16,40,17,28,45,41,44,85,5,6,11,15,32,22,5,17,94,104
2017,2,21700267,11/24/2017,1610612751,Brooklyn Nets,1,0,1610612757,Portland Trail Blazers,0,1,40,35,75,10,15,25,50,50,100,15,6,21,17,35,25,5,9,102,125
2019,2,21900174,11/15/2019,1610612747,Los Angeles Lakers,1,1,1610612758,Sacramento Kings,0,0,23,21,44,11,26,37,34,47,81,20,2,22,12,36,22,7,13,91,99
2019,2,21900174,11/15/2019,1610612758,Sacramento Kings,0,0,1610612747,Los Angeles Lakers,1,1,20,23,43,16,23,39,36,46,82,9,0,9,11,35,24,11,18,93,97
2017,2,21700267,11/24/2017,1610612757,Portland Trail Blazers,0,1,1610612751,Brooklyn Nets,1,0,42,39,81,6,9,15,48,48,96,25,10,35,17,37,24,4,7,102,127
2016,2,21600809,2/11/2017,1610612749,Milwaukee Bucks,0,1,1610612754,Indiana Pacers,1,0,18,24,42,17,14,31,35,38,73,29,8,37,11,31,28,2,7,88,116
2020,2,22000616,3/17/2021,1610612761,Toronto Raptors,0,0,1610612765,Detroit Pistons,1,1,25,21,46,12,28,40,37,49,86,26,8,34,12,43,27,8,9,98,112
2020,2,22000616,3/17/2021,1610612765,Detroit Pistons,1,1,1610612761,Toronto Raptors,0,0,26,20,46,12,17,29,38,37,75,28,4,32,14,25,23,7,21,96,116
2021,2,22100498,12/26/2021,1610612759,San Antonio Spurs,1,1,1610612765,Detroit Pistons,0,0,38,26,64,13,14,27,51,40,91,29,8,37,16,28,39,10,19,112,144
2021,2,22100498,12/26/2021,1610612765,Detroit Pistons,0,0,1610612759,San Antonio Spurs,1,1,30,36,66,8,24,32,38,60,98,25,9,34,19,46,16,6,14,112,109
2014,2,21400061,11/5/2014,1610612752,New York Knicks,0,0,1610612765,Detroit Pistons,1,1,30,40,70,9,11,20,39,51,90,8,2,10,14,38,25,5,9,91,95
2020,2,22000300,1/30/2021,1610612740,New Orleans Pelicans,1,0,1610612745,Houston Rockets,0,1,29,21,50,12,29,41,41,50,91,18,11,29,14,41,27,8,15,106,112
2020,2,22000300,1/30/2021,1610612745,Houston Rockets,0,1,1610612740,New Orleans Pelicans,1,0,25,21,46,20,26,46,45,47,92,16,4,20,10,39,32,11,16,107,126
2019,2,21900435,12/21/2019,1610612758,Sacramento Kings,0,0,1610612763,Memphis Grizzlies,1,1,32,32,64,11,25,36,43,57,100,18,6,24,22,37,22,8,13,103,115
2019,2,21900435,12/21/2019,1610612763,Memphis Grizzlies,1,1,1610612758,Sacramento Kings,0,0,25,23,48,15,20,35,40,43,83,24,5,29,10,36,32,10,14,102,119
2020,2,22001077,5/16/2021,1610612758,Sacramento Kings,1,0,1610612762,Utah Jazz,0,1,33,27,60,9,21,30,42,48,90,6,4,10,7,42,24,9,13,101,99
2020,2,22001077,5/16/2021,1610612762,Utah Jazz,0,1,1610612758,Sacramento Kings,1,0,23,24,47,18,21,39,41,45,86,21,4,25,12,35,28,10,16,100,121
2023,2,22300202,11/18/2023,1610612766,Charlotte Hornets,1,0,1610612752,New York Knicks,0,1,23,24,47,17,18,35,40,42,82,11,2,13,7,36,29,7,13,96,108
2020,2,22000299,1/30/2021,1610612749,Milwaukee Bucks,0,0,1610612766,Charlotte Hornets,1,1,22,15,37,18,27,45,40,42,82,16,8,24,10,35,22,8,16,99,114
2020,2,22000299,1/30/2021,1610612766,Charlotte Hornets,1,1,1610612749,Milwaukee Bucks,0,0,23,25,48,21,23,44,44,48,92,17,3,20,11,38,32,6,9,99,126
2017,2,21700266,11/22/2017,1610612747,Los Angeles Lakers,0,0,1610612758,Sacramento Kings,1,1,24,25,49,15,14,29,39,39,78,9,6,15,7,36,27,9,17,94,102
2014,2,21400061,11/5/2014,1610612765,Detroit Pistons,1,1,1610612752,New York Knicks,0,0,21,43,64,11,12,23,32,55,87,23,10,33,21,38,17,3,8,91,98
2020,2,22000615,3/16/2021,1610612747,Los Angeles Lakers,1,1,1610612750,Minnesota Timberwolves,0,0,37,24,61,13,13,26,50,37,87,24,4,28,11,28,37,9,14,101,137
2020,2,22000615,3/16/2021,1610612750,Minnesota Timberwolves,0,0,1610612747,Los Angeles Lakers,1,1,36,19,55,11,24,35,47,43,90,16,6,22,11,36,28,3,12,103,121
2022,2,22200992,3/9/2023,1610612766,Charlotte Hornets,0,1,1610612765,Detroit Pistons,1,0,35,27,62,8,16,24,43,43,86,19,13,32,15,34,24,5,13,98,113
2017,2,21700266,11/22/2017,1610612758,Sacramento Kings,1,1,1610612747,Los Angeles Lakers,0,0,37,27,64,10,11,21,47,38,85,9,5,14,14,28,26,8,17,95,113
2016,2,21600809,2/11/2017,1610612754,Indiana Pacers,1,0,1610612749,Milwaukee Bucks,0,1,25,26,51,10,12,22,35,38,73,20,4,24,10,29,19,7,14,89,100
2021,2,22100497,12/26/2021,1610612740,New Orleans Pelicans,0,0,1610612760,Oklahoma City Thunder,1,1,29,24,53,10,31,41,39,55,94,24,4,28,13,44,26,8,11,103,112
2021,2,22100497,12/26/2021,1610612760,Oklahoma City Thunder,1,1,1610612740,New Orleans Pelicans,0,0,28,22,50,13,23,36,41,45,86,22,9,31,9,41,24,10,12,104,117
2020,2,22000298,1/30/2021,1610612741,Chicago Bulls,1,0,1610612757,Portland Trail Blazers,0,1,22,18,40,21,24,45,43,42,85,15,0,15,12,30,31,11,15,93,122
2020,2,22000298,1/30/2021,1610612757,Portland Trail Blazers,0,1,1610612741,Chicago Bulls,1,0,28,18,46,17,25,42,45,43,88,16,3,19,11,34,20,5,8,94,123
2019,2,21900434,12/21/2019,1610612749,Milwaukee Bucks,0,1,1610612752,New York Knicks,1,0,23,19,42,18,25,43,41,44,85,23,12,35,13,38,26,10,19,106,123
2019,2,21900434,12/21/2019,1610612752,New York Knicks,1,0,1610612749,Milwaukee Bucks,0,1,30,37,67,9,21,30,39,58,97,15,6,21,16,46,23,9,15,107,102
2014,2,21401027,3/20/2015,1610612742,Dallas Mavericks,1,0,1610612763,Memphis Grizzlies,0,1,26,28,54,8,14,22,34,42,76,25,11,36,12,34,14,7,17,99,101
2014,2,21401027,3/20/2015,1610612763,Memphis Grizzlies,0,1,1610612742,Dallas Mavericks,1,0,33,26,59,8,10,18,41,36,77,22,10,32,8,34,19,6,17,99,112
2014,2,21400455,12/28/2014,1610612742,Dallas Mavericks,1,1,1610612760,Oklahoma City Thunder,0,0,29,28,57,10,21,31,39,49,88,24,4,28,10,41,26,8,12,103,112
2014,2,21400455,12/28/2014,1610612760,Oklahoma City Thunder,0,0,1610612742,Dallas Mavericks,1,1,40,36,76,5,9,14,45,45,90,12,9,21,15,36,21,8,18,102,107
2018,2,21801103,3/25/2019,1610612753,Orlando Magic,1,1,1610612755,Philadelphia 76ers,0,0,34,24,58,11,18,29,45,42,87,18,5,23,13,33,28,4,7,92,119
2018,2,21801103,3/25/2019,1610612755,Philadelphia 76ers,0,0,1610612753,Orlando Magic,1,1,30,20,50,6,17,23,36,37,73,20,6,26,7,33,20,9,15,93,98
2022,2,22201068,3/19/2023,1610612761,Toronto Raptors,0,0,1610612749,Milwaukee Bucks,1,1,30,35,65,14,20,34,44,55,99,9,3,12,16,40,25,3,7,96,111
2021,2,22100496,12/26/2021,1610612758,Sacramento Kings,1,0,1610612763,Memphis Grizzlies,0,1,24,28,52,10,19,29,34,47,81,24,3,27,12,36,22,11,18,101,102
2021,2,22100496,12/26/2021,1610612763,Memphis Grizzlies,0,1,1610612758,Sacramento Kings,1,0,38,32,70,9,21,30,47,53,100,24,6,30,25,31,33,7,12,99,127
2014,2,21400060,11/5/2014,1610612750,Minnesota Timberwolves,0,1,1610612751,Brooklyn Nets,1,0,30,43,73,7,10,17,37,53,90,17,5,22,19,36,22,6,13,95,98
2019,2,21900433,12/21/2019,1610612755,Philadelphia 76ers,1,1,1610612764,Washington Wizards,0,0,35,26,61,14,19,33,49,45,94,13,8,21,18,32,28,7,14,101,125
2019,2,21900433,12/21/2019,1610612764,Washington Wizards,0,0,1610612755,Philadelphia 76ers,1,1,29,28,57,7,24,31,36,52,88,29,5,34,12,42,18,7,11,101,108
2019,2,21900173,11/15/2019,1610612738,Boston Celtics,0,1,1610612744,Golden State Warriors,1,0,24,34,58,13,20,33,37,54,91,18,5,23,13,46,24,8,14,103,105
2019,2,21900173,11/15/2019,1610612744,Golden State Warriors,1,0,1610612738,Boston Celtics,0,1,29,25,54,5,23,28,34,48,82,27,7,34,17,37,17,13,20,104,100
2020,2,22000614,3/16/2021,1610612740,New Orleans Pelicans,0,0,1610612757,Portland Trail Blazers,1,1,30,25,55,16,17,33,46,42,88,16,4,20,15,30,38,8,16,101,124
2020,2,22000614,3/16/2021,1610612757,Portland Trail Blazers,1,1,1610612740,New Orleans Pelicans,0,0,20,10,30,18,25,43,38,35,73,31,0,31,4,31,20,8,17,100,125
2014,2,21400060,11/5/2014,1610612751,Brooklyn Nets,1,0,1610612750,Minnesota Timberwolves,0,1,28,33,61,8,13,21,36,46,82,11,6,17,12,39,17,9,18,95,91
2017,2,21700265,11/22/2017,1610612741,Chicago Bulls,0,0,1610612762,Utah Jazz,1,1,24,33,57,5,16,21,29,49,78,17,3,20,12,39,15,10,16,92,80
2017,2,21700265,11/22/2017,1610612762,Utah Jazz,1,1,1610612741,Chicago Bulls,0,0,26,25,51,14,21,35,40,46,86,16,3,19,12,35,23,3,7,91,110
2021,2,22100495,12/26/2021,1610612755,Philadelphia 76ers,0,1,1610612764,Washington Wizards,1,0,31,24,55,12,19,31,43,43,86,19,3,22,13,31,25,6,13,93,117
2021,2,22100495,12/26/2021,1610612764,Washington Wizards,1,0,1610612755,Philadelphia 76ers,0,1,27,30,57,8,25,33,35,55,90,18,10,28,17,43,22,6,8,93,96
2022,2,22201051,3/17/2023,1610612740,New Orleans Pelicans,0,0,1610612745,Houston Rockets,1,1,27,27,54,12,16,28,39,43,82,22,3,25,9,37,22,9,9,93,112
2023,2,22300447,12/31/2023,1610612751,Brooklyn Nets,0,0,1610612760,Oklahoma City Thunder,1,1,26,28,54,12,34,46,38,62,100,20,11,31,22,45,26,1,7,101,108
2020,2,22001076,5/16/2021,1610612743,Denver Nuggets,0,0,1610612757,Portland Trail Blazers,1,1,30,31,61,14,23,37,44,54,98,14,1,15,14,41,20,3,6,96,116
2020,2,22001076,5/16/2021,1610612757,Portland Trail Blazers,1,1,1610612743,Denver Nuggets,0,0,28,16,44,18,25,43,46,41,87,22,4,26,15,29,24,8,14,97,132
2020,2,22000613,3/16/2021,1610612737,Atlanta Hawks,0,1,1610612745,Houston Rockets,1,0,27,22,49,17,20,37,44,42,86,14,2,16,15,28,32,6,12,93,119
2020,2,22000297,1/29/2021,1610612742,Dallas Mavericks,0,0,1610612762,Utah Jazz,1,1,28,25,53,9,24,33,37,49,86,18,9,27,12,41,20,8,11,97,101
2014,2,21400059,11/5/2014,1610612738,Boston Celtics,1,0,1610612761,Toronto Raptors,0,1,30,22,52,10,16,26,40,38,78,17,1,18,19,20,22,11,28,94,107
2020,2,22000297,1/29/2021,1610612762,Utah Jazz,1,1,1610612742,Dallas Mavericks,0,0,18,21,39,20,28,48,38,49,87,24,2,26,18,33,21,6,15,96,120
2019,2,21900432,12/21/2019,1610612741,Chicago Bulls,0,1,1610612765,Detroit Pistons,1,0,22,20,42,18,17,35,40,37,77,21,4,25,13,25,21,14,21,97,119
2019,2,21900432,12/21/2019,1610612765,Detroit Pistons,1,0,1610612741,Chicago Bulls,0,1,24,28,52,16,19,35,40,47,87,11,1,12,9,39,30,8,16,98,107
2023,2,22300261,11/29/2023,1610612762,Utah Jazz,0,0,1610612763,Memphis Grizzlies,1,1,18,33,51,16,23,39,34,56,90,7,5,12,19,39,26,9,18,94,91
2022,2,22200592,1/7/2023,1610612741,Chicago Bulls,1,1,1610612762,Utah Jazz,0,0,31,24,55,13,15,28,44,39,83,25,7,32,8,36,22,6,10,99,126
2020,2,22001075,5/16/2021,1610612753,Orlando Magic,0,0,1610612755,Philadelphia 76ers,1,1,26,22,48,10,18,28,36,40,76,35,6,41,11,32,23,8,17,101,117
2020,2,22001075,5/16/2021,1610612755,Philadelphia 76ers,1,1,1610612753,Orlando Magic,0,0,27,27,54,19,21,40,46,48,94,17,6,23,10,41,35,4,12,102,128
2020,2,22000613,3/16/2021,1610612745,Houston Rockets,1,0,1610612737,Atlanta Hawks,0,1,29,25,54,13,21,34,42,46,88,10,3,13,14,32,27,8,13,92,107
2022,2,22200592,1/7/2023,1610612762,Utah Jazz,0,0,1610612741,Chicago Bulls,1,1,34,18,52,12,29,41,46,47,93,14,4,18,11,38,36,4,10,99,118
2016,2,21600317,12/6/2016,1610612741,Chicago Bulls,0,0,1610612765,Detroit Pistons,1,1,31,29,60,2,13,15,33,42,75,23,9,32,11,37,15,10,14,93,91
2016,2,21600317,12/6/2016,1610612765,Detroit Pistons,1,1,1610612741,Chicago Bulls,0,0,32,35,67,8,13,21,40,48,88,14,7,21,13,39,24,6,9,94,102
2014,2,21400059,11/5/2014,1610612761,Toronto Raptors,0,1,1610612738,Boston Celtics,1,0,35,36,71,7,9,16,42,45,87,19,4,23,9,39,18,5,7,94,110
2021,2,22100494,12/26/2021,1610612739,Cleveland Cavaliers,1,1,1610612761,Toronto Raptors,0,0,34,20,54,22,30,52,56,50,106,10,2,12,17,33,39,11,15,108,144
2021,2,22100494,12/26/2021,1610612761,Toronto Raptors,0,0,1610612739,Cleveland Cavaliers,1,1,28,25,53,9,27,36,37,52,89,16,7,23,13,43,24,12,21,108,99
2020,2,22000296,1/29/2021,1610612743,Denver Nuggets,0,0,1610612759,San Antonio Spurs,1,1,27,20,47,14,17,31,41,37,78,13,7,20,8,32,25,8,16,98,109
2020,2,22000296,1/29/2021,1610612759,San Antonio Spurs,1,1,1610612743,Denver Nuggets,0,0,34,24,58,10,13,23,44,37,81,21,5,26,10,30,29,8,13,96,119
2019,2,21900172,11/15/2019,1610612755,Philadelphia 76ers,0,0,1610612760,Oklahoma City Thunder,1,1,31,27,58,14,18,32,45,45,90,15,7,22,17,32,24,7,16,101,119
2019,2,21900172,11/15/2019,1610612760,Oklahoma City Thunder,1,1,1610612755,Philadelphia 76ers,0,0,31,21,52,10,14,24,41,35,76,35,6,41,7,32,22,6,13,102,127
2022,2,22201068,3/19/2023,1610612749,Milwaukee Bucks,1,1,1610612761,Toronto Raptors,0,0,27,10,37,16,29,45,43,39,82,16,5,21,8,32,35,6,12,95,118
2020,2,22000612,3/16/2021,1610612741,Chicago Bulls,1,1,1610612760,Oklahoma City Thunder,0,0,36,22,58,12,24,36,48,46,94,15,3,18,18,30,24,9,12,96,123
2020,2,22000612,3/16/2021,1610612760,Oklahoma City Thunder,0,0,1610612741,Chicago Bulls,1,1,35,35,70,7,13,20,42,48,90,11,2,13,16,33,16,8,17,95,102
2023,2,22300202,11/18/2023,1610612752,New York Knicks,0,1,1610612766,Charlotte Hornets,1,0,30,24,54,16,21,37,46,45,91,14,5,19,15,34,27,5,12,94,122
2023,2,22300607,1/22/2024,1610612753,Orlando Magic,1,0,1610612739,Cleveland Cavaliers,0,1,23,22,45,11,18,29,34,40,74,20,10,30,11,34,25,10,15,93,99
2021,2,22100493,12/26/2021,1610612748,Miami Heat,1,1,1610612753,Orlando Magic,0,0,26,29,55,10,24,34,36,53,89,11,7,18,21,36,28,6,14,90,93
2021,2,22100493,12/26/2021,1610612753,Orlando Magic,0,0,1610612748,Miami Heat,1,1,21,19,40,10,22,32,31,41,72,11,6,17,11,32,17,7,19,89,83
2020,2,22000295,1/29/2021,1610612751,Brooklyn Nets,0,1,1610612760,Oklahoma City Thunder,1,0,38,17,55,19,26,45,57,43,100,14,2,16,11,33,33,4,11,105,147
2020,2,22000295,1/29/2021,1610612760,Oklahoma City Thunder,1,0,1610612751,Brooklyn Nets,0,1,24,24,48,16,22,38,40,46,86,29,5,34,9,41,23,7,12,104,125
2019,2,21900431,12/21/2019,1610612737,Atlanta Hawks,0,0,1610612751,Brooklyn Nets,1,1,28,29,57,11,37,48,39,66,105,23,4,27,17,52,17,8,10,110,112
2019,2,21900431,12/21/2019,1610612751,Brooklyn Nets,1,1,1610612737,Atlanta Hawks,0,0,35,35,70,11,19,30,46,54,100,19,9,28,19,39,23,7,16,110,122
2017,2,21700264,11/22/2017,1610612749,Milwaukee Bucks,0,1,1610612756,Phoenix Suns,1,0,34,34,68,8,21,29,42,55,97,21,10,31,15,44,19,7,15,111,113
2017,2,21700264,11/22/2017,1610612756,Phoenix Suns,1,0,1610612749,Milwaukee Bucks,0,1,30,41,71,7,15,22,37,56,93,26,7,33,27,32,15,16,29,112,107
2020,2,22000611,3/16/2021,1610612752,New York Knicks,0,0,1610612755,Philadelphia 76ers,1,1,29,31,60,8,16,24,37,47,84,14,8,22,12,38,19,8,13,93,96
2020,2,22000611,3/16/2021,1610612755,Philadelphia 76ers,1,1,1610612752,New York Knicks,0,0,26,32,58,11,21,32,37,53,90,14,5,19,16,39,19,7,12,94,99
2014,2,21401026,3/20/2015,1610612737,Atlanta Hawks,0,0,1610612760,Oklahoma City Thunder,1,1,28,25,53,13,16,29,41,41,82,20,5,25,9,34,20,6,11,96,115
2014,2,21401026,3/20/2015,1610612760,Oklahoma City Thunder,1,1,1610612737,Atlanta Hawks,0,0,30,24,54,13,17,30,43,41,84,24,2,26,12,30,26,9,12,96,123
2014,2,21400454,12/28/2014,1610612745,Houston Rockets,0,0,1610612759,San Antonio Spurs,1,1,26,18,44,12,21,33,38,39,77,18,13,31,15,30,20,12,25,102,106
2014,2,21400454,12/28/2014,1610612759,San Antonio Spurs,1,1,1610612745,Houston Rockets,0,0,28,25,53,11,19,30,39,44,83,21,3,24,13,32,22,15,19,101,110
2016,2,21600808,2/11/2017,1610612746,LA Clippers,0,1,1610612766,Charlotte Hornets,1,0,26,25,51,14,20,34,40,45,85,13,7,20,15,33,26,6,14,91,107
2016,2,21600808,2/11/2017,1610612766,Charlotte Hornets,1,0,1610612746,LA Clippers,0,1,24,24,48,13,24,37,37,48,85,15,5,20,10,41,24,3,8,92,102
2022,2,22200648,1/15/2023,1610612752,New York Knicks,0,1,1610612765,Detroit Pistons,1,0,28,30,58,12,18,30,40,48,88,25,6,31,19,32,17,4,8,91,117
2022,2,22200648,1/15/2023,1610612765,Detroit Pistons,1,0,1610612752,New York Knicks,0,1,19,20,39,18,26,44,37,46,83,12,3,15,11,37,23,3,12,91,104
2023,2,22300085,10/27/2023,1610612746,LA Clippers,0,0,1610612762,Utah Jazz,1,1,27,15,42,14,21,35,41,36,77,22,6,28,8,31,17,7,16,99,118
2020,2,22000610,3/16/2021,1610612739,Cleveland Cavaliers,0,0,1610612748,Miami Heat,1,1,29,22,51,10,25,35,39,47,86,10,4,14,15,34,23,11,14,91,98
2023,2,22300040,11/21/2023,1610612739,Cleveland Cavaliers,0,1,1610612755,Philadelphia 76ers,1,0,37,32,69,9,16,25,46,48,94,21,4,25,16,34,33,12,16,106,122
2020,2,22000610,3/16/2021,1610612748,Miami Heat,1,1,1610612739,Cleveland Cavaliers,0,0,32,26,58,10,17,27,42,43,85,19,2,21,17,27,30,7,15,90,113
2021,2,22100492,12/25/2021,1610612742,Dallas Mavericks,0,0,1610612762,Utah Jazz,1,1,28,31,59,10,20,30,38,51,89,30,5,35,14,38,19,9,14,103,116
2021,2,22100492,12/25/2021,1610612762,Utah Jazz,1,1,1610612742,Dallas Mavericks,0,0,28,26,54,12,24,36,40,50,90,28,9,37,18,38,24,7,14,102,120
2014,2,21400058,11/5/2014,1610612753,Orlando Magic,0,1,1610612755,Philadelphia 76ers,1,0,36,32,68,3,17,20,39,49,88,10,2,12,17,34,14,12,24,101,91
2014,2,21400058,11/5/2014,1610612755,Philadelphia 76ers,1,0,1610612753,Orlando Magic,0,1,25,27,52,8,17,25,33,44,77,15,8,23,9,39,22,11,20,100,89
2020,2,22000294,1/29/2021,1610612750,Minnesota Timberwolves,1,0,1610612755,Philadelphia 76ers,0,1,25,24,49,10,23,33,35,47,82,14,4,18,6,43,20,11,18,101,94
2020,2,22000294,1/29/2021,1610612755,Philadelphia 76ers,0,1,1610612750,Minnesota Timberwolves,1,0,31,40,71,8,8,16,39,48,87,32,6,38,14,37,20,3,10,100,118
2019,2,21900430,12/21/2019,1610612762,Utah Jazz,0,1,1610612766,Charlotte Hornets,1,0,22,19,41,17,17,34,39,36,75,19,1,20,11,26,27,13,21,96,114
2020,2,22001074,5/16/2021,1610612746,LA Clippers,0,0,1610612760,Oklahoma City Thunder,1,1,35,28,63,10,33,43,45,61,106,12,3,15,19,43,17,1,3,99,112
2020,2,22001074,5/16/2021,1610612760,Oklahoma City Thunder,1,1,1610612746,LA Clippers,0,0,42,26,68,8,18,26,50,44,94,9,7,16,17,31,20,8,15,98,117
2017,2,21700263,11/22/2017,1610612744,Golden State Warriors,0,0,1610612760,Oklahoma City Thunder,1,1,23,26,49,10,21,31,33,47,80,15,3,18,10,38,22,15,22,103,91
2017,2,21700263,11/22/2017,1610612760,Oklahoma City Thunder,1,1,1610612744,Golden State Warriors,0,0,33,32,65,8,17,25,41,49,90,18,8,26,17,35,16,11,17,103,108
2014,2,21400057,11/5/2014,1610612748,Miami Heat,0,0,1610612766,Charlotte Hornets,1,1,26,29,55,4,18,22,30,47,77,25,6,31,9,41,19,4,8,91,89
2023,2,22300040,11/21/2023,1610612755,Philadelphia 76ers,1,0,1610612739,Cleveland Cavaliers,0,1,29,32,61,11,24,35,40,56,96,28,6,34,17,43,19,9,14,107,119
2021,2,22100491,12/25/2021,1610612747,Los Angeles Lakers,1,0,1610612751,Brooklyn Nets,0,1,30,31,61,10,25,35,40,56,96,25,3,28,22,36,29,6,14,101,115
2021,2,22100491,12/25/2021,1610612751,Brooklyn Nets,0,1,1610612747,Los Angeles Lakers,1,0,29,28,57,14,18,32,43,46,89,22,5,27,11,38,31,8,12,101,122
2023,2,22300374,12/21/2023,1610612762,Utah Jazz,0,1,1610612765,Detroit Pistons,1,0,32,32,64,11,19,30,43,51,94,22,2,24,18,34,26,6,13,100,119
2020,2,22000293,1/29/2021,1610612740,New Orleans Pelicans,1,1,1610612749,Milwaukee Bucks,0,0,24,24,48,21,27,48,45,51,96,20,8,28,15,39,32,5,9,103,131
2020,2,22000293,1/29/2021,1610612749,Milwaukee Bucks,0,0,1610612740,New Orleans Pelicans,1,1,35,26,61,13,22,35,48,48,96,17,5,22,14,36,29,7,12,102,126
2019,2,21900430,12/21/2019,1610612766,Charlotte Hornets,1,0,1610612762,Utah Jazz,0,1,27,29,56,12,17,29,39,46,85,17,5,22,13,36,20,7,14,97,107
2019,2,21900171,11/15/2019,1610612750,Minnesota Timberwolves,1,0,1610612764,Washington Wizards,0,1,31,21,52,11,26,37,42,47,89,21,8,29,12,39,26,10,20,111,116
2019,2,21900171,11/15/2019,1610612764,Washington Wizards,0,1,1610612750,Minnesota Timberwolves,1,0,44,28,72,10,18,28,54,46,100,19,6,25,15,35,38,6,14,112,137
2014,2,21400057,11/5/2014,1610612766,Charlotte Hornets,1,1,1610612748,Miami Heat,0,0,30,34,64,5,13,18,35,47,82,21,8,29,19,32,23,6,13,91,96
2016,2,21600316,12/6/2016,1610612748,Miami Heat,1,0,1610612752,New York Knicks,0,1,27,37,64,11,14,25,38,51,89,16,11,27,18,41,21,6,10,93,103
2016,2,21600316,12/6/2016,1610612752,New York Knicks,0,1,1610612748,Miami Heat,1,0,41,32,73,7,18,25,48,50,98,11,5,16,22,31,22,8,11,94,114
2020,2,22000609,3/16/2021,1610612738,Boston Celtics,1,0,1610612762,Utah Jazz,0,1,38,31,69,10,19,29,48,50,98,3,1,4,19,32,28,6,14,93,109
2020,2,22000609,3/16/2021,1610612762,Utah Jazz,0,1,1610612738,Boston Celtics,1,0,19,18,37,19,24,43,38,42,80,22,2,24,14,29,23,8,17,94,117
2014,2,21400056,11/4/2014,1610612747,Los Angeles Lakers,1,0,1610612756,Phoenix Suns,0,1,29,42,71,6,9,15,35,51,86,28,11,39,18,39,16,6,12,98,104
2017,2,21700262,11/22/2017,1610612740,New Orleans Pelicans,1,1,1610612759,San Antonio Spurs,0,0,32,25,57,7,17,24,39,42,81,22,2,24,11,32,23,10,16,96,107
2017,2,21700262,11/22/2017,1610612759,San Antonio Spurs,0,0,1610612740,New Orleans Pelicans,1,1,29,35,64,6,18,24,35,53,88,14,1,15,12,42,22,7,16,97,90
2016,2,21600807,2/10/2017,1610612741,Chicago Bulls,0,0,1610612756,Phoenix Suns,1,1,32,35,67,5,14,19,37,49,86,18,4,22,16,34,20,4,11,91,97
2016,2,21600807,2/10/2017,1610612756,Phoenix Suns,1,1,1610612741,Chicago Bulls,0,0,40,36,76,8,11,19,48,47,95,11,2,13,18,31,25,7,9,92,115
2016,2,21600315,12/6/2016,1610612753,Orlando Magic,0,1,1610612764,Washington Wizards,1,0,31,26,57,12,14,26,43,40,83,26,10,36,12,32,24,5,13,101,124
2016,2,21600315,12/6/2016,1610612764,Washington Wizards,1,0,1610612753,Orlando Magic,0,1,33,37,70,11,12,23,44,49,93,17,7,24,16,37,20,7,12,101,116
2018,2,21800839,2/11/2019,1610612739,Cleveland Cavaliers,1,1,1610612752,New York Knicks,0,0,24,27,51,14,30,44,38,57,95,17,2,19,21,37,20,8,18,100,107
2018,2,21800839,2/11/2019,1610612752,New York Knicks,0,0,1610612739,Cleveland Cavaliers,1,1,35,31,66,7,19,26,42,50,92,13,7,20,12,42,21,6,10,100,104
2017,2,21700261,11/22/2017,1610612750,Minnesota Timberwolves,1,1,1610612753,Orlando Magic,0,0,32,32,64,8,15,23,40,47,87,36,9,45,12,39,22,4,8,104,124
2017,2,21700261,11/22/2017,1610612753,Orlando Magic,0,0,1610612750,Minnesota Timberwolves,1,1,34,20,54,12,25,37,46,45,91,14,8,22,13,35,28,9,15,105,118
2021,2,22100490,12/25/2021,1610612744,Golden State Warriors,0,1,1610612756,Phoenix Suns,1,0,28,20,48,14,23,37,42,43,85,18,3,21,14,31,28,5,11,94,116
2021,2,22100490,12/25/2021,1610612756,Phoenix Suns,1,0,1610612744,Golden State Warriors,0,1,29,24,53,11,19,30,40,43,83,16,0,16,11,32,20,11,13,94,107
2014,2,21401025,3/20/2015,1610612741,Chicago Bulls,1,1,1610612761,Toronto Raptors,0,0,33,18,51,9,19,28,42,37,79,15,2,17,15,24,32,6,12,83,108
2014,2,21401025,3/20/2015,1610612761,Toronto Raptors,0,0,1610612741,Chicago Bulls,1,1,20,34,54,10,15,25,30,49,79,22,4,26,16,36,20,4,7,83,92
2020,2,22001073,5/16/2021,1610612738,Boston Celtics,0,0,1610612752,New York Knicks,1,1,24,21,45,11,30,41,35,51,86,11,4,15,14,39,19,7,12,93,92
2020,2,22001073,5/16/2021,1610612752,New York Knicks,1,1,1610612738,Boston Celtics,0,0,21,31,52,13,14,27,34,45,79,15,4,19,7,39,16,4,11,91,96
2020,2,22000608,3/15/2021,1610612744,Golden State Warriors,1,0,1610612747,Los Angeles Lakers,0,1,21,21,42,13,24,37,34,45,79,16,8,24,10,41,24,9,22,102,97
2022,2,22201051,3/17/2023,1610612745,Houston Rockets,1,1,1610612740,New Orleans Pelicans,0,0,32,24,56,11,21,32,43,45,88,17,7,24,18,30,20,8,13,95,114
2020,2,22000608,3/15/2021,1610612747,Los Angeles Lakers,0,1,1610612744,Golden State Warriors,1,0,38,13,51,11,16,27,49,29,78,19,6,25,9,22,36,9,19,101,128
2023,2,22300244,11/25/2023,1610612746,LA Clippers,1,1,1610612742,Dallas Mavericks,0,0,30,29,59,8,21,29,38,50,88,23,8,31,25,29,25,6,13,92,107
2023,2,22300244,11/25/2023,1610612742,Dallas Mavericks,0,0,1610612746,LA Clippers,1,1,25,28,53,9,29,38,34,57,91,11,3,14,15,44,17,2,9,93,88
2023,2,22300264,11/29/2023,1610612746,LA Clippers,0,1,1610612758,Sacramento Kings,1,0,36,29,65,14,14,28,50,43,93,17,5,22,11,35,28,1,7,98,131
2014,2,21400056,11/4/2014,1610612756,Phoenix Suns,0,1,1610612747,Los Angeles Lakers,1,0,35,38,73,6,12,18,41,50,91,23,6,29,20,33,28,7,13,99,111
2021,2,22100489,12/25/2021,1610612738,Boston Celtics,0,0,1610612749,Milwaukee Bucks,1,1,21,23,44,17,28,45,38,51,89,20,4,24,15,37,24,6,13,98,113
2021,2,22100489,12/25/2021,1610612749,Milwaukee Bucks,1,1,1610612738,Boston Celtics,0,0,31,27,58,12,21,33,43,48,91,19,8,27,17,35,24,10,14,98,117
2020,2,22000292,1/29/2021,1610612758,Sacramento Kings,0,1,1610612761,Toronto Raptors,1,0,27,15,42,16,20,36,43,35,78,24,7,31,13,26,31,14,22,100,126
2020,2,22000292,1/29/2021,1610612761,Toronto Raptors,1,0,1610612758,Sacramento Kings,0,1,29,25,54,13,19,32,42,44,86,27,6,33,17,30,20,7,15,101,124
2017,2,21700260,11/22/2017,1610612742,Dallas Mavericks,0,1,1610612763,Memphis Grizzlies,1,0,30,33,63,9,19,28,39,52,91,8,8,16,7,50,23,7,8,99,95
2020,2,22000607,3/15/2021,1610612756,Phoenix Suns,1,1,1610612763,Memphis Grizzlies,0,0,35,18,53,12,18,30,47,36,83,16,2,18,8,29,28,11,15,97,122
2020,2,22000607,3/15/2021,1610612763,Memphis Grizzlies,0,0,1610612756,Phoenix Suns,1,1,33,31,64,5,18,23,38,49,87,18,8,26,13,40,15,7,11,97,99
2017,2,21700260,11/22/2017,1610612763,Memphis Grizzlies,1,0,1610612742,Dallas Mavericks,0,1,30,22,52,7,22,29,37,44,81,13,1,14,7,38,25,9,17,98,94
2016,2,21600314,12/5/2016,1610612744,Golden State Warriors,1,1,1610612754,Indiana Pacers,0,0,40,27,67,14,23,37,54,50,104,20,6,26,23,32,45,10,11,105,142
2016,2,21600314,12/5/2016,1610612754,Indiana Pacers,0,0,1610612744,Golden State Warriors,1,1,32,38,70,3,12,15,35,50,85,33,2,35,11,39,20,12,14,105,106
2021,2,22100488,12/25/2021,1610612737,Atlanta Hawks,0,0,1610612752,New York Knicks,1,1,20,29,49,13,25,38,33,54,87,8,6,14,13,43,23,6,12,92,87
2021,2,22100488,12/25/2021,1610612752,New York Knicks,1,1,1610612737,Atlanta Hawks,0,0,18,17,35,20,30,50,38,47,85,5,7,12,11,40,28,8,10,91,101
2020,2,22000291,1/29/2021,1610612739,Cleveland Cavaliers,0,0,1610612752,New York Knicks,1,1,21,37,58,8,18,26,29,55,84,15,3,18,18,38,15,8,14,90,81
2020,2,22000291,1/29/2021,1610612752,New York Knicks,1,1,1610612739,Cleveland Cavaliers,0,0,29,24,53,10,17,27,39,41,80,14,2,16,11,32,20,8,14,89,102
2019,2,21900429,12/20/2019,1610612740,New Orleans Pelicans,0,0,1610612744,Golden State Warriors,1,1,30,29,59,9,25,34,39,54,93,15,8,23,17,39,23,10,18,104,102
2019,2,21900429,12/20/2019,1610612744,Golden State Warriors,1,1,1610612740,New Orleans Pelicans,0,0,26,24,50,10,23,33,36,47,83,24,1,25,11,37,25,8,18,102,106
2020,2,22001072,5/16/2021,1610612740,New Orleans Pelicans,1,0,1610612747,Los Angeles Lakers,0,1,28,25,53,9,16,25,37,41,78,15,6,21,9,34,26,14,21,99,98
2020,2,22001072,5/16/2021,1610612747,Los Angeles Lakers,0,1,1610612740,New Orleans Pelicans,1,0,34,27,61,11,24,35,45,51,96,9,6,15,15,39,30,4,10,100,110
2020,2,22000606,3/15/2021,1610612743,Denver Nuggets,1,1,1610612754,Indiana Pacers,0,0,30,39,69,15,13,28,45,52,97,16,3,19,23,30,32,8,10,93,121
2023,2,22300447,12/31/2023,1610612760,Oklahoma City Thunder,1,1,1610612751,Brooklyn Nets,0,0,27,23,50,18,15,33,45,38,83,16,4,20,6,35,31,9,15,101,124
2020,2,22000606,3/15/2021,1610612754,Indiana Pacers,0,0,1610612743,Denver Nuggets,1,1,22,26,48,17,25,42,39,51,90,11,2,13,13,39,28,7,12,94,106
2021,2,22100487,12/23/2021,1610612747,Los Angeles Lakers,1,0,1610612759,San Antonio Spurs,0,1,39,28,67,5,22,27,44,50,94,17,13,30,18,40,21,7,14,105,110
2021,2,22100487,12/23/2021,1610612759,San Antonio Spurs,0,1,1610612747,Los Angeles Lakers,1,0,28,28,56,18,21,39,46,49,95,28,5,33,12,39,33,4,6,104,138
2020,2,22000290,1/29/2021,1610612737,Atlanta Hawks,0,1,1610612764,Washington Wizards,1,0,27,23,50,12,25,37,39,48,87,26,8,34,13,37,16,6,13,102,116
2020,2,22000290,1/29/2021,1610612764,Washington Wizards,1,0,1610612737,Atlanta Hawks,0,1,24,33,57,7,21,28,31,54,85,31,7,38,16,40,13,5,13,100,100
2019,2,21900428,12/20/2019,1610612753,Orlando Magic,0,0,1610612757,Portland Trail Blazers,1,1,32,46,78,7,21,28,39,67,106,18,8,26,26,44,21,4,10,101,103
2019,2,21900428,12/20/2019,1610612757,Portland Trail Blazers,1,1,1610612753,Orlando Magic,0,0,25,23,48,17,19,36,42,42,84,17,2,19,13,30,16,14,21,102,118
2014,2,21400055,11/4/2014,1610612739,Cleveland Cavaliers,0,0,1610612757,Portland Trail Blazers,1,1,22,42,64,9,12,21,31,54,85,11,3,14,16,39,18,7,14,89,82
2014,2,21400055,11/4/2014,1610612757,Portland Trail Blazers,1,1,1610612739,Cleveland Cavaliers,0,0,29,21,50,8,17,25,37,38,75,19,6,25,12,30,21,5,12,88,101
2020,2,22001071,5/16/2021,1610612742,Dallas Mavericks,0,0,1610612750,Minnesota Timberwolves,1,1,28,25,53,16,22,38,44,47,91,17,3,20,17,31,32,11,16,98,121
2020,2,22001071,5/16/2021,1610612750,Minnesota Timberwolves,1,1,1610612742,Dallas Mavericks,0,0,32,18,50,17,23,40,49,41,90,21,4,25,14,29,35,5,10,97,136
2020,2,22000605,3/15/2021,1610612742,Dallas Mavericks,1,0,1610612746,LA Clippers,0,1,22,16,38,17,24,41,39,40,79,4,1,5,4,37,24,10,15,91,99
2020,2,22000605,3/15/2021,1610612746,LA Clippers,0,1,1610612742,Dallas Mavericks,1,0,29,25,54,14,18,32,43,43,86,9,2,11,11,33,23,8,9,92,109
2016,2,21600806,2/10/2017,1610612737,Atlanta Hawks,0,0,1610612758,Sacramento Kings,1,1,25,16,41,11,19,30,36,35,71,24,7,31,5,33,19,12,17,99,107
2016,2,21600806,2/10/2017,1610612758,Sacramento Kings,1,1,1610612737,Atlanta Hawks,0,0,20,24,44,18,18,36,38,42,80,14,7,21,11,36,27,6,18,98,108
2020,2,22000289,1/29/2021,1610612746,LA Clippers,0,1,1610612753,Orlando Magic,1,0,33,24,57,13,24,37,46,48,94,11,0,11,10,38,25,6,11,98,116
2020,2,22000289,1/29/2021,1610612753,Orlando Magic,1,0,1610612746,LA Clippers,0,1,22,34,56,10,23,33,32,57,89,16,2,18,16,41,20,8,17,97,90
2017,2,21700259,11/22/2017,1610612743,Denver Nuggets,0,0,1610612745,Houston Rockets,1,1,25,29,54,10,23,33,35,52,87,15,8,23,18,39,19,13,21,101,95
2017,2,21700259,11/22/2017,1610612745,Houston Rockets,1,1,1610612743,Denver Nuggets,0,0,27,14,41,18,23,41,45,37,82,17,6,23,9,31,30,11,18,101,125
2014,2,21400054,11/4/2014,1610612740,New Orleans Pelicans,1,1,1610612766,Charlotte Hornets,0,0,33,30,63,5,13,18,38,43,81,19,0,19,12,31,26,6,13,91,100
2014,2,21400054,11/4/2014,1610612766,Charlotte Hornets,0,0,1610612740,New Orleans Pelicans,1,1,31,28,59,6,15,21,37,43,80,11,2,13,6,37,23,5,12,92,91
2016,2,21600313,12/5/2016,1610612747,Los Angeles Lakers,1,0,1610612762,Utah Jazz,0,1,34,39,73,5,9,14,39,48,87,18,5,23,18,31,15,5,11,91,101
2016,2,21600313,12/5/2016,1610612762,Utah Jazz,0,1,1610612747,Los Angeles Lakers,1,0,25,23,48,13,19,32,38,42,80,18,11,29,15,31,26,8,12,91,107
2014,2,21400453,12/28/2014,1610612739,Cleveland Cavaliers,1,0,1610612765,Detroit Pistons,0,1,26,27,53,5,24,29,31,51,82,13,4,17,17,35,25,12,18,92,80
2014,2,21400453,12/28/2014,1610612765,Detroit Pistons,0,1,1610612739,Cleveland Cavaliers,1,0,24,36,60,17,14,31,41,50,91,4,5,9,17,37,21,4,11,91,103
2021,2,22100486,1/10/2022,1610612751,Brooklyn Nets,0,0,1610612757,Portland Trail Blazers,1,1,30,29,59,12,20,32,42,49,91,12,3,15,15,36,23,8,15,97,108
2021,2,22100486,1/10/2022,1610612757,Portland Trail Blazers,1,1,1610612751,Brooklyn Nets,0,0,25,23,48,15,23,38,40,46,86,19,7,26,17,32,23,9,15,99,114
2020,2,22000288,1/29/2021,1610612754,Indiana Pacers,0,0,1610612766,Charlotte Hornets,1,1,31,21,52,11,24,35,42,45,87,10,3,13,12,35,30,7,16,98,105
2020,2,22000288,1/29/2021,1610612766,Charlotte Hornets,1,1,1610612754,Indiana Pacers,0,0,27,21,48,16,21,37,43,42,85,6,3,9,9,34,35,7,17,97,108
2019,2,21900427,12/20/2019,1610612743,Denver Nuggets,1,1,1610612750,Minnesota Timberwolves,0,0,34,27,61,10,18,28,44,45,89,11,1,12,15,31,27,8,16,96,109
2019,2,21900427,12/20/2019,1610612750,Minnesota Timberwolves,0,0,1610612743,Denver Nuggets,1,1,26,19,45,10,32,42,36,51,87,18,9,27,18,37,20,9,14,97,100
2019,2,21900170,11/15/2019,1610612762,Utah Jazz,0,0,1610612763,Memphis Grizzlies,1,1,26,27,53,9,25,34,35,52,87,27,5,32,14,38,17,6,15,102,106
2019,2,21900170,11/15/2019,1610612763,Memphis Grizzlies,1,1,1610612762,Utah Jazz,0,0,33,28,61,10,25,35,43,53,96,11,2,13,12,42,25,5,11,102,107
2020,2,22001070,5/16/2021,1610612744,Golden State Warriors,1,1,1610612763,Memphis Grizzlies,0,0,26,18,44,15,24,39,41,42,83,16,2,18,14,28,26,12,20,99,113
2020,2,22001070,5/16/2021,1610612763,Memphis Grizzlies,0,0,1610612744,Golden State Warriors,1,1,34,33,67,6,19,25,40,52,92,15,4,19,17,36,25,9,13,98,101
2020,2,22000604,3/15/2021,1610612751,Brooklyn Nets,1,1,1610612752,New York Knicks,0,0,32,15,47,12,17,29,44,32,76,17,5,22,6,28,29,9,15,96,117
2020,2,22000604,3/15/2021,1610612752,New York Knicks,0,0,1610612751,Brooklyn Nets,1,1,22,28,50,15,27,42,37,55,92,23,4,27,17,39,16,3,9,96,112
2022,2,22200997,3/9/2023,1610612758,Sacramento Kings,1,1,1610612752,New York Knicks,0,0,34,18,52,10,22,32,44,40,84,24,8,32,7,38,28,8,12,104,122
2014,2,21400452,12/27/2014,1610612744,Golden State Warriors,1,1,1610612750,Minnesota Timberwolves,0,0,30,30,60,11,17,28,41,47,88,17,4,21,11,36,32,10,16,105,110
2014,2,21400452,12/27/2014,1610612750,Minnesota Timberwolves,0,0,1610612744,Golden State Warriors,1,1,26,32,58,8,11,19,34,43,77,21,15,36,14,36,29,17,25,105,97
2023,2,22300240,11/25/2023,1610612748,Miami Heat,0,0,1610612751,Brooklyn Nets,1,1,27,26,53,11,23,34,38,49,87,10,3,13,17,34,24,11,18,94,97
2021,2,22100485,12/23/2021,1610612744,Golden State Warriors,1,1,1610612763,Memphis Grizzlies,0,0,21,21,42,19,21,40,40,42,82,14,4,18,14,30,30,10,19,98,113
2021,2,22100485,12/23/2021,1610612763,Memphis Grizzlies,0,0,1610612744,Golden State Warriors,1,1,30,34,64,8,18,26,38,52,90,20,4,24,18,36,18,9,13,97,104
2017,2,21700258,11/22/2017,1610612752,New York Knicks,1,1,1610612761,Toronto Raptors,0,0,35,34,69,8,16,24,43,50,93,14,2,16,20,31,29,4,12,94,108
2017,2,21700258,11/22/2017,1610612761,Toronto Raptors,0,0,1610612752,New York Knicks,1,1,23,26,49,14,24,38,37,50,87,12,6,18,17,36,21,8,15,95,100
2016,2,21600805,2/10/2017,1610612754,Indiana Pacers,0,0,1610612764,Washington Wizards,1,1,41,30,71,4,17,21,45,47,92,13,2,15,15,33,29,8,11,98,107
2016,2,21600805,2/10/2017,1610612764,Washington Wizards,1,1,1610612754,Indiana Pacers,0,0,31,28,59,10,19,29,41,47,88,20,10,30,16,37,29,3,11,96,112
2023,2,22300360,12/19/2023,1610612763,Memphis Grizzlies,0,1,1610612740,New Orleans Pelicans,1,0,31,20,51,10,21,31,41,41,82,23,6,29,17,28,19,4,18,97,115
2020,2,22000603,3/15/2021,1610612749,Milwaukee Bucks,0,1,1610612764,Washington Wizards,1,0,41,25,66,11,17,28,52,42,94,18,1,19,10,32,29,5,16,109,133
2020,2,22000603,3/15/2021,1610612764,Washington Wizards,1,0,1610612749,Milwaukee Bucks,0,1,28,21,49,16,22,38,44,43,87,18,6,24,4,41,34,6,14,109,122
2020,2,22000287,1/28/2021,1610612745,Houston Rockets,1,1,1610612757,Portland Trail Blazers,0,0,25,18,43,13,34,47,38,52,90,15,3,18,13,41,19,6,14,99,104
2020,2,22000287,1/28/2021,1610612757,Portland Trail Blazers,0,0,1610612745,Houston Rockets,1,1,22,30,52,17,24,41,39,54,93,6,2,8,15,40,16,8,15,99,101
2019,2,21900426,12/20/2019,1610612756,Phoenix Suns,0,0,1610612760,Oklahoma City Thunder,1,1,27,28,55,11,21,32,38,49,87,21,2,23,17,33,26,7,16,98,108
2019,2,21900426,12/20/2019,1610612760,Oklahoma City Thunder,1,1,1610612756,Phoenix Suns,0,0,39,24,63,10,14,24,49,38,87,18,3,21,14,27,23,9,15,99,126
2017,2,21700257,11/22/2017,1610612738,Boston Celtics,0,0,1610612748,Miami Heat,1,1,26,32,58,9,17,26,35,49,84,19,8,27,12,42,19,3,12,96,98
2017,2,21700257,11/22/2017,1610612748,Miami Heat,1,1,1610612738,Boston Celtics,0,0,30,23,53,10,18,28,40,41,81,14,2,16,9,33,20,11,15,95,104
2022,2,22200997,3/9/2023,1610612752,New York Knicks,0,0,1610612758,Sacramento Kings,1,1,29,22,51,13,37,50,42,59,101,20,11,31,26,40,27,10,14,104,117
2020,2,22001069,5/16/2021,1610612748,Miami Heat,0,1,1610612765,Detroit Pistons,1,0,34,16,50,13,21,34,47,37,84,13,7,20,9,30,32,4,12,97,120
2020,2,22001069,5/16/2021,1610612765,Detroit Pistons,1,0,1610612748,Miami Heat,0,1,29,22,51,11,24,35,40,46,86,16,6,22,12,37,26,11,16,97,107
2020,2,22000602,3/15/2021,1610612758,Sacramento Kings,0,0,1610612766,Charlotte Hornets,1,1,39,16,55,9,22,31,48,38,86,11,6,17,5,37,28,7,12,101,116
2023,2,22300061,10/24/2023,1610612743,Denver Nuggets,1,1,1610612747,Los Angeles Lakers,0,0,34,23,57,14,20,34,48,43,91,9,3,12,13,32,29,5,12,94,119
2020,2,22000602,3/15/2021,1610612766,Charlotte Hornets,1,1,1610612758,Sacramento Kings,0,0,33,31,64,12,18,30,45,49,94,20,5,25,12,40,30,7,9,102,122
2016,2,21600312,12/5/2016,1610612742,Dallas Mavericks,1,0,1610612766,Charlotte Hornets,0,1,24,29,53,13,23,36,37,52,89,14,4,18,11,45,23,2,7,94,101
2016,2,21600312,12/5/2016,1610612766,Charlotte Hornets,0,1,1610612742,Dallas Mavericks,1,0,37,24,61,3,15,18,40,39,79,26,2,28,10,29,21,4,12,92,109
2023,2,22300240,11/25/2023,1610612751,Brooklyn Nets,1,1,1610612748,Miami Heat,0,0,25,17,42,14,22,36,39,39,78,20,3,23,8,32,27,6,13,94,112
2023,2,22300309,12/12/2023,1610612746,LA Clippers,1,1,1610612758,Sacramento Kings,0,0,33,22,55,11,18,29,44,40,84,20,1,21,9,32,21,9,18,99,119
2023,2,22300773,2/13/2024,1610612749,Milwaukee Bucks,1,0,1610612748,Miami Heat,0,1,24,20,44,13,26,39,37,46,83,10,1,11,6,40,24,10,18,100,97
2023,2,22300346,12/17/2023,1610612749,Milwaukee Bucks,1,1,1610612745,Houston Rockets,0,0,32,22,54,13,23,36,45,45,90,25,7,32,21,28,25,8,17,97,128
2022,2,22201052,3/17/2023,1610612759,San Antonio Spurs,1,0,1610612763,Memphis Grizzlies,0,1,19,27,46,20,32,52,39,59,98,22,7,29,22,39,31,13,20,111,120
2021,2,22100484,12/23/2021,1610612750,Minnesota Timberwolves,0,0,1610612762,Utah Jazz,1,1,28,28,56,17,28,45,45,56,101,9,3,12,19,37,29,7,14,101,116
2021,2,22100484,12/23/2021,1610612762,Utah Jazz,1,1,1610612750,Minnesota Timberwolves,0,0,32,19,51,16,23,39,48,42,90,16,6,22,16,29,31,7,15,102,128
2023,2,22300061,10/24/2023,1610612747,Los Angeles Lakers,0,0,1610612743,Denver Nuggets,1,1,31,30,61,10,19,29,41,49,90,15,5,20,18,34,23,9,12,94,107
2017,2,21700256,11/22/2017,1610612737,Atlanta Hawks,1,0,1610612746,LA Clippers,0,1,30,24,54,10,19,29,40,43,83,13,2,15,14,30,26,7,15,93,103
2020,2,22001068,5/16/2021,1610612741,Chicago Bulls,1,1,1610612749,Milwaukee Bucks,0,0,31,24,55,14,18,32,45,42,87,14,5,19,11,33,23,13,16,102,118
2020,2,22001068,5/16/2021,1610612749,Milwaukee Bucks,0,0,1610612741,Chicago Bulls,1,1,26,27,53,12,25,37,38,52,90,24,8,32,14,40,14,8,12,102,112
2020,2,22000601,3/14/2021,1610612740,New Orleans Pelicans,1,1,1610612746,LA Clippers,0,0,41,14,55,12,14,26,53,28,81,17,4,21,6,24,38,12,19,101,135
2020,2,22000601,3/14/2021,1610612746,LA Clippers,0,0,1610612740,New Orleans Pelicans,1,1,27,22,49,15,28,43,42,50,92,16,3,19,12,39,23,8,12,102,115
2023,2,22300500,1/7/2024,1610612740,New Orleans Pelicans,0,1,1610612758,Sacramento Kings,1,0,31,16,47,19,16,35,50,32,82,14,2,16,13,19,35,9,16,95,133
2021,2,22100483,12/23/2021,1610612756,Phoenix Suns,1,1,1610612760,Oklahoma City Thunder,0,0,30,24,54,15,24,39,45,48,93,8,5,13,12,37,26,6,14,100,113
2021,2,22100483,12/23/2021,1610612760,Oklahoma City Thunder,0,0,1610612756,Phoenix Suns,1,1,26,29,55,11,30,41,37,59,96,16,5,21,18,43,17,9,13,100,101
2020,2,22000286,1/28/2021,1610612744,Golden State Warriors,0,0,1610612756,Phoenix Suns,1,1,27,34,61,11,27,38,38,61,99,6,2,8,13,49,21,7,13,103,93
2020,2,22000286,1/28/2021,1610612756,Phoenix Suns,1,1,1610612744,Golden State Warriors,0,0,30,26,56,11,21,32,41,47,88,21,2,23,10,39,34,8,14,101,114
2017,2,21700256,11/22/2017,1610612746,LA Clippers,0,1,1610612737,Atlanta Hawks,1,0,29,17,46,15,15,30,44,32,76,13,6,19,9,27,30,10,17,92,116
2014,2,21400053,11/4/2014,1610612741,Chicago Bulls,1,1,1610612753,Orlando Magic,0,0,28,32,60,7,8,15,35,40,75,21,6,27,10,35,23,6,12,89,98
2014,2,21400053,11/4/2014,1610612753,Orlando Magic,0,0,1610612741,Chicago Bulls,1,1,32,42,74,6,8,14,38,50,88,8,6,14,17,39,21,6,13,90,90
2020,2,22001067,5/16/2021,1610612739,Cleveland Cavaliers,0,0,1610612751,Brooklyn Nets,1,1,26,20,46,12,27,39,38,47,85,21,10,31,17,36,16,9,16,98,109
2020,2,22001067,5/16/2021,1610612751,Brooklyn Nets,1,1,1610612739,Cleveland Cavaliers,0,0,31,22,53,16,14,30,47,36,83,13,4,17,5,34,35,8,12,97,123
2020,2,22000600,3/14/2021,1610612741,Chicago Bulls,1,1,1610612761,Toronto Raptors,0,0,32,21,53,12,32,44,44,53,97,18,5,23,17,37,35,5,12,103,118
2020,2,22000600,3/14/2021,1610612761,Toronto Raptors,0,0,1610612741,Chicago Bulls,1,1,22,23,45,12,33,45,34,56,90,15,6,21,11,46,23,6,12,103,95
2014,2,21401024,3/20/2015,1610612743,Denver Nuggets,0,0,1610612748,Miami Heat,1,1,30,22,52,7,20,27,37,42,79,10,9,19,11,35,21,8,16,93,91
2014,2,21401024,3/20/2015,1610612748,Miami Heat,1,1,1610612743,Denver Nuggets,0,0,36,29,65,7,9,16,43,38,81,15,4,19,16,26,23,11,16,92,108
2018,2,21800960,3/5/2019,1610612753,Orlando Magic,0,0,1610612755,Philadelphia 76ers,1,1,29,32,61,13,19,32,42,51,93,9,3,12,12,40,21,10,12,99,106
2018,2,21800960,3/5/2019,1610612755,Philadelphia 76ers,1,1,1610612753,Orlando Magic,0,0,31,30,61,11,17,28,42,47,89,19,2,21,11,36,28,4,11,99,114
2021,2,22100482,12/23/2021,1610612743,Denver Nuggets,1,0,1610612766,Charlotte Hornets,0,1,26,30,56,14,26,40,40,56,96,13,4,17,19,39,23,10,15,102,107
2021,2,22100482,12/23/2021,1610612766,Charlotte Hornets,0,1,1610612743,Denver Nuggets,1,0,23,24,47,16,31,47,39,55,94,21,3,24,14,44,28,7,11,101,115
2020,2,22000285,1/28/2021,1610612746,LA Clippers,0,1,1610612748,Miami Heat,1,0,19,26,45,17,25,42,36,51,87,20,2,22,13,38,22,5,13,97,109
2020,2,22000285,1/28/2021,1610612748,Miami Heat,1,0,1610612746,LA Clippers,0,1,27,30,57,13,20,33,40,50,90,12,3,15,10,42,24,11,14,98,105
2019,2,21900425,12/20/2019,1610612742,Dallas Mavericks,0,1,1610612755,Philadelphia 76ers,1,0,29,21,50,14,19,33,43,40,83,17,5,22,9,35,23,9,16,100,117
2019,2,21900425,12/20/2019,1610612755,Philadelphia 76ers,1,0,1610612742,Dallas Mavericks,0,1,28,28,56,10,24,34,38,52,90,12,6,18,12,43,25,10,15,100,98
2020,2,22001066,5/16/2021,1610612737,Atlanta Hawks,1,1,1610612745,Houston Rockets,0,0,42,27,69,7,14,21,49,41,90,19,7,26,14,33,32,8,13,100,124
2020,2,22001066,5/16/2021,1610612745,Houston Rockets,0,0,1610612737,Atlanta Hawks,1,1,13,16,29,18,45,63,31,61,92,15,5,20,16,48,25,10,16,102,95
2023,2,22300261,11/29/2023,1610612763,Memphis Grizzlies,1,1,1610612762,Utah Jazz,0,0,30,18,48,13,26,39,43,44,87,6,2,8,16,29,26,8,17,93,105
2021,2,22100481,12/23/2021,1610612742,Dallas Mavericks,1,0,1610612749,Milwaukee Bucks,0,1,23,18,41,12,33,45,35,51,86,13,4,17,10,44,25,7,11,96,95
2021,2,22100481,12/23/2021,1610612749,Milwaukee Bucks,0,1,1610612742,Dallas Mavericks,1,0,27,19,46,10,26,36,37,45,82,18,4,22,9,39,26,6,12,95,102
2022,2,22200995,3/9/2023,1610612749,Milwaukee Bucks,1,1,1610612751,Brooklyn Nets,0,0,25,29,54,19,31,50,44,60,104,11,3,14,23,37,33,10,16,105,118
2022,2,22200995,3/9/2023,1610612751,Brooklyn Nets,0,0,1610612749,Milwaukee Bucks,1,1,27,41,68,14,22,36,41,63,104,17,0,17,21,42,20,8,14,105,113
2020,2,22000284,1/28/2021,1610612747,Los Angeles Lakers,0,0,1610612765,Detroit Pistons,1,1,24,36,60,12,16,28,36,52,88,8,4,12,16,39,25,4,11,91,92
2020,2,22000284,1/28/2021,1610612765,Detroit Pistons,1,1,1610612747,Los Angeles Lakers,0,0,26,25,51,14,22,36,40,47,87,13,0,13,13,34,27,2,9,90,107
2023,2,22300788,2/14/2024,1610612747,Los Angeles Lakers,0,1,1610612762,Utah Jazz,1,0,38,22,60,14,17,31,52,39,91,20,4,24,10,29,34,5,10,101,138
2020,2,22001065,5/15/2021,1610612756,Phoenix Suns,0,1,1610612759,San Antonio Spurs,1,0,37,24,61,15,18,33,52,42,94,21,1,22,8,35,32,5,10,105,140
2020,2,22001065,5/15/2021,1610612759,San Antonio Spurs,1,0,1610612756,Phoenix Suns,0,1,35,27,62,4,22,26,39,49,88,21,3,24,10,41,23,10,16,106,103
2020,2,22000599,3/14/2021,1610612750,Minnesota Timberwolves,1,1,1610612757,Portland Trail Blazers,0,0,23,12,35,13,25,38,36,37,73,29,10,39,7,36,24,6,12,97,114
2020,2,22000599,3/14/2021,1610612757,Portland Trail Blazers,0,0,1610612750,Minnesota Timberwolves,1,1,22,22,44,17,28,45,39,50,89,17,4,21,12,42,22,6,12,97,112
2021,2,22100480,12/23/2021,1610612752,New York Knicks,1,0,1610612764,Washington Wizards,0,1,29,22,51,13,29,42,42,51,93,20,3,23,16,36,17,4,7,94,117
2021,2,22100480,12/23/2021,1610612764,Washington Wizards,0,1,1610612752,New York Knicks,1,0,26,12,38,16,21,37,42,33,75,24,8,32,6,33,30,2,11,96,124
2020,2,22000283,1/27/2021,1610612744,Golden State Warriors,1,1,1610612750,Minnesota Timberwolves,0,0,30,21,51,15,19,34,45,40,85,18,5,23,13,29,32,12,21,104,123
2020,2,22000283,1/27/2021,1610612750,Minnesota Timberwolves,0,0,1610612744,Golden State Warriors,1,1,23,28,51,14,22,36,37,50,87,23,10,33,16,38,23,11,17,104,111
2019,2,21900169,11/15/2019,1610612745,Houston Rockets,1,1,1610612754,Indiana Pacers,0,0,22,21,43,14,32,46,36,53,89,25,4,29,11,44,12,2,8,98,111
2019,2,21900169,11/15/2019,1610612754,Indiana Pacers,0,0,1610612745,Houston Rockets,1,1,29,20,49,8,25,33,37,45,82,20,6,26,13,35,24,11,17,99,102
2016,2,21600804,2/10/2017,1610612740,New Orleans Pelicans,0,1,1610612750,Minnesota Timberwolves,1,0,33,17,50,12,13,25,45,30,75,20,7,27,12,22,27,11,21,98,122
2016,2,21600804,2/10/2017,1610612750,Minnesota Timberwolves,1,0,1610612740,New Orleans Pelicans,0,1,32,23,55,6,21,27,38,44,82,24,8,32,13,36,22,8,13,97,106
2023,2,22300162,11/8/2023,1610612756,Phoenix Suns,0,1,1610612741,Chicago Bulls,1,0,19,23,42,19,29,48,38,52,90,21,4,25,18,35,32,12,22,107,116
2023,2,22300175,11/11/2023,1610612748,Miami Heat,0,1,1610612737,Atlanta Hawks,1,0,29,17,46,12,26,38,41,43,84,23,2,25,9,35,23,6,15,101,117
2023,2,22300346,12/17/2023,1610612745,Houston Rockets,0,0,1610612749,Milwaukee Bucks,1,1,34,24,58,11,16,27,45,40,85,18,3,21,8,32,26,4,10,97,119
2023,2,22300788,2/14/2024,1610612762,Utah Jazz,1,0,1610612747,Los Angeles Lakers,0,1,35,21,56,14,31,45,49,52,101,10,3,13,19,35,29,8,13,102,122
2023,2,22300263,11/29/2023,1610612743,Denver Nuggets,1,1,1610612745,Houston Rockets,0,0,29,23,52,19,24,43,48,47,95,19,7,26,22,28,37,3,4,90,134
2020,2,22000282,1/27/2021,1610612742,Dallas Mavericks,0,0,1610612762,Utah Jazz,1,1,30,26,56,12,23,35,42,49,91,8,1,9,8,41,22,7,8,94,104
2020,2,22000282,1/27/2021,1610612762,Utah Jazz,1,1,1610612742,Dallas Mavericks,0,0,26,24,50,16,25,41,42,49,91,16,5,21,17,35,20,4,10,96,116
2023,2,22300448,12/31/2023,1610612738,Boston Celtics,0,1,1610612759,San Antonio Spurs,1,0,36,17,53,15,27,42,51,44,95,17,5,22,14,33,29,6,11,103,134
2023,2,22300500,1/7/2024,1610612758,Sacramento Kings,1,0,1610612740,New Orleans Pelicans,0,1,23,23,46,15,30,45,38,53,91,9,3,12,11,45,28,2,9,94,100
2017,2,21700255,11/22/2017,1610612755,Philadelphia 76ers,1,1,1610612757,Portland Trail Blazers,0,0,28,30,58,11,21,32,39,51,90,12,5,17,14,41,23,8,18,101,101
2020,2,22000598,3/14/2021,1610612738,Boston Celtics,0,1,1610612745,Houston Rockets,1,0,33,22,55,18,19,37,51,41,92,14,7,21,11,35,29,8,14,105,134
2020,2,22000598,3/14/2021,1610612745,Houston Rockets,1,0,1610612738,Boston Celtics,0,1,19,22,41,16,34,50,35,56,91,21,10,31,13,47,23,8,11,105,107
2017,2,21700255,11/22/2017,1610612757,Portland Trail Blazers,0,0,1610612755,Philadelphia 76ers,1,1,23,40,63,7,19,26,30,59,89,14,10,24,15,49,14,12,17,102,81
2021,2,22100479,12/23/2021,1610612748,Miami Heat,1,1,1610612765,Detroit Pistons,0,0,31,25,56,12,20,32,43,45,88,17,2,19,9,38,23,9,13,99,115
2021,2,22100479,12/23/2021,1610612765,Detroit Pistons,0,0,1610612748,Miami Heat,1,1,18,22,40,18,22,40,36,44,80,22,3,25,7,39,23,4,16,99,112
2017,2,21700254,11/22/2017,1610612739,Cleveland Cavaliers,1,1,1610612751,Brooklyn Nets,0,0,29,19,48,14,20,34,43,39,82,19,8,27,6,37,21,5,10,99,119
2017,2,21700254,11/22/2017,1610612751,Brooklyn Nets,0,0,1610612739,Cleveland Cavaliers,1,1,28,16,44,14,23,37,42,39,81,11,5,16,9,32,26,8,19,98,109
2019,2,21900424,12/20/2019,1610612748,Miami Heat,1,1,1610612752,New York Knicks,0,0,25,14,39,18,20,38,43,34,77,25,9,34,11,29,34,11,18,99,129
2019,2,21900424,12/20/2019,1610612752,New York Knicks,0,0,1610612748,Miami Heat,1,1,31,29,60,10,24,34,41,53,94,22,11,33,18,43,23,6,8,99,114
2014,2,21400052,11/4/2014,1610612760,Oklahoma City Thunder,0,0,1610612761,Toronto Raptors,1,1,28,16,44,6,15,21,34,31,65,14,11,25,8,29,23,6,21,90,88
2014,2,21400052,11/4/2014,1610612761,Toronto Raptors,1,1,1610612760,Oklahoma City Thunder,0,0,24,26,50,8,23,31,32,49,81,28,5,33,15,36,23,4,10,91,100
2020,2,22000597,3/14/2021,1610612737,Atlanta Hawks,1,1,1610612739,Cleveland Cavaliers,0,0,20,22,42,12,17,29,32,39,71,24,2,26,17,22,21,4,21,88,100
2020,2,22000597,3/14/2021,1610612739,Cleveland Cavaliers,0,0,1610612737,Atlanta Hawks,1,1,23,28,51,8,22,30,31,50,81,12,11,23,19,37,19,4,13,88,82
2014,2,21400451,12/27/2014,1610612752,New York Knicks,0,0,1610612758,Sacramento Kings,1,1,42,35,77,6,14,20,48,49,97,27,5,32,19,34,30,9,15,108,129
2014,2,21400451,12/27/2014,1610612758,Sacramento Kings,1,1,1610612752,New York Knicks,0,0,41,32,73,8,8,16,49,40,89,29,4,33,13,28,23,10,17,108,135
2020,2,22000281,1/27/2021,1610612756,Phoenix Suns,1,0,1610612760,Oklahoma City Thunder,0,1,21,31,52,15,28,43,36,59,95,10,2,12,15,46,19,7,15,99,97
2020,2,22000281,1/27/2021,1610612760,Oklahoma City Thunder,0,1,1610612756,Phoenix Suns,1,0,22,23,45,16,24,40,38,47,85,10,4,14,7,42,21,7,14,100,102
2019,2,21900423,12/20/2019,1610612761,Toronto Raptors,1,1,1610612764,Washington Wizards,0,0,26,22,48,12,18,30,38,40,78,34,10,44,10,35,26,6,17,108,122
2019,2,21900423,12/20/2019,1610612764,Washington Wizards,0,0,1610612761,Toronto Raptors,1,1,26,22,48,14,25,39,40,47,87,24,8,32,10,39,24,6,15,106,118
2019,2,21900168,11/15/2019,1610612753,Orlando Magic,1,1,1610612759,San Antonio Spurs,0,0,24,34,58,12,17,29,36,51,87,27,7,34,18,36,22,8,10,94,111
2019,2,21900168,11/15/2019,1610612759,San Antonio Spurs,0,0,1610612753,Orlando Magic,1,1,32,31,63,13,13,26,45,44,89,6,4,10,10,35,23,6,11,93,109
2023,2,22300163,11/8/2023,1610612745,Houston Rockets,1,1,1610612747,Los Angeles Lakers,0,0,37,23,60,14,19,33,51,42,93,12,7,19,17,30,26,7,13,97,128
2023,2,22300173,11/11/2023,1610612749,Milwaukee Bucks,0,0,1610612753,Orlando Magic,1,1,29,19,48,9,20,29,38,39,77,12,13,25,9,35,25,9,19,100,97
2017,2,21700253,11/22/2017,1610612764,Washington Wizards,0,0,1610612766,Charlotte Hornets,1,1,37,29,66,11,22,33,48,51,99,17,5,22,13,41,25,5,13,111,124
2017,2,21700253,11/22/2017,1610612766,Charlotte Hornets,1,1,1610612764,Washington Wizards,0,0,33,30,63,10,18,28,43,48,91,33,7,40,15,36,23,4,12,108,129
2020,2,22001064,5/15/2021,1610612752,New York Knicks,1,1,1610612766,Charlotte Hornets,0,0,29,22,51,16,21,37,45,43,88,12,3,15,8,37,29,5,10,98,118
2020,2,22001064,5/15/2021,1610612766,Charlotte Hornets,0,0,1610612752,New York Knicks,1,1,26,27,53,13,36,49,39,63,102,18,6,24,23,44,28,3,8,99,109
2020,2,22000596,3/14/2021,1610612748,Miami Heat,0,1,1610612753,Orlando Magic,1,0,23,16,39,14,36,50,37,52,89,14,1,15,12,40,28,4,11,97,102
2020,2,22000596,3/14/2021,1610612753,Orlando Magic,1,0,1610612748,Miami Heat,0,1,17,18,35,16,24,40,33,42,75,15,6,21,9,35,25,15,23,97,97
2023,2,22300227,11/22/2023,1610612737,Atlanta Hawks,1,1,1610612751,Brooklyn Nets,0,0,33,34,67,18,31,49,51,65,116,27,2,29,28,37,24,8,14,115,147
2023,2,22300263,11/29/2023,1610612745,Houston Rockets,0,0,1610612743,Denver Nuggets,1,1,31,14,45,16,25,41,47,39,86,14,5,19,14,29,27,4,9,90,124
2018,2,21800743,1/27/2019,1610612747,Los Angeles Lakers,1,1,1610612756,Phoenix Suns,0,0,37,29,66,10,13,23,47,42,89,12,6,18,19,26,28,8,18,96,116
2021,2,22100478,12/23/2021,1610612737,Atlanta Hawks,0,1,1610612755,Philadelphia 76ers,1,0,30,28,58,7,17,24,37,45,82,17,2,19,16,30,20,8,16,90,98
2021,2,22100478,12/23/2021,1610612755,Philadelphia 76ers,1,0,1610612737,Atlanta Hawks,0,1,27,26,53,6,21,27,33,47,80,24,2,26,11,37,20,5,8,90,96
2020,2,22001063,5/15/2021,1610612738,Boston Celtics,0,1,1610612750,Minnesota Timberwolves,1,0,28,25,53,18,24,42,46,49,95,14,4,18,17,32,27,8,15,102,124
2020,2,22001063,5/15/2021,1610612750,Minnesota Timberwolves,1,0,1610612738,Boston Celtics,0,1,34,24,58,5,32,37,39,56,95,25,9,34,21,39,22,8,13,101,108
2017,2,21700252,11/21/2017,1610612741,Chicago Bulls,0,0,1610612747,Los Angeles Lakers,1,1,25,33,58,11,25,36,36,58,94,11,5,16,17,44,22,7,14,98,94
2017,2,21700252,11/21/2017,1610612747,Los Angeles Lakers,1,1,1610612741,Chicago Bulls,0,0,23,27,50,13,27,40,36,54,90,17,7,24,13,44,23,4,14,99,102
2018,2,21801102,3/24/2019,1610612747,Los Angeles Lakers,1,1,1610612758,Sacramento Kings,0,0,26,19,45,13,27,40,39,46,85,20,4,24,14,35,29,13,22,104,111
2020,2,22000280,1/27/2021,1610612738,Boston Celtics,0,0,1610612759,San Antonio Spurs,1,1,32,36,68,10,20,30,42,56,98,12,2,14,17,39,15,5,12,99,106
2020,2,22000280,1/27/2021,1610612759,San Antonio Spurs,1,1,1610612738,Boston Celtics,0,0,38,16,54,8,20,28,46,36,82,10,6,16,11,28,22,10,20,100,110
2019,2,21900422,12/20/2019,1610612738,Boston Celtics,1,1,1610612765,Detroit Pistons,0,0,36,23,59,9,18,27,45,41,86,15,6,21,14,29,24,13,20,102,114
2019,2,21900422,12/20/2019,1610612765,Detroit Pistons,0,0,1610612738,Boston Celtics,1,1,23,31,54,11,20,31,34,51,85,14,5,19,17,38,21,13,25,102,93
2017,2,21700251,11/20/2017,1610612743,Denver Nuggets,0,1,1610612758,Sacramento Kings,1,0,27,27,54,15,17,32,42,44,86,15,5,20,16,29,18,11,14,93,114
2017,2,21700251,11/20/2017,1610612758,Sacramento Kings,1,0,1610612743,Denver Nuggets,0,1,33,33,66,8,12,20,41,45,86,8,1,9,9,38,18,6,13,94,98
2016,2,21600311,12/5/2016,1610612738,Boston Celtics,0,0,1610612745,Houston Rockets,1,1,31,36,67,11,21,32,42,57,99,11,1,12,16,42,27,8,11,99,106
2020,2,22000595,3/14/2021,1610612755,Philadelphia 76ers,1,1,1610612759,San Antonio Spurs,0,0,41,28,69,15,14,29,56,42,98,7,4,11,18,27,35,8,11,97,134
2020,2,22000595,3/14/2021,1610612759,San Antonio Spurs,0,0,1610612755,Philadelphia 76ers,1,1,32,32,64,4,17,21,36,49,85,23,8,31,10,42,20,7,9,98,99
2016,2,21600311,12/5/2016,1610612745,Houston Rockets,1,1,1610612738,Boston Celtics,0,0,22,16,38,12,26,38,34,42,76,27,4,31,9,34,20,7,17,99,107
2014,2,21401023,3/20/2015,1610612739,Cleveland Cavaliers,1,1,1610612754,Indiana Pacers,0,0,26,30,56,9,17,26,35,47,82,16,5,21,14,34,18,5,9,88,95
2014,2,21401023,3/20/2015,1610612754,Indiana Pacers,0,0,1610612739,Cleveland Cavaliers,1,1,28,36,64,8,12,20,36,48,84,12,1,13,12,36,23,4,9,89,92
2014,2,21400450,12/27/2014,1610612755,Philadelphia 76ers,0,0,1610612762,Utah Jazz,1,1,19,29,48,5,21,26,24,50,74,18,10,28,14,44,11,11,18,92,71
2014,2,21400450,12/27/2014,1610612762,Utah Jazz,1,1,1610612755,Philadelphia 76ers,0,0,26,35,61,4,19,23,30,54,84,24,4,28,20,37,17,8,14,93,88
2023,2,22300062,10/24/2023,1610612756,Phoenix Suns,0,1,1610612744,Golden State Warriors,1,0,31,31,62,11,22,33,42,53,95,13,4,17,21,32,23,11,19,100,108
2021,2,22100477,12/23/2021,1610612740,New Orleans Pelicans,0,1,1610612753,Orlando Magic,1,0,24,32,56,13,17,30,37,49,86,23,3,26,14,37,21,6,10,94,110
2021,2,22100477,12/23/2021,1610612753,Orlando Magic,1,0,1610612740,New Orleans Pelicans,0,1,29,27,56,9,23,32,38,50,88,19,2,21,13,38,19,4,9,94,104
2020,2,22000279,1/27/2021,1610612740,New Orleans Pelicans,1,1,1610612764,Washington Wizards,0,0,29,17,46,17,26,43,46,43,89,15,9,24,16,30,27,11,15,98,124
2020,2,22000279,1/27/2021,1610612764,Washington Wizards,0,0,1610612740,New Orleans Pelicans,1,1,24,30,54,13,25,38,37,55,92,19,2,21,14,41,29,7,11,98,106
2020,2,22000594,3/14/2021,1610612744,Golden State Warriors,1,1,1610612762,Utah Jazz,0,0,34,24,58,16,15,31,50,39,89,15,3,18,7,33,33,6,14,104,131
2020,2,22000594,3/14/2021,1610612762,Utah Jazz,0,0,1610612744,Golden State Warriors,1,1,26,23,49,15,29,44,41,52,93,22,7,29,19,36,24,12,14,102,119
2023,2,22300478,1/4/2024,1610612744,Golden State Warriors,1,0,1610612743,Denver Nuggets,0,1,34,20,54,15,21,36,49,41,90,14,2,16,13,29,35,7,10,93,127
2023,2,22300062,10/24/2023,1610612744,Golden State Warriors,1,0,1610612756,Phoenix Suns,0,1,26,32,58,10,33,43,36,65,101,22,6,28,24,43,19,5,11,101,104
2021,2,22100476,12/23/2021,1610612745,Houston Rockets,0,0,1610612754,Indiana Pacers,1,1,20,23,43,15,22,37,35,45,80,21,5,26,14,34,16,6,13,91,106
2021,2,22100476,12/23/2021,1610612754,Indiana Pacers,1,1,1610612745,Houston Rockets,0,0,33,17,50,13,25,38,46,42,88,13,6,19,21,23,27,9,15,91,118
2020,2,22000278,4/12/2021,1610612741,Chicago Bulls,0,0,1610612763,Memphis Grizzlies,1,1,31,24,55,5,26,31,36,50,86,13,4,17,11,41,23,7,17,101,90
2020,2,22000278,4/12/2021,1610612763,Memphis Grizzlies,1,1,1610612741,Chicago Bulls,0,0,31,26,57,9,19,28,40,45,85,12,2,14,12,33,27,8,20,100,101
2019,2,21900421,12/20/2019,1610612754,Indiana Pacers,1,1,1610612758,Sacramento Kings,0,0,31,24,55,14,17,31,45,41,86,15,3,18,8,34,34,4,9,95,119
2019,2,21900421,12/20/2019,1610612758,Sacramento Kings,0,0,1610612754,Indiana Pacers,1,1,31,28,59,10,22,32,41,50,91,13,2,15,15,36,25,5,12,95,105
2019,2,21900167,11/15/2019,1610612765,Detroit Pistons,0,0,1610612766,Charlotte Hornets,1,1,25,21,46,15,20,35,40,41,81,11,0,11,12,29,25,10,21,95,106
2019,2,21900167,11/15/2019,1610612766,Charlotte Hornets,1,1,1610612765,Detroit Pistons,0,0,30,31,61,13,22,35,43,53,96,10,6,16,19,37,22,3,11,96,109
2023,2,22300086,10/27/2023,1610612753,Orlando Magic,0,1,1610612757,Portland Trail Blazers,1,0,27,24,51,9,19,28,36,43,79,21,11,32,13,35,22,6,14,94,102
2021,2,22100475,12/22/2021,1610612746,LA Clippers,0,1,1610612758,Sacramento Kings,1,0,35,23,58,7,17,24,42,40,82,14,2,16,8,33,26,7,13,96,105
2021,2,22100475,12/22/2021,1610612758,Sacramento Kings,1,0,1610612746,LA Clippers,0,1,22,25,47,12,26,38,34,51,85,9,3,12,13,40,24,10,19,94,89
2020,2,22000277,1/27/2021,1610612749,Milwaukee Bucks,0,1,1610612761,Toronto Raptors,1,0,24,25,49,16,28,44,40,53,93,19,7,26,19,39,30,8,15,100,115
2020,2,22000277,1/27/2021,1610612761,Toronto Raptors,1,0,1610612749,Milwaukee Bucks,0,1,16,23,39,22,33,55,38,56,94,10,2,12,12,46,26,9,12,100,108
2017,2,21700250,11/20/2017,1610612737,Atlanta Hawks,0,0,1610612759,San Antonio Spurs,1,1,29,26,55,8,22,30,37,48,85,3,5,8,11,41,21,7,15,93,85
2017,2,21700250,11/20/2017,1610612759,San Antonio Spurs,1,1,1610612737,Atlanta Hawks,0,0,30,28,58,10,21,31,40,49,89,6,0,6,17,32,29,7,18,94,96
2016,2,21600803,2/10/2017,1610612744,Golden State Warriors,0,1,1610612763,Memphis Grizzlies,1,0,24,20,44,15,18,33,39,38,77,29,9,38,9,34,31,6,12,97,122
2016,2,21600803,2/10/2017,1610612763,Memphis Grizzlies,1,0,1610612744,Golden State Warriors,0,1,25,36,61,9,17,26,34,53,87,30,7,37,24,31,20,14,19,97,107
2014,2,21400051,11/4/2014,1610612752,New York Knicks,1,0,1610612764,Washington Wizards,0,1,22,44,66,8,7,15,30,51,81,15,4,19,19,33,16,8,18,87,83
2020,2,22000593,3/14/2021,1610612760,Oklahoma City Thunder,1,1,1610612763,Memphis Grizzlies,0,0,26,16,42,16,15,31,42,31,73,28,6,34,12,21,26,13,25,102,128
2020,2,22000593,3/14/2021,1610612763,Memphis Grizzlies,0,0,1610612760,Oklahoma City Thunder,1,1,40,30,70,7,15,22,47,45,92,21,8,29,11,39,27,7,7,101,122
2023,2,22300087,10/27/2023,1610612744,Golden State Warriors,0,1,1610612758,Sacramento Kings,1,0,34,21,55,14,18,32,48,39,87,12,2,14,9,31,32,10,19,104,122
2023,2,22300361,12/19/2023,1610612759,San Antonio Spurs,0,0,1610612749,Milwaukee Bucks,1,1,37,29,66,9,21,30,46,50,96,18,3,21,13,39,27,11,16,110,119
2018,2,21801102,3/24/2019,1610612758,Sacramento Kings,0,0,1610612747,Los Angeles Lakers,1,1,25,46,71,14,19,33,39,65,104,14,9,23,19,51,27,4,8,105,106
2023,2,22300352,12/18/2023,1610612737,Atlanta Hawks,1,1,1610612765,Detroit Pistons,0,0,30,19,49,16,20,36,46,39,85,22,5,27,13,28,25,7,18,101,130
2021,2,22100474,12/22/2021,1610612743,Denver Nuggets,0,0,1610612760,Oklahoma City Thunder,1,1,20,20,40,13,31,44,33,51,84,15,11,26,8,48,21,7,11,99,94
2021,2,22100474,12/22/2021,1610612760,Oklahoma City Thunder,1,1,1610612743,Denver Nuggets,0,0,34,26,60,8,26,34,42,52,94,16,3,19,16,37,22,7,11,97,108
2020,2,22000276,1/27/2021,1610612747,Los Angeles Lakers,0,0,1610612755,Philadelphia 76ers,1,1,33,29,62,8,16,24,41,45,86,16,9,25,14,35,20,10,12,95,106
2020,2,22000276,1/27/2021,1610612755,Philadelphia 76ers,1,1,1610612747,Los Angeles Lakers,0,0,32,28,60,9,16,25,41,44,85,16,10,26,17,32,24,5,14,95,107
2019,2,21900420,12/20/2019,1610612739,Cleveland Cavaliers,1,1,1610612763,Memphis Grizzlies,0,0,23,32,55,17,20,37,40,52,92,17,6,23,19,36,26,9,16,100,114
2019,2,21900420,12/20/2019,1610612763,Memphis Grizzlies,0,0,1610612739,Cleveland Cavaliers,1,1,30,31,61,14,27,41,44,58,102,5,2,7,14,46,31,4,7,101,107
2020,2,22001062,5/15/2021,1610612748,Miami Heat,0,0,1610612749,Milwaukee Bucks,1,1,18,29,47,22,27,49,40,56,96,6,2,8,11,45,25,4,11,100,108
2020,2,22001062,5/15/2021,1610612749,Milwaukee Bucks,1,1,1610612748,Miami Heat,0,0,33,18,51,13,22,35,46,40,86,17,7,24,7,37,29,8,11,100,122
2020,2,22000592,3/13/2021,1610612742,Dallas Mavericks,0,1,1610612743,Denver Nuggets,1,0,24,16,40,18,28,46,42,44,86,14,2,16,13,31,26,5,8,91,116
2020,2,22000592,3/13/2021,1610612743,Denver Nuggets,1,0,1610612742,Dallas Mavericks,0,1,21,28,49,16,25,41,37,53,90,13,5,18,18,38,27,5,10,92,103
2017,2,21700249,11/20/2017,1610612738,Boston Celtics,0,1,1610612742,Dallas Mavericks,1,0,25,23,48,13,23,36,38,46,84,21,5,26,7,42,24,7,17,107,110
2017,2,21700249,11/20/2017,1610612742,Dallas Mavericks,1,0,1610612738,Boston Celtics,0,1,32,31,63,7,26,33,39,57,96,17,3,20,8,51,18,8,11,107,102
2016,2,21600802,2/10/2017,1610612747,Los Angeles Lakers,0,1,1610612749,Milwaukee Bucks,1,0,24,20,44,15,16,31,39,36,75,29,6,35,9,30,25,11,19,99,122
2023,2,22300773,2/13/2024,1610612748,Miami Heat,0,1,1610612749,Milwaukee Bucks,1,0,26,21,47,19,21,40,45,42,87,14,4,18,10,34,34,8,14,100,123
2016,2,21600802,2/10/2017,1610612749,Milwaukee Bucks,1,0,1610612747,Los Angeles Lakers,0,1,32,16,48,8,20,28,40,36,76,26,5,31,10,28,27,9,20,100,114
2014,2,21400051,11/4/2014,1610612764,Washington Wizards,0,1,1610612752,New York Knicks,1,0,31,31,62,8,10,18,39,41,80,12,7,19,14,31,26,5,12,88,98
2020,2,22000591,3/13/2021,1610612750,Minnesota Timberwolves,1,0,1610612757,Portland Trail Blazers,0,1,34,26,60,10,16,26,44,42,86,23,8,31,20,28,23,6,18,98,121
2020,2,22000591,3/13/2021,1610612757,Portland Trail Blazers,0,1,1610612750,Minnesota Timberwolves,1,0,30,19,49,13,27,40,43,46,89,26,4,30,12,37,26,5,8,99,125
2021,2,22100473,12/22/2021,1610612745,Houston Rockets,0,0,1610612749,Milwaukee Bucks,1,1,23,18,41,13,32,45,36,50,86,21,10,31,17,39,23,8,15,100,106
2021,2,22100473,12/22/2021,1610612749,Milwaukee Bucks,1,1,1610612745,Houston Rockets,0,0,28,29,57,17,29,46,45,58,103,19,2,21,19,40,25,0,7,101,126
2020,2,22000275,1/27/2021,1610612743,Denver Nuggets,0,1,1610612748,Miami Heat,1,0,28,21,49,14,29,43,42,50,92,11,0,11,16,34,29,6,14,94,109
2020,2,22000275,1/27/2021,1610612748,Miami Heat,1,0,1610612743,Denver Nuggets,0,1,17,18,35,13,32,45,30,50,80,9,2,11,9,43,24,14,17,93,82
2020,2,22001061,5/15/2021,1610612747,Los Angeles Lakers,0,1,1610612754,Indiana Pacers,1,0,30,27,57,11,18,29,41,45,86,29,7,36,17,31,25,10,13,99,122
2023,2,22300087,10/27/2023,1610612758,Sacramento Kings,1,0,1610612744,Golden State Warriors,0,1,29,25,54,12,28,40,41,53,94,20,9,29,17,39,24,14,14,104,114
2020,2,22001061,5/15/2021,1610612754,Indiana Pacers,1,0,1610612747,Los Angeles Lakers,0,1,37,19,56,9,24,33,46,43,89,14,5,19,11,36,28,5,13,100,115
2020,2,22000590,3/13/2021,1610612737,Atlanta Hawks,1,1,1610612758,Sacramento Kings,0,0,31,20,51,12,21,33,43,41,84,23,10,33,16,28,21,5,9,93,121
2023,2,22300264,11/29/2023,1610612758,Sacramento Kings,1,0,1610612746,LA Clippers,0,1,27,18,45,13,28,41,40,46,86,24,4,28,16,31,22,8,14,97,117
2023,2,22300165,11/8/2023,1610612749,Milwaukee Bucks,1,1,1610612765,Detroit Pistons,0,0,30,23,53,11,26,37,41,49,90,27,5,32,7,44,19,2,10,106,120
2023,2,22300361,12/19/2023,1610612749,Milwaukee Bucks,1,1,1610612759,San Antonio Spurs,0,0,32,25,57,18,31,49,50,56,106,14,4,18,12,47,34,4,7,108,132
2019,2,21900166,11/14/2019,1610612743,Denver Nuggets,1,1,1610612751,Brooklyn Nets,0,0,33,35,68,10,23,33,43,58,101,5,5,10,14,47,26,3,7,98,101
2019,2,21900166,11/14/2019,1610612751,Brooklyn Nets,0,0,1610612743,Denver Nuggets,1,1,28,29,57,8,30,38,36,59,95,13,3,16,11,50,19,4,7,98,93
2023,2,22300086,10/27/2023,1610612757,Portland Trail Blazers,1,0,1610612753,Orlando Magic,0,1,26,30,56,9,23,32,35,53,88,18,3,21,19,35,15,10,16,96,97
2020,2,22001060,5/15/2021,1610612741,Chicago Bulls,0,0,1610612751,Brooklyn Nets,1,1,23,34,57,11,30,41,34,64,98,12,5,17,21,47,24,6,9,93,91
2020,2,22001060,5/15/2021,1610612751,Brooklyn Nets,1,1,1610612741,Chicago Bulls,0,0,27,26,53,14,20,34,41,46,87,9,6,15,11,38,26,7,10,94,105
2020,2,22000590,3/13/2021,1610612758,Sacramento Kings,0,0,1610612737,Atlanta Hawks,1,1,36,26,62,7,29,36,43,55,98,13,3,16,25,32,27,6,13,93,106
2021,2,22100472,1/26/2022,1610612741,Chicago Bulls,1,1,1610612761,Toronto Raptors,0,0,39,19,58,7,19,26,46,38,84,12,4,16,14,27,32,8,15,93,111
2021,2,22100472,1/26/2022,1610612761,Toronto Raptors,0,0,1610612741,Chicago Bulls,1,1,26,22,48,12,19,31,38,41,79,17,11,28,10,38,24,2,12,92,105
2020,2,22000274,1/27/2021,1610612737,Atlanta Hawks,1,0,1610612751,Brooklyn Nets,0,1,32,29,61,13,20,33,45,49,94,25,3,28,17,32,29,7,11,103,128
2020,2,22000274,1/27/2021,1610612751,Brooklyn Nets,0,1,1610612737,Atlanta Hawks,1,0,41,25,66,11,21,32,52,46,98,17,3,20,17,29,29,3,11,103,132
2019,2,21900419,12/19/2019,1610612745,Houston Rockets,0,1,1610612746,LA Clippers,1,0,29,20,49,14,23,37,43,43,86,22,7,29,12,34,23,10,18,105,122
2019,2,21900419,12/19/2019,1610612746,LA Clippers,1,0,1610612745,Houston Rockets,0,1,27,22,49,16,21,37,43,43,86,15,4,19,8,35,23,9,18,104,117
2023,2,22300960,3/14/2024,1610612752,New York Knicks,0,1,1610612757,Portland Trail Blazers,1,0,32,26,58,6,23,29,38,49,87,23,3,26,17,33,16,10,15,95,105
2020,2,22001059,5/14/2021,1610612740,New Orleans Pelicans,0,0,1610612744,Golden State Warriors,1,1,35,37,72,11,16,27,46,53,99,19,9,28,17,41,21,4,9,104,122
2020,2,22001059,5/14/2021,1610612744,Golden State Warriors,1,1,1610612740,New Orleans Pelicans,0,0,25,23,48,17,22,39,42,45,87,24,6,30,9,40,29,6,12,103,125
2020,2,22000589,3/13/2021,1610612749,Milwaukee Bucks,0,1,1610612764,Washington Wizards,1,0,26,28,54,17,28,45,43,56,99,22,3,25,16,40,33,9,18,113,125
2020,2,22000589,3/13/2021,1610612764,Washington Wizards,1,0,1610612749,Milwaukee Bucks,0,1,27,26,53,16,25,41,43,51,94,17,5,22,8,45,25,9,15,113,119
2016,2,21600310,12/5/2016,1610612740,New Orleans Pelicans,1,0,1610612763,Memphis Grizzlies,0,1,29,38,67,10,22,32,39,60,99,20,1,21,11,50,21,8,13,111,108
2016,2,21600310,12/5/2016,1610612763,Memphis Grizzlies,0,1,1610612740,New Orleans Pelicans,1,0,29,41,70,13,21,34,42,62,104,13,8,21,16,50,23,7,14,113,110
2021,2,22100471,12/22/2021,1610612738,Boston Celtics,1,1,1610612739,Cleveland Cavaliers,0,0,32,30,62,11,19,30,43,49,92,14,4,18,14,38,24,8,13,99,111
2021,2,22100471,12/22/2021,1610612739,Cleveland Cavaliers,0,0,1610612738,Boston Celtics,1,1,27,27,54,9,29,38,36,56,92,20,4,24,19,38,17,12,16,100,101
2020,2,22001058,5/14/2021,1610612745,Houston Rockets,1,1,1610612746,LA Clippers,0,0,32,17,49,14,23,37,46,40,86,16,6,22,12,32,30,9,16,101,122
2020,2,22001058,5/14/2021,1610612746,LA Clippers,0,0,1610612745,Houston Rockets,1,1,34,24,58,11,24,35,45,48,93,14,1,15,13,36,29,4,14,100,115
2023,2,22300262,11/29/2023,1610612740,New Orleans Pelicans,1,1,1610612755,Philadelphia 76ers,0,0,32,16,48,10,20,30,42,36,78,30,4,34,15,24,33,8,20,97,124
2023,2,22300316,12/13/2023,1610612759,San Antonio Spurs,1,0,1610612747,Los Angeles Lakers,0,1,29,30,59,16,21,37,45,51,96,13,5,18,12,41,28,14,17,109,119
2021,2,22100470,12/22/2021,1610612737,Atlanta Hawks,1,0,1610612753,Orlando Magic,0,1,20,29,49,12,19,31,32,48,80,22,7,29,15,35,21,11,14,93,98
2021,2,22100470,12/22/2021,1610612753,Orlando Magic,0,1,1610612737,Atlanta Hawks,1,0,27,21,48,11,26,37,38,47,85,17,6,23,11,38,27,4,10,94,104
2020,2,22000273,1/27/2021,1610612753,Orlando Magic,1,0,1610612758,Sacramento Kings,0,1,30,40,70,10,16,26,40,56,96,17,1,18,20,36,25,8,14,98,107
2022,2,22201052,3/17/2023,1610612763,Memphis Grizzlies,0,1,1610612759,San Antonio Spurs,1,0,35,28,63,14,24,38,49,52,101,14,7,21,17,40,27,11,17,111,126
2020,2,22000273,1/27/2021,1610612758,Sacramento Kings,0,1,1610612753,Orlando Magic,1,0,31,28,59,14,19,33,45,47,92,17,9,26,22,30,30,8,15,98,121
2020,2,22001057,5/14/2021,1610612742,Dallas Mavericks,1,1,1610612761,Toronto Raptors,0,0,22,26,48,17,25,42,39,51,90,19,2,21,12,40,27,7,10,97,114
2020,2,22001057,5/14/2021,1610612761,Toronto Raptors,0,0,1610612742,Dallas Mavericks,1,1,29,18,47,13,25,38,42,43,85,13,4,17,8,37,19,4,12,97,110
2020,2,22000588,3/13/2021,1610612761,Toronto Raptors,0,0,1610612766,Charlotte Hornets,1,1,22,28,50,15,31,46,37,59,96,15,3,18,16,44,25,10,16,106,104
2023,2,22300262,11/29/2023,1610612755,Philadelphia 76ers,0,0,1610612740,New Orleans Pelicans,1,1,28,19,47,14,20,34,42,39,81,16,2,18,11,30,28,11,22,97,114
2020,2,22000588,3/13/2021,1610612766,Charlotte Hornets,1,1,1610612761,Toronto Raptors,0,0,18,14,32,21,28,49,39,42,81,15,4,19,10,35,30,10,27,106,114
2020,2,22000272,1/27/2021,1610612739,Cleveland Cavaliers,1,1,1610612765,Detroit Pistons,0,0,36,30,66,11,10,21,47,40,87,17,6,23,13,29,24,7,17,102,122
2020,2,22000272,1/27/2021,1610612765,Detroit Pistons,0,0,1610612739,Cleveland Cavaliers,1,1,26,29,55,11,16,27,37,45,82,22,7,29,15,31,29,14,22,102,107
2019,2,21900165,11/14/2019,1610612737,Atlanta Hawks,0,0,1610612756,Phoenix Suns,1,1,32,28,60,8,23,31,40,51,91,24,6,30,18,37,25,6,22,110,112
2019,2,21900165,11/14/2019,1610612756,Phoenix Suns,1,1,1610612737,Atlanta Hawks,0,0,26,20,46,15,24,39,41,44,85,31,7,38,10,36,32,15,20,110,128
2014,2,21400050,11/4/2014,1610612745,Houston Rockets,0,1,1610612748,Miami Heat,1,0,18,13,31,17,20,37,35,33,68,21,6,27,13,23,22,7,18,86,108
2014,2,21400449,12/27/2014,1610612737,Atlanta Hawks,0,1,1610612749,Milwaukee Bucks,1,0,24,37,61,9,20,29,33,57,90,15,4,19,24,35,25,5,15,92,90
2023,2,22300164,11/8/2023,1610612748,Miami Heat,0,1,1610612763,Memphis Grizzlies,1,0,24,25,49,11,17,28,35,42,77,27,5,32,13,31,22,10,19,100,108
2014,2,21400449,12/27/2014,1610612749,Milwaukee Bucks,1,0,1610612737,Atlanta Hawks,0,1,19,31,50,12,18,30,31,49,80,11,3,14,15,36,21,9,19,92,85
2023,2,22300315,12/13/2023,1610612754,Indiana Pacers,0,0,1610612749,Milwaukee Bucks,1,1,34,30,64,11,25,36,45,55,100,25,7,32,24,34,30,8,18,111,126
2023,2,22300350,12/18/2023,1610612754,Indiana Pacers,1,0,1610612746,LA Clippers,0,1,37,25,62,12,21,33,49,46,95,17,4,21,13,34,38,4,11,103,127
2021,2,22100469,12/21/2021,1610612747,Los Angeles Lakers,1,0,1610612756,Phoenix Suns,0,1,27,25,52,7,28,35,34,53,87,15,8,23,9,47,14,11,15,104,90
2021,2,22100469,12/21/2021,1610612756,Phoenix Suns,0,1,1610612747,Los Angeles Lakers,1,0,29,23,52,12,29,41,41,52,93,14,1,15,10,43,29,9,16,103,108
2020,2,22000271,1/27/2021,1610612754,Indiana Pacers,0,1,1610612766,Charlotte Hornets,1,0,29,19,48,16,24,40,45,43,88,10,2,12,11,32,34,3,12,95,116
2020,2,22000271,1/27/2021,1610612766,Charlotte Hornets,1,0,1610612754,Indiana Pacers,0,1,24,28,52,13,25,38,37,53,90,19,2,21,16,37,28,1,11,97,106
2019,2,21900418,12/19/2019,1610612751,Brooklyn Nets,0,0,1610612759,San Antonio Spurs,1,1,28,19,47,7,29,36,35,48,83,28,2,30,10,38,16,10,18,105,105
2019,2,21900418,12/19/2019,1610612759,San Antonio Spurs,1,1,1610612751,Brooklyn Nets,0,0,30,33,63,13,20,33,43,53,96,19,4,23,14,41,26,9,11,104,118
2020,2,22001056,5/14/2021,1610612760,Oklahoma City Thunder,1,0,1610612762,Utah Jazz,0,1,30,35,65,6,13,19,36,48,84,15,1,16,10,38,13,9,17,98,93
2020,2,22001056,5/14/2021,1610612762,Utah Jazz,0,1,1610612760,Oklahoma City Thunder,1,0,27,27,54,13,26,39,40,53,93,16,5,21,17,37,23,6,11,97,109
2020,2,22000587,3/13/2021,1610612751,Brooklyn Nets,1,1,1610612765,Detroit Pistons,0,0,33,20,53,6,21,27,39,41,80,16,6,22,7,36,22,10,12,96,100
2020,2,22000587,3/13/2021,1610612765,Detroit Pistons,0,0,1610612751,Brooklyn Nets,1,1,28,29,57,8,24,32,36,53,89,15,5,20,18,37,26,8,13,96,95
2023,2,22300142,11/5/2023,1610612744,Golden State Warriors,0,0,1610612739,Cleveland Cavaliers,1,1,18,35,53,16,25,41,34,60,94,20,10,30,21,45,26,8,13,102,104
2021,2,22100468,12/21/2021,1610612742,Dallas Mavericks,1,1,1610612750,Minnesota Timberwolves,0,0,31,21,52,11,23,34,42,44,86,19,4,23,15,32,30,4,11,94,114
2021,2,22100468,12/21/2021,1610612750,Minnesota Timberwolves,0,0,1610612742,Dallas Mavericks,1,1,23,16,39,13,27,40,36,43,79,17,3,20,9,36,26,11,17,94,102
2020,2,22000270,1/26/2021,1610612752,New York Knicks,0,0,1610612762,Utah Jazz,1,1,26,30,56,10,17,27,36,47,83,12,5,17,12,37,15,6,12,92,94
2017,2,21700247,11/20/2017,1610612749,Milwaukee Bucks,1,0,1610612764,Washington Wizards,0,1,31,26,57,4,18,22,35,44,79,14,5,19,8,40,17,4,10,90,88
2020,2,22000270,1/26/2021,1610612762,Utah Jazz,1,1,1610612752,New York Knicks,0,0,22,22,44,15,33,48,37,55,92,19,3,22,18,38,24,6,6,91,108
2019,2,21900417,12/19/2019,1610612747,Los Angeles Lakers,0,0,1610612749,Milwaukee Bucks,1,1,25,20,45,12,23,35,37,43,80,18,5,23,11,37,24,14,19,96,104
2019,2,21900417,12/19/2019,1610612749,Milwaukee Bucks,1,1,1610612747,Los Angeles Lakers,0,0,20,18,38,16,23,39,36,41,77,23,9,32,11,34,22,4,14,97,111
2017,2,21700247,11/20/2017,1610612764,Washington Wizards,0,1,1610612749,Milwaukee Bucks,1,0,30,20,50,9,15,24,39,35,74,12,5,17,11,27,23,10,18,90,99
2016,2,21600801,2/10/2017,1610612759,San Antonio Spurs,0,1,1610612765,Detroit Pistons,1,0,32,31,63,9,10,19,41,41,82,12,3,15,13,30,27,8,20,94,103
2016,2,21600801,2/10/2017,1610612765,Detroit Pistons,1,0,1610612759,San Antonio Spurs,0,1,34,41,75,5,12,17,39,53,92,9,4,13,14,42,22,4,10,94,92
2020,2,22000586,3/13/2021,1610612752,New York Knicks,0,1,1610612760,Oklahoma City Thunder,1,0,30,25,55,14,21,35,44,46,90,17,5,22,13,35,23,3,11,98,119
2020,2,22000586,3/13/2021,1610612760,Oklahoma City Thunder,1,0,1610612752,New York Knicks,0,1,29,15,44,8,24,32,37,39,76,15,6,21,6,36,22,12,18,98,97
2023,2,22300654,1/28/2024,1610612760,Oklahoma City Thunder,0,0,1610612765,Detroit Pistons,1,1,36,28,64,8,20,28,44,48,92,8,4,12,12,38,17,6,10,96,104
2023,2,22300331,12/15/2023,1610612759,San Antonio Spurs,1,1,1610612747,Los Angeles Lakers,0,0,29,24,53,18,24,42,47,48,95,17,2,19,13,35,35,5,9,99,129
2023,2,22300066,10/25/2023,1610612753,Orlando Magic,1,1,1610612745,Houston Rockets,0,0,33,20,53,9,25,34,42,45,87,23,3,26,21,25,19,6,16,96,116
2023,2,22300360,12/19/2023,1610612740,New Orleans Pelicans,1,0,1610612763,Memphis Grizzlies,0,1,29,31,60,11,14,25,40,45,85,22,2,24,12,34,23,5,11,95,113
2020,2,22000269,1/26/2021,1610612745,Houston Rockets,1,1,1610612764,Washington Wizards,0,0,25,26,51,12,25,37,37,51,88,21,8,29,12,43,16,7,14,103,107
2020,2,22000269,1/26/2021,1610612764,Washington Wizards,0,0,1610612745,Houston Rockets,1,1,28,31,59,5,21,26,33,52,85,17,6,23,15,40,19,13,21,103,88
2017,2,21700246,11/20/2017,1610612757,Portland Trail Blazers,0,1,1610612763,Memphis Grizzlies,1,0,27,41,68,6,9,15,33,50,83,28,4,32,20,32,11,6,17,97,100
2017,2,21700246,11/20/2017,1610612763,Memphis Grizzlies,1,0,1610612757,Portland Trail Blazers,0,1,25,31,56,8,22,30,33,53,86,18,5,23,8,49,23,1,8,96,92
2014,2,21400050,11/4/2014,1610612748,Miami Heat,1,0,1610612745,Houston Rockets,0,1,19,27,46,12,16,28,31,43,74,17,10,27,19,29,16,8,19,87,91
2020,2,22000585,3/12/2021,1610612747,Los Angeles Lakers,1,1,1610612754,Indiana Pacers,0,0,27,27,54,7,15,22,34,42,76,30,9,39,10,35,20,7,15,101,105
2020,2,22000585,3/12/2021,1610612754,Indiana Pacers,0,0,1610612747,Los Angeles Lakers,1,1,29,23,52,8,28,36,37,51,88,18,3,21,13,40,22,10,16,100,100
2021,2,22100467,12/21/2021,1610612740,New Orleans Pelicans,1,1,1610612757,Portland Trail Blazers,0,0,30,17,47,12,21,33,42,38,80,15,3,18,12,27,27,12,16,92,111
2021,2,22100467,12/21/2021,1610612757,Portland Trail Blazers,0,0,1610612740,New Orleans Pelicans,1,1,22,22,44,13,21,34,35,43,78,14,5,19,9,38,18,5,11,91,97
2019,2,21900416,12/19/2019,1610612737,Atlanta Hawks,1,0,1610612762,Utah Jazz,0,1,28,33,61,11,18,29,39,51,90,17,2,19,11,41,24,8,16,106,106
2019,2,21900416,12/19/2019,1610612762,Utah Jazz,0,1,1610612737,Atlanta Hawks,1,0,33,26,59,6,18,24,39,44,83,27,11,38,13,37,18,8,19,106,111
2020,2,22001055,5/14/2021,1610612753,Orlando Magic,0,0,1610612755,Philadelphia 76ers,1,1,23,30,53,10,20,30,33,50,83,21,7,28,14,39,21,9,13,95,97
2020,2,22001055,5/14/2021,1610612755,Philadelphia 76ers,1,1,1610612753,Orlando Magic,0,0,28,31,59,16,18,34,44,49,93,18,1,19,15,35,35,4,9,97,122
2020,2,22000584,3/12/2021,1610612745,Houston Rockets,0,0,1610612762,Utah Jazz,1,1,32,37,69,9,34,43,41,71,112,8,5,13,25,48,15,7,11,104,99
2020,2,22000584,3/12/2021,1610612762,Utah Jazz,1,1,1610612745,Houston Rockets,0,0,24,17,41,15,25,40,39,42,81,21,4,25,11,32,24,11,20,103,114
2020,2,22000268,1/26/2021,1610612737,Atlanta Hawks,1,1,1610612746,LA Clippers,0,0,27,27,54,10,16,26,37,43,80,24,1,25,10,34,20,11,14,96,108
2020,2,22000268,1/26/2021,1610612746,LA Clippers,0,0,1610612737,Atlanta Hawks,1,1,28,35,63,8,18,26,36,53,89,19,3,22,15,39,23,7,12,96,99
2017,2,21700245,11/20/2017,1610612746,LA Clippers,0,0,1610612752,New York Knicks,1,1,20,28,48,10,22,32,30,50,80,15,6,21,14,40,20,11,22,97,85
2017,2,21700245,11/20/2017,1610612752,New York Knicks,1,1,1610612746,LA Clippers,0,0,22,25,47,13,21,34,35,46,81,23,1,24,19,27,24,12,22,97,106
2019,2,21900164,11/14/2019,1610612740,New Orleans Pelicans,1,1,1610612746,LA Clippers,0,0,29,35,64,18,16,34,47,51,98,20,9,29,21,34,26,6,14,104,132
2022,2,22200546,12/31/2022,1610612748,Miami Heat,0,1,1610612762,Utah Jazz,1,0,32,18,50,13,26,39,45,44,89,23,7,30,15,34,32,6,12,97,126
2019,2,21900164,11/14/2019,1610612746,LA Clippers,0,0,1610612740,New Orleans Pelicans,1,1,35,25,60,11,13,24,46,38,84,24,7,31,9,33,28,11,16,106,127
2022,2,22200546,12/31/2022,1610612762,Utah Jazz,1,0,1610612748,Miami Heat,0,1,18,23,41,17,23,40,35,46,81,36,8,44,20,28,23,10,16,96,123
2022,2,22200454,12/19/2022,1610612737,Atlanta Hawks,1,1,1610612753,Orlando Magic,0,0,36,26,62,12,20,32,48,46,94,18,2,20,11,37,29,8,10,100,126
2022,2,22200454,12/19/2022,1610612753,Orlando Magic,0,0,1610612737,Atlanta Hawks,1,1,33,28,61,12,22,34,45,50,95,23,2,25,16,36,29,7,8,100,125
2020,2,22000583,3/12/2021,1610612753,Orlando Magic,0,0,1610612759,San Antonio Spurs,1,1,19,23,42,10,28,38,29,51,80,9,3,12,10,43,17,8,20,95,77
2020,2,22000583,3/12/2021,1610612759,San Antonio Spurs,1,1,1610612753,Orlando Magic,0,0,30,30,60,10,19,29,40,49,89,14,4,18,14,37,24,3,11,95,104
2016,2,21600309,12/5/2016,1610612749,Milwaukee Bucks,1,0,1610612759,San Antonio Spurs,0,1,24,25,49,6,18,24,30,43,73,30,4,34,9,36,16,6,14,95,96
2016,2,21600309,12/5/2016,1610612759,San Antonio Spurs,0,1,1610612749,Milwaukee Bucks,1,0,32,33,65,8,20,28,40,53,93,9,5,14,20,38,26,4,15,94,97
2023,2,22300478,1/4/2024,1610612743,Denver Nuggets,0,1,1610612744,Golden State Warriors,1,0,39,20,59,9,17,26,48,37,85,25,4,29,12,26,28,4,9,94,130
2021,2,22100466,12/21/2021,1610612752,New York Knicks,1,1,1610612765,Detroit Pistons,0,0,29,28,57,11,22,33,40,50,90,14,5,19,15,38,22,9,13,98,105
2021,2,22100466,12/21/2021,1610612765,Detroit Pistons,0,0,1610612752,New York Knicks,1,1,26,35,61,8,25,33,34,60,94,15,4,19,20,42,22,5,14,100,91
2017,2,21700244,11/20/2017,1610612755,Philadelphia 76ers,1,1,1610612762,Utah Jazz,0,0,40,30,70,4,11,15,44,41,85,15,7,22,13,31,20,16,20,102,107
2017,2,21700244,11/20/2017,1610612762,Utah Jazz,0,0,1610612755,Philadelphia 76ers,1,1,21,36,57,9,19,28,30,55,85,17,2,19,8,48,18,11,14,100,86
2019,2,21900415,12/18/2019,1610612744,Golden State Warriors,0,0,1610612757,Portland Trail Blazers,1,1,25,40,65,16,22,38,41,62,103,14,9,23,21,44,24,6,8,103,112
2022,2,22201109,3/25/2023,1610612749,Milwaukee Bucks,0,0,1610612743,Denver Nuggets,1,1,30,22,52,9,27,36,39,49,88,19,2,21,6,44,26,4,10,104,106
2019,2,21900415,12/18/2019,1610612757,Portland Trail Blazers,1,1,1610612744,Golden State Warriors,0,0,35,31,66,9,22,31,44,53,97,25,3,28,21,33,19,7,11,103,122
2016,2,21600800,2/10/2017,1610612743,Denver Nuggets,0,1,1610612752,New York Knicks,1,0,38,25,63,16,16,32,54,41,95,7,3,10,20,24,30,10,15,94,131
2016,2,21600800,2/10/2017,1610612752,New York Knicks,1,0,1610612743,Denver Nuggets,0,1,36,19,55,16,22,38,52,41,93,3,2,5,12,29,36,6,11,94,123
2020,2,22001054,5/14/2021,1610612743,Denver Nuggets,0,1,1610612765,Detroit Pistons,1,0,33,21,54,9,23,32,42,44,86,11,3,14,13,32,29,6,12,93,104
2020,2,22001054,5/14/2021,1610612765,Detroit Pistons,1,0,1610612743,Denver Nuggets,0,1,28,18,46,6,31,37,34,49,83,17,6,23,11,42,21,6,10,92,91
2023,2,22300167,11/8/2023,1610612760,Oklahoma City Thunder,1,1,1610612739,Cleveland Cavaliers,0,0,32,26,58,12,16,28,44,42,86,28,2,30,12,31,23,9,14,102,128
2023,2,22300143,11/5/2023,1610612766,Charlotte Hornets,0,0,1610612742,Dallas Mavericks,1,1,41,28,69,8,22,30,49,50,99,12,9,21,17,38,30,3,9,102,118
2014,2,21400448,12/27/2014,1610612751,Brooklyn Nets,1,0,1610612754,Indiana Pacers,0,1,21,31,52,7,18,25,28,49,77,22,5,27,10,40,15,11,16,97,85
2014,2,21400448,12/27/2014,1610612754,Indiana Pacers,0,1,1610612751,Brooklyn Nets,1,0,35,33,68,9,9,18,44,42,86,13,5,18,10,34,33,2,11,97,110
2023,2,22300010,11/10/2023,1610612738,Boston Celtics,1,1,1610612751,Brooklyn Nets,0,0,22,20,42,19,33,52,41,53,94,20,8,28,19,38,29,0,8,96,121
2023,2,22300403,12/25/2023,1610612747,Los Angeles Lakers,1,0,1610612738,Boston Celtics,0,1,30,28,58,13,19,32,43,47,90,16,5,21,15,34,24,8,12,98,115
2021,2,22100465,12/21/2021,1610612748,Miami Heat,1,1,1610612754,Indiana Pacers,0,0,25,21,46,22,27,49,47,48,95,9,2,11,18,32,30,6,11,93,125
2021,2,22100465,12/21/2021,1610612754,Indiana Pacers,0,0,1610612748,Miami Heat,1,1,20,36,56,11,20,31,31,56,87,23,5,28,17,39,22,5,12,94,96
2020,2,22000267,1/25/2021,1610612757,Portland Trail Blazers,1,0,1610612760,Oklahoma City Thunder,0,1,32,25,57,14,27,41,46,52,98,16,5,21,19,36,17,5,9,99,122
2020,2,22000267,1/25/2021,1610612760,Oklahoma City Thunder,0,1,1610612757,Portland Trail Blazers,1,0,25,19,44,18,22,40,43,41,84,21,14,35,10,36,25,6,8,98,125
2017,2,21700243,11/20/2017,1610612753,Orlando Magic,1,0,1610612754,Indiana Pacers,0,1,22,24,46,13,25,38,35,49,84,14,9,23,13,41,23,17,22,104,97
2019,2,21900163,11/14/2019,1610612741,Chicago Bulls,0,0,1610612749,Milwaukee Bucks,1,1,20,30,50,18,25,43,38,55,93,21,4,25,13,42,25,9,20,115,115
2019,2,21900163,11/14/2019,1610612749,Milwaukee Bucks,1,1,1610612741,Chicago Bulls,0,0,36,19,55,6,27,33,42,46,88,34,13,47,18,37,24,14,22,114,124
2017,2,21700243,11/20/2017,1610612754,Indiana Pacers,0,1,1610612753,Orlando Magic,1,0,29,40,69,8,12,20,37,52,89,23,6,29,12,43,25,6,13,103,105
2020,2,22000582,3/12/2021,1610612741,Chicago Bulls,1,0,1610612748,Miami Heat,0,1,19,35,54,15,23,38,34,58,92,7,0,7,15,43,25,11,16,97,90
2020,2,22000582,3/12/2021,1610612748,Miami Heat,0,1,1610612741,Chicago Bulls,1,0,25,20,45,12,23,35,37,43,80,15,5,20,2,43,26,5,10,97,101
2023,2,22300142,11/5/2023,1610612739,Cleveland Cavaliers,1,1,1610612744,Golden State Warriors,0,0,30,16,46,11,26,37,41,42,83,22,6,28,14,30,26,10,18,100,115
2023,2,22301074,3/30/2024,1610612740,New Orleans Pelicans,1,0,1610612738,Boston Celtics,0,1,21,30,51,13,22,35,34,52,86,11,7,18,11,46,22,7,9,91,92
2023,2,22300350,12/18/2023,1610612746,LA Clippers,0,1,1610612754,Indiana Pacers,1,0,37,23,60,19,19,38,56,42,98,20,3,23,18,25,26,6,11,102,151
2023,2,22300431,12/29/2023,1610612737,Atlanta Hawks,1,0,1610612758,Sacramento Kings,0,1,22,29,51,15,28,43,37,57,94,21,4,25,21,37,29,9,15,99,110
2021,2,22100464,2/17/2022,1610612751,Brooklyn Nets,1,0,1610612764,Washington Wizards,0,1,22,29,51,14,24,38,36,53,89,17,7,24,19,37,19,10,16,97,103
2021,2,22100464,2/17/2022,1610612764,Washington Wizards,0,1,1610612751,Brooklyn Nets,1,0,34,25,59,12,12,24,46,37,83,13,3,16,10,30,26,6,16,96,117
2017,2,21700242,11/20/2017,1610612739,Cleveland Cavaliers,0,1,1610612765,Detroit Pistons,1,0,26,21,47,16,17,33,42,38,80,16,1,17,9,29,28,7,11,90,116
2023,2,22300403,12/25/2023,1610612738,Boston Celtics,0,1,1610612747,Los Angeles Lakers,1,0,33,16,49,13,29,42,46,45,91,21,7,28,14,36,31,4,8,97,126
2020,2,22000581,3/12/2021,1610612739,Cleveland Cavaliers,0,0,1610612740,New Orleans Pelicans,1,1,23,33,56,7,25,32,30,58,88,15,5,20,8,52,13,2,7,97,82
2020,2,22000581,3/12/2021,1610612740,New Orleans Pelicans,1,1,1610612739,Cleveland Cavaliers,0,0,41,36,77,6,18,24,47,54,101,16,3,19,26,31,25,8,14,98,116
2023,2,22300959,3/14/2024,1610612742,Dallas Mavericks,0,0,1610612760,Oklahoma City Thunder,1,1,31,24,55,12,17,29,43,41,84,21,5,26,15,28,25,10,19,100,119
2021,2,22100463,12/20/2021,1610612746,LA Clippers,1,0,1610612759,San Antonio Spurs,0,1,25,30,55,9,23,32,34,53,87,15,5,20,11,44,18,11,15,100,92
2021,2,22100463,12/20/2021,1610612759,San Antonio Spurs,0,1,1610612746,LA Clippers,1,0,38,39,77,12,25,37,50,64,114,4,2,6,29,36,37,6,12,100,116
2020,2,22000266,1/25/2021,1610612744,Golden State Warriors,1,1,1610612750,Minnesota Timberwolves,0,0,30,29,59,14,16,30,44,45,89,28,9,37,16,34,21,8,15,103,130
2020,2,22000266,1/25/2021,1610612750,Minnesota Timberwolves,0,0,1610612744,Golden State Warriors,1,1,31,39,70,8,16,24,39,55,94,22,3,25,21,35,26,13,18,104,108
2019,2,21900414,12/18/2019,1610612743,Denver Nuggets,1,1,1610612753,Orlando Magic,0,0,29,28,57,11,16,27,40,44,84,22,3,25,17,28,28,9,19,97,113
2019,2,21900414,12/18/2019,1610612753,Orlando Magic,0,0,1610612743,Denver Nuggets,1,1,26,32,58,11,18,29,37,50,87,19,2,21,13,39,25,8,13,98,104
2017,2,21700242,11/20/2017,1610612765,Detroit Pistons,1,0,1610612739,Cleveland Cavaliers,0,1,21,26,47,13,17,30,34,43,77,7,6,13,9,37,23,4,14,91,88
2023,2,22300315,12/13/2023,1610612749,Milwaukee Bucks,1,1,1610612754,Indiana Pacers,0,0,41,21,62,7,20,27,48,41,89,37,11,48,17,31,27,7,16,108,140
2022,2,22200456,12/19/2022,1610612742,Dallas Mavericks,0,0,1610612750,Minnesota Timberwolves,1,1,12,19,31,19,26,45,31,45,76,25,6,31,11,36,23,5,16,97,106
2022,2,22200456,12/19/2022,1610612750,Minnesota Timberwolves,1,1,1610612742,Dallas Mavericks,0,0,30,28,58,12,19,31,42,47,89,20,4,24,12,38,19,5,11,96,116
2020,2,22000580,3/12/2021,1610612743,Denver Nuggets,0,1,1610612763,Memphis Grizzlies,1,0,28,27,55,13,24,37,41,51,92,8,3,11,14,38,27,6,12,97,103
2020,2,22000580,3/12/2021,1610612763,Memphis Grizzlies,1,0,1610612743,Denver Nuggets,0,1,26,33,59,14,14,28,40,47,87,8,0,8,11,36,27,10,17,96,102
2016,2,21600308,12/5/2016,1610612741,Chicago Bulls,1,0,1610612757,Portland Trail Blazers,0,1,28,32,60,7,16,23,35,48,83,33,5,38,19,32,16,9,15,96,110
2016,2,21600308,12/5/2016,1610612757,Portland Trail Blazers,0,1,1610612741,Chicago Bulls,1,0,36,33,69,9,15,24,45,48,93,13,5,18,14,36,25,8,10,97,112
2023,2,22300465,1/3/2024,1610612739,Cleveland Cavaliers,1,1,1610612764,Washington Wizards,0,0,34,25,59,20,22,42,54,47,101,12,4,16,25,25,37,8,11,96,140
2023,2,22300932,3/10/2024,1610612750,Minnesota Timberwolves,0,0,1610612747,Los Angeles Lakers,1,1,25,26,51,16,30,46,41,56,97,11,2,13,15,42,27,9,12,100,109
2020,2,22000265,1/25/2021,1610612742,Dallas Mavericks,1,0,1610612743,Denver Nuggets,0,1,30,22,52,11,21,32,41,43,84,20,4,24,10,35,26,9,11,95,113
2020,2,22000265,1/25/2021,1610612743,Denver Nuggets,0,1,1610612742,Dallas Mavericks,1,0,25,19,44,15,20,35,40,39,79,22,6,28,16,27,25,11,18,95,117
2019,2,21900413,12/18/2019,1610612738,Boston Celtics,0,1,1610612742,Dallas Mavericks,1,0,23,25,48,12,26,38,35,51,86,27,3,30,18,34,13,7,16,97,109
2019,2,21900413,12/18/2019,1610612742,Dallas Mavericks,1,0,1610612738,Boston Celtics,0,1,19,25,44,15,28,43,34,53,87,20,5,25,10,45,23,3,8,97,103
2020,2,22000579,3/12/2021,1610612755,Philadelphia 76ers,0,1,1610612764,Washington Wizards,1,0,38,31,69,11,10,21,49,41,90,18,0,18,12,29,26,10,17,104,127
2020,2,22000579,3/12/2021,1610612764,Washington Wizards,1,0,1610612755,Philadelphia 76ers,0,1,32,26,58,8,16,24,40,42,82,13,9,22,8,40,19,13,18,103,101
2023,2,22300173,11/11/2023,1610612753,Orlando Magic,1,1,1610612749,Milwaukee Bucks,0,0,26,32,58,10,16,26,36,48,84,30,5,35,17,33,24,9,16,99,112
2021,2,22100462,12/20/2021,1610612744,Golden State Warriors,1,1,1610612758,Sacramento Kings,0,0,31,20,51,15,22,37,46,42,88,6,3,9,11,32,28,10,16,97,113
2021,2,22100462,12/20/2021,1610612758,Sacramento Kings,0,0,1610612744,Golden State Warriors,1,1,24,27,51,13,19,32,37,46,83,11,5,16,15,34,23,12,21,97,98
2020,2,22000264,4/24/2021,1610612740,New Orleans Pelicans,1,0,1610612759,San Antonio Spurs,0,1,32,33,65,9,13,22,41,46,87,17,15,32,14,39,20,9,20,106,108
2020,2,22000264,4/24/2021,1610612759,San Antonio Spurs,0,1,1610612740,New Orleans Pelicans,1,0,28,26,54,9,22,31,37,48,85,27,5,32,12,40,22,12,17,107,110
2019,2,21900410,12/18/2019,1610612748,Miami Heat,0,1,1610612755,Philadelphia 76ers,1,0,28,26,54,12,19,31,40,45,85,16,4,20,14,32,26,9,16,96,108
2019,2,21900410,12/18/2019,1610612755,Philadelphia 76ers,1,0,1610612748,Miami Heat,0,1,26,25,51,12,27,39,38,52,90,16,2,18,15,39,24,6,13,95,104
2019,2,21900162,11/14/2019,1610612742,Dallas Mavericks,0,0,1610612752,New York Knicks,1,1,28,20,48,8,28,36,36,48,84,23,8,31,13,41,21,6,12,95,103
2019,2,21900162,11/14/2019,1610612752,New York Knicks,1,1,1610612742,Dallas Mavericks,0,0,29,35,64,13,17,30,42,52,94,9,2,11,20,33,20,8,15,94,106
2017,2,21700241,11/20/2017,1610612750,Minnesota Timberwolves,0,0,1610612766,Charlotte Hornets,1,1,31,32,63,6,21,27,37,53,90,22,4,26,12,43,13,5,11,100,102
2017,2,21700241,11/20/2017,1610612766,Charlotte Hornets,1,1,1610612750,Minnesota Timberwolves,0,0,31,28,59,11,15,26,42,43,85,23,6,29,16,32,22,8,17,100,118
2016,2,21600799,2/10/2017,1610612748,Miami Heat,0,1,1610612751,Brooklyn Nets,1,0,34,35,69,7,16,23,41,51,92,19,2,21,16,35,16,4,14,98,108
2016,2,21600799,2/10/2017,1610612751,Brooklyn Nets,1,0,1610612748,Miami Heat,0,1,27,34,61,8,12,20,35,46,81,21,7,28,17,36,19,11,22,98,99
2020,2,22000578,3/11/2021,1610612745,Houston Rockets,0,0,1610612758,Sacramento Kings,1,1,30,24,54,11,34,45,41,58,99,12,5,17,15,45,24,11,13,106,105
2020,2,22000578,3/11/2021,1610612758,Sacramento Kings,1,1,1610612745,Houston Rockets,0,0,34,25,59,11,22,33,45,47,92,24,4,28,13,35,25,7,15,106,125
2016,2,21600307,12/5/2016,1610612737,Atlanta Hawks,1,0,1610612760,Oklahoma City Thunder,0,1,27,28,55,7,15,22,34,43,77,24,8,32,10,38,26,9,18,100,99
2016,2,21600307,12/5/2016,1610612760,Oklahoma City Thunder,0,1,1610612737,Atlanta Hawks,1,0,27,22,49,10,21,31,37,43,80,18,10,28,12,35,26,13,19,100,102
2014,2,21400049,11/4/2014,1610612749,Milwaukee Bucks,0,1,1610612754,Indiana Pacers,1,0,30,32,62,7,14,21,37,46,83,6,1,7,14,33,20,4,13,87,87
2014,2,21400049,11/4/2014,1610612754,Indiana Pacers,1,0,1610612749,Milwaukee Bucks,0,1,25,29,54,6,18,24,31,47,78,13,9,22,20,30,14,12,19,86,81
2022,2,22201109,3/25/2023,1610612743,Denver Nuggets,1,1,1610612749,Milwaukee Bucks,0,0,32,21,53,15,21,36,47,42,89,20,8,28,9,37,28,7,12,104,129
2023,2,22300167,11/8/2023,1610612739,Cleveland Cavaliers,0,0,1610612760,Oklahoma City Thunder,1,1,33,21,54,9,20,29,42,41,83,27,10,37,16,30,26,10,20,103,120
2023,2,22300314,12/13/2023,1610612745,Houston Rockets,1,1,1610612763,Memphis Grizzlies,0,0,27,27,54,12,20,32,39,47,86,27,10,37,18,38,23,7,19,102,117
2023,2,22300144,11/5/2023,1610612763,Memphis Grizzlies,0,1,1610612757,Portland Trail Blazers,1,0,32,25,57,13,19,32,45,44,89,9,4,13,12,34,27,11,17,99,112
2020,2,22000263,5/14/2021,1610612758,Sacramento Kings,0,0,1610612763,Memphis Grizzlies,1,1,27,27,54,10,32,42,37,59,96,22,5,27,18,42,21,8,10,105,106
2020,2,22000263,5/14/2021,1610612763,Memphis Grizzlies,1,1,1610612758,Sacramento Kings,0,0,26,25,51,11,22,33,37,47,84,22,13,35,10,44,23,7,13,103,107
2019,2,21900411,12/18/2019,1610612740,New Orleans Pelicans,0,1,1610612750,Minnesota Timberwolves,1,0,24,29,53,14,19,33,38,48,86,17,4,21,14,36,23,9,19,100,107
2019,2,21900411,12/18/2019,1610612750,Minnesota Timberwolves,1,0,1610612740,New Orleans Pelicans,0,1,26,30,56,10,29,39,36,59,95,17,10,27,16,47,20,6,11,101,99
2017,2,21700240,11/19/2017,1610612743,Denver Nuggets,0,0,1610612747,Los Angeles Lakers,1,1,23,30,53,13,18,31,36,48,84,24,11,35,20,33,18,11,20,102,109
2023,2,22300314,12/13/2023,1610612763,Memphis Grizzlies,0,0,1610612745,Houston Rockets,1,1,25,19,44,10,28,38,35,47,82,24,10,34,6,44,25,6,11,102,104
2023,2,22300331,12/15/2023,1610612747,Los Angeles Lakers,0,0,1610612759,San Antonio Spurs,1,1,32,21,53,11,25,36,43,46,89,18,10,28,11,38,32,5,6,99,115
2023,2,22300126,11/1/2023,1610612744,Golden State Warriors,1,1,1610612758,Sacramento Kings,0,0,28,22,50,11,20,31,39,42,81,13,2,15,9,35,32,8,18,96,102
2023,2,22300432,12/29/2023,1610612738,Boston Celtics,1,1,1610612761,Toronto Raptors,0,0,26,23,49,17,22,39,43,45,88,17,3,20,16,31,29,10,16,97,120
2021,2,22100461,12/20/2021,1610612762,Utah Jazz,1,1,1610612766,Charlotte Hornets,0,0,18,25,43,16,37,53,34,62,96,28,9,37,25,43,21,7,17,105,112
2021,2,22100461,12/20/2021,1610612766,Charlotte Hornets,0,0,1610612762,Utah Jazz,1,1,24,34,58,15,28,43,39,62,101,9,0,9,14,48,27,4,13,104,102
2020,2,22000262,1/25/2021,1610612738,Boston Celtics,0,1,1610612741,Chicago Bulls,1,0,29,29,58,15,14,29,44,43,87,16,4,20,9,35,28,4,13,100,119
2023,2,22300375,12/21/2023,1610612739,Cleveland Cavaliers,1,0,1610612740,New Orleans Pelicans,0,1,24,19,43,17,27,44,41,46,87,5,3,8,10,37,34,7,12,92,104
2020,2,22000262,1/25/2021,1610612741,Chicago Bulls,1,0,1610612738,Boston Celtics,0,1,24,25,49,17,22,39,41,47,88,4,6,10,13,38,28,9,19,98,103
2019,2,21900412,12/18/2019,1610612760,Oklahoma City Thunder,1,1,1610612763,Memphis Grizzlies,0,0,39,21,60,7,17,24,46,38,84,27,7,34,9,32,25,5,12,103,126
2019,2,21900412,12/18/2019,1610612763,Memphis Grizzlies,0,0,1610612760,Oklahoma City Thunder,1,1,40,33,73,10,16,26,50,49,99,12,3,15,19,31,27,6,15,103,122
2019,2,21900161,11/14/2019,1610612739,Cleveland Cavaliers,1,0,1610612748,Miami Heat,0,1,28,25,53,8,24,32,36,49,85,17,4,21,13,38,18,10,18,98,97
2019,2,21900161,11/14/2019,1610612748,Miami Heat,0,1,1610612739,Cleveland Cavaliers,1,0,31,18,49,12,18,30,43,36,79,10,1,11,7,30,31,14,19,97,108
2017,2,21700240,11/19/2017,1610612747,Los Angeles Lakers,1,1,1610612743,Denver Nuggets,0,0,41,27,68,12,20,32,53,47,100,9,7,16,19,32,36,8,15,102,127
2014,2,21400048,11/3/2014,1610612746,LA Clippers,1,1,1610612762,Utah Jazz,0,0,31,27,58,10,13,23,41,40,81,15,2,17,6,35,28,4,10,92,107
2022,2,22200459,12/19/2022,1610612747,Los Angeles Lakers,0,0,1610612756,Phoenix Suns,1,1,27,32,59,12,16,28,39,48,87,14,3,17,14,36,13,10,15,96,104
2022,2,22200459,12/19/2022,1610612756,Phoenix Suns,1,1,1610612747,Los Angeles Lakers,0,0,26,28,54,20,19,39,46,47,93,18,6,24,18,31,21,5,9,96,130
2020,2,22000577,3/11/2021,1610612756,Phoenix Suns,0,1,1610612757,Portland Trail Blazers,1,0,36,23,59,13,11,24,49,34,83,16,3,19,7,28,28,8,13,96,127
2020,2,22000577,3/11/2021,1610612757,Portland Trail Blazers,1,0,1610612756,Phoenix Suns,0,1,25,26,51,18,25,43,43,51,94,17,2,19,17,36,26,6,11,96,121
2021,2,22100460,12/20/2021,1610612760,Oklahoma City Thunder,0,1,1610612763,Memphis Grizzlies,1,0,25,21,46,11,27,38,36,48,84,19,9,28,14,38,24,9,14,97,102
2021,2,22100460,12/20/2021,1610612763,Memphis Grizzlies,1,0,1610612760,Oklahoma City Thunder,0,1,28,41,69,11,21,32,39,62,101,10,3,13,21,43,24,7,12,98,99
2023,2,22300143,11/5/2023,1610612742,Dallas Mavericks,1,1,1610612766,Charlotte Hornets,0,0,29,20,49,14,28,42,43,48,91,24,8,32,14,39,31,5,11,103,124
2017,2,21700239,11/19/2017,1610612741,Chicago Bulls,0,0,1610612756,Phoenix Suns,1,1,30,35,65,12,24,36,42,59,101,9,5,14,17,44,20,5,13,103,105
2017,2,21700239,11/19/2017,1610612756,Phoenix Suns,1,1,1610612741,Chicago Bulls,0,0,38,24,62,7,20,27,45,44,89,16,6,22,10,37,32,5,11,102,113
2014,2,21401022,3/20/2015,1610612749,Milwaukee Bucks,0,0,1610612751,Brooklyn Nets,1,1,41,72,113,8,8,16,49,80,129,21,8,29,42,43,23,9,18,119,127
2022,2,22200461,12/20/2022,1610612762,Utah Jazz,0,1,1610612765,Detroit Pistons,1,0,27,20,47,20,26,46,47,46,93,12,7,19,17,34,27,6,12,95,126
2022,2,22200461,12/20/2022,1610612765,Detroit Pistons,1,0,1610612762,Utah Jazz,0,1,32,24,56,9,16,25,41,40,81,20,7,27,12,32,22,7,14,94,111
2023,2,22300329,12/15/2023,1610612753,Orlando Magic,0,0,1610612738,Boston Celtics,1,1,28,24,52,14,21,35,42,45,87,13,5,18,20,28,25,14,21,97,111
2018,2,21801101,3/24/2019,1610612744,Golden State Warriors,1,1,1610612765,Detroit Pistons,0,0,33,16,49,13,12,25,46,28,74,16,3,19,8,21,31,6,16,91,121
2023,2,22300316,12/13/2023,1610612747,Los Angeles Lakers,0,1,1610612759,San Antonio Spurs,1,0,35,21,56,14,21,35,49,42,91,10,7,17,7,39,31,8,16,109,122
2023,2,22300433,12/29/2023,1610612749,Milwaukee Bucks,0,1,1610612739,Cleveland Cavaliers,1,0,29,22,51,12,17,29,41,39,80,25,3,28,9,31,26,11,17,102,119
2018,2,21801101,3/24/2019,1610612765,Detroit Pistons,0,0,1610612744,Golden State Warriors,1,1,27,26,53,12,19,31,39,45,84,24,1,25,14,31,25,3,8,92,114
2023,2,22300144,11/5/2023,1610612757,Portland Trail Blazers,1,0,1610612763,Memphis Grizzlies,0,1,23,27,50,14,31,45,37,58,95,12,3,15,20,39,23,6,14,97,100
2021,2,22100459,12/20/2021,1610612741,Chicago Bulls,1,1,1610612745,Houston Rockets,0,0,31,22,53,16,19,35,47,41,88,23,1,24,14,28,33,4,8,93,133
2021,2,22100459,12/20/2021,1610612745,Houston Rockets,0,0,1610612741,Chicago Bulls,1,1,32,13,45,12,21,33,44,34,78,18,6,24,10,27,27,7,14,93,118
2020,2,22000261,1/25/2021,1610612739,Cleveland Cavaliers,1,0,1610612747,Los Angeles Lakers,0,1,31,34,65,9,12,21,40,46,86,19,3,22,17,29,19,7,17,96,108
2020,2,22000261,1/25/2021,1610612747,Los Angeles Lakers,0,1,1610612739,Cleveland Cavaliers,1,0,32,23,55,10,22,32,42,45,87,21,7,28,17,32,21,8,14,97,115
2014,2,21400048,11/3/2014,1610612762,Utah Jazz,0,0,1610612746,LA Clippers,1,1,26,24,50,10,17,27,36,41,77,19,5,24,13,30,24,6,17,94,101
2014,2,21401022,3/20/2015,1610612751,Brooklyn Nets,1,1,1610612749,Milwaukee Bucks,0,0,35,47,82,11,14,25,46,61,107,26,8,34,18,44,31,11,15,120,129
2014,2,21400447,12/27/2014,1610612740,New Orleans Pelicans,0,0,1610612741,Chicago Bulls,1,1,37,37,74,4,10,14,41,47,88,14,2,16,18,30,18,8,15,93,100
2020,2,22000576,3/11/2021,1610612744,Golden State Warriors,0,0,1610612746,LA Clippers,1,1,29,23,52,9,27,36,38,50,88,19,8,27,8,46,20,10,16,109,104
2020,2,22000576,3/11/2021,1610612746,LA Clippers,1,1,1610612744,Golden State Warriors,0,0,26,29,55,18,23,41,44,52,96,24,5,29,13,42,23,6,11,108,130
2014,2,21400447,12/27/2014,1610612741,Chicago Bulls,1,1,1610612740,New Orleans Pelicans,0,0,35,34,69,6,14,20,41,48,89,19,3,22,21,28,19,9,14,92,107
2017,2,21700238,11/19/2017,1610612750,Minnesota Timberwolves,1,0,1610612765,Detroit Pistons,0,1,35,21,56,5,17,22,40,38,78,12,6,18,11,30,23,10,21,96,97
2017,2,21700238,11/19/2017,1610612765,Detroit Pistons,0,1,1610612750,Minnesota Timberwolves,1,0,31,27,58,8,17,25,39,44,83,14,6,20,14,34,25,11,19,97,100
2019,2,21900409,12/18/2019,1610612741,Chicago Bulls,0,1,1610612764,Washington Wizards,1,0,28,32,60,11,26,37,39,58,97,21,3,24,15,45,25,8,15,107,110
2019,2,21900409,12/18/2019,1610612764,Washington Wizards,1,0,1610612741,Chicago Bulls,0,1,20,30,50,14,31,45,34,61,95,27,5,32,19,43,21,10,16,107,109
2019,2,21900160,11/13/2019,1610612757,Portland Trail Blazers,1,0,1610612761,Toronto Raptors,0,1,21,27,48,17,31,48,38,58,96,13,3,16,19,40,24,4,12,99,106
2019,2,21900160,11/13/2019,1610612761,Toronto Raptors,0,1,1610612757,Portland Trail Blazers,1,0,28,32,60,14,18,32,42,50,92,16,1,17,17,34,20,3,14,98,114
2016,2,21600306,12/5/2016,1610612751,Brooklyn Nets,1,0,1610612764,Washington Wizards,0,1,29,25,54,11,16,27,40,41,81,22,8,30,15,29,25,17,22,101,113
2016,2,21600306,12/5/2016,1610612764,Washington Wizards,0,1,1610612751,Brooklyn Nets,1,0,31,27,58,14,20,34,45,47,92,14,4,18,11,37,26,5,10,102,118
2020,2,22000575,3/11/2021,1610612742,Dallas Mavericks,0,0,1610612760,Oklahoma City Thunder,1,1,20,28,48,15,19,34,35,47,82,23,10,33,10,41,20,2,6,94,108
2020,2,22000575,3/11/2021,1610612760,Oklahoma City Thunder,1,1,1610612742,Dallas Mavericks,0,0,25,34,59,16,16,32,41,50,91,18,2,20,18,33,25,4,9,92,116
2018,2,21801100,3/24/2019,1610612738,Boston Celtics,1,0,1610612759,San Antonio Spurs,0,1,31,28,59,7,28,35,38,56,94,13,3,16,15,42,23,1,8,97,96
2018,2,21801100,3/24/2019,1610612759,San Antonio Spurs,0,1,1610612738,Boston Celtics,1,0,42,32,74,8,16,24,50,48,98,7,1,8,13,35,32,4,8,95,115
2018,2,21800959,3/5/2019,1610612741,Chicago Bulls,0,0,1610612754,Indiana Pacers,1,1,32,36,68,4,21,25,36,57,93,20,4,24,19,41,16,6,10,95,96
2018,2,21800959,3/5/2019,1610612754,Indiana Pacers,1,1,1610612741,Chicago Bulls,0,0,27,32,59,11,14,25,38,46,84,18,6,24,15,36,19,7,12,95,105
2021,2,22100458,3/4/2022,1610612753,Orlando Magic,0,1,1610612761,Toronto Raptors,1,0,25,33,58,11,26,37,36,59,95,20,1,21,16,43,24,2,11,100,103
2021,2,22100458,3/4/2022,1610612761,Toronto Raptors,1,0,1610612753,Orlando Magic,0,1,25,31,56,12,25,37,37,56,93,11,6,17,13,46,22,5,12,100,97
2020,2,22000260,1/25/2021,1610612748,Miami Heat,0,0,1610612751,Brooklyn Nets,1,1,20,21,41,11,32,43,31,53,84,12,5,17,12,45,20,6,14,94,85
2020,2,22000260,1/25/2021,1610612751,Brooklyn Nets,1,1,1610612748,Miami Heat,0,0,23,24,47,11,27,38,34,51,85,19,3,22,10,41,24,3,9,93,98
2017,2,21700237,11/19/2017,1610612761,Toronto Raptors,1,1,1610612764,Washington Wizards,0,0,30,21,51,10,29,39,40,50,90,10,4,14,15,37,20,5,8,90,100
2017,2,21700237,11/19/2017,1610612764,Washington Wizards,0,0,1610612761,Toronto Raptors,1,1,23,39,62,11,8,19,34,47,81,12,9,21,15,38,20,8,14,90,91
2016,2,21600798,2/9/2017,1610612738,Boston Celtics,0,1,1610612757,Portland Trail Blazers,1,0,34,27,61,10,20,30,44,47,91,22,5,27,17,33,23,4,8,95,120
2020,2,22001051,5/13/2021,1610612741,Chicago Bulls,1,1,1610612761,Toronto Raptors,0,0,28,19,47,17,19,36,45,38,83,7,3,10,11,27,31,16,19,97,114
2020,2,22001051,5/13/2021,1610612761,Toronto Raptors,0,0,1610612741,Chicago Bulls,1,1,28,26,54,12,24,36,40,50,90,10,8,18,10,45,24,4,11,98,102
2020,2,22000574,3/11/2021,1610612740,New Orleans Pelicans,1,0,1610612750,Minnesota Timberwolves,0,1,37,31,68,6,26,32,43,57,100,13,11,24,28,34,28,11,18,101,105
2020,2,22000574,3/11/2021,1610612750,Minnesota Timberwolves,0,1,1610612740,New Orleans Pelicans,1,0,32,23,55,19,21,40,51,44,95,14,2,16,12,34,28,7,12,102,135
2023,2,22300227,11/22/2023,1610612751,Brooklyn Nets,0,0,1610612737,Atlanta Hawks,1,1,40,38,78,15,20,35,55,58,113,20,4,24,24,37,28,10,16,116,145
2023,2,22300375,12/21/2023,1610612740,New Orleans Pelicans,0,1,1610612739,Cleveland Cavaliers,1,0,32,19,51,15,20,35,47,39,86,14,2,16,11,30,32,4,9,93,123
2021,2,22100457,12/20/2021,1610612738,Boston Celtics,1,0,1610612755,Philadelphia 76ers,0,1,31,24,55,7,20,27,38,44,82,20,5,25,14,32,16,11,18,101,103
2021,2,22100457,12/20/2021,1610612755,Philadelphia 76ers,0,1,1610612738,Boston Celtics,1,0,26,21,47,10,15,25,36,36,72,26,5,31,4,32,20,9,17,100,108
2020,2,22000259,1/25/2021,1610612753,Orlando Magic,1,1,1610612766,Charlotte Hornets,0,0,23,28,51,19,18,37,42,46,88,14,8,22,14,36,31,5,16,103,117
2020,2,22000259,1/25/2021,1610612766,Charlotte Hornets,0,0,1610612753,Orlando Magic,1,1,28,23,51,11,27,38,39,50,89,19,8,27,13,41,22,10,14,103,108
2019,2,21900408,12/18/2019,1610612761,Toronto Raptors,0,1,1610612765,Detroit Pistons,1,0,26,30,56,13,22,35,39,52,91,21,3,24,14,40,27,7,12,100,112
2019,2,21900408,12/18/2019,1610612765,Detroit Pistons,1,0,1610612761,Toronto Raptors,0,1,33,19,52,6,29,35,39,48,87,15,7,22,12,40,19,9,15,100,99
2014,2,21400047,11/3/2014,1610612743,Denver Nuggets,1,0,1610612758,Sacramento Kings,0,1,31,38,69,5,19,24,36,57,93,28,5,33,20,39,22,8,15,104,105
2016,2,21600798,2/9/2017,1610612757,Portland Trail Blazers,1,0,1610612738,Boston Celtics,0,1,30,21,51,9,17,26,39,38,77,24,7,31,12,29,23,8,16,96,111
2020,2,22001052,5/13/2021,1610612743,Denver Nuggets,0,1,1610612750,Minnesota Timberwolves,1,0,34,26,60,12,24,36,46,50,96,10,1,11,18,32,30,3,14,97,114
2020,2,22001052,5/13/2021,1610612750,Minnesota Timberwolves,1,0,1610612743,Denver Nuggets,0,1,18,21,39,16,25,41,34,46,80,19,13,32,12,40,20,6,15,98,103
2020,2,22000573,3/11/2021,1610612749,Milwaukee Bucks,1,1,1610612752,New York Knicks,0,0,32,17,49,18,20,38,50,37,87,16,1,17,7,30,29,3,12,99,134
2020,2,22000573,3/11/2021,1610612752,New York Knicks,0,0,1610612749,Milwaukee Bucks,1,1,24,27,51,13,24,37,37,51,88,14,7,21,14,40,19,9,15,101,101
2021,2,22100456,12/19/2021,1610612756,Phoenix Suns,1,1,1610612766,Charlotte Hornets,0,0,34,20,54,20,21,41,54,41,95,9,4,13,12,30,35,12,18,106,137
2021,2,22100456,12/19/2021,1610612766,Charlotte Hornets,0,0,1610612756,Phoenix Suns,1,1,26,29,55,10,35,45,36,64,100,24,4,28,18,49,26,5,9,107,106
2020,2,22000258,1/25/2021,1610612754,Indiana Pacers,1,1,1610612761,Toronto Raptors,0,0,28,21,49,12,17,29,40,38,78,37,8,45,13,28,26,9,15,103,129
2020,2,22000258,1/25/2021,1610612761,Toronto Raptors,0,0,1610612754,Indiana Pacers,1,1,24,31,55,14,24,38,38,55,93,24,3,27,17,40,24,5,12,104,114
2019,2,21900159,11/13/2019,1610612744,Golden State Warriors,0,0,1610612747,Los Angeles Lakers,1,1,27,27,54,9,26,35,36,53,89,13,4,17,16,40,29,8,17,99,94
2019,2,21900159,11/13/2019,1610612747,Los Angeles Lakers,1,1,1610612744,Golden State Warriors,0,0,39,30,69,9,11,20,48,41,89,15,3,18,20,24,31,8,19,99,120
2017,2,21700236,11/19/2017,1610612744,Golden State Warriors,0,1,1610612751,Brooklyn Nets,1,0,36,30,66,10,14,24,46,44,90,16,7,23,9,40,29,7,15,108,118
2017,2,21700236,11/19/2017,1610612751,Brooklyn Nets,1,0,1610612744,Golden State Warriors,0,1,18,29,47,16,32,48,34,61,95,27,12,39,17,52,24,8,13,108,111
2014,2,21400047,11/3/2014,1610612758,Sacramento Kings,0,1,1610612743,Denver Nuggets,1,0,32,40,72,2,7,9,34,47,81,40,7,47,19,31,21,4,18,103,110
2020,2,22001053,5/13/2021,1610612756,Phoenix Suns,1,1,1610612757,Portland Trail Blazers,0,0,28,28,56,13,19,32,41,47,88,23,3,26,14,34,22,7,11,98,118
2020,2,22001053,5/13/2021,1610612757,Portland Trail Blazers,0,0,1610612756,Phoenix Suns,1,1,29,19,48,15,18,33,44,37,81,14,4,18,6,33,23,4,13,97,117
2014,2,21400446,12/27/2014,1610612748,Miami Heat,1,0,1610612763,Memphis Grizzlies,0,1,31,21,52,6,14,20,37,35,72,15,6,21,12,27,18,10,16,87,95
2014,2,21400446,12/27/2014,1610612763,Memphis Grizzlies,0,1,1610612748,Miami Heat,1,0,27,30,57,7,9,16,34,39,73,28,9,37,18,26,22,10,14,87,103
2021,2,22100455,12/19/2021,1610612742,Dallas Mavericks,0,0,1610612750,Minnesota Timberwolves,1,1,24,17,41,12,29,41,36,46,82,21,1,22,11,36,27,6,12,92,105
2021,2,22100455,12/19/2021,1610612750,Minnesota Timberwolves,1,1,1610612742,Dallas Mavericks,0,0,21,22,43,15,19,34,36,41,77,24,7,31,9,37,26,5,9,93,111
2020,2,22000257,1/25/2021,1610612755,Philadelphia 76ers,0,0,1610612765,Detroit Pistons,1,1,31,35,66,9,19,28,40,54,94,15,5,20,16,39,15,6,9,95,104
2020,2,22000257,1/25/2021,1610612765,Detroit Pistons,1,1,1610612755,Philadelphia 76ers,0,0,18,14,32,17,21,38,35,35,70,32,6,38,12,26,22,12,19,95,119
2017,2,21700235,11/19/2017,1610612748,Miami Heat,1,0,1610612754,Indiana Pacers,0,1,22,24,46,13,24,37,35,48,83,12,2,14,15,34,21,9,16,92,95
2017,2,21700235,11/19/2017,1610612754,Indiana Pacers,0,1,1610612748,Miami Heat,1,0,40,22,62,11,12,23,51,34,85,7,1,8,9,25,33,8,14,93,120
2016,2,21600797,2/9/2017,1610612742,Dallas Mavericks,1,1,1610612762,Utah Jazz,0,0,39,28,67,5,15,20,44,43,87,19,6,25,12,35,21,8,12,100,112
2016,2,21600797,2/9/2017,1610612762,Utah Jazz,0,0,1610612742,Dallas Mavericks,1,1,26,30,56,13,16,29,39,46,85,14,3,17,13,35,26,12,21,100,105
2014,2,21400046,11/3/2014,1610612738,Boston Celtics,0,0,1610612742,Dallas Mavericks,1,1,34,37,71,11,20,31,45,57,102,12,4,16,28,31,29,5,17,99,113
2014,2,21400046,11/3/2014,1610612742,Dallas Mavericks,1,1,1610612738,Boston Celtics,0,0,30,27,57,14,11,25,44,38,82,16,4,20,10,30,24,9,18,99,118
2020,2,22000572,3/11/2021,1610612741,Chicago Bulls,1,0,1610612755,Philadelphia 76ers,0,1,25,29,54,14,15,29,39,44,83,13,3,16,10,35,26,11,19,101,105
2020,2,22000572,3/11/2021,1610612755,Philadelphia 76ers,0,1,1610612741,Chicago Bulls,1,0,43,27,70,10,23,33,53,50,103,11,4,15,19,33,25,3,11,101,127
2023,2,22300265,11/30/2023,1610612739,Cleveland Cavaliers,1,0,1610612757,Portland Trail Blazers,0,1,31,26,57,7,25,32,38,51,89,12,0,12,20,31,25,10,19,94,95
2023,2,22300347,12/17/2023,1610612756,Phoenix Suns,1,1,1610612764,Washington Wizards,0,0,34,25,59,7,24,31,41,49,90,23,7,30,19,36,29,8,17,104,112
2023,2,22300354,12/18/2023,1610612766,Charlotte Hornets,0,0,1610612761,Toronto Raptors,1,1,31,26,57,8,24,32,39,50,89,13,0,13,14,36,18,4,13,96,99
2021,2,22100454,1/25/2022,1610612740,New Orleans Pelicans,0,0,1610612755,Philadelphia 76ers,1,1,31,30,61,9,13,22,40,43,83,18,8,26,12,33,26,4,8,90,107
2021,2,22100454,1/25/2022,1610612755,Philadelphia 76ers,1,1,1610612740,New Orleans Pelicans,0,0,29,24,53,10,21,31,39,45,84,29,2,31,18,28,26,5,11,90,117
2020,2,22000256,1/24/2021,1610612752,New York Knicks,0,0,1610612757,Portland Trail Blazers,1,1,27,30,57,12,17,29,39,47,86,23,2,25,14,34,20,5,12,95,113
2020,2,22000256,1/24/2021,1610612757,Portland Trail Blazers,1,1,1610612752,New York Knicks,0,0,22,15,37,17,29,46,39,44,83,21,2,23,10,36,19,9,11,95,116
2019,2,21900407,12/18/2019,1610612739,Cleveland Cavaliers,1,1,1610612766,Charlotte Hornets,0,0,33,15,48,7,19,26,40,34,74,13,4,17,17,20,25,12,25,89,100
2019,2,21900407,12/18/2019,1610612766,Charlotte Hornets,0,0,1610612739,Cleveland Cavaliers,1,1,24,30,54,13,24,37,37,54,91,11,7,18,16,41,25,7,9,91,98
2017,2,21700234,11/18/2017,1610612757,Portland Trail Blazers,1,1,1610612758,Sacramento Kings,0,0,28,21,49,10,11,21,38,32,70,16,5,21,5,29,19,9,18,94,102
2017,2,21700234,11/18/2017,1610612758,Sacramento Kings,0,0,1610612757,Portland Trail Blazers,1,1,26,46,72,8,9,17,34,55,89,14,4,18,14,42,14,6,11,96,90
2014,2,21400045,11/3/2014,1610612740,New Orleans Pelicans,0,0,1610612763,Memphis Grizzlies,1,1,25,37,62,4,20,24,29,57,86,19,10,29,18,44,14,5,12,95,81
2020,2,22000571,3/11/2021,1610612748,Miami Heat,1,1,1610612753,Orlando Magic,0,0,25,17,42,16,33,49,41,50,91,13,9,22,14,42,27,6,11,98,111
2020,2,22000571,3/11/2021,1610612753,Orlando Magic,0,0,1610612748,Miami Heat,1,1,27,35,62,12,22,34,39,57,96,13,2,15,19,38,22,8,14,97,103
2023,2,22300540,1/12/2024,1610612762,Utah Jazz,1,1,1610612761,Toronto Raptors,0,0,31,19,50,21,22,43,52,41,93,20,6,26,20,24,34,5,14,101,145
2023,2,22300352,12/18/2023,1610612765,Detroit Pistons,0,0,1610612737,Atlanta Hawks,1,1,39,33,72,9,13,22,48,46,94,19,8,27,17,33,23,6,13,103,124
2022,2,22200538,12/31/2022,1610612746,LA Clippers,0,0,1610612754,Indiana Pacers,1,1,27,19,46,16,18,34,43,37,80,28,1,29,8,30,23,10,16,99,130
2022,2,22200538,12/31/2022,1610612754,Indiana Pacers,1,1,1610612746,LA Clippers,0,0,32,18,50,14,24,38,46,42,88,25,4,29,12,32,28,7,12,100,131
2023,2,22301203,12/5/2023,1610612747,Los Angeles Lakers,1,1,1610612756,Phoenix Suns,0,0,29,43,72,9,21,30,38,64,102,21,4,25,26,40,24,8,10,96,106
2017,2,21700233,11/18/2017,1610612742,Dallas Mavericks,1,1,1610612749,Milwaukee Bucks,0,0,19,22,41,19,19,38,38,41,79,16,3,19,12,31,27,8,17,92,111
2017,2,21700233,11/18/2017,1610612749,Milwaukee Bucks,0,0,1610612742,Dallas Mavericks,1,1,22,27,49,6,19,25,28,46,74,17,14,31,8,46,13,7,12,94,79
2016,2,21600305,12/5/2016,1610612739,Cleveland Cavaliers,0,1,1610612761,Toronto Raptors,1,0,26,26,52,14,18,32,40,44,84,22,5,27,21,25,21,8,16,92,116
2016,2,21600305,12/5/2016,1610612761,Toronto Raptors,1,0,1610612739,Cleveland Cavaliers,0,1,25,31,56,13,19,32,38,50,88,23,4,27,15,38,22,4,7,92,112
2020,2,22000570,3/11/2021,1610612737,Atlanta Hawks,0,1,1610612761,Toronto Raptors,1,0,24,24,48,15,27,42,39,51,90,28,7,35,16,39,20,8,14,107,121
2020,2,22000570,3/11/2021,1610612761,Toronto Raptors,1,0,1610612737,Atlanta Hawks,0,1,25,34,59,17,20,37,42,54,96,19,4,23,14,42,23,8,14,106,120
2014,2,21401021,3/20/2015,1610612752,New York Knicks,0,0,1610612755,Philadelphia 76ers,1,1,17,36,53,8,8,16,25,44,69,23,3,26,11,35,16,11,20,91,81
2014,2,21401021,3/20/2015,1610612755,Philadelphia 76ers,1,1,1610612752,New York Knicks,0,0,26,32,58,11,19,30,37,51,88,12,3,15,19,33,23,7,16,91,97
2014,2,21400445,12/27/2014,1610612738,Boston Celtics,0,0,1610612764,Washington Wizards,1,1,26,29,55,6,18,24,32,47,79,18,6,24,8,41,17,11,18,99,88
2023,2,22300433,12/29/2023,1610612739,Cleveland Cavaliers,1,0,1610612749,Milwaukee Bucks,0,1,43,17,60,6,37,43,49,54,103,7,2,9,15,40,28,5,8,102,111
2018,2,21800743,1/27/2019,1610612756,Phoenix Suns,0,0,1610612747,Los Angeles Lakers,1,1,27,32,59,7,19,26,34,51,85,27,5,32,20,32,19,8,16,96,102
2018,2,21800661,1/16/2019,1610612742,Dallas Mavericks,1,0,1610612759,San Antonio Spurs,0,1,22,22,44,15,27,42,37,49,86,12,4,16,20,31,22,9,14,88,101
2018,2,21800661,1/16/2019,1610612759,San Antonio Spurs,0,1,1610612742,Dallas Mavericks,1,0,28,25,53,13,17,30,41,42,83,10,2,12,12,30,26,6,9,86,105
2021,2,22100453,1/26/2022,1610612743,Denver Nuggets,0,1,1610612751,Brooklyn Nets,1,0,27,26,53,15,21,36,42,47,89,25,2,27,15,34,27,6,13,100,124
2021,2,22100453,1/26/2022,1610612751,Brooklyn Nets,1,0,1610612743,Denver Nuggets,0,1,31,28,59,12,17,29,43,45,88,20,6,26,9,39,26,8,12,101,118
2020,2,22000255,5/13/2021,1610612758,Sacramento Kings,0,0,1610612763,Memphis Grizzlies,1,1,25,30,55,17,24,41,42,54,96,9,5,14,18,38,33,2,11,96,110
2020,2,22000255,5/13/2021,1610612763,Memphis Grizzlies,1,1,1610612758,Sacramento Kings,0,0,34,23,57,11,22,33,45,45,90,15,3,18,21,25,30,9,18,96,116
2014,2,21400045,11/3/2014,1610612763,Memphis Grizzlies,1,1,1610612740,New Orleans Pelicans,0,0,27,35,62,4,10,14,31,45,76,27,10,37,11,37,19,5,11,94,93
2019,2,21900158,11/13/2019,1610612750,Minnesota Timberwolves,1,1,1610612759,San Antonio Spurs,0,0,34,23,57,11,23,34,45,46,91,28,6,34,15,35,25,4,10,103,129
2019,2,21900158,11/13/2019,1610612759,San Antonio Spurs,0,0,1610612750,Minnesota Timberwolves,1,1,41,32,73,3,14,17,44,46,90,23,6,29,11,39,24,11,12,101,114
2020,2,22001050,5/13/2021,1610612748,Miami Heat,1,1,1610612755,Philadelphia 76ers,0,0,28,18,46,13,22,35,41,40,81,11,0,11,17,23,26,8,20,89,106
2020,2,22001050,5/13/2021,1610612755,Philadelphia 76ers,0,0,1610612748,Miami Heat,1,1,29,24,53,7,18,25,36,42,78,15,5,20,12,32,20,5,13,88,94
2014,2,21400445,12/27/2014,1610612764,Washington Wizards,1,1,1610612738,Boston Celtics,0,0,40,37,77,5,8,13,45,45,90,6,4,10,14,32,28,10,18,99,101
2017,2,21700232,11/18/2017,1610612745,Houston Rockets,0,1,1610612763,Memphis Grizzlies,1,0,17,18,35,18,25,43,35,43,78,17,4,21,12,34,21,6,16,90,105
2020,2,22000569,3/11/2021,1610612738,Boston Celtics,0,0,1610612751,Brooklyn Nets,1,1,28,23,51,13,27,40,41,50,91,14,8,22,18,36,22,3,11,96,109
2023,2,22300165,11/8/2023,1610612765,Detroit Pistons,0,0,1610612749,Milwaukee Bucks,1,1,41,28,69,7,22,29,48,50,98,15,1,16,16,35,28,8,19,107,118
2020,2,22000569,3/11/2021,1610612751,Brooklyn Nets,1,1,1610612738,Boston Celtics,0,0,23,23,46,19,23,42,42,46,88,18,4,22,17,30,21,10,15,96,121
2023,2,22301203,12/5/2023,1610612756,Phoenix Suns,0,0,1610612747,Los Angeles Lakers,1,1,25,25,50,12,13,25,37,38,75,17,4,21,12,27,25,11,22,97,103
2018,2,21801099,3/24/2019,1610612740,New Orleans Pelicans,1,0,1610612745,Houston Rockets,0,1,31,33,64,7,21,28,38,54,92,7,3,10,17,38,26,10,15,96,90
2018,2,21801099,3/24/2019,1610612745,Houston Rockets,0,1,1610612740,New Orleans Pelicans,1,0,21,16,37,21,28,49,42,44,86,8,1,9,15,30,24,9,19,95,113
2018,2,21800958,3/4/2019,1610612746,LA Clippers,0,1,1610612747,Los Angeles Lakers,1,0,30,24,54,11,18,29,41,42,83,20,4,24,11,33,25,2,16,99,113
2018,2,21800958,3/4/2019,1610612747,Los Angeles Lakers,1,0,1610612746,LA Clippers,0,1,28,25,53,10,28,38,38,53,91,19,5,24,12,44,22,7,12,100,105
2021,2,22100452,3/31/2022,1610612737,Atlanta Hawks,1,1,1610612739,Cleveland Cavaliers,0,0,28,24,52,17,22,39,45,46,91,24,4,28,14,33,27,6,9,99,131
2021,2,22100452,3/31/2022,1610612739,Cleveland Cavaliers,0,0,1610612737,Atlanta Hawks,1,1,32,28,60,7,23,30,39,51,90,22,6,28,17,37,19,7,14,98,107
2020,2,22000254,1/24/2021,1610612737,Atlanta Hawks,0,0,1610612749,Milwaukee Bucks,1,1,28,16,44,14,25,39,42,41,83,17,5,22,7,36,27,4,9,97,115
2020,2,22000254,1/24/2021,1610612749,Milwaukee Bucks,1,1,1610612737,Atlanta Hawks,0,0,40,20,60,10,21,31,50,41,91,19,8,27,21,23,32,8,17,97,129
2019,2,21900406,12/17/2019,1610612746,LA Clippers,1,1,1610612756,Phoenix Suns,0,0,31,26,57,14,18,32,45,44,89,16,6,22,10,37,23,11,16,105,120
2019,2,21900406,12/17/2019,1610612756,Phoenix Suns,0,0,1610612746,LA Clippers,1,1,31,36,67,10,25,35,41,61,102,7,3,10,21,42,30,14,20,104,99
2019,2,21900157,11/13/2019,1610612745,Houston Rockets,1,1,1610612746,LA Clippers,0,0,19,25,44,14,28,42,33,53,86,22,5,27,11,46,12,3,10,100,102
2019,2,21900157,11/13/2019,1610612746,LA Clippers,0,0,1610612745,Houston Rockets,1,1,28,37,65,10,23,33,38,60,98,7,7,14,16,48,17,7,13,101,93
2017,2,21700232,11/18/2017,1610612763,Memphis Grizzlies,1,0,1610612745,Houston Rockets,0,1,24,35,59,7,20,27,31,55,86,13,5,18,18,39,18,8,13,92,82
2016,2,21600796,2/9/2017,1610612739,Cleveland Cavaliers,0,0,1610612760,Oklahoma City Thunder,1,1,28,30,58,10,11,21,38,41,79,23,7,30,7,37,14,10,16,100,109
2020,2,22001049,5/13/2021,1610612737,Atlanta Hawks,1,1,1610612753,Orlando Magic,0,0,27,31,58,14,22,36,41,53,94,20,4,24,15,39,19,3,7,97,116
2020,2,22001049,5/13/2021,1610612753,Orlando Magic,0,0,1610612737,Atlanta Hawks,1,1,25,33,58,11,25,36,36,58,94,10,5,15,20,40,24,9,14,98,93
2020,2,22000568,3/11/2021,1610612765,Detroit Pistons,0,0,1610612766,Charlotte Hornets,1,1,23,16,39,15,31,46,38,47,85,11,3,14,11,37,27,9,14,94,102
2020,2,22000568,3/11/2021,1610612766,Charlotte Hornets,1,1,1610612765,Detroit Pistons,0,0,26,34,60,10,20,30,36,54,90,23,1,24,15,40,26,6,9,94,105
2016,2,21600796,2/9/2017,1610612760,Oklahoma City Thunder,1,1,1610612739,Cleveland Cavaliers,0,0,42,37,79,8,19,27,50,56,106,10,3,13,23,37,24,9,14,102,118
2022,2,22200486,12/23/2022,1610612748,Miami Heat,1,0,1610612754,Indiana Pacers,0,1,28,34,62,13,20,33,41,54,95,13,1,14,19,35,23,5,10,93,108
2022,2,22200486,12/23/2022,1610612754,Indiana Pacers,0,1,1610612748,Miami Heat,1,0,19,17,36,21,26,47,40,43,83,10,4,14,12,33,26,7,16,93,111
2021,2,22100451,12/19/2021,1610612758,Sacramento Kings,1,1,1610612759,San Antonio Spurs,0,0,32,34,66,14,11,25,46,45,91,15,3,18,15,31,23,7,12,96,121
2021,2,22100451,12/19/2021,1610612759,San Antonio Spurs,0,0,1610612758,Sacramento Kings,1,1,33,33,66,12,13,25,45,46,91,12,1,13,16,30,24,11,14,95,114
2020,2,22000253,1/24/2021,1610612759,San Antonio Spurs,1,1,1610612764,Washington Wizards,0,0,33,32,65,15,16,31,48,48,96,10,1,11,9,39,27,5,9,101,121
2020,2,22000253,1/24/2021,1610612764,Washington Wizards,0,0,1610612759,San Antonio Spurs,1,1,25,25,50,14,28,42,39,53,92,9,5,14,12,42,23,11,14,100,101
2019,2,21900405,12/17/2019,1610612753,Orlando Magic,0,0,1610612762,Utah Jazz,1,1,35,23,58,7,28,35,42,51,93,11,4,15,4,49,21,3,3,97,102
2019,2,21900405,12/17/2019,1610612762,Utah Jazz,1,1,1610612753,Orlando Magic,0,0,27,27,54,15,21,36,42,48,90,10,6,16,13,39,27,6,14,98,109
2017,2,21700231,11/18/2017,1610612744,Golden State Warriors,0,1,1610612755,Philadelphia 76ers,1,0,43,25,68,7,16,23,50,41,91,17,3,20,13,30,25,8,13,101,124
2022,2,22201108,3/25/2023,1610612748,Miami Heat,1,0,1610612751,Brooklyn Nets,0,1,26,24,50,12,18,30,38,42,80,12,2,14,14,29,22,6,14,87,100
2023,2,22300336,12/16/2023,1610612739,Cleveland Cavaliers,1,1,1610612737,Atlanta Hawks,0,0,33,26,59,16,26,42,49,52,101,13,2,15,24,29,32,5,11,96,127
2023,2,22300151,11/6/2023,1610612746,LA Clippers,0,0,1610612752,New York Knicks,1,1,25,16,41,11,21,32,36,37,73,14,2,16,8,30,21,13,22,94,97
2023,2,22300270,11/30/2023,1610612762,Utah Jazz,0,0,1610612750,Minnesota Timberwolves,1,1,22,31,53,11,23,34,33,54,87,13,1,14,19,35,22,13,21,96,90
2023,2,22300431,12/29/2023,1610612758,Sacramento Kings,0,1,1610612737,Atlanta Hawks,1,0,29,15,44,17,28,45,46,43,89,8,7,15,9,38,35,9,12,99,117
2023,2,22300347,12/17/2023,1610612764,Washington Wizards,0,0,1610612756,Phoenix Suns,1,1,25,24,49,14,32,46,39,56,95,16,4,20,13,45,24,8,10,103,108
2021,2,22100450,12/19/2021,1610612757,Portland Trail Blazers,0,1,1610612763,Memphis Grizzlies,1,0,24,18,42,11,21,32,35,39,74,24,4,28,15,25,17,13,25,94,105
2021,2,22100450,12/19/2021,1610612763,Memphis Grizzlies,1,0,1610612757,Portland Trail Blazers,0,1,26,31,57,9,25,34,35,56,91,21,4,25,17,42,22,4,8,93,100
2020,2,22000252,1/24/2021,1610612753,Orlando Magic,1,0,1610612766,Charlotte Hornets,0,1,22,27,49,17,21,38,39,48,87,9,4,13,15,35,27,10,16,96,104
2020,2,22000252,1/24/2021,1610612766,Charlotte Hornets,0,1,1610612753,Orlando Magic,1,0,28,24,52,14,22,36,42,46,88,9,7,16,12,37,28,4,12,97,107
2017,2,21700231,11/18/2017,1610612755,Philadelphia 76ers,1,0,1610612744,Golden State Warriors,0,1,37,31,68,10,19,29,47,50,97,12,4,16,13,39,28,5,11,102,116
2014,2,21401020,3/20/2015,1610612753,Orlando Magic,1,1,1610612757,Portland Trail Blazers,0,0,38,44,82,5,7,12,43,51,94,20,4,24,20,33,22,4,7,92,111
2014,2,21401020,3/20/2015,1610612757,Portland Trail Blazers,0,0,1610612753,Orlando Magic,1,1,31,25,56,7,17,24,38,42,80,21,3,24,11,34,13,9,13,92,104
2020,2,22000567,3/10/2021,1610612742,Dallas Mavericks,1,1,1610612759,San Antonio Spurs,0,0,30,13,43,13,27,40,43,40,83,16,3,19,15,26,29,10,15,94,115
2020,2,22000567,3/10/2021,1610612759,San Antonio Spurs,0,0,1610612742,Dallas Mavericks,1,1,26,29,55,12,16,28,38,45,83,16,4,20,7,41,18,3,9,93,104
2021,2,22100449,12/19/2021,1610612748,Miami Heat,0,0,1610612765,Detroit Pistons,1,1,15,16,31,13,30,43,28,46,74,21,12,33,9,42,23,4,13,95,90
2021,2,22100449,12/19/2021,1610612765,Detroit Pistons,1,1,1610612748,Miami Heat,0,0,27,16,43,8,24,32,35,40,75,22,8,30,9,35,24,4,15,96,100
2020,2,22000251,1/24/2021,1610612746,LA Clippers,1,1,1610612760,Oklahoma City Thunder,0,0,27,19,46,14,32,46,41,51,92,12,4,16,13,41,26,7,10,98,108
2020,2,22000251,1/24/2021,1610612760,Oklahoma City Thunder,0,0,1610612746,LA Clippers,1,1,35,25,60,7,28,35,42,53,95,9,5,14,17,39,22,4,13,98,100
2019,2,21900156,11/13/2019,1610612738,Boston Celtics,1,1,1610612764,Washington Wizards,0,0,33,27,60,16,20,36,49,47,96,26,3,29,16,32,32,5,12,106,140
2019,2,21900156,11/13/2019,1610612764,Washington Wizards,0,0,1610612738,Boston Celtics,1,1,39,28,67,11,18,29,50,46,96,22,5,27,9,38,28,5,9,106,133
2020,2,22001048,5/13/2021,1610612749,Milwaukee Bucks,0,1,1610612754,Indiana Pacers,1,0,43,21,64,11,19,30,54,40,94,23,8,31,14,33,34,6,12,107,142
2020,2,22001048,5/13/2021,1610612754,Indiana Pacers,1,0,1610612749,Milwaukee Bucks,0,1,29,38,67,21,22,43,50,60,110,12,3,15,18,43,34,5,8,108,133
2023,2,22300336,12/16/2023,1610612737,Atlanta Hawks,0,0,1610612739,Cleveland Cavaliers,1,1,26,23,49,15,21,36,41,44,85,22,3,25,12,34,21,8,11,97,119
2020,2,22000566,3/10/2021,1610612763,Memphis Grizzlies,1,1,1610612764,Washington Wizards,0,0,42,34,76,8,15,23,50,49,99,19,10,29,20,35,31,9,16,110,127
2020,2,22000566,3/10/2021,1610612764,Washington Wizards,0,0,1610612763,Memphis Grizzlies,1,1,27,32,59,11,25,36,38,57,95,25,2,27,8,51,23,4,9,109,112
2017,2,21700230,11/18/2017,1610612737,Atlanta Hawks,1,0,1610612738,Boston Celtics,0,1,28,26,54,9,15,24,37,41,78,16,4,20,9,34,24,9,14,91,99
2020,2,22000250,1/24/2021,1610612738,Boston Celtics,1,1,1610612739,Cleveland Cavaliers,0,0,38,27,65,14,14,28,52,41,93,23,4,27,14,28,26,10,16,108,141
2020,2,22000250,1/24/2021,1610612739,Cleveland Cavaliers,0,0,1610612738,Boston Celtics,1,1,24,28,52,10,23,33,34,51,85,25,9,34,12,43,24,14,17,107,103
2019,2,21900404,12/17/2019,1610612740,New Orleans Pelicans,1,0,1610612751,Brooklyn Nets,0,1,26,41,67,11,29,40,37,70,107,16,8,24,22,51,20,3,9,107,101
2019,2,21900404,12/17/2019,1610612751,Brooklyn Nets,0,1,1610612740,New Orleans Pelicans,1,0,29,28,57,11,28,39,40,56,96,17,6,23,14,46,25,3,13,108,108
2017,2,21700230,11/18/2017,1610612738,Boston Celtics,0,1,1610612737,Atlanta Hawks,1,0,23,25,48,16,18,34,39,43,82,16,4,20,13,32,21,7,15,92,110
2014,2,21400044,11/3/2014,1610612751,Brooklyn Nets,1,1,1610612760,Oklahoma City Thunder,0,0,33,28,61,11,12,23,44,40,84,17,2,19,11,30,25,3,8,89,116
2016,2,21600304,12/5/2016,1610612743,Denver Nuggets,0,1,1610612755,Philadelphia 76ers,1,0,25,24,49,10,17,27,35,41,76,26,8,34,11,34,17,12,19,101,106
2020,2,22000565,3/4/2021,1610612752,New York Knicks,1,1,1610612765,Detroit Pistons,0,0,36,20,56,9,18,27,45,38,83,15,4,19,16,25,25,6,13,92,114
2020,2,22000565,3/4/2021,1610612765,Detroit Pistons,0,0,1610612752,New York Knicks,1,1,25,19,44,14,22,36,39,41,80,12,3,15,9,35,23,10,13,90,104
2016,2,21600304,12/5/2016,1610612755,Philadelphia 76ers,1,0,1610612743,Denver Nuggets,0,1,24,31,55,11,20,31,35,51,86,17,6,23,17,36,20,13,19,102,98
2023,2,22300265,11/30/2023,1610612757,Portland Trail Blazers,0,1,1610612739,Cleveland Cavaliers,1,0,25,17,42,14,21,35,39,38,77,11,0,11,12,26,29,12,23,95,103
2023,2,22300164,11/8/2023,1610612763,Memphis Grizzlies,1,0,1610612748,Miami Heat,0,1,24,29,53,11,26,37,35,55,90,21,7,28,18,39,20,9,14,98,102
2023,2,22300540,1/12/2024,1610612761,Toronto Raptors,0,0,1610612762,Utah Jazz,1,1,18,29,47,17,17,34,35,46,81,26,11,37,9,45,25,7,13,101,113
2023,2,22300378,12/21/2023,1610612753,Orlando Magic,0,0,1610612749,Milwaukee Bucks,1,1,37,29,66,8,25,33,45,54,99,16,7,23,14,42,26,3,7,102,114
2021,2,22100448,12/19/2021,1610612741,Chicago Bulls,1,1,1610612747,Los Angeles Lakers,0,0,30,33,63,10,20,30,40,53,93,25,6,31,17,41,20,6,10,100,115
2021,2,22100448,12/19/2021,1610612747,Los Angeles Lakers,0,0,1610612741,Chicago Bulls,1,1,30,18,48,12,22,34,42,40,82,14,8,22,12,30,25,10,20,101,110
2017,2,21700229,11/18/2017,1610612753,Orlando Magic,1,0,1610612762,Utah Jazz,0,1,23,29,52,8,21,29,31,50,81,15,8,23,11,44,13,10,16,98,85
2017,2,21700229,11/18/2017,1610612762,Utah Jazz,0,1,1610612753,Orlando Magic,1,0,33,31,64,14,20,34,47,51,98,17,1,18,16,35,31,10,11,100,125
2016,2,21600795,2/9/2017,1610612753,Orlando Magic,1,0,1610612755,Philadelphia 76ers,0,1,31,32,63,10,11,21,41,43,84,19,5,24,12,32,27,13,21,106,111
2016,2,21600795,2/9/2017,1610612755,Philadelphia 76ers,0,1,1610612753,Orlando Magic,1,0,29,38,67,11,17,28,40,55,95,21,6,27,16,43,25,4,15,104,112
2014,2,21400044,11/3/2014,1610612760,Oklahoma City Thunder,0,0,1610612751,Brooklyn Nets,1,1,24,35,59,8,15,23,32,50,82,13,8,21,22,33,14,11,18,90,85
2020,2,22000564,2/17/2021,1610612741,Chicago Bulls,1,1,1610612765,Detroit Pistons,0,0,33,24,57,8,20,28,41,44,85,15,9,24,11,36,29,9,13,99,105
2020,2,22000564,2/17/2021,1610612765,Detroit Pistons,0,0,1610612741,Chicago Bulls,1,1,29,25,54,8,20,28,37,45,82,20,4,24,8,40,15,8,13,99,102
2018,2,21801098,3/24/2019,1610612761,Toronto Raptors,1,0,1610612766,Charlotte Hornets,0,1,34,17,51,11,15,26,45,32,77,13,0,13,6,26,29,12,13,91,114
2018,2,21801098,3/24/2019,1610612766,Charlotte Hornets,0,1,1610612761,Toronto Raptors,1,0,23,29,52,18,23,41,41,52,93,15,2,17,17,35,32,6,8,92,115
2018,2,21800505,12/26/2018,1610612751,Brooklyn Nets,1,1,1610612766,Charlotte Hornets,0,0,32,25,57,19,28,47,51,53,104,13,5,18,12,43,31,8,17,119,134
2018,2,21800505,12/26/2018,1610612766,Charlotte Hornets,0,0,1610612751,Brooklyn Nets,1,1,32,43,75,15,16,31,47,59,106,23,7,30,16,48,26,8,14,118,132
2022,2,22200453,12/19/2022,1610612755,Philadelphia 76ers,1,1,1610612761,Toronto Raptors,0,0,17,21,38,15,27,42,32,48,80,25,2,27,8,41,22,6,16,101,104
2022,2,22200453,12/19/2022,1610612761,Toronto Raptors,0,0,1610612755,Philadelphia 76ers,1,1,26,22,48,11,29,40,37,51,88,16,4,20,13,39,24,8,16,102,101
2019,2,21900403,12/17/2019,1610612737,Atlanta Hawks,0,0,1610612752,New York Knicks,1,1,30,26,56,15,28,43,45,54,99,15,5,20,14,42,20,7,11,107,120
2019,2,21900403,12/17/2019,1610612752,New York Knicks,1,1,1610612737,Atlanta Hawks,0,0,40,27,67,13,15,28,53,42,95,24,7,31,16,30,30,7,12,107,143
2017,2,21700228,11/18/2017,1610612746,LA Clippers,0,0,1610612766,Charlotte Hornets,1,1,25,29,54,8,21,29,33,50,83,13,6,19,11,42,18,7,14,94,87
2017,2,21700228,11/18/2017,1610612766,Charlotte Hornets,1,1,1610612746,LA Clippers,0,0,23,38,61,11,15,26,34,53,87,23,6,29,14,42,20,5,8,95,102
2014,2,21400043,11/3/2014,1610612745,Houston Rockets,0,1,1610612755,Philadelphia 76ers,1,0,16,25,41,16,18,34,32,43,75,24,6,30,18,28,27,12,22,93,104
2014,2,21400043,11/3/2014,1610612755,Philadelphia 76ers,1,0,1610612745,Houston Rockets,0,1,22,30,52,11,11,22,33,41,74,16,7,23,11,36,19,12,18,92,93
2020,2,22001047,5/13/2021,1610612746,LA Clippers,0,1,1610612766,Charlotte Hornets,1,0,19,11,30,21,24,45,40,35,75,12,4,16,8,29,28,9,17,93,113
2020,2,22001047,5/13/2021,1610612766,Charlotte Hornets,1,0,1610612746,LA Clippers,0,1,24,27,51,9,24,33,33,51,84,15,4,19,12,41,24,6,12,93,90
2014,2,21400444,12/27/2014,1610612753,Orlando Magic,0,1,1610612766,Charlotte Hornets,1,0,30,33,63,8,12,20,38,45,83,18,6,24,14,35,22,2,6,87,102
2023,2,22300404,12/25/2023,1610612748,Miami Heat,1,1,1610612755,Philadelphia 76ers,0,0,28,24,52,12,20,32,40,44,84,27,8,35,15,31,27,11,14,100,119
2014,2,21400444,12/27/2014,1610612766,Charlotte Hornets,1,0,1610612753,Orlando Magic,0,1,28,34,62,8,16,24,36,50,86,14,4,18,17,35,18,6,10,88,94
2023,2,22300363,12/19/2023,1610612756,Phoenix Suns,0,0,1610612757,Portland Trail Blazers,1,1,37,34,71,5,18,23,42,52,94,15,6,21,18,36,23,8,15,101,104
2021,2,22100447,12/18/2021,1610612762,Utah Jazz,1,0,1610612764,Washington Wizards,0,1,21,16,37,14,30,44,35,46,81,19,11,30,11,39,17,7,16,100,103
2021,2,22100447,12/18/2021,1610612764,Washington Wizards,0,1,1610612762,Utah Jazz,1,0,33,30,63,9,22,31,42,52,94,16,4,20,12,42,27,5,9,99,109
2020,2,22000249,1/24/2021,1610612754,Indiana Pacers,1,0,1610612761,Toronto Raptors,0,1,22,26,48,13,26,39,35,52,87,19,3,22,17,36,23,12,19,99,102
2020,2,22000249,1/24/2021,1610612761,Toronto Raptors,0,1,1610612754,Indiana Pacers,1,0,22,33,55,15,20,35,37,53,90,18,8,26,20,38,24,10,17,100,107
2019,2,21900155,11/13/2019,1610612753,Orlando Magic,1,1,1610612755,Philadelphia 76ers,0,0,28,26,54,10,22,32,38,48,86,26,8,34,13,39,27,5,13,103,112
2019,2,21900155,11/13/2019,1610612755,Philadelphia 76ers,0,0,1610612753,Orlando Magic,1,1,32,29,61,8,22,30,40,51,91,9,4,13,10,41,25,6,15,102,97
2014,2,21400042,11/2/2014,1610612744,Golden State Warriors,0,1,1610612757,Portland Trail Blazers,1,0,30,32,62,6,13,19,36,45,81,17,4,21,9,40,22,9,17,99,95
2014,2,21400042,11/2/2014,1610612757,Portland Trail Blazers,1,0,1610612744,Golden State Warriors,0,1,30,35,65,7,20,27,37,55,92,9,5,14,21,36,20,11,19,100,90
2022,2,22201147,3/30/2023,1610612743,Denver Nuggets,1,0,1610612740,New Orleans Pelicans,0,1,28,24,52,4,24,28,32,48,80,20,12,32,15,39,21,6,10,92,88
2020,2,22000563,2/19/2021,1610612739,Cleveland Cavaliers,1,0,1610612743,Denver Nuggets,0,1,27,25,52,12,19,31,39,44,83,13,8,21,15,33,30,9,18,95,103
2020,2,22000563,2/19/2021,1610612743,Denver Nuggets,0,1,1610612739,Cleveland Cavaliers,1,0,31,18,49,15,16,31,46,34,80,13,4,17,10,26,24,8,17,95,120
2014,2,21400443,12/27/2014,1610612746,LA Clippers,1,0,1610612761,Toronto Raptors,0,1,25,31,56,12,13,25,37,44,81,12,3,15,12,33,26,7,15,93,98
2014,2,21400443,12/27/2014,1610612761,Toronto Raptors,0,1,1610612746,LA Clippers,1,0,28,24,52,13,21,34,41,45,86,15,4,19,14,34,25,4,10,91,110
2023,2,22300362,12/19/2023,1610612738,Boston Celtics,0,0,1610612744,Golden State Warriors,1,1,30,26,56,17,41,58,47,67,114,15,2,17,23,45,28,4,8,107,126
2023,2,22300337,12/16/2023,1610612741,Chicago Bulls,0,0,1610612748,Miami Heat,1,1,21,18,39,16,22,38,37,40,77,26,3,29,16,25,25,7,15,90,116
2023,2,22300404,12/25/2023,1610612755,Philadelphia 76ers,0,0,1610612748,Miami Heat,1,1,23,26,49,17,28,45,40,54,94,16,9,25,14,43,23,5,8,100,113
2017,2,21700227,11/17/2017,1610612747,Los Angeles Lakers,1,0,1610612756,Phoenix Suns,0,1,38,28,66,7,18,25,45,46,91,16,8,24,11,37,26,10,19,111,113
2017,2,21700227,11/17/2017,1610612756,Phoenix Suns,0,1,1610612747,Los Angeles Lakers,1,0,35,36,71,13,19,32,48,55,103,13,6,19,15,43,28,7,14,111,122
2021,2,22100446,12/18/2021,1610612739,Cleveland Cavaliers,0,1,1610612749,Milwaukee Bucks,1,0,29,16,45,16,29,45,45,45,90,13,1,14,14,32,36,8,15,97,119
2021,2,22100446,12/18/2021,1610612749,Milwaukee Bucks,1,0,1610612739,Cleveland Cavaliers,0,1,23,28,51,12,26,38,35,54,89,8,3,11,15,40,18,11,17,96,90
2019,2,21900402,12/17/2019,1610612747,Los Angeles Lakers,0,0,1610612754,Indiana Pacers,1,1,35,25,60,8,23,31,43,48,91,8,9,17,18,35,28,9,13,93,102
2019,2,21900402,12/17/2019,1610612754,Indiana Pacers,1,1,1610612747,Los Angeles Lakers,0,0,31,29,60,10,15,25,41,44,85,13,7,20,17,29,22,5,13,94,105
2016,2,21600794,2/9/2017,1610612745,Houston Rockets,0,1,1610612766,Charlotte Hornets,1,0,26,21,47,13,27,40,39,48,87,16,4,20,11,39,22,8,17,100,107
2023,2,22300362,12/19/2023,1610612744,Golden State Warriors,1,1,1610612738,Boston Celtics,0,0,30,29,59,20,30,50,50,59,109,12,2,14,20,40,29,6,10,106,132
2020,2,22000248,1/23/2021,1610612743,Denver Nuggets,0,1,1610612756,Phoenix Suns,1,0,25,36,61,15,21,36,40,57,97,25,7,32,16,45,22,8,18,114,120
2020,2,22000248,1/23/2021,1610612756,Phoenix Suns,1,0,1610612743,Denver Nuggets,0,1,25,24,49,16,37,53,41,61,102,14,4,18,9,54,26,4,10,112,112
2021,2,22100445,12/18/2021,1610612738,Boston Celtics,1,1,1610612752,New York Knicks,0,0,25,19,44,17,28,45,42,47,89,13,4,17,13,35,23,8,13,97,114
2021,2,22100445,12/18/2021,1610612752,New York Knicks,0,0,1610612738,Boston Celtics,1,1,22,22,44,13,23,36,35,45,80,24,6,30,10,37,18,6,14,96,107
2017,2,21700226,11/17/2017,1610612740,New Orleans Pelicans,0,0,1610612743,Denver Nuggets,1,1,36,22,58,12,21,33,48,43,91,6,4,10,10,36,32,5,13,98,114
2017,2,21700226,11/17/2017,1610612743,Denver Nuggets,1,1,1610612740,New Orleans Pelicans,0,0,38,16,54,18,17,35,56,33,89,16,5,21,15,22,37,2,15,99,146
2019,2,21900154,11/13/2019,1610612763,Memphis Grizzlies,0,1,1610612766,Charlotte Hornets,1,0,31,23,54,17,18,35,48,41,89,6,3,9,13,30,32,8,24,104,119
2019,2,21900154,11/13/2019,1610612766,Charlotte Hornets,1,0,1610612763,Memphis Grizzlies,0,1,27,24,51,16,20,36,43,44,87,15,4,19,9,36,27,9,15,103,117
2016,2,21600794,2/9/2017,1610612766,Charlotte Hornets,1,0,1610612745,Houston Rockets,0,1,29,30,59,8,18,26,37,48,85,13,1,14,13,35,26,13,22,99,95
2016,2,21600303,12/4/2016,1610612746,LA Clippers,1,0,1610612754,Indiana Pacers,0,1,26,25,51,10,20,30,36,45,81,20,8,28,17,33,19,9,20,97,102
2020,2,22001046,5/12/2021,1610612745,Houston Rockets,0,0,1610612747,Los Angeles Lakers,1,1,25,18,43,18,24,42,43,42,85,18,9,27,12,37,33,8,15,101,122
2020,2,22001046,5/12/2021,1610612747,Los Angeles Lakers,1,1,1610612745,Houston Rockets,0,0,45,26,71,7,13,20,52,39,91,13,9,22,10,34,28,7,11,101,124
2020,2,22000562,2/17/2021,1610612760,Oklahoma City Thunder,0,0,1610612763,Memphis Grizzlies,1,1,16,21,37,19,22,41,35,43,78,24,4,28,7,39,25,14,18,103,113
2020,2,22000562,2/17/2021,1610612763,Memphis Grizzlies,1,1,1610612760,Oklahoma City Thunder,0,0,30,27,57,12,14,26,42,41,83,26,7,33,11,35,31,5,13,101,122
2023,2,22300959,3/14/2024,1610612760,Oklahoma City Thunder,1,1,1610612742,Dallas Mavericks,0,0,29,18,47,16,23,39,45,41,86,20,3,23,11,31,28,6,13,99,126
2023,2,22300932,3/10/2024,1610612747,Los Angeles Lakers,1,1,1610612750,Minnesota Timberwolves,0,0,34,25,59,10,14,24,44,39,83,22,7,29,15,27,29,8,21,100,120
2020,2,22000247,1/23/2021,1610612742,Dallas Mavericks,1,0,1610612745,Houston Rockets,0,1,32,26,58,5,20,25,37,46,83,29,11,40,12,39,15,5,10,100,108
2020,2,22000247,1/23/2021,1610612745,Houston Rockets,0,1,1610612742,Dallas Mavericks,1,0,31,18,49,16,21,37,47,39,86,23,6,29,15,28,28,7,14,98,133
2014,2,21400041,11/2/2014,1610612752,New York Knicks,1,1,1610612766,Charlotte Hornets,0,0,31,31,62,8,8,16,39,39,78,10,7,17,12,31,23,7,14,87,96
2023,2,22300849,2/29/2024,1610612766,Charlotte Hornets,1,0,1610612749,Milwaukee Bucks,0,1,24,19,43,12,27,39,36,46,82,15,5,20,11,37,24,9,13,93,99
2014,2,21400041,11/2/2014,1610612766,Charlotte Hornets,0,0,1610612752,New York Knicks,1,1,27,28,55,6,9,15,33,37,70,21,8,29,10,32,20,5,13,87,93
2016,2,21600303,12/4/2016,1610612754,Indiana Pacers,0,1,1610612746,LA Clippers,1,0,34,31,65,5,9,14,39,40,79,28,7,35,7,38,21,5,11,98,111
2014,2,21400442,12/26/2014,1610612756,Phoenix Suns,0,1,1610612758,Sacramento Kings,1,0,32,29,61,14,19,33,46,48,94,9,3,12,17,33,25,8,14,96,115
2020,2,22000561,2/14/2021,1610612740,New Orleans Pelicans,0,0,1610612765,Detroit Pistons,1,1,31,24,55,9,26,35,40,50,90,23,5,28,22,29,23,3,11,92,112
2020,2,22000561,2/14/2021,1610612765,Detroit Pistons,1,1,1610612740,New Orleans Pelicans,0,0,28,21,49,17,18,35,45,39,84,16,4,20,15,27,34,5,14,92,123
2022,2,22201108,3/25/2023,1610612751,Brooklyn Nets,0,1,1610612748,Miami Heat,1,0,26,23,49,18,22,40,44,45,89,23,2,25,20,26,30,5,8,87,129
2014,2,21400442,12/26/2014,1610612758,Sacramento Kings,1,0,1610612756,Phoenix Suns,0,1,34,39,73,7,13,20,41,52,93,17,7,24,24,31,18,6,13,96,106
2023,2,22300349,12/18/2023,1610612745,Houston Rockets,0,0,1610612739,Cleveland Cavaliers,1,1,35,34,69,12,21,33,47,55,102,24,3,27,27,29,34,7,14,102,130
2023,2,22300363,12/19/2023,1610612757,Portland Trail Blazers,1,1,1610612756,Phoenix Suns,0,0,25,34,59,14,14,28,39,48,87,17,2,19,13,35,23,10,17,100,109
2018,2,21800838,2/10/2019,1610612744,Golden State Warriors,1,1,1610612748,Miami Heat,0,0,31,15,46,13,23,36,44,38,82,19,7,26,10,32,28,6,12,96,120
2018,2,21800838,2/10/2019,1610612748,Miami Heat,0,0,1610612744,Golden State Warriors,1,1,30,32,62,18,25,43,48,57,105,4,4,8,27,32,32,8,16,98,118
2020,2,22000246,1/23/2021,1610612740,New Orleans Pelicans,0,0,1610612750,Minnesota Timberwolves,1,1,30,24,54,10,23,33,40,47,87,20,8,28,13,38,21,14,21,106,110
2020,2,22000246,1/23/2021,1610612750,Minnesota Timberwolves,1,1,1610612740,New Orleans Pelicans,0,0,27,30,57,12,22,34,39,52,91,30,7,37,17,38,23,5,13,105,120
2017,2,21700225,11/17/2017,1610612757,Portland Trail Blazers,0,0,1610612758,Sacramento Kings,1,1,23,33,56,7,18,25,30,51,81,15,1,16,17,35,13,11,18,91,82
2021,2,22100443,12/18/2021,1610612744,Golden State Warriors,0,0,1610612761,Toronto Raptors,1,1,26,17,43,11,25,36,37,42,79,15,6,21,16,31,26,13,20,97,100
2021,2,22100443,12/18/2021,1610612761,Toronto Raptors,1,1,1610612744,Golden State Warriors,0,0,31,21,52,14,24,38,45,45,90,15,8,23,15,36,26,5,11,95,119
2019,2,21900401,12/17/2019,1610612758,Sacramento Kings,0,0,1610612766,Charlotte Hornets,1,1,24,28,52,14,25,39,38,53,91,12,1,13,15,38,23,5,10,92,102
2020,2,22001045,5/12/2021,1610612757,Portland Trail Blazers,0,1,1610612762,Utah Jazz,1,0,27,32,59,13,19,32,40,51,91,12,5,17,15,40,17,4,5,91,105
2020,2,22001045,5/12/2021,1610612762,Utah Jazz,1,0,1610612757,Portland Trail Blazers,0,1,23,22,45,12,28,40,35,50,85,16,5,21,17,34,15,7,12,90,98
2020,2,22000560,2/14/2021,1610612738,Boston Celtics,0,0,1610612764,Washington Wizards,1,1,23,32,55,9,26,35,32,58,90,18,12,30,16,47,14,9,17,104,91
2020,2,22000560,2/14/2021,1610612764,Washington Wizards,1,1,1610612738,Boston Celtics,0,0,26,27,53,7,23,30,33,50,83,31,5,36,13,39,24,5,18,104,104
2020,2,22000245,1/23/2021,1610612741,Chicago Bulls,1,0,1610612747,Los Angeles Lakers,0,1,25,34,59,8,17,25,33,51,84,16,6,22,12,40,18,7,19,102,90
2020,2,22000245,1/23/2021,1610612747,Los Angeles Lakers,0,1,1610612741,Chicago Bulls,1,0,32,28,60,4,15,19,36,43,79,25,6,31,9,37,20,8,19,102,101
2022,2,22201147,3/30/2023,1610612740,New Orleans Pelicans,0,1,1610612743,Denver Nuggets,1,0,25,28,53,13,14,27,38,42,80,18,4,22,11,33,22,4,12,90,107
2019,2,21900401,12/17/2019,1610612766,Charlotte Hornets,1,1,1610612758,Sacramento Kings,0,0,26,25,51,13,17,30,39,42,81,19,8,27,21,26,26,10,19,92,110
2017,2,21700225,11/17/2017,1610612758,Sacramento Kings,1,1,1610612757,Portland Trail Blazers,0,0,32,39,71,4,10,14,36,49,85,10,5,15,15,36,20,8,13,91,86
2016,2,21600793,2/8/2017,1610612738,Boston Celtics,0,0,1610612758,Sacramento Kings,1,1,19,22,41,10,22,32,29,44,73,24,3,27,8,37,18,11,18,97,92
2016,2,21600793,2/8/2017,1610612758,Sacramento Kings,1,1,1610612738,Boston Celtics,0,0,32,27,59,10,15,25,42,42,84,14,1,15,9,33,24,8,14,97,108
2023,2,22300348,12/17/2023,1610612744,Golden State Warriors,0,1,1610612757,Portland Trail Blazers,1,0,33,16,49,13,25,38,46,41,87,13,6,19,16,29,31,10,14,96,118
2023,2,22300849,2/29/2024,1610612749,Milwaukee Bucks,0,1,1610612766,Charlotte Hornets,1,0,23,24,47,16,23,39,39,47,86,17,3,20,10,38,21,3,8,93,111
2023,2,22300348,12/17/2023,1610612757,Portland Trail Blazers,1,0,1610612744,Golden State Warriors,0,1,27,23,50,13,22,35,40,45,85,21,2,23,12,34,23,10,14,95,114
2023,2,22300126,11/1/2023,1610612758,Sacramento Kings,0,0,1610612744,Golden State Warriors,1,1,25,28,53,11,24,35,36,52,88,18,5,23,19,35,24,5,15,95,101
2022,2,22201111,3/25/2023,1610612758,Sacramento Kings,1,1,1610612762,Utah Jazz,0,0,28,24,52,16,27,43,44,51,95,17,4,21,16,36,30,3,9,100,121
2023,2,22300489,1/5/2024,1610612748,Miami Heat,0,0,1610612756,Phoenix Suns,1,1,24,22,46,10,27,37,34,49,83,19,3,22,15,36,26,13,16,93,97
2021,2,22100442,12/18/2021,1610612751,Brooklyn Nets,1,0,1610612753,Orlando Magic,0,1,30,26,56,9,37,46,39,63,102,6,2,8,22,41,24,6,16,100,93
2021,2,22100442,12/18/2021,1610612753,Orlando Magic,0,1,1610612751,Brooklyn Nets,1,0,29,34,63,10,21,31,39,55,94,12,1,13,18,37,20,8,16,100,100
2020,2,22000244,1/23/2021,1610612748,Miami Heat,0,0,1610612751,Brooklyn Nets,1,1,29,14,43,13,33,46,42,47,89,27,5,32,9,39,29,0,8,103,124
2020,2,22000244,1/23/2021,1610612751,Brooklyn Nets,1,1,1610612748,Miami Heat,0,0,25,21,46,19,18,37,44,39,83,21,5,26,9,33,34,7,17,102,128
2017,2,21700224,11/17/2017,1610612742,Dallas Mavericks,1,0,1610612750,Minnesota Timberwolves,0,1,24,24,48,8,30,38,32,54,86,15,2,17,15,40,18,7,11,91,87
2017,2,21700224,11/17/2017,1610612750,Minnesota Timberwolves,0,1,1610612742,Dallas Mavericks,1,0,26,28,54,13,17,30,39,45,84,20,3,23,14,33,27,3,10,92,111
2022,2,22201111,3/25/2023,1610612762,Utah Jazz,0,0,1610612758,Sacramento Kings,1,1,38,25,63,9,19,28,47,44,91,10,6,16,15,32,30,11,17,100,113
2020,2,22000559,2/2/2021,1610612757,Portland Trail Blazers,0,1,1610612764,Washington Wizards,1,0,23,26,49,21,25,46,44,51,95,23,0,23,17,34,19,2,9,97,132
2020,2,22000559,2/2/2021,1610612764,Washington Wizards,1,0,1610612757,Portland Trail Blazers,0,1,30,13,43,16,24,40,46,37,83,13,4,17,7,33,32,6,14,97,121
2023,2,22300449,12/31/2023,1610612758,Sacramento Kings,0,1,1610612763,Memphis Grizzlies,1,0,31,28,59,16,17,33,47,45,92,13,4,17,13,35,28,4,13,98,123
2017,2,21700223,11/17/2017,1610612759,San Antonio Spurs,1,1,1610612760,Oklahoma City Thunder,0,0,20,22,42,14,21,35,34,43,77,22,6,28,14,31,23,7,13,91,104
2017,2,21700223,11/17/2017,1610612760,Oklahoma City Thunder,0,0,1610612759,San Antonio Spurs,1,1,30,36,66,9,14,23,39,50,89,14,7,21,16,38,24,6,9,91,101
2023,2,22300768,2/12/2024,1610612764,Washington Wizards,0,0,1610612742,Dallas Mavericks,1,1,37,37,74,7,25,32,44,62,106,9,6,15,20,45,27,7,16,109,104
2019,2,21900153,11/12/2019,1610612757,Portland Trail Blazers,0,0,1610612758,Sacramento Kings,1,1,26,21,47,8,22,30,34,43,77,23,7,30,9,37,15,9,17,98,99
2019,2,21900153,11/12/2019,1610612758,Sacramento Kings,1,1,1610612757,Portland Trail Blazers,0,0,27,27,54,11,21,32,38,48,86,20,6,26,15,37,24,4,14,97,107
2022,2,22201050,3/17/2023,1610612741,Chicago Bulls,1,1,1610612750,Minnesota Timberwolves,0,0,40,30,70,11,13,24,51,43,94,26,4,30,8,37,23,6,12,112,139
2014,2,21401019,3/19/2015,1610612747,Los Angeles Lakers,1,0,1610612762,Utah Jazz,0,1,28,38,66,3,8,11,31,46,77,8,9,17,15,36,20,11,16,86,73
2020,2,22001044,5/12/2021,1610612738,Boston Celtics,0,0,1610612739,Cleveland Cavaliers,1,1,24,36,60,12,29,41,36,65,101,10,4,14,16,50,14,4,7,99,94
2020,2,22001044,5/12/2021,1610612739,Cleveland Cavaliers,1,1,1610612738,Boston Celtics,0,0,28,28,56,8,16,24,36,44,80,22,5,27,11,34,27,9,16,99,102
2014,2,21401019,3/19/2015,1610612762,Utah Jazz,0,1,1610612747,Los Angeles Lakers,1,0,16,21,37,9,16,25,25,37,62,21,10,31,6,35,19,9,15,87,80
2023,2,22300046,11/24/2023,1610612761,Toronto Raptors,1,1,1610612741,Chicago Bulls,0,0,31,13,44,13,26,39,44,39,83,20,7,27,14,30,32,5,14,95,121
2014,2,21400441,12/26/2014,1610612755,Philadelphia 76ers,0,0,1610612757,Portland Trail Blazers,1,1,33,34,67,3,11,14,36,45,81,18,15,33,11,40,16,10,18,102,93
2014,2,21400441,12/26/2014,1610612757,Portland Trail Blazers,1,1,1610612755,Philadelphia 76ers,0,0,24,21,45,18,25,43,42,46,88,12,2,14,12,35,25,13,21,102,114
2018,2,21800957,3/4/2019,1610612752,New York Knicks,0,0,1610612758,Sacramento Kings,1,1,27,29,56,12,17,29,39,46,85,18,10,28,12,39,17,11,19,104,108
2017,2,21700222,11/17/2017,1610612741,Chicago Bulls,1,1,1610612766,Charlotte Hornets,0,0,30,27,57,17,17,34,47,44,91,12,1,13,6,38,26,3,11,104,123
2021,2,22100441,12/18/2021,1610612745,Houston Rockets,0,1,1610612765,Detroit Pistons,1,0,32,23,55,14,24,38,46,47,93,10,7,17,16,31,27,8,19,103,116
2021,2,22100441,12/18/2021,1610612765,Detroit Pistons,1,0,1610612745,Houston Rockets,0,1,33,24,57,10,26,36,43,50,93,11,5,16,18,35,29,15,21,103,107
2017,2,21700222,11/17/2017,1610612766,Charlotte Hornets,0,0,1610612741,Chicago Bulls,1,1,32,28,60,10,11,21,42,39,81,26,8,34,8,32,19,9,13,104,120
2020,2,22000243,1/23/2021,1610612755,Philadelphia 76ers,0,1,1610612765,Detroit Pistons,1,0,30,30,60,8,15,23,38,45,83,30,8,38,13,38,14,9,15,103,114
2020,2,22000243,1/23/2021,1610612765,Detroit Pistons,1,0,1610612755,Philadelphia 76ers,0,1,23,30,53,14,19,33,37,49,86,22,8,30,12,39,25,10,16,105,110
2019,2,21900400,12/16/2019,1610612756,Phoenix Suns,1,0,1610612757,Portland Trail Blazers,0,1,29,27,56,12,22,34,41,49,90,16,3,19,16,34,31,9,21,103,110
2019,2,21900400,12/16/2019,1610612757,Portland Trail Blazers,0,1,1610612756,Phoenix Suns,1,0,26,24,50,14,20,34,40,44,84,17,3,20,10,35,21,11,20,102,111
2018,2,21800957,3/4/2019,1610612758,Sacramento Kings,1,1,1610612752,New York Knicks,0,0,28,26,54,11,18,29,39,44,83,26,7,33,9,39,28,8,13,104,115
2021,2,22100440,12/17/2021,1610612758,Sacramento Kings,1,0,1610612763,Memphis Grizzlies,0,1,23,30,53,13,22,35,36,52,88,20,6,26,15,40,21,11,18,105,105
2023,2,22300405,12/25/2023,1610612756,Phoenix Suns,1,0,1610612742,Dallas Mavericks,0,1,26,23,49,14,27,41,40,50,90,20,5,25,19,32,28,7,16,101,114
2021,2,22100440,12/17/2021,1610612763,Memphis Grizzlies,0,1,1610612758,Sacramento Kings,1,0,32,41,73,13,11,24,45,52,97,21,6,27,18,37,25,5,13,105,124
2019,2,21900399,12/16/2019,1610612741,Chicago Bulls,0,0,1610612760,Oklahoma City Thunder,1,1,34,22,56,9,22,31,43,44,87,11,2,13,9,36,27,8,14,99,106
2019,2,21900399,12/16/2019,1610612760,Oklahoma City Thunder,1,1,1610612741,Chicago Bulls,0,0,19,16,35,16,18,34,35,34,69,23,5,28,10,27,21,17,26,98,109
2023,2,22300450,12/31/2023,1610612753,Orlando Magic,0,0,1610612756,Phoenix Suns,1,1,30,23,53,12,25,37,42,48,90,11,1,12,14,34,22,11,15,96,107
2020,2,22001043,5/12/2021,1610612751,Brooklyn Nets,1,1,1610612759,San Antonio Spurs,0,0,36,15,51,12,16,28,48,31,79,20,7,27,5,30,33,7,11,98,128
2020,2,22001043,5/12/2021,1610612759,San Antonio Spurs,0,0,1610612751,Brooklyn Nets,1,1,35,35,70,8,23,31,43,58,101,22,5,27,21,40,21,3,8,99,116
2016,2,21600302,12/4/2016,1610612752,New York Knicks,1,1,1610612758,Sacramento Kings,0,0,28,31,59,11,18,29,39,49,88,17,7,24,18,35,20,13,19,101,106
2016,2,21600302,12/4/2016,1610612758,Sacramento Kings,0,0,1610612752,New York Knicks,1,1,22,47,69,9,19,28,31,66,97,27,4,31,20,47,18,5,11,101,98
2020,2,22000242,1/23/2021,1610612744,Golden State Warriors,0,0,1610612762,Utah Jazz,1,1,28,26,54,14,25,39,42,51,93,10,5,15,7,47,30,6,11,103,108
2020,2,22000242,1/23/2021,1610612762,Utah Jazz,1,1,1610612744,Golden State Warriors,0,0,25,19,44,20,30,50,45,49,94,17,5,22,18,32,28,6,16,103,127
2021,2,22100439,12/17/2021,1610612757,Portland Trail Blazers,1,1,1610612766,Charlotte Hornets,0,0,23,15,38,21,26,47,44,41,85,16,2,18,14,28,27,8,17,98,125
2021,2,22100439,12/17/2021,1610612766,Charlotte Hornets,0,0,1610612757,Portland Trail Blazers,1,1,31,24,55,13,24,37,44,48,92,15,3,18,15,35,29,7,13,99,116
2019,2,21900152,11/12/2019,1610612751,Brooklyn Nets,0,0,1610612762,Utah Jazz,1,1,30,23,53,11,26,37,41,49,90,21,4,25,17,36,19,7,17,102,114
2019,2,21900152,11/12/2019,1610612762,Utah Jazz,1,1,1610612751,Brooklyn Nets,0,0,37,29,66,6,20,26,43,49,92,27,8,35,17,35,16,5,11,104,119
2017,2,21700221,11/17/2017,1610612752,New York Knicks,0,0,1610612761,Toronto Raptors,1,1,21,47,68,9,14,23,30,61,91,15,2,17,19,43,17,4,10,91,84
2017,2,21700221,11/17/2017,1610612761,Toronto Raptors,1,1,1610612752,New York Knicks,0,0,35,17,52,9,17,26,44,34,78,10,1,11,5,30,29,7,12,89,107
2014,2,21401018,3/19/2015,1610612740,New Orleans Pelicans,0,0,1610612756,Phoenix Suns,1,1,26,39,65,5,13,18,31,52,83,5,5,10,12,43,19,5,11,88,72
2014,2,21401018,3/19/2015,1610612756,Phoenix Suns,1,1,1610612740,New Orleans Pelicans,0,0,27,34,61,2,20,22,29,54,83,14,7,21,18,38,11,4,12,89,74
2014,2,21400440,12/26/2014,1610612743,Denver Nuggets,1,1,1610612750,Minnesota Timberwolves,0,0,36,40,76,3,16,19,39,56,95,25,7,32,27,33,18,5,18,102,106
2014,2,21400440,12/26/2014,1610612750,Minnesota Timberwolves,0,0,1610612743,Denver Nuggets,1,1,38,50,88,3,12,15,41,62,103,17,7,24,22,41,29,1,8,103,102
2018,2,21801097,3/24/2019,1610612743,Denver Nuggets,0,0,1610612754,Indiana Pacers,1,1,26,38,64,7,22,29,33,60,93,15,1,16,20,41,21,9,17,100,88
2018,2,21801097,3/24/2019,1610612754,Indiana Pacers,1,1,1610612743,Denver Nuggets,0,0,43,30,73,8,10,18,51,40,91,14,3,17,12,29,34,5,11,98,124
2020,2,22000241,1/22/2021,1610612752,New York Knicks,0,0,1610612758,Sacramento Kings,1,1,31,41,72,5,17,22,36,58,94,17,8,25,20,45,19,6,12,94,94
2021,2,22100438,12/17/2021,1610612740,New Orleans Pelicans,1,1,1610612749,Milwaukee Bucks,0,0,29,23,52,13,24,37,42,47,89,19,11,30,18,36,34,12,20,107,116
2021,2,22100438,12/17/2021,1610612749,Milwaukee Bucks,0,0,1610612740,New Orleans Pelicans,1,1,31,26,57,14,33,47,45,59,104,8,2,10,14,46,16,10,13,106,112
2020,2,22000241,1/22/2021,1610612758,Sacramento Kings,1,1,1610612752,New York Knicks,0,0,26,31,57,12,22,34,38,53,91,15,6,21,15,41,21,2,6,94,103
2016,2,21600792,2/8/2017,1610612741,Chicago Bulls,0,0,1610612744,Golden State Warriors,1,1,33,35,68,4,20,24,37,55,92,14,5,19,18,41,25,9,15,98,92
2016,2,21600792,2/8/2017,1610612744,Golden State Warriors,1,1,1610612741,Chicago Bulls,0,0,33,24,57,15,13,28,48,37,85,12,1,13,6,32,37,7,13,97,123
2021,2,22100437,12/17/2021,1610612759,San Antonio Spurs,0,1,1610612762,Utah Jazz,1,0,35,24,59,15,26,41,50,50,100,13,5,18,13,39,27,5,7,103,128
2021,2,22100437,12/17/2021,1610612762,Utah Jazz,1,0,1610612759,San Antonio Spurs,0,1,33,23,56,13,24,37,46,47,93,21,5,26,16,33,26,8,13,103,126
2020,2,22000240,4/25/2021,1610612757,Portland Trail Blazers,1,0,1610612763,Memphis Grizzlies,0,1,25,42,67,14,24,38,39,66,105,21,4,25,21,47,21,9,11,107,113
2020,2,22000240,4/25/2021,1610612763,Memphis Grizzlies,0,1,1610612757,Portland Trail Blazers,1,0,30,38,68,12,11,23,42,49,91,24,4,28,12,40,22,11,15,106,120
2019,2,21900398,12/16/2019,1610612742,Dallas Mavericks,0,1,1610612749,Milwaukee Bucks,1,0,25,22,47,16,25,41,41,47,88,22,5,27,11,38,27,8,14,103,120
2019,2,21900398,12/16/2019,1610612749,Milwaukee Bucks,1,0,1610612742,Dallas Mavericks,0,1,33,31,64,11,30,41,44,61,105,17,7,24,20,46,29,5,9,103,116
2017,2,21700220,11/17/2017,1610612739,Cleveland Cavaliers,1,1,1610612746,LA Clippers,0,0,31,26,57,11,22,33,42,48,90,23,6,29,9,43,24,7,15,111,118
2017,2,21700220,11/17/2017,1610612746,LA Clippers,0,0,1610612739,Cleveland Cavaliers,1,1,36,32,68,10,25,35,46,57,103,11,3,14,14,44,29,9,15,111,113
2020,2,22001042,5/12/2021,1610612737,Atlanta Hawks,1,1,1610612764,Washington Wizards,0,0,34,19,53,10,23,33,44,42,86,22,6,28,8,37,22,10,14,104,120
2020,2,22001042,5/12/2021,1610612764,Washington Wizards,0,0,1610612737,Atlanta Hawks,1,1,35,37,72,10,19,29,45,56,101,16,3,19,12,45,29,4,7,106,116
2014,2,21400040,11/2/2014,1610612748,Miami Heat,1,1,1610612761,Toronto Raptors,0,0,26,20,46,9,15,24,35,35,70,28,10,38,15,21,22,7,16,89,107
2014,2,21400040,11/2/2014,1610612761,Toronto Raptors,0,0,1610612748,Miami Heat,1,1,33,30,63,4,12,16,37,42,79,24,15,39,16,34,11,7,11,89,102
2016,2,21600301,12/4/2016,1610612740,New Orleans Pelicans,0,0,1610612760,Oklahoma City Thunder,1,1,30,40,70,6,22,28,36,62,98,14,5,19,16,49,15,7,11,103,92
2016,2,21600301,12/4/2016,1610612760,Oklahoma City Thunder,1,1,1610612740,New Orleans Pelicans,0,0,35,26,61,6,22,28,41,48,89,13,13,26,12,44,24,8,16,103,101
2022,2,22201050,3/17/2023,1610612750,Minnesota Timberwolves,0,0,1610612741,Chicago Bulls,1,1,28,30,58,18,24,42,46,54,100,21,10,31,17,44,33,9,16,114,131
2020,2,22000239,1/22/2021,1610612746,LA Clippers,1,1,1610612760,Oklahoma City Thunder,0,0,33,18,51,10,23,33,43,41,84,24,1,25,13,28,21,8,13,98,120
2020,2,22000239,1/22/2021,1610612760,Oklahoma City Thunder,0,0,1610612746,LA Clippers,1,1,27,18,45,14,28,42,41,46,87,10,3,13,6,41,24,8,11,98,106
2017,2,21700219,11/17/2017,1610612751,Brooklyn Nets,1,1,1610612762,Utah Jazz,0,0,26,21,47,17,20,37,43,41,84,15,5,20,9,34,27,6,13,98,118
2017,2,21700219,11/17/2017,1610612762,Utah Jazz,0,0,1610612751,Brooklyn Nets,1,1,27,26,53,12,14,26,39,40,79,17,7,24,10,33,21,8,16,97,107
2019,2,21900151,11/12/2019,1610612747,Los Angeles Lakers,0,1,1610612756,Phoenix Suns,1,0,41,29,70,10,15,25,51,44,95,11,10,21,14,36,39,3,10,99,123
2019,2,21900151,11/12/2019,1610612756,Phoenix Suns,1,0,1610612747,Los Angeles Lakers,0,1,27,26,53,16,22,38,43,48,91,13,4,17,10,39,32,4,11,100,115
2014,2,21400039,11/2/2014,1610612746,LA Clippers,1,0,1610612758,Sacramento Kings,0,1,24,33,57,9,22,31,33,55,88,17,4,21,17,39,23,4,10,91,92
2014,2,21400039,11/2/2014,1610612758,Sacramento Kings,0,1,1610612746,LA Clippers,1,0,31,27,58,3,7,10,34,34,68,27,6,33,12,24,21,10,20,90,98
2023,2,22300046,11/24/2023,1610612741,Chicago Bulls,0,0,1610612761,Toronto Raptors,1,1,30,25,55,12,15,27,42,40,82,12,7,19,13,29,20,8,13,92,108
2023,2,22300405,12/25/2023,1610612742,Dallas Mavericks,0,1,1610612756,Phoenix Suns,1,0,29,11,40,16,28,44,45,39,84,22,8,30,9,34,28,5,11,100,128
2023,2,22300127,11/1/2023,1610612747,Los Angeles Lakers,1,1,1610612746,LA Clippers,0,0,35,23,58,11,21,32,46,44,90,27,9,36,13,37,28,12,14,109,130
2023,2,22300415,12/27/2023,1610612753,Orlando Magic,1,0,1610612755,Philadelphia 76ers,0,1,22,24,46,9,24,33,31,48,79,21,3,24,11,38,17,10,17,96,92
2023,2,22300768,2/12/2024,1610612742,Dallas Mavericks,1,1,1610612764,Washington Wizards,0,0,34,26,60,9,27,36,43,53,96,17,9,26,15,43,27,9,16,108,112
2023,2,22300449,12/31/2023,1610612763,Memphis Grizzlies,1,0,1610612758,Sacramento Kings,0,1,18,24,42,12,28,40,30,52,82,20,8,28,5,51,20,2,8,99,92
2021,2,22100436,12/17/2021,1610612747,Los Angeles Lakers,0,0,1610612750,Minnesota Timberwolves,1,1,18,17,35,12,31,43,30,48,78,20,9,29,4,49,26,13,18,107,92
2021,2,22100436,12/17/2021,1610612750,Minnesota Timberwolves,1,1,1610612747,Los Angeles Lakers,0,0,29,25,54,12,32,44,41,57,98,16,8,24,18,43,23,6,15,106,110
2020,2,22000238,1/22/2021,1610612743,Denver Nuggets,0,1,1610612756,Phoenix Suns,1,0,47,30,77,6,20,26,53,50,103,18,1,19,15,36,32,7,9,106,130
2020,2,22000238,1/22/2021,1610612756,Phoenix Suns,1,0,1610612743,Denver Nuggets,0,1,30,20,50,17,27,44,47,47,94,15,0,15,12,35,30,12,16,106,126
2023,2,22300450,12/31/2023,1610612756,Phoenix Suns,1,1,1610612753,Orlando Magic,0,0,36,25,61,8,19,27,44,44,88,16,3,19,7,39,21,2,6,96,112
2019,2,21900397,12/16/2019,1610612748,Miami Heat,0,0,1610612763,Memphis Grizzlies,1,1,26,31,57,11,13,24,37,44,81,26,5,31,13,32,22,4,14,99,111
2019,2,21900397,12/16/2019,1610612763,Memphis Grizzlies,1,1,1610612748,Miami Heat,0,0,29,21,50,13,23,36,42,44,86,21,9,30,19,29,28,9,17,97,118
2020,2,22001041,5/11/2021,1610612747,Los Angeles Lakers,1,1,1610612752,New York Knicks,0,0,25,36,61,12,16,28,37,52,89,15,4,19,16,40,31,8,20,101,101
2020,2,22001041,5/11/2021,1610612752,New York Knicks,0,0,1610612747,Los Angeles Lakers,1,1,24,34,58,10,19,29,34,53,87,21,2,23,9,44,19,5,10,101,99
2021,2,22100435,12/17/2021,1610612738,Boston Celtics,1,0,1610612744,Golden State Warriors,0,1,21,20,41,15,26,41,36,46,82,20,9,29,17,35,20,9,16,97,107
2021,2,22100435,12/17/2021,1610612744,Golden State Warriors,0,1,1610612738,Boston Celtics,1,0,23,21,44,16,30,46,39,51,90,17,4,21,17,36,27,5,14,96,111
2020,2,22000237,1/22/2021,1610612742,Dallas Mavericks,0,1,1610612759,San Antonio Spurs,1,0,31,23,54,14,25,39,45,48,93,18,2,20,8,41,23,3,6,101,122
2020,2,22000237,1/22/2021,1610612759,San Antonio Spurs,1,0,1610612742,Dallas Mavericks,0,1,29,32,61,12,16,28,41,48,89,23,7,30,12,38,21,3,7,101,117
2016,2,21600791,2/8/2017,1610612746,LA Clippers,0,1,1610612752,New York Knicks,1,0,35,32,67,10,15,25,45,47,92,19,9,28,18,33,22,9,11,97,119
2016,2,21600791,2/8/2017,1610612752,New York Knicks,1,0,1610612746,LA Clippers,0,1,38,27,65,8,19,27,46,46,92,15,3,18,15,34,25,8,12,97,115
2014,2,21400439,12/26/2014,1610612742,Dallas Mavericks,1,1,1610612747,Los Angeles Lakers,0,0,37,28,65,5,13,18,42,41,83,13,11,24,10,39,20,8,13,98,102
2014,2,21400439,12/26/2014,1610612747,Los Angeles Lakers,0,0,1610612742,Dallas Mavericks,1,1,25,45,70,11,18,29,36,63,99,15,5,20,27,38,20,9,16,100,98
2023,2,22300127,11/1/2023,1610612746,LA Clippers,0,0,1610612747,Los Angeles Lakers,1,1,33,32,65,14,20,34,47,52,99,17,10,27,14,44,22,10,13,108,125
2021,2,22100434,12/17/2021,1610612737,Atlanta Hawks,1,0,1610612743,Denver Nuggets,0,1,34,30,64,7,17,24,41,47,88,26,8,34,14,36,22,9,15,105,115
2021,2,22100434,12/17/2021,1610612743,Denver Nuggets,0,1,1610612737,Atlanta Hawks,1,0,33,15,48,17,21,38,50,36,86,16,2,18,7,30,35,6,17,106,133
2022,2,22201110,3/25/2023,1610612755,Philadelphia 76ers,0,0,1610612756,Phoenix Suns,1,1,21,26,47,13,18,31,34,44,78,24,3,27,12,34,21,4,13,93,105
2023,2,22300096,10/29/2023,1610612744,Golden State Warriors,0,1,1610612745,Houston Rockets,1,0,17,19,36,18,27,45,35,46,81,18,5,23,12,36,27,7,14,93,106
2023,2,22300122,11/1/2023,1610612766,Charlotte Hornets,0,0,1610612745,Houston Rockets,1,1,34,29,63,11,16,27,45,45,90,18,7,25,18,31,21,10,16,101,119
2020,2,22001040,5/11/2021,1610612758,Sacramento Kings,1,1,1610612760,Oklahoma City Thunder,0,0,25,22,47,19,20,39,44,42,86,15,4,19,9,37,28,9,16,103,122
2020,2,22001040,5/11/2021,1610612760,Oklahoma City Thunder,0,0,1610612758,Sacramento Kings,1,1,30,31,61,9,14,23,39,45,84,19,9,28,15,36,22,13,18,102,106
2023,2,22300376,12/21/2023,1610612741,Chicago Bulls,1,1,1610612759,San Antonio Spurs,0,0,42,20,62,7,21,28,49,41,90,9,2,11,10,32,24,6,12,98,114
2023,2,22300539,1/12/2024,1610612743,Denver Nuggets,1,1,1610612740,New Orleans Pelicans,0,0,36,21,57,14,19,33,50,40,90,11,4,15,14,28,30,9,17,100,125
2020,2,22000236,1/22/2021,1610612737,Atlanta Hawks,0,1,1610612750,Minnesota Timberwolves,1,0,23,25,48,15,20,35,38,45,83,25,5,30,17,31,21,14,17,99,116
2021,2,22100433,12/17/2021,1610612748,Miami Heat,0,1,1610612753,Orlando Magic,1,0,22,25,47,19,16,35,41,41,82,14,5,19,15,29,25,10,17,92,115
2021,2,22100433,12/17/2021,1610612753,Orlando Magic,1,0,1610612748,Miami Heat,0,1,32,25,57,11,21,32,43,46,89,8,2,10,13,33,23,5,11,91,105
2022,2,22201112,3/25/2023,1610612746,LA Clippers,1,0,1610612740,New Orleans Pelicans,0,1,24,18,42,15,18,33,39,36,75,17,4,21,4,35,29,11,20,100,110
2021,2,22100432,12/16/2021,1610612756,Phoenix Suns,1,1,1610612764,Washington Wizards,0,0,33,17,50,9,20,29,42,37,79,25,1,26,10,28,25,11,20,99,118
2021,2,22100432,12/16/2021,1610612764,Washington Wizards,0,0,1610612756,Phoenix Suns,1,1,34,27,61,6,15,21,40,42,82,12,7,19,7,38,22,9,16,98,98
2020,2,22000236,1/22/2021,1610612750,Minnesota Timberwolves,1,0,1610612737,Atlanta Hawks,0,1,32,29,61,8,24,32,40,53,93,10,2,12,11,44,30,9,13,100,98
2019,2,21900396,12/16/2019,1610612745,Houston Rockets,1,1,1610612759,San Antonio Spurs,0,0,29,26,55,11,32,43,40,58,98,18,9,27,16,46,20,5,13,109,109
2019,2,21900396,12/16/2019,1610612759,San Antonio Spurs,0,0,1610612745,Houston Rockets,1,1,27,31,58,12,21,33,39,52,91,17,3,20,10,45,23,9,18,108,107
2019,2,21900150,11/12/2019,1610612737,Atlanta Hawks,0,1,1610612743,Denver Nuggets,1,0,29,20,49,15,19,34,44,39,83,22,12,34,16,26,30,7,15,99,125
2019,2,21900150,11/12/2019,1610612743,Denver Nuggets,1,0,1610612737,Atlanta Hawks,0,1,35,28,63,11,30,41,46,58,104,18,4,22,19,40,31,1,3,100,121
2023,2,22300539,1/12/2024,1610612740,New Orleans Pelicans,0,0,1610612743,Denver Nuggets,1,1,29,27,56,13,20,33,42,47,89,16,6,22,9,40,30,5,9,100,113
2023,2,22300746,2/9/2024,1610612743,Denver Nuggets,0,0,1610612758,Sacramento Kings,1,1,28,25,53,10,19,29,38,44,82,20,8,28,13,37,26,11,21,102,106
2020,2,22000235,5/5/2021,1610612749,Milwaukee Bucks,1,1,1610612764,Washington Wizards,0,0,30,22,52,18,19,37,48,41,89,21,7,28,14,33,30,6,20,106,135
2020,2,22000235,5/5/2021,1610612764,Washington Wizards,0,0,1610612749,Milwaukee Bucks,1,1,39,35,74,8,14,22,47,49,96,32,11,43,15,37,27,4,7,106,134
2021,2,22100431,12/16/2021,1610612745,Houston Rockets,1,0,1610612752,New York Knicks,0,1,23,13,36,11,21,32,34,34,68,24,6,30,11,25,29,8,19,89,103
2021,2,22100431,12/16/2021,1610612752,New York Knicks,0,1,1610612745,Houston Rockets,1,0,22,25,47,17,19,36,39,44,83,21,4,25,18,28,25,4,12,88,116
2017,2,21700218,11/17/2017,1610612748,Miami Heat,0,1,1610612764,Washington Wizards,1,0,24,24,48,10,25,35,34,49,83,13,5,18,12,42,21,4,15,93,91
2017,2,21700218,11/17/2017,1610612764,Washington Wizards,1,0,1610612748,Miami Heat,0,1,22,27,49,10,25,35,32,52,84,14,2,16,10,43,18,6,12,93,88
2016,2,21600790,2/8/2017,1610612750,Minnesota Timberwolves,1,1,1610612761,Toronto Raptors,0,0,32,29,61,7,12,19,39,41,80,27,3,30,14,29,22,6,8,88,112
2022,2,22200530,12/30/2022,1610612737,Atlanta Hawks,1,0,1610612747,Los Angeles Lakers,0,1,37,26,63,11,27,38,48,53,101,14,6,20,14,43,22,7,10,104,121
2022,2,22200530,12/30/2022,1610612747,Los Angeles Lakers,0,1,1610612737,Atlanta Hawks,1,0,42,22,64,10,22,32,52,44,96,16,2,18,15,30,34,6,16,104,130
2020,2,22000234,1/22/2021,1610612748,Miami Heat,0,0,1610612761,Toronto Raptors,1,1,26,20,46,7,24,31,33,44,77,8,2,10,7,37,19,11,19,95,81
2020,2,22000234,1/22/2021,1610612761,Toronto Raptors,1,1,1610612748,Miami Heat,0,0,22,22,44,17,23,40,39,45,84,6,3,9,16,30,22,13,22,96,101
2019,2,21900149,11/12/2019,1610612741,Chicago Bulls,1,1,1610612752,New York Knicks,0,0,27,21,48,14,19,33,41,40,81,24,7,31,13,30,22,12,20,102,120
2019,2,21900149,11/12/2019,1610612752,New York Knicks,0,0,1610612741,Chicago Bulls,1,1,26,30,56,10,22,32,36,52,88,20,11,31,16,41,27,9,18,103,102
2023,2,22300037,11/17/2023,1610612745,Houston Rockets,0,0,1610612746,LA Clippers,1,1,28,29,57,10,21,31,38,50,88,14,6,20,14,41,24,10,17,98,100
2020,2,22001039,5/11/2021,1610612744,Golden State Warriors,1,1,1610612756,Phoenix Suns,0,0,36,19,55,11,29,40,47,48,95,17,3,20,20,30,33,4,10,92,122
2020,2,22001039,5/11/2021,1610612756,Phoenix Suns,0,0,1610612744,Golden State Warriors,1,1,25,17,42,16,21,37,41,38,79,18,2,20,9,30,26,8,11,92,116
2021,2,22100430,2/3/2022,1610612741,Chicago Bulls,0,0,1610612761,Toronto Raptors,1,1,31,30,61,12,17,29,43,47,90,22,2,24,13,36,30,10,17,108,120
2021,2,22100430,2/3/2022,1610612761,Toronto Raptors,1,1,1610612741,Chicago Bulls,0,0,34,43,77,14,22,36,48,65,113,17,2,19,25,41,30,8,12,108,127
2020,2,22000233,1/22/2021,1610612738,Boston Celtics,0,0,1610612755,Philadelphia 76ers,1,1,29,31,60,12,18,30,41,49,90,16,4,20,14,37,23,9,13,99,110
2020,2,22000233,1/22/2021,1610612755,Philadelphia 76ers,1,1,1610612738,Boston Celtics,0,0,33,20,53,12,16,28,45,36,81,20,4,24,14,23,23,10,20,97,122
2017,2,21700217,11/17/2017,1610612754,Indiana Pacers,1,1,1610612765,Detroit Pistons,0,0,24,37,61,15,13,28,39,50,89,14,7,21,16,35,22,4,10,93,107
2020,2,22000232,1/22/2021,1610612739,Cleveland Cavaliers,1,1,1610612751,Brooklyn Nets,0,0,37,25,62,8,17,25,45,42,87,27,5,32,18,25,24,5,15,98,125
2020,2,22000232,1/22/2021,1610612751,Brooklyn Nets,0,0,1610612739,Cleveland Cavaliers,1,1,28,16,44,14,29,43,42,45,87,15,2,17,7,40,23,7,11,98,113
2017,2,21700217,11/17/2017,1610612765,Detroit Pistons,0,0,1610612754,Indiana Pacers,1,1,25,35,60,14,19,33,39,54,93,8,2,10,15,39,20,4,11,94,100
2016,2,21600790,2/8/2017,1610612761,Toronto Raptors,0,0,1610612750,Minnesota Timberwolves,1,1,31,20,51,11,17,28,42,37,79,14,6,20,13,27,19,8,13,90,109
2014,2,21400038,11/1/2014,1610612744,Golden State Warriors,1,1,1610612747,Los Angeles Lakers,0,0,35,25,60,11,12,23,46,37,83,24,4,28,14,24,30,9,20,101,127
2014,2,21400038,11/1/2014,1610612747,Los Angeles Lakers,0,0,1610612744,Golden State Warriors,1,1,37,37,74,4,10,14,41,47,88,18,7,25,18,34,21,10,22,102,104
2018,2,21800742,1/27/2019,1610612759,San Antonio Spurs,1,1,1610612764,Washington Wizards,0,0,33,19,52,16,18,34,49,37,86,18,3,21,12,26,31,11,16,101,132
2021,2,22100429,12/16/2021,1610612751,Brooklyn Nets,1,1,1610612755,Philadelphia 76ers,0,0,33,33,66,11,12,23,44,45,89,15,1,16,11,35,21,10,15,98,114
2021,2,22100429,12/16/2021,1610612755,Philadelphia 76ers,0,0,1610612751,Brooklyn Nets,1,1,29,26,55,10,24,34,39,50,89,17,3,20,9,42,19,4,9,99,105
2014,2,21400037,11/1/2014,1610612756,Phoenix Suns,0,0,1610612762,Utah Jazz,1,1,29,27,56,7,24,31,36,51,87,12,3,15,11,41,17,10,13,97,91
2014,2,21400037,11/1/2014,1610612762,Utah Jazz,1,1,1610612756,Phoenix Suns,0,0,35,27,62,7,19,26,42,46,88,27,6,33,16,32,19,8,14,97,118
2019,2,21900395,12/16/2019,1610612739,Cleveland Cavaliers,0,0,1610612761,Toronto Raptors,1,1,32,23,55,12,23,35,44,46,90,13,4,17,11,37,30,7,11,100,113
2019,2,21900395,12/16/2019,1610612761,Toronto Raptors,1,1,1610612739,Cleveland Cavaliers,0,0,36,21,57,16,16,32,52,37,89,13,4,17,7,32,31,6,7,99,133
2021,2,22100428,12/16/2021,1610612754,Indiana Pacers,1,1,1610612765,Detroit Pistons,0,0,38,21,59,7,25,32,45,46,91,25,3,28,13,34,26,6,9,101,122
2021,2,22100428,12/16/2021,1610612765,Detroit Pistons,0,0,1610612754,Indiana Pacers,1,1,33,23,56,7,18,25,40,41,81,26,4,30,7,36,20,6,12,100,113
2020,2,22000231,1/22/2021,1610612753,Orlando Magic,0,0,1610612754,Indiana Pacers,1,1,26,31,57,17,20,37,43,51,94,15,9,24,17,38,29,9,14,102,118
2020,2,22000231,1/22/2021,1610612754,Indiana Pacers,1,1,1610612753,Orlando Magic,0,0,34,25,59,12,22,34,46,47,93,16,2,18,10,38,28,7,10,102,120
2023,2,22300499,1/7/2024,1610612737,Atlanta Hawks,0,0,1610612753,Orlando Magic,1,1,33,28,61,9,21,30,42,49,91,17,12,29,9,46,21,8,13,105,110
2021,2,22100427,12/15/2021,1610612758,Sacramento Kings,1,1,1610612764,Washington Wizards,0,0,37,19,56,8,18,26,45,37,82,21,8,29,7,34,25,8,11,98,119
2021,2,22100427,12/15/2021,1610612764,Washington Wizards,0,0,1610612758,Sacramento Kings,1,1,37,28,65,5,19,24,42,47,89,16,5,21,12,36,20,7,11,99,105
2017,2,21700216,11/16/2017,1610612745,Houston Rockets,0,1,1610612756,Phoenix Suns,1,0,22,24,46,21,23,44,43,47,90,35,3,38,13,36,27,9,14,106,142
2017,2,21700216,11/16/2017,1610612756,Phoenix Suns,1,0,1610612745,Houston Rockets,0,1,37,37,74,10,20,30,47,57,104,12,9,21,22,40,28,9,15,107,116
2019,2,21900394,12/16/2019,1610612764,Washington Wizards,0,1,1610612765,Detroit Pistons,1,0,31,23,54,18,16,34,49,39,88,17,4,21,13,26,31,6,16,98,133
2019,2,21900394,12/16/2019,1610612765,Detroit Pistons,1,0,1610612764,Washington Wizards,0,1,28,19,47,13,26,39,41,45,86,24,10,34,18,30,29,6,14,97,119
2016,2,21600300,12/4/2016,1610612753,Orlando Magic,0,1,1610612765,Detroit Pistons,1,0,35,21,56,7,16,23,42,37,79,7,7,14,6,35,23,8,11,89,98
2020,2,22001037,5/11/2021,1610612742,Dallas Mavericks,0,0,1610612763,Memphis Grizzlies,1,1,25,25,50,12,26,38,37,51,88,18,1,19,18,34,23,11,13,92,104
2020,2,22001037,5/11/2021,1610612763,Memphis Grizzlies,1,1,1610612742,Dallas Mavericks,0,0,35,21,56,16,17,33,51,38,89,15,1,16,14,24,32,8,11,93,133
2020,2,22000230,1/22/2021,1610612745,Houston Rockets,0,1,1610612765,Detroit Pistons,1,0,23,31,54,14,27,41,37,58,95,15,5,20,19,42,24,5,14,100,103
2020,2,22000230,1/22/2021,1610612765,Detroit Pistons,1,0,1610612745,Houston Rockets,0,1,16,34,50,15,17,32,31,51,82,25,12,37,20,38,17,7,19,99,102
2021,2,22100426,12/15/2021,1610612757,Portland Trail Blazers,1,0,1610612763,Memphis Grizzlies,0,1,16,28,44,15,23,38,31,51,82,26,2,28,9,43,18,10,15,99,103
2021,2,22100426,12/15/2021,1610612763,Memphis Grizzlies,0,1,1610612757,Portland Trail Blazers,1,0,28,22,50,11,21,32,39,43,82,24,6,30,13,35,22,9,16,100,113
2017,2,21700215,11/16/2017,1610612738,Boston Celtics,1,1,1610612744,Golden State Warriors,0,0,19,28,47,7,25,32,26,53,79,33,5,38,13,42,15,9,15,100,92
2017,2,21700215,11/16/2017,1610612744,Golden State Warriors,0,0,1610612738,Boston Celtics,1,1,23,27,50,10,22,32,33,49,82,12,7,19,7,48,22,8,15,99,88
2014,2,21400036,11/1/2014,1610612743,Denver Nuggets,0,0,1610612760,Oklahoma City Thunder,1,1,28,26,54,7,19,26,35,45,80,14,6,20,11,36,19,8,18,96,91
2020,2,22001036,5/11/2021,1610612741,Chicago Bulls,1,0,1610612751,Brooklyn Nets,0,1,21,31,52,18,26,44,39,57,96,11,3,14,17,41,21,4,9,96,107
2020,2,22001036,5/11/2021,1610612751,Brooklyn Nets,0,1,1610612741,Chicago Bulls,1,0,30,26,56,12,21,33,42,47,89,19,6,25,14,37,32,4,8,95,115
2017,2,21700214,11/15/2017,1610612747,Los Angeles Lakers,1,0,1610612755,Philadelphia 76ers,0,1,39,43,82,3,24,27,42,67,109,22,5,27,26,44,18,7,9,107,109
2021,2,22100425,12/15/2021,1610612746,LA Clippers,0,0,1610612762,Utah Jazz,1,1,30,25,55,10,20,30,40,45,85,13,7,20,10,37,24,11,16,99,103
2021,2,22100425,12/15/2021,1610612762,Utah Jazz,1,1,1610612746,LA Clippers,0,0,32,20,52,15,22,37,47,42,89,15,5,20,9,36,26,6,10,98,124
2020,2,22000229,1/22/2021,1610612741,Chicago Bulls,0,1,1610612766,Charlotte Hornets,1,0,34,19,53,15,28,43,49,47,96,10,2,12,15,34,33,8,16,101,123
2020,2,22000229,1/22/2021,1610612766,Charlotte Hornets,1,0,1610612741,Chicago Bulls,0,1,35,18,53,7,25,32,42,43,85,19,6,25,16,30,22,11,21,101,110
2017,2,21700214,11/15/2017,1610612755,Philadelphia 76ers,0,1,1610612747,Los Angeles Lakers,1,0,35,19,54,7,25,32,42,44,86,24,6,30,10,38,27,7,16,106,115
2019,2,21900148,11/12/2019,1610612748,Miami Heat,1,1,1610612765,Detroit Pistons,0,0,27,18,45,14,18,32,41,36,77,21,6,27,14,25,34,9,20,97,117
2019,2,21900148,11/12/2019,1610612765,Detroit Pistons,0,0,1610612748,Miami Heat,1,1,19,18,37,15,26,41,34,44,78,25,12,37,12,38,27,6,16,97,108
2016,2,21600300,12/4/2016,1610612765,Detroit Pistons,1,0,1610612753,Orlando Magic,0,1,28,31,59,10,17,27,38,48,86,6,7,13,16,36,16,8,13,91,92
2014,2,21401017,3/19/2015,1610612743,Denver Nuggets,0,0,1610612745,Houston Rockets,1,1,29,28,57,13,23,36,42,51,93,11,8,19,12,42,23,8,16,107,108
2014,2,21401017,3/19/2015,1610612745,Houston Rockets,1,1,1610612743,Denver Nuggets,0,0,25,28,53,12,18,30,37,46,83,32,8,40,14,37,27,8,16,105,118
2014,2,21400438,12/26/2014,1610612760,Oklahoma City Thunder,1,1,1610612766,Charlotte Hornets,0,0,28,33,61,8,19,27,36,52,88,18,3,21,14,39,18,8,11,95,98
2014,2,21400438,12/26/2014,1610612766,Charlotte Hornets,0,0,1610612760,Oklahoma City Thunder,1,1,20,43,63,5,19,24,25,62,87,20,6,26,18,46,12,6,16,97,75
2022,2,22200587,1/6/2023,1610612746,LA Clippers,0,0,1610612750,Minnesota Timberwolves,1,1,35,40,75,9,16,25,44,56,100,18,9,27,22,39,22,4,10,100,115
2022,2,22200587,1/6/2023,1610612750,Minnesota Timberwolves,1,1,1610612746,LA Clippers,0,0,33,13,46,13,22,35,46,35,81,23,6,29,13,25,28,13,20,101,128
2022,2,22200503,12/26/2022,1610612759,San Antonio Spurs,1,1,1610612762,Utah Jazz,0,0,42,27,69,6,12,18,48,39,87,24,10,34,10,33,27,10,14,105,126
2020,2,22000228,1/21/2021,1610612744,Golden State Warriors,1,0,1610612752,New York Knicks,0,1,24,24,48,9,29,38,33,53,86,29,10,39,16,45,27,5,10,101,104
2020,2,22000228,1/21/2021,1610612752,New York Knicks,0,1,1610612744,Golden State Warriors,1,0,27,31,58,11,13,24,38,44,82,32,9,41,13,37,24,5,11,100,119
2022,2,22200503,12/26/2022,1610612762,Utah Jazz,0,0,1610612759,San Antonio Spurs,1,1,26,28,54,13,30,43,39,58,97,31,6,37,22,37,20,11,12,104,122
2021,2,22100424,12/15/2021,1610612743,Denver Nuggets,1,0,1610612750,Minnesota Timberwolves,0,1,24,21,45,14,25,39,38,46,84,17,6,23,14,34,33,10,18,99,107
2021,2,22100424,12/15/2021,1610612750,Minnesota Timberwolves,0,1,1610612743,Denver Nuggets,1,0,22,18,40,23,25,48,45,43,88,11,5,16,9,36,24,5,12,99,124
2017,2,21700213,11/15/2017,1610612753,Orlando Magic,0,0,1610612757,Portland Trail Blazers,1,1,26,24,50,11,18,29,37,42,79,9,0,9,8,34,19,7,15,91,94
2017,2,21700213,11/15/2017,1610612757,Portland Trail Blazers,1,1,1610612753,Orlando Magic,0,0,24,36,60,14,13,27,38,49,87,9,4,13,16,34,21,6,13,92,99
2016,2,21600789,2/8/2017,1610612740,New Orleans Pelicans,1,0,1610612762,Utah Jazz,0,1,30,23,53,5,19,24,35,42,77,19,6,25,9,37,17,9,13,92,94
2016,2,21600789,2/8/2017,1610612762,Utah Jazz,0,1,1610612740,New Orleans Pelicans,1,0,34,22,56,14,18,32,48,40,88,17,4,21,13,30,25,6,8,93,127
2020,2,22001035,5/11/2021,1610612754,Indiana Pacers,1,1,1610612755,Philadelphia 76ers,0,0,23,19,42,14,27,41,37,46,83,15,1,16,13,34,28,9,14,94,103
2020,2,22001035,5/11/2021,1610612755,Philadelphia 76ers,0,0,1610612754,Indiana Pacers,1,1,30,31,61,8,18,26,38,49,87,10,4,14,11,41,23,7,11,94,94
2022,2,22200518,12/28/2022,1610612747,Los Angeles Lakers,0,0,1610612748,Miami Heat,1,1,24,17,41,13,23,36,37,40,77,11,4,15,14,28,25,14,26,93,98
2022,2,22200518,12/28/2022,1610612748,Miami Heat,1,1,1610612747,Los Angeles Lakers,0,0,33,24,57,11,24,35,44,48,92,13,3,16,14,36,20,2,6,94,112
2021,2,22100423,12/15/2021,1610612759,San Antonio Spurs,1,0,1610612766,Charlotte Hornets,0,1,27,26,53,12,25,37,39,51,90,25,0,25,12,39,27,3,8,97,115
2021,2,22100423,12/15/2021,1610612766,Charlotte Hornets,0,1,1610612759,San Antonio Spurs,1,0,33,19,52,18,16,34,51,35,86,11,5,16,10,27,34,5,13,97,131
2020,2,22000227,1/21/2021,1610612740,New Orleans Pelicans,0,0,1610612762,Utah Jazz,1,1,31,29,60,11,14,25,42,43,85,23,7,30,13,34,27,8,18,104,118
2020,2,22000227,1/21/2021,1610612762,Utah Jazz,1,1,1610612740,New Orleans Pelicans,0,0,27,22,49,17,22,39,44,44,88,24,1,25,12,32,27,9,15,104,129
2020,2,22001034,5/11/2021,1610612746,LA Clippers,0,1,1610612761,Toronto Raptors,1,0,28,18,46,11,21,32,39,39,78,26,0,26,11,28,25,10,18,96,115
2020,2,22001034,5/11/2021,1610612761,Toronto Raptors,1,0,1610612746,LA Clippers,0,1,25,24,49,10,27,37,35,51,86,16,3,19,11,42,21,10,13,98,96
2022,2,22201110,3/25/2023,1610612756,Phoenix Suns,1,1,1610612755,Philadelphia 76ers,0,0,32,29,61,15,17,32,47,46,93,16,3,19,17,30,35,3,8,92,125
2020,2,22000226,1/21/2021,1610612747,Los Angeles Lakers,0,1,1610612749,Milwaukee Bucks,1,0,22,29,51,19,18,37,41,47,88,12,3,15,7,42,25,5,9,97,113
2020,2,22000226,1/21/2021,1610612749,Milwaukee Bucks,1,0,1610612747,Los Angeles Lakers,0,1,35,24,59,9,19,28,44,43,87,9,3,12,9,35,27,8,16,98,106
2019,2,21900393,12/15/2019,1610612744,Golden State Warriors,1,0,1610612758,Sacramento Kings,0,1,24,27,51,6,19,25,30,46,76,13,5,18,11,37,24,9,21,93,79
2022,2,22201112,3/25/2023,1610612740,New Orleans Pelicans,0,1,1610612746,LA Clippers,1,0,30,32,62,21,13,34,51,45,96,8,1,9,16,29,36,9,16,100,131
2023,2,22300125,11/1/2023,1610612762,Utah Jazz,1,1,1610612763,Memphis Grizzlies,0,0,25,19,44,22,21,43,47,40,87,17,7,24,11,31,35,12,21,108,133
2020,2,22001033,5/11/2021,1610612750,Minnesota Timberwolves,0,1,1610612765,Detroit Pistons,1,0,31,19,50,14,34,48,45,53,98,15,6,21,15,41,30,8,15,107,119
2020,2,22001033,5/11/2021,1610612765,Detroit Pistons,1,0,1610612750,Minnesota Timberwolves,0,1,25,27,52,10,13,23,35,40,75,20,6,26,9,34,21,16,28,106,100
2021,2,22100422,12/15/2021,1610612740,New Orleans Pelicans,0,1,1610612760,Oklahoma City Thunder,1,0,28,24,52,11,17,28,39,41,80,24,12,36,11,35,23,8,12,98,113
2021,2,22100422,12/15/2021,1610612760,Oklahoma City Thunder,1,0,1610612740,New Orleans Pelicans,0,1,26,32,58,13,22,35,39,54,93,19,0,19,12,42,22,6,8,98,110
2014,2,21400036,11/1/2014,1610612760,Oklahoma City Thunder,1,1,1610612743,Denver Nuggets,0,0,31,29,60,6,14,20,37,43,80,22,9,31,13,33,24,4,14,96,102
2019,2,21900393,12/15/2019,1610612758,Sacramento Kings,0,1,1610612744,Golden State Warriors,1,0,28,13,41,10,12,22,38,25,63,14,2,16,5,20,27,14,29,94,100
2019,2,21900147,11/12/2019,1610612739,Cleveland Cavaliers,0,0,1610612755,Philadelphia 76ers,1,1,33,32,65,5,16,21,38,48,86,16,4,20,14,36,13,8,14,94,97
2019,2,21900147,11/12/2019,1610612755,Philadelphia 76ers,1,1,1610612739,Cleveland Cavaliers,0,0,32,19,51,8,30,38,40,49,89,10,3,13,14,37,24,10,14,95,98
2020,2,22000225,4/23/2021,1610612757,Portland Trail Blazers,1,0,1610612763,Memphis Grizzlies,0,1,32,29,61,14,21,35,46,50,96,22,5,27,17,35,28,7,12,105,128
2020,2,22000225,4/23/2021,1610612763,Memphis Grizzlies,0,1,1610612757,Portland Trail Blazers,1,0,43,25,68,9,21,30,52,46,98,17,5,22,12,37,33,6,9,104,130
2019,2,21900392,12/15/2019,1610612743,Denver Nuggets,1,1,1610612752,New York Knicks,0,0,34,32,66,10,18,28,44,50,94,13,6,19,19,35,27,9,9,91,111
2019,2,21900392,12/15/2019,1610612752,New York Knicks,0,0,1610612743,Denver Nuggets,1,1,36,26,62,8,24,32,44,50,94,9,1,10,17,33,20,5,11,92,105
2017,2,21700212,11/15/2017,1610612741,Chicago Bulls,0,0,1610612760,Oklahoma City Thunder,1,1,15,31,46,11,18,29,26,49,75,16,4,20,12,39,16,7,17,89,79
2017,2,21700212,11/15/2017,1610612760,Oklahoma City Thunder,1,1,1610612741,Chicago Bulls,0,0,18,24,42,8,22,30,26,46,72,32,5,37,14,35,15,7,14,91,92
2014,2,21400035,11/1/2014,1610612741,Chicago Bulls,0,1,1610612750,Minnesota Timberwolves,1,0,24,22,46,9,14,23,33,36,69,31,9,40,10,32,15,9,17,94,106
2023,2,22300965,3/15/2024,1610612759,San Antonio Spurs,1,0,1610612743,Denver Nuggets,0,1,26,26,52,11,18,29,37,44,81,21,6,27,14,34,23,13,17,96,106
2014,2,21400035,11/1/2014,1610612750,Minnesota Timberwolves,1,0,1610612741,Chicago Bulls,0,1,34,39,73,4,8,12,38,47,85,25,6,31,16,35,26,3,11,94,105
2021,2,22100421,12/15/2021,1610612749,Milwaukee Bucks,1,1,1610612754,Indiana Pacers,0,0,30,31,61,14,15,29,44,46,90,12,3,15,11,37,25,6,9,95,114
2017,2,21700211,11/15/2017,1610612740,New Orleans Pelicans,1,0,1610612761,Toronto Raptors,0,1,36,28,64,10,17,27,46,45,91,14,0,14,13,32,31,8,14,99,116
2017,2,21700211,11/15/2017,1610612761,Toronto Raptors,0,1,1610612740,New Orleans Pelicans,1,0,29,13,42,16,18,34,45,31,76,19,1,20,8,23,27,13,21,98,125
2021,2,22100421,12/15/2021,1610612754,Indiana Pacers,0,0,1610612749,Milwaukee Bucks,1,1,28,17,45,11,27,38,39,44,83,10,1,11,14,31,24,10,19,95,99
2020,2,22000224,1/20/2021,1610612746,LA Clippers,1,1,1610612758,Sacramento Kings,0,0,25,26,51,16,19,35,41,45,86,17,1,18,10,36,24,11,17,103,115
2020,2,22001032,5/11/2021,1610612738,Boston Celtics,1,0,1610612748,Miami Heat,0,1,28,23,51,18,19,37,46,42,88,11,6,17,7,39,31,7,11,99,121
2020,2,22001032,5/11/2021,1610612748,Miami Heat,0,1,1610612738,Boston Celtics,1,0,32,19,51,16,14,30,48,33,81,17,5,22,6,31,25,8,14,98,129
2020,2,22000224,1/20/2021,1610612758,Sacramento Kings,0,0,1610612746,LA Clippers,1,1,26,32,58,13,15,28,39,47,86,5,7,12,8,44,25,14,18,102,96
2017,2,21700210,11/15/2017,1610612750,Minnesota Timberwolves,1,1,1610612759,San Antonio Spurs,0,0,30,39,69,9,9,18,39,48,87,11,5,16,16,34,27,4,7,87,98
2023,2,22300122,11/1/2023,1610612745,Houston Rockets,1,1,1610612766,Charlotte Hornets,0,0,23,24,47,21,16,37,44,40,84,19,4,23,11,32,35,9,17,101,128
2023,2,22300125,11/1/2023,1610612763,Memphis Grizzlies,0,0,1610612762,Utah Jazz,1,1,21,21,42,14,40,54,35,61,96,25,7,32,21,44,25,7,16,108,109
2020,2,22000223,1/20/2021,1610612744,Golden State Warriors,1,1,1610612759,San Antonio Spurs,0,0,31,22,53,15,23,38,46,45,91,14,6,20,13,34,31,7,15,102,121
2020,2,22000223,1/20/2021,1610612759,San Antonio Spurs,0,0,1610612744,Golden State Warriors,1,1,31,30,61,4,29,33,35,59,94,25,6,31,15,48,17,6,10,103,99
2017,2,21700210,11/15/2017,1610612759,San Antonio Spurs,0,0,1610612750,Minnesota Timberwolves,1,1,26,29,55,7,17,24,33,46,79,13,2,15,16,30,20,9,16,86,86
2016,2,21600788,2/8/2017,1610612756,Phoenix Suns,0,0,1610612763,Memphis Grizzlies,1,1,24,40,64,5,18,23,29,58,87,28,6,34,25,36,13,6,16,96,91
2016,2,21600788,2/8/2017,1610612763,Memphis Grizzlies,1,1,1610612756,Phoenix Suns,0,0,21,27,48,14,10,24,35,37,72,26,8,34,11,30,24,12,22,95,110
2016,2,21600299,12/3/2016,1610612744,Golden State Warriors,1,1,1610612756,Phoenix Suns,0,0,35,22,57,14,7,21,49,29,78,26,8,34,9,24,37,8,17,101,138
2016,2,21600299,12/3/2016,1610612756,Phoenix Suns,0,0,1610612744,Golden State Warriors,1,1,30,29,59,11,21,32,41,50,91,16,5,21,16,35,24,9,15,101,109
2018,2,21801096,3/24/2019,1610612739,Cleveland Cavaliers,0,0,1610612749,Milwaukee Bucks,1,1,30,25,55,11,30,41,41,55,96,12,5,17,16,42,23,8,12,101,105
2018,2,21801096,3/24/2019,1610612749,Milwaukee Bucks,1,1,1610612739,Cleveland Cavaliers,0,0,33,13,46,15,26,41,48,39,87,16,5,21,6,35,26,6,9,101,127
2018,2,21800956,3/4/2019,1610612740,New Orleans Pelicans,0,1,1610612762,Utah Jazz,1,0,37,39,76,9,11,20,46,50,96,14,4,18,15,37,24,3,8,97,115
2018,2,21800956,3/4/2019,1610612762,Utah Jazz,1,0,1610612740,New Orleans Pelicans,0,1,29,25,54,14,24,38,43,49,92,12,2,14,16,34,35,12,18,97,112
2023,2,22300378,12/21/2023,1610612749,Milwaukee Bucks,1,1,1610612753,Orlando Magic,0,0,27,26,53,11,26,37,38,52,90,31,4,35,17,36,26,6,13,103,118
2020,2,22000222,1/20/2021,1610612745,Houston Rockets,1,0,1610612756,Phoenix Suns,0,1,27,30,57,10,21,31,37,51,88,19,3,22,9,43,17,6,16,104,103
2020,2,22000222,1/20/2021,1610612756,Phoenix Suns,0,1,1610612745,Houston Rockets,1,0,34,21,55,8,26,34,42,47,89,17,2,19,12,35,25,11,17,103,109
2021,2,22100420,12/15/2021,1610612742,Dallas Mavericks,1,0,1610612747,Los Angeles Lakers,0,1,27,27,54,12,32,44,39,59,98,14,3,17,15,46,22,8,11,105,104
2021,2,22100420,12/15/2021,1610612747,Los Angeles Lakers,0,1,1610612742,Dallas Mavericks,1,0,24,27,51,15,24,39,39,51,90,14,4,18,7,47,24,4,14,104,107
2019,2,21900391,12/15/2019,1610612751,Brooklyn Nets,1,1,1610612755,Philadelphia 76ers,0,0,34,36,70,9,15,24,43,51,94,14,4,18,17,35,22,9,16,101,109
2021,2,22100419,12/15/2021,1610612748,Miami Heat,0,1,1610612755,Philadelphia 76ers,1,0,17,17,34,18,26,44,35,43,78,13,4,17,14,31,25,9,18,91,101
2021,2,22100419,12/15/2021,1610612755,Philadelphia 76ers,1,0,1610612748,Miami Heat,0,1,23,19,42,12,25,37,35,44,79,14,3,17,7,39,26,5,11,90,96
2020,2,22000221,1/20/2021,1610612750,Minnesota Timberwolves,1,0,1610612753,Orlando Magic,0,1,21,29,50,15,20,35,36,49,85,9,5,14,13,39,25,5,16,94,96
2020,2,22000221,1/20/2021,1610612753,Orlando Magic,0,1,1610612750,Minnesota Timberwolves,1,0,26,35,61,10,21,31,36,56,92,15,6,21,19,39,26,5,12,95,97
2019,2,21900391,12/15/2019,1610612755,Philadelphia 76ers,0,0,1610612751,Brooklyn Nets,1,1,32,28,60,5,21,26,37,49,86,10,7,17,10,41,19,9,16,101,89
2019,2,21900146,11/12/2019,1610612754,Indiana Pacers,1,1,1610612760,Oklahoma City Thunder,0,0,39,32,71,7,16,23,46,48,94,12,1,13,16,33,21,9,15,99,111
2019,2,21900146,11/12/2019,1610612760,Oklahoma City Thunder,0,0,1610612754,Indiana Pacers,1,1,23,34,57,6,19,25,29,53,82,21,3,24,11,43,19,6,15,99,85
2017,2,21700209,11/15/2017,1610612749,Milwaukee Bucks,1,1,1610612765,Detroit Pistons,0,0,30,26,56,8,14,22,38,40,78,15,5,20,14,28,24,7,15,89,99
2017,2,21700209,11/15/2017,1610612765,Detroit Pistons,0,0,1610612749,Milwaukee Bucks,1,1,15,33,48,15,22,37,30,55,85,20,3,23,24,34,23,10,18,91,95
2016,2,21600787,2/8/2017,1610612748,Miami Heat,0,1,1610612749,Milwaukee Bucks,1,0,30,23,53,11,22,33,41,45,86,13,5,18,18,30,23,10,16,91,106
2016,2,21600787,2/8/2017,1610612749,Milwaukee Bucks,1,0,1610612748,Miami Heat,0,1,27,29,56,6,9,15,33,38,71,16,12,28,7,37,18,5,13,90,88
2014,2,21400034,11/1/2014,1610612738,Boston Celtics,0,0,1610612745,Houston Rockets,1,1,36,37,73,1,24,25,37,61,98,15,3,18,18,45,20,9,11,100,90
2017,2,21700206,11/15/2017,1610612752,New York Knicks,1,1,1610612762,Utah Jazz,0,0,29,31,60,9,12,21,38,43,81,21,4,25,15,29,18,5,11,90,106
2017,2,21700206,11/15/2017,1610612762,Utah Jazz,0,0,1610612752,New York Knicks,1,1,17,27,44,17,18,35,34,45,79,16,1,17,11,34,19,4,13,90,101
2021,2,22100418,12/15/2021,1610612737,Atlanta Hawks,0,1,1610612753,Orlando Magic,1,0,31,23,54,11,20,31,42,43,85,16,0,16,7,36,25,4,13,97,111
2021,2,22100418,12/15/2021,1610612753,Orlando Magic,1,0,1610612737,Atlanta Hawks,0,1,25,30,55,10,25,35,35,55,90,19,2,21,18,39,25,11,17,98,99
2014,2,21400034,11/1/2014,1610612745,Houston Rockets,1,1,1610612738,Boston Celtics,0,0,20,22,42,12,22,34,32,44,76,28,12,40,17,32,20,10,19,99,104
2023,2,22300123,11/1/2023,1610612750,Minnesota Timberwolves,1,1,1610612743,Denver Nuggets,0,0,30,32,62,8,13,21,38,45,83,26,1,27,12,34,20,6,14,98,110
2023,2,22300056,11/28/2023,1610612749,Milwaukee Bucks,0,1,1610612748,Miami Heat,1,0,34,19,53,13,22,35,47,41,88,24,3,27,10,32,26,3,9,99,131
2020,2,22000220,1/20/2021,1610612748,Miami Heat,0,1,1610612761,Toronto Raptors,1,0,21,19,40,18,22,40,39,41,80,15,2,17,11,31,29,8,19,96,111
2020,2,22000220,1/20/2021,1610612761,Toronto Raptors,1,0,1610612748,Miami Heat,0,1,19,20,39,16,33,49,35,53,88,16,2,18,16,38,27,4,13,96,102
2021,2,22100417,12/15/2021,1610612739,Cleveland Cavaliers,1,1,1610612745,Houston Rockets,0,0,27,13,40,18,22,40,45,35,80,16,8,24,9,32,26,13,17,96,124
2023,2,22300056,11/28/2023,1610612748,Miami Heat,1,0,1610612749,Milwaukee Bucks,0,1,34,30,64,14,16,30,48,46,94,14,7,21,10,41,32,3,6,100,124
2021,2,22100417,12/15/2021,1610612745,Houston Rockets,0,0,1610612739,Cleveland Cavaliers,1,1,25,24,49,5,24,29,30,48,78,24,11,35,16,38,20,6,17,96,89
2019,2,21900390,12/15/2019,1610612737,Atlanta Hawks,1,0,1610612747,Los Angeles Lakers,0,1,19,25,44,12,30,42,31,55,86,22,3,25,13,45,18,14,20,104,96
2019,2,21900390,12/15/2019,1610612747,Los Angeles Lakers,0,1,1610612737,Atlanta Hawks,1,0,31,22,53,5,26,31,36,48,84,24,9,33,15,37,21,8,22,105,101
2020,2,22001031,5/10/2021,1610612745,Houston Rockets,0,0,1610612757,Portland Trail Blazers,1,1,24,23,47,18,20,38,42,43,85,27,1,28,7,36,30,7,13,104,129
2020,2,22001031,5/10/2021,1610612757,Portland Trail Blazers,1,1,1610612745,Houston Rockets,0,0,29,23,52,18,22,40,47,45,92,28,7,35,12,37,30,5,9,103,140
2017,2,21700207,11/15/2017,1610612739,Cleveland Cavaliers,0,1,1610612766,Charlotte Hornets,1,0,29,28,57,13,25,38,42,53,95,18,2,20,20,34,25,7,14,98,115
2017,2,21700207,11/15/2017,1610612766,Charlotte Hornets,1,0,1610612739,Cleveland Cavaliers,0,1,35,25,60,6,20,26,41,45,86,19,9,28,13,37,21,9,13,98,107
2017,2,21700208,11/15/2017,1610612754,Indiana Pacers,0,1,1610612763,Memphis Grizzlies,1,0,31,30,61,12,12,24,43,42,85,18,2,20,10,34,29,5,12,97,116
2017,2,21700208,11/15/2017,1610612763,Memphis Grizzlies,1,0,1610612754,Indiana Pacers,0,1,36,18,54,8,24,32,44,42,86,17,5,22,12,33,29,6,14,97,113
2021,2,22100416,12/14/2021,1610612756,Phoenix Suns,0,1,1610612757,Portland Trail Blazers,1,0,33,29,62,11,20,31,44,49,93,12,3,15,12,37,30,7,14,103,111
2021,2,22100416,12/14/2021,1610612757,Portland Trail Blazers,1,0,1610612756,Phoenix Suns,0,1,27,28,55,13,28,41,40,56,96,14,8,22,15,44,23,7,14,105,107
2014,2,21400033,11/1/2014,1610612751,Brooklyn Nets,0,1,1610612765,Detroit Pistons,1,0,35,26,61,7,19,26,42,45,87,11,2,13,15,31,18,3,8,87,102
2023,2,22300121,11/1/2023,1610612760,Oklahoma City Thunder,1,0,1610612740,New Orleans Pelicans,0,1,31,23,54,7,27,34,38,50,88,23,2,25,11,40,23,8,15,103,106
2016,2,21600298,12/3/2016,1610612748,Miami Heat,0,0,1610612757,Portland Trail Blazers,1,1,32,32,64,6,16,22,38,48,86,10,5,15,14,36,23,6,14,96,92
2016,2,21600298,12/3/2016,1610612757,Portland Trail Blazers,1,1,1610612748,Miami Heat,0,0,27,38,65,9,15,24,36,53,89,18,6,24,13,43,19,6,9,95,99
2014,2,21400437,12/26/2014,1610612740,New Orleans Pelicans,1,1,1610612759,San Antonio Spurs,0,0,29,38,67,6,11,17,35,49,84,21,3,24,10,40,25,2,8,96,97
2014,2,21400437,12/26/2014,1610612759,San Antonio Spurs,0,0,1610612740,New Orleans Pelicans,1,1,31,30,61,6,8,14,37,38,75,10,4,14,3,37,25,8,17,95,90
2023,2,22300121,11/1/2023,1610612740,New Orleans Pelicans,0,1,1610612760,Oklahoma City Thunder,1,0,27,33,60,13,29,42,40,62,102,17,12,29,24,45,23,6,11,103,110
2023,2,22300836,2/27/2024,1610612755,Philadelphia 76ers,0,0,1610612738,Boston Celtics,1,1,23,29,52,14,28,42,37,57,94,11,1,12,11,47,20,7,10,97,99
2018,2,21800955,3/4/2019,1610612749,Milwaukee Bucks,0,0,1610612756,Phoenix Suns,1,1,23,30,53,12,30,42,35,60,95,23,8,31,22,42,17,10,15,103,105
2018,2,21800955,3/4/2019,1610612756,Phoenix Suns,1,1,1610612749,Milwaukee Bucks,0,0,34,35,69,7,15,22,41,50,91,25,6,31,17,39,22,8,14,102,114
2018,2,21800837,2/10/2019,1610612737,Atlanta Hawks,1,0,1610612753,Orlando Magic,0,1,24,24,48,13,19,32,37,43,80,21,4,25,5,39,27,4,11,97,108
2018,2,21800837,2/10/2019,1610612753,Orlando Magic,0,1,1610612737,Atlanta Hawks,1,0,30,24,54,13,24,37,43,48,91,25,3,28,16,32,29,5,8,97,124
2018,2,21800742,1/27/2019,1610612764,Washington Wizards,0,0,1610612759,San Antonio Spurs,1,1,22,21,43,18,28,46,40,49,89,21,8,29,11,42,32,6,9,101,119
2018,2,21800584,1/6/2019,1610612741,Chicago Bulls,1,0,1610612751,Brooklyn Nets,0,1,34,36,70,7,11,18,41,47,88,11,4,15,15,34,20,6,14,95,100
2018,2,21800584,1/6/2019,1610612751,Brooklyn Nets,0,1,1610612741,Chicago Bulls,1,0,26,11,37,16,30,46,42,41,83,17,5,22,10,34,29,6,10,94,117
2018,2,21800092,10/29/2018,1610612749,Milwaukee Bucks,1,1,1610612761,Toronto Raptors,0,0,26,21,47,19,26,45,45,47,92,15,4,19,11,37,28,9,17,107,124
2018,2,21800092,10/29/2018,1610612761,Toronto Raptors,0,0,1610612749,Milwaukee Bucks,1,1,30,28,58,9,36,45,39,64,103,22,6,28,19,49,25,5,10,108,109
2021,2,22100415,1/11/2022,1610612741,Chicago Bulls,1,1,1610612765,Detroit Pistons,0,0,32,26,58,18,16,34,50,42,92,15,4,19,17,27,33,9,18,102,133
2021,2,22100415,1/11/2022,1610612765,Detroit Pistons,0,0,1610612741,Chicago Bulls,1,1,24,30,54,6,29,35,30,59,89,21,6,27,17,47,17,13,18,103,87
2020,2,22000219,1/20/2021,1610612737,Atlanta Hawks,1,1,1610612765,Detroit Pistons,0,0,35,42,77,9,14,23,44,56,100,26,12,38,26,37,21,9,14,107,123
2020,2,22000219,1/20/2021,1610612765,Detroit Pistons,0,0,1610612737,Atlanta Hawks,1,1,34,32,66,10,21,31,44,53,97,17,2,19,11,42,22,6,13,107,115
2014,2,21400033,11/1/2014,1610612765,Detroit Pistons,1,0,1610612751,Brooklyn Nets,0,1,31,28,59,1,16,17,32,44,76,25,10,35,12,37,21,3,7,88,90
2023,2,22300317,12/13/2023,1610612756,Phoenix Suns,1,0,1610612751,Brooklyn Nets,0,1,31,25,56,9,19,28,40,44,84,23,4,27,16,28,28,9,12,93,112
2023,2,22300376,12/21/2023,1610612759,San Antonio Spurs,0,0,1610612741,Chicago Bulls,1,1,27,24,51,10,20,30,37,44,81,11,5,16,10,36,24,11,19,96,95
2023,2,22300432,12/29/2023,1610612761,Toronto Raptors,0,0,1610612738,Boston Celtics,1,1,27,24,51,17,27,44,44,51,95,13,7,20,12,42,29,3,5,98,118
2019,2,21900389,12/15/2019,1610612754,Indiana Pacers,1,1,1610612766,Charlotte Hornets,0,0,30,23,53,10,25,35,40,48,88,17,3,20,10,40,30,4,9,96,107
2019,2,21900389,12/15/2019,1610612766,Charlotte Hornets,0,0,1610612754,Indiana Pacers,1,1,23,36,59,5,27,32,28,63,91,24,11,35,23,45,18,6,12,98,85
2019,2,21900145,11/11/2019,1610612746,LA Clippers,1,1,1610612761,Toronto Raptors,0,0,26,30,56,8,28,36,34,58,92,22,8,30,26,36,25,9,22,102,98
2019,2,21900145,11/11/2019,1610612761,Toronto Raptors,0,0,1610612746,LA Clippers,1,1,23,32,55,11,19,30,34,51,85,9,6,15,7,46,25,9,15,101,88
2017,2,21700205,11/15/2017,1610612748,Miami Heat,1,0,1610612764,Washington Wizards,0,1,19,29,48,13,17,30,32,46,78,16,3,19,15,33,15,8,17,89,93
2017,2,21700205,11/15/2017,1610612764,Washington Wizards,0,1,1610612748,Miami Heat,1,0,23,36,59,9,10,19,32,46,78,29,2,31,16,31,9,3,12,89,102
2016,2,21600786,2/8/2017,1610612747,Los Angeles Lakers,0,0,1610612765,Detroit Pistons,1,1,31,32,63,6,17,23,37,49,86,22,4,26,12,39,21,11,21,108,102
2023,2,22300123,11/1/2023,1610612743,Denver Nuggets,0,0,1610612750,Minnesota Timberwolves,1,1,32,31,63,6,27,33,38,58,96,7,3,10,18,41,23,9,16,97,89
2023,2,22300514,1/9/2024,1610612752,New York Knicks,1,1,1610612757,Portland Trail Blazers,0,0,19,22,41,18,30,48,37,52,89,20,3,23,20,33,26,8,15,94,112
2020,2,22000218,1/20/2021,1610612738,Boston Celtics,0,0,1610612755,Philadelphia 76ers,1,1,30,26,56,12,21,33,42,47,89,13,7,20,17,32,22,12,16,97,109
2020,2,22000218,1/20/2021,1610612755,Philadelphia 76ers,1,1,1610612738,Boston Celtics,0,0,27,24,51,9,18,27,36,42,78,36,9,45,11,35,20,3,9,96,117
2021,2,22100414,12/14/2021,1610612744,Golden State Warriors,0,1,1610612752,New York Knicks,1,0,20,17,37,15,25,40,35,42,77,20,7,27,11,34,28,6,12,91,105
2021,2,22100414,12/14/2021,1610612752,New York Knicks,1,0,1610612744,Golden State Warriors,0,1,14,27,41,16,26,42,30,53,83,20,2,22,11,44,18,3,9,91,96
2017,2,21700204,11/15/2017,1610612737,Atlanta Hawks,1,1,1610612758,Sacramento Kings,0,0,34,13,47,16,16,32,50,29,79,10,6,16,11,21,40,12,19,95,126
2017,2,21700204,11/15/2017,1610612758,Sacramento Kings,0,0,1610612737,Atlanta Hawks,1,1,25,35,60,6,22,28,31,57,88,12,8,20,14,47,18,9,12,95,80
2019,2,21900144,11/11/2019,1610612744,Golden State Warriors,1,0,1610612762,Utah Jazz,0,1,35,28,63,10,21,31,45,49,94,8,6,14,11,40,23,3,10,102,108
2019,2,21900144,11/11/2019,1610612762,Utah Jazz,0,1,1610612744,Golden State Warriors,1,0,24,22,46,16,19,35,40,41,81,26,6,32,8,37,30,8,12,101,122
2016,2,21600786,2/8/2017,1610612765,Detroit Pistons,1,1,1610612747,Los Angeles Lakers,0,0,47,34,81,4,12,16,51,46,97,15,9,24,16,35,32,7,15,107,121
2014,2,21400032,11/1/2014,1610612737,Atlanta Hawks,1,1,1610612754,Indiana Pacers,0,0,28,21,49,7,13,20,35,34,69,25,8,33,4,34,26,5,13,94,102
2020,2,22001030,5/10/2021,1610612744,Golden State Warriors,1,1,1610612762,Utah Jazz,0,0,27,19,46,14,28,42,41,47,88,23,2,25,9,38,26,7,10,100,119
2020,2,22001030,5/10/2021,1610612762,Utah Jazz,0,0,1610612744,Golden State Warriors,1,1,28,19,47,13,31,44,41,50,91,21,3,24,16,35,14,8,15,100,116
2014,2,21400032,11/1/2014,1610612754,Indiana Pacers,0,0,1610612737,Atlanta Hawks,1,1,19,30,49,12,20,32,31,50,81,18,3,21,14,39,25,10,18,93,92
2018,2,21801095,3/24/2019,1610612746,LA Clippers,0,1,1610612752,New York Knicks,1,0,23,28,51,15,20,35,38,48,86,33,4,37,15,34,24,5,9,98,124
2018,2,21801095,3/24/2019,1610612752,New York Knicks,1,0,1610612746,LA Clippers,0,1,32,21,53,9,24,33,41,45,86,22,3,25,16,31,22,7,15,98,113
2023,2,22300097,10/29/2023,1610612737,Atlanta Hawks,0,1,1610612749,Milwaukee Bucks,1,0,32,24,56,15,22,37,47,46,93,18,4,22,19,29,32,10,17,102,127
2023,2,22300041,11/21/2023,1610612757,Portland Trail Blazers,0,0,1610612756,Phoenix Suns,1,1,24,32,56,14,17,31,38,49,87,17,3,20,19,31,20,8,13,89,107
2020,2,22000217,1/20/2021,1610612742,Dallas Mavericks,0,1,1610612754,Indiana Pacers,1,0,43,27,70,8,19,27,51,46,97,14,3,17,12,34,32,6,8,100,124
2020,2,22000217,1/20/2021,1610612754,Indiana Pacers,1,0,1610612742,Dallas Mavericks,0,1,25,28,53,16,23,39,41,51,92,14,7,21,11,42,21,5,10,101,112
2023,2,22300155,11/6/2023,1610612760,Oklahoma City Thunder,1,1,1610612737,Atlanta Hawks,0,0,31,28,59,14,21,35,45,49,94,22,1,23,12,38,27,8,13,106,126
2017,2,21700203,11/14/2017,1610612742,Dallas Mavericks,1,0,1610612759,San Antonio Spurs,0,1,23,24,47,10,24,34,33,48,81,15,3,18,10,40,18,9,15,95,91
2017,2,21700203,11/14/2017,1610612759,San Antonio Spurs,0,1,1610612742,Dallas Mavericks,1,0,29,24,53,6,20,26,35,44,79,21,6,27,11,36,18,7,12,93,97
2016,2,21600785,2/8/2017,1610612737,Atlanta Hawks,1,1,1610612743,Denver Nuggets,0,0,39,27,66,8,19,27,47,46,93,15,3,18,17,29,31,8,11,96,117
2023,2,22300270,11/30/2023,1610612750,Minnesota Timberwolves,1,1,1610612762,Utah Jazz,0,0,26,28,54,13,22,35,39,50,89,10,3,13,12,39,29,6,12,96,101
2023,2,22300349,12/18/2023,1610612739,Cleveland Cavaliers,1,1,1610612745,Houston Rockets,0,0,28,21,49,19,29,48,47,50,97,22,12,34,22,34,29,9,12,103,135
2023,2,22300039,11/21/2023,1610612737,Atlanta Hawks,1,0,1610612754,Indiana Pacers,0,1,42,22,64,15,16,31,57,38,95,23,5,28,14,26,28,7,15,107,152
2023,2,22300683,1/31/2024,1610612749,Milwaukee Bucks,0,0,1610612757,Portland Trail Blazers,1,1,32,15,47,13,32,45,45,47,92,13,5,18,17,32,27,9,13,98,116
2020,2,22000216,1/20/2021,1610612739,Cleveland Cavaliers,1,1,1610612751,Brooklyn Nets,0,0,36,33,69,20,20,40,56,53,109,15,6,21,15,40,29,8,15,119,147
2020,2,22000216,1/20/2021,1610612751,Brooklyn Nets,0,0,1610612739,Cleveland Cavaliers,1,1,33,32,65,15,26,41,48,58,106,24,3,27,16,44,30,10,16,119,135
2014,2,21400031,11/1/2014,1610612749,Milwaukee Bucks,0,0,1610612764,Washington Wizards,1,1,25,33,58,9,13,22,34,46,80,20,4,24,17,31,18,18,28,99,97
2014,2,21400031,11/1/2014,1610612764,Washington Wizards,1,1,1610612749,Milwaukee Bucks,0,0,36,24,60,4,9,13,40,33,73,24,9,33,9,29,28,11,19,99,108
2021,2,22100413,12/14/2021,1610612751,Brooklyn Nets,1,1,1610612761,Toronto Raptors,0,0,36,28,64,14,25,39,50,53,103,17,6,23,24,32,28,6,18,109,131
2021,2,22100413,12/14/2021,1610612761,Toronto Raptors,0,0,1610612751,Brooklyn Nets,1,1,30,23,53,18,34,52,48,57,105,15,4,19,18,42,26,7,12,111,129
2019,2,21900388,12/15/2019,1610612740,New Orleans Pelicans,1,0,1610612753,Orlando Magic,0,1,28,17,45,19,24,43,47,41,88,6,6,12,12,33,34,8,17,98,119
2019,2,21900388,12/15/2019,1610612753,Orlando Magic,0,1,1610612740,New Orleans Pelicans,1,0,29,26,55,17,17,34,46,43,89,21,5,26,13,32,32,6,10,98,130
2017,2,21700202,11/14/2017,1610612745,Houston Rockets,1,0,1610612761,Toronto Raptors,0,1,21,19,40,12,27,39,33,46,79,35,6,41,17,31,21,11,19,100,113
2017,2,21700202,11/14/2017,1610612761,Toronto Raptors,0,1,1610612745,Houston Rockets,1,0,27,21,48,14,16,30,41,37,78,33,9,42,6,36,28,4,13,101,129
2016,2,21600785,2/8/2017,1610612743,Denver Nuggets,0,0,1610612737,Atlanta Hawks,1,1,27,29,56,13,31,44,40,60,100,13,8,21,24,39,25,6,10,94,106
2020,2,22001029,5/10/2021,1610612749,Milwaukee Bucks,0,0,1610612759,San Antonio Spurs,1,1,34,19,53,13,28,41,47,47,94,18,5,23,10,39,26,6,8,104,125
2020,2,22001029,5/10/2021,1610612759,San Antonio Spurs,1,1,1610612749,Milwaukee Bucks,0,0,39,26,65,17,12,29,56,38,94,17,4,21,13,26,27,6,13,104,146
2016,2,21600297,12/3/2016,1610612743,Denver Nuggets,0,0,1610612762,Utah Jazz,1,1,24,35,59,13,11,24,37,46,83,11,3,14,12,35,19,8,14,92,98
2016,2,21600297,12/3/2016,1610612762,Utah Jazz,1,1,1610612743,Denver Nuggets,0,0,26,27,53,9,16,25,35,43,78,26,2,28,10,33,20,7,9,90,105
2014,2,21401016,3/19/2015,1610612750,Minnesota Timberwolves,0,1,1610612752,New York Knicks,1,0,32,39,71,2,10,12,34,49,83,25,5,30,14,38,12,9,16,100,95
2023,2,22301214,12/6/2023,1610612757,Portland Trail Blazers,0,0,1610612744,Golden State Warriors,1,1,23,26,49,16,30,46,39,56,95,12,4,16,16,41,22,4,10,98,106
2022,2,22201168,4/2/2023,1610612764,Washington Wizards,0,0,1610612752,New York Knicks,1,1,23,19,42,16,21,37,39,40,79,15,3,18,8,33,26,12,19,99,109
2018,2,21800585,1/6/2019,1610612747,Los Angeles Lakers,0,0,1610612750,Minnesota Timberwolves,1,1,27,38,65,5,17,22,32,55,87,17,11,28,18,44,20,10,21,103,86
2018,2,21800585,1/6/2019,1610612750,Minnesota Timberwolves,1,1,1610612747,Los Angeles Lakers,0,0,30,27,57,11,21,32,41,48,89,15,6,21,11,41,24,6,14,102,108
2018,2,21800363,12/5/2018,1610612740,New Orleans Pelicans,1,1,1610612742,Dallas Mavericks,0,0,34,29,63,17,12,29,51,41,92,13,7,20,8,36,36,7,12,106,132
2020,2,22000215,2/7/2021,1610612764,Washington Wizards,0,0,1610612766,Charlotte Hornets,1,1,25,25,50,9,31,40,34,56,90,20,8,28,16,44,22,6,15,102,97
2020,2,22000215,2/7/2021,1610612766,Charlotte Hornets,1,1,1610612764,Washington Wizards,0,0,27,36,63,15,21,36,42,57,99,20,6,26,22,39,21,6,11,101,119
2017,2,21700201,11/14/2017,1610612738,Boston Celtics,0,1,1610612751,Brooklyn Nets,1,0,30,29,59,9,18,27,39,47,86,22,5,27,15,35,15,4,14,100,109
2017,2,21700201,11/14/2017,1610612751,Brooklyn Nets,1,0,1610612738,Boston Celtics,0,1,25,28,53,14,21,35,39,49,88,10,6,16,9,42,26,8,15,100,102
2014,2,21400030,11/1/2014,1610612748,Miami Heat,0,1,1610612755,Philadelphia 76ers,1,0,29,30,59,12,12,24,41,42,83,20,9,29,14,34,33,9,16,98,114
2014,2,21400030,11/1/2014,1610612755,Philadelphia 76ers,1,0,1610612748,Miami Heat,0,1,28,16,44,7,16,23,35,32,67,19,7,26,6,28,28,16,25,98,96
2020,2,22000214,1/19/2021,1610612740,New Orleans Pelicans,0,0,1610612762,Utah Jazz,1,1,37,32,69,6,20,26,43,52,95,10,5,15,12,43,17,4,8,96,102
2020,2,22000214,1/19/2021,1610612762,Utah Jazz,1,1,1610612740,New Orleans Pelicans,0,0,22,16,38,21,26,47,43,42,85,11,6,17,13,31,28,8,16,95,118
2021,2,22100412,12/13/2021,1610612746,LA Clippers,1,1,1610612756,Phoenix Suns,0,0,34,23,57,9,12,21,43,35,78,16,7,23,10,28,24,10,17,96,111
2021,2,22100412,12/13/2021,1610612756,Phoenix Suns,0,0,1610612746,LA Clippers,1,1,29,38,67,7,22,29,36,60,96,16,3,19,21,40,22,5,11,96,95
2017,2,21700200,11/13/2017,1610612746,LA Clippers,1,0,1610612755,Philadelphia 76ers,0,1,24,26,50,12,20,32,36,46,82,21,11,32,12,42,16,9,15,100,105
2017,2,21700200,11/13/2017,1610612755,Philadelphia 76ers,0,1,1610612746,LA Clippers,1,0,31,14,45,7,25,32,38,39,77,26,9,35,16,27,27,8,20,101,109
2020,2,22001028,5/10/2021,1610612740,New Orleans Pelicans,0,0,1610612763,Memphis Grizzlies,1,1,33,41,74,10,13,23,43,54,97,14,7,21,20,40,29,8,12,98,110
2020,2,22001028,5/10/2021,1610612763,Memphis Grizzlies,1,1,1610612740,New Orleans Pelicans,0,0,36,25,61,9,21,30,45,46,91,16,11,27,15,37,33,9,12,99,115
2016,2,21600784,2/8/2017,1610612751,Brooklyn Nets,1,0,1610612764,Washington Wizards,0,1,29,29,58,9,24,33,38,53,91,25,11,36,20,39,20,9,17,107,110
2016,2,21600784,2/8/2017,1610612764,Washington Wizards,0,1,1610612751,Brooklyn Nets,1,0,31,41,72,9,16,25,40,57,97,25,8,33,21,40,21,6,13,107,114
2023,2,22300124,11/1/2023,1610612741,Chicago Bulls,0,0,1610612742,Dallas Mavericks,1,1,31,25,56,11,22,33,42,47,89,10,1,11,14,34,19,7,13,93,105
2023,2,22300152,11/6/2023,1610612741,Chicago Bulls,1,1,1610612762,Utah Jazz,0,0,30,29,59,18,16,34,48,45,93,16,3,19,12,35,26,1,8,97,130
2023,2,22300041,11/21/2023,1610612756,Phoenix Suns,1,1,1610612757,Portland Trail Blazers,0,0,36,23,59,7,10,17,43,33,76,27,1,28,14,19,26,8,15,91,120
2023,2,22300704,2/4/2024,1610612753,Orlando Magic,0,1,1610612765,Detroit Pistons,1,0,35,25,60,10,14,24,45,39,84,11,4,15,9,31,22,6,10,92,111
2021,2,22100411,12/13/2021,1610612743,Denver Nuggets,1,1,1610612764,Washington Wizards,0,0,27,20,47,10,22,32,37,42,79,29,4,33,7,37,26,7,13,100,113
2021,2,22100411,12/13/2021,1610612764,Washington Wizards,0,0,1610612743,Denver Nuggets,1,1,29,27,56,12,22,34,41,49,90,13,8,21,8,45,25,8,10,99,107
2014,2,21401016,3/19/2015,1610612752,New York Knicks,1,0,1610612750,Minnesota Timberwolves,0,1,36,41,77,4,16,20,40,57,97,8,2,10,19,38,22,10,16,101,92
2014,2,21400436,12/26/2014,1610612745,Houston Rockets,0,1,1610612763,Memphis Grizzlies,1,0,27,30,57,14,20,34,41,50,91,21,7,28,16,36,25,8,14,103,117
2014,2,21400436,12/26/2014,1610612763,Memphis Grizzlies,1,0,1610612745,Houston Rockets,0,1,36,44,80,7,17,24,43,61,104,18,5,23,19,45,31,2,6,102,111
2021,2,22100410,12/13/2021,1610612742,Dallas Mavericks,1,1,1610612766,Charlotte Hornets,0,0,24,18,42,19,22,41,43,40,83,15,2,17,19,21,28,8,13,84,120
2021,2,22100410,12/13/2021,1610612766,Charlotte Hornets,0,0,1610612742,Dallas Mavericks,1,1,21,28,49,13,24,37,34,52,86,15,9,24,23,37,22,4,10,84,96
2020,2,22000213,1/19/2021,1610612743,Denver Nuggets,1,1,1610612760,Oklahoma City Thunder,0,0,32,31,63,14,28,42,46,59,105,13,1,14,22,37,29,8,15,103,119
2020,2,22000213,1/19/2021,1610612760,Oklahoma City Thunder,0,0,1610612743,Denver Nuggets,1,1,22,21,43,14,29,43,36,50,86,15,8,23,13,40,22,11,19,105,101
2019,2,21900387,12/14/2019,1610612743,Denver Nuggets,1,1,1610612760,Oklahoma City Thunder,0,0,36,22,58,7,20,27,43,42,85,17,6,23,15,31,30,7,16,98,110
2019,2,21900387,12/14/2019,1610612760,Oklahoma City Thunder,0,0,1610612743,Denver Nuggets,1,1,32,26,58,6,17,23,38,43,81,20,3,23,9,35,22,6,15,97,102
2019,2,21900143,11/11/2019,1610612759,San Antonio Spurs,1,0,1610612763,Memphis Grizzlies,0,1,30,30,60,12,18,30,42,48,90,13,4,17,11,39,29,7,14,101,109
2019,2,21900143,11/11/2019,1610612763,Memphis Grizzlies,0,1,1610612759,San Antonio Spurs,1,0,33,26,59,11,17,28,44,43,87,14,6,20,10,36,32,4,11,100,113
2017,2,21700199,11/13/2017,1610612744,Golden State Warriors,1,1,1610612753,Orlando Magic,0,0,36,29,65,8,15,23,44,44,88,14,2,16,13,32,35,10,16,98,110
2017,2,21700199,11/13/2017,1610612753,Orlando Magic,0,0,1610612744,Golden State Warriors,1,1,27,29,56,10,22,32,37,51,88,16,2,18,9,44,26,4,11,100,100
2020,2,22001027,5/10/2021,1610612739,Cleveland Cavaliers,1,0,1610612754,Indiana Pacers,0,1,20,34,54,13,26,39,33,60,93,23,7,30,21,40,21,7,12,98,102
2020,2,22001027,5/10/2021,1610612754,Indiana Pacers,0,1,1610612739,Cleveland Cavaliers,1,0,33,28,61,11,16,27,44,44,88,12,4,16,12,35,32,8,11,97,111
2023,2,22300097,10/29/2023,1610612749,Milwaukee Bucks,1,0,1610612737,Atlanta Hawks,0,1,23,19,42,16,28,44,39,47,86,16,4,20,15,34,22,15,23,102,110
2023,2,22300154,11/6/2023,1610612738,Boston Celtics,0,0,1610612750,Minnesota Timberwolves,1,1,25,28,53,11,28,39,36,56,92,26,8,34,18,41,20,7,18,110,109
2023,2,22300024,11/14/2023,1610612743,Denver Nuggets,1,1,1610612746,LA Clippers,0,0,31,19,50,8,15,23,39,34,73,25,7,32,9,28,26,10,14,94,111
2022,2,22201168,4/2/2023,1610612752,New York Knicks,1,1,1610612764,Washington Wizards,0,0,33,23,56,13,19,32,46,42,88,13,5,18,9,35,31,9,12,99,118
2018,2,21801094,3/23/2019,1610612756,Phoenix Suns,0,0,1610612758,Sacramento Kings,1,1,27,27,54,9,25,34,36,52,88,22,4,26,14,40,25,7,14,99,103
2018,2,21801094,3/23/2019,1610612758,Sacramento Kings,1,1,1610612756,Phoenix Suns,0,0,22,32,54,17,21,38,39,53,92,17,5,22,19,36,25,10,14,99,112
2017,2,21700198,11/13/2017,1610612743,Denver Nuggets,0,0,1610612757,Portland Trail Blazers,1,1,21,31,52,9,23,32,30,54,84,13,2,15,18,37,13,12,20,94,82
2017,2,21700198,11/13/2017,1610612757,Portland Trail Blazers,1,1,1610612743,Denver Nuggets,0,0,31,21,52,7,14,21,38,35,73,16,2,18,10,26,22,9,22,93,99
2021,2,22100409,12/13/2021,1610612755,Philadelphia 76ers,0,0,1610612763,Memphis Grizzlies,1,1,33,28,61,4,18,22,37,46,83,13,6,19,9,42,22,12,15,99,91
2021,2,22100409,12/13/2021,1610612763,Memphis Grizzlies,1,1,1610612755,Philadelphia 76ers,0,0,33,22,55,14,20,34,47,42,89,18,5,23,12,34,29,5,11,98,126
2016,2,21600296,12/3/2016,1610612741,Chicago Bulls,0,0,1610612742,Dallas Mavericks,1,1,29,29,58,3,10,13,32,39,71,15,6,21,12,30,9,11,20,89,82
2016,2,21600296,12/3/2016,1610612742,Dallas Mavericks,1,1,1610612741,Chicago Bulls,0,0,27,29,56,13,18,31,40,47,87,14,4,18,15,33,31,4,10,89,107
2020,2,22001026,5/10/2021,1610612737,Atlanta Hawks,1,1,1610612764,Washington Wizards,0,0,36,30,66,10,20,30,46,50,96,23,3,26,16,36,23,8,12,106,125
2020,2,22001026,5/10/2021,1610612764,Washington Wizards,0,0,1610612737,Atlanta Hawks,1,1,38,36,74,13,13,26,51,49,100,9,2,11,8,43,28,4,9,106,124
2023,2,22300025,11/14/2023,1610612744,Golden State Warriors,1,0,1610612750,Minnesota Timberwolves,0,1,24,25,49,13,26,39,37,51,88,14,2,16,16,36,28,9,20,97,101
2023,2,22301215,12/6/2023,1610612746,LA Clippers,1,1,1610612743,Denver Nuggets,0,0,28,32,60,12,15,27,40,47,87,19,6,25,16,33,21,7,11,96,111
2023,2,22300318,12/13/2023,1610612762,Utah Jazz,1,1,1610612752,New York Knicks,0,0,27,29,56,16,26,42,43,55,98,15,6,21,22,36,31,10,16,102,117
2023,2,22300389,12/23/2023,1610612738,Boston Celtics,0,1,1610612746,LA Clippers,1,0,24,17,41,25,28,53,49,45,94,22,6,28,19,28,33,4,10,97,145
2023,2,22300857,3/1/2024,1610612765,Detroit Pistons,1,0,1610612739,Cleveland Cavaliers,0,1,23,30,53,10,26,36,33,56,89,24,4,28,13,45,24,7,9,97,100
2023,2,22300555,1/15/2024,1610612755,Philadelphia 76ers,1,1,1610612745,Houston Rockets,0,0,25,27,52,15,16,31,40,43,83,29,5,34,13,31,25,7,11,98,124
2020,2,22000212,1/18/2021,1610612744,Golden State Warriors,0,1,1610612747,Los Angeles Lakers,1,0,32,18,50,12,25,37,44,43,87,15,5,20,6,40,31,6,13,103,115
2020,2,22000212,1/18/2021,1610612747,Los Angeles Lakers,1,0,1610612744,Golden State Warriors,0,1,31,23,54,9,20,29,40,43,83,24,9,33,16,31,23,8,19,102,113
2021,2,22100408,12/13/2021,1610612738,Boston Celtics,1,1,1610612749,Milwaukee Bucks,0,0,23,16,39,20,27,47,43,43,86,11,2,13,9,35,31,8,13,96,117
2021,2,22100408,12/13/2021,1610612749,Milwaukee Bucks,0,0,1610612738,Boston Celtics,1,1,29,25,54,11,25,36,40,50,90,12,3,15,14,38,22,6,14,96,103
2017,2,21700197,11/13/2017,1610612750,Minnesota Timberwolves,0,1,1610612762,Utah Jazz,1,0,27,24,51,10,10,20,37,34,71,25,4,29,8,27,22,8,17,95,109
2017,2,21700197,11/13/2017,1610612762,Utah Jazz,1,0,1610612750,Minnesota Timberwolves,0,1,23,21,44,14,26,40,37,47,84,10,1,11,10,38,23,9,15,94,98
2023,2,22300096,10/29/2023,1610612745,Houston Rockets,1,0,1610612744,Golden State Warriors,0,1,25,32,57,9,24,33,34,56,90,18,1,19,13,44,22,6,7,94,95
2023,2,22300124,11/1/2023,1610612742,Dallas Mavericks,1,1,1610612741,Chicago Bulls,0,0,17,16,33,20,28,48,37,44,81,20,8,28,16,32,23,10,15,94,114
2016,2,21600783,2/8/2017,1610612739,Cleveland Cavaliers,0,1,1610612754,Indiana Pacers,1,0,30,18,48,16,20,36,46,38,84,24,2,26,8,32,24,7,10,97,132
2016,2,21600783,2/8/2017,1610612754,Indiana Pacers,1,0,1610612739,Cleveland Cavaliers,0,1,28,29,57,13,12,25,41,41,82,22,4,26,9,34,24,7,12,98,117
2014,2,21400029,11/1/2014,1610612753,Orlando Magic,1,0,1610612761,Toronto Raptors,0,1,31,30,61,7,13,20,38,43,81,12,12,24,13,37,25,4,14,94,95
2020,2,22001025,5/9/2021,1610612758,Sacramento Kings,1,1,1610612760,Oklahoma City Thunder,0,0,29,20,49,16,20,36,45,40,85,20,4,24,12,30,30,9,15,100,126
2020,2,22001025,5/9/2021,1610612760,Oklahoma City Thunder,0,0,1610612758,Sacramento Kings,1,1,23,27,50,11,26,37,34,53,87,19,10,29,15,43,23,8,14,101,98
2023,2,22300223,11/20/2023,1610612746,LA Clippers,0,1,1610612759,San Antonio Spurs,1,0,33,26,59,12,24,36,45,50,95,22,3,25,15,36,30,4,7,99,124
2023,2,22300317,12/13/2023,1610612751,Brooklyn Nets,0,1,1610612756,Phoenix Suns,1,0,26,22,48,15,26,41,41,48,89,19,5,24,13,38,24,5,7,93,116
2020,2,22000211,1/18/2021,1610612741,Chicago Bulls,1,1,1610612745,Houston Rockets,0,0,23,24,47,20,25,45,43,49,92,19,2,21,15,34,23,8,19,108,125
2020,2,22000211,1/18/2021,1610612745,Houston Rockets,0,0,1610612741,Chicago Bulls,1,1,29,19,48,17,23,40,46,42,88,11,6,17,6,39,25,10,17,107,120
2021,2,22100407,12/13/2021,1610612737,Atlanta Hawks,1,0,1610612745,Houston Rockets,0,1,27,19,46,15,24,39,42,43,85,27,4,31,9,35,20,8,12,102,126
2021,2,22100407,12/13/2021,1610612745,Houston Rockets,0,1,1610612737,Atlanta Hawks,1,0,27,23,50,19,27,46,46,50,96,21,6,27,17,35,27,9,11,104,132
2017,2,21700196,11/13/2017,1610612747,Los Angeles Lakers,0,1,1610612756,Phoenix Suns,1,0,25,34,59,14,19,33,39,53,92,8,5,13,11,45,17,6,16,104,100
2017,2,21700196,11/13/2017,1610612756,Phoenix Suns,1,0,1610612747,Los Angeles Lakers,0,1,30,39,69,7,19,26,37,58,95,12,8,20,19,43,15,6,17,104,93
2023,2,22301214,12/6/2023,1610612744,Golden State Warriors,1,1,1610612757,Portland Trail Blazers,0,0,26,26,52,10,24,34,36,50,86,28,5,33,19,33,20,8,17,98,110
2023,2,22300318,12/13/2023,1610612752,New York Knicks,0,0,1610612762,Utah Jazz,1,1,32,23,55,9,30,39,41,53,94,22,10,32,18,42,21,5,11,101,113
2020,2,22000210,1/18/2021,1610612742,Dallas Mavericks,0,0,1610612761,Toronto Raptors,1,1,22,24,46,9,27,36,31,51,82,22,5,27,11,41,21,9,17,100,93
2020,2,22000210,1/18/2021,1610612761,Toronto Raptors,1,1,1610612742,Dallas Mavericks,0,0,32,23,55,12,21,33,44,44,88,16,2,18,11,33,23,6,15,101,116
2019,2,21900386,12/14/2019,1610612745,Houston Rockets,1,0,1610612765,Detroit Pistons,0,1,28,29,57,13,32,45,41,61,102,12,6,18,16,50,18,6,11,105,107
2019,2,21900386,12/14/2019,1610612765,Detroit Pistons,0,1,1610612745,Houston Rockets,1,0,29,26,55,12,25,37,41,51,92,21,4,25,13,38,27,9,14,104,115
2019,2,21900142,11/11/2019,1610612740,New Orleans Pelicans,1,0,1610612745,Houston Rockets,0,1,27,23,50,14,31,45,41,54,95,20,7,27,17,42,26,9,17,109,116
2019,2,21900142,11/11/2019,1610612745,Houston Rockets,0,1,1610612740,New Orleans Pelicans,1,0,32,12,44,12,29,41,44,41,85,22,10,32,10,36,16,8,19,109,122
2022,2,22201054,3/17/2023,1610612742,Dallas Mavericks,0,1,1610612747,Los Angeles Lakers,1,0,24,21,45,16,18,34,40,39,79,15,4,19,10,31,27,8,15,92,111
2017,2,21700195,11/13/2017,1610612737,Atlanta Hawks,0,0,1610612740,New Orleans Pelicans,1,1,23,28,51,17,19,36,40,47,87,8,1,9,15,32,25,10,16,94,105
2017,2,21700195,11/13/2017,1610612740,New Orleans Pelicans,1,1,1610612737,Atlanta Hawks,0,0,28,14,42,13,20,33,41,34,75,11,6,17,10,26,31,14,19,92,106
2020,2,22001024,5/9/2021,1610612747,Los Angeles Lakers,1,1,1610612756,Phoenix Suns,0,0,26,24,50,13,17,30,39,41,80,32,9,41,15,31,24,8,14,98,123
2020,2,22001024,5/9/2021,1610612756,Phoenix Suns,0,0,1610612747,Los Angeles Lakers,1,1,28,20,48,11,14,25,39,34,73,21,4,25,3,31,23,11,15,97,110
2014,2,21400029,11/1/2014,1610612761,Toronto Raptors,0,1,1610612753,Orlando Magic,1,0,29,33,62,4,17,21,33,50,83,38,10,48,21,32,13,3,9,94,108
2020,2,22000209,1/18/2021,1610612749,Milwaukee Bucks,0,0,1610612751,Brooklyn Nets,1,1,35,32,67,11,27,38,46,59,105,20,4,24,17,45,21,2,6,104,123
2020,2,22000209,1/18/2021,1610612751,Brooklyn Nets,1,1,1610612749,Milwaukee Bucks,0,0,31,22,53,15,16,31,46,38,84,18,3,21,8,31,26,9,17,103,125
2021,2,22100406,12/13/2021,1610612758,Sacramento Kings,0,0,1610612761,Toronto Raptors,1,1,27,33,60,11,23,34,38,56,94,14,7,21,21,40,21,10,17,99,101
2014,2,21400028,11/1/2014,1610612763,Memphis Grizzlies,0,1,1610612766,Charlotte Hornets,1,0,26,43,69,3,8,11,29,51,80,10,3,13,11,42,16,10,19,93,71
2014,2,21400028,11/1/2014,1610612766,Charlotte Hornets,1,0,1610612763,Memphis Grizzlies,0,1,22,36,58,4,10,14,26,46,72,13,5,18,7,40,17,8,20,94,69
2021,2,22100406,12/13/2021,1610612761,Toronto Raptors,1,1,1610612758,Sacramento Kings,0,0,42,25,67,11,20,31,53,45,98,7,3,10,13,35,28,5,10,100,124
2019,2,21900385,12/14/2019,1610612739,Cleveland Cavaliers,0,0,1610612749,Milwaukee Bucks,1,1,26,29,55,15,20,35,41,49,90,11,4,15,16,34,27,12,18,102,108
2019,2,21900385,12/14/2019,1610612749,Milwaukee Bucks,1,1,1610612739,Cleveland Cavaliers,0,0,32,16,48,14,23,37,46,39,85,19,7,26,8,33,26,10,12,100,125
2019,2,21900141,11/11/2019,1610612738,Boston Celtics,1,1,1610612742,Dallas Mavericks,0,0,26,25,51,15,20,35,41,45,86,19,6,25,13,35,25,2,9,91,116
2019,2,21900141,11/11/2019,1610612742,Dallas Mavericks,0,0,1610612738,Boston Celtics,1,1,26,21,47,11,31,42,37,52,89,21,7,28,19,37,22,4,8,92,106
2016,2,21600295,12/3/2016,1610612747,Los Angeles Lakers,0,0,1610612763,Memphis Grizzlies,1,1,28,32,60,7,14,21,35,46,81,23,6,29,17,32,16,13,18,92,100
2020,2,22001023,5/9/2021,1610612741,Chicago Bulls,0,1,1610612765,Detroit Pistons,1,0,31,21,52,12,20,32,43,41,84,10,4,14,7,36,27,4,9,93,108
2020,2,22001023,5/9/2021,1610612765,Detroit Pistons,1,0,1610612741,Chicago Bulls,0,1,25,27,52,11,16,27,36,43,79,13,9,22,8,39,22,6,14,93,96
2016,2,21600295,12/3/2016,1610612763,Memphis Grizzlies,1,1,1610612747,Los Angeles Lakers,0,0,31,27,58,10,20,30,41,47,88,11,4,15,17,32,32,7,12,91,103
2014,2,21400435,12/26/2014,1610612754,Indiana Pacers,0,0,1610612765,Detroit Pistons,1,1,33,30,63,9,11,20,42,41,83,16,6,22,13,32,25,11,18,99,109
2014,2,21400435,12/26/2014,1610612765,Detroit Pistons,1,1,1610612754,Indiana Pacers,0,0,37,23,60,10,16,26,47,39,86,15,14,29,14,34,25,3,11,97,119
2020,2,22000208,1/18/2021,1610612756,Phoenix Suns,0,0,1610612763,Memphis Grizzlies,1,1,25,27,52,15,21,36,40,48,88,9,7,16,17,35,30,13,18,98,104
2020,2,22000208,1/18/2021,1610612763,Memphis Grizzlies,1,1,1610612756,Phoenix Suns,0,0,30,27,57,11,15,26,41,42,83,15,5,20,10,32,31,8,15,97,108
2017,2,21700194,11/13/2017,1610612749,Milwaukee Bucks,1,1,1610612763,Memphis Grizzlies,0,0,28,32,60,12,10,22,40,42,82,18,7,25,14,30,23,5,10,90,110
2017,2,21700194,11/13/2017,1610612763,Memphis Grizzlies,0,0,1610612749,Milwaukee Bucks,1,1,26,24,50,11,15,26,37,39,76,18,3,21,11,29,21,6,15,91,103
2014,2,21400027,11/1/2014,1610612740,New Orleans Pelicans,1,0,1610612742,Dallas Mavericks,0,1,31,39,70,7,12,19,38,51,89,21,7,28,20,35,24,4,13,95,104
2014,2,21400027,11/1/2014,1610612742,Dallas Mavericks,0,1,1610612740,New Orleans Pelicans,1,0,40,24,64,6,19,25,46,43,89,11,8,19,13,33,25,8,12,95,109
2022,2,22201053,3/17/2023,1610612738,Boston Celtics,0,1,1610612757,Portland Trail Blazers,1,0,26,19,45,15,27,42,41,46,87,29,6,35,20,29,29,12,18,102,126
2018,2,21800836,2/10/2019,1610612756,Phoenix Suns,0,0,1610612758,Sacramento Kings,1,1,32,32,64,6,21,27,38,53,91,22,8,30,17,40,22,12,17,105,104
2018,2,21800836,2/10/2019,1610612758,Sacramento Kings,1,1,1610612756,Phoenix Suns,0,0,29,24,53,9,22,31,38,46,84,32,12,44,12,41,26,5,12,105,117
2023,2,22301215,12/6/2023,1610612743,Denver Nuggets,0,0,1610612746,LA Clippers,1,1,29,38,67,12,19,31,41,57,98,8,1,9,18,39,29,7,11,96,102
2021,2,22100405,12/13/2021,1610612744,Golden State Warriors,0,1,1610612754,Indiana Pacers,1,0,34,20,54,8,22,30,42,42,84,10,4,14,13,32,21,11,18,95,102
2021,2,22100405,12/13/2021,1610612754,Indiana Pacers,1,0,1610612744,Golden State Warriors,0,1,28,29,57,7,23,30,35,52,87,23,8,31,16,40,16,6,10,95,100
2022,2,22201054,3/17/2023,1610612747,Los Angeles Lakers,1,0,1610612742,Dallas Mavericks,0,1,38,26,64,5,15,20,43,41,84,19,12,31,19,29,23,8,12,92,110
2023,2,22300355,12/18/2023,1610612760,Oklahoma City Thunder,1,1,1610612763,Memphis Grizzlies,0,0,31,25,56,11,25,36,42,50,92,21,2,23,11,41,31,6,12,104,116
2023,2,22300026,11/14/2023,1610612747,Los Angeles Lakers,1,1,1610612763,Memphis Grizzlies,0,0,25,21,46,22,13,35,47,34,81,18,6,24,16,20,30,8,19,96,134
2020,2,22000207,1/18/2021,1610612757,Portland Trail Blazers,1,0,1610612759,San Antonio Spurs,0,1,29,26,55,10,25,35,39,51,90,16,3,19,14,38,20,6,13,98,104
2020,2,22000207,1/18/2021,1610612759,San Antonio Spurs,0,1,1610612757,Portland Trail Blazers,1,0,33,24,57,15,18,33,48,42,90,14,2,16,15,29,33,9,13,97,125
2019,2,21900384,12/14/2019,1610612742,Dallas Mavericks,1,0,1610612748,Miami Heat,0,1,28,29,57,17,27,44,45,56,101,11,6,17,10,49,30,8,11,109,118
2019,2,21900384,12/14/2019,1610612748,Miami Heat,0,1,1610612742,Dallas Mavericks,1,0,23,28,51,16,24,40,39,52,91,28,6,34,10,45,27,4,10,109,122
2017,2,21700193,11/13/2017,1610612739,Cleveland Cavaliers,0,1,1610612752,New York Knicks,1,0,19,24,43,16,29,45,35,53,88,18,4,22,18,37,21,13,20,101,104
2017,2,21700193,11/13/2017,1610612752,New York Knicks,1,0,1610612739,Cleveland Cavaliers,0,1,30,33,63,8,17,25,38,50,88,17,5,22,16,36,19,7,17,101,101
2016,2,21600782,2/8/2017,1610612755,Philadelphia 76ers,1,0,1610612759,San Antonio Spurs,0,1,21,29,50,13,21,34,34,50,84,22,7,29,12,46,23,2,7,93,103
2016,2,21600782,2/8/2017,1610612759,San Antonio Spurs,0,1,1610612755,Philadelphia 76ers,1,0,28,24,52,11,11,22,39,35,74,22,3,25,8,28,24,8,15,93,111
2014,2,21400026,10/31/2014,1610612746,LA Clippers,0,1,1610612747,Los Angeles Lakers,1,0,22,16,38,12,21,33,34,37,71,38,6,44,6,32,25,5,15,102,118
2014,2,21400026,10/31/2014,1610612747,Los Angeles Lakers,1,0,1610612746,LA Clippers,0,1,35,27,62,7,13,20,42,40,82,20,8,28,10,34,24,6,14,101,111
2020,2,22001022,5/9/2021,1610612750,Minnesota Timberwolves,0,1,1610612753,Orlando Magic,1,0,31,21,52,16,29,45,47,50,97,18,6,24,14,39,30,5,10,101,128
2020,2,22001022,5/9/2021,1610612753,Orlando Magic,1,0,1610612750,Minnesota Timberwolves,0,1,27,28,55,9,27,36,36,55,91,15,7,22,14,47,20,5,13,100,96
2014,2,21401015,3/18/2015,1610612762,Utah Jazz,1,0,1610612764,Washington Wizards,0,1,30,30,60,4,18,22,34,48,82,12,12,24,17,38,21,4,9,86,84
2014,2,21401015,3/18/2015,1610612764,Washington Wizards,0,1,1610612762,Utah Jazz,1,0,27,25,52,6,5,11,33,30,63,16,7,23,10,23,16,9,22,85,88
2014,2,21400434,12/26/2014,1610612737,Atlanta Hawks,1,0,1610612749,Milwaukee Bucks,0,1,27,26,53,4,19,23,31,45,76,11,3,14,10,35,20,15,23,96,77
2014,2,21400434,12/26/2014,1610612749,Milwaukee Bucks,0,1,1610612737,Atlanta Hawks,1,0,32,28,60,8,11,19,40,39,79,19,4,23,8,31,28,8,15,98,107
2017,2,21700192,11/13/2017,1610612758,Sacramento Kings,0,0,1610612764,Washington Wizards,1,1,22,39,61,12,11,23,34,50,84,12,6,18,12,41,19,7,10,90,92
2017,2,21700192,11/13/2017,1610612764,Washington Wizards,1,1,1610612758,Sacramento Kings,0,0,33,18,51,11,23,34,44,41,85,11,1,12,13,28,30,9,12,91,110
2021,2,22100404,12/13/2021,1610612739,Cleveland Cavaliers,1,1,1610612748,Miami Heat,0,0,20,25,45,16,20,36,36,45,81,17,1,18,12,33,24,4,14,91,105
2021,2,22100404,12/13/2021,1610612748,Miami Heat,0,0,1610612739,Cleveland Cavaliers,1,1,25,20,45,13,27,40,38,47,85,5,4,9,13,36,26,6,16,92,94
2022,2,22201053,3/17/2023,1610612757,Portland Trail Blazers,1,0,1610612738,Boston Celtics,0,1,24,17,41,14,24,38,38,41,79,22,9,31,10,35,20,12,19,100,112
2014,2,21400433,12/26/2014,1610612739,Cleveland Cavaliers,0,1,1610612753,Orlando Magic,1,0,25,25,50,8,22,30,33,47,80,24,2,26,13,34,19,8,9,87,98
2014,2,21400433,12/26/2014,1610612753,Orlando Magic,1,0,1610612739,Cleveland Cavaliers,0,1,27,25,52,9,12,21,36,37,73,8,4,12,8,30,25,10,17,87,89
2023,2,22300026,11/14/2023,1610612763,Memphis Grizzlies,0,0,1610612747,Los Angeles Lakers,1,1,19,34,53,20,33,53,39,67,106,9,3,12,22,46,28,4,9,97,107
2018,2,21801093,3/23/2019,1610612757,Portland Trail Blazers,1,1,1610612765,Detroit Pistons,0,0,32,21,53,11,15,26,43,36,79,20,7,27,13,26,22,9,13,90,117
2018,2,21801093,3/23/2019,1610612765,Detroit Pistons,0,0,1610612757,Portland Trail Blazers,1,1,28,22,50,14,20,34,42,42,84,14,0,14,9,33,24,4,8,92,112
2018,2,21800954,3/4/2019,1610612743,Denver Nuggets,0,0,1610612759,San Antonio Spurs,1,1,24,31,55,17,23,40,41,54,95,4,0,4,15,39,27,8,13,95,103
2023,2,22300147,11/6/2023,1610612742,Dallas Mavericks,0,1,1610612753,Orlando Magic,1,0,26,16,42,15,25,40,41,41,82,20,8,28,9,37,21,6,15,100,117
2018,2,21800954,3/4/2019,1610612759,San Antonio Spurs,1,1,1610612743,Denver Nuggets,0,0,33,27,60,8,17,25,41,44,85,14,5,19,10,36,27,5,9,94,104
2018,2,21800835,2/10/2019,1610612747,Los Angeles Lakers,0,0,1610612755,Philadelphia 76ers,1,1,38,28,66,10,17,27,48,45,93,14,5,19,12,36,31,10,16,106,120
2023,2,22300389,12/23/2023,1610612746,LA Clippers,1,0,1610612738,Boston Celtics,0,1,30,25,55,11,23,34,41,48,89,15,0,15,11,37,25,4,11,96,108
2021,2,22100403,12/12/2021,1610612747,Los Angeles Lakers,1,1,1610612753,Orlando Magic,0,0,28,28,56,13,15,28,41,43,84,11,6,17,10,35,24,6,14,96,106
2020,2,22000206,1/18/2021,1610612748,Miami Heat,1,1,1610612765,Detroit Pistons,0,0,31,14,45,12,18,30,43,32,75,15,4,19,8,26,23,8,18,96,113
2020,2,22000206,1/18/2021,1610612765,Detroit Pistons,0,0,1610612748,Miami Heat,1,1,25,20,45,13,24,37,38,44,82,18,6,24,14,34,24,8,18,96,107
2021,2,22100403,12/12/2021,1610612753,Orlando Magic,0,0,1610612747,Los Angeles Lakers,1,1,20,30,50,13,25,38,33,55,88,15,4,19,20,39,17,12,19,97,94
2017,2,21700191,11/12/2017,1610612742,Dallas Mavericks,0,0,1610612760,Oklahoma City Thunder,1,1,26,24,50,11,26,37,37,50,87,14,4,18,16,36,18,10,20,101,99
2017,2,21700191,11/12/2017,1610612760,Oklahoma City Thunder,1,1,1610612742,Dallas Mavericks,0,0,21,19,40,15,17,32,36,36,72,25,8,33,4,34,21,9,17,99,112
2014,2,21400025,10/31/2014,1610612757,Portland Trail Blazers,0,0,1610612758,Sacramento Kings,1,1,25,32,57,9,17,26,34,49,83,17,2,19,13,38,20,6,11,90,94
2014,2,21400025,10/31/2014,1610612758,Sacramento Kings,1,1,1610612757,Portland Trail Blazers,0,0,30,41,71,4,6,10,34,47,81,31,4,35,17,31,14,5,10,90,103
2016,2,21600294,12/3/2016,1610612738,Boston Celtics,0,1,1610612755,Philadelphia 76ers,1,0,30,20,50,8,18,26,38,38,76,23,6,29,9,31,22,5,11,93,107
2016,2,21600294,12/3/2016,1610612755,Philadelphia 76ers,1,0,1610612738,Boston Celtics,0,1,20,23,43,15,18,33,35,41,76,21,5,26,12,31,20,5,17,94,106
2014,2,21401014,3/18/2015,1610612737,Atlanta Hawks,0,0,1610612744,Golden State Warriors,1,1,23,42,65,8,14,22,31,56,87,25,5,30,19,37,24,8,15,96,95
2014,2,21401014,3/18/2015,1610612744,Golden State Warriors,1,1,1610612737,Atlanta Hawks,0,0,30,24,54,14,16,30,44,40,84,12,8,20,15,29,39,14,18,96,114
2023,2,22300355,12/18/2023,1610612763,Memphis Grizzlies,0,0,1610612760,Oklahoma City Thunder,1,1,11,20,31,19,35,54,30,55,85,18,3,21,12,44,25,11,22,106,97
2023,2,22300377,12/21/2023,1610612763,Memphis Grizzlies,1,1,1610612754,Indiana Pacers,0,0,27,22,49,16,19,35,43,41,84,14,7,21,15,29,27,12,20,98,116
2023,2,22300606,1/22/2024,1610612749,Milwaukee Bucks,0,1,1610612765,Detroit Pistons,1,0,32,23,55,10,29,39,42,52,94,28,6,34,17,40,26,4,9,103,122
2018,2,21800835,2/10/2019,1610612755,Philadelphia 76ers,1,1,1610612747,Los Angeles Lakers,0,0,44,29,73,12,12,24,56,41,97,19,3,22,8,35,33,3,8,106,143
2018,2,21800504,12/26/2018,1610612737,Atlanta Hawks,1,0,1610612754,Indiana Pacers,0,1,28,25,53,17,19,36,45,44,89,14,4,18,15,32,33,13,20,103,121
2018,2,21800504,12/26/2018,1610612754,Indiana Pacers,0,1,1610612737,Atlanta Hawks,1,0,33,23,56,13,14,27,46,37,83,24,9,33,11,31,35,8,17,104,129
2018,2,21800432,12/15/2018,1610612745,Houston Rockets,0,1,1610612763,Memphis Grizzlies,1,0,22,14,36,13,24,37,35,38,73,22,3,25,8,31,23,8,14,91,105
2023,2,22300025,11/14/2023,1610612750,Minnesota Timberwolves,0,1,1610612744,Golden State Warriors,1,0,22,25,47,14,20,34,36,45,81,18,3,21,12,35,24,11,20,96,104
2020,2,22000205,1/18/2021,1610612737,Atlanta Hawks,1,1,1610612750,Minnesota Timberwolves,0,0,26,25,51,11,17,28,37,42,79,23,2,25,13,31,32,16,26,103,108
2020,2,22000205,1/18/2021,1610612750,Minnesota Timberwolves,0,0,1610612737,Atlanta Hawks,1,1,22,32,54,14,23,37,36,55,91,11,5,16,13,44,22,15,18,105,97
2021,2,22100402,12/12/2021,1610612750,Minnesota Timberwolves,0,1,1610612757,Portland Trail Blazers,1,0,24,25,49,14,22,36,38,47,85,26,6,32,17,34,23,9,17,99,116
2021,2,22100402,12/12/2021,1610612757,Portland Trail Blazers,1,0,1610612750,Minnesota Timberwolves,0,1,19,14,33,18,30,48,37,44,81,19,9,28,15,33,25,9,19,100,111
2019,2,21900140,11/11/2019,1610612750,Minnesota Timberwolves,0,1,1610612765,Detroit Pistons,1,0,30,25,55,15,19,34,45,44,89,15,4,19,14,33,25,9,17,99,120
2019,2,21900140,11/11/2019,1610612765,Detroit Pistons,1,0,1610612750,Minnesota Timberwolves,0,1,23,32,55,16,16,32,39,48,87,20,5,25,15,34,25,7,17,100,114
2020,2,22001021,5/9/2021,1610612739,Cleveland Cavaliers,1,0,1610612742,Dallas Mavericks,0,1,22,33,55,11,20,31,33,53,86,20,11,31,20,36,18,9,16,97,97
2020,2,22001021,5/9/2021,1610612742,Dallas Mavericks,0,1,1610612739,Cleveland Cavaliers,1,0,35,19,54,15,24,39,50,43,93,9,2,11,14,30,33,5,12,97,124
2020,2,22000204,5/14/2021,1610612739,Cleveland Cavaliers,0,0,1610612764,Washington Wizards,1,1,29,19,48,10,26,36,39,45,84,17,4,21,11,35,24,9,17,99,105
2021,2,22100401,12/12/2021,1610612740,New Orleans Pelicans,0,0,1610612759,San Antonio Spurs,1,1,32,33,65,8,21,29,40,54,94,9,6,15,18,40,24,11,14,98,97
2021,2,22100401,12/12/2021,1610612759,San Antonio Spurs,1,1,1610612740,New Orleans Pelicans,0,0,38,28,66,7,18,25,45,46,91,15,5,20,17,32,31,8,14,97,112
2020,2,22000204,5/14/2021,1610612764,Washington Wizards,1,1,1610612739,Cleveland Cavaliers,0,0,34,30,64,7,18,25,41,48,89,31,6,37,14,39,23,4,11,101,120
2019,2,21900383,12/14/2019,1610612763,Memphis Grizzlies,1,1,1610612764,Washington Wizards,0,0,37,20,57,11,16,27,48,36,84,21,3,24,13,24,32,12,24,106,128
2019,2,21900383,12/14/2019,1610612764,Washington Wizards,0,0,1610612763,Memphis Grizzlies,1,1,22,25,47,14,24,38,36,49,85,25,7,32,12,43,22,11,18,105,111
2016,2,21600781,2/7/2017,1610612742,Dallas Mavericks,1,0,1610612757,Portland Trail Blazers,0,1,25,22,47,12,16,28,37,38,75,27,5,32,4,37,16,6,7,93,113
2016,2,21600781,2/7/2017,1610612757,Portland Trail Blazers,0,1,1610612742,Dallas Mavericks,1,0,31,27,58,11,17,28,42,44,86,19,5,24,19,28,17,6,15,93,114
2018,2,21800953,3/4/2019,1610612737,Atlanta Hawks,0,0,1610612748,Miami Heat,1,1,21,24,45,17,29,46,38,53,91,20,5,25,17,36,25,9,14,100,113
2018,2,21800953,3/4/2019,1610612748,Miami Heat,1,1,1610612737,Atlanta Hawks,0,0,35,21,56,9,14,23,44,35,79,17,7,24,11,28,23,9,19,99,114
2018,2,21800741,1/27/2019,1610612748,Miami Heat,0,1,1610612752,New York Knicks,1,0,27,24,51,12,21,33,39,45,84,16,2,18,13,32,26,13,16,95,106
2018,2,21800741,1/27/2019,1610612752,New York Knicks,1,0,1610612748,Miami Heat,0,1,29,29,58,7,19,26,36,48,84,18,6,24,10,41,22,6,11,95,97
2018,2,21800660,1/16/2019,1610612749,Milwaukee Bucks,0,1,1610612763,Memphis Grizzlies,1,0,28,22,50,12,22,34,40,44,84,19,3,22,8,38,27,11,16,102,111
2018,2,21800660,1/16/2019,1610612763,Memphis Grizzlies,1,0,1610612749,Milwaukee Bucks,0,1,27,37,64,10,21,31,37,58,95,17,8,25,17,46,29,9,15,103,101
2021,2,22100400,12/12/2021,1610612742,Dallas Mavericks,0,1,1610612760,Oklahoma City Thunder,1,0,29,28,57,9,24,33,38,52,90,18,5,23,15,41,25,3,9,94,103
2021,2,22100400,12/12/2021,1610612760,Oklahoma City Thunder,1,0,1610612742,Dallas Mavericks,0,1,17,26,43,13,24,37,30,50,80,11,5,16,6,46,19,5,11,93,84
2020,2,22000203,1/18/2021,1610612752,New York Knicks,1,1,1610612753,Orlando Magic,0,0,26,34,60,5,22,27,31,56,87,24,10,34,16,43,15,4,8,97,91
2020,2,22000203,1/18/2021,1610612753,Orlando Magic,0,0,1610612752,New York Knicks,1,1,17,31,48,12,26,38,29,57,86,14,2,16,12,45,18,6,12,96,84
2017,2,21700190,11/12/2017,1610612745,Houston Rockets,0,1,1610612754,Indiana Pacers,1,0,26,17,43,17,30,47,43,47,90,15,3,18,15,34,24,5,13,98,118
2017,2,21700190,11/12/2017,1610612754,Indiana Pacers,1,0,1610612745,Houston Rockets,0,1,29,32,61,8,14,22,37,46,83,13,8,21,10,37,18,10,13,98,95
2023,2,22300965,3/15/2024,1610612743,Denver Nuggets,0,1,1610612759,San Antonio Spurs,1,0,39,25,64,10,15,25,49,40,89,9,3,12,9,33,37,6,13,98,117
2023,2,22300130,11/2/2023,1610612762,Utah Jazz,1,0,1610612753,Orlando Magic,0,1,29,27,56,12,21,33,41,48,89,19,7,26,16,35,27,17,20,106,113
2023,2,22300787,2/14/2024,1610612756,Phoenix Suns,1,1,1610612765,Detroit Pistons,0,0,25,21,46,10,21,31,35,42,77,36,8,44,13,33,28,14,24,108,116
2023,2,22300377,12/21/2023,1610612754,Indiana Pacers,0,0,1610612763,Memphis Grizzlies,1,1,20,18,38,18,34,52,38,52,90,9,2,11,16,36,28,8,17,97,103
2020,2,22000202,1/17/2021,1610612746,LA Clippers,1,1,1610612754,Indiana Pacers,0,0,29,19,48,19,20,39,48,39,87,14,6,20,12,30,27,13,18,102,129
2020,2,22000202,1/17/2021,1610612754,Indiana Pacers,0,0,1610612746,LA Clippers,1,1,26,25,51,11,27,38,37,52,89,11,5,16,9,46,28,4,16,102,96
2022,2,22201154,3/31/2023,1610612752,New York Knicks,0,1,1610612739,Cleveland Cavaliers,1,0,32,25,57,17,19,36,49,44,93,15,9,24,19,31,24,2,10,95,130
2022,2,22201167,4/2/2023,1610612742,Dallas Mavericks,0,0,1610612737,Atlanta Hawks,1,1,39,18,57,10,28,38,49,46,95,22,10,32,13,39,24,10,14,113,130
2019,2,21900139,11/10/2019,1610612747,Los Angeles Lakers,1,0,1610612761,Toronto Raptors,0,1,31,33,64,10,20,30,41,53,94,12,7,19,16,39,31,6,12,100,104
2019,2,21900139,11/10/2019,1610612761,Toronto Raptors,0,1,1610612747,Los Angeles Lakers,1,0,31,22,53,12,24,36,43,46,89,15,7,22,12,39,26,6,15,100,113
2023,2,22300131,11/2/2023,1610612759,San Antonio Spurs,0,1,1610612756,Phoenix Suns,1,0,33,28,61,18,19,37,51,47,98,12,1,13,14,33,37,5,8,100,132
2023,2,22300383,12/22/2023,1610612743,Denver Nuggets,0,1,1610612751,Brooklyn Nets,1,0,34,27,61,11,15,26,45,42,87,21,4,25,13,33,29,4,6,93,122
2016,2,21600780,2/7/2017,1610612745,Houston Rockets,1,1,1610612753,Orlando Magic,0,0,28,23,51,16,22,38,44,45,89,24,12,36,12,39,31,7,11,102,128
2020,2,22001020,5/9/2021,1610612740,New Orleans Pelicans,0,1,1610612766,Charlotte Hornets,1,0,33,26,59,12,25,37,45,51,96,10,12,22,18,38,26,6,16,104,112
2020,2,22001020,5/9/2021,1610612766,Charlotte Hornets,1,0,1610612740,New Orleans Pelicans,0,1,29,29,58,13,24,37,42,53,95,13,5,18,19,36,22,11,19,103,110
2016,2,21600780,2/7/2017,1610612753,Orlando Magic,0,0,1610612745,Houston Rockets,1,1,36,27,63,6,19,25,42,46,88,14,6,20,11,38,28,9,16,102,104
2023,2,22300388,12/23/2023,1610612749,Milwaukee Bucks,0,1,1610612752,New York Knicks,1,0,32,27,59,16,16,32,48,43,91,18,5,23,13,32,25,5,14,102,130
2023,2,22300608,1/22/2024,1610612759,San Antonio Spurs,0,0,1610612755,Philadelphia 76ers,1,1,30,22,52,13,28,41,43,50,93,24,3,27,16,34,29,5,8,99,123
2023,2,22300388,12/23/2023,1610612752,New York Knicks,1,0,1610612749,Milwaukee Bucks,0,1,32,32,64,9,20,29,41,52,93,20,1,21,11,41,17,4,11,102,111
2023,2,22300434,12/29/2023,1610612755,Philadelphia 76ers,0,1,1610612745,Houston Rockets,1,0,33,20,53,12,21,33,45,41,86,29,4,33,13,30,22,8,10,97,131
2017,2,21700189,11/12/2017,1610612748,Miami Heat,0,0,1610612765,Detroit Pistons,1,1,26,27,53,13,24,37,39,51,90,12,4,16,9,44,25,2,9,96,103
2017,2,21700189,11/12/2017,1610612765,Detroit Pistons,1,1,1610612748,Miami Heat,0,0,28,31,59,14,14,28,42,45,87,14,6,20,14,35,24,8,13,98,112
2021,2,22100399,12/12/2021,1610612751,Brooklyn Nets,0,1,1610612765,Detroit Pistons,1,0,30,29,59,11,17,28,41,46,87,23,2,25,16,32,28,11,18,104,116
2021,2,22100399,12/12/2021,1610612765,Detroit Pistons,1,0,1610612751,Brooklyn Nets,0,1,25,30,55,14,23,37,39,53,92,12,6,18,17,38,24,8,21,103,104
2019,2,21900382,12/14/2019,1610612741,Chicago Bulls,1,1,1610612746,LA Clippers,0,0,26,28,54,14,17,31,40,45,85,15,3,18,14,34,21,9,18,98,109
2019,2,21900382,12/14/2019,1610612746,LA Clippers,0,0,1610612741,Chicago Bulls,1,1,25,33,58,10,12,22,35,45,80,26,10,36,12,39,20,12,15,99,106
2014,2,21400024,10/31/2014,1610612756,Phoenix Suns,1,1,1610612759,San Antonio Spurs,0,0,33,36,69,2,16,18,35,52,87,22,4,26,14,41,15,3,7,92,94
2014,2,21400024,10/31/2014,1610612759,San Antonio Spurs,0,0,1610612756,Phoenix Suns,1,1,24,29,53,8,17,25,32,46,78,17,6,23,9,40,20,2,13,94,89
2018,2,21801092,3/23/2019,1610612742,Dallas Mavericks,0,1,1610612744,Golden State Warriors,1,0,23,11,34,21,28,49,44,39,83,17,5,22,9,31,33,6,10,93,126
2018,2,21801092,3/23/2019,1610612744,Golden State Warriors,1,0,1610612742,Dallas Mavericks,0,1,32,28,60,4,26,30,36,54,90,15,6,21,15,41,22,7,10,95,91
2020,2,22000201,1/17/2021,1610612740,New Orleans Pelicans,0,1,1610612758,Sacramento Kings,1,0,34,29,63,11,11,22,45,40,85,27,7,34,15,28,24,7,14,99,128
2020,2,22000201,1/17/2021,1610612758,Sacramento Kings,1,0,1610612740,New Orleans Pelicans,0,1,34,18,52,13,26,39,47,44,91,16,2,18,10,35,23,5,11,100,123
2017,2,21700188,11/12/2017,1610612738,Boston Celtics,1,1,1610612761,Toronto Raptors,0,0,25,36,61,10,16,26,35,52,87,15,4,19,20,33,24,8,15,90,95
2023,2,22300608,1/22/2024,1610612755,Philadelphia 76ers,1,1,1610612759,San Antonio Spurs,0,0,43,34,77,5,15,20,48,49,97,32,8,40,21,31,28,3,4,97,133
2023,2,22300383,12/22/2023,1610612751,Brooklyn Nets,1,0,1610612743,Denver Nuggets,0,1,30,26,56,13,20,33,43,46,89,18,8,26,18,34,32,6,11,93,117
2020,2,22001019,5/9/2021,1610612746,LA Clippers,1,0,1610612752,New York Knicks,0,1,25,26,51,12,23,35,37,49,86,14,2,16,11,39,24,7,13,96,100
2020,2,22001019,5/9/2021,1610612752,New York Knicks,0,1,1610612746,LA Clippers,1,0,29,29,58,13,19,32,42,48,90,9,0,9,9,39,25,5,10,95,106
2017,2,21700188,11/12/2017,1610612761,Toronto Raptors,0,0,1610612738,Boston Celtics,1,1,22,23,45,10,14,24,32,37,69,20,3,23,7,32,18,9,17,89,94
2021,2,22100398,12/12/2021,1610612749,Milwaukee Bucks,0,1,1610612752,New York Knicks,1,0,28,19,47,14,27,41,42,46,88,14,3,17,15,33,27,12,15,95,112
2021,2,22100398,12/12/2021,1610612752,New York Knicks,1,0,1610612749,Milwaukee Bucks,0,1,18,15,33,17,32,49,35,47,82,10,3,13,11,38,27,11,17,96,97
2014,2,21400023,10/31/2014,1610612749,Milwaukee Bucks,1,1,1610612755,Philadelphia 76ers,0,0,27,37,64,9,15,24,36,52,88,12,9,21,20,36,25,9,21,98,93
2023,2,22300216,11/19/2023,1610612745,Houston Rockets,0,0,1610612747,Los Angeles Lakers,1,1,27,20,47,14,23,37,41,43,84,8,2,10,9,34,35,13,18,99,104
2014,2,21400023,10/31/2014,1610612755,Philadelphia 76ers,0,0,1610612749,Milwaukee Bucks,1,1,27,36,63,5,18,23,32,54,86,12,10,22,17,45,20,10,18,99,81
2014,2,21400432,12/26/2014,1610612738,Boston Celtics,1,0,1610612751,Brooklyn Nets,0,1,36,27,63,9,15,24,45,42,87,8,3,11,10,33,32,9,14,97,107
2014,2,21400432,12/26/2014,1610612751,Brooklyn Nets,0,1,1610612738,Boston Celtics,1,0,34,28,62,7,14,21,41,42,83,20,8,28,14,32,19,8,15,97,109
2023,2,22300216,11/19/2023,1610612747,Los Angeles Lakers,1,1,1610612745,Houston Rockets,0,0,33,21,54,6,23,29,39,44,83,21,8,29,16,30,26,7,18,99,105
2020,2,22000200,1/17/2021,1610612743,Denver Nuggets,1,0,1610612762,Utah Jazz,0,1,26,37,63,14,23,37,40,60,100,11,4,15,27,35,25,7,10,92,105
2020,2,22000200,1/17/2021,1610612762,Utah Jazz,0,1,1610612743,Denver Nuggets,1,0,24,15,39,15,22,37,39,37,76,16,12,28,9,34,24,6,13,91,109
2022,2,22201170,4/2/2023,1610612758,Sacramento Kings,1,0,1610612759,San Antonio Spurs,0,1,38,21,59,11,33,44,49,54,103,25,7,32,19,39,24,8,15,114,134
2017,2,21700187,11/11/2017,1610612751,Brooklyn Nets,0,0,1610612762,Utah Jazz,1,1,28,25,53,7,16,23,35,41,76,29,10,39,11,37,13,12,17,100,106
2017,2,21700187,11/11/2017,1610612762,Utah Jazz,1,1,1610612751,Brooklyn Nets,0,0,30,26,56,11,18,29,41,44,85,21,4,25,12,34,19,7,16,100,114
2016,2,21600779,2/7/2017,1610612751,Brooklyn Nets,0,0,1610612766,Charlotte Hornets,1,1,27,23,50,12,24,36,39,47,86,17,4,21,8,40,26,6,18,105,107
2023,2,22300098,10/29/2023,1610612757,Portland Trail Blazers,0,0,1610612755,Philadelphia 76ers,1,1,29,34,63,7,24,31,36,58,94,19,3,22,18,42,19,10,16,102,98
2021,2,22100397,12/11/2021,1610612743,Denver Nuggets,0,1,1610612759,San Antonio Spurs,1,0,27,23,50,20,23,43,47,46,93,13,1,14,13,33,33,4,12,97,127
2021,2,22100397,12/11/2021,1610612759,San Antonio Spurs,1,0,1610612743,Denver Nuggets,0,1,31,31,62,10,17,27,41,48,89,20,9,29,18,33,28,9,17,97,112
2016,2,21600779,2/7/2017,1610612766,Charlotte Hornets,1,1,1610612751,Brooklyn Nets,0,0,33,43,76,7,19,26,40,62,102,24,5,29,18,46,19,3,7,105,111
2016,2,21600292,12/3/2016,1610612750,Minnesota Timberwolves,0,1,1610612766,Charlotte Hornets,1,0,38,41,79,10,17,27,48,58,106,19,3,22,17,42,32,6,11,110,125
2016,2,21600292,12/3/2016,1610612766,Charlotte Hornets,1,0,1610612750,Minnesota Timberwolves,0,1,30,35,65,14,22,36,44,57,101,18,8,26,21,40,30,10,15,111,120
2020,2,22001018,5/8/2021,1610612757,Portland Trail Blazers,1,1,1610612759,San Antonio Spurs,0,0,33,30,63,12,22,34,45,52,97,22,8,30,20,36,24,6,8,99,124
2020,2,22001018,5/8/2021,1610612759,San Antonio Spurs,0,0,1610612757,Portland Trail Blazers,1,1,29,34,63,8,22,30,37,56,93,20,3,23,13,45,17,3,7,101,102
2023,2,22300001,11/3/2023,1610612754,Indiana Pacers,1,1,1610612739,Cleveland Cavaliers,0,0,30,25,55,15,16,31,45,41,86,16,8,24,14,30,28,10,19,102,121
2023,2,22300131,11/2/2023,1610612756,Phoenix Suns,1,0,1610612759,San Antonio Spurs,0,1,27,21,48,16,16,32,43,37,80,19,7,26,6,33,26,7,14,99,121
2023,2,22300407,12/26/2023,1610612764,Washington Wizards,1,0,1610612753,Orlando Magic,0,1,27,18,45,16,26,42,43,44,87,17,4,21,11,35,27,11,20,105,119
2023,2,22300451,1/1/2024,1610612750,Minnesota Timberwolves,0,0,1610612752,New York Knicks,1,1,25,23,48,11,17,28,36,40,76,23,6,29,8,34,19,7,14,96,106
2020,2,22000199,4/10/2021,1610612755,Philadelphia 76ers,0,1,1610612760,Oklahoma City Thunder,1,0,32,24,56,12,26,38,44,50,94,17,8,25,17,39,24,3,10,99,117
2020,2,22000199,4/10/2021,1610612760,Oklahoma City Thunder,1,0,1610612755,Philadelphia 76ers,0,1,30,26,56,8,12,20,38,38,76,9,10,19,8,34,21,11,23,99,93
2021,2,22100396,12/11/2021,1610612744,Golden State Warriors,0,0,1610612755,Philadelphia 76ers,1,1,22,15,37,12,36,48,34,51,85,13,5,18,15,39,21,7,13,94,93
2021,2,22100396,12/11/2021,1610612755,Philadelphia 76ers,1,1,1610612744,Golden State Warriors,0,0,26,23,49,9,18,27,35,41,76,23,3,26,8,34,19,5,13,93,102
2019,2,21900381,12/14/2019,1610612751,Brooklyn Nets,0,0,1610612761,Toronto Raptors,1,1,27,28,55,12,34,46,39,62,101,12,5,17,19,46,24,10,20,109,102
2019,2,21900381,12/14/2019,1610612761,Toronto Raptors,1,1,1610612751,Brooklyn Nets,0,0,24,34,58,14,26,40,38,60,98,20,5,25,12,51,21,4,11,109,110
2019,2,21900138,11/10/2019,1610612737,Atlanta Hawks,0,0,1610612757,Portland Trail Blazers,1,1,31,32,63,11,30,41,42,62,104,18,7,25,20,47,21,10,16,111,113
2019,2,21900138,11/10/2019,1610612757,Portland Trail Blazers,1,1,1610612737,Atlanta Hawks,0,0,33,35,68,12,24,36,45,59,104,22,6,28,23,41,19,11,17,111,124
2020,2,22001017,5/8/2021,1610612744,Golden State Warriors,1,1,1610612760,Oklahoma City Thunder,0,0,20,7,27,27,27,54,47,34,81,15,3,18,6,30,31,10,19,103,136
2020,2,22001017,5/8/2021,1610612760,Oklahoma City Thunder,0,0,1610612744,Golden State Warriors,1,1,29,28,57,9,28,37,38,56,94,12,8,20,12,47,21,5,13,103,97
2020,2,22000198,1/17/2021,1610612741,Chicago Bulls,0,1,1610612742,Dallas Mavericks,1,0,36,24,60,7,18,25,43,42,85,24,9,33,10,36,32,6,14,106,117
2020,2,22000198,1/17/2021,1610612742,Dallas Mavericks,1,0,1610612741,Chicago Bulls,0,1,33,29,62,8,23,31,41,52,93,11,8,19,13,44,18,14,17,106,101
2021,2,22100395,12/11/2021,1610612745,Houston Rockets,0,0,1610612763,Memphis Grizzlies,1,1,27,17,44,11,22,33,38,39,77,19,10,29,17,30,25,10,16,90,106
2021,2,22100395,12/11/2021,1610612763,Memphis Grizzlies,1,1,1610612745,Houston Rockets,0,0,29,22,51,11,18,29,40,40,80,22,14,36,18,29,22,5,11,90,113
2017,2,21700186,11/11/2017,1610612750,Minnesota Timberwolves,0,0,1610612756,Phoenix Suns,1,1,35,41,76,4,16,20,39,57,96,28,7,35,20,40,16,4,11,103,110
2017,2,21700186,11/11/2017,1610612756,Phoenix Suns,1,1,1610612750,Minnesota Timberwolves,0,0,36,24,60,10,16,26,46,40,86,16,8,24,11,31,21,12,18,104,118
2014,2,21400022,10/31/2014,1610612739,Cleveland Cavaliers,0,1,1610612741,Chicago Bulls,1,0,38,51,89,3,12,15,41,63,104,29,4,33,28,37,18,4,12,104,114
2014,2,21400022,10/31/2014,1610612741,Chicago Bulls,1,0,1610612739,Cleveland Cavaliers,0,1,28,31,59,13,18,31,41,49,90,13,4,17,16,35,25,8,20,103,108
2019,2,21900137,11/10/2019,1610612751,Brooklyn Nets,0,0,1610612756,Phoenix Suns,1,1,36,21,57,8,26,34,44,47,91,16,1,17,10,38,27,8,17,106,112
2019,2,21900137,11/10/2019,1610612756,Phoenix Suns,1,1,1610612751,Brooklyn Nets,0,0,33,24,57,19,23,42,52,47,99,15,4,19,10,38,37,4,7,106,138
2020,2,22001016,5/8/2021,1610612745,Houston Rockets,0,0,1610612762,Utah Jazz,1,1,25,22,47,18,33,51,43,55,98,12,5,17,12,45,25,7,9,104,116
2020,2,22001016,5/8/2021,1610612762,Utah Jazz,1,1,1610612745,Houston Rockets,0,0,30,17,47,15,23,38,45,40,85,19,2,21,9,32,28,11,18,102,124
2014,2,21400431,12/25/2014,1610612744,Golden State Warriors,0,0,1610612746,LA Clippers,1,1,28,24,52,6,22,28,34,46,80,12,10,22,10,39,24,10,16,96,86
2014,2,21400431,12/25/2014,1610612746,LA Clippers,1,1,1610612744,Golden State Warriors,0,0,25,30,55,9,23,32,34,53,87,23,8,31,18,39,18,11,13,97,100
2020,2,22000197,4/25/2021,1610612739,Cleveland Cavaliers,0,0,1610612764,Washington Wizards,1,1,30,21,51,10,17,27,40,38,78,20,5,25,12,28,28,11,19,97,110
2021,2,22100394,12/11/2021,1610612741,Chicago Bulls,0,0,1610612748,Miami Heat,1,1,14,29,43,17,23,40,31,52,83,13,7,20,15,40,22,8,16,93,92
2021,2,22100394,12/11/2021,1610612748,Miami Heat,1,1,1610612741,Chicago Bulls,0,0,27,23,50,19,24,43,46,47,93,7,2,9,16,32,37,5,10,94,118
2020,2,22000197,4/25/2021,1610612764,Washington Wizards,1,1,1610612739,Cleveland Cavaliers,0,0,31,27,58,12,19,31,43,46,89,21,5,26,15,33,25,5,10,97,119
2017,2,21700185,11/11/2017,1610612743,Denver Nuggets,1,1,1610612753,Orlando Magic,0,0,34,24,58,12,17,29,46,41,87,21,6,27,15,30,29,7,13,97,125
2017,2,21700185,11/11/2017,1610612753,Orlando Magic,0,0,1610612743,Denver Nuggets,1,1,30,26,56,11,20,31,41,46,87,14,6,20,10,39,24,9,12,99,107
2014,2,21400021,10/31/2014,1610612754,Indiana Pacers,1,0,1610612763,Memphis Grizzlies,0,1,26,27,53,8,13,21,34,40,74,13,3,16,12,29,19,11,18,88,89
2014,2,21400021,10/31/2014,1610612763,Memphis Grizzlies,0,1,1610612754,Indiana Pacers,1,0,28,32,60,7,12,19,35,44,79,20,7,27,13,35,20,5,9,88,97
2014,2,21401013,3/18/2015,1610612746,LA Clippers,0,1,1610612758,Sacramento Kings,1,0,28,23,51,17,20,37,45,43,88,9,4,13,11,35,27,7,11,94,116
2014,2,21401013,3/18/2015,1610612758,Sacramento Kings,1,0,1610612746,LA Clippers,0,1,35,27,62,3,14,17,38,41,79,26,6,32,11,31,18,5,11,95,105
2014,2,21400430,12/25/2014,1610612741,Chicago Bulls,1,1,1610612747,Los Angeles Lakers,0,0,32,30,62,10,14,24,42,44,86,19,6,25,24,24,27,9,14,87,113
2014,2,21400430,12/25/2014,1610612747,Los Angeles Lakers,0,0,1610612741,Chicago Bulls,1,1,31,45,76,5,11,16,36,56,92,16,5,21,19,38,18,1,4,88,93
2023,2,22300654,1/28/2024,1610612765,Detroit Pistons,1,1,1610612760,Oklahoma City Thunder,0,0,36,33,69,11,15,26,47,48,95,15,4,19,16,34,27,7,9,96,120
2014,2,21400020,10/30/2014,1610612746,LA Clippers,1,1,1610612760,Oklahoma City Thunder,0,0,27,30,57,7,23,30,34,53,87,18,7,25,15,42,17,5,12,95,93
2016,2,21600778,2/6/2017,1610612741,Chicago Bulls,0,1,1610612758,Sacramento Kings,1,0,37,25,62,6,13,19,43,38,81,20,11,31,10,34,21,4,8,92,112
2016,2,21600778,2/6/2017,1610612758,Sacramento Kings,1,0,1610612741,Chicago Bulls,0,1,30,21,51,11,17,28,41,38,79,14,2,16,11,29,27,10,17,91,107
2023,2,22300002,11/3/2023,1610612752,New York Knicks,0,0,1610612749,Milwaukee Bucks,1,1,28,29,57,10,29,39,38,58,96,19,6,25,19,41,18,6,11,99,105
2023,2,22300382,12/22/2023,1610612755,Philadelphia 76ers,1,1,1610612761,Toronto Raptors,0,0,30,22,52,14,17,31,44,39,83,19,2,21,6,35,34,9,14,100,121
2020,2,22000196,1/17/2021,1610612738,Boston Celtics,1,0,1610612752,New York Knicks,0,1,18,20,38,7,39,46,25,59,84,18,11,29,18,49,15,11,18,97,75
2020,2,22000196,1/17/2021,1610612752,New York Knicks,0,1,1610612738,Boston Celtics,1,0,26,23,49,12,19,31,38,42,80,17,4,21,11,32,22,10,17,95,105
2021,2,22100393,12/11/2021,1610612739,Cleveland Cavaliers,1,1,1610612758,Sacramento Kings,0,0,29,28,57,12,19,31,41,47,88,23,5,28,9,40,27,8,14,106,117
2021,2,22100393,12/11/2021,1610612758,Sacramento Kings,0,0,1610612739,Cleveland Cavaliers,1,1,34,31,65,7,21,28,41,52,93,14,8,22,13,43,19,13,17,107,103
2019,2,21900380,12/14/2019,1610612756,Phoenix Suns,1,0,1610612759,San Antonio Spurs,0,1,35,28,63,10,30,40,45,58,103,19,7,26,10,52,29,6,10,118,119
2019,2,21900380,12/14/2019,1610612759,San Antonio Spurs,0,1,1610612756,Phoenix Suns,1,0,36,40,76,8,22,30,44,62,106,25,9,34,14,54,23,5,11,119,121
2017,2,21700184,11/11/2017,1610612744,Golden State Warriors,1,1,1610612755,Philadelphia 76ers,0,0,34,21,55,14,13,27,48,34,82,25,1,26,7,28,31,10,22,108,135
2020,2,22001015,5/8/2021,1610612743,Denver Nuggets,1,0,1610612751,Brooklyn Nets,0,1,28,23,51,14,27,41,42,50,92,21,2,23,17,34,21,10,12,97,119
2020,2,22001015,5/8/2021,1610612751,Brooklyn Nets,0,1,1610612743,Denver Nuggets,1,0,25,10,35,16,15,31,41,25,66,27,6,33,2,26,27,8,17,97,125
2017,2,21700184,11/11/2017,1610612755,Philadelphia 76ers,0,0,1610612744,Golden State Warriors,1,1,32,34,66,12,16,28,44,50,94,14,6,20,13,39,30,15,20,108,114
2014,2,21400020,10/30/2014,1610612760,Oklahoma City Thunder,0,0,1610612746,LA Clippers,1,1,22,22,44,6,15,21,28,37,65,28,6,34,13,25,23,10,27,97,90
2023,2,22300128,11/2/2023,1610612755,Philadelphia 76ers,1,1,1610612761,Toronto Raptors,0,0,33,34,67,9,16,25,42,50,92,21,4,25,19,34,21,4,14,95,114
2023,2,22300917,3/9/2024,1610612746,LA Clippers,1,1,1610612741,Chicago Bulls,0,0,30,19,49,12,23,35,42,42,84,16,2,18,15,27,29,7,16,94,112
2023,2,22300382,12/22/2023,1610612761,Toronto Raptors,0,0,1610612755,Philadelphia 76ers,1,1,30,24,54,9,24,33,39,48,87,24,4,28,14,35,30,6,12,99,111
2023,2,22300339,12/16/2023,1610612751,Brooklyn Nets,0,0,1610612744,Golden State Warriors,1,1,28,22,50,17,26,43,45,48,93,13,2,15,17,32,31,7,16,100,120
2017,2,21700183,11/11/2017,1610612741,Chicago Bulls,0,0,1610612759,San Antonio Spurs,1,1,34,29,63,6,17,23,40,46,86,8,5,13,8,42,22,5,13,98,94
2017,2,21700183,11/11/2017,1610612759,San Antonio Spurs,1,1,1610612741,Chicago Bulls,0,0,33,25,58,18,9,27,51,34,85,13,3,16,9,26,33,9,14,97,133
2022,2,22201170,4/2/2023,1610612759,San Antonio Spurs,0,1,1610612758,Sacramento Kings,1,0,39,25,64,13,21,34,52,46,98,25,4,29,17,31,31,9,18,114,142
2019,2,21900379,12/13/2019,1610612744,Golden State Warriors,0,0,1610612762,Utah Jazz,1,1,32,30,62,9,20,29,41,50,91,15,7,22,16,38,19,5,12,97,106
2019,2,21900379,12/13/2019,1610612762,Utah Jazz,1,1,1610612744,Golden State Warriors,0,0,21,20,41,16,22,38,37,42,79,24,7,31,10,36,22,9,13,97,114
2019,2,21900136,11/10/2019,1610612739,Cleveland Cavaliers,0,1,1610612752,New York Knicks,1,0,28,26,54,8,20,28,36,46,82,28,3,31,11,37,20,11,14,98,108
2019,2,21900136,11/10/2019,1610612752,New York Knicks,1,0,1610612739,Cleveland Cavaliers,0,1,22,33,55,9,22,31,31,55,86,16,9,25,23,37,19,11,21,100,87
2014,2,21400019,10/30/2014,1610612742,Dallas Mavericks,1,1,1610612762,Utah Jazz,0,0,39,25,64,8,13,21,47,38,85,18,5,23,15,25,25,6,9,91,120
2023,2,22300098,10/29/2023,1610612755,Philadelphia 76ers,1,1,1610612757,Portland Trail Blazers,0,0,29,25,54,11,17,28,40,42,82,35,5,40,15,29,28,10,16,102,126
2023,2,22300917,3/9/2024,1610612741,Chicago Bulls,0,0,1610612746,LA Clippers,1,1,24,27,51,13,22,35,37,49,86,15,4,19,14,36,27,7,12,93,102
2018,2,21800952,3/4/2019,1610612742,Dallas Mavericks,0,0,1610612751,Brooklyn Nets,1,1,19,23,42,12,33,45,31,56,87,14,8,22,10,49,20,8,14,103,88
2018,2,21800952,3/4/2019,1610612751,Brooklyn Nets,1,1,1610612742,Dallas Mavericks,0,0,31,13,44,17,24,41,48,37,85,14,5,19,6,33,29,4,13,102,127
2018,2,21800834,2/10/2019,1610612742,Dallas Mavericks,1,1,1610612757,Portland Trail Blazers,0,0,24,26,50,12,25,37,36,51,87,18,5,23,16,37,20,7,16,97,102
2018,2,21800834,2/10/2019,1610612757,Portland Trail Blazers,0,0,1610612742,Dallas Mavericks,1,1,33,24,57,9,20,29,42,44,86,8,6,14,14,31,24,6,19,98,101
2023,2,22300643,1/27/2024,1610612752,New York Knicks,1,1,1610612748,Miami Heat,0,0,28,26,54,17,16,33,45,42,87,18,8,26,13,32,25,6,7,92,125
2021,2,22100392,12/11/2021,1610612762,Utah Jazz,0,1,1610612764,Washington Wizards,1,0,35,19,54,13,26,39,48,45,93,14,3,17,14,33,28,3,9,95,123
2021,2,22100392,12/11/2021,1610612764,Washington Wizards,1,0,1610612762,Utah Jazz,0,1,33,31,64,8,17,25,41,48,89,8,6,14,12,39,17,5,13,97,98
2020,2,22000195,1/16/2021,1610612737,Atlanta Hawks,0,0,1610612757,Portland Trail Blazers,1,1,32,25,57,6,24,30,38,49,87,24,4,28,10,40,24,6,13,102,106
2020,2,22000195,1/16/2021,1610612757,Portland Trail Blazers,1,1,1610612737,Atlanta Hawks,0,0,25,34,59,15,29,44,40,63,103,17,3,20,20,44,18,4,8,103,112
2017,2,21700182,11/11/2017,1610612747,Los Angeles Lakers,0,0,1610612749,Milwaukee Bucks,1,1,25,27,52,6,16,22,31,43,74,22,15,37,15,35,21,11,23,102,90
2017,2,21700182,11/11/2017,1610612749,Milwaukee Bucks,1,1,1610612747,Los Angeles Lakers,0,0,29,33,62,6,17,23,35,50,85,22,4,26,12,42,16,7,16,101,98
2023,2,22300451,1/1/2024,1610612752,New York Knicks,1,1,1610612750,Minnesota Timberwolves,0,0,27,28,55,12,22,34,39,50,89,22,6,28,21,32,23,6,15,94,112
2014,2,21400019,10/30/2014,1610612762,Utah Jazz,0,0,1610612742,Dallas Mavericks,1,1,22,26,48,14,21,35,36,47,83,16,2,18,16,33,22,8,16,91,102
2021,2,22100391,12/11/2021,1610612746,LA Clippers,1,1,1610612753,Orlando Magic,0,0,24,32,56,18,18,36,42,50,92,4,2,6,13,39,27,4,8,92,106
2021,2,22100391,12/11/2021,1610612753,Orlando Magic,0,0,1610612746,LA Clippers,1,1,23,24,47,12,21,33,35,45,80,22,2,24,12,35,21,7,11,92,104
2018,2,21801091,3/23/2019,1610612750,Minnesota Timberwolves,0,1,1610612763,Memphis Grizzlies,1,0,28,29,57,12,14,26,40,43,83,20,1,21,16,28,25,8,19,96,112
2018,2,21801091,3/23/2019,1610612763,Memphis Grizzlies,1,0,1610612750,Minnesota Timberwolves,0,1,26,37,63,10,23,33,36,60,96,17,5,22,24,39,22,7,15,97,99
2016,2,21600291,12/3/2016,1610612749,Milwaukee Bucks,1,1,1610612751,Brooklyn Nets,0,0,34,27,61,6,18,24,40,45,85,26,10,36,10,39,25,6,12,105,112
2016,2,21600291,12/3/2016,1610612751,Brooklyn Nets,0,0,1610612749,Milwaukee Bucks,1,1,23,27,50,11,30,41,34,57,91,24,9,33,17,43,21,9,14,105,103
2021,2,22100390,12/10/2021,1610612738,Boston Celtics,0,0,1610612756,Phoenix Suns,1,1,31,36,67,4,22,26,35,58,93,16,8,24,17,45,13,4,13,98,90
2021,2,22100390,12/10/2021,1610612756,Phoenix Suns,1,1,1610612738,Boston Celtics,0,0,29,29,58,14,24,38,43,53,96,11,0,11,16,37,25,7,12,98,111
2020,2,22000194,3/13/2021,1610612754,Indiana Pacers,0,1,1610612756,Phoenix Suns,1,0,33,26,59,13,15,28,46,41,87,17,4,21,10,32,25,9,16,104,122
2020,2,22000194,3/13/2021,1610612756,Phoenix Suns,1,0,1610612754,Indiana Pacers,0,1,31,29,60,12,19,31,43,48,91,13,4,17,12,38,28,9,16,104,111
2019,2,21900378,12/13/2019,1610612752,New York Knicks,0,1,1610612758,Sacramento Kings,1,0,35,30,65,9,21,30,44,51,95,6,4,10,18,36,24,0,9,90,103
2019,2,21900378,12/13/2019,1610612758,Sacramento Kings,1,0,1610612752,New York Knicks,0,1,22,22,44,17,22,39,39,44,83,6,2,8,10,36,19,7,14,91,101
2017,2,21700181,11/11/2017,1610612739,Cleveland Cavaliers,0,1,1610612742,Dallas Mavericks,1,0,23,27,50,12,19,31,35,46,81,29,6,35,12,36,18,7,17,104,111
2017,2,21700181,11/11/2017,1610612742,Dallas Mavericks,1,0,1610612739,Cleveland Cavaliers,0,1,29,29,58,10,24,34,39,53,92,16,5,21,10,45,21,8,11,104,104
2020,2,22001014,5/8/2021,1610612761,Toronto Raptors,1,0,1610612763,Memphis Grizzlies,0,1,26,36,62,10,22,32,36,58,94,17,7,24,18,44,18,7,12,97,99
2020,2,22001014,5/8/2021,1610612763,Memphis Grizzlies,0,1,1610612761,Toronto Raptors,1,0,24,18,42,14,29,43,38,47,85,19,7,26,17,34,24,10,17,98,109
2022,2,22200570,1/4/2023,1610612741,Chicago Bulls,1,1,1610612751,Brooklyn Nets,0,0,35,26,61,8,12,20,43,38,81,27,2,29,8,31,21,9,17,104,121
2022,2,22200570,1/4/2023,1610612751,Brooklyn Nets,0,0,1610612741,Chicago Bulls,1,1,30,24,54,12,25,37,42,49,91,16,5,21,6,45,24,7,11,104,112
2014,2,21400429,12/25/2014,1610612739,Cleveland Cavaliers,0,0,1610612748,Miami Heat,1,1,26,20,46,6,20,26,32,40,72,21,12,33,13,33,16,8,15,89,91
2014,2,21400429,12/25/2014,1610612748,Miami Heat,1,1,1610612739,Cleveland Cavaliers,0,0,33,30,63,7,14,21,40,44,84,14,3,17,18,26,27,8,13,89,101
2023,2,22300434,12/29/2023,1610612745,Houston Rockets,1,0,1610612755,Philadelphia 76ers,0,1,35,26,61,14,16,30,49,42,91,15,6,21,22,22,30,10,17,96,127
2023,2,22300128,11/2/2023,1610612761,Toronto Raptors,0,0,1610612755,Philadelphia 76ers,1,1,28,23,51,10,18,28,38,41,79,13,6,19,10,33,30,12,19,96,99
2022,2,22201221,4/9/2023,1610612749,Milwaukee Bucks,0,0,1610612761,Toronto Raptors,1,1,26,22,48,12,22,34,38,44,82,17,4,21,7,39,28,8,14,99,105
2020,2,22000193,1/16/2021,1610612755,Philadelphia 76ers,0,0,1610612763,Memphis Grizzlies,1,1,30,29,59,7,18,25,37,47,84,23,9,32,20,32,23,15,23,103,104
2020,2,22000193,1/16/2021,1610612763,Memphis Grizzlies,1,1,1610612755,Philadelphia 76ers,0,0,35,35,70,8,21,29,43,56,99,12,6,18,17,41,27,5,11,104,106
2021,2,22100389,12/10/2021,1610612747,Los Angeles Lakers,0,1,1610612760,Oklahoma City Thunder,1,0,22,23,45,19,23,42,41,46,87,15,5,20,16,33,23,9,16,97,116
2021,2,22100389,12/10/2021,1610612760,Oklahoma City Thunder,1,0,1610612747,Los Angeles Lakers,0,1,28,24,52,10,34,44,38,58,96,9,5,14,20,41,21,12,15,96,95
2019,2,21900135,11/10/2019,1610612749,Milwaukee Bucks,0,1,1610612760,Oklahoma City Thunder,1,0,36,19,55,11,17,28,47,36,83,16,2,18,6,31,27,11,22,106,121
2019,2,21900135,11/10/2019,1610612760,Oklahoma City Thunder,1,0,1610612749,Milwaukee Bucks,0,1,28,21,49,17,25,42,45,46,91,12,5,17,6,43,31,9,15,108,119
2017,2,21700180,11/11/2017,1610612745,Houston Rockets,1,1,1610612763,Memphis Grizzlies,0,0,21,17,38,16,29,45,37,46,83,21,7,28,11,37,18,9,15,100,111
2017,2,21700180,11/11/2017,1610612763,Memphis Grizzlies,0,0,1610612745,Houston Rockets,1,1,32,27,59,6,14,20,38,41,79,14,4,18,8,36,23,14,20,101,96
2016,2,21600777,2/6/2017,1610612759,San Antonio Spurs,0,0,1610612763,Memphis Grizzlies,1,1,26,37,63,4,15,19,30,52,82,10,8,18,17,38,11,8,17,91,74
2020,2,22000192,1/16/2021,1610612748,Miami Heat,1,0,1610612765,Detroit Pistons,0,1,20,18,38,12,17,29,32,35,67,24,3,27,7,30,25,9,23,95,100
2020,2,22000192,1/16/2021,1610612765,Detroit Pistons,0,1,1610612748,Miami Heat,1,0,28,17,45,18,28,46,46,45,91,10,5,15,17,29,34,1,13,94,120
2021,2,22100388,12/10/2021,1610612740,New Orleans Pelicans,1,1,1610612765,Detroit Pistons,0,0,28,30,58,13,24,37,41,54,95,14,2,16,20,34,29,7,16,99,109
2021,2,22100388,12/10/2021,1610612765,Detroit Pistons,0,0,1610612740,New Orleans Pelicans,1,1,23,30,53,12,25,37,35,55,90,11,1,12,10,46,22,6,13,99,93
2014,2,21400018,10/30/2014,1610612739,Cleveland Cavaliers,1,0,1610612752,New York Knicks,0,1,23,23,46,9,15,24,32,38,70,17,3,20,13,27,22,9,19,85,90
2023,2,22300337,12/16/2023,1610612748,Miami Heat,1,1,1610612741,Chicago Bulls,0,0,30,18,48,13,22,35,43,40,83,19,6,25,13,30,26,8,10,91,118
2016,2,21600777,2/6/2017,1610612763,Memphis Grizzlies,1,1,1610612759,San Antonio Spurs,0,0,28,34,62,4,15,19,32,49,81,21,4,25,16,35,18,8,13,91,89
2016,2,21600290,12/2/2016,1610612743,Denver Nuggets,1,0,1610612745,Houston Rockets,0,1,37,36,73,9,22,31,46,58,104,9,7,16,29,33,22,11,16,100,110
2016,2,21600290,12/2/2016,1610612745,Houston Rockets,0,1,1610612743,Denver Nuggets,1,0,28,23,51,17,20,37,45,43,88,21,4,25,14,32,25,5,13,99,128
2020,2,22001013,5/8/2021,1610612755,Philadelphia 76ers,1,1,1610612765,Detroit Pistons,0,0,32,22,54,9,21,30,41,43,84,27,4,31,11,35,22,5,11,99,118
2020,2,22001013,5/8/2021,1610612765,Detroit Pistons,0,0,1610612755,Philadelphia 76ers,1,1,30,20,50,11,23,34,41,43,84,11,5,16,10,37,22,11,18,98,104
2014,2,21401012,3/18/2015,1610612742,Dallas Mavericks,1,1,1610612753,Orlando Magic,0,0,26,23,49,13,18,31,39,41,80,16,8,24,11,32,28,12,20,100,107
2014,2,21401012,3/18/2015,1610612753,Orlando Magic,0,0,1610612742,Dallas Mavericks,1,1,31,28,59,9,19,28,40,47,87,13,1,14,12,35,28,7,18,100,102
2018,2,21801090,3/23/2019,1610612741,Chicago Bulls,1,0,1610612762,Utah Jazz,0,1,31,45,76,2,14,16,33,59,92,15,5,20,15,46,16,7,12,99,83
2018,2,21801090,3/23/2019,1610612762,Utah Jazz,0,1,1610612741,Chicago Bulls,1,0,35,28,63,11,21,32,46,49,95,11,4,15,16,36,27,6,12,99,114
2014,2,21400428,12/25/2014,1610612759,San Antonio Spurs,1,0,1610612760,Oklahoma City Thunder,0,1,35,23,58,7,16,23,42,39,81,15,6,21,11,32,33,9,17,95,106
2014,2,21400428,12/25/2014,1610612760,Oklahoma City Thunder,0,1,1610612759,San Antonio Spurs,1,0,33,33,66,9,6,15,42,39,81,21,17,38,18,29,25,8,14,95,114
2021,2,22100387,12/10/2021,1610612739,Cleveland Cavaliers,0,1,1610612750,Minnesota Timberwolves,1,0,33,19,52,13,20,33,46,39,85,18,4,22,9,32,34,9,17,103,123
2021,2,22100387,12/10/2021,1610612750,Minnesota Timberwolves,1,0,1610612739,Cleveland Cavaliers,0,1,25,28,53,11,28,39,36,56,92,23,5,28,15,44,24,8,14,104,106
2020,2,22000191,1/16/2021,1610612761,Toronto Raptors,1,1,1610612766,Charlotte Hornets,0,0,15,22,37,21,28,49,36,50,86,23,3,26,15,37,28,6,15,101,116
2020,2,22000191,1/16/2021,1610612766,Charlotte Hornets,0,0,1610612761,Toronto Raptors,1,1,23,28,51,15,21,36,38,49,87,22,7,29,14,39,26,5,15,101,113
2017,2,21700179,11/11/2017,1610612752,New York Knicks,1,1,1610612758,Sacramento Kings,0,0,35,28,63,12,15,27,47,43,90,12,3,15,12,34,29,6,11,94,118
2017,2,21700179,11/11/2017,1610612758,Sacramento Kings,0,0,1610612752,New York Knicks,1,1,23,35,58,7,15,22,30,50,80,24,6,30,12,38,19,6,13,94,91
2014,2,21400018,10/30/2014,1610612752,New York Knicks,0,1,1610612739,Cleveland Cavaliers,1,0,31,26,57,6,6,12,37,32,69,15,3,18,11,23,30,5,18,84,95
2020,2,22000190,1/16/2021,1610612751,Brooklyn Nets,1,1,1610612753,Orlando Magic,0,0,26,17,43,16,19,35,42,36,78,22,3,25,7,30,24,13,19,102,122
2020,2,22000190,1/16/2021,1610612753,Orlando Magic,0,0,1610612751,Brooklyn Nets,1,1,30,19,49,14,32,46,44,51,95,13,3,16,14,39,28,9,12,103,115
2019,2,21900377,12/13/2019,1610612746,LA Clippers,0,1,1610612750,Minnesota Timberwolves,1,0,28,26,54,11,14,25,39,40,79,35,4,39,10,32,16,9,19,108,124
2019,2,21900377,12/13/2019,1610612750,Minnesota Timberwolves,1,0,1610612746,LA Clippers,0,1,28,16,44,10,31,41,38,47,85,31,6,37,11,39,17,5,18,108,117
2017,2,21700178,11/11/2017,1610612740,New Orleans Pelicans,1,1,1610612746,LA Clippers,0,0,37,27,64,6,10,16,43,37,80,19,5,24,10,29,26,12,23,102,111
2017,2,21700178,11/11/2017,1610612746,LA Clippers,0,0,1610612740,New Orleans Pelicans,1,1,25,35,60,10,16,26,35,51,86,23,4,27,9,45,16,7,12,103,103
2020,2,22001012,5/8/2021,1610612754,Indiana Pacers,1,0,1610612764,Washington Wizards,0,1,43,32,75,7,22,29,50,54,104,25,5,30,10,48,33,7,13,121,132
2020,2,22001012,5/8/2021,1610612764,Washington Wizards,0,1,1610612754,Indiana Pacers,1,0,40,38,78,9,23,32,49,61,110,26,4,30,20,43,26,11,18,122,133
2014,2,21400017,10/30/2014,1610612750,Minnesota Timberwolves,1,1,1610612765,Detroit Pistons,0,0,33,33,66,4,6,10,37,39,76,19,9,28,11,34,18,3,12,88,97
2022,2,22200531,12/30/2022,1610612756,Phoenix Suns,0,0,1610612761,Toronto Raptors,1,1,21,20,41,14,16,30,35,36,71,20,3,23,13,24,26,15,28,95,104
2022,2,22200531,12/30/2022,1610612761,Toronto Raptors,1,1,1610612756,Phoenix Suns,0,0,29,19,48,11,22,33,40,41,81,22,4,26,9,34,20,7,11,94,113
2018,2,21800740,1/27/2019,1610612750,Minnesota Timberwolves,1,0,1610612762,Utah Jazz,0,1,20,21,41,17,19,36,37,40,77,20,3,23,7,35,22,8,16,97,111
2018,2,21800740,1/27/2019,1610612762,Utah Jazz,0,1,1610612750,Minnesota Timberwolves,1,0,31,16,47,15,24,39,46,40,86,18,7,25,9,32,30,7,9,97,125
2021,2,22100386,12/10/2021,1610612745,Houston Rockets,1,0,1610612749,Milwaukee Bucks,0,1,23,20,43,19,27,46,42,47,89,11,9,20,14,37,30,11,16,100,114
2021,2,22100386,12/10/2021,1610612749,Milwaukee Bucks,0,1,1610612745,Houston Rockets,1,0,27,17,44,15,24,39,42,41,83,24,8,32,14,30,19,9,15,100,123
2017,2,21700177,11/11/2017,1610612737,Atlanta Hawks,0,0,1610612764,Washington Wizards,1,1,20,30,50,14,19,33,34,49,83,12,5,17,16,36,19,14,24,99,94
2017,2,21700177,11/11/2017,1610612764,Washington Wizards,1,1,1610612737,Atlanta Hawks,0,0,35,19,54,7,17,24,42,36,78,22,6,28,15,25,22,11,23,100,113
2014,2,21400017,10/30/2014,1610612765,Detroit Pistons,0,0,1610612750,Minnesota Timberwolves,1,1,31,39,70,7,14,21,38,53,91,8,5,13,20,36,20,8,12,90,91
2016,2,21600289,12/2/2016,1610612759,San Antonio Spurs,1,1,1610612764,Washington Wizards,0,0,31,29,60,8,12,20,39,41,80,21,12,33,12,36,27,13,15,98,107
2016,2,21600289,12/2/2016,1610612764,Washington Wizards,0,0,1610612759,San Antonio Spurs,1,1,34,36,70,7,4,11,41,40,81,16,2,18,12,29,25,11,20,96,105
2014,2,21400427,12/25/2014,1610612752,New York Knicks,1,0,1610612764,Washington Wizards,0,1,32,26,58,4,18,22,36,44,80,15,4,19,11,35,17,4,10,88,91
2014,2,21400427,12/25/2014,1610612764,Washington Wizards,0,1,1610612752,New York Knicks,1,0,37,33,70,7,9,16,44,42,86,7,3,10,13,31,25,5,10,88,102
2020,2,22000189,1/16/2021,1610612745,Houston Rockets,0,0,1610612759,San Antonio Spurs,1,1,19,33,52,12,20,32,31,53,84,17,10,27,16,42,20,10,23,101,91
2020,2,22000189,1/16/2021,1610612759,San Antonio Spurs,1,1,1610612745,Houston Rockets,0,0,35,41,76,5,19,24,40,60,100,18,5,23,21,43,19,6,12,101,103
2019,2,21900376,12/13/2019,1610612749,Milwaukee Bucks,0,1,1610612763,Memphis Grizzlies,1,0,33,24,57,11,19,30,44,43,87,28,5,33,13,34,22,9,17,107,127
2019,2,21900376,12/13/2019,1610612763,Memphis Grizzlies,1,0,1610612749,Milwaukee Bucks,0,1,18,31,49,20,29,49,38,60,98,18,5,23,14,49,27,4,13,106,114
2019,2,21900134,11/10/2019,1610612755,Philadelphia 76ers,1,1,1610612766,Charlotte Hornets,0,0,36,20,56,10,18,28,46,38,84,12,4,16,13,28,29,9,21,99,114
2019,2,21900134,11/10/2019,1610612766,Charlotte Hornets,0,0,1610612755,Philadelphia 76ers,1,1,24,27,51,14,19,33,38,46,84,16,6,22,8,40,22,9,13,98,106
2014,2,21400016,10/30/2014,1610612753,Orlando Magic,1,0,1610612764,Washington Wizards,0,1,31,26,57,6,9,15,37,35,72,18,6,24,7,32,20,10,18,95,98
2014,2,21400016,10/30/2014,1610612764,Washington Wizards,0,1,1610612753,Orlando Magic,1,0,32,35,67,7,6,13,39,41,80,20,6,26,10,35,22,4,12,96,105
2020,2,22001011,5/7/2021,1610612758,Sacramento Kings,1,0,1610612759,San Antonio Spurs,0,1,28,24,52,13,19,32,41,43,84,9,6,15,6,39,27,8,16,101,104
2020,2,22001011,5/7/2021,1610612759,San Antonio Spurs,0,1,1610612758,Sacramento Kings,1,0,42,25,67,4,18,22,46,43,89,17,2,19,11,33,20,10,13,101,113
2016,2,21600776,2/6/2017,1610612742,Dallas Mavericks,0,0,1610612743,Denver Nuggets,1,1,26,27,53,8,18,26,34,45,79,11,6,17,5,42,25,7,11,93,87
2016,2,21600776,2/6/2017,1610612743,Denver Nuggets,1,1,1610612742,Dallas Mavericks,0,0,31,25,56,11,17,28,42,42,84,15,1,16,14,29,28,8,15,94,110
2021,2,22100385,12/10/2021,1610612752,New York Knicks,0,0,1610612761,Toronto Raptors,1,1,20,27,47,9,25,34,29,52,81,20,4,24,18,37,18,9,15,90,87
2023,2,22300130,11/2/2023,1610612753,Orlando Magic,0,1,1610612762,Utah Jazz,1,0,29,27,56,10,19,29,39,46,85,27,9,36,12,41,27,9,17,107,115
2021,2,22100385,12/10/2021,1610612761,Toronto Raptors,1,1,1610612752,New York Knicks,0,0,18,34,52,12,23,35,30,57,87,18,5,23,16,43,21,4,8,91,90
2017,2,21700176,11/10/2017,1610612751,Brooklyn Nets,0,1,1610612757,Portland Trail Blazers,1,0,27,26,53,12,26,38,39,52,91,11,8,19,12,45,25,4,10,98,101
2017,2,21700176,11/10/2017,1610612757,Portland Trail Blazers,1,0,1610612751,Brooklyn Nets,0,1,32,40,72,8,15,23,40,55,95,9,2,11,14,41,17,7,11,97,97
2014,2,21400015,10/29/2014,1610612757,Portland Trail Blazers,1,1,1610612760,Oklahoma City Thunder,0,0,28,30,58,11,18,29,39,48,87,17,5,22,20,32,23,9,10,86,106
2020,2,22001010,5/7/2021,1610612747,Los Angeles Lakers,0,0,1610612757,Portland Trail Blazers,1,1,26,33,59,11,19,30,37,52,89,16,6,22,14,39,19,6,14,99,101
2020,2,22001010,5/7/2021,1610612757,Portland Trail Blazers,1,1,1610612747,Los Angeles Lakers,0,0,25,26,51,12,25,37,37,51,88,20,1,21,11,40,22,2,9,99,106
2023,2,22300683,1/31/2024,1610612757,Portland Trail Blazers,1,1,1610612749,Milwaukee Bucks,0,0,37,27,64,12,16,28,49,43,92,9,0,9,11,32,26,7,11,97,119
2020,2,22000188,1/15/2021,1610612746,LA Clippers,0,1,1610612758,Sacramento Kings,1,0,34,20,54,18,17,35,52,37,89,16,4,20,13,26,29,4,11,96,138
2021,2,22100384,12/10/2021,1610612737,Atlanta Hawks,1,0,1610612751,Brooklyn Nets,0,1,26,34,60,11,23,34,37,57,94,20,4,24,20,38,21,9,15,100,105
2021,2,22100384,12/10/2021,1610612751,Brooklyn Nets,0,1,1610612737,Atlanta Hawks,1,0,40,30,70,6,17,23,46,47,93,15,1,16,13,35,26,10,14,101,113
2020,2,22000188,1/15/2021,1610612758,Sacramento Kings,1,0,1610612746,LA Clippers,0,1,32,27,59,8,18,26,40,45,85,12,5,17,12,35,23,10,14,96,100
2017,2,21700175,11/10/2017,1610612748,Miami Heat,0,1,1610612762,Utah Jazz,1,0,20,32,52,10,15,25,30,47,77,14,4,18,11,37,10,10,20,94,84
2014,2,21400015,10/29/2014,1610612760,Oklahoma City Thunder,0,0,1610612757,Portland Trail Blazers,1,1,31,34,65,2,14,16,33,48,81,21,5,26,18,32,19,4,15,88,89
2017,2,21700175,11/10/2017,1610612762,Utah Jazz,1,0,1610612748,Miami Heat,0,1,20,33,53,5,16,21,25,49,74,19,3,22,9,43,12,9,18,93,74
2014,2,21400426,12/23/2014,1610612744,Golden State Warriors,0,0,1610612747,Los Angeles Lakers,1,1,27,31,58,12,14,26,39,45,84,15,2,17,15,31,20,11,20,98,105
2014,2,21400426,12/23/2014,1610612747,Los Angeles Lakers,1,1,1610612744,Golden State Warriors,0,0,34,29,63,12,14,26,46,43,89,11,6,17,17,29,28,8,16,97,115
2018,2,21801089,3/23/2019,1610612748,Miami Heat,0,1,1610612764,Washington Wizards,1,0,32,17,49,12,27,39,44,44,88,13,6,19,14,33,29,5,12,94,113
2018,2,21801089,3/23/2019,1610612764,Washington Wizards,1,0,1610612748,Miami Heat,0,1,32,34,66,9,21,30,41,55,96,17,6,23,26,32,25,5,12,94,108
2018,2,21800951,3/3/2019,1610612760,Oklahoma City Thunder,1,1,1610612763,Memphis Grizzlies,0,0,24,39,63,9,21,30,33,60,93,24,9,33,21,43,19,9,14,102,99
2018,2,21800951,3/3/2019,1610612763,Memphis Grizzlies,0,0,1610612760,Oklahoma City Thunder,1,1,28,29,57,7,15,22,35,44,79,18,1,19,8,37,22,10,22,102,95
2018,2,21800833,2/9/2019,1610612749,Milwaukee Bucks,1,0,1610612753,Orlando Magic,0,1,25,35,60,6,29,35,31,64,95,15,3,18,15,50,18,5,10,99,83
2018,2,21800833,2/9/2019,1610612753,Orlando Magic,0,1,1610612749,Milwaukee Bucks,1,0,34,33,67,10,17,27,44,50,94,5,1,6,11,40,28,5,12,97,103
2018,2,21800582,1/5/2019,1610612745,Houston Rockets,0,0,1610612757,Portland Trail Blazers,1,1,26,20,46,13,25,38,39,45,84,10,2,12,11,35,13,7,12,90,101
2018,2,21800582,1/5/2019,1610612757,Portland Trail Blazers,1,1,1610612745,Houston Rockets,0,0,34,32,66,9,19,28,43,51,94,15,5,20,21,32,27,6,9,90,110
2018,2,21800432,12/15/2018,1610612763,Memphis Grizzlies,1,0,1610612745,Houston Rockets,0,1,35,17,52,5,18,23,40,35,75,12,5,17,7,31,20,5,15,91,97
2018,2,21800363,12/5/2018,1610612742,Dallas Mavericks,0,0,1610612740,New Orleans Pelicans,1,1,25,20,45,14,32,46,39,52,91,14,7,21,13,42,26,12,18,105,106
2020,2,22000187,1/15/2021,1610612740,New Orleans Pelicans,0,0,1610612747,Los Angeles Lakers,1,1,32,25,57,9,20,29,41,45,86,4,4,8,14,34,22,11,20,95,95
2020,2,22000187,1/15/2021,1610612747,Los Angeles Lakers,1,1,1610612740,New Orleans Pelicans,0,0,24,32,56,15,22,37,39,54,93,19,7,26,18,39,31,3,8,95,112
2021,2,22100383,12/10/2021,1610612742,Dallas Mavericks,0,0,1610612754,Indiana Pacers,1,1,35,20,55,4,25,29,39,45,84,11,1,12,15,31,18,7,14,89,93
2021,2,22100383,12/10/2021,1610612754,Indiana Pacers,1,1,1610612742,Dallas Mavericks,0,0,28,23,51,13,23,36,41,46,87,11,1,12,17,29,28,7,13,89,106
2019,2,21900375,12/13/2019,1610612741,Chicago Bulls,1,0,1610612766,Charlotte Hornets,0,1,20,36,56,7,27,34,27,63,90,12,2,14,13,51,20,9,14,97,73
2019,2,21900375,12/13/2019,1610612766,Charlotte Hornets,0,1,1610612741,Chicago Bulls,1,0,24,24,48,6,25,31,30,49,79,17,4,21,15,36,21,11,21,95,83
2019,2,21900133,11/10/2019,1610612753,Orlando Magic,1,0,1610612754,Indiana Pacers,0,1,26,27,53,15,21,36,41,48,89,5,1,6,12,36,27,6,11,91,102
2019,2,21900133,11/10/2019,1610612754,Indiana Pacers,0,1,1610612753,Orlando Magic,1,0,39,32,71,9,11,20,48,43,91,4,1,5,12,31,31,5,9,90,109
2022,2,22201169,4/2/2023,1610612765,Detroit Pistons,0,0,1610612753,Orlando Magic,1,1,23,22,45,9,24,33,32,46,78,29,7,36,13,37,22,11,16,100,102
2023,2,22300384,12/22/2023,1610612737,Atlanta Hawks,0,0,1610612748,Miami Heat,1,1,23,19,42,19,35,54,42,54,96,10,4,14,17,39,29,7,14,100,113
2014,2,21401011,3/18/2015,1610612738,Boston Celtics,0,0,1610612760,Oklahoma City Thunder,1,1,31,19,50,13,21,34,44,40,84,17,11,28,14,31,32,12,20,104,118
2020,2,22001009,5/7/2021,1610612752,New York Knicks,0,0,1610612756,Phoenix Suns,1,1,27,25,52,11,21,32,38,46,84,18,5,23,8,40,24,5,13,100,105
2020,2,22001009,5/7/2021,1610612756,Phoenix Suns,1,1,1610612752,New York Knicks,0,0,25,26,51,18,23,41,43,49,92,24,1,25,10,39,26,2,7,100,128
2014,2,21401011,3/18/2015,1610612760,Oklahoma City Thunder,1,1,1610612738,Boston Celtics,0,0,37,32,69,5,14,19,42,46,88,33,6,39,19,31,19,10,17,104,122
2020,2,22000186,1/15/2021,1610612737,Atlanta Hawks,0,0,1610612762,Utah Jazz,1,1,33,31,64,5,23,28,38,54,92,11,4,15,13,42,21,7,15,103,92
2021,2,22100382,12/10/2021,1610612758,Sacramento Kings,0,0,1610612766,Charlotte Hornets,1,1,34,26,60,14,27,41,48,53,101,13,4,17,24,31,22,9,14,101,123
2020,2,22000186,1/15/2021,1610612762,Utah Jazz,1,1,1610612737,Atlanta Hawks,0,0,23,25,48,20,24,44,43,49,92,10,4,14,16,36,27,6,19,102,116
2021,2,22100382,12/10/2021,1610612766,Charlotte Hornets,1,1,1610612758,Sacramento Kings,0,0,34,18,52,14,21,35,48,39,87,14,6,20,12,29,29,11,16,99,124
2019,2,21900374,12/13/2019,1610612747,Los Angeles Lakers,0,1,1610612748,Miami Heat,1,0,31,19,50,12,25,37,43,44,87,15,8,23,17,32,26,8,19,98,113
2019,2,21900374,12/13/2019,1610612748,Miami Heat,1,0,1610612747,Los Angeles Lakers,0,1,29,23,52,10,23,33,39,46,85,22,6,28,9,40,24,5,8,100,110
2016,2,21600775,2/6/2017,1610612748,Miami Heat,0,1,1610612750,Minnesota Timberwolves,1,0,30,28,58,15,13,28,45,41,86,10,4,14,17,26,27,13,17,92,115
2016,2,21600775,2/6/2017,1610612750,Minnesota Timberwolves,1,0,1610612748,Miami Heat,0,1,38,31,69,5,6,11,43,37,80,22,6,28,12,27,25,5,11,93,113
2020,2,22000185,3/4/2021,1610612744,Golden State Warriors,0,0,1610612756,Phoenix Suns,1,1,26,27,53,12,23,35,38,50,88,10,6,16,10,42,22,8,17,102,98
2020,2,22000185,3/4/2021,1610612756,Phoenix Suns,1,1,1610612744,Golden State Warriors,0,0,37,29,66,12,18,30,49,47,96,10,3,13,16,33,31,9,16,103,120
2021,2,22100381,12/9/2021,1610612743,Denver Nuggets,0,0,1610612759,San Antonio Spurs,1,1,27,28,55,15,24,39,42,52,94,12,1,13,11,42,29,5,9,98,111
2021,2,22100381,12/9/2021,1610612759,San Antonio Spurs,1,1,1610612743,Denver Nuggets,0,0,31,22,53,15,20,35,46,42,88,16,6,22,15,31,32,7,14,97,123
2017,2,21700174,11/10/2017,1610612753,Orlando Magic,0,1,1610612756,Phoenix Suns,1,0,30,24,54,13,15,28,43,39,82,29,14,43,11,34,29,8,18,109,128
2017,2,21700174,11/10/2017,1610612756,Phoenix Suns,1,0,1610612753,Orlando Magic,0,1,39,31,70,5,19,24,44,50,94,19,6,25,13,39,13,8,15,108,112
2023,2,22300042,11/21/2023,1610612747,Los Angeles Lakers,1,1,1610612762,Utah Jazz,0,0,38,19,57,11,18,29,49,37,86,22,5,27,10,29,35,6,15,103,131
2016,2,21600288,12/2/2016,1610612737,Atlanta Hawks,1,0,1610612765,Detroit Pistons,0,1,26,38,64,6,18,24,32,56,88,15,5,20,7,49,22,4,7,97,85
2016,2,21600288,12/2/2016,1610612765,Detroit Pistons,0,1,1610612737,Atlanta Hawks,1,0,31,29,60,17,12,29,48,41,89,8,4,12,14,29,28,6,15,95,121
2014,2,21401010,3/18/2015,1610612749,Milwaukee Bucks,1,0,1610612759,San Antonio Spurs,0,1,32,34,66,7,7,14,39,41,80,18,6,24,11,34,28,9,12,92,103
2014,2,21401010,3/18/2015,1610612759,San Antonio Spurs,0,1,1610612749,Milwaukee Bucks,1,0,30,26,56,8,12,20,38,38,76,30,8,38,9,32,27,5,9,92,114
2014,2,21400425,12/23/2014,1610612742,Dallas Mavericks,0,0,1610612756,Phoenix Suns,1,1,32,31,63,9,16,25,41,47,88,24,5,29,17,32,22,12,20,105,115
2023,2,22300148,11/6/2023,1610612755,Philadelphia 76ers,1,1,1610612764,Washington Wizards,0,0,39,21,60,12,19,31,51,40,91,32,4,36,13,29,37,6,16,110,146
2023,2,22300384,12/22/2023,1610612748,Miami Heat,1,1,1610612737,Atlanta Hawks,0,0,23,24,47,17,22,39,40,46,86,25,5,30,16,33,21,9,17,99,122
2014,2,21400425,12/23/2014,1610612756,Phoenix Suns,1,1,1610612742,Dallas Mavericks,0,0,31,33,64,13,20,33,44,53,97,23,9,32,19,38,30,4,12,106,124
2019,2,21900373,12/13/2019,1610612737,Atlanta Hawks,1,0,1610612754,Indiana Pacers,0,1,33,33,66,6,22,28,39,55,94,16,7,23,16,43,24,7,15,106,100
2019,2,21900373,12/13/2019,1610612754,Indiana Pacers,0,1,1610612737,Atlanta Hawks,1,0,39,31,70,7,15,22,46,46,92,11,4,15,8,40,28,6,15,105,110
2017,2,21700173,11/10/2017,1610612749,Milwaukee Bucks,0,1,1610612759,San Antonio Spurs,1,0,36,35,71,5,13,18,41,48,89,7,7,14,17,35,27,8,14,94,94
2017,2,21700173,11/10/2017,1610612759,San Antonio Spurs,1,0,1610612749,Milwaukee Bucks,0,1,25,26,51,9,20,29,34,46,80,10,1,11,9,38,23,10,18,94,87
2014,2,21400014,10/29/2014,1610612744,Golden State Warriors,0,1,1610612758,Sacramento Kings,1,0,27,21,48,6,21,27,33,42,75,23,9,32,8,37,21,11,22,103,95
2014,2,21400014,10/29/2014,1610612758,Sacramento Kings,1,0,1610612744,Golden State Warriors,0,1,21,39,60,3,15,18,24,54,78,26,9,35,18,40,13,12,27,104,77
2020,2,22001008,5/7/2021,1610612743,Denver Nuggets,0,0,1610612762,Utah Jazz,1,1,26,19,45,17,21,38,43,40,83,17,3,20,12,30,31,9,17,97,120
2020,2,22001008,5/7/2021,1610612762,Utah Jazz,1,1,1610612743,Denver Nuggets,0,0,22,21,43,21,25,46,43,46,89,20,3,23,15,31,27,8,12,96,127
2018,2,21800950,3/3/2019,1610612750,Minnesota Timberwolves,0,0,1610612764,Washington Wizards,1,1,48,24,72,4,23,27,52,47,99,13,6,19,16,35,25,6,12,103,121
2018,2,21800950,3/3/2019,1610612764,Washington Wizards,1,1,1610612750,Minnesota Timberwolves,0,0,38,27,65,11,22,33,49,49,98,26,6,32,18,35,30,3,9,102,135
2022,2,22200490,12/23/2022,1610612756,Phoenix Suns,1,0,1610612763,Memphis Grizzlies,0,1,29,23,52,9,26,35,38,49,87,15,11,26,18,36,23,11,15,99,100
2022,2,22200490,12/23/2022,1610612763,Memphis Grizzlies,0,1,1610612756,Phoenix Suns,1,0,38,30,68,7,16,23,45,46,91,28,10,38,24,25,30,6,12,97,125
2023,2,22300042,11/21/2023,1610612762,Utah Jazz,0,0,1610612747,Los Angeles Lakers,1,1,27,27,54,11,33,44,38,60,98,12,4,16,16,46,25,6,14,103,99
2021,2,22100380,12/9/2021,1610612747,Los Angeles Lakers,0,0,1610612763,Memphis Grizzlies,1,1,24,24,48,12,18,30,36,42,78,11,6,17,9,35,26,18,22,99,95
2021,2,22100380,12/9/2021,1610612763,Memphis Grizzlies,1,1,1610612747,Los Angeles Lakers,0,0,27,25,52,14,28,42,41,53,94,12,6,18,16,41,28,8,13,100,108
2020,2,22000184,1/15/2021,1610612741,Chicago Bulls,0,0,1610612760,Oklahoma City Thunder,1,1,22,23,45,21,25,46,43,48,91,18,7,25,13,37,27,12,24,115,125
2020,2,22000184,1/15/2021,1610612760,Oklahoma City Thunder,1,1,1610612741,Chicago Bulls,0,0,33,27,60,15,30,45,48,57,105,16,8,24,14,48,26,5,13,115,127
2017,2,21700172,11/10/2017,1610612746,LA Clippers,0,0,1610612760,Oklahoma City Thunder,1,1,27,27,54,12,18,30,39,45,84,21,9,30,20,29,13,8,19,95,111
2017,2,21700172,11/10/2017,1610612760,Oklahoma City Thunder,1,1,1610612746,LA Clippers,0,0,29,23,52,11,15,26,40,38,78,29,11,40,13,30,23,4,11,95,120
2019,2,21900132,11/10/2019,1610612743,Denver Nuggets,0,1,1610612750,Minnesota Timberwolves,1,0,28,45,73,11,17,28,39,62,101,11,6,17,23,42,26,9,20,106,100
2019,2,21900132,11/10/2019,1610612750,Minnesota Timberwolves,1,0,1610612743,Denver Nuggets,0,1,28,24,52,6,39,45,34,63,97,24,9,33,20,45,22,6,13,106,98
2016,2,21600774,2/6/2017,1610612740,New Orleans Pelicans,1,1,1610612756,Phoenix Suns,0,0,33,33,66,9,17,26,42,50,92,18,4,22,10,41,20,7,13,105,111
2016,2,21600774,2/6/2017,1610612756,Phoenix Suns,0,0,1610612740,New Orleans Pelicans,1,1,35,31,66,5,22,27,40,53,93,21,4,25,15,41,26,11,16,107,106
2014,2,21401009,3/18/2015,1610612741,Chicago Bulls,1,1,1610612754,Indiana Pacers,0,0,24,34,58,10,14,24,34,48,82,25,3,28,14,36,22,3,12,95,103
2014,2,21401009,3/18/2015,1610612754,Indiana Pacers,0,0,1610612741,Chicago Bulls,1,1,26,36,62,6,13,19,32,49,81,16,5,21,6,45,16,6,10,96,86
2014,2,21400424,12/23/2014,1610612757,Portland Trail Blazers,0,1,1610612760,Oklahoma City Thunder,1,0,21,39,60,17,14,31,38,53,91,22,2,24,12,42,22,8,14,103,115
2014,2,21400424,12/23/2014,1610612760,Oklahoma City Thunder,1,0,1610612757,Portland Trail Blazers,0,1,40,42,82,6,13,19,46,55,101,13,2,15,15,41,20,6,11,103,111
2017,2,21700171,11/10/2017,1610612741,Chicago Bulls,1,0,1610612754,Indiana Pacers,0,1,30,36,66,7,20,27,37,56,93,6,3,9,12,45,24,8,12,97,87
2017,2,21700171,11/10/2017,1610612754,Indiana Pacers,0,1,1610612741,Chicago Bulls,1,0,31,24,55,12,17,29,43,41,84,7,5,12,11,33,27,10,18,98,105
2014,2,21400013,10/29/2014,1610612747,Los Angeles Lakers,0,0,1610612756,Phoenix Suns,1,1,33,40,73,4,9,13,37,49,86,21,4,25,19,32,20,5,15,94,99
2014,2,21400013,10/29/2014,1610612756,Phoenix Suns,1,1,1610612747,Los Angeles Lakers,0,0,29,21,50,16,16,32,45,37,82,13,5,18,13,26,23,9,14,94,119
2019,2,21900372,12/13/2019,1610612740,New Orleans Pelicans,0,0,1610612755,Philadelphia 76ers,1,1,29,35,64,9,15,24,38,50,88,24,11,35,14,41,24,7,9,99,109
2019,2,21900372,12/13/2019,1610612755,Philadelphia 76ers,1,1,1610612740,New Orleans Pelicans,0,0,36,31,67,7,13,20,43,44,87,23,11,34,15,36,24,5,11,100,116
2016,2,21600287,12/2/2016,1610612740,New Orleans Pelicans,1,0,1610612746,LA Clippers,0,1,34,31,65,5,15,20,39,46,85,13,8,21,16,35,21,6,13,92,96
2016,2,21600287,12/2/2016,1610612746,LA Clippers,0,1,1610612740,New Orleans Pelicans,1,0,35,29,64,10,14,24,45,43,88,14,2,16,14,31,27,5,9,92,114
2018,2,21800739,1/27/2019,1610612742,Dallas Mavericks,1,0,1610612761,Toronto Raptors,0,1,32,20,52,11,25,36,43,45,88,23,11,34,14,37,25,6,11,99,120
2018,2,21800739,1/27/2019,1610612761,Toronto Raptors,0,1,1610612742,Dallas Mavericks,1,0,20,29,49,17,17,34,37,46,83,32,6,38,10,37,24,5,8,98,123
2018,2,21800583,1/5/2019,1610612744,Golden State Warriors,0,1,1610612758,Sacramento Kings,1,0,26,20,46,21,26,47,47,46,93,12,2,14,15,32,29,12,14,96,127
2018,2,21800583,1/5/2019,1610612758,Sacramento Kings,1,0,1610612744,Golden State Warriors,0,1,26,35,61,20,16,36,46,51,97,11,3,14,15,36,34,5,8,97,123
2018,2,21800503,12/26/2018,1610612753,Orlando Magic,1,0,1610612756,Phoenix Suns,0,1,30,30,60,14,22,36,44,52,96,18,4,22,16,36,20,9,17,106,120
2018,2,21800503,12/26/2018,1610612756,Phoenix Suns,0,1,1610612753,Orlando Magic,1,0,35,36,71,13,11,24,48,47,95,13,4,17,16,32,22,11,18,107,122
2018,2,21800303,11/27/2018,1610612761,Toronto Raptors,0,1,1610612763,Memphis Grizzlies,1,0,24,12,36,18,15,33,42,27,69,20,8,28,5,25,25,9,15,93,122
2018,2,21800303,11/27/2018,1610612763,Memphis Grizzlies,1,0,1610612761,Toronto Raptors,0,1,33,23,56,10,19,29,43,42,85,18,3,21,14,29,27,5,15,93,114
2018,2,21800247,11/19/2018,1610612758,Sacramento Kings,1,1,1610612760,Oklahoma City Thunder,0,0,29,35,64,16,22,38,45,57,102,11,6,17,16,44,29,8,15,111,117
2018,2,21800247,11/19/2018,1610612760,Oklahoma City Thunder,0,0,1610612758,Sacramento Kings,1,1,33,34,67,12,29,41,45,63,108,11,5,16,19,47,22,7,13,112,113
2018,2,21800194,11/12/2018,1610612762,Utah Jazz,0,1,1610612763,Memphis Grizzlies,1,0,23,27,50,9,23,32,32,50,82,23,7,30,17,36,19,7,15,96,96
2018,2,21800194,11/12/2018,1610612763,Memphis Grizzlies,1,0,1610612762,Utah Jazz,0,1,29,26,55,4,20,24,33,46,79,18,5,23,11,37,19,7,16,96,88
2020,2,22000183,5/5/2021,1610612750,Minnesota Timberwolves,1,0,1610612763,Memphis Grizzlies,0,1,30,25,55,19,20,39,49,45,94,18,4,22,15,34,32,6,14,103,135
2020,2,22000183,5/5/2021,1610612763,Memphis Grizzlies,0,1,1610612750,Minnesota Timberwolves,1,0,38,30,68,14,15,29,52,45,97,21,7,28,18,31,30,7,14,103,139
2014,2,21400012,10/29/2014,1610612745,Houston Rockets,0,1,1610612762,Utah Jazz,1,0,26,24,50,14,13,27,40,37,77,10,4,14,13,24,18,8,18,90,104
2014,2,21400012,10/29/2014,1610612762,Utah Jazz,1,0,1610612745,Houston Rockets,0,1,35,28,63,3,15,18,38,43,81,14,3,17,15,29,16,7,14,88,93
2021,2,22100379,12/9/2021,1610612755,Philadelphia 76ers,1,0,1610612762,Utah Jazz,0,1,32,23,55,6,27,33,38,50,88,14,1,15,13,37,17,7,12,94,96
2021,2,22100379,12/9/2021,1610612762,Utah Jazz,0,1,1610612755,Philadelphia 76ers,1,0,28,23,51,15,25,40,43,48,91,17,7,24,19,29,22,9,12,94,118
2017,2,21700170,11/10/2017,1610612738,Boston Celtics,1,1,1610612766,Charlotte Hornets,0,0,21,32,53,9,22,31,30,54,84,21,4,25,13,43,15,5,13,97,90
2017,2,21700170,11/10/2017,1610612766,Charlotte Hornets,0,0,1610612738,Boston Celtics,1,1,25,33,58,6,16,22,31,49,80,19,14,33,15,41,20,6,14,98,87
2020,2,22001007,5/7/2021,1610612739,Cleveland Cavaliers,0,0,1610612742,Dallas Mavericks,1,1,26,28,54,6,23,29,32,51,83,20,6,26,17,37,17,7,15,93,90
2020,2,22001007,5/7/2021,1610612742,Dallas Mavericks,1,1,1610612739,Cleveland Cavaliers,0,0,31,20,51,10,22,32,41,42,83,18,4,22,10,35,21,6,10,93,110
2023,2,22300385,12/22/2023,1610612742,Dallas Mavericks,0,0,1610612745,Houston Rockets,1,1,28,33,61,7,33,40,35,66,101,19,7,26,18,52,18,7,12,107,96
2020,2,22000182,1/15/2021,1610612742,Dallas Mavericks,0,0,1610612749,Milwaukee Bucks,1,1,32,29,61,13,23,36,45,52,97,6,7,13,14,42,22,5,9,99,109
2020,2,22000182,1/15/2021,1610612749,Milwaukee Bucks,1,1,1610612742,Dallas Mavericks,0,0,29,30,59,14,23,37,43,53,96,12,13,25,18,43,22,5,11,98,112
2014,2,21400011,10/29/2014,1610612743,Denver Nuggets,1,1,1610612765,Detroit Pistons,0,0,24,37,61,6,18,24,30,55,85,23,8,31,20,39,17,4,15,94,89
2014,2,21400011,10/29/2014,1610612765,Detroit Pistons,0,0,1610612743,Denver Nuggets,1,1,25,33,58,6,20,26,31,53,84,11,8,19,16,41,15,7,16,95,79
2019,2,21900371,12/13/2019,1610612745,Houston Rockets,0,1,1610612753,Orlando Magic,1,0,26,21,47,22,17,39,48,38,86,12,1,13,10,28,21,3,9,91,130
2019,2,21900371,12/13/2019,1610612753,Orlando Magic,1,0,1610612745,Houston Rockets,0,1,25,29,54,15,22,37,40,51,91,12,4,16,16,37,24,5,7,90,107
2017,2,21700169,11/10/2017,1610612737,Atlanta Hawks,0,0,1610612765,Detroit Pistons,1,1,36,29,65,8,16,24,44,45,89,8,3,11,13,34,28,7,16,98,104
2017,2,21700169,11/10/2017,1610612765,Detroit Pistons,1,1,1610612737,Atlanta Hawks,0,0,27,32,59,12,18,30,39,50,89,21,6,27,21,34,23,11,17,98,111
2022,2,22201169,4/2/2023,1610612753,Orlando Magic,1,1,1610612765,Detroit Pistons,0,0,26,16,42,17,16,33,43,32,75,25,15,40,10,29,30,4,16,100,128
2020,2,22001006,5/7/2021,1610612745,Houston Rockets,0,0,1610612749,Milwaukee Bucks,1,1,23,20,43,25,28,53,48,48,96,12,6,18,10,42,36,8,16,110,133
2020,2,22001006,5/7/2021,1610612749,Milwaukee Bucks,1,1,1610612745,Houston Rockets,0,0,32,17,49,19,27,46,51,44,95,20,3,23,14,31,30,10,17,109,141
2014,2,21400423,12/23/2014,1610612749,Milwaukee Bucks,1,0,1610612766,Charlotte Hornets,0,1,31,30,61,8,13,21,39,43,82,15,5,20,11,35,25,6,20,99,101
2014,2,21400423,12/23/2014,1610612766,Charlotte Hornets,0,1,1610612749,Milwaukee Bucks,1,0,28,33,61,8,13,21,36,46,82,28,8,36,15,32,21,7,13,99,108
2023,2,22300234,11/22/2023,1610612741,Chicago Bulls,0,0,1610612760,Oklahoma City Thunder,1,1,17,27,44,17,27,44,34,54,88,17,0,17,15,39,22,4,12,94,102
2023,2,22300385,12/22/2023,1610612745,Houston Rockets,1,1,1610612742,Dallas Mavericks,0,0,35,22,57,11,27,38,46,49,95,19,4,23,15,37,21,10,17,108,122
2020,2,22000181,1/15/2021,1610612739,Cleveland Cavaliers,1,1,1610612752,New York Knicks,0,0,27,25,52,9,18,27,36,43,79,25,9,34,17,33,26,9,16,93,106
2020,2,22000181,1/15/2021,1610612752,New York Knicks,0,0,1610612739,Cleveland Cavaliers,1,1,31,26,57,9,16,25,40,42,82,14,2,16,10,34,20,9,13,94,103
2021,2,22100378,12/8/2021,1610612738,Boston Celtics,0,0,1610612746,LA Clippers,1,1,31,23,54,10,22,32,41,45,86,19,2,21,14,32,26,13,23,101,111
2021,2,22100378,12/8/2021,1610612746,LA Clippers,1,1,1610612738,Boston Celtics,0,0,26,27,53,14,18,32,40,45,85,20,2,22,12,34,20,11,20,101,114
2020,2,22000180,1/15/2021,1610612738,Boston Celtics,1,1,1610612753,Orlando Magic,0,0,28,18,46,17,25,42,45,43,88,17,2,19,9,35,25,5,12,96,124
2020,2,22000180,1/15/2021,1610612753,Orlando Magic,0,0,1610612738,Boston Celtics,1,1,31,35,66,7,21,28,38,56,94,14,8,22,20,41,14,7,12,96,97
2014,2,21400010,10/29/2014,1610612741,Chicago Bulls,0,1,1610612752,New York Knicks,1,0,29,18,47,7,17,24,36,35,71,25,5,30,11,26,21,9,15,88,104
2014,2,21400010,10/29/2014,1610612752,New York Knicks,1,0,1610612741,Chicago Bulls,0,1,28,40,68,3,14,17,31,54,85,15,2,17,18,38,19,9,12,89,80
2021,2,22100377,12/8/2021,1610612753,Orlando Magic,0,0,1610612758,Sacramento Kings,1,1,32,31,63,16,18,34,48,49,97,18,5,23,19,32,29,8,13,101,130
2021,2,22100377,12/8/2021,1610612758,Sacramento Kings,1,1,1610612753,Orlando Magic,0,0,38,25,63,15,19,34,53,44,97,21,4,25,17,28,24,2,8,100,142
2016,2,21600773,2/6/2017,1610612755,Philadelphia 76ers,0,0,1610612765,Detroit Pistons,1,1,31,26,57,5,23,28,36,49,85,19,9,28,14,41,19,8,13,97,96
2019,2,21900131,11/9/2019,1610612744,Golden State Warriors,0,0,1610612760,Oklahoma City Thunder,1,1,35,28,63,7,15,22,42,43,85,17,0,17,8,35,22,7,15,101,108
2019,2,21900131,11/9/2019,1610612760,Oklahoma City Thunder,1,1,1610612744,Golden State Warriors,0,0,29,20,49,14,16,30,43,36,79,14,3,17,7,31,30,9,19,100,114
2016,2,21600773,2/6/2017,1610612765,Detroit Pistons,1,1,1610612755,Philadelphia 76ers,0,0,41,36,77,5,17,22,46,53,99,16,1,17,23,31,22,8,13,97,113
2020,2,22001005,5/7/2021,1610612748,Miami Heat,1,1,1610612750,Minnesota Timberwolves,0,0,31,24,55,13,19,32,44,43,87,20,7,27,11,35,27,7,14,104,121
2020,2,22001005,5/7/2021,1610612750,Minnesota Timberwolves,0,0,1610612748,Miami Heat,1,1,31,17,48,10,27,37,41,44,85,20,10,30,12,37,27,9,16,103,112
2020,2,22000179,4/1/2021,1610612764,Washington Wizards,0,0,1610612765,Detroit Pistons,1,1,35,31,66,5,14,19,40,45,85,6,13,19,5,45,25,8,15,103,91
2020,2,22000179,4/1/2021,1610612765,Detroit Pistons,1,1,1610612764,Washington Wizards,0,0,33,32,65,12,17,29,45,49,94,18,4,22,13,37,31,6,13,103,120
2021,2,22100376,12/8/2021,1610612744,Golden State Warriors,1,1,1610612757,Portland Trail Blazers,0,0,19,18,37,14,32,46,33,50,83,24,7,31,15,38,22,5,16,100,104
2021,2,22100376,12/8/2021,1610612757,Portland Trail Blazers,0,0,1610612744,Golden State Warriors,1,1,25,25,50,8,22,30,33,47,80,20,8,28,9,42,24,9,16,99,94
2019,2,21900370,12/12/2019,1610612743,Denver Nuggets,1,1,1610612757,Portland Trail Blazers,0,0,24,28,52,18,18,36,42,46,88,12,7,19,19,29,25,4,11,90,114
2019,2,21900370,12/12/2019,1610612757,Portland Trail Blazers,0,0,1610612743,Denver Nuggets,1,1,32,24,56,9,21,30,41,45,86,8,3,11,12,35,22,6,9,92,99
2017,2,21700168,11/9/2017,1610612743,Denver Nuggets,1,1,1610612760,Oklahoma City Thunder,0,0,29,26,55,9,18,27,38,44,82,17,5,22,19,28,27,15,19,90,102
2017,2,21700168,11/9/2017,1610612760,Oklahoma City Thunder,0,0,1610612743,Denver Nuggets,1,1,27,33,60,11,19,30,38,52,90,7,7,14,22,33,16,7,18,92,94
2022,2,22201154,3/31/2023,1610612739,Cleveland Cavaliers,1,0,1610612752,New York Knicks,0,1,27,22,49,17,20,37,44,42,86,11,2,13,8,35,33,6,10,93,116
2022,2,22201167,4/2/2023,1610612737,Atlanta Hawks,1,1,1610612742,Dallas Mavericks,0,0,39,34,73,12,23,35,51,57,108,18,4,22,19,41,28,4,11,111,132
2014,2,21401008,3/18/2015,1610612750,Minnesota Timberwolves,0,0,1610612761,Toronto Raptors,1,1,36,34,70,6,11,17,42,45,87,10,5,15,16,34,21,6,18,96,100
2014,2,21401008,3/18/2015,1610612761,Toronto Raptors,1,1,1610612750,Minnesota Timberwolves,0,0,23,27,50,12,17,29,35,44,79,23,4,27,10,36,25,7,13,96,105
2023,2,22300340,12/16/2023,1610612743,Denver Nuggets,1,0,1610612760,Oklahoma City Thunder,0,1,30,31,61,12,20,32,42,51,93,21,3,24,17,35,30,4,9,97,117
2023,2,22300380,12/21/2023,1610612747,Los Angeles Lakers,0,0,1610612750,Minnesota Timberwolves,1,1,31,28,59,10,14,24,41,42,83,19,5,24,10,33,21,13,18,101,111
2021,2,22100375,12/8/2021,1610612740,New Orleans Pelicans,1,0,1610612743,Denver Nuggets,0,1,36,24,60,11,19,30,47,43,90,9,3,12,15,30,32,12,25,105,114
2021,2,22100375,12/8/2021,1610612743,Denver Nuggets,0,1,1610612740,New Orleans Pelicans,1,0,36,20,56,9,23,32,45,43,88,21,6,27,8,38,28,8,12,105,120
2023,2,22300380,12/21/2023,1610612750,Minnesota Timberwolves,1,1,1610612747,Los Angeles Lakers,0,0,28,23,51,14,22,36,42,45,87,20,5,25,13,34,32,6,14,100,118
2014,2,21401007,3/18/2015,1610612748,Miami Heat,1,1,1610612757,Portland Trail Blazers,0,0,39,38,77,7,3,10,46,41,87,9,5,14,12,33,21,3,9,91,108
2014,2,21401007,3/18/2015,1610612757,Portland Trail Blazers,0,0,1610612748,Miami Heat,1,1,31,24,55,10,16,26,41,40,81,12,9,21,17,29,22,7,17,92,104
2019,2,21900130,11/9/2019,1610612742,Dallas Mavericks,0,1,1610612763,Memphis Grizzlies,1,0,34,21,55,18,24,42,52,45,97,16,4,20,16,31,27,10,15,104,138
2019,2,21900130,11/9/2019,1610612763,Memphis Grizzlies,1,0,1610612742,Dallas Mavericks,0,1,38,21,59,12,24,36,50,45,95,10,4,14,13,35,31,8,16,105,122
2014,2,21400422,12/23/2014,1610612748,Miami Heat,1,0,1610612755,Philadelphia 76ers,0,1,25,29,54,8,18,26,33,47,80,13,5,18,18,31,13,13,22,92,87
2014,2,21400422,12/23/2014,1610612755,Philadelphia 76ers,0,1,1610612748,Miami Heat,1,0,28,30,58,5,14,19,33,44,77,20,7,27,16,32,11,10,17,92,91
2020,2,22001004,5/7/2021,1610612753,Orlando Magic,0,0,1610612766,Charlotte Hornets,1,1,32,36,68,9,21,30,41,57,98,21,7,28,18,42,19,5,7,101,112
2020,2,22001004,5/7/2021,1610612766,Charlotte Hornets,1,1,1610612753,Orlando Magic,0,0,35,21,56,9,24,33,44,45,89,25,8,33,16,34,28,6,11,100,122
2016,2,21600286,12/2/2016,1610612739,Cleveland Cavaliers,0,0,1610612741,Chicago Bulls,1,1,35,22,57,10,16,26,45,38,83,5,5,10,7,35,30,11,20,98,105
2016,2,21600286,12/2/2016,1610612741,Chicago Bulls,1,1,1610612739,Cleveland Cavaliers,0,0,44,34,78,3,15,18,47,49,96,14,3,17,19,30,31,5,12,99,111
2018,2,21801088,3/23/2019,1610612737,Atlanta Hawks,1,1,1610612755,Philadelphia 76ers,0,0,34,25,59,15,32,47,49,57,106,16,5,21,17,42,28,7,12,111,129
2018,2,21801088,3/23/2019,1610612755,Philadelphia 76ers,0,0,1610612737,Atlanta Hawks,1,1,32,36,68,10,13,23,42,49,91,33,6,39,15,35,21,8,14,109,127
2018,2,21800949,3/3/2019,1610612761,Toronto Raptors,0,0,1610612765,Detroit Pistons,1,1,23,34,57,14,25,39,37,59,96,19,5,24,21,40,22,10,17,103,107
2018,2,21800949,3/3/2019,1610612765,Detroit Pistons,1,1,1610612761,Toronto Raptors,0,0,28,25,53,12,21,33,40,46,86,20,9,29,14,33,25,8,17,103,112
2022,2,22200446,12/18/2022,1610612752,New York Knicks,0,1,1610612754,Indiana Pacers,1,0,31,26,57,8,18,26,39,44,83,23,7,30,15,32,13,5,16,98,109
2022,2,22200446,12/18/2022,1610612754,Indiana Pacers,1,0,1610612752,New York Knicks,0,1,26,26,52,13,25,38,39,51,90,15,8,23,17,38,20,7,15,97,106
2020,2,22000178,1/14/2021,1610612754,Indiana Pacers,0,1,1610612757,Portland Trail Blazers,1,0,35,27,62,9,21,30,44,48,92,14,4,18,18,32,29,8,14,95,111
2020,2,22000178,1/14/2021,1610612757,Portland Trail Blazers,1,0,1610612754,Indiana Pacers,0,1,19,25,44,13,30,43,32,55,87,10,0,10,17,38,16,11,18,96,87
2022,2,22201148,3/31/2023,1610612766,Charlotte Hornets,1,0,1610612741,Chicago Bulls,0,1,21,19,40,14,23,37,35,42,77,7,3,10,9,35,27,12,22,96,91
2017,2,21700167,11/9/2017,1610612755,Philadelphia 76ers,0,0,1610612758,Sacramento Kings,1,1,22,28,50,15,22,37,37,50,87,19,8,27,14,39,23,6,17,103,108
2017,2,21700167,11/9/2017,1610612758,Sacramento Kings,1,1,1610612755,Philadelphia 76ers,0,0,28,38,66,12,15,27,40,53,93,17,11,28,14,43,29,6,9,102,109
2016,2,21600772,2/6/2017,1610612737,Atlanta Hawks,1,0,1610612762,Utah Jazz,0,1,27,30,57,6,11,17,33,41,74,23,9,32,11,36,16,9,12,91,95
2023,2,22300246,11/26/2023,1610612738,Boston Celtics,1,1,1610612737,Atlanta Hawks,0,0,29,19,48,13,34,47,42,53,95,16,4,20,20,33,24,5,13,98,113
2016,2,21600772,2/6/2017,1610612762,Utah Jazz,0,1,1610612737,Atlanta Hawks,1,0,39,15,54,10,16,26,49,31,80,12,6,18,10,23,31,6,12,90,120
2020,2,22001003,5/7/2021,1610612740,New Orleans Pelicans,0,0,1610612755,Philadelphia 76ers,1,1,32,33,65,9,27,36,41,60,101,16,6,22,22,41,26,5,11,102,107
2020,2,22001003,5/7/2021,1610612755,Philadelphia 76ers,1,1,1610612740,New Orleans Pelicans,0,0,23,27,50,15,20,35,38,47,85,18,4,22,12,38,27,12,17,101,109
2023,2,22300266,11/30/2023,1610612751,Brooklyn Nets,1,0,1610612766,Charlotte Hornets,0,1,38,31,69,14,22,36,52,53,105,10,5,15,26,30,21,6,9,95,128
2014,2,21400421,12/23/2014,1610612743,Denver Nuggets,0,0,1610612751,Brooklyn Nets,1,1,29,28,57,7,18,25,36,46,82,17,5,22,19,30,15,10,18,92,96
2014,2,21400421,12/23/2014,1610612751,Brooklyn Nets,1,1,1610612743,Denver Nuggets,0,0,37,31,68,6,17,23,43,48,91,10,4,14,15,37,21,4,9,91,102
2022,2,22200447,12/18/2022,1610612751,Brooklyn Nets,0,1,1610612765,Detroit Pistons,1,0,29,22,51,15,14,29,44,36,80,21,2,23,6,32,26,9,13,98,124
2022,2,22200447,12/18/2022,1610612765,Detroit Pistons,1,0,1610612751,Brooklyn Nets,0,1,34,24,58,8,22,30,42,46,88,29,5,34,15,33,20,5,9,99,121
2017,2,21700166,11/9/2017,1610612739,Cleveland Cavaliers,0,0,1610612745,Houston Rockets,1,1,33,21,54,12,15,27,45,36,81,11,3,14,9,28,24,11,18,98,113
2017,2,21700166,11/9/2017,1610612745,Houston Rockets,1,1,1610612739,Cleveland Cavaliers,0,0,20,11,31,16,30,46,36,41,77,29,7,36,19,24,21,9,22,97,117
2016,2,21600771,2/6/2017,1610612746,LA Clippers,0,0,1610612761,Toronto Raptors,1,1,29,26,55,13,22,35,42,48,90,12,6,18,12,39,24,6,9,95,109
2016,2,21600771,2/6/2017,1610612761,Toronto Raptors,1,1,1610612746,LA Clippers,0,0,31,29,60,10,14,24,41,43,84,26,3,29,13,32,20,7,11,95,118
2014,2,21400009,10/29/2014,1610612750,Minnesota Timberwolves,0,0,1610612763,Memphis Grizzlies,1,1,33,41,74,6,6,12,39,47,86,17,6,23,26,24,20,10,23,96,101
2014,2,21400009,10/29/2014,1610612763,Memphis Grizzlies,1,1,1610612750,Minnesota Timberwolves,0,0,39,28,67,4,11,15,43,39,82,15,5,20,12,29,21,8,17,96,105
2023,2,22300151,11/6/2023,1610612752,New York Knicks,1,1,1610612746,LA Clippers,0,0,29,28,57,12,19,31,41,47,88,17,1,18,21,26,28,8,20,96,111
2023,2,22300191,11/13/2023,1610612739,Cleveland Cavaliers,0,0,1610612758,Sacramento Kings,1,1,29,27,56,16,19,35,45,46,91,14,3,17,16,32,24,3,11,94,120
2023,2,22300353,12/18/2023,1610612748,Miami Heat,1,0,1610612750,Minnesota Timberwolves,0,1,30,27,57,11,19,30,41,46,87,15,3,18,14,34,27,10,15,97,108
2020,2,22000177,1/14/2021,1610612743,Denver Nuggets,1,1,1610612744,Golden State Warriors,0,0,30,23,53,11,26,37,41,49,90,21,6,27,13,39,29,9,14,104,114
2020,2,22000177,1/14/2021,1610612744,Golden State Warriors,0,0,1610612743,Denver Nuggets,1,1,27,25,52,11,18,29,38,43,81,17,7,24,6,41,29,11,19,104,104
2017,2,21700165,11/9/2017,1610612740,New Orleans Pelicans,0,0,1610612761,Toronto Raptors,1,1,31,20,51,13,18,31,44,38,82,17,8,25,4,39,31,8,14,104,118
2022,2,22200448,12/18/2022,1610612744,Golden State Warriors,0,1,1610612761,Toronto Raptors,1,0,25,17,42,18,21,39,43,38,81,22,4,26,15,25,31,6,17,96,126
2022,2,22200448,12/18/2022,1610612761,Toronto Raptors,1,0,1610612744,Golden State Warriors,0,1,27,35,62,13,20,33,40,55,95,17,5,22,23,35,21,6,14,97,110
2019,2,21900369,12/12/2019,1610612742,Dallas Mavericks,0,1,1610612765,Detroit Pistons,1,0,29,15,44,16,28,44,45,43,88,16,7,23,13,33,25,8,11,98,122
2019,2,21900369,12/12/2019,1610612765,Detroit Pistons,1,0,1610612742,Dallas Mavericks,0,1,25,22,47,15,27,42,40,49,89,16,7,23,10,42,23,4,8,99,111
2017,2,21700165,11/9/2017,1610612761,Toronto Raptors,1,1,1610612740,New Orleans Pelicans,0,0,29,27,56,16,26,42,45,53,98,16,7,23,18,38,27,7,12,105,122
2014,2,21400420,12/23/2014,1610612737,Atlanta Hawks,1,1,1610612746,LA Clippers,0,0,22,31,53,12,11,23,34,42,76,27,8,35,11,36,28,10,14,95,107
2014,2,21400420,12/23/2014,1610612746,LA Clippers,0,0,1610612737,Atlanta Hawks,1,1,26,37,63,11,18,29,37,55,92,19,9,28,21,38,26,6,10,97,104
2021,2,22100374,12/8/2021,1610612750,Minnesota Timberwolves,1,0,1610612762,Utah Jazz,0,1,21,27,48,17,30,47,38,57,95,11,6,17,16,46,19,6,16,104,104
2023,2,22300643,1/27/2024,1610612748,Miami Heat,0,0,1610612752,New York Knicks,1,1,27,24,51,14,23,37,41,47,88,13,3,16,11,39,26,6,8,92,109
2021,2,22100374,12/8/2021,1610612762,Utah Jazz,0,1,1610612750,Minnesota Timberwolves,1,0,25,9,34,25,29,54,50,38,88,11,4,15,7,31,26,9,15,103,136
2020,2,22000176,1/14/2021,1610612745,Houston Rockets,0,1,1610612759,San Antonio Spurs,1,0,29,24,53,13,20,33,42,44,86,12,7,19,15,34,25,10,18,98,109
2020,2,22000176,1/14/2021,1610612759,San Antonio Spurs,1,0,1610612745,Houston Rockets,0,1,33,28,61,9,22,31,42,50,92,12,4,16,11,41,26,6,10,98,105
2014,2,21400008,10/29/2014,1610612737,Atlanta Hawks,0,0,1610612761,Toronto Raptors,1,1,27,31,58,13,9,22,40,40,80,9,8,17,13,33,26,13,19,94,102
2020,2,22001002,5/6/2021,1610612746,LA Clippers,1,1,1610612747,Los Angeles Lakers,0,0,28,18,46,13,18,31,41,36,77,23,3,26,14,24,23,8,22,97,118
2020,2,22001002,5/6/2021,1610612747,Los Angeles Lakers,0,0,1610612746,LA Clippers,1,1,23,28,51,10,26,36,33,54,87,18,11,29,15,43,21,4,11,97,94
2020,2,22000175,1/14/2021,1610612761,Toronto Raptors,1,1,1610612766,Charlotte Hornets,0,0,20,18,38,20,30,50,40,48,88,11,2,13,16,33,33,11,18,97,111
2020,2,22000175,1/14/2021,1610612766,Charlotte Hornets,0,0,1610612761,Toronto Raptors,1,1,27,25,52,15,20,35,42,45,87,9,3,12,18,29,32,13,20,96,108
2014,2,21400008,10/29/2014,1610612761,Toronto Raptors,1,1,1610612737,Atlanta Hawks,0,0,29,35,64,8,18,26,37,53,90,27,6,33,22,35,26,6,10,94,109
2014,2,21401006,3/18/2015,1610612755,Philadelphia 76ers,1,1,1610612765,Detroit Pistons,0,0,25,32,57,11,16,27,36,48,84,11,7,18,17,34,25,8,15,92,94
2014,2,21401006,3/18/2015,1610612765,Detroit Pistons,0,0,1610612755,Philadelphia 76ers,1,1,21,41,62,8,18,26,29,59,88,17,2,19,24,36,18,12,18,92,83
2014,2,21400419,12/23/2014,1610612741,Chicago Bulls,0,1,1610612764,Washington Wizards,1,0,34,34,68,5,12,17,39,46,85,16,8,24,12,37,20,7,12,95,99
2014,2,21400419,12/23/2014,1610612764,Washington Wizards,1,0,1610612741,Chicago Bulls,0,1,33,47,80,5,4,9,38,51,89,10,6,16,9,46,21,5,8,94,91
2017,2,21700164,11/9/2017,1610612747,Los Angeles Lakers,0,0,1610612764,Washington Wizards,1,1,28,35,63,3,20,23,31,55,86,30,11,41,19,40,17,7,19,105,95
2017,2,21700164,11/9/2017,1610612764,Washington Wizards,1,1,1610612747,Los Angeles Lakers,0,0,36,26,62,7,14,21,43,40,83,18,2,20,9,31,20,9,22,105,111
2014,2,21400007,10/29/2014,1610612748,Miami Heat,1,1,1610612764,Washington Wizards,0,0,30,23,53,9,19,28,39,42,81,20,3,23,14,29,20,7,14,92,107
2014,2,21400007,10/29/2014,1610612764,Washington Wizards,0,0,1610612748,Miami Heat,1,1,30,26,56,6,13,19,36,39,75,17,7,24,9,32,20,9,14,91,95
2021,2,22100373,12/8/2021,1610612742,Dallas Mavericks,0,1,1610612763,Memphis Grizzlies,1,0,25,19,44,12,21,33,37,40,77,18,5,23,11,29,24,14,19,96,104
2022,2,22201221,4/9/2023,1610612761,Toronto Raptors,1,1,1610612749,Milwaukee Bucks,0,0,37,25,62,11,22,33,48,47,95,14,2,16,11,36,29,5,9,100,121
2021,2,22100373,12/8/2021,1610612763,Memphis Grizzlies,1,0,1610612742,Dallas Mavericks,0,1,27,32,59,9,22,31,36,54,90,15,10,25,22,37,23,5,13,98,96
2019,2,21900129,11/9/2019,1610612741,Chicago Bulls,1,0,1610612745,Houston Rockets,0,1,33,33,66,4,28,32,37,61,98,16,2,18,14,48,21,12,15,107,94
2019,2,21900129,11/9/2019,1610612745,Houston Rockets,0,1,1610612741,Chicago Bulls,1,0,20,19,39,19,25,44,39,44,83,20,8,28,11,38,18,14,24,108,117
2016,2,21600770,2/6/2017,1610612754,Indiana Pacers,1,1,1610612760,Oklahoma City Thunder,0,0,25,36,61,8,18,26,33,54,87,19,10,29,19,42,19,6,10,91,93
2016,2,21600770,2/6/2017,1610612760,Oklahoma City Thunder,0,0,1610612754,Indiana Pacers,1,1,27,33,60,7,21,28,34,54,88,15,5,20,24,31,17,7,16,92,90
2023,2,22300150,11/6/2023,1610612748,Miami Heat,1,1,1610612747,Los Angeles Lakers,0,0,29,22,51,12,25,37,41,47,88,14,2,16,14,34,30,6,18,100,108
2020,2,22000174,1/14/2021,1610612748,Miami Heat,0,0,1610612755,Philadelphia 76ers,1,1,28,19,47,12,22,34,40,41,81,16,10,26,9,35,28,15,20,105,108
2020,2,22000174,1/14/2021,1610612755,Philadelphia 76ers,1,1,1610612748,Miami Heat,0,0,27,18,45,17,20,37,44,38,82,20,4,24,7,32,27,4,18,106,125
2023,2,22300866,3/2/2024,1610612751,Brooklyn Nets,1,1,1610612737,Atlanta Hawks,0,0,26,30,56,15,17,32,41,47,88,17,5,22,15,34,28,4,11,94,114
2021,2,22100372,12/8/2021,1610612745,Houston Rockets,1,1,1610612751,Brooklyn Nets,0,0,26,14,40,14,27,41,40,41,81,20,9,29,15,31,23,7,14,93,114
2021,2,22100372,12/8/2021,1610612751,Brooklyn Nets,0,0,1610612745,Houston Rockets,1,1,27,29,56,8,25,33,35,54,89,26,5,31,23,34,18,9,13,95,104
2017,2,21700163,11/8/2017,1610612744,Golden State Warriors,1,1,1610612750,Minnesota Timberwolves,0,0,33,16,49,15,21,36,48,37,85,14,4,18,5,35,37,15,19,106,125
2017,2,21700163,11/8/2017,1610612750,Minnesota Timberwolves,0,0,1610612744,Golden State Warriors,1,1,33,35,68,5,19,24,38,54,92,20,7,27,13,43,21,10,14,107,101
2020,2,22001001,5/6/2021,1610612744,Golden State Warriors,1,1,1610612760,Oklahoma City Thunder,0,0,23,16,39,19,28,47,42,44,86,15,3,18,9,37,36,9,14,99,118
2022,2,22201149,3/31/2023,1610612760,Oklahoma City Thunder,0,0,1610612754,Indiana Pacers,1,1,38,20,58,4,26,30,42,46,88,29,5,34,13,36,21,5,11,103,117
2020,2,22001001,5/6/2021,1610612760,Oklahoma City Thunder,0,0,1610612744,Golden State Warriors,1,1,27,22,49,9,30,39,36,52,88,16,4,20,8,48,21,4,10,100,97
2023,2,22300150,11/6/2023,1610612747,Los Angeles Lakers,0,0,1610612748,Miami Heat,1,1,36,19,55,8,18,26,44,37,81,11,3,14,5,34,28,11,17,98,107
2014,2,21400418,12/23/2014,1610612738,Boston Celtics,0,0,1610612753,Orlando Magic,1,1,26,36,62,7,16,23,33,52,85,22,7,29,13,43,22,7,12,99,95
2014,2,21400418,12/23/2014,1610612753,Orlando Magic,1,1,1610612738,Boston Celtics,0,0,32,33,65,7,11,18,39,44,83,15,8,23,10,37,23,10,14,99,100
2020,2,22000173,1/13/2021,1610612757,Portland Trail Blazers,0,1,1610612758,Sacramento Kings,1,0,21,21,42,23,25,48,44,46,90,21,6,27,14,36,28,4,8,96,132
2020,2,22000173,1/13/2021,1610612758,Sacramento Kings,1,0,1610612757,Portland Trail Blazers,0,1,25,21,46,19,19,38,44,40,84,19,7,26,15,28,35,9,13,96,126
2014,2,21400006,10/29/2014,1610612738,Boston Celtics,1,1,1610612751,Brooklyn Nets,0,0,41,25,66,8,14,22,49,39,88,15,8,23,11,34,28,6,13,101,121
2014,2,21400006,10/29/2014,1610612751,Brooklyn Nets,0,0,1610612738,Boston Celtics,1,1,32,29,61,7,12,19,39,41,80,20,6,26,14,29,20,11,21,101,105
2021,2,22100371,12/8/2021,1610612760,Oklahoma City Thunder,0,1,1610612761,Toronto Raptors,1,0,21,23,44,17,23,40,38,46,84,17,3,20,12,35,28,6,14,98,110
2021,2,22100371,12/8/2021,1610612761,Toronto Raptors,1,0,1610612760,Oklahoma City Thunder,0,1,27,25,52,15,26,41,42,51,93,10,5,15,15,38,27,12,13,98,109
2019,2,21900368,12/12/2019,1610612739,Cleveland Cavaliers,0,1,1610612759,San Antonio Spurs,1,0,29,22,51,15,30,45,44,52,96,14,6,20,15,40,22,11,19,108,117
2019,2,21900368,12/12/2019,1610612759,San Antonio Spurs,1,0,1610612739,Cleveland Cavaliers,0,1,37,33,70,5,11,16,42,44,86,20,5,25,5,42,19,6,12,107,109
2019,2,21900128,11/9/2019,1610612740,New Orleans Pelicans,0,1,1610612766,Charlotte Hornets,1,0,26,16,42,14,19,33,40,35,75,21,9,30,10,30,25,10,26,105,115
2019,2,21900128,11/9/2019,1610612766,Charlotte Hornets,1,0,1610612740,New Orleans Pelicans,0,1,24,29,53,12,23,35,36,52,88,26,8,34,18,36,27,13,22,107,110
2016,2,21600285,12/2/2016,1610612750,Minnesota Timberwolves,0,0,1610612752,New York Knicks,1,1,31,29,60,10,18,28,41,47,88,22,2,24,15,32,25,9,14,98,114
2016,2,21600285,12/2/2016,1610612752,New York Knicks,1,1,1610612750,Minnesota Timberwolves,0,0,29,26,55,12,19,31,41,45,86,24,6,30,18,31,26,6,15,99,118
2017,2,21700162,11/8/2017,1610612748,Miami Heat,0,1,1610612756,Phoenix Suns,1,0,31,20,51,12,18,30,43,38,81,28,7,35,11,30,21,4,15,102,126
2017,2,21700162,11/8/2017,1610612756,Phoenix Suns,1,0,1610612748,Miami Heat,0,1,28,31,59,12,17,29,40,48,88,23,7,30,9,45,20,5,11,104,115
2014,2,21401005,3/18/2015,1610612739,Cleveland Cavaliers,1,1,1610612751,Brooklyn Nets,0,0,30,23,53,15,14,29,45,37,82,12,8,20,15,26,32,7,13,90,117
2021,2,22100370,12/8/2021,1610612748,Miami Heat,1,1,1610612749,Milwaukee Bucks,0,0,18,12,30,22,25,47,40,37,77,11,1,12,7,30,32,11,22,98,113
2021,2,22100370,12/8/2021,1610612749,Milwaukee Bucks,0,0,1610612748,Miami Heat,1,1,24,22,46,12,27,39,36,49,85,20,7,27,16,39,18,6,19,99,104
2016,2,21600769,2/6/2017,1610612739,Cleveland Cavaliers,0,1,1610612764,Washington Wizards,1,0,30,24,54,19,19,38,49,43,92,23,5,28,16,32,31,9,20,111,140
2016,2,21600769,2/6/2017,1610612764,Washington Wizards,1,0,1610612739,Cleveland Cavaliers,0,1,38,32,70,12,17,29,50,49,99,23,3,26,14,35,29,7,12,111,135
2016,2,21600284,12/2/2016,1610612747,Los Angeles Lakers,0,0,1610612761,Toronto Raptors,1,1,26,41,67,6,20,26,32,61,93,10,7,17,27,37,16,8,18,92,80
2016,2,21600284,12/2/2016,1610612761,Toronto Raptors,1,1,1610612747,Los Angeles Lakers,0,0,33,21,54,12,17,29,45,38,83,11,2,13,8,31,25,6,11,92,113
2022,2,22201150,3/31/2023,1610612761,Toronto Raptors,0,0,1610612755,Philadelphia 76ers,1,1,34,24,58,8,18,26,42,42,84,18,5,23,18,28,26,7,13,89,110
2023,2,22300817,2/25/2024,1610612749,Milwaukee Bucks,0,1,1610612755,Philadelphia 76ers,1,0,25,17,42,18,19,37,43,36,79,15,3,18,11,28,32,12,19,95,119
2023,2,22300149,11/6/2023,1610612749,Milwaukee Bucks,0,1,1610612751,Brooklyn Nets,1,0,30,18,48,16,32,48,46,50,96,21,3,24,15,36,26,2,10,102,129
2014,2,21401005,3/18/2015,1610612751,Brooklyn Nets,0,0,1610612739,Cleveland Cavaliers,1,1,31,29,60,5,15,20,36,44,80,15,6,21,11,35,23,2,11,91,92
2023,2,22300152,11/6/2023,1610612762,Utah Jazz,0,0,1610612741,Chicago Bulls,1,1,25,18,43,16,27,43,41,45,86,15,2,17,18,29,32,12,23,99,113
2020,2,22000172,1/13/2021,1610612740,New Orleans Pelicans,0,0,1610612746,LA Clippers,1,1,32,28,60,10,18,28,42,46,88,12,4,16,14,34,18,4,11,92,106
2020,2,22000172,1/13/2021,1610612746,LA Clippers,1,1,1610612740,New Orleans Pelicans,0,0,17,20,37,18,19,37,35,39,74,23,4,27,5,37,26,4,10,93,111
2021,2,22100369,12/8/2021,1610612752,New York Knicks,0,0,1610612754,Indiana Pacers,1,1,27,29,56,9,21,30,36,50,86,21,2,23,16,34,17,8,13,95,102
2021,2,22100369,12/8/2021,1610612754,Indiana Pacers,1,1,1610612752,New York Knicks,0,0,36,23,59,10,17,27,46,40,86,20,5,25,14,28,27,6,11,95,122
2022,2,22201151,3/31/2023,1610612764,Washington Wizards,1,0,1610612753,Orlando Magic,0,1,24,31,55,17,33,50,41,64,105,10,2,12,21,44,24,2,13,101,109
2023,2,22300191,11/13/2023,1610612758,Sacramento Kings,1,1,1610612739,Cleveland Cavaliers,0,0,29,12,41,20,22,42,49,34,83,14,8,22,9,30,32,3,10,95,132
2023,2,22300058,11/28/2023,1610612760,Oklahoma City Thunder,0,0,1610612750,Minnesota Timberwolves,1,1,26,34,60,11,19,30,37,53,90,18,5,23,12,43,22,3,10,99,103
2023,2,22300153,11/6/2023,1610612758,Sacramento Kings,0,0,1610612745,Houston Rockets,1,1,22,19,41,14,26,40,36,45,81,11,9,20,14,35,22,8,15,92,97
2020,2,22000171,3/30/2021,1610612737,Atlanta Hawks,0,0,1610612756,Phoenix Suns,1,1,28,25,53,13,19,32,41,44,85,15,6,21,7,41,30,6,7,95,110
2017,2,21700161,11/8/2017,1610612738,Boston Celtics,1,1,1610612747,Los Angeles Lakers,0,0,31,38,69,7,22,29,38,60,98,24,7,31,25,39,20,8,14,103,107
2017,2,21700161,11/8/2017,1610612747,Los Angeles Lakers,0,0,1610612738,Boston Celtics,1,1,32,29,61,5,19,24,37,48,85,17,6,23,13,37,16,8,20,101,96
2021,2,22100368,12/8/2021,1610612764,Washington Wizards,0,1,1610612765,Detroit Pistons,1,0,30,26,56,12,20,32,42,46,88,23,5,28,16,34,27,9,17,101,119
2021,2,22100368,12/8/2021,1610612765,Detroit Pistons,1,0,1610612764,Washington Wizards,0,1,24,31,55,13,11,24,37,42,79,29,6,35,12,33,22,6,16,103,116
2020,2,22000171,3/30/2021,1610612756,Phoenix Suns,1,1,1610612737,Atlanta Hawks,0,0,33,23,56,12,20,32,45,43,88,15,3,18,14,30,27,9,14,95,117
2019,2,21900367,12/12/2019,1610612738,Boston Celtics,1,0,1610612755,Philadelphia 76ers,0,1,31,29,60,11,20,31,42,49,91,14,3,17,12,39,24,4,6,91,109
2019,2,21900367,12/12/2019,1610612755,Philadelphia 76ers,0,1,1610612738,Boston Celtics,1,0,27,27,54,14,14,28,41,41,82,19,4,23,14,28,27,4,12,91,115
2020,2,22001000,5/6/2021,1610612737,Atlanta Hawks,0,0,1610612754,Indiana Pacers,1,1,33,24,57,15,22,37,48,46,94,15,3,18,11,35,27,11,12,101,126
2020,2,22001000,5/6/2021,1610612754,Indiana Pacers,1,1,1610612737,Atlanta Hawks,0,0,46,21,67,8,12,20,54,33,87,17,2,19,8,27,35,8,15,102,133
2022,2,22201149,3/31/2023,1610612754,Indiana Pacers,1,1,1610612760,Oklahoma City Thunder,0,0,33,24,57,12,29,41,45,53,98,19,9,28,24,34,30,10,16,104,121
2022,2,22200492,12/23/2022,1610612747,Los Angeles Lakers,1,0,1610612766,Charlotte Hornets,0,1,29,19,48,19,25,44,48,44,92,15,7,22,14,32,27,11,17,105,130
2022,2,22200492,12/23/2022,1610612766,Charlotte Hornets,0,1,1610612747,Los Angeles Lakers,1,0,36,17,53,16,25,41,52,42,94,14,4,18,13,31,30,5,16,107,134
2018,2,21800832,2/9/2019,1610612745,Houston Rockets,1,0,1610612760,Oklahoma City Thunder,0,1,21,20,41,16,29,45,37,49,86,22,8,30,10,43,18,7,12,103,112
2018,2,21800832,2/9/2019,1610612760,Oklahoma City Thunder,0,1,1610612745,Houston Rockets,1,0,27,28,55,13,21,34,40,49,89,24,6,30,18,35,20,10,19,103,117
2018,2,21800658,1/16/2019,1610612738,Boston Celtics,1,1,1610612761,Toronto Raptors,0,0,32,30,62,14,16,30,46,46,92,11,2,13,15,31,32,9,15,97,117
2023,2,22300817,2/25/2024,1610612755,Philadelphia 76ers,1,0,1610612749,Milwaukee Bucks,0,1,20,31,51,16,30,46,36,61,97,10,1,11,19,42,24,6,10,94,98
2021,2,22100367,12/8/2021,1610612739,Cleveland Cavaliers,1,1,1610612741,Chicago Bulls,0,0,31,21,52,13,15,28,44,36,80,14,2,16,8,29,28,6,16,96,115
2021,2,22100367,12/8/2021,1610612741,Chicago Bulls,0,0,1610612739,Cleveland Cavaliers,1,1,28,30,58,7,19,26,35,49,84,15,6,21,16,38,21,10,18,96,92
2020,2,22000169,1/13/2021,1610612750,Minnesota Timberwolves,1,0,1610612763,Memphis Grizzlies,0,1,30,23,53,9,28,37,39,51,90,20,4,24,15,38,27,11,13,99,107
2020,2,22000169,1/13/2021,1610612763,Memphis Grizzlies,0,1,1610612750,Minnesota Timberwolves,1,0,42,39,81,8,17,25,50,56,106,10,3,13,18,41,33,3,7,100,118
2014,2,21400005,10/29/2014,1610612754,Indiana Pacers,1,1,1610612755,Philadelphia 76ers,0,0,30,26,56,8,17,25,38,43,81,19,9,28,19,29,22,10,18,92,103
2014,2,21400005,10/29/2014,1610612755,Philadelphia 76ers,0,0,1610612754,Indiana Pacers,1,1,28,40,68,6,15,21,34,55,89,17,13,30,22,38,17,5,11,94,91
2017,2,21700160,11/8/2017,1610612752,New York Knicks,0,0,1610612753,Orlando Magic,1,1,37,31,68,5,7,12,42,38,80,10,3,13,16,24,26,16,23,93,99
2017,2,21700160,11/8/2017,1610612753,Orlando Magic,1,1,1610612752,New York Knicks,0,0,30,22,52,13,15,28,43,37,80,13,9,22,10,32,31,7,13,92,112
2016,2,21600283,12/2/2016,1610612738,Boston Celtics,1,1,1610612758,Sacramento Kings,0,0,25,35,60,11,17,28,36,52,88,14,1,15,15,38,25,9,15,95,97
2016,2,21600283,12/2/2016,1610612758,Sacramento Kings,0,0,1610612738,Boston Celtics,1,1,27,35,62,6,20,26,33,55,88,20,5,25,20,38,22,10,14,96,92
2023,2,22300153,11/6/2023,1610612745,Houston Rockets,1,1,1610612758,Sacramento Kings,0,0,28,16,44,15,16,31,43,32,75,21,6,27,7,26,28,5,11,92,122
2017,2,21700159,11/8/2017,1610612754,Indiana Pacers,0,0,1610612765,Detroit Pistons,1,1,31,33,64,7,17,24,38,50,88,14,4,18,11,42,22,3,15,99,97
2017,2,21700159,11/8/2017,1610612765,Detroit Pistons,1,1,1610612754,Indiana Pacers,0,0,31,25,56,12,15,27,43,40,83,16,9,25,12,34,25,8,18,99,114
2016,2,21600768,2/6/2017,1610612747,Los Angeles Lakers,0,1,1610612752,New York Knicks,1,0,36,38,74,8,20,28,44,58,102,25,6,31,24,37,19,4,8,102,121
2016,2,21600768,2/6/2017,1610612752,New York Knicks,1,0,1610612747,Los Angeles Lakers,0,1,30,31,61,7,14,21,37,45,82,26,7,33,12,36,16,9,16,101,107
2021,2,22100366,12/8/2021,1610612755,Philadelphia 76ers,0,1,1610612766,Charlotte Hornets,1,0,23,18,41,13,21,34,36,39,75,25,5,30,10,30,23,7,17,96,110
2021,2,22100366,12/8/2021,1610612766,Charlotte Hornets,1,0,1610612755,Philadelphia 76ers,0,1,29,22,51,10,19,29,39,41,80,18,3,21,11,31,22,6,19,97,106
2020,2,22000170,1/13/2021,1610612747,Los Angeles Lakers,0,1,1610612760,Oklahoma City Thunder,1,0,30,28,58,17,20,37,47,48,95,17,5,22,16,36,26,4,10,98,128
2020,2,22000170,1/13/2021,1610612760,Oklahoma City Thunder,1,0,1610612747,Los Angeles Lakers,0,1,27,28,55,10,21,31,37,49,86,15,4,19,10,41,23,6,12,98,99
2014,2,21400004,10/29/2014,1610612749,Milwaukee Bucks,0,0,1610612766,Charlotte Hornets,1,1,32,34,66,7,7,14,39,41,80,21,3,24,4,37,25,8,15,103,106
2019,2,21900127,11/9/2019,1610612738,Boston Celtics,0,1,1610612759,San Antonio Spurs,1,0,34,23,57,14,23,37,48,46,94,25,3,28,9,40,28,0,8,103,135
2019,2,21900127,11/9/2019,1610612759,San Antonio Spurs,1,0,1610612738,Boston Celtics,0,1,25,44,69,14,16,30,39,60,99,23,7,30,23,40,24,12,16,102,115
2018,2,21801087,3/23/2019,1610612738,Boston Celtics,0,0,1610612766,Charlotte Hornets,1,1,25,25,50,19,24,43,44,49,93,10,5,15,11,41,31,7,11,101,117
2018,2,21801087,3/23/2019,1610612766,Charlotte Hornets,1,1,1610612738,Boston Celtics,0,0,24,33,57,18,20,38,42,53,95,22,6,28,19,37,26,6,11,100,124
2018,2,21800948,3/3/2019,1610612739,Cleveland Cavaliers,1,1,1610612753,Orlando Magic,0,0,22,18,40,14,29,43,36,47,83,21,2,23,13,36,20,5,13,95,107
2018,2,21800948,3/3/2019,1610612753,Orlando Magic,0,0,1610612739,Cleveland Cavaliers,1,1,33,29,62,6,20,26,39,49,88,9,2,11,11,40,23,7,11,95,93
2017,2,21700158,11/7/2017,1610612758,Sacramento Kings,1,1,1610612760,Oklahoma City Thunder,0,0,28,27,55,9,15,24,37,42,79,11,1,12,6,37,21,16,23,100,94
2017,2,21700158,11/7/2017,1610612760,Oklahoma City Thunder,0,0,1610612758,Sacramento Kings,1,1,19,30,49,10,27,37,29,57,86,18,5,23,15,44,15,6,17,101,86
2022,2,22201220,4/9/2023,1610612752,New York Knicks,1,0,1610612754,Indiana Pacers,0,1,37,31,68,15,25,40,52,56,108,17,5,22,22,38,29,8,15,109,136
2022,2,22201151,3/31/2023,1610612753,Orlando Magic,0,1,1610612764,Washington Wizards,1,0,36,28,64,8,16,24,44,44,88,20,6,26,10,37,26,5,11,101,116
2023,2,22300154,11/6/2023,1610612750,Minnesota Timberwolves,1,1,1610612738,Boston Celtics,0,0,31,17,48,13,24,37,44,41,85,13,12,25,11,38,26,13,24,109,114
2014,2,21400004,10/29/2014,1610612766,Charlotte Hornets,1,1,1610612749,Milwaukee Bucks,0,0,35,45,80,6,15,21,41,60,101,20,9,29,26,38,27,9,13,104,108
2023,2,22300155,11/6/2023,1610612737,Atlanta Hawks,0,0,1610612760,Oklahoma City Thunder,1,1,24,36,60,14,28,42,38,64,102,27,5,32,27,40,27,7,15,106,117
2021,2,22100365,12/7/2021,1610612738,Boston Celtics,0,0,1610612747,Los Angeles Lakers,1,1,26,23,49,10,23,33,36,46,82,20,9,29,10,41,27,7,13,97,102
2021,2,22100365,12/7/2021,1610612747,Los Angeles Lakers,1,1,1610612738,Boston Celtics,0,0,40,26,66,8,19,27,48,45,93,13,4,17,20,27,25,8,16,98,117
2019,2,21900126,11/8/2019,1610612747,Los Angeles Lakers,1,1,1610612748,Miami Heat,0,0,32,25,57,8,24,32,40,49,89,7,1,8,16,33,30,9,18,93,95
2019,2,21900126,11/8/2019,1610612748,Miami Heat,0,0,1610612747,Los Angeles Lakers,1,1,22,23,45,6,29,35,28,52,80,18,6,24,11,42,18,6,13,93,80
2020,2,22000999,5/6/2021,1610612763,Memphis Grizzlies,0,0,1610612765,Detroit Pistons,1,1,28,24,52,10,27,37,38,51,89,11,6,17,17,37,25,9,15,94,97
2020,2,22000999,5/6/2021,1610612765,Detroit Pistons,1,1,1610612763,Memphis Grizzlies,0,0,33,22,55,11,17,28,44,39,83,12,2,14,8,31,24,7,12,94,111
2023,2,22300381,12/21/2023,1610612764,Washington Wizards,0,1,1610612757,Portland Trail Blazers,1,0,30,24,54,12,18,30,42,42,84,22,10,32,12,36,26,7,12,99,118
2014,2,21400003,10/28/2014,1610612745,Houston Rockets,0,1,1610612747,Los Angeles Lakers,1,0,19,25,44,12,17,29,31,42,73,34,16,50,17,31,22,7,14,93,108
2014,2,21400003,10/28/2014,1610612747,Los Angeles Lakers,1,0,1610612745,Houston Rockets,0,1,25,44,69,3,7,10,28,51,79,31,8,39,17,37,16,7,13,94,90
2021,2,22100364,12/7/2021,1610612752,New York Knicks,0,1,1610612759,San Antonio Spurs,1,0,25,28,53,18,20,38,43,48,91,17,2,19,17,32,22,5,11,94,121
2021,2,22100364,12/7/2021,1610612759,San Antonio Spurs,1,0,1610612752,New York Knicks,0,1,29,32,61,12,19,31,41,51,92,15,5,20,16,38,30,7,10,95,109
2020,2,22000168,1/13/2021,1610612751,Brooklyn Nets,0,1,1610612752,New York Knicks,1,0,28,23,51,16,24,40,44,47,91,12,5,17,14,35,29,4,6,92,116
2020,2,22000168,1/13/2021,1610612752,New York Knicks,1,0,1610612751,Brooklyn Nets,0,1,33,31,64,11,17,28,44,48,92,10,2,12,14,36,22,3,9,91,109
2019,2,21900366,12/11/2019,1610612744,Golden State Warriors,1,0,1610612752,New York Knicks,0,1,35,32,67,10,27,37,45,59,104,22,8,30,16,47,27,5,8,110,122
2019,2,21900366,12/11/2019,1610612752,New York Knicks,0,1,1610612744,Golden State Warriors,1,0,31,30,61,12,17,29,43,47,90,26,8,34,18,33,25,10,19,109,124
2014,2,21401004,3/17/2015,1610612746,LA Clippers,1,1,1610612766,Charlotte Hornets,0,0,26,27,53,9,15,24,35,42,77,20,8,28,9,36,24,6,13,94,99
2014,2,21401004,3/17/2015,1610612766,Charlotte Hornets,0,0,1610612746,LA Clippers,1,1,27,38,65,5,9,14,32,47,79,23,6,29,13,39,20,7,13,94,92
2020,2,22000998,5/6/2021,1610612742,Dallas Mavericks,1,1,1610612751,Brooklyn Nets,0,0,25,30,55,15,19,34,40,49,89,18,8,26,12,41,23,7,11,102,113
2020,2,22000998,5/6/2021,1610612751,Brooklyn Nets,0,0,1610612742,Dallas Mavericks,1,1,28,30,58,13,24,37,41,54,95,14,1,15,12,42,18,11,14,102,109
2014,2,21400417,12/23/2014,1610612740,New Orleans Pelicans,0,0,1610612754,Indiana Pacers,1,1,29,34,63,4,16,20,33,50,83,14,5,19,15,38,15,9,16,93,84
2014,2,21400417,12/23/2014,1610612754,Indiana Pacers,1,1,1610612740,New Orleans Pelicans,0,0,34,29,63,5,10,15,39,39,78,13,5,18,4,37,24,4,9,92,96
2022,2,22201150,3/31/2023,1610612755,Philadelphia 76ers,1,1,1610612761,Toronto Raptors,0,0,29,13,42,12,19,31,41,32,73,23,2,25,13,20,28,6,18,89,117
2018,2,21801086,3/22/2019,1610612747,Los Angeles Lakers,1,0,1610612751,Brooklyn Nets,0,1,28,32,60,9,27,36,37,59,96,23,9,32,23,40,21,8,16,104,106
2018,2,21801086,3/22/2019,1610612751,Brooklyn Nets,0,1,1610612747,Los Angeles Lakers,1,0,21,29,50,16,26,42,37,55,92,21,7,28,15,44,21,8,14,104,111
2023,2,22300381,12/21/2023,1610612757,Portland Trail Blazers,1,0,1610612764,Washington Wizards,0,1,29,36,65,14,16,30,43,52,95,17,6,23,23,32,24,9,16,101,117
2018,2,21800658,1/16/2019,1610612761,Toronto Raptors,0,0,1610612738,Boston Celtics,1,1,34,29,63,7,22,29,41,51,92,19,2,21,17,36,20,7,13,96,108
2023,2,22300146,11/6/2023,1610612759,San Antonio Spurs,0,0,1610612754,Indiana Pacers,1,1,32,36,68,8,18,26,40,54,94,23,7,30,14,44,26,7,11,104,111
2020,2,22000167,3/21/2021,1610612738,Boston Celtics,1,1,1610612753,Orlando Magic,0,0,17,16,33,23,32,55,40,48,88,9,0,9,12,36,27,6,10,92,112
2020,2,22000167,3/21/2021,1610612753,Orlando Magic,0,0,1610612738,Boston Celtics,1,1,21,29,50,11,23,34,32,52,84,21,9,30,12,42,20,6,6,92,96
2021,2,22100363,12/7/2021,1610612742,Dallas Mavericks,1,0,1610612751,Brooklyn Nets,0,1,27,17,44,9,37,46,36,54,90,18,4,22,13,42,21,3,4,93,99
2021,2,22100363,12/7/2021,1610612751,Brooklyn Nets,0,1,1610612742,Dallas Mavericks,1,0,34,23,57,8,18,26,42,41,83,10,3,13,10,32,28,6,12,92,102
2019,2,21900365,12/11/2019,1610612758,Sacramento Kings,1,1,1610612760,Oklahoma City Thunder,0,0,29,28,57,10,21,31,39,49,88,6,4,10,13,37,12,8,16,96,94
2019,2,21900365,12/11/2019,1610612760,Oklahoma City Thunder,0,0,1610612758,Sacramento Kings,1,1,21,25,46,13,20,33,34,45,79,12,6,18,10,38,24,8,18,95,93
2017,2,21700157,11/7/2017,1610612757,Portland Trail Blazers,1,0,1610612763,Memphis Grizzlies,0,1,30,32,62,6,13,19,36,45,81,19,1,20,14,32,11,8,16,92,97
2014,2,21401003,3/17/2015,1610612740,New Orleans Pelicans,1,1,1610612749,Milwaukee Bucks,0,0,21,37,58,8,17,25,29,54,83,19,7,26,14,43,26,4,13,94,85
2014,2,21401003,3/17/2015,1610612749,Milwaukee Bucks,0,0,1610612740,New Orleans Pelicans,1,1,28,38,66,4,16,20,32,54,86,16,5,21,14,43,20,6,10,94,84
2017,2,21700157,11/7/2017,1610612763,Memphis Grizzlies,0,1,1610612757,Portland Trail Blazers,1,0,28,26,54,7,12,19,35,38,73,21,4,25,6,33,18,9,15,92,98
2014,2,21400002,10/28/2014,1610612742,Dallas Mavericks,0,0,1610612759,San Antonio Spurs,1,1,30,27,57,8,13,21,38,40,78,16,3,19,13,29,17,5,10,85,100
2021,2,22100362,12/6/2021,1610612746,LA Clippers,0,1,1610612757,Portland Trail Blazers,1,0,30,26,56,11,25,36,41,51,92,9,5,14,13,39,18,6,13,98,102
2021,2,22100362,12/6/2021,1610612757,Portland Trail Blazers,1,0,1610612746,LA Clippers,0,1,30,27,57,5,17,22,35,44,79,15,5,20,9,37,16,8,18,98,90
2020,2,22000166,3/18/2021,1610612762,Utah Jazz,0,0,1610612764,Washington Wizards,1,1,26,22,48,18,30,48,44,52,96,16,12,28,18,38,19,6,17,107,122
2020,2,22000166,3/18/2021,1610612764,Washington Wizards,1,1,1610612762,Utah Jazz,0,0,40,29,69,7,10,17,47,39,86,30,8,38,8,36,23,10,13,108,131
2014,2,21400002,10/28/2014,1610612759,San Antonio Spurs,1,1,1610612742,Dallas Mavericks,0,0,23,19,42,14,14,28,37,33,70,13,3,16,11,25,23,9,21,85,101
2020,2,22000997,5/6/2021,1610612761,Toronto Raptors,1,0,1610612764,Washington Wizards,0,1,33,34,67,14,24,38,47,58,105,21,6,27,22,39,23,4,13,110,129
2020,2,22000997,5/6/2021,1610612764,Washington Wizards,0,1,1610612761,Toronto Raptors,1,0,28,36,64,13,17,30,41,53,94,36,7,43,20,35,29,9,15,110,131
2014,2,21400416,12/23/2014,1610612739,Cleveland Cavaliers,1,1,1610612750,Minnesota Timberwolves,0,0,32,28,60,12,12,24,44,40,84,25,6,31,17,25,24,13,17,98,125
2014,2,21400416,12/23/2014,1610612750,Minnesota Timberwolves,0,0,1610612739,Cleveland Cavaliers,1,1,35,40,75,4,9,13,39,49,88,22,7,29,24,30,25,11,18,98,104
2023,2,22300129,11/2/2023,1610612765,Detroit Pistons,0,0,1610612740,New Orleans Pelicans,1,1,28,28,56,13,25,38,41,53,94,21,5,26,23,31,30,5,16,100,116
2020,2,22000165,1/13/2021,1610612749,Milwaukee Bucks,0,1,1610612765,Detroit Pistons,1,0,22,20,42,19,24,43,41,44,85,9,5,14,10,36,31,8,14,96,110
2020,2,22000165,1/13/2021,1610612765,Detroit Pistons,1,0,1610612749,Milwaukee Bucks,0,1,22,35,57,14,21,35,36,56,92,15,7,22,21,38,25,10,16,96,101
2021,2,22100361,12/6/2021,1610612744,Golden State Warriors,1,1,1610612753,Orlando Magic,0,0,23,24,47,20,20,40,43,44,87,20,9,29,12,36,28,10,15,105,126
2021,2,22100361,12/6/2021,1610612753,Orlando Magic,0,0,1610612744,Golden State Warriors,1,1,22,16,38,11,27,38,33,43,76,18,4,22,6,38,18,15,23,104,95
2016,2,21600767,2/5/2017,1610612757,Portland Trail Blazers,0,0,1610612760,Oklahoma City Thunder,1,1,25,34,59,10,18,28,35,52,87,19,2,21,11,41,15,9,13,99,99
2016,2,21600767,2/5/2017,1610612760,Oklahoma City Thunder,1,1,1610612757,Portland Trail Blazers,0,0,36,44,80,4,14,18,40,58,98,21,7,28,27,35,18,6,12,100,105
2016,2,21600282,12/2/2016,1610612753,Orlando Magic,0,1,1610612755,Philadelphia 76ers,1,0,24,28,52,13,13,26,37,41,78,18,8,26,12,32,24,3,12,92,105
2016,2,21600282,12/2/2016,1610612755,Philadelphia 76ers,1,0,1610612753,Orlando Magic,0,1,27,36,63,9,23,32,36,59,95,7,3,10,17,43,24,8,10,92,88
2020,2,22000164,1/13/2021,1610612742,Dallas Mavericks,0,1,1610612766,Charlotte Hornets,1,0,25,25,50,15,31,46,40,56,96,9,7,16,18,43,22,8,10,96,104
2020,2,22000164,1/13/2021,1610612766,Charlotte Hornets,1,0,1610612742,Dallas Mavericks,0,1,28,34,62,10,28,38,38,62,100,7,7,14,25,41,26,8,14,97,93
2019,2,21900364,12/11/2019,1610612740,New Orleans Pelicans,0,0,1610612749,Milwaukee Bucks,1,1,23,20,43,16,29,45,39,49,88,18,4,22,12,39,29,13,21,107,112
2019,2,21900364,12/11/2019,1610612749,Milwaukee Bucks,1,1,1610612740,New Orleans Pelicans,0,0,31,23,54,19,20,39,50,43,93,8,1,9,7,37,27,8,15,106,127
2017,2,21700156,11/7/2017,1610612755,Philadelphia 76ers,0,1,1610612762,Utah Jazz,1,0,22,32,54,12,15,27,34,47,81,24,6,30,12,37,23,14,22,106,104
2017,2,21700156,11/7/2017,1610612762,Utah Jazz,1,0,1610612755,Philadelphia 76ers,0,1,21,39,60,9,30,39,30,69,99,28,7,35,22,52,15,5,12,107,97
2014,2,21400001,10/28/2014,1610612740,New Orleans Pelicans,1,1,1610612753,Orlando Magic,0,0,37,47,84,4,13,17,41,60,101,15,16,31,29,42,20,5,9,94,101
2014,2,21400001,10/28/2014,1610612753,Orlando Magic,0,0,1610612740,New Orleans Pelicans,1,1,28,45,73,4,7,11,32,52,84,16,5,21,18,37,17,10,18,94,84
2020,2,22000996,5/5/2021,1610612759,San Antonio Spurs,0,0,1610612762,Utah Jazz,1,1,30,39,69,7,16,23,37,55,92,13,7,20,11,47,22,5,7,98,94
2020,2,22000996,5/5/2021,1610612762,Utah Jazz,1,1,1610612759,San Antonio Spurs,0,0,31,16,47,18,23,41,49,39,88,10,4,14,13,28,24,7,18,98,126
2022,2,22201152,3/31/2023,1610612762,Utah Jazz,0,0,1610612738,Boston Celtics,1,1,37,30,67,9,20,29,46,50,96,13,1,14,16,35,23,8,18,105,114
2022,2,22201156,3/31/2023,1610612763,Memphis Grizzlies,1,1,1610612746,LA Clippers,0,0,34,29,63,9,24,33,43,53,96,13,4,17,14,42,25,5,15,103,108
2023,2,22300883,3/4/2024,1610612758,Sacramento Kings,1,0,1610612741,Chicago Bulls,0,1,30,25,55,11,26,37,41,51,92,16,2,18,26,26,29,9,18,92,109
2023,2,22300145,11/6/2023,1610612744,Golden State Warriors,0,1,1610612765,Detroit Pistons,1,0,34,22,56,12,29,41,46,51,97,16,5,21,21,33,26,8,11,98,120
2023,2,22300129,11/2/2023,1610612740,New Orleans Pelicans,1,1,1610612765,Detroit Pistons,0,0,25,23,48,14,18,32,39,41,80,33,2,35,10,33,27,4,12,101,125
2017,2,21700155,11/7/2017,1610612743,Denver Nuggets,1,1,1610612751,Brooklyn Nets,0,0,35,24,59,9,25,34,44,49,93,15,5,20,11,43,26,12,19,109,112
2017,2,21700155,11/7/2017,1610612751,Brooklyn Nets,0,0,1610612743,Denver Nuggets,1,1,27,27,54,11,24,35,38,51,89,17,5,22,13,39,22,15,25,109,104
2022,2,22201148,3/31/2023,1610612741,Chicago Bulls,0,1,1610612766,Charlotte Hornets,1,0,32,25,57,13,18,31,45,43,88,18,4,22,10,35,25,3,7,94,121
2021,2,22100360,12/6/2021,1610612756,Phoenix Suns,1,1,1610612759,San Antonio Spurs,0,0,33,32,65,10,19,29,43,51,94,12,6,18,19,35,27,12,17,101,108
2021,2,22100360,12/6/2021,1610612759,San Antonio Spurs,0,0,1610612756,Phoenix Suns,1,1,29,35,64,11,18,29,40,53,93,13,6,19,16,38,31,6,15,101,104
2019,2,21900363,12/11/2019,1610612756,Phoenix Suns,1,0,1610612763,Memphis Grizzlies,0,1,28,31,59,9,25,34,37,56,93,25,5,30,12,49,29,8,12,106,108
2019,2,21900363,12/11/2019,1610612763,Memphis Grizzlies,0,1,1610612756,Phoenix Suns,1,0,32,31,63,10,14,24,42,45,87,21,5,26,13,36,23,6,18,105,115
2020,2,22000995,5/5/2021,1610612743,Denver Nuggets,1,1,1610612752,New York Knicks,0,0,25,33,58,12,27,39,37,60,97,27,6,33,24,37,23,6,15,104,113
2020,2,22000995,5/5/2021,1610612752,New York Knicks,0,0,1610612743,Denver Nuggets,1,1,20,31,51,13,22,35,33,53,86,18,9,27,10,48,18,13,15,104,97
2020,2,22000163,1/12/2021,1610612744,Golden State Warriors,1,0,1610612754,Indiana Pacers,0,1,21,30,51,13,25,38,34,55,89,14,8,22,15,43,25,9,16,101,95
2017,2,21700154,11/7/2017,1610612746,LA Clippers,0,0,1610612759,San Antonio Spurs,1,1,31,21,52,11,19,30,42,40,82,12,5,17,15,28,20,13,18,96,107
2017,2,21700154,11/7/2017,1610612759,San Antonio Spurs,1,1,1610612746,LA Clippers,0,0,30,26,56,15,13,28,45,39,84,15,4,19,11,31,33,6,13,95,120
2016,2,21600766,2/5/2017,1610612738,Boston Celtics,1,1,1610612746,LA Clippers,0,0,21,15,36,16,36,52,37,51,88,17,3,20,11,42,24,4,11,97,107
2020,2,22000163,1/12/2021,1610612754,Indiana Pacers,0,1,1610612744,Golden State Warriors,1,0,30,30,60,9,19,28,39,49,88,17,8,25,14,39,26,8,15,100,104
2019,2,21900125,11/8/2019,1610612751,Brooklyn Nets,0,1,1610612757,Portland Trail Blazers,1,0,25,37,62,16,21,37,41,58,99,21,9,30,23,40,18,3,9,98,119
2019,2,21900125,11/8/2019,1610612757,Portland Trail Blazers,1,0,1610612751,Brooklyn Nets,0,1,29,38,67,11,19,30,40,57,97,24,1,25,20,37,11,6,11,100,115
2016,2,21600766,2/5/2017,1610612746,LA Clippers,0,0,1610612738,Boston Celtics,1,1,25,30,55,10,19,29,35,49,84,22,6,28,13,38,22,9,13,98,102
2016,2,21600281,12/1/2016,1610612744,Golden State Warriors,1,0,1610612745,Houston Rockets,0,1,31,29,60,12,32,44,43,61,104,29,8,37,19,46,31,11,17,122,127
2016,2,21600281,12/1/2016,1610612745,Houston Rockets,0,1,1610612744,Golden State Warriors,1,0,34,30,64,14,30,44,48,60,108,22,8,30,20,43,26,12,21,120,132
2018,2,21800947,3/3/2019,1610612746,LA Clippers,1,1,1610612752,New York Knicks,0,0,29,34,63,19,16,35,48,50,98,13,4,17,15,37,33,9,17,107,128
2018,2,21800947,3/3/2019,1610612752,New York Knicks,0,0,1610612746,LA Clippers,1,1,24,35,59,11,18,29,35,53,88,26,8,34,9,46,23,5,13,107,107
2018,2,21800831,2/9/2019,1610612740,New Orleans Pelicans,0,0,1610612763,Memphis Grizzlies,1,1,28,25,53,6,27,33,34,52,86,16,11,27,21,37,25,6,15,92,90
2018,2,21800831,2/9/2019,1610612763,Memphis Grizzlies,1,1,1610612740,New Orleans Pelicans,0,0,30,29,59,8,21,29,38,50,88,15,3,18,16,35,27,6,12,92,99
2018,2,21800659,1/16/2019,1610612745,Houston Rockets,1,0,1610612751,Brooklyn Nets,0,1,22,13,35,23,47,70,45,60,105,29,5,34,17,46,18,4,10,114,142
2018,2,21800659,1/16/2019,1610612751,Brooklyn Nets,0,1,1610612745,Houston Rockets,1,0,40,32,72,16,20,36,56,52,108,17,5,22,18,38,29,7,14,113,145
2023,2,22300232,11/22/2023,1610612750,Minnesota Timberwolves,1,1,1610612755,Philadelphia 76ers,0,0,33,30,63,10,16,26,43,46,89,16,8,24,16,36,28,9,13,97,112
2021,2,22100359,12/6/2021,1610612737,Atlanta Hawks,0,1,1610612750,Minnesota Timberwolves,1,0,15,26,41,25,24,49,40,50,90,16,3,19,15,36,31,9,12,97,121
2021,2,22100359,12/6/2021,1610612750,Minnesota Timberwolves,1,0,1610612737,Atlanta Hawks,0,1,22,36,58,17,23,40,39,59,98,15,4,19,19,41,22,5,8,97,110
2023,2,22300058,11/28/2023,1610612750,Minnesota Timberwolves,1,1,1610612760,Oklahoma City Thunder,0,0,19,26,45,14,19,33,33,45,78,26,6,32,16,32,18,8,20,98,106
2023,2,22300491,1/5/2024,1610612763,Memphis Grizzlies,0,1,1610612747,Los Angeles Lakers,1,0,21,16,37,23,22,45,44,38,82,16,4,20,9,31,33,12,19,101,127
2020,2,22000162,1/12/2021,1610612759,San Antonio Spurs,0,1,1610612760,Oklahoma City Thunder,1,0,31,29,60,10,25,35,41,54,95,20,2,22,10,45,26,1,4,101,112
2020,2,22000162,1/12/2021,1610612760,Oklahoma City Thunder,1,0,1610612759,San Antonio Spurs,0,1,29,28,57,7,19,26,36,47,83,23,6,29,10,40,18,8,13,101,102
2023,2,22300883,3/4/2024,1610612741,Chicago Bulls,0,1,1610612758,Sacramento Kings,1,0,31,21,52,11,21,32,42,42,84,18,4,22,12,33,28,6,10,93,113
2017,2,21700153,11/7/2017,1610612741,Chicago Bulls,0,0,1610612761,Toronto Raptors,1,1,29,22,51,11,18,29,40,40,80,23,5,28,11,32,26,5,15,97,114
2017,2,21700153,11/7/2017,1610612761,Toronto Raptors,1,1,1610612741,Chicago Bulls,0,0,31,25,56,13,12,25,44,37,81,18,6,24,10,31,22,10,16,97,119
2020,2,22000994,5/5/2021,1610612745,Houston Rockets,1,0,1610612755,Philadelphia 76ers,0,1,25,23,48,17,28,45,42,51,93,14,4,18,14,38,28,10,13,100,115
2020,2,22000994,5/5/2021,1610612755,Philadelphia 76ers,0,1,1610612745,Houston Rockets,1,0,35,24,59,15,20,35,50,44,94,20,2,22,15,29,26,6,10,101,135
2023,2,22300146,11/6/2023,1610612754,Indiana Pacers,1,1,1610612759,San Antonio Spurs,0,0,35,22,57,20,18,38,55,40,95,22,1,23,15,25,38,7,15,106,152
2020,2,22000161,1/12/2021,1610612745,Houston Rockets,1,0,1610612747,Los Angeles Lakers,0,1,26,31,57,12,28,40,38,59,97,12,4,16,15,46,23,10,15,103,100
2020,2,22000161,1/12/2021,1610612747,Los Angeles Lakers,0,1,1610612745,Houston Rockets,1,0,28,24,52,14,18,32,42,42,84,19,8,27,15,33,26,14,21,102,117
2019,2,21900362,12/11/2019,1610612750,Minnesota Timberwolves,1,0,1610612762,Utah Jazz,0,1,25,25,50,15,26,41,40,51,91,21,5,26,17,36,18,4,12,98,116
2019,2,21900362,12/11/2019,1610612762,Utah Jazz,0,1,1610612750,Minnesota Timberwolves,1,0,31,17,48,16,19,35,47,36,83,17,5,22,11,28,23,9,16,98,127
2014,2,21400415,12/22/2014,1610612744,Golden State Warriors,1,1,1610612758,Sacramento Kings,0,0,40,26,66,9,16,25,49,42,91,21,3,24,12,32,36,5,12,101,128
2014,2,21400415,12/22/2014,1610612758,Sacramento Kings,0,0,1610612744,Golden State Warriors,1,1,35,38,73,8,9,17,43,47,90,14,7,21,12,37,31,9,13,102,108
2017,2,21700152,11/7/2017,1610612752,New York Knicks,1,1,1610612766,Charlotte Hornets,0,0,33,17,50,12,13,25,45,30,75,16,5,21,9,24,29,8,16,93,118
2017,2,21700152,11/7/2017,1610612766,Charlotte Hornets,0,0,1610612752,New York Knicks,1,1,27,27,54,15,22,37,42,49,91,14,3,17,20,30,24,5,13,92,113
2021,2,22100358,12/6/2021,1610612739,Cleveland Cavaliers,0,0,1610612749,Milwaukee Bucks,1,1,20,24,44,15,31,46,35,55,90,19,1,20,9,46,27,7,10,100,104
2021,2,22100358,12/6/2021,1610612749,Milwaukee Bucks,1,1,1610612739,Cleveland Cavaliers,0,0,27,27,54,13,19,32,40,46,86,19,5,24,13,34,21,8,17,101,112
2020,2,22000160,5/7/2021,1610612738,Boston Celtics,0,0,1610612741,Chicago Bulls,1,1,24,23,47,11,28,39,35,51,86,18,5,23,15,39,19,10,14,97,99
2020,2,22000160,5/7/2021,1610612741,Chicago Bulls,1,1,1610612738,Boston Celtics,0,0,25,34,59,18,22,40,43,56,99,17,1,18,18,39,26,5,9,98,121
2016,2,21600765,2/5/2017,1610612751,Brooklyn Nets,1,0,1610612761,Toronto Raptors,0,1,19,23,42,13,21,34,32,44,76,18,3,21,9,37,19,8,22,100,95
2020,2,22000993,5/5/2021,1610612754,Indiana Pacers,1,0,1610612758,Sacramento Kings,0,1,27,31,58,9,16,25,36,47,83,12,5,17,13,38,26,16,22,100,93
2020,2,22000993,5/5/2021,1610612758,Sacramento Kings,0,1,1610612754,Indiana Pacers,1,0,35,28,63,8,24,32,43,52,95,10,4,14,15,39,21,8,12,101,104
2016,2,21600765,2/5/2017,1610612761,Toronto Raptors,0,1,1610612751,Brooklyn Nets,1,0,35,33,68,5,14,19,40,47,87,18,2,20,11,37,21,8,12,99,103
2020,2,22000159,1/12/2021,1610612739,Cleveland Cavaliers,1,0,1610612762,Utah Jazz,0,1,27,32,59,8,23,31,35,55,90,9,5,14,15,41,23,8,14,96,87
2020,2,22000159,1/12/2021,1610612762,Utah Jazz,0,1,1610612739,Cleveland Cavaliers,1,0,18,21,39,24,21,45,42,42,84,9,3,12,14,30,26,7,18,95,117
2017,2,21700151,11/7/2017,1610612742,Dallas Mavericks,0,1,1610612764,Washington Wizards,1,0,32,29,61,11,19,30,43,48,91,16,4,20,13,37,26,5,12,100,113
2021,2,22100357,12/6/2021,1610612741,Chicago Bulls,1,1,1610612743,Denver Nuggets,0,0,28,28,56,13,22,35,41,50,91,14,6,20,14,40,25,5,11,96,109
2021,2,22100357,12/6/2021,1610612743,Denver Nuggets,0,0,1610612741,Chicago Bulls,1,1,27,37,64,11,21,32,38,58,96,10,5,15,17,44,30,4,11,97,97
2017,2,21700151,11/7/2017,1610612764,Washington Wizards,1,0,1610612742,Dallas Mavericks,0,1,22,28,50,10,15,25,32,43,75,25,7,32,4,42,21,6,15,100,99
2014,2,21401002,3/17/2015,1610612745,Houston Rockets,1,1,1610612753,Orlando Magic,0,0,28,23,51,11,16,27,39,39,78,18,9,27,14,30,27,8,16,93,107
2014,2,21401002,3/17/2015,1610612753,Orlando Magic,0,0,1610612745,Houston Rockets,1,1,32,35,67,6,16,22,38,51,89,12,5,17,16,38,19,7,10,91,94
2023,2,22300266,11/30/2023,1610612766,Charlotte Hornets,0,1,1610612751,Brooklyn Nets,1,0,25,30,55,21,15,36,46,45,91,16,0,16,15,30,30,6,9,94,129
2021,2,22100356,12/6/2021,1610612748,Miami Heat,1,0,1610612763,Memphis Grizzlies,0,1,29,25,54,6,16,22,35,41,76,14,3,17,11,32,26,11,23,97,90
2021,2,22100356,12/6/2021,1610612763,Memphis Grizzlies,0,1,1610612748,Miami Heat,1,0,25,31,56,13,20,33,38,51,89,16,5,21,19,33,26,11,19,98,105
2017,2,21700150,11/7/2017,1610612740,New Orleans Pelicans,0,1,1610612754,Indiana Pacers,1,0,30,22,52,14,21,35,44,43,87,15,7,22,15,32,23,4,13,97,117
2017,2,21700150,11/7/2017,1610612754,Indiana Pacers,1,0,1610612740,New Orleans Pelicans,0,1,35,34,69,9,15,24,44,49,93,15,3,18,16,35,19,6,11,97,112
2019,2,21900361,12/11/2019,1610612737,Atlanta Hawks,0,0,1610612741,Chicago Bulls,1,1,22,23,45,13,25,38,35,48,83,19,7,26,12,39,26,15,23,106,102
2019,2,21900361,12/11/2019,1610612741,Chicago Bulls,1,1,1610612737,Atlanta Hawks,0,0,43,27,70,11,13,24,54,40,94,17,2,19,8,34,32,7,13,106,136
2019,2,21900124,11/8/2019,1610612749,Milwaukee Bucks,0,0,1610612762,Utah Jazz,1,1,24,35,59,10,26,36,34,61,95,22,8,30,17,48,14,3,13,105,100
2019,2,21900124,11/8/2019,1610612762,Utah Jazz,1,1,1610612749,Milwaukee Bucks,0,0,19,29,48,15,21,36,34,50,84,20,9,29,12,41,15,8,20,106,103
2022,2,22201153,3/31/2023,1610612751,Brooklyn Nets,1,1,1610612737,Atlanta Hawks,0,0,34,21,55,15,18,33,49,39,88,11,2,13,10,30,33,6,13,94,124
2023,2,22300465,1/3/2024,1610612764,Washington Wizards,0,0,1610612739,Cleveland Cavaliers,1,1,30,36,66,12,23,35,42,59,101,5,6,11,18,45,22,5,8,95,101
2014,2,21400414,12/22/2014,1610612746,LA Clippers,0,0,1610612759,San Antonio Spurs,1,1,33,29,62,10,14,24,43,43,86,22,7,29,13,32,23,6,10,93,118
2014,2,21400414,12/22/2014,1610612759,San Antonio Spurs,1,1,1610612746,LA Clippers,0,0,36,18,54,13,10,23,49,28,77,14,8,22,3,28,37,10,11,94,125
2023,2,22300787,2/14/2024,1610612765,Detroit Pistons,0,0,1610612756,Phoenix Suns,1,1,28,34,62,10,27,37,38,61,99,14,8,22,17,48,26,15,19,109,100
2017,2,21700149,11/7/2017,1610612739,Cleveland Cavaliers,1,1,1610612749,Milwaukee Bucks,0,0,32,32,64,9,9,18,41,41,82,33,5,38,16,29,18,6,14,97,124
2017,2,21700149,11/7/2017,1610612749,Milwaukee Bucks,0,0,1610612739,Cleveland Cavaliers,1,1,34,19,53,13,17,30,47,36,83,12,4,16,10,29,29,7,15,97,119
2021,2,22100355,12/6/2021,1610612754,Indiana Pacers,1,1,1610612764,Washington Wizards,0,0,34,25,59,9,14,23,43,39,82,21,1,22,18,21,25,11,16,89,116
2021,2,22100355,12/6/2021,1610612764,Washington Wizards,0,0,1610612754,Indiana Pacers,1,1,36,30,66,7,8,15,43,38,81,17,4,21,12,28,25,10,12,90,110
2020,2,22000158,1/12/2021,1610612743,Denver Nuggets,0,0,1610612751,Brooklyn Nets,1,1,26,25,51,18,19,37,44,44,88,10,6,16,12,35,28,6,13,96,116
2020,2,22000158,1/12/2021,1610612751,Brooklyn Nets,1,1,1610612743,Denver Nuggets,0,0,32,15,47,16,16,32,48,31,79,10,5,15,10,25,31,12,19,96,122
2020,2,22000992,5/5/2021,1610612737,Atlanta Hawks,1,1,1610612756,Phoenix Suns,0,0,40,18,58,13,13,26,53,31,84,16,2,18,11,21,35,9,11,93,135
2020,2,22000992,5/5/2021,1610612756,Phoenix Suns,0,0,1610612737,Atlanta Hawks,1,1,21,26,47,12,20,32,33,46,79,25,4,29,11,37,19,8,10,93,103
2016,2,21600280,12/1/2016,1610612748,Miami Heat,0,1,1610612762,Utah Jazz,1,0,36,31,67,8,11,19,44,42,86,15,4,19,15,28,16,5,6,86,111
2016,2,21600280,12/1/2016,1610612762,Utah Jazz,1,0,1610612748,Miami Heat,0,1,23,20,43,17,13,30,40,33,73,13,4,17,7,28,24,7,11,86,110
2018,2,21801085,3/22/2019,1610612748,Miami Heat,0,0,1610612749,Milwaukee Bucks,1,1,21,27,48,11,26,37,32,53,85,12,11,23,15,44,20,5,13,94,87
2018,2,21801085,3/22/2019,1610612749,Milwaukee Bucks,1,1,1610612748,Miami Heat,0,0,26,25,51,17,17,34,43,42,85,13,7,20,15,31,33,7,16,94,116
2018,2,21800738,1/27/2019,1610612749,Milwaukee Bucks,0,0,1610612760,Oklahoma City Thunder,1,1,24,30,54,15,22,37,39,52,91,19,9,28,13,45,22,5,14,105,112
2018,2,21800738,1/27/2019,1610612760,Oklahoma City Thunder,1,1,1610612749,Milwaukee Bucks,0,0,28,34,62,16,16,32,44,50,94,14,11,25,14,41,29,6,12,104,118
2023,2,22300024,11/14/2023,1610612746,LA Clippers,0,0,1610612743,Denver Nuggets,1,1,24,33,57,13,16,29,37,49,86,21,3,24,16,34,21,4,11,94,108
2021,2,22100354,12/6/2021,1610612760,Oklahoma City Thunder,0,1,1610612765,Detroit Pistons,1,0,32,25,57,9,16,25,41,41,82,23,7,30,8,37,22,8,11,99,114
2021,2,22100354,12/6/2021,1610612765,Detroit Pistons,1,0,1610612760,Oklahoma City Thunder,0,1,25,33,58,16,25,41,41,58,99,5,1,6,20,38,21,10,17,99,103
2017,2,21700148,11/6/2017,1610612744,Golden State Warriors,1,1,1610612748,Miami Heat,0,0,21,34,55,11,21,32,32,55,87,22,2,24,15,40,20,10,15,100,97
2017,2,21700148,11/6/2017,1610612748,Miami Heat,0,0,1610612744,Golden State Warriors,1,1,22,35,57,8,18,26,30,53,83,12,5,17,14,42,19,12,23,101,80
2022,2,22201152,3/31/2023,1610612738,Boston Celtics,1,1,1610612762,Utah Jazz,0,0,25,20,45,17,34,51,42,54,96,21,1,22,14,41,27,3,12,104,122
2016,2,21600763,2/4/2017,1610612750,Minnesota Timberwolves,1,0,1610612763,Memphis Grizzlies,0,1,25,33,58,10,16,26,35,49,84,19,5,24,18,33,22,7,13,88,99
2016,2,21600763,2/4/2017,1610612763,Memphis Grizzlies,0,1,1610612750,Minnesota Timberwolves,1,0,22,27,49,10,18,28,32,45,77,33,6,39,17,31,17,4,10,89,107
2023,2,22300147,11/6/2023,1610612753,Orlando Magic,1,0,1610612742,Dallas Mavericks,0,1,32,26,58,8,19,27,40,45,85,14,4,18,15,30,27,9,21,99,102
2014,2,21400413,12/22/2014,1610612737,Atlanta Hawks,0,1,1610612742,Dallas Mavericks,1,0,33,29,62,7,12,19,40,41,81,18,9,27,9,35,26,12,17,101,105
2014,2,21400413,12/22/2014,1610612742,Dallas Mavericks,1,0,1610612737,Atlanta Hawks,0,1,28,34,62,11,17,28,39,51,90,13,7,20,15,39,23,6,15,102,102
2021,2,22100353,12/6/2021,1610612755,Philadelphia 76ers,0,1,1610612766,Charlotte Hornets,1,0,31,20,51,15,21,36,46,41,87,20,7,27,13,32,28,6,15,102,127
2021,2,22100353,12/6/2021,1610612766,Charlotte Hornets,1,0,1610612755,Philadelphia 76ers,0,1,32,29,61,16,30,46,48,59,107,12,5,17,18,44,31,6,8,103,124
2020,2,22000157,1/12/2021,1610612748,Miami Heat,0,0,1610612755,Philadelphia 76ers,1,1,29,19,48,19,37,56,48,56,104,19,5,24,18,40,27,10,18,116,134
2020,2,22000157,1/12/2021,1610612755,Philadelphia 76ers,1,1,1610612748,Miami Heat,0,0,31,16,47,19,36,55,50,52,102,18,7,25,18,36,32,6,19,115,137
2019,2,21900360,12/11/2019,1610612751,Brooklyn Nets,1,0,1610612766,Charlotte Hornets,0,1,28,22,50,10,28,38,38,50,88,22,11,33,21,32,20,2,12,95,108
2019,2,21900360,12/11/2019,1610612766,Charlotte Hornets,0,1,1610612751,Brooklyn Nets,1,0,21,32,53,15,20,35,36,52,88,26,6,32,18,37,20,5,8,94,113
2016,2,21600764,2/4/2017,1610612744,Golden State Warriors,0,0,1610612758,Sacramento Kings,1,1,21,22,43,15,29,44,36,51,87,19,5,24,13,39,22,11,18,108,106
2016,2,21600764,2/4/2017,1610612758,Sacramento Kings,1,1,1610612744,Golden State Warriors,0,0,36,29,65,7,16,23,43,45,88,16,3,19,10,35,25,10,19,106,109
2016,2,21600279,12/1/2016,1610612739,Cleveland Cavaliers,1,0,1610612746,LA Clippers,0,1,19,26,45,9,15,24,28,41,69,29,10,39,12,35,12,7,18,94,94
2014,2,21401001,3/17/2015,1610612752,New York Knicks,1,1,1610612759,San Antonio Spurs,0,0,38,39,77,3,11,14,41,50,91,19,8,27,18,36,22,7,13,99,104
2014,2,21401001,3/17/2015,1610612759,San Antonio Spurs,0,0,1610612752,New York Knicks,1,1,33,47,80,3,11,14,36,58,94,25,5,30,22,37,17,7,12,100,100
2021,2,22100352,12/5/2021,1610612740,New Orleans Pelicans,0,0,1610612745,Houston Rockets,1,1,30,26,56,10,28,38,40,54,94,18,7,25,24,33,19,3,8,90,108
2021,2,22100352,12/5/2021,1610612745,Houston Rockets,1,1,1610612740,New Orleans Pelicans,0,0,22,17,39,17,23,40,39,40,79,23,6,29,16,29,24,9,14,91,118
2020,2,22000156,1/11/2021,1610612754,Indiana Pacers,0,0,1610612758,Sacramento Kings,1,1,34,24,58,13,26,39,47,50,97,15,3,18,13,38,26,6,13,104,122
2020,2,22000156,1/11/2021,1610612758,Sacramento Kings,1,1,1610612754,Indiana Pacers,0,0,32,20,52,15,17,32,47,37,84,18,5,23,10,28,29,14,19,104,127
2017,2,21700147,11/6/2017,1610612751,Brooklyn Nets,0,1,1610612756,Phoenix Suns,1,0,27,28,55,8,24,32,35,52,87,20,9,29,15,41,20,8,16,103,98
2017,2,21700147,11/6/2017,1610612756,Phoenix Suns,1,0,1610612751,Brooklyn Nets,0,1,24,37,61,6,19,25,30,56,86,26,9,35,18,41,13,10,17,104,92
2019,2,21900123,11/8/2019,1610612743,Denver Nuggets,1,1,1610612755,Philadelphia 76ers,0,0,30,35,65,9,13,22,39,48,87,13,4,17,9,41,28,8,10,96,100
2019,2,21900123,11/8/2019,1610612755,Philadelphia 76ers,0,0,1610612743,Denver Nuggets,1,1,25,35,60,13,13,26,38,48,86,8,9,17,15,37,28,10,18,96,97
2020,2,22000991,5/5/2021,1610612739,Cleveland Cavaliers,1,0,1610612757,Portland Trail Blazers,0,1,24,30,54,13,25,38,37,55,92,18,8,26,14,46,23,7,9,99,105
2020,2,22000991,5/5/2021,1610612757,Portland Trail Blazers,0,1,1610612739,Cleveland Cavaliers,1,0,37,22,59,16,17,33,53,39,92,19,6,25,14,30,26,9,10,100,141
2020,2,22000155,1/11/2021,1610612757,Portland Trail Blazers,1,1,1610612761,Toronto Raptors,0,0,24,17,41,14,28,42,38,45,83,22,3,25,10,38,18,6,13,96,112
2017,2,21700146,11/6/2017,1610612737,Atlanta Hawks,1,0,1610612738,Boston Celtics,0,1,26,29,55,13,13,26,39,42,81,16,4,20,9,36,24,3,14,96,107
2020,2,22000155,1/11/2021,1610612761,Toronto Raptors,0,0,1610612757,Portland Trail Blazers,1,1,21,21,42,19,28,47,40,49,89,12,0,12,14,35,27,9,15,98,111
2017,2,21700146,11/6/2017,1610612738,Boston Celtics,0,1,1610612737,Atlanta Hawks,1,0,25,20,45,14,22,36,39,42,81,18,4,22,12,32,28,8,14,96,110
2016,2,21600279,12/1/2016,1610612746,LA Clippers,0,1,1610612739,Cleveland Cavaliers,1,0,29,29,58,13,18,31,42,47,89,16,8,24,19,32,33,5,12,96,113
2014,2,21400412,12/22/2014,1610612762,Utah Jazz,0,1,1610612763,Memphis Grizzlies,1,0,25,31,56,9,10,19,34,41,75,20,7,27,13,31,20,4,12,88,97
2014,2,21400412,12/22/2014,1610612763,Memphis Grizzlies,1,0,1610612762,Utah Jazz,0,1,31,32,63,7,16,23,38,48,86,8,1,9,7,42,22,0,4,88,91
2020,2,22000990,5/5/2021,1610612738,Boston Celtics,0,1,1610612753,Orlando Magic,1,0,30,21,51,21,24,45,51,45,96,9,3,12,10,36,28,7,11,103,132
2020,2,22000990,5/5/2021,1610612753,Orlando Magic,1,0,1610612738,Boston Celtics,0,1,27,33,60,6,19,25,33,52,85,24,4,28,15,38,13,8,19,103,96
2018,2,21800945,3/3/2019,1610612738,Boston Celtics,1,0,1610612745,Houston Rockets,0,1,29,20,49,8,20,28,37,40,77,22,7,29,10,34,23,8,13,94,104
2018,2,21800945,3/3/2019,1610612745,Houston Rockets,0,1,1610612738,Boston Celtics,1,0,17,12,29,21,30,51,38,42,80,18,11,29,12,37,22,7,12,95,115
2018,2,21800830,2/9/2019,1610612741,Chicago Bulls,1,0,1610612764,Washington Wizards,0,1,43,31,74,6,17,23,49,48,97,21,7,28,16,36,28,6,11,105,125
2018,2,21800830,2/9/2019,1610612764,Washington Wizards,0,1,1610612741,Chicago Bulls,1,0,43,25,68,12,15,27,55,40,95,12,2,14,9,33,38,7,13,104,134
2021,2,22100351,12/5/2021,1610612761,Toronto Raptors,1,1,1610612764,Washington Wizards,0,0,30,32,62,8,15,23,38,47,85,18,6,24,13,37,22,4,8,91,102
2021,2,22100351,12/5/2021,1610612764,Washington Wizards,0,0,1610612761,Toronto Raptors,1,1,22,26,48,8,17,25,30,43,73,22,7,29,7,38,20,3,10,91,90
2020,2,22000154,5/12/2021,1610612740,New Orleans Pelicans,0,0,1610612742,Dallas Mavericks,1,1,29,30,59,7,21,28,36,51,87,28,10,38,15,40,18,4,13,102,107
2020,2,22000154,5/12/2021,1610612742,Dallas Mavericks,1,1,1610612740,New Orleans Pelicans,0,0,32,19,51,15,30,45,47,49,96,16,4,20,13,37,23,5,8,102,125
2017,2,21700145,11/5/2017,1610612747,Los Angeles Lakers,1,1,1610612763,Memphis Grizzlies,0,0,31,27,58,9,18,27,40,45,85,18,5,23,14,35,25,6,19,98,107
2017,2,21700145,11/5/2017,1610612763,Memphis Grizzlies,0,0,1610612747,Los Angeles Lakers,1,1,29,21,50,11,26,37,40,47,87,11,3,14,8,40,23,5,12,98,102
2016,2,21600762,2/4/2017,1610612743,Denver Nuggets,0,0,1610612759,San Antonio Spurs,1,1,31,35,66,10,16,26,41,51,92,5,5,10,20,33,22,13,22,99,97
2016,2,21600762,2/4/2017,1610612759,San Antonio Spurs,1,1,1610612743,Denver Nuggets,0,0,35,23,58,10,11,21,45,34,79,21,5,26,7,29,29,7,14,100,121
2022,2,22201225,4/9/2023,1610612740,New Orleans Pelicans,0,0,1610612750,Minnesota Timberwolves,1,1,37,32,69,3,18,21,40,50,90,25,4,29,16,36,18,7,15,101,108
2023,2,22300156,11/6/2023,1610612743,Denver Nuggets,1,1,1610612740,New Orleans Pelicans,0,0,36,20,56,15,24,39,51,44,95,17,6,23,14,32,37,6,10,101,134
2017,2,21700144,11/5/2017,1610612757,Portland Trail Blazers,1,1,1610612760,Oklahoma City Thunder,0,0,30,24,54,7,13,20,37,37,74,22,6,28,9,29,20,11,23,100,103
2017,2,21700144,11/5/2017,1610612760,Oklahoma City Thunder,0,0,1610612757,Portland Trail Blazers,1,1,29,27,56,11,22,33,40,49,89,8,7,15,10,42,17,6,11,102,99
2014,2,21401000,3/17/2015,1610612763,Memphis Grizzlies,0,0,1610612765,Detroit Pistons,1,1,25,37,62,10,8,18,35,45,80,15,2,17,17,29,28,5,18,89,95
2014,2,21401000,3/17/2015,1610612765,Detroit Pistons,1,1,1610612763,Memphis Grizzlies,0,0,27,23,50,12,21,33,39,44,83,15,7,22,12,34,26,9,9,91,105
2019,2,21900359,12/11/2019,1610612746,LA Clippers,0,1,1610612761,Toronto Raptors,1,0,26,20,46,12,28,40,38,48,86,24,3,27,17,33,29,10,18,100,112
2019,2,21900359,12/11/2019,1610612761,Toronto Raptors,1,0,1610612746,LA Clippers,0,1,23,29,52,8,28,36,31,57,88,22,3,25,18,41,21,8,18,100,92
2014,2,21400411,12/22/2014,1610612745,Houston Rockets,1,1,1610612757,Portland Trail Blazers,0,0,28,23,51,13,23,36,41,46,87,15,5,20,11,38,22,9,18,103,110
2020,2,22000989,5/4/2021,1610612746,LA Clippers,1,1,1610612761,Toronto Raptors,0,0,24,17,41,15,19,34,39,36,75,12,1,13,6,31,28,10,18,95,105
2020,2,22000989,5/4/2021,1610612761,Toronto Raptors,0,0,1610612746,LA Clippers,1,1,28,24,52,12,23,35,40,47,87,8,5,13,10,38,22,7,12,94,100
2018,2,21801084,3/22/2019,1610612745,Houston Rockets,1,1,1610612759,San Antonio Spurs,0,0,22,27,49,14,23,37,36,50,86,25,7,32,12,43,12,6,10,99,111
2018,2,21801084,3/22/2019,1610612759,San Antonio Spurs,0,0,1610612745,Houston Rockets,1,1,34,32,66,7,17,24,41,49,90,16,1,17,9,40,27,5,11,98,105
2018,2,21800946,3/3/2019,1610612737,Atlanta Hawks,0,1,1610612741,Chicago Bulls,1,0,21,26,47,21,21,42,42,47,89,18,10,28,14,35,30,6,13,103,123
2018,2,21800946,3/3/2019,1610612741,Chicago Bulls,1,0,1610612737,Atlanta Hawks,0,1,39,26,65,8,19,27,47,45,92,16,5,21,13,35,25,10,14,103,118
2018,2,21800737,1/27/2019,1610612745,Houston Rockets,1,1,1610612753,Orlando Magic,0,0,26,18,44,12,24,36,38,42,80,15,6,21,5,40,20,10,13,96,103
2018,2,21800737,1/27/2019,1610612753,Orlando Magic,0,0,1610612745,Houston Rockets,1,1,29,33,62,10,25,35,39,58,97,10,7,17,24,39,23,8,15,95,98
2020,2,22000153,1/11/2021,1610612737,Atlanta Hawks,1,1,1610612755,Philadelphia 76ers,0,0,20,35,55,17,27,44,37,62,99,21,6,27,23,42,20,2,8,98,112
2020,2,22000153,1/11/2021,1610612755,Philadelphia 76ers,0,0,1610612737,Atlanta Hawks,1,1,29,27,56,8,28,36,37,55,92,12,1,13,9,47,20,7,9,99,94
2021,2,22100350,12/5/2021,1610612737,Atlanta Hawks,1,0,1610612766,Charlotte Hornets,0,1,31,25,56,17,20,37,48,45,93,14,4,18,14,33,29,9,11,99,127
2021,2,22100350,12/5/2021,1610612766,Charlotte Hornets,0,1,1610612737,Atlanta Hawks,1,0,29,20,49,17,20,37,46,40,86,21,7,28,7,37,21,4,6,98,130
2019,2,21900358,12/11/2019,1610612747,Los Angeles Lakers,0,1,1610612753,Orlando Magic,1,0,25,31,56,12,19,31,37,50,87,10,9,19,17,38,20,10,14,92,96
2019,2,21900358,12/11/2019,1610612753,Orlando Magic,1,0,1610612747,Los Angeles Lakers,0,1,26,29,55,8,18,26,34,47,81,11,6,17,13,37,20,10,15,93,87
2019,2,21900122,11/8/2019,1610612742,Dallas Mavericks,1,0,1610612752,New York Knicks,0,1,23,23,46,14,30,44,37,53,90,14,3,17,9,45,18,9,13,101,102
2019,2,21900122,11/8/2019,1610612752,New York Knicks,0,1,1610612742,Dallas Mavericks,1,0,23,38,61,14,14,28,37,52,89,18,13,31,15,43,19,4,12,100,106
2022,2,22201222,4/9/2023,1610612745,Houston Rockets,0,1,1610612764,Washington Wizards,1,0,38,31,69,6,15,21,44,46,90,20,8,28,13,39,24,11,15,105,114
2017,2,21700143,11/5/2017,1610612750,Minnesota Timberwolves,1,1,1610612766,Charlotte Hornets,0,0,28,31,59,10,14,24,38,45,83,26,4,30,15,32,20,8,16,97,112
2017,2,21700143,11/5/2017,1610612766,Charlotte Hornets,0,0,1610612750,Minnesota Timberwolves,1,1,28,33,61,9,19,28,37,52,89,11,10,21,13,45,24,4,11,98,94
2016,2,21600278,12/1/2016,1610612753,Orlando Magic,0,0,1610612763,Memphis Grizzlies,1,1,27,23,50,6,18,24,33,41,74,22,9,31,12,32,15,9,18,92,94
2016,2,21600278,12/1/2016,1610612763,Memphis Grizzlies,1,1,1610612753,Orlando Magic,0,0,26,35,61,7,11,18,33,46,79,22,6,28,11,37,18,5,10,92,95
2020,2,22000152,1/11/2021,1610612756,Phoenix Suns,0,0,1610612764,Washington Wizards,1,1,35,25,60,4,23,27,39,48,87,25,5,30,12,40,21,3,6,96,107
2020,2,22000152,1/11/2021,1610612764,Washington Wizards,1,1,1610612756,Phoenix Suns,0,0,33,25,58,15,19,34,48,44,92,17,11,28,17,35,29,3,8,94,128
2017,2,21700142,11/5/2017,1610612752,New York Knicks,1,1,1610612754,Indiana Pacers,0,0,38,27,65,6,17,23,44,44,88,14,5,19,12,34,24,6,12,94,108
2017,2,21700142,11/5/2017,1610612754,Indiana Pacers,0,0,1610612752,New York Knicks,1,1,25,29,54,12,13,25,37,42,79,15,2,17,6,37,24,8,12,93,101
2016,2,21600761,2/4/2017,1610612749,Milwaukee Bucks,0,1,1610612756,Phoenix Suns,1,0,45,20,65,7,10,17,52,30,82,26,9,35,10,29,29,9,16,102,137
2016,2,21600761,2/4/2017,1610612756,Phoenix Suns,1,0,1610612749,Milwaukee Bucks,0,1,27,36,63,11,17,28,38,53,91,25,5,30,19,37,22,9,17,103,112
2020,2,22000988,5/4/2021,1610612758,Sacramento Kings,0,1,1610612760,Oklahoma City Thunder,1,0,27,25,52,12,31,43,39,56,95,13,3,16,15,41,25,5,12,99,103
2020,2,22000988,5/4/2021,1610612760,Oklahoma City Thunder,1,0,1610612758,Sacramento Kings,0,1,24,38,62,11,25,36,35,63,98,18,7,25,22,44,21,6,10,100,99
2014,2,21400411,12/22/2014,1610612757,Portland Trail Blazers,0,0,1610612745,Houston Rockets,1,1,24,25,49,10,17,27,34,42,76,17,1,18,5,37,19,14,23,102,95
2018,2,21800736,1/27/2019,1610612746,LA Clippers,1,1,1610612758,Sacramento Kings,0,0,31,28,59,11,18,29,42,46,88,27,2,29,18,30,35,12,19,102,122
2018,2,21800736,1/27/2019,1610612758,Sacramento Kings,0,0,1610612746,LA Clippers,1,1,29,28,57,8,28,36,37,56,93,26,4,30,18,39,18,6,12,102,108
2018,2,21800580,1/5/2019,1610612749,Milwaukee Bucks,1,0,1610612761,Toronto Raptors,0,1,26,18,44,14,23,37,40,41,81,22,5,27,9,34,29,9,16,101,116
2018,2,21800580,1/5/2019,1610612761,Toronto Raptors,0,1,1610612749,Milwaukee Bucks,1,0,28,23,51,14,17,31,42,40,82,25,6,31,8,35,28,9,11,102,123
2018,2,21800502,12/26/2018,1610612764,Washington Wizards,0,0,1610612765,Detroit Pistons,1,1,29,21,50,9,24,33,38,45,83,10,3,13,7,39,17,8,16,97,95
2018,2,21800502,12/26/2018,1610612765,Detroit Pistons,1,1,1610612764,Washington Wizards,0,0,23,20,43,14,23,37,37,43,80,18,1,19,16,27,25,14,24,96,106
2014,2,21400999,3/16/2015,1610612744,Golden State Warriors,1,1,1610612747,Los Angeles Lakers,0,0,33,24,57,7,20,27,40,44,84,21,2,23,8,36,28,11,15,100,108
2014,2,21400999,3/16/2015,1610612747,Los Angeles Lakers,0,0,1610612744,Golden State Warriors,1,1,31,39,70,8,7,15,39,46,85,19,2,21,15,32,24,16,19,100,105
2021,2,22100349,12/5/2021,1610612739,Cleveland Cavaliers,1,0,1610612762,Utah Jazz,0,1,28,25,53,14,24,38,42,49,91,10,3,13,18,33,20,8,14,93,108
2021,2,22100349,12/5/2021,1610612762,Utah Jazz,0,1,1610612739,Cleveland Cavaliers,1,0,20,22,42,20,28,48,40,50,90,9,1,10,19,32,24,12,17,94,109
2014,2,21400410,12/22/2014,1610612741,Chicago Bulls,1,1,1610612761,Toronto Raptors,0,0,34,28,62,6,6,12,40,34,74,43,4,47,15,20,20,10,16,98,129
2014,2,21400410,12/22/2014,1610612761,Toronto Raptors,0,0,1610612741,Chicago Bulls,1,1,35,35,70,9,21,30,44,56,100,23,9,32,27,32,15,4,8,99,120
2018,2,21800362,12/5/2018,1610612750,Minnesota Timberwolves,1,1,1610612766,Charlotte Hornets,0,0,36,29,65,12,12,24,48,41,89,13,7,20,14,29,34,7,15,98,121
2018,2,21800362,12/5/2018,1610612766,Charlotte Hornets,0,0,1610612750,Minnesota Timberwolves,1,1,28,37,65,12,21,33,40,58,98,12,3,15,15,43,27,6,10,99,104
2021,2,22100348,12/4/2021,1610612746,LA Clippers,0,0,1610612758,Sacramento Kings,1,1,21,34,55,13,21,34,34,55,89,18,9,27,17,42,23,8,18,101,99
2021,2,22100348,12/4/2021,1610612758,Sacramento Kings,1,1,1610612746,LA Clippers,0,0,24,28,52,12,22,34,36,50,86,20,5,25,14,39,19,7,17,100,104
2020,2,22000151,1/11/2021,1610612749,Milwaukee Bucks,0,1,1610612753,Orlando Magic,1,0,33,23,56,13,22,35,46,45,91,16,4,20,16,31,25,5,15,99,121
2020,2,22000151,1/11/2021,1610612753,Orlando Magic,1,0,1610612749,Milwaukee Bucks,0,1,28,32,60,11,20,31,39,52,91,10,3,13,18,35,24,15,19,98,99
2019,2,21900357,12/11/2019,1610612738,Boston Celtics,0,0,1610612754,Indiana Pacers,1,1,29,22,51,14,22,36,43,44,87,17,5,22,12,36,25,11,15,101,117
2019,2,21900357,12/11/2019,1610612754,Indiana Pacers,1,1,1610612738,Boston Celtics,0,0,31,29,60,10,15,25,41,44,85,30,6,36,10,39,27,6,10,101,122
2020,2,22000987,5/4/2021,1610612740,New Orleans Pelicans,1,1,1610612744,Golden State Warriors,0,0,27,40,67,12,18,30,39,58,97,18,4,22,16,43,28,7,12,104,108
2020,2,22000987,5/4/2021,1610612744,Golden State Warriors,0,0,1610612740,New Orleans Pelicans,1,1,19,21,40,20,33,53,39,54,93,5,2,7,12,43,22,10,18,105,103
2017,2,21700141,11/5/2017,1610612756,Phoenix Suns,0,0,1610612759,San Antonio Spurs,1,1,29,29,58,8,15,23,37,44,81,13,9,22,13,35,23,9,18,96,95
2017,2,21700141,11/5/2017,1610612759,San Antonio Spurs,1,1,1610612756,Phoenix Suns,0,0,33,33,66,11,11,22,44,44,88,13,5,18,12,35,21,5,10,95,112
2016,2,21600277,12/1/2016,1610612749,Milwaukee Bucks,0,1,1610612751,Brooklyn Nets,1,0,21,25,46,15,19,34,36,44,80,24,5,29,17,29,23,9,19,98,111
2016,2,21600277,12/1/2016,1610612751,Brooklyn Nets,1,0,1610612749,Milwaukee Bucks,0,1,22,27,49,12,28,40,34,55,89,13,3,16,16,39,20,8,18,98,93
2018,2,21801083,3/22/2019,1610612760,Oklahoma City Thunder,0,1,1610612761,Toronto Raptors,1,0,22,29,51,20,23,43,42,52,94,12,2,14,15,38,30,7,13,96,116
2018,2,21801083,3/22/2019,1610612761,Toronto Raptors,1,0,1610612760,Oklahoma City Thunder,0,1,26,27,53,13,12,25,39,39,78,18,3,21,13,27,20,9,22,96,109
2022,2,22201153,3/31/2023,1610612737,Atlanta Hawks,0,0,1610612751,Brooklyn Nets,1,1,31,23,54,8,29,37,39,52,91,21,2,23,20,34,23,9,11,96,107
2021,2,22100347,12/4/2021,1610612738,Boston Celtics,0,1,1610612757,Portland Trail Blazers,1,0,28,22,50,21,16,37,49,38,87,26,3,29,14,25,26,7,12,97,145
2021,2,22100347,12/4/2021,1610612757,Portland Trail Blazers,1,0,1610612738,Boston Celtics,0,1,34,26,60,8,21,29,42,47,89,25,7,32,14,36,22,5,9,96,117
2020,2,22000150,1/11/2021,1610612739,Cleveland Cavaliers,1,0,1610612763,Memphis Grizzlies,0,1,26,30,56,11,15,26,37,45,82,6,8,14,14,35,20,10,21,96,91
2020,2,22000150,1/11/2021,1610612763,Memphis Grizzlies,0,1,1610612739,Cleveland Cavaliers,1,0,35,23,58,5,15,20,40,38,78,16,5,21,9,32,32,11,15,95,101
2016,2,21600760,2/4/2017,1610612762,Utah Jazz,1,1,1610612766,Charlotte Hornets,0,0,25,23,48,13,20,33,38,43,81,16,8,24,13,35,16,7,14,94,105
2016,2,21600760,2/4/2017,1610612766,Charlotte Hornets,0,0,1610612762,Utah Jazz,1,1,22,27,49,13,20,33,35,47,82,15,3,18,6,42,20,5,10,94,98
2020,2,22000986,5/4/2021,1610612742,Dallas Mavericks,0,1,1610612748,Miami Heat,1,0,24,15,39,22,26,48,46,41,87,13,5,18,12,32,26,9,13,94,127
2020,2,22000986,5/4/2021,1610612748,Miami Heat,1,0,1610612742,Dallas Mavericks,0,1,21,22,43,18,23,41,39,45,84,17,4,21,12,34,30,6,12,95,113
2023,2,22300099,10/29/2023,1610612746,LA Clippers,1,1,1610612759,San Antonio Spurs,0,0,31,18,49,16,26,42,47,44,91,13,8,21,14,32,23,9,16,103,123
2018,2,21801082,3/22/2019,1610612743,Denver Nuggets,0,1,1610612752,New York Knicks,1,0,25,33,58,15,23,38,40,56,96,16,3,19,19,39,24,3,9,94,111
2018,2,21801082,3/22/2019,1610612752,New York Knicks,1,0,1610612743,Denver Nuggets,0,1,25,33,58,9,23,32,34,56,90,16,5,21,12,48,20,5,7,94,93
2023,2,22300268,11/30/2023,1610612765,Detroit Pistons,0,0,1610612752,New York Knicks,1,1,28,18,46,15,20,35,43,38,81,11,6,17,10,31,22,8,20,98,112
2018,2,21800829,2/9/2019,1610612738,Boston Celtics,1,0,1610612746,LA Clippers,0,1,30,36,66,9,17,26,39,53,92,25,6,31,11,44,21,6,12,109,112
2023,2,22300820,2/25/2024,1610612764,Washington Wizards,1,0,1610612739,Cleveland Cavaliers,0,1,28,22,50,12,28,40,40,50,90,13,5,18,8,44,29,6,9,100,105
2018,2,21800829,2/9/2019,1610612746,LA Clippers,0,1,1610612738,Boston Celtics,1,0,28,26,54,12,18,30,40,44,84,31,9,40,9,39,28,9,17,110,123
2018,2,21800581,1/5/2019,1610612759,San Antonio Spurs,1,1,1610612763,Memphis Grizzlies,0,0,29,22,51,7,15,22,36,37,73,29,6,35,6,34,26,12,17,101,108
2021,2,22100346,12/4/2021,1610612744,Golden State Warriors,1,0,1610612759,San Antonio Spurs,0,1,27,24,51,13,26,39,40,50,90,14,7,21,13,39,26,10,13,99,107
2021,2,22100346,12/4/2021,1610612759,San Antonio Spurs,0,1,1610612744,Golden State Warriors,1,0,30,23,53,12,23,35,42,46,88,16,3,19,11,36,24,6,12,97,112
2017,2,21700140,11/5/2017,1610612745,Houston Rockets,1,1,1610612762,Utah Jazz,0,0,25,17,42,23,16,39,48,33,81,18,3,21,8,27,26,7,20,101,137
2017,2,21700140,11/5/2017,1610612762,Utah Jazz,0,0,1610612745,Houston Rockets,1,1,25,29,54,13,21,34,38,50,88,21,3,24,11,39,22,9,13,100,110
2019,2,21900356,12/11/2019,1610612739,Cleveland Cavaliers,1,0,1610612745,Houston Rockets,0,1,33,24,57,13,19,32,46,43,89,5,3,8,16,28,29,10,17,93,110
2019,2,21900356,12/11/2019,1610612745,Houston Rockets,0,1,1610612739,Cleveland Cavaliers,1,0,26,19,45,17,25,42,43,44,87,13,0,13,14,30,18,8,13,94,116
2019,2,21900121,11/8/2019,1610612740,New Orleans Pelicans,1,0,1610612761,Toronto Raptors,0,1,30,28,58,10,31,41,40,59,99,14,7,21,17,45,21,9,18,107,104
2019,2,21900121,11/8/2019,1610612761,Toronto Raptors,0,1,1610612740,New Orleans Pelicans,1,0,22,28,50,19,24,43,41,52,93,21,3,24,13,41,27,7,17,108,122
2016,2,21600276,12/1/2016,1610612742,Dallas Mavericks,0,0,1610612766,Charlotte Hornets,1,1,23,32,55,9,22,31,32,54,86,14,4,18,15,40,18,5,13,94,87
2016,2,21600276,12/1/2016,1610612766,Charlotte Hornets,1,1,1610612742,Dallas Mavericks,0,0,30,26,56,5,13,18,35,39,74,22,9,31,6,36,24,6,10,92,97
2014,2,21400998,3/16/2015,1610612737,Atlanta Hawks,0,1,1610612758,Sacramento Kings,1,0,26,27,53,12,19,31,38,46,84,22,8,30,13,36,25,7,12,96,110
2014,2,21400998,3/16/2015,1610612758,Sacramento Kings,1,0,1610612737,Atlanta Hawks,0,1,31,30,61,7,13,20,38,43,81,20,5,25,16,31,23,11,20,96,103
2014,2,21400409,12/22/2014,1610612743,Denver Nuggets,0,0,1610612766,Charlotte Hornets,1,1,29,35,64,2,16,18,31,51,82,18,6,24,15,38,11,6,13,93,82
2014,2,21400409,12/22/2014,1610612766,Charlotte Hornets,1,1,1610612743,Denver Nuggets,0,0,35,26,61,8,11,19,43,37,80,16,8,24,12,28,23,6,12,93,110
2023,2,22300099,10/29/2023,1610612759,San Antonio Spurs,0,0,1610612746,LA Clippers,1,1,19,28,47,11,22,33,30,50,80,12,4,16,11,42,21,15,25,101,83
2023,2,22300866,3/2/2024,1610612737,Atlanta Hawks,0,0,1610612751,Brooklyn Nets,1,1,26,27,53,11,23,34,37,50,87,17,6,23,16,35,23,6,12,92,102
2018,2,21800581,1/5/2019,1610612763,Memphis Grizzlies,0,0,1610612759,San Antonio Spurs,1,1,20,34,54,11,17,28,31,51,82,15,4,19,11,41,21,10,21,99,88
2018,2,21800431,12/15/2018,1610612738,Boston Celtics,0,0,1610612765,Detroit Pistons,1,1,30,31,61,9,24,33,39,55,94,17,6,23,17,40,19,10,14,105,104
2018,2,21800431,12/15/2018,1610612765,Detroit Pistons,1,1,1610612738,Boston Celtics,0,0,29,21,50,10,20,30,39,41,80,25,10,35,12,33,25,11,20,104,113
2018,2,21800246,11/19/2018,1610612740,New Orleans Pelicans,1,1,1610612759,San Antonio Spurs,0,0,49,27,76,10,16,26,59,43,102,12,2,14,18,26,34,7,11,102,140
2021,2,22100345,12/4/2021,1610612742,Dallas Mavericks,1,0,1610612763,Memphis Grizzlies,0,1,16,33,49,15,28,43,31,61,92,13,6,19,21,44,19,10,15,95,90
2021,2,22100345,12/4/2021,1610612763,Memphis Grizzlies,0,1,1610612742,Dallas Mavericks,1,0,28,22,50,9,17,26,37,39,76,14,10,24,17,29,20,10,23,94,97
2020,2,22000149,1/11/2021,1610612752,New York Knicks,0,0,1610612766,Charlotte Hornets,1,1,25,25,50,9,28,37,34,53,87,11,6,17,22,34,20,8,17,90,88
2020,2,22000149,1/11/2021,1610612766,Charlotte Hornets,1,1,1610612752,New York Knicks,0,0,25,21,46,13,19,32,38,40,78,20,3,23,9,33,28,6,10,91,109
2019,2,21900120,11/8/2019,1610612744,Golden State Warriors,0,0,1610612750,Minnesota Timberwolves,1,1,33,35,68,10,25,35,43,60,103,23,1,24,17,43,18,10,20,119,119
2019,2,21900120,11/8/2019,1610612750,Minnesota Timberwolves,1,1,1610612744,Golden State Warriors,0,0,39,36,75,9,27,36,48,63,111,20,9,29,24,42,20,12,19,118,125
2017,2,21700139,11/5/2017,1610612761,Toronto Raptors,1,0,1610612764,Washington Wizards,0,1,32,24,56,5,19,24,37,43,80,17,10,27,9,39,17,9,13,96,96
2017,2,21700139,11/5/2017,1610612764,Washington Wizards,0,1,1610612761,Toronto Raptors,1,0,29,33,62,11,12,23,40,45,85,16,7,23,17,30,19,7,17,97,107
2016,2,21600759,2/4/2017,1610612739,Cleveland Cavaliers,0,1,1610612752,New York Knicks,1,0,25,19,44,16,24,40,41,43,84,13,5,18,14,31,20,9,17,95,111
2016,2,21600759,2/4/2017,1610612752,New York Knicks,1,0,1610612739,Cleveland Cavaliers,0,1,27,28,55,12,19,31,39,47,86,14,14,28,15,39,23,3,11,95,104
2023,2,22300357,12/18/2023,1610612762,Utah Jazz,1,1,1610612751,Brooklyn Nets,0,0,31,26,57,14,20,34,45,46,91,21,3,24,19,29,30,4,14,100,125
2023,2,22300488,1/5/2024,1610612743,Denver Nuggets,1,0,1610612753,Orlando Magic,0,1,39,23,62,9,24,33,48,47,95,15,4,19,16,31,28,9,13,102,120
2023,2,22300145,11/6/2023,1610612765,Detroit Pistons,1,0,1610612744,Golden State Warriors,0,1,25,25,50,13,17,30,38,42,80,20,1,21,10,32,23,8,16,95,109
2020,2,22000148,1/10/2021,1610612744,Golden State Warriors,1,1,1610612761,Toronto Raptors,0,0,25,22,47,13,33,46,38,55,93,17,2,19,17,40,30,8,15,100,106
2020,2,22000148,1/10/2021,1610612761,Toronto Raptors,0,0,1610612744,Golden State Warriors,1,1,26,32,58,13,25,38,39,57,96,14,8,22,18,42,20,2,12,99,105
2017,2,21700138,11/5/2017,1610612738,Boston Celtics,0,1,1610612753,Orlando Magic,1,0,28,28,56,11,22,33,39,50,89,15,5,20,14,39,26,4,14,99,104
2017,2,21700138,11/5/2017,1610612753,Orlando Magic,1,0,1610612738,Boston Celtics,0,1,27,35,62,6,23,29,33,58,91,16,2,18,13,47,18,10,13,100,88
2020,2,22000985,5/4/2021,1610612749,Milwaukee Bucks,1,1,1610612751,Brooklyn Nets,0,0,30,31,61,14,23,37,44,54,98,22,5,27,20,37,23,6,13,103,124
2020,2,22000985,5/4/2021,1610612751,Brooklyn Nets,0,0,1610612749,Milwaukee Bucks,1,1,21,20,41,20,23,43,41,43,84,16,10,26,8,40,21,7,13,103,118
2014,2,21400408,12/21/2014,1610612740,New Orleans Pelicans,0,1,1610612760,Oklahoma City Thunder,1,0,36,34,70,7,13,20,43,47,90,8,2,10,14,33,33,7,12,91,101
2014,2,21400408,12/21/2014,1610612760,Oklahoma City Thunder,1,0,1610612740,New Orleans Pelicans,0,1,33,30,63,5,15,20,38,45,83,18,6,24,18,31,17,11,16,92,99
2018,2,21800943,3/2/2019,1610612749,Milwaukee Bucks,0,0,1610612762,Utah Jazz,1,1,22,35,57,15,24,39,37,59,96,22,8,30,23,38,20,13,15,105,111
2018,2,21800943,3/2/2019,1610612762,Utah Jazz,1,1,1610612749,Milwaukee Bucks,0,0,32,35,67,12,17,29,44,52,96,15,11,26,18,39,22,6,13,104,115
2018,2,21800656,1/15/2019,1610612741,Chicago Bulls,0,0,1610612747,Los Angeles Lakers,1,1,28,33,61,9,22,31,37,55,92,17,7,24,19,40,21,7,15,101,100
2018,2,21800656,1/15/2019,1610612747,Los Angeles Lakers,1,1,1610612741,Chicago Bulls,0,0,30,26,56,8,18,26,38,44,82,23,11,34,15,34,21,11,17,100,107
2018,2,21800501,12/25/2018,1610612757,Portland Trail Blazers,0,0,1610612762,Utah Jazz,1,1,26,40,66,9,14,23,35,54,89,17,9,26,14,44,20,7,12,99,96
2018,2,21800501,12/25/2018,1610612762,Utah Jazz,1,1,1610612757,Portland Trail Blazers,0,0,33,21,54,13,16,29,46,37,83,12,11,23,12,31,20,7,17,100,117
2018,2,21800430,12/15/2018,1610612747,Los Angeles Lakers,0,1,1610612766,Charlotte Hornets,1,0,35,23,58,14,20,34,49,43,92,16,8,24,13,32,34,3,16,106,128
2018,2,21800430,12/15/2018,1610612766,Charlotte Hornets,1,0,1610612747,Los Angeles Lakers,0,1,32,31,63,7,22,29,39,53,92,15,3,18,12,44,22,12,18,104,100
2020,2,22000147,1/10/2021,1610612750,Minnesota Timberwolves,1,1,1610612759,San Antonio Spurs,0,0,25,30,55,9,17,26,34,47,81,19,4,23,10,39,19,4,14,96,96
2020,2,22000147,1/10/2021,1610612759,San Antonio Spurs,0,0,1610612750,Minnesota Timberwolves,1,1,28,36,64,8,22,30,36,58,94,8,6,14,14,48,21,6,10,96,88
2021,2,22100344,12/4/2021,1610612748,Miami Heat,0,0,1610612749,Milwaukee Bucks,1,1,17,24,41,17,26,43,34,50,84,17,7,24,13,41,29,3,15,97,102
2021,2,22100344,12/4/2021,1610612749,Milwaukee Bucks,1,1,1610612748,Miami Heat,0,0,26,22,48,18,32,50,44,54,98,18,2,20,24,31,32,6,14,97,124
2019,2,21900355,12/10/2019,1610612752,New York Knicks,0,0,1610612757,Portland Trail Blazers,1,1,25,28,53,7,31,38,32,59,91,16,10,26,13,49,16,6,11,100,87
2019,2,21900355,12/10/2019,1610612757,Portland Trail Blazers,1,1,1610612752,New York Knicks,0,0,22,27,49,17,24,41,39,51,90,20,4,24,13,39,20,5,12,101,115
2017,2,21700137,11/5/2017,1610612746,LA Clippers,1,0,1610612748,Miami Heat,0,1,25,31,56,9,22,31,34,53,87,24,6,30,21,33,16,12,16,96,101
2017,2,21700137,11/5/2017,1610612748,Miami Heat,0,1,1610612746,LA Clippers,1,0,23,25,48,14,22,36,37,47,84,16,3,19,13,36,23,11,16,96,104
2014,2,21400407,12/21/2014,1610612750,Minnesota Timberwolves,1,0,1610612754,Indiana Pacers,0,1,31,35,66,5,6,11,36,41,77,19,5,24,11,31,23,9,16,94,96
2014,2,21400407,12/21/2014,1610612754,Indiana Pacers,0,1,1610612750,Minnesota Timberwolves,1,0,36,29,65,6,13,19,42,42,84,10,4,14,9,36,25,8,13,94,100
2023,2,22300820,2/25/2024,1610612739,Cleveland Cavaliers,0,1,1610612764,Washington Wizards,1,0,32,19,51,10,22,32,42,41,83,20,7,27,9,36,35,6,11,99,114
2018,2,21801081,3/22/2019,1610612739,Cleveland Cavaliers,1,0,1610612746,LA Clippers,0,1,31,28,59,12,19,31,43,47,90,10,3,13,13,36,14,6,13,98,108
2018,2,21801081,3/22/2019,1610612746,LA Clippers,0,1,1610612739,Cleveland Cavaliers,1,0,36,20,56,6,20,26,42,40,82,20,3,23,7,35,24,7,12,96,110
2018,2,21800944,3/3/2019,1610612757,Portland Trail Blazers,0,1,1610612766,Charlotte Hornets,1,0,32,32,64,11,21,32,43,53,96,21,2,23,20,34,26,7,11,97,118
2018,2,21800944,3/3/2019,1610612766,Charlotte Hornets,1,0,1610612757,Portland Trail Blazers,0,1,23,27,50,14,19,33,37,46,83,20,3,23,10,37,25,9,12,96,108
2018,2,21800735,1/27/2019,1610612739,Cleveland Cavaliers,0,1,1610612741,Chicago Bulls,1,0,26,32,58,13,21,34,39,53,92,13,2,15,13,42,26,5,8,95,104
2020,2,22000146,1/10/2021,1610612745,Houston Rockets,1,0,1610612747,Los Angeles Lakers,0,1,25,24,49,12,29,41,37,53,90,16,7,23,16,42,22,13,21,104,102
2020,2,22000146,1/10/2021,1610612747,Los Angeles Lakers,0,1,1610612745,Houston Rockets,1,0,36,26,62,10,19,29,46,45,91,18,6,24,13,33,28,7,17,102,120
2019,2,21900354,12/10/2019,1610612737,Atlanta Hawks,0,0,1610612748,Miami Heat,1,1,25,16,41,20,34,54,45,50,95,11,7,18,10,45,30,5,12,106,121
2019,2,21900354,12/10/2019,1610612748,Miami Heat,1,1,1610612737,Atlanta Hawks,0,0,39,23,62,14,27,41,53,50,103,15,7,22,18,35,35,4,12,108,135
2017,2,21700136,11/5/2017,1610612737,Atlanta Hawks,0,1,1610612739,Cleveland Cavaliers,1,0,30,31,61,11,14,25,41,45,86,24,10,34,16,34,24,6,17,102,117
2017,2,21700136,11/5/2017,1610612739,Cleveland Cavaliers,1,0,1610612737,Atlanta Hawks,0,1,32,28,60,10,26,36,42,54,96,21,2,23,19,35,27,4,13,101,115
2022,2,22200608,1/9/2023,1610612759,San Antonio Spurs,0,0,1610612763,Memphis Grizzlies,1,1,33,32,65,11,21,32,44,53,97,14,2,16,14,41,28,9,14,104,113
2016,2,21600758,2/4/2017,1610612748,Miami Heat,1,1,1610612755,Philadelphia 76ers,0,0,36,24,60,12,10,22,48,34,82,17,6,23,10,29,28,10,21,103,125
2016,2,21600758,2/4/2017,1610612755,Philadelphia 76ers,0,0,1610612748,Miami Heat,1,1,29,32,61,6,17,23,35,49,84,26,5,31,8,41,20,6,15,104,102
2022,2,22200608,1/9/2023,1610612763,Memphis Grizzlies,1,1,1610612759,San Antonio Spurs,0,0,34,31,65,11,15,26,45,46,91,20,15,35,17,35,26,8,14,105,121
2016,2,21600275,11/30/2016,1610612754,Indiana Pacers,0,0,1610612757,Portland Trail Blazers,1,1,30,28,58,6,8,14,36,36,72,31,4,35,10,27,19,13,17,95,109
2016,2,21600275,11/30/2016,1610612757,Portland Trail Blazers,1,1,1610612754,Indiana Pacers,0,0,39,23,62,12,20,32,51,43,94,17,2,19,14,30,29,3,7,96,131
2023,2,22300232,11/22/2023,1610612755,Philadelphia 76ers,0,0,1610612750,Minnesota Timberwolves,1,1,27,28,55,7,25,32,34,53,87,24,6,30,20,38,21,10,15,96,99
2014,2,21400997,3/16/2015,1610612762,Utah Jazz,1,1,1610612766,Charlotte Hornets,0,0,18,36,54,15,9,24,33,45,78,13,6,19,17,32,19,5,14,84,94
2014,2,21400997,3/16/2015,1610612766,Charlotte Hornets,0,0,1610612762,Utah Jazz,1,1,18,41,59,5,14,19,23,55,78,15,3,18,8,48,9,3,7,85,66
2014,2,21400406,12/21/2014,1610612756,Phoenix Suns,0,1,1610612764,Washington Wizards,1,0,34,27,61,6,11,17,40,38,78,18,7,25,14,28,13,11,17,91,104
2014,2,21400406,12/21/2014,1610612764,Washington Wizards,1,0,1610612756,Phoenix Suns,0,1,31,38,69,3,11,14,34,49,83,21,8,29,17,34,11,3,13,92,92
2021,2,22100343,12/4/2021,1610612741,Chicago Bulls,0,1,1610612751,Brooklyn Nets,1,0,31,24,55,10,21,31,41,45,86,19,8,27,9,41,22,8,9,98,111
2021,2,22100343,12/4/2021,1610612751,Brooklyn Nets,1,0,1610612741,Chicago Bulls,0,1,38,48,86,8,17,25,46,65,111,7,2,9,25,41,28,4,7,99,107
2023,2,22300391,12/23/2023,1610612754,Indiana Pacers,1,0,1610612753,Orlando Magic,0,1,28,20,48,15,19,34,43,39,82,9,4,13,9,32,27,9,15,94,110
2023,2,22300100,10/29/2023,1610612747,Los Angeles Lakers,0,0,1610612758,Sacramento Kings,1,1,28,25,53,15,30,45,43,55,98,26,8,34,15,43,27,6,12,112,127
2023,2,22300148,11/6/2023,1610612764,Washington Wizards,0,0,1610612755,Philadelphia 76ers,1,1,35,27,62,14,20,34,49,47,96,16,4,20,14,35,31,12,19,111,128
2018,2,21800828,2/9/2019,1610612752,New York Knicks,1,0,1610612761,Toronto Raptors,0,1,29,40,69,10,15,25,39,55,94,11,8,19,20,38,22,8,15,99,99
2018,2,21800828,2/9/2019,1610612761,Toronto Raptors,0,1,1610612752,New York Knicks,1,0,19,32,51,14,21,35,33,53,86,24,5,29,12,45,27,9,12,99,104
2018,2,21800735,1/27/2019,1610612741,Chicago Bulls,1,0,1610612739,Cleveland Cavaliers,0,1,30,32,62,9,17,26,39,49,88,14,3,17,11,40,22,5,10,96,101
2018,2,21800657,1/16/2019,1610612753,Orlando Magic,0,0,1610612765,Detroit Pistons,1,1,33,22,55,14,25,39,47,47,94,7,6,13,14,36,29,4,12,99,115
2018,2,21800657,1/16/2019,1610612765,Detroit Pistons,1,1,1610612753,Orlando Magic,0,0,32,30,62,12,18,30,44,48,92,20,5,25,19,30,26,6,13,100,120
2018,2,21800579,1/5/2019,1610612739,Cleveland Cavaliers,1,0,1610612740,New Orleans Pelicans,0,1,24,31,55,12,21,33,36,52,88,14,4,18,17,36,22,13,20,100,98
2018,2,21800579,1/5/2019,1610612740,New Orleans Pelicans,0,1,1610612739,Cleveland Cavaliers,1,0,33,21,54,14,13,27,47,34,81,25,4,29,10,24,29,12,15,98,133
2020,2,22000145,5/9/2021,1610612738,Boston Celtics,1,0,1610612748,Miami Heat,0,1,31,14,45,14,24,38,45,38,83,20,5,25,10,32,29,8,14,99,124
2020,2,22000145,5/9/2021,1610612748,Miami Heat,0,1,1610612738,Boston Celtics,1,0,31,16,47,16,19,35,47,35,82,20,2,22,5,31,30,7,11,99,130
2021,2,22100342,12/4/2021,1610612743,Denver Nuggets,0,1,1610612752,New York Knicks,1,0,24,17,41,20,23,43,44,40,84,5,0,5,11,29,30,7,13,89,113
2021,2,22100342,12/4/2021,1610612752,New York Knicks,1,0,1610612743,Denver Nuggets,0,1,23,25,48,12,28,40,35,53,88,17,4,21,21,35,23,10,11,88,99
2019,2,21900119,11/8/2019,1610612737,Atlanta Hawks,1,0,1610612758,Sacramento Kings,0,1,37,22,59,9,19,28,46,41,87,8,6,14,16,28,23,7,13,91,109
2019,2,21900119,11/8/2019,1610612758,Sacramento Kings,0,1,1610612737,Atlanta Hawks,1,0,24,21,45,18,13,31,42,34,76,19,3,22,10,25,27,8,15,91,121
2020,2,22000984,5/4/2021,1610612765,Detroit Pistons,1,0,1610612766,Charlotte Hornets,0,1,30,23,53,9,23,32,39,46,85,12,8,20,15,35,21,8,13,92,99
2020,2,22000984,5/4/2021,1610612766,Charlotte Hornets,0,1,1610612765,Detroit Pistons,1,0,30,32,62,8,23,31,38,55,93,18,6,24,20,39,23,3,8,92,102
2017,2,21700135,11/4/2017,1610612743,Denver Nuggets,1,0,1610612744,Golden State Warriors,0,1,34,29,63,6,18,24,40,47,87,22,5,27,13,36,26,13,18,106,108
2017,2,21700135,11/4/2017,1610612744,Golden State Warriors,0,1,1610612743,Denver Nuggets,1,0,32,19,51,18,22,40,50,41,91,9,8,17,8,39,38,9,15,104,127
2016,2,21600274,11/30/2016,1610612737,Atlanta Hawks,0,0,1610612756,Phoenix Suns,1,1,36,28,64,9,16,25,45,44,89,8,2,10,15,30,20,11,22,101,107
2016,2,21600274,11/30/2016,1610612756,Phoenix Suns,1,1,1610612737,Atlanta Hawks,0,0,30,38,68,10,11,21,40,49,89,19,6,25,17,35,15,9,17,101,109
2014,2,21400996,3/16/2015,1610612742,Dallas Mavericks,1,1,1610612760,Oklahoma City Thunder,0,0,32,32,64,10,15,25,42,47,89,25,10,35,9,43,27,8,13,108,119
2014,2,21400996,3/16/2015,1610612760,Oklahoma City Thunder,0,0,1610612742,Dallas Mavericks,1,1,33,31,64,7,19,26,40,50,90,28,7,35,21,32,19,9,21,107,115
2014,2,21400405,12/21/2014,1610612753,Orlando Magic,1,0,1610612755,Philadelphia 76ers,0,1,28,33,61,7,16,23,35,49,84,11,9,20,14,41,21,8,14,94,88
2014,2,21400405,12/21/2014,1610612755,Philadelphia 76ers,0,1,1610612753,Orlando Magic,1,0,29,30,59,6,17,23,35,47,82,20,5,25,18,33,20,11,19,94,96
2023,2,22300100,10/29/2023,1610612758,Sacramento Kings,1,1,1610612747,Los Angeles Lakers,0,0,32,24,56,17,31,48,49,55,104,17,7,24,11,49,30,4,10,112,132
2023,2,22300339,12/16/2023,1610612744,Golden State Warriors,1,1,1610612751,Brooklyn Nets,0,0,27,32,59,17,15,32,44,47,91,19,1,20,16,31,29,6,14,99,124
2023,2,22300436,12/29/2023,1610612766,Charlotte Hornets,0,0,1610612756,Phoenix Suns,1,1,21,25,46,23,23,46,44,48,92,8,0,8,11,37,32,3,6,92,119
2023,2,22300149,11/6/2023,1610612751,Brooklyn Nets,1,0,1610612749,Milwaukee Bucks,0,1,33,23,56,16,29,45,49,52,101,11,2,13,13,39,22,6,8,102,125
2023,2,22300489,1/5/2024,1610612756,Phoenix Suns,1,1,1610612748,Miami Heat,0,0,30,22,52,14,21,35,44,43,87,11,6,17,13,34,30,5,11,94,113
2021,2,22100341,12/3/2021,1610612746,LA Clippers,0,1,1610612747,Los Angeles Lakers,1,0,25,21,46,16,19,35,41,40,81,21,3,24,11,31,28,8,10,93,119
2021,2,22100341,12/3/2021,1610612747,Los Angeles Lakers,1,0,1610612746,LA Clippers,0,1,33,24,57,12,21,33,45,45,90,13,8,21,18,31,28,5,12,93,115
2020,2,22000144,1/10/2021,1610612743,Denver Nuggets,0,1,1610612752,New York Knicks,1,0,30,19,49,15,20,35,45,39,84,9,3,12,11,29,23,4,12,90,114
2020,2,22000144,1/10/2021,1610612752,New York Knicks,1,0,1610612743,Denver Nuggets,0,1,26,27,53,6,15,21,32,42,74,19,6,25,11,35,19,11,16,90,89
2019,2,21900353,12/10/2019,1610612743,Denver Nuggets,0,0,1610612755,Philadelphia 76ers,1,1,30,28,58,7,20,27,37,48,85,11,1,12,9,39,29,9,14,95,92
2019,2,21900353,12/10/2019,1610612755,Philadelphia 76ers,1,1,1610612743,Denver Nuggets,0,0,25,28,53,12,24,36,37,52,89,11,5,16,19,35,24,12,17,96,97
2017,2,21700134,11/4/2017,1610612742,Dallas Mavericks,0,0,1610612750,Minnesota Timberwolves,1,1,30,30,60,10,17,27,40,47,87,9,3,12,9,41,18,7,15,98,99
2017,2,21700134,11/4/2017,1610612750,Minnesota Timberwolves,1,1,1610612742,Dallas Mavericks,0,0,33,22,55,10,14,24,43,36,79,16,4,20,13,24,33,7,19,98,112
2016,2,21600757,2/4/2017,1610612754,Indiana Pacers,1,1,1610612765,Detroit Pistons,0,0,37,30,67,7,17,24,44,47,91,10,5,15,9,39,22,2,6,95,105
2016,2,21600757,2/4/2017,1610612765,Detroit Pistons,0,0,1610612754,Indiana Pacers,1,1,25,33,58,6,11,17,31,44,75,16,4,20,11,36,18,11,21,95,84
2014,2,21400404,12/21/2014,1610612738,Boston Celtics,0,0,1610612748,Miami Heat,1,1,27,33,60,6,17,23,33,50,83,12,3,15,17,35,22,9,15,90,84
2014,2,21400404,12/21/2014,1610612748,Miami Heat,1,1,1610612738,Boston Celtics,0,0,31,26,57,6,15,21,37,41,78,20,6,26,12,31,18,6,11,90,100
2023,2,22300609,1/22/2024,1610612761,Toronto Raptors,1,0,1610612763,Memphis Grizzlies,0,1,27,29,56,8,15,23,35,44,79,22,1,23,14,30,31,11,18,94,100
2023,2,22300409,12/26/2023,1610612754,Indiana Pacers,0,1,1610612745,Houston Rockets,1,0,24,15,39,19,24,43,43,39,82,18,3,21,10,30,28,15,20,100,123
2018,2,21800827,2/9/2019,1610612737,Atlanta Hawks,1,0,1610612766,Charlotte Hornets,0,1,32,21,53,14,19,33,46,40,86,14,5,19,15,29,26,12,18,98,120
2018,2,21800827,2/9/2019,1610612766,Charlotte Hornets,0,1,1610612737,Atlanta Hawks,1,0,29,17,46,19,23,42,48,40,88,14,4,18,13,29,30,10,14,98,129
2022,2,22201156,3/31/2023,1610612746,LA Clippers,0,0,1610612763,Memphis Grizzlies,1,1,23,32,55,11,24,35,34,56,90,15,3,18,13,44,26,11,18,103,94
2020,2,22000143,1/10/2021,1610612751,Brooklyn Nets,1,0,1610612760,Oklahoma City Thunder,0,1,33,18,51,10,24,34,43,42,85,20,4,24,10,35,23,12,17,102,116
2020,2,22000143,1/10/2021,1610612760,Oklahoma City Thunder,0,1,1610612751,Brooklyn Nets,1,0,34,17,51,15,24,39,49,41,90,16,1,17,4,38,24,3,11,103,129
2021,2,22100340,12/3/2021,1610612744,Golden State Warriors,1,1,1610612756,Phoenix Suns,0,0,26,27,53,19,20,39,45,47,92,9,3,12,15,33,30,9,17,98,118
2021,2,22100340,12/3/2021,1610612756,Phoenix Suns,0,0,1610612744,Golden State Warriors,1,1,23,36,59,8,14,22,31,50,81,26,9,35,13,43,23,10,16,99,96
2017,2,21700133,11/4/2017,1610612740,New Orleans Pelicans,0,1,1610612741,Chicago Bulls,1,0,26,30,56,9,22,31,35,52,87,17,5,22,8,45,23,10,15,105,96
2017,2,21700133,11/4/2017,1610612741,Chicago Bulls,1,0,1610612740,New Orleans Pelicans,0,1,24,33,57,11,31,42,35,64,99,9,3,12,17,49,23,9,19,106,90
2014,2,21400995,3/16/2015,1610612739,Cleveland Cavaliers,0,0,1610612748,Miami Heat,1,1,19,27,46,11,22,33,30,49,79,21,6,27,13,40,17,8,14,95,92
2014,2,21400995,3/16/2015,1610612748,Miami Heat,1,1,1610612739,Cleveland Cavaliers,0,0,38,23,61,4,11,15,42,34,76,18,4,22,9,27,21,8,17,93,106
2014,2,21400403,12/21/2014,1610612751,Brooklyn Nets,1,1,1610612765,Detroit Pistons,0,0,32,24,56,8,12,20,40,36,76,22,7,29,6,33,29,10,15,100,110
2014,2,21400403,12/21/2014,1610612765,Detroit Pistons,0,0,1610612751,Brooklyn Nets,1,1,31,33,64,9,18,27,40,51,91,16,10,26,19,36,26,9,14,99,105
2018,2,21801080,3/22/2019,1610612753,Orlando Magic,1,1,1610612763,Memphis Grizzlies,0,0,30,24,54,14,25,39,44,49,93,21,6,27,11,42,30,5,9,105,123
2018,2,21801080,3/22/2019,1610612763,Memphis Grizzlies,0,0,1610612753,Orlando Magic,1,1,32,23,55,15,23,38,47,46,93,10,11,21,11,40,28,6,13,103,119
2018,2,21800941,3/2/2019,1610612740,New Orleans Pelicans,0,1,1610612743,Denver Nuggets,1,0,33,29,62,12,18,30,45,47,92,18,8,26,17,35,28,13,21,107,120
2018,2,21800941,3/2/2019,1610612743,Denver Nuggets,1,0,1610612740,New Orleans Pelicans,0,1,30,30,60,9,23,32,39,53,92,25,4,29,16,38,25,10,16,109,112
2021,2,22100339,12/3/2021,1610612738,Boston Celtics,0,0,1610612762,Utah Jazz,1,1,33,19,52,14,25,39,47,44,91,22,0,22,9,35,23,3,6,100,130
2021,2,22100339,12/3/2021,1610612762,Utah Jazz,1,1,1610612738,Boston Celtics,0,0,18,12,30,27,24,51,45,36,81,20,3,23,12,26,26,9,20,99,137
2020,2,22000142,1/10/2021,1610612741,Chicago Bulls,0,0,1610612746,LA Clippers,1,1,29,15,44,18,15,33,47,30,77,15,2,17,6,25,30,13,23,101,127
2020,2,22000142,1/10/2021,1610612746,LA Clippers,1,1,1610612741,Chicago Bulls,0,0,25,29,54,20,18,38,45,47,92,20,5,25,13,37,28,6,10,100,130
2017,2,21700132,11/4/2017,1610612758,Sacramento Kings,0,0,1610612765,Detroit Pistons,1,1,30,25,55,10,11,21,40,36,76,9,4,13,6,32,24,10,18,94,99
2023,2,22300704,2/4/2024,1610612765,Detroit Pistons,1,0,1610612753,Orlando Magic,0,1,28,21,49,8,23,31,36,44,80,19,3,22,11,35,22,7,15,95,99
2017,2,21700132,11/4/2017,1610612765,Detroit Pistons,1,1,1610612758,Sacramento Kings,0,0,27,28,55,13,11,24,40,39,79,15,7,22,12,30,28,6,14,94,108
2019,2,21900118,11/8/2019,1610612739,Cleveland Cavaliers,0,1,1610612764,Washington Wizards,1,0,35,28,63,6,21,27,41,49,90,25,4,29,19,32,18,5,13,97,113
2019,2,21900118,11/8/2019,1610612764,Washington Wizards,1,0,1610612739,Cleveland Cavaliers,0,1,38,27,65,7,24,31,45,51,96,3,3,6,21,32,26,10,19,98,100
2016,2,21600273,11/30/2016,1610612743,Denver Nuggets,1,0,1610612748,Miami Heat,0,1,31,38,69,7,15,22,38,53,91,15,9,24,20,38,28,14,19,100,98
2016,2,21600273,11/30/2016,1610612748,Miami Heat,0,1,1610612743,Denver Nuggets,1,0,32,37,69,9,15,24,41,52,93,15,11,26,13,44,26,3,6,99,106
2017,2,21700131,11/4/2017,1610612746,LA Clippers,1,0,1610612763,Memphis Grizzlies,0,1,34,23,57,4,22,26,38,45,83,24,7,31,18,30,18,8,12,92,104
2017,2,21700131,11/4/2017,1610612763,Memphis Grizzlies,0,1,1610612746,LA Clippers,1,0,27,26,53,13,18,31,40,44,84,20,4,24,17,29,21,7,13,93,113
2016,2,21600756,2/4/2017,1610612737,Atlanta Hawks,1,1,1610612753,Orlando Magic,0,0,31,19,50,10,18,28,41,37,78,21,6,27,13,27,28,8,17,96,113
2016,2,21600756,2/4/2017,1610612753,Orlando Magic,0,0,1610612737,Atlanta Hawks,1,1,20,31,51,7,20,27,27,51,78,25,3,28,10,42,17,8,14,96,86
2021,2,22100338,12/3/2021,1610612740,New Orleans Pelicans,0,1,1610612742,Dallas Mavericks,1,0,25,35,60,12,18,30,37,53,90,21,7,28,16,39,30,4,10,97,107
2021,2,22100338,12/3/2021,1610612742,Dallas Mavericks,1,0,1610612740,New Orleans Pelicans,0,1,22,23,45,10,24,34,32,47,79,17,9,26,10,43,17,5,15,97,91
2019,2,21900352,12/10/2019,1610612764,Washington Wizards,0,0,1610612766,Charlotte Hornets,1,1,27,28,55,11,24,35,38,52,90,20,5,25,15,40,27,4,10,96,107
2019,2,21900352,12/10/2019,1610612766,Charlotte Hornets,1,1,1610612764,Washington Wizards,0,0,22,22,44,16,25,41,38,47,85,22,6,28,16,34,22,7,13,97,114
2014,2,21400402,12/21/2014,1610612747,Los Angeles Lakers,0,0,1610612758,Sacramento Kings,1,1,23,38,61,10,16,26,33,54,87,25,5,30,20,36,14,8,17,98,101
2020,2,22000983,5/4/2021,1610612739,Cleveland Cavaliers,1,0,1610612756,Phoenix Suns,0,1,28,33,61,13,16,29,41,49,90,23,4,27,16,36,29,10,18,105,118
2020,2,22000983,5/4/2021,1610612756,Phoenix Suns,0,1,1610612739,Cleveland Cavaliers,1,0,43,31,74,12,19,31,55,50,105,12,1,13,14,36,35,3,7,105,134
2014,2,21400402,12/21/2014,1610612758,Sacramento Kings,1,1,1610612747,Los Angeles Lakers,0,0,31,25,56,7,16,23,38,41,79,25,11,36,13,33,15,8,14,98,108
2018,2,21800940,3/2/2019,1610612759,San Antonio Spurs,1,1,1610612760,Oklahoma City Thunder,0,0,37,35,72,8,11,19,45,46,91,18,7,25,13,35,15,7,11,101,116
2018,2,21800940,3/2/2019,1610612760,Oklahoma City Thunder,0,0,1610612759,San Antonio Spurs,1,1,33,26,59,7,22,29,40,48,88,15,9,24,12,42,17,8,13,103,102
2018,2,21800734,1/26/2019,1610612737,Atlanta Hawks,0,0,1610612757,Portland Trail Blazers,1,1,30,29,59,12,21,33,42,50,92,15,5,20,12,40,24,8,11,101,111
2018,2,21800734,1/26/2019,1610612757,Portland Trail Blazers,1,1,1610612737,Atlanta Hawks,0,0,30,22,52,11,19,30,41,41,82,27,3,30,14,29,26,9,19,99,120
2018,2,21800578,1/5/2019,1610612742,Dallas Mavericks,0,0,1610612755,Philadelphia 76ers,1,1,29,28,57,9,22,31,38,50,88,15,8,23,12,43,27,7,15,102,100
2018,2,21800578,1/5/2019,1610612755,Philadelphia 76ers,1,1,1610612742,Dallas Mavericks,0,0,33,24,57,6,20,26,39,44,83,22,11,33,8,41,31,4,10,100,106
2018,2,21800361,12/5/2018,1610612749,Milwaukee Bucks,1,1,1610612765,Detroit Pistons,0,0,24,17,41,14,27,41,38,44,82,25,5,30,4,42,25,6,16,107,115
2018,2,21800361,12/5/2018,1610612765,Detroit Pistons,0,0,1610612749,Milwaukee Bucks,1,1,26,31,57,9,29,38,35,60,95,13,6,19,16,46,19,13,20,109,92
2018,2,21800302,11/27/2018,1610612737,Atlanta Hawks,0,1,1610612748,Miami Heat,1,0,26,23,49,12,19,31,38,42,80,27,5,32,11,33,22,20,24,108,115
2018,2,21800302,11/27/2018,1610612748,Miami Heat,1,0,1610612737,Atlanta Hawks,0,1,27,22,49,13,25,38,40,47,87,20,10,30,14,37,22,13,20,108,113
2018,2,21800246,11/19/2018,1610612759,San Antonio Spurs,0,0,1610612740,New Orleans Pelicans,1,1,33,37,70,12,12,24,45,49,94,24,6,30,22,30,22,10,15,102,126
2018,2,21800136,11/4/2018,1610612756,Phoenix Suns,1,1,1610612763,Memphis Grizzlies,0,0,19,13,32,14,18,32,33,31,64,22,4,26,10,22,25,13,25,90,102
2018,2,21800136,11/4/2018,1610612763,Memphis Grizzlies,0,0,1610612756,Phoenix Suns,1,1,29,24,53,7,16,23,36,40,76,21,8,29,10,33,19,7,13,92,100
2020,2,22000141,1/10/2021,1610612762,Utah Jazz,0,1,1610612765,Detroit Pistons,1,0,24,23,47,11,24,35,35,47,82,15,7,22,19,31,17,10,16,90,96
2020,2,22000141,1/10/2021,1610612765,Detroit Pistons,1,0,1610612762,Utah Jazz,0,1,19,26,45,10,32,42,29,58,87,18,3,21,13,47,21,3,8,91,86
2022,2,22201218,4/9/2023,1610612766,Charlotte Hornets,0,1,1610612739,Cleveland Cavaliers,1,0,31,18,49,6,26,32,37,44,81,26,4,30,13,33,23,9,19,100,106
2018,2,21801079,3/21/2019,1610612744,Golden State Warriors,1,1,1610612754,Indiana Pacers,0,0,31,22,53,13,23,36,44,45,89,11,5,16,12,35,32,7,16,100,112
2018,2,21801079,3/21/2019,1610612754,Indiana Pacers,0,0,1610612744,Golden State Warriors,1,1,29,39,68,6,17,23,35,56,91,13,4,17,14,44,17,6,16,100,89
2018,2,21800942,3/2/2019,1610612747,Los Angeles Lakers,0,0,1610612756,Phoenix Suns,1,1,35,29,64,8,17,25,43,46,89,15,8,23,15,35,27,7,12,99,109
2018,2,21800942,3/2/2019,1610612756,Phoenix Suns,1,1,1610612747,Los Angeles Lakers,0,0,33,17,50,6,20,26,39,37,76,34,6,40,10,30,21,3,13,97,118
2018,2,21800826,2/9/2019,1610612739,Cleveland Cavaliers,0,0,1610612754,Indiana Pacers,1,1,19,24,43,16,20,36,35,44,79,4,5,9,8,40,23,8,13,89,90
2023,2,22300488,1/5/2024,1610612753,Orlando Magic,0,1,1610612743,Denver Nuggets,1,0,24,22,46,17,19,36,41,41,82,23,11,34,12,32,25,8,15,102,122
2022,2,22201155,3/31/2023,1610612765,Detroit Pistons,0,0,1610612745,Houston Rockets,1,1,32,22,54,11,24,35,43,46,89,18,9,27,16,35,24,9,12,99,115
2017,2,21700130,11/3/2017,1610612747,Los Angeles Lakers,1,1,1610612751,Brooklyn Nets,0,0,39,34,73,9,12,21,48,46,94,19,8,27,11,40,26,8,16,110,124
2017,2,21700130,11/3/2017,1610612751,Brooklyn Nets,0,0,1610612747,Los Angeles Lakers,1,1,28,25,53,9,29,38,37,54,91,29,9,38,10,50,23,10,16,112,112
2021,2,22100337,12/3/2021,1610612745,Houston Rockets,1,1,1610612753,Orlando Magic,0,0,27,18,45,17,30,47,44,48,92,13,2,15,12,36,33,6,12,99,118
2021,2,22100337,12/3/2021,1610612753,Orlando Magic,0,0,1610612745,Houston Rockets,1,1,29,20,49,13,24,37,42,44,86,19,2,21,14,31,24,7,18,100,116
2019,2,21900117,11/8/2019,1610612753,Orlando Magic,1,1,1610612763,Memphis Grizzlies,0,0,37,28,65,7,21,28,44,49,93,23,4,27,16,36,24,3,9,99,118
2023,2,22300268,11/30/2023,1610612752,New York Knicks,1,1,1610612765,Detroit Pistons,0,0,25,22,47,16,25,41,41,47,88,20,8,28,15,36,25,4,11,98,118
2019,2,21900117,11/8/2019,1610612763,Memphis Grizzlies,0,0,1610612753,Orlando Magic,1,1,21,36,57,11,18,29,32,54,86,11,2,13,9,46,23,10,18,100,86
2016,2,21600272,11/30/2016,1610612742,Dallas Mavericks,1,0,1610612759,San Antonio Spurs,0,1,23,24,47,10,20,30,33,44,77,11,3,14,9,36,16,7,12,86,87
2016,2,21600272,11/30/2016,1610612759,San Antonio Spurs,0,1,1610612742,Dallas Mavericks,1,0,22,30,52,11,8,19,33,38,71,17,7,24,9,31,16,5,12,85,94
2020,2,22000982,5/3/2021,1610612743,Denver Nuggets,0,0,1610612747,Los Angeles Lakers,1,1,30,28,58,6,18,24,36,46,82,11,5,16,10,38,22,5,13,94,89
2020,2,22000982,5/3/2021,1610612747,Los Angeles Lakers,1,1,1610612743,Denver Nuggets,0,0,19,24,43,13,17,30,32,41,73,16,7,23,10,35,18,10,20,93,93
2014,2,21400994,3/16/2015,1610612750,Minnesota Timberwolves,1,0,1610612751,Brooklyn Nets,0,1,32,41,73,9,6,15,41,47,88,15,2,17,15,33,27,8,16,99,106
2014,2,21400994,3/16/2015,1610612751,Brooklyn Nets,0,1,1610612750,Minnesota Timberwolves,1,0,47,30,77,5,8,13,52,38,90,13,4,17,15,24,21,6,14,98,122
2014,2,21400401,12/21/2014,1610612739,Cleveland Cavaliers,1,1,1610612763,Memphis Grizzlies,0,0,39,23,62,7,7,14,46,30,76,6,4,10,5,28,34,8,14,89,105
2014,2,21400401,12/21/2014,1610612763,Memphis Grizzlies,0,0,1610612739,Cleveland Cavaliers,1,1,38,32,70,1,15,16,39,47,86,12,3,15,14,34,25,2,11,89,91
2018,2,21800826,2/9/2019,1610612754,Indiana Pacers,1,1,1610612739,Cleveland Cavaliers,0,0,36,22,58,9,17,26,45,39,84,6,4,10,11,29,31,3,10,89,105
2018,2,21800655,1/15/2019,1610612743,Denver Nuggets,1,0,1610612744,Golden State Warriors,0,1,28,30,58,14,20,34,42,50,92,13,3,16,10,41,30,6,8,97,111
2018,2,21800655,1/15/2019,1610612744,Golden State Warriors,0,1,1610612743,Denver Nuggets,1,0,36,20,56,21,18,39,57,38,95,7,3,10,13,28,38,4,10,96,142
2022,2,22201218,4/9/2023,1610612739,Cleveland Cavaliers,1,0,1610612766,Charlotte Hornets,0,1,25,27,52,10,27,37,35,54,89,15,1,16,13,41,27,8,16,99,95
2020,2,22000140,1/9/2021,1610612757,Portland Trail Blazers,0,1,1610612758,Sacramento Kings,1,0,27,32,59,17,24,41,44,56,100,20,3,23,14,44,26,4,8,107,125
2020,2,22000140,1/9/2021,1610612758,Sacramento Kings,1,0,1610612757,Portland Trail Blazers,0,1,25,26,51,8,22,30,33,48,81,25,10,35,7,46,21,10,15,107,99
2019,2,21900351,12/9/2019,1610612744,Golden State Warriors,1,0,1610612763,Memphis Grizzlies,0,1,24,42,66,11,16,27,35,58,93,21,4,25,15,44,23,13,16,106,102
2019,2,21900351,12/9/2019,1610612763,Memphis Grizzlies,0,1,1610612744,Golden State Warriors,1,0,26,16,42,15,25,40,41,41,82,13,4,17,5,38,29,10,20,104,110
2023,2,22300814,2/24/2024,1610612765,Detroit Pistons,1,0,1610612753,Orlando Magic,0,1,29,25,54,14,17,31,43,42,85,9,4,13,11,35,29,9,12,92,109
2016,2,21600755,2/4/2017,1610612740,New Orleans Pelicans,0,0,1610612764,Washington Wizards,1,1,32,35,67,5,12,17,37,47,84,12,10,22,12,39,18,10,15,97,91
2016,2,21600755,2/4/2017,1610612764,Washington Wizards,1,1,1610612740,New Orleans Pelicans,0,0,28,24,52,10,21,31,38,45,83,19,3,22,11,36,20,4,13,98,105
2014,2,21400993,3/16/2015,1610612743,Denver Nuggets,0,0,1610612763,Memphis Grizzlies,1,1,22,41,63,8,10,18,30,51,81,13,8,21,15,40,14,9,16,92,81
2014,2,21400993,3/16/2015,1610612763,Memphis Grizzlies,1,1,1610612743,Denver Nuggets,0,0,31,40,71,2,7,9,33,47,80,24,4,28,21,28,14,13,20,92,92
2014,2,21400400,12/21/2014,1610612752,New York Knicks,0,0,1610612761,Toronto Raptors,1,1,35,33,68,5,9,14,40,42,82,23,3,26,16,28,27,7,12,90,108
2014,2,21400400,12/21/2014,1610612761,Toronto Raptors,1,1,1610612752,New York Knicks,0,0,28,25,53,14,19,33,42,44,86,20,7,27,20,27,24,6,10,89,118
2023,2,22300357,12/18/2023,1610612751,Brooklyn Nets,0,0,1610612762,Utah Jazz,1,1,23,28,51,16,23,39,39,51,90,14,6,20,15,41,25,6,14,98,108
2018,2,21800577,1/5/2019,1610612762,Utah Jazz,0,1,1610612765,Detroit Pistons,1,0,32,29,61,7,14,21,39,43,82,25,7,32,7,39,24,7,12,101,110
2018,2,21800577,1/5/2019,1610612765,Detroit Pistons,1,0,1610612762,Utah Jazz,0,1,28,29,57,11,14,25,39,43,82,16,4,20,7,38,18,12,18,102,105
2021,2,22100336,12/3/2021,1610612750,Minnesota Timberwolves,0,0,1610612751,Brooklyn Nets,1,1,23,28,51,13,29,42,36,57,93,20,4,24,21,37,22,4,18,102,105
2022,2,22201157,3/31/2023,1610612750,Minnesota Timberwolves,1,0,1610612747,Los Angeles Lakers,0,1,28,28,56,13,26,39,41,54,95,16,3,19,13,42,25,10,16,104,111
2021,2,22100336,12/3/2021,1610612751,Brooklyn Nets,1,1,1610612750,Minnesota Timberwolves,0,0,30,23,53,6,17,23,36,40,76,32,9,41,11,32,26,5,17,103,110
2020,2,22000139,1/9/2021,1610612742,Dallas Mavericks,1,1,1610612753,Orlando Magic,0,0,19,20,39,20,20,40,39,40,79,14,4,18,7,34,25,11,18,98,112
2020,2,22000139,1/9/2021,1610612753,Orlando Magic,0,0,1610612742,Dallas Mavericks,1,1,32,26,58,6,25,31,38,51,89,16,6,22,13,41,17,5,10,96,98
2017,2,21700129,11/3/2017,1610612738,Boston Celtics,0,1,1610612760,Oklahoma City Thunder,1,0,23,33,56,13,15,28,36,48,84,16,8,24,13,37,23,4,11,93,101
2017,2,21700129,11/3/2017,1610612760,Oklahoma City Thunder,1,0,1610612738,Boston Celtics,0,1,22,30,52,13,22,35,35,52,87,11,3,14,13,40,20,6,12,93,94
2016,2,21600271,11/30/2016,1610612750,Minnesota Timberwolves,1,0,1610612752,New York Knicks,0,1,30,28,58,4,15,19,34,43,77,32,7,39,18,30,17,8,15,93,104
2016,2,21600271,11/30/2016,1610612752,New York Knicks,0,1,1610612750,Minnesota Timberwolves,1,0,28,31,59,13,19,32,41,50,91,11,4,15,18,34,24,9,14,94,106
2014,2,21400399,12/20/2014,1610612746,LA Clippers,1,1,1610612749,Milwaukee Bucks,0,0,25,30,55,12,14,26,37,44,81,20,7,27,11,38,29,6,12,95,106
2014,2,21400399,12/20/2014,1610612749,Milwaukee Bucks,0,0,1610612746,LA Clippers,1,1,35,22,57,8,16,24,43,38,81,8,7,15,12,31,29,10,20,96,102
2018,2,21801078,3/21/2019,1610612742,Dallas Mavericks,0,0,1610612758,Sacramento Kings,1,1,24,28,52,12,28,40,36,56,92,16,7,23,13,47,23,7,8,97,100
2018,2,21801078,3/21/2019,1610612758,Sacramento Kings,1,1,1610612742,Dallas Mavericks,0,0,28,24,52,13,22,35,41,46,87,21,7,28,15,37,24,5,12,98,116
2023,2,22300356,12/18/2023,1610612743,Denver Nuggets,1,1,1610612742,Dallas Mavericks,0,0,35,26,61,14,12,26,49,38,87,18,4,22,10,30,29,2,9,96,130
2018,2,21800733,1/26/2019,1610612743,Denver Nuggets,1,1,1610612755,Philadelphia 76ers,0,0,40,30,70,8,16,24,48,46,94,22,7,29,14,32,27,7,11,105,126
2018,2,21800733,1/26/2019,1610612755,Philadelphia 76ers,0,0,1610612743,Denver Nuggets,1,1,24,31,55,14,22,36,38,53,91,20,7,27,12,44,29,4,12,104,110
2018,2,21800500,12/25/2018,1610612744,Golden State Warriors,1,0,1610612747,Los Angeles Lakers,0,1,29,28,57,9,27,36,38,55,93,16,5,21,12,46,28,5,14,105,101
2021,2,22100335,12/3/2021,1610612737,Atlanta Hawks,1,0,1610612755,Philadelphia 76ers,0,1,21,27,48,10,18,28,31,45,76,24,6,30,14,37,20,8,15,92,96
2021,2,22100335,12/3/2021,1610612755,Philadelphia 76ers,0,1,1610612737,Atlanta Hawks,1,0,29,30,59,9,13,22,38,43,81,13,4,17,7,38,22,5,11,91,98
2020,2,22000138,1/9/2021,1610612750,Minnesota Timberwolves,1,0,1610612759,San Antonio Spurs,0,1,33,33,66,15,15,30,48,48,96,11,6,17,14,37,29,8,17,107,122
2020,2,22000138,1/9/2021,1610612759,San Antonio Spurs,0,1,1610612750,Minnesota Timberwolves,1,0,31,38,69,13,19,32,44,57,101,24,5,29,16,44,22,1,6,107,125
2017,2,21700128,11/3/2017,1610612761,Toronto Raptors,0,1,1610612762,Utah Jazz,1,0,27,14,41,11,19,30,38,33,71,22,6,28,7,28,20,9,17,93,109
2017,2,21700128,11/3/2017,1610612762,Utah Jazz,1,0,1610612761,Toronto Raptors,0,1,27,30,57,8,15,23,35,45,80,22,2,24,11,35,11,9,14,94,100
2016,2,21600754,2/3/2017,1610612742,Dallas Mavericks,0,1,1610612757,Portland Trail Blazers,1,0,19,26,45,17,14,31,36,40,76,19,4,23,5,35,15,3,7,90,108
2016,2,21600754,2/3/2017,1610612757,Portland Trail Blazers,1,0,1610612742,Dallas Mavericks,0,1,31,27,58,9,21,30,40,48,88,15,5,20,16,34,16,3,9,91,104
2020,2,22000981,5/3/2021,1610612759,San Antonio Spurs,0,0,1610612762,Utah Jazz,1,1,37,35,72,5,13,18,42,48,90,10,0,10,12,36,25,10,13,96,99
2020,2,22000981,5/3/2021,1610612762,Utah Jazz,1,1,1610612759,San Antonio Spurs,0,0,33,19,52,11,25,36,44,44,88,11,5,16,17,30,22,10,16,95,110
2023,2,22300029,11/17/2023,1610612755,Philadelphia 76ers,0,1,1610612737,Atlanta Hawks,1,0,30,28,58,13,17,30,43,45,88,27,1,28,19,26,32,8,17,98,126
2018,2,21801230,4/10/2019,1610612757,Portland Trail Blazers,1,1,1610612758,Sacramento Kings,0,0,39,28,67,14,10,24,53,38,91,16,6,22,16,25,19,5,13,98,136
2018,2,21801230,4/10/2019,1610612758,Sacramento Kings,0,0,1610612757,Portland Trail Blazers,1,1,32,21,53,18,25,43,50,46,96,13,3,16,16,31,25,5,10,99,131
2022,2,22201223,4/9/2023,1610612741,Chicago Bulls,1,1,1610612765,Detroit Pistons,0,0,34,31,65,6,24,30,40,55,95,17,5,22,12,45,21,1,4,98,103
2023,2,22300246,11/26/2023,1610612737,Atlanta Hawks,0,0,1610612738,Boston Celtics,1,1,17,18,35,19,34,53,36,52,88,12,7,19,14,42,15,9,16,98,103
2023,2,22300410,12/26/2023,1610612763,Memphis Grizzlies,0,1,1610612740,New Orleans Pelicans,1,0,28,16,44,11,35,46,39,51,90,27,5,32,13,41,24,12,18,111,116
2023,2,22300387,12/22/2023,1610612756,Phoenix Suns,0,0,1610612758,Sacramento Kings,1,1,34,29,63,5,20,25,39,49,88,22,6,28,20,33,19,7,15,96,105
2018,2,21800939,3/2/2019,1610612742,Dallas Mavericks,1,0,1610612763,Memphis Grizzlies,0,1,19,26,45,7,33,40,26,59,85,22,11,33,15,50,17,4,10,96,81
2023,2,22300406,12/26/2023,1610612765,Detroit Pistons,1,0,1610612751,Brooklyn Nets,0,1,31,34,65,9,16,25,40,50,90,23,9,32,18,36,20,6,14,101,112
2023,2,22300045,11/24/2023,1610612752,New York Knicks,1,1,1610612748,Miami Heat,0,0,29,23,52,10,19,29,39,42,81,12,6,18,9,36,21,11,19,97,100
2021,2,22100334,12/3/2021,1610612739,Cleveland Cavaliers,0,1,1610612764,Washington Wizards,1,0,29,30,59,13,17,30,42,47,89,19,6,25,19,34,30,5,16,96,116
2021,2,22100334,12/3/2021,1610612764,Washington Wizards,1,0,1610612739,Cleveland Cavaliers,0,1,28,23,51,10,21,31,38,44,82,15,4,19,6,39,21,2,10,95,101
2020,2,22000137,1/9/2021,1610612739,Cleveland Cavaliers,0,0,1610612749,Milwaukee Bucks,1,1,29,32,61,7,19,26,36,51,87,11,5,16,19,35,16,11,18,93,90
2020,2,22000137,1/9/2021,1610612749,Milwaukee Bucks,1,1,1610612739,Cleveland Cavaliers,0,0,25,23,48,12,24,36,37,47,84,14,4,18,15,34,25,6,16,94,100
2019,2,21900350,12/9/2019,1610612760,Oklahoma City Thunder,0,1,1610612762,Utah Jazz,1,0,32,25,57,8,20,28,40,45,85,16,3,19,5,41,21,7,11,101,104
2019,2,21900350,12/9/2019,1610612762,Utah Jazz,1,0,1610612760,Oklahoma City Thunder,0,1,28,30,58,8,23,31,36,53,89,10,2,12,9,45,19,9,15,100,90
2019,2,21900116,11/8/2019,1610612754,Indiana Pacers,1,1,1610612765,Detroit Pistons,0,0,39,29,68,4,11,15,43,40,83,22,3,25,11,32,23,6,13,95,112
2019,2,21900116,11/8/2019,1610612765,Detroit Pistons,0,0,1610612754,Indiana Pacers,1,1,26,27,53,13,20,33,39,47,86,15,3,18,15,34,27,6,17,95,106
2023,2,22300652,1/28/2024,1610612754,Indiana Pacers,1,1,1610612763,Memphis Grizzlies,0,0,31,24,55,13,22,35,44,46,90,15,1,16,12,34,31,5,10,95,116
2017,2,21700127,11/3/2017,1610612743,Denver Nuggets,1,1,1610612748,Miami Heat,0,0,27,30,57,9,14,23,36,44,80,14,11,25,15,33,17,9,16,92,95
2017,2,21700127,11/3/2017,1610612748,Miami Heat,0,0,1610612743,Denver Nuggets,1,1,21,19,40,15,22,37,36,41,77,7,4,11,12,32,23,9,24,92,94
2014,2,21400398,12/20/2014,1610612743,Denver Nuggets,1,1,1610612754,Indiana Pacers,0,0,28,38,66,2,14,16,30,52,82,14,5,19,14,42,14,5,16,93,76
2014,2,21400398,12/20/2014,1610612754,Indiana Pacers,0,0,1610612743,Denver Nuggets,1,1,20,45,65,7,16,23,27,61,88,12,5,17,20,45,17,7,15,95,73
2021,2,22100333,12/3/2021,1610612748,Miami Heat,0,1,1610612754,Indiana Pacers,1,0,27,20,47,16,18,34,43,38,81,11,2,13,11,28,24,7,13,90,113
2021,2,22100333,12/3/2021,1610612754,Indiana Pacers,1,0,1610612748,Miami Heat,0,1,26,18,44,9,27,36,35,45,80,25,8,33,18,31,20,5,13,90,104
2023,2,22301181,4/12/2024,1610612742,Dallas Mavericks,1,0,1610612765,Detroit Pistons,0,1,28,26,54,8,21,29,36,47,83,9,3,12,11,37,20,11,20,99,89
2020,2,22000136,1/9/2021,1610612748,Miami Heat,0,1,1610612764,Washington Wizards,1,0,30,20,50,16,27,43,46,47,93,20,6,26,14,37,32,9,16,110,128
2020,2,22000136,1/9/2021,1610612764,Washington Wizards,1,0,1610612748,Miami Heat,0,1,29,30,59,15,25,40,44,55,99,21,7,28,8,51,25,3,6,110,124
2017,2,21700126,11/3/2017,1610612759,San Antonio Spurs,1,1,1610612766,Charlotte Hornets,0,0,30,26,56,9,18,27,39,44,83,21,5,26,10,36,31,11,16,99,108
2017,2,21700126,11/3/2017,1610612766,Charlotte Hornets,0,0,1610612759,San Antonio Spurs,1,1,25,31,56,8,16,24,33,47,80,27,15,42,14,41,16,7,12,100,101
2016,2,21600753,2/3/2017,1610612756,Phoenix Suns,0,1,1610612758,Sacramento Kings,1,0,20,28,48,12,17,29,32,45,77,29,6,35,7,39,11,5,12,98,105
2016,2,21600753,2/3/2017,1610612758,Sacramento Kings,1,0,1610612756,Phoenix Suns,0,1,28,30,58,10,17,27,38,47,85,17,5,22,11,38,23,7,13,98,103
2016,2,21600270,11/30/2016,1610612760,Oklahoma City Thunder,1,1,1610612764,Washington Wizards,0,0,34,31,65,12,18,30,46,49,95,22,9,31,14,39,28,8,14,110,126
2016,2,21600270,11/30/2016,1610612764,Washington Wizards,0,0,1610612760,Oklahoma City Thunder,1,1,34,36,70,10,18,28,44,54,98,17,9,26,16,42,25,10,12,110,115
2018,2,21801077,3/21/2019,1610612756,Phoenix Suns,1,0,1610612765,Detroit Pistons,0,1,28,19,47,7,19,26,35,38,73,21,5,26,9,30,22,11,19,96,98
2018,2,21801077,3/21/2019,1610612765,Detroit Pistons,0,1,1610612756,Phoenix Suns,1,0,21,27,48,17,25,42,38,52,90,25,9,34,26,30,23,6,15,96,118
2018,2,21800939,3/2/2019,1610612763,Memphis Grizzlies,0,1,1610612742,Dallas Mavericks,1,0,25,19,44,14,20,34,39,39,78,19,5,24,9,33,30,9,15,95,111
2018,2,21800654,1/15/2019,1610612748,Miami Heat,0,0,1610612749,Milwaukee Bucks,1,1,28,24,52,8,26,34,36,50,86,6,2,8,5,46,27,8,18,102,86
2018,2,21800654,1/15/2019,1610612749,Milwaukee Bucks,1,1,1610612748,Miami Heat,0,0,31,26,57,17,22,39,48,48,96,11,7,18,9,41,35,2,7,102,124
2018,2,21800500,12/25/2018,1610612747,Los Angeles Lakers,0,1,1610612744,Golden State Warriors,1,0,34,18,52,13,20,33,47,38,85,20,7,27,6,34,27,5,12,104,127
2018,2,21800137,11/4/2018,1610612753,Orlando Magic,0,1,1610612759,San Antonio Spurs,1,0,34,25,59,12,20,32,46,45,91,13,5,18,13,34,29,3,9,95,117
2018,2,21800137,11/4/2018,1610612759,San Antonio Spurs,1,0,1610612753,Orlando Magic,0,1,26,27,53,12,23,35,38,50,88,22,3,25,15,36,25,7,11,97,110
2018,2,21800091,10/29/2018,1610612741,Chicago Bulls,1,0,1610612744,Golden State Warriors,0,1,35,24,59,11,24,35,46,48,94,21,13,34,15,41,25,9,9,104,124
2018,2,21800091,10/29/2018,1610612744,Golden State Warriors,0,1,1610612741,Chicago Bulls,1,0,29,22,51,24,21,45,53,43,96,19,7,26,10,37,34,6,7,103,149
2022,2,22201216,4/9/2023,1610612737,Atlanta Hawks,0,0,1610612738,Boston Celtics,1,1,33,25,58,11,28,39,44,53,97,15,4,19,17,37,27,5,9,97,114
2021,2,22100332,12/2/2021,1610612757,Portland Trail Blazers,1,0,1610612759,San Antonio Spurs,0,1,17,31,48,12,22,34,29,53,82,13,4,17,9,46,19,10,18,99,83
2021,2,22100332,12/2/2021,1610612759,San Antonio Spurs,0,1,1610612757,Portland Trail Blazers,1,0,30,25,55,14,22,36,44,47,91,12,4,16,12,38,32,8,14,101,114
2023,2,22300406,12/26/2023,1610612751,Brooklyn Nets,0,1,1610612765,Detroit Pistons,1,0,32,28,60,9,13,22,41,41,82,27,16,43,11,39,22,6,9,100,118
2019,2,21900115,11/7/2019,1610612746,LA Clippers,1,1,1610612757,Portland Trail Blazers,0,0,35,31,66,4,19,23,39,50,89,25,5,30,18,35,20,7,17,103,107
2019,2,21900115,11/7/2019,1610612757,Portland Trail Blazers,0,0,1610612746,LA Clippers,1,1,28,37,65,11,28,39,39,65,104,12,4,16,20,46,18,6,14,103,101
2023,2,22300192,11/15/2023,1610612742,Dallas Mavericks,0,1,1610612764,Washington Wizards,1,0,31,19,50,17,25,42,48,44,92,17,12,29,11,40,32,6,10,102,130
2018,2,21801229,4/10/2019,1610612746,LA Clippers,1,1,1610612762,Utah Jazz,0,0,42,36,78,12,16,28,54,52,106,23,7,30,14,42,34,8,12,117,143
2018,2,21801229,4/10/2019,1610612762,Utah Jazz,0,0,1610612746,LA Clippers,1,1,33,38,71,14,21,35,47,59,106,29,4,33,21,41,31,7,17,118,137
2022,2,22200500,12/26/2022,1610612748,Miami Heat,1,1,1610612750,Minnesota Timberwolves,0,0,34,19,53,13,36,49,47,55,102,6,2,8,17,39,27,4,10,97,113
2022,2,22200500,12/26/2022,1610612750,Minnesota Timberwolves,0,0,1610612748,Miami Heat,1,1,28,17,45,15,19,34,43,36,79,9,5,14,10,30,31,9,22,95,110
2023,2,22300452,1/1/2024,1610612739,Cleveland Cavaliers,0,0,1610612761,Toronto Raptors,1,1,31,22,53,12,24,36,43,46,89,23,3,26,10,38,25,5,9,101,121
2023,2,22300359,12/18/2023,1610612747,Los Angeles Lakers,1,0,1610612752,New York Knicks,0,1,29,29,58,13,28,41,42,57,99,12,1,13,12,45,29,5,10,102,109
2021,2,22100331,12/2/2021,1610612756,Phoenix Suns,1,1,1610612765,Detroit Pistons,0,0,31,27,58,12,9,21,43,36,79,16,7,23,9,31,23,6,15,96,114
2021,2,22100331,12/2/2021,1610612765,Detroit Pistons,0,0,1610612756,Phoenix Suns,1,1,25,28,53,11,16,27,36,44,80,20,6,26,8,39,20,8,13,96,103
2022,2,22201155,3/31/2023,1610612745,Houston Rockets,1,1,1610612765,Detroit Pistons,0,0,27,25,52,11,20,31,38,45,83,34,11,45,19,30,18,7,12,99,121
2022,2,22200594,1/7/2023,1610612744,Golden State Warriors,1,0,1610612753,Orlando Magic,0,1,15,15,30,18,40,58,33,55,88,17,4,21,16,42,26,12,16,100,101
2020,2,22000135,1/9/2021,1610612754,Indiana Pacers,1,0,1610612756,Phoenix Suns,0,1,32,31,63,12,17,29,44,48,92,17,7,24,15,38,23,6,10,98,117
2020,2,22000135,1/9/2021,1610612756,Phoenix Suns,0,1,1610612754,Indiana Pacers,1,0,30,23,53,16,25,41,46,48,94,17,0,17,8,40,33,2,3,97,125
2019,2,21900349,12/9/2019,1610612750,Minnesota Timberwolves,0,0,1610612756,Phoenix Suns,1,1,34,29,63,6,16,22,40,45,85,23,6,29,17,32,14,5,17,100,109
2019,2,21900349,12/9/2019,1610612756,Phoenix Suns,1,1,1610612750,Minnesota Timberwolves,0,0,31,24,55,16,24,40,47,48,95,15,4,19,15,35,31,6,9,99,125
2017,2,21700125,11/3/2017,1610612740,New Orleans Pelicans,0,1,1610612742,Dallas Mavericks,1,0,29,31,60,7,22,29,36,53,89,20,6,26,16,39,23,4,14,101,99
2017,2,21700125,11/3/2017,1610612742,Dallas Mavericks,1,0,1610612740,New Orleans Pelicans,0,1,25,29,54,9,25,34,34,54,88,17,5,22,11,47,19,9,15,102,94
2020,2,22000980,5/3/2021,1610612752,New York Knicks,0,1,1610612763,Memphis Grizzlies,1,0,31,31,62,14,13,27,45,44,89,14,4,18,9,37,19,7,10,97,118
2020,2,22000980,5/3/2021,1610612763,Memphis Grizzlies,1,0,1610612752,New York Knicks,0,1,18,27,45,16,25,41,34,52,86,20,4,24,15,37,26,6,12,96,104
2016,2,21600269,11/30/2016,1610612741,Chicago Bulls,1,0,1610612747,Los Angeles Lakers,0,1,28,42,70,4,17,21,32,59,91,22,7,29,18,45,22,12,14,102,90
2016,2,21600269,11/30/2016,1610612747,Los Angeles Lakers,0,1,1610612741,Chicago Bulls,1,0,31,42,73,2,6,8,33,48,81,28,13,41,20,34,17,15,24,102,96
2014,2,21400397,12/20/2014,1610612742,Dallas Mavericks,1,1,1610612759,San Antonio Spurs,0,0,28,32,60,9,17,26,37,49,86,16,4,20,14,38,18,6,12,94,99
2014,2,21400397,12/20/2014,1610612759,San Antonio Spurs,0,0,1610612742,Dallas Mavericks,1,1,29,35,64,3,10,13,32,45,77,26,0,26,15,30,10,10,19,94,93
2022,2,22200594,1/7/2023,1610612753,Orlando Magic,0,1,1610612744,Golden State Warriors,1,0,31,24,55,13,19,32,44,43,87,14,10,24,9,40,26,7,11,99,115
2022,2,22201222,4/9/2023,1610612764,Washington Wizards,1,0,1610612745,Houston Rockets,0,1,27,25,52,14,31,45,41,56,97,13,8,21,16,42,28,8,13,105,109
2018,2,21801228,4/10/2019,1610612743,Denver Nuggets,1,1,1610612750,Minnesota Timberwolves,0,0,29,25,54,10,23,33,39,48,87,11,6,17,13,38,23,6,13,96,99
2018,2,21801228,4/10/2019,1610612750,Minnesota Timberwolves,0,0,1610612743,Denver Nuggets,1,1,26,33,59,13,19,32,39,52,91,4,2,6,9,45,24,6,10,94,95
2018,2,21800825,2/9/2019,1610612759,San Antonio Spurs,0,0,1610612762,Utah Jazz,1,1,33,34,67,7,15,22,40,49,89,18,2,20,7,44,24,7,9,100,105
2018,2,21800825,2/9/2019,1610612762,Utah Jazz,1,1,1610612759,San Antonio Spurs,0,0,31,18,49,16,25,41,47,43,90,15,5,20,13,33,29,7,11,101,125
2018,2,21800576,1/5/2019,1610612743,Denver Nuggets,1,1,1610612766,Charlotte Hornets,0,0,33,30,63,14,25,39,47,55,102,15,5,20,21,37,30,7,8,97,123
2018,2,21800576,1/5/2019,1610612766,Charlotte Hornets,0,0,1610612743,Denver Nuggets,1,1,28,25,53,11,18,29,39,43,82,21,5,26,14,30,22,10,17,97,110
2022,2,22201157,3/31/2023,1610612747,Los Angeles Lakers,0,1,1610612750,Minnesota Timberwolves,1,0,36,32,68,9,13,22,45,45,90,24,6,30,18,29,28,10,16,103,123
2023,2,22300192,11/15/2023,1610612764,Washington Wizards,1,0,1610612742,Dallas Mavericks,0,1,31,22,53,12,24,36,43,46,89,19,4,23,10,39,23,6,12,102,117
2017,2,21700124,11/3/2017,1610612752,New York Knicks,1,1,1610612756,Phoenix Suns,0,0,37,24,61,8,18,26,45,42,87,22,3,25,12,31,24,7,13,99,120
2017,2,21700124,11/3/2017,1610612756,Phoenix Suns,0,0,1610612752,New York Knicks,1,1,25,40,65,9,23,32,34,63,97,30,7,37,25,41,17,5,10,100,107
2019,2,21900348,12/9/2019,1610612740,New Orleans Pelicans,1,0,1610612765,Detroit Pistons,0,1,32,21,53,8,30,38,40,51,91,15,7,22,17,37,24,6,15,102,103
2019,2,21900348,12/9/2019,1610612765,Detroit Pistons,0,1,1610612740,New Orleans Pelicans,1,0,25,25,50,11,24,35,36,49,85,22,5,27,16,36,15,6,19,101,105
2016,2,21600752,2/3/2017,1610612743,Denver Nuggets,1,1,1610612749,Milwaukee Bucks,0,0,31,30,61,9,19,28,40,49,89,32,12,44,20,34,31,9,15,104,121
2016,2,21600752,2/3/2017,1610612749,Milwaukee Bucks,0,0,1610612743,Denver Nuggets,1,1,36,23,59,9,15,24,45,38,83,18,5,23,10,31,26,8,18,103,117
2015,2,21500793,2/10/2016,1610612751,Brooklyn Nets,1,0,1610612763,Memphis Grizzlies,0,1,22,27,49,11,11,22,33,38,71,13,6,19,12,27,25,15,22,91,90
2015,2,21500793,2/10/2016,1610612763,Memphis Grizzlies,0,1,1610612751,Brooklyn Nets,1,0,36,30,66,9,11,20,45,41,86,10,2,12,13,29,26,4,12,92,109
2023,2,22300356,12/18/2023,1610612742,Dallas Mavericks,0,0,1610612743,Denver Nuggets,1,1,28,26,54,13,25,38,41,51,92,9,10,19,18,40,19,7,11,96,104
2023,2,22300413,12/26/2023,1610612757,Portland Trail Blazers,1,1,1610612758,Sacramento Kings,0,0,33,25,58,16,24,40,49,49,98,16,4,20,22,30,28,5,10,96,130
2018,2,21800732,1/26/2019,1610612738,Boston Celtics,1,0,1610612744,Golden State Warriors,0,1,26,33,59,15,25,40,41,58,99,14,1,15,17,42,23,8,14,102,111
2018,2,21800732,1/26/2019,1610612744,Golden State Warriors,0,1,1610612738,Boston Celtics,1,0,25,25,50,12,21,33,37,46,83,29,5,34,13,35,25,6,15,102,115
2018,2,21800427,12/14/2018,1610612757,Portland Trail Blazers,1,1,1610612761,Toronto Raptors,0,0,35,32,67,13,14,27,48,46,94,19,2,21,16,31,29,4,8,99,128
2018,2,21800427,12/14/2018,1610612761,Toronto Raptors,0,0,1610612757,Portland Trail Blazers,1,1,25,22,47,18,13,31,43,35,78,18,3,21,7,28,20,10,17,98,122
2018,2,21800301,11/27/2018,1610612752,New York Knicks,0,0,1610612765,Detroit Pistons,1,1,27,37,64,9,18,27,36,55,91,27,5,32,14,43,16,5,13,105,108
2018,2,21800301,11/27/2018,1610612765,Detroit Pistons,1,1,1610612752,New York Knicks,0,0,31,25,56,7,17,24,38,42,80,32,13,45,9,38,20,5,13,104,115
2018,2,21800193,11/12/2018,1610612741,Chicago Bulls,1,0,1610612742,Dallas Mavericks,0,1,27,29,56,8,25,33,35,54,89,20,2,22,11,43,16,11,17,103,98
2018,2,21800193,11/12/2018,1610612742,Dallas Mavericks,0,1,1610612741,Chicago Bulls,1,0,27,19,46,10,23,33,37,42,79,19,10,29,10,39,18,11,20,103,103
2018,2,21800090,10/29/2018,1610612751,Brooklyn Nets,0,0,1610612752,New York Knicks,1,1,23,23,46,11,27,38,34,50,84,17,5,22,11,42,22,5,10,92,96
2018,2,21800090,10/29/2018,1610612752,New York Knicks,1,1,1610612751,Brooklyn Nets,0,0,36,32,68,9,15,24,45,47,92,16,2,18,25,23,21,6,16,92,115
2021,2,22100330,12/2/2021,1610612760,Oklahoma City Thunder,0,0,1610612763,Memphis Grizzlies,1,1,14,24,38,11,27,38,25,51,76,18,4,22,9,44,14,16,20,98,79
2021,2,22100330,12/2/2021,1610612763,Memphis Grizzlies,1,1,1610612760,Oklahoma City Thunder,0,0,41,19,60,19,17,36,60,36,96,13,5,18,17,21,41,2,10,97,152
2020,2,22000134,1/9/2021,1610612737,Atlanta Hawks,0,0,1610612766,Charlotte Hornets,1,1,20,24,44,14,31,45,34,55,89,23,5,28,21,36,25,11,14,95,105
2020,2,22000134,1/9/2021,1610612766,Charlotte Hornets,1,1,1610612737,Atlanta Hawks,0,0,25,19,44,15,18,33,40,37,77,18,6,24,9,32,27,10,15,96,113
2020,2,22000979,5/3/2021,1610612741,Chicago Bulls,1,0,1610612755,Philadelphia 76ers,0,1,25,28,53,11,23,34,36,51,87,11,3,14,15,37,25,11,15,94,94
2020,2,22000979,5/3/2021,1610612755,Philadelphia 76ers,0,1,1610612741,Chicago Bulls,1,0,29,18,47,11,17,28,40,35,75,15,6,21,8,31,23,7,18,95,106
2017,2,21700123,11/3/2017,1610612737,Atlanta Hawks,1,0,1610612745,Houston Rockets,0,1,28,20,48,11,22,33,39,42,81,15,3,18,8,36,16,14,18,99,104
2017,2,21700123,11/3/2017,1610612745,Houston Rockets,0,1,1610612737,Atlanta Hawks,1,0,26,16,42,16,31,47,42,47,89,19,4,23,11,39,28,8,13,99,119
2022,2,22201217,4/9/2023,1610612751,Brooklyn Nets,1,0,1610612755,Philadelphia 76ers,0,1,23,28,51,12,20,32,35,48,83,23,5,28,11,39,22,10,19,104,105
2016,2,21600268,11/30/2016,1610612761,Toronto Raptors,1,1,1610612763,Memphis Grizzlies,0,0,22,15,37,16,16,32,38,31,69,28,5,33,13,20,23,13,20,92,120
2016,2,21600268,11/30/2016,1610612763,Memphis Grizzlies,0,0,1610612761,Toronto Raptors,1,1,25,30,55,11,16,27,36,46,82,22,4,26,14,34,16,7,14,93,105
2014,2,21400992,3/16/2015,1610612738,Boston Celtics,1,1,1610612755,Philadelphia 76ers,0,0,36,32,68,8,12,20,44,44,88,12,3,15,11,34,27,7,11,97,108
2014,2,21400992,3/16/2015,1610612755,Philadelphia 76ers,0,0,1610612738,Boston Celtics,1,1,26,34,60,8,16,24,34,50,84,13,11,24,14,42,20,7,16,97,89
2018,2,21801076,3/21/2019,1610612737,Atlanta Hawks,1,1,1610612762,Utah Jazz,0,0,22,25,47,19,21,40,41,46,87,16,7,23,12,37,26,12,17,104,117
2018,2,21801076,3/21/2019,1610612762,Utah Jazz,0,0,1610612737,Atlanta Hawks,1,1,33,29,62,10,22,32,43,51,94,18,8,26,16,39,25,8,15,104,114
2018,2,21800938,3/2/2019,1610612744,Golden State Warriors,0,1,1610612755,Philadelphia 76ers,1,0,27,21,48,14,19,33,41,40,81,24,10,34,5,38,23,6,14,107,120
2023,2,22300045,11/24/2023,1610612748,Miami Heat,0,0,1610612752,New York Knicks,1,1,24,26,50,10,27,37,34,53,87,20,1,21,11,42,20,7,11,97,98
2018,2,21800938,3/2/2019,1610612755,Philadelphia 76ers,1,0,1610612744,Golden State Warriors,0,1,25,31,56,14,17,31,39,48,87,25,4,29,14,37,26,14,21,106,117
2014,2,21400396,12/20/2014,1610612737,Atlanta Hawks,0,1,1610612745,Houston Rockets,1,0,28,20,48,10,16,26,38,36,74,18,6,24,8,30,26,8,15,93,104
2014,2,21400396,12/20/2014,1610612745,Houston Rockets,1,0,1610612737,Atlanta Hawks,0,1,19,24,43,15,28,43,34,52,86,14,4,18,18,37,27,7,16,94,97
2020,2,22000133,1/9/2021,1610612743,Denver Nuggets,0,1,1610612755,Philadelphia 76ers,1,0,33,24,57,12,21,33,45,45,90,13,2,15,17,29,28,8,17,96,115
2020,2,22000133,1/9/2021,1610612755,Philadelphia 76ers,1,0,1610612743,Denver Nuggets,0,1,32,36,68,11,24,35,43,60,103,6,4,10,28,33,23,11,17,97,103
2019,2,21900347,12/9/2019,1610612749,Milwaukee Bucks,1,1,1610612753,Orlando Magic,0,0,27,24,51,16,25,41,43,49,92,8,7,15,13,37,30,8,15,104,110
2019,2,21900347,12/9/2019,1610612753,Orlando Magic,0,0,1610612749,Milwaukee Bucks,1,1,25,36,61,10,21,31,35,57,92,21,5,26,13,45,24,7,12,103,101
2019,2,21900114,11/7/2019,1610612748,Miami Heat,0,1,1610612756,Phoenix Suns,1,0,30,24,54,15,13,28,45,37,82,19,5,24,8,31,22,4,15,102,124
2019,2,21900114,11/7/2019,1610612756,Phoenix Suns,1,0,1610612748,Miami Heat,0,1,26,26,52,11,21,32,37,47,84,23,8,31,14,37,22,9,15,100,108
2017,2,21700122,11/3/2017,1610612739,Cleveland Cavaliers,0,1,1610612764,Washington Wizards,1,0,34,21,55,12,15,27,46,36,82,26,2,28,9,28,20,5,15,100,130
2017,2,21700122,11/3/2017,1610612764,Washington Wizards,1,0,1610612739,Cleveland Cavaliers,0,1,34,22,56,11,17,28,45,39,84,21,10,31,14,29,25,11,16,101,122
2016,2,21600751,2/3/2017,1610612738,Boston Celtics,1,1,1610612747,Los Angeles Lakers,0,0,26,21,47,13,22,35,39,43,82,22,6,28,9,37,28,9,16,101,113
2016,2,21600751,2/3/2017,1610612747,Los Angeles Lakers,0,0,1610612738,Boston Celtics,1,1,23,33,56,14,24,38,37,57,94,19,7,26,17,43,24,8,12,102,107
2014,2,21400991,3/16/2015,1610612757,Portland Trail Blazers,0,0,1610612764,Washington Wizards,1,1,28,33,61,8,20,28,36,53,89,17,3,20,16,38,19,5,10,93,97
2014,2,21400991,3/16/2015,1610612764,Washington Wizards,1,1,1610612757,Portland Trail Blazers,0,0,34,36,70,7,5,12,41,41,82,16,10,26,10,36,25,2,7,93,105
2018,2,21801227,4/10/2019,1610612742,Dallas Mavericks,0,0,1610612759,San Antonio Spurs,1,1,26,28,54,11,26,37,37,54,91,9,3,12,9,47,27,6,7,96,94
2018,2,21801227,4/10/2019,1610612759,San Antonio Spurs,1,1,1610612742,Dallas Mavericks,0,0,33,31,64,8,16,24,41,47,88,15,3,18,11,37,22,5,11,96,105
2018,2,21800653,1/15/2019,1610612737,Atlanta Hawks,1,1,1610612760,Oklahoma City Thunder,0,0,38,15,53,18,19,37,56,34,90,12,4,16,11,26,36,16,19,106,142
2018,2,21800653,1/15/2019,1610612760,Oklahoma City Thunder,0,0,1610612737,Atlanta Hawks,1,1,34,28,62,9,23,32,43,51,94,31,10,41,18,37,22,8,12,107,126
2018,2,21800499,12/25/2018,1610612738,Boston Celtics,1,1,1610612755,Philadelphia 76ers,0,0,31,36,67,14,27,41,45,63,108,17,3,20,16,48,21,6,9,113,121
2018,2,21800499,12/25/2018,1610612755,Philadelphia 76ers,0,0,1610612738,Boston Celtics,1,1,23,29,52,15,25,40,38,54,92,23,6,29,12,44,25,8,19,114,114
2018,2,21800429,12/15/2018,1610612753,Orlando Magic,1,1,1610612762,Utah Jazz,0,0,23,25,48,11,13,24,34,38,72,17,3,20,6,33,18,13,22,100,96
2018,2,21800429,12/15/2018,1610612762,Utah Jazz,0,0,1610612753,Orlando Magic,1,1,21,39,60,7,22,29,28,61,89,26,2,28,12,49,17,7,10,99,89
2020,2,22000132,1/8/2021,1610612758,Sacramento Kings,1,0,1610612761,Toronto Raptors,0,1,31,16,47,15,19,34,46,35,81,16,12,28,7,33,36,8,12,98,123
2020,2,22000132,1/8/2021,1610612761,Toronto Raptors,0,1,1610612758,Sacramento Kings,1,0,33,19,52,20,19,39,53,38,91,18,4,22,15,25,30,9,13,100,144
2021,2,22100329,12/2/2021,1610612749,Milwaukee Bucks,0,0,1610612761,Toronto Raptors,1,1,21,33,54,11,20,31,32,53,85,18,7,25,23,34,16,10,15,90,93
2021,2,22100329,12/2/2021,1610612761,Toronto Raptors,1,1,1610612749,Milwaukee Bucks,0,0,23,25,48,14,26,40,37,51,88,9,5,14,21,33,23,4,14,89,97
2017,2,21700121,11/3/2017,1610612754,Indiana Pacers,0,0,1610612755,Philadelphia 76ers,1,1,37,32,69,8,20,28,45,52,97,12,7,19,15,41,25,7,12,104,110
2017,2,21700121,11/3/2017,1610612755,Philadelphia 76ers,1,1,1610612754,Indiana Pacers,0,0,28,28,56,18,18,36,46,46,92,11,3,14,14,33,34,6,20,104,121
2014,2,21400990,3/16/2015,1610612754,Indiana Pacers,1,0,1610612761,Toronto Raptors,0,1,36,33,69,2,17,19,38,50,88,20,5,25,6,46,21,3,4,97,98
2014,2,21400990,3/16/2015,1610612761,Toronto Raptors,0,1,1610612754,Indiana Pacers,1,0,27,32,59,12,11,23,39,43,82,27,6,33,10,37,19,7,12,99,117
2014,2,21400395,12/20/2014,1610612762,Utah Jazz,0,0,1610612766,Charlotte Hornets,1,1,25,29,54,8,23,31,33,52,85,12,3,15,17,36,18,9,10,83,86
2014,2,21400395,12/20/2014,1610612766,Charlotte Hornets,1,1,1610612762,Utah Jazz,0,0,33,32,65,9,13,22,42,45,87,11,5,16,18,27,21,2,4,82,104
2018,2,21801075,3/21/2019,1610612743,Denver Nuggets,0,1,1610612764,Washington Wizards,1,0,32,25,57,14,16,30,46,41,87,7,4,11,10,34,30,4,8,91,113
2018,2,21801075,3/21/2019,1610612764,Washington Wizards,1,0,1610612743,Denver Nuggets,0,1,32,19,51,8,20,28,40,39,79,20,1,21,9,31,25,9,12,91,108
2021,2,22100328,12/2/2021,1610612741,Chicago Bulls,0,1,1610612752,New York Knicks,1,0,33,27,60,11,18,29,44,45,89,20,1,21,15,30,24,10,15,100,119
2021,2,22100328,12/2/2021,1610612752,New York Knicks,1,0,1610612741,Chicago Bulls,0,1,33,23,56,9,17,26,42,40,82,22,5,27,13,30,19,10,18,101,115
2020,2,22000131,1/8/2021,1610612741,Chicago Bulls,0,0,1610612747,Los Angeles Lakers,1,1,36,29,65,10,16,26,46,45,91,13,1,14,13,33,26,3,13,95,115
2020,2,22000131,1/8/2021,1610612747,Los Angeles Lakers,1,1,1610612741,Chicago Bulls,0,0,29,23,52,12,17,29,41,40,81,23,4,27,11,32,21,10,15,97,117
2019,2,21900346,12/9/2019,1610612745,Houston Rockets,1,0,1610612758,Sacramento Kings,0,1,24,10,34,17,33,50,41,43,84,19,4,23,15,29,25,14,19,99,118
2019,2,21900346,12/9/2019,1610612758,Sacramento Kings,0,1,1610612745,Houston Rockets,1,0,20,23,43,20,25,45,40,48,88,19,3,22,9,42,24,4,10,99,119
2016,2,21600267,11/30/2016,1610612738,Boston Celtics,1,0,1610612765,Detroit Pistons,0,1,25,24,49,15,27,42,40,51,91,19,1,20,12,40,26,4,6,95,114
2016,2,21600267,11/30/2016,1610612765,Detroit Pistons,0,1,1610612738,Boston Celtics,1,0,39,28,67,9,11,20,48,39,87,16,5,21,15,26,28,6,11,94,121
2014,2,21400394,12/20/2014,1610612740,New Orleans Pelicans,1,0,1610612757,Portland Trail Blazers,0,1,27,43,70,3,12,15,30,55,85,25,3,28,21,35,15,11,17,96,88
2014,2,21400394,12/20/2014,1610612757,Portland Trail Blazers,0,1,1610612740,New Orleans Pelicans,1,0,39,26,65,9,16,25,48,42,90,9,6,15,14,32,25,7,13,95,114
2022,2,22201216,4/9/2023,1610612738,Boston Celtics,1,1,1610612737,Atlanta Hawks,0,0,17,18,35,25,29,54,42,47,89,11,3,14,14,34,33,11,15,97,120
2018,2,21800937,3/2/2019,1610612748,Miami Heat,1,1,1610612751,Brooklyn Nets,0,0,30,26,56,14,20,34,44,46,90,15,7,22,15,33,36,6,12,98,117
2018,2,21800937,3/2/2019,1610612751,Brooklyn Nets,0,0,1610612748,Miami Heat,1,1,22,24,46,9,33,42,31,57,88,17,5,22,14,46,20,5,12,97,88
2022,2,22201223,4/9/2023,1610612765,Detroit Pistons,0,0,1610612741,Chicago Bulls,1,1,22,30,52,9,24,33,31,54,85,10,3,13,18,37,20,15,25,99,81
2021,2,22100327,12/1/2021,1610612746,LA Clippers,1,0,1610612758,Sacramento Kings,0,1,38,31,69,9,22,31,47,53,100,12,4,16,20,35,35,8,13,99,115
2021,2,22100327,12/1/2021,1610612758,Sacramento Kings,0,1,1610612746,LA Clippers,1,0,31,19,50,15,23,38,46,42,88,17,3,20,10,33,28,8,12,100,124
2023,2,22300340,12/16/2023,1610612760,Oklahoma City Thunder,0,1,1610612743,Denver Nuggets,1,0,36,27,63,7,14,21,43,41,84,25,5,30,12,32,22,5,11,98,118
2017,2,21700120,11/3/2017,1610612741,Chicago Bulls,0,1,1610612753,Orlando Magic,1,0,26,30,56,14,15,29,40,45,85,11,1,12,13,32,23,6,17,95,105
2017,2,21700120,11/3/2017,1610612753,Orlando Magic,1,0,1610612741,Chicago Bulls,0,1,25,26,51,10,25,35,35,51,86,3,2,5,11,42,23,6,16,95,83
2016,2,21600750,2/3/2017,1610612760,Oklahoma City Thunder,1,1,1610612763,Memphis Grizzlies,0,0,25,29,54,13,13,26,38,42,80,25,8,33,22,22,21,10,20,95,114
2016,2,21600750,2/3/2017,1610612763,Memphis Grizzlies,0,0,1610612760,Oklahoma City Thunder,1,1,37,27,64,3,16,19,40,43,83,19,3,22,11,34,21,7,12,95,102
2020,2,22000978,5/3/2021,1610612737,Atlanta Hawks,1,1,1610612757,Portland Trail Blazers,0,0,24,19,43,20,21,41,44,40,84,15,3,18,7,33,32,7,11,97,123
2023,2,22300267,11/30/2023,1610612754,Indiana Pacers,0,0,1610612748,Miami Heat,1,1,39,16,55,11,32,43,50,48,98,21,11,32,15,39,30,4,10,106,132
2020,2,22000978,5/3/2021,1610612757,Portland Trail Blazers,0,0,1610612737,Atlanta Hawks,1,1,26,28,54,17,24,41,43,52,95,11,3,14,11,44,25,6,8,99,114
2018,2,21801226,4/10/2019,1610612749,Milwaukee Bucks,1,0,1610612760,Oklahoma City Thunder,0,1,28,26,54,15,31,46,43,57,100,15,6,21,15,45,27,7,15,109,116
2018,2,21801226,4/10/2019,1610612760,Oklahoma City Thunder,0,1,1610612749,Milwaukee Bucks,1,0,25,20,45,23,31,54,48,51,99,8,5,13,9,45,40,7,13,109,127
2023,2,22300413,12/26/2023,1610612758,Sacramento Kings,0,0,1610612757,Portland Trail Blazers,1,1,35,16,51,10,32,42,45,48,93,13,3,16,16,32,25,5,12,95,113
2018,2,21800428,12/14/2018,1610612744,Golden State Warriors,0,1,1610612758,Sacramento Kings,1,0,29,27,56,15,25,40,44,52,96,27,9,36,17,38,32,6,18,115,130
2018,2,21800428,12/14/2018,1610612758,Sacramento Kings,1,0,1610612744,Golden State Warriors,0,1,30,22,52,15,29,44,45,51,96,20,5,25,7,46,33,5,13,114,125
2018,2,21800360,12/5/2018,1610612746,LA Clippers,0,0,1610612763,Memphis Grizzlies,1,1,17,34,51,8,15,23,25,49,74,28,7,35,14,38,16,9,19,97,86
2020,2,22000130,1/8/2021,1610612744,Golden State Warriors,1,1,1610612746,LA Clippers,0,0,20,21,41,20,21,41,40,42,82,15,3,18,11,32,25,6,16,96,115
2020,2,22000130,1/8/2021,1610612746,LA Clippers,0,0,1610612744,Golden State Warriors,1,1,26,26,52,14,17,31,40,43,83,11,2,13,13,30,23,13,19,96,105
2021,2,22100326,12/1/2021,1610612745,Houston Rockets,0,1,1610612760,Oklahoma City Thunder,1,0,25,17,42,15,22,37,40,39,79,19,3,22,13,27,25,9,19,97,114
2021,2,22100326,12/1/2021,1610612760,Oklahoma City Thunder,1,0,1610612745,Houston Rockets,0,1,32,21,53,8,24,32,40,45,85,22,7,29,15,33,16,9,13,97,110
2017,2,21700119,11/3/2017,1610612749,Milwaukee Bucks,0,0,1610612765,Detroit Pistons,1,1,29,29,58,10,15,25,39,44,83,8,1,9,10,34,27,10,14,92,96
2017,2,21700119,11/3/2017,1610612765,Detroit Pistons,1,1,1610612749,Milwaukee Bucks,0,0,29,23,52,8,18,26,37,41,78,23,5,28,13,31,21,6,14,91,105
2019,2,21900113,11/7/2019,1610612759,San Antonio Spurs,1,1,1610612760,Oklahoma City Thunder,0,0,42,32,74,9,11,20,51,43,94,10,1,11,15,28,32,7,13,97,121
2019,2,21900113,11/7/2019,1610612760,Oklahoma City Thunder,0,0,1610612759,San Antonio Spurs,1,1,32,27,59,10,11,21,42,38,80,18,6,24,6,36,26,5,13,97,112
2020,2,22000977,5/3/2021,1610612740,New Orleans Pelicans,1,0,1610612744,Golden State Warriors,0,1,34,31,65,5,20,25,39,51,90,25,7,32,16,38,20,9,17,106,108
2020,2,22000977,5/3/2021,1610612744,Golden State Warriors,0,1,1610612740,New Orleans Pelicans,1,0,30,14,44,17,27,44,47,41,88,12,2,14,6,36,31,6,15,107,123
2022,2,22201217,4/9/2023,1610612755,Philadelphia 76ers,0,1,1610612751,Brooklyn Nets,1,0,39,30,69,14,18,32,53,48,101,14,5,19,18,33,31,6,13,103,134
2016,2,21600266,1/30/2017,1610612755,Philadelphia 76ers,1,1,1610612758,Sacramento Kings,0,0,34,18,52,11,20,31,45,38,83,21,5,26,14,26,32,7,16,98,122
2016,2,21600266,1/30/2017,1610612758,Sacramento Kings,0,0,1610612755,Philadelphia 76ers,1,1,28,17,45,13,16,29,41,33,74,24,5,29,13,22,31,13,21,97,119
2022,2,22201171,4/2/2023,1610612745,Houston Rockets,1,0,1610612747,Los Angeles Lakers,0,1,31,37,68,13,21,34,44,58,102,8,2,10,18,42,23,4,10,98,109
2023,2,22300387,12/22/2023,1610612758,Sacramento Kings,1,1,1610612756,Phoenix Suns,0,0,32,13,45,12,26,38,44,39,83,20,6,26,10,32,32,8,14,98,120
2021,2,22100325,12/1/2021,1610612740,New Orleans Pelicans,1,0,1610612742,Dallas Mavericks,0,1,27,25,52,13,24,37,40,49,89,14,2,16,18,32,22,7,16,93,107
2021,2,22100325,12/1/2021,1610612742,Dallas Mavericks,0,1,1610612740,New Orleans Pelicans,1,0,39,10,49,18,16,34,57,26,83,7,2,9,11,17,32,10,18,94,139
2019,2,21900345,12/9/2019,1610612741,Chicago Bulls,1,0,1610612761,Toronto Raptors,0,1,23,20,43,12,34,46,35,54,89,10,4,14,12,43,30,8,17,101,92
2019,2,21900345,12/9/2019,1610612761,Toronto Raptors,0,1,1610612741,Chicago Bulls,1,0,27,34,61,7,22,29,34,56,90,18,8,26,20,39,19,6,17,102,93
2017,2,21700118,11/2/2017,1610612747,Los Angeles Lakers,0,0,1610612757,Portland Trail Blazers,1,1,39,22,61,4,14,18,43,36,79,20,7,27,5,33,16,7,11,97,110
2017,2,21700118,11/2/2017,1610612757,Portland Trail Blazers,1,1,1610612747,Los Angeles Lakers,0,0,31,33,64,9,13,22,40,46,86,24,3,27,14,33,22,8,12,97,113
2014,2,21400989,3/15/2015,1610612737,Atlanta Hawks,0,1,1610612747,Los Angeles Lakers,1,0,29,24,53,5,18,23,34,42,76,18,9,27,11,36,25,6,13,91,91
2014,2,21400989,3/15/2015,1610612747,Los Angeles Lakers,1,0,1610612737,Atlanta Hawks,0,1,27,40,67,7,11,18,34,51,85,11,4,15,24,30,21,9,22,90,86
2014,2,21400393,12/20/2014,1610612752,New York Knicks,1,0,1610612756,Phoenix Suns,0,1,28,38,66,7,15,22,35,53,88,13,3,16,20,35,17,10,15,90,90
2014,2,21400393,12/20/2014,1610612756,Phoenix Suns,0,1,1610612752,New York Knicks,1,0,25,28,53,10,15,25,35,43,78,19,4,23,15,29,15,11,16,90,99
2022,2,22201219,4/9/2023,1610612748,Miami Heat,1,1,1610612753,Orlando Magic,0,0,27,12,39,18,26,44,45,38,83,15,5,20,10,31,30,13,18,99,123
2023,2,22300454,1/1/2024,1610612754,Indiana Pacers,0,1,1610612749,Milwaukee Bucks,1,0,38,24,62,5,30,35,43,54,97,31,7,38,18,39,23,4,7,103,122
2018,2,21800824,2/8/2019,1610612748,Miami Heat,0,0,1610612758,Sacramento Kings,1,1,27,28,55,11,22,33,38,50,88,9,10,19,15,40,26,11,20,102,96
2018,2,21800824,2/8/2019,1610612758,Sacramento Kings,1,1,1610612748,Miami Heat,0,0,28,36,64,9,17,26,37,53,90,19,6,25,14,42,18,6,14,102,102
2020,2,22000129,1/8/2021,1610612749,Milwaukee Bucks,1,0,1610612762,Utah Jazz,0,1,31,25,56,13,29,42,44,54,98,17,4,21,15,43,18,6,12,103,118
2020,2,22000129,1/8/2021,1610612762,Utah Jazz,0,1,1610612749,Milwaukee Bucks,1,0,24,20,44,25,28,53,49,48,97,8,5,13,12,38,31,5,10,101,131
2017,2,21700117,11/2/2017,1610612744,Golden State Warriors,0,1,1610612759,San Antonio Spurs,1,0,29,26,55,14,14,28,43,40,83,12,4,16,8,34,30,6,14,101,112
2017,2,21700117,11/2/2017,1610612759,San Antonio Spurs,1,0,1610612744,Golden State Warriors,0,1,27,36,63,7,17,24,34,53,87,17,6,23,19,38,19,11,19,100,92
2020,2,22000976,5/3/2021,1610612754,Indiana Pacers,0,0,1610612764,Washington Wizards,1,1,39,41,80,14,13,27,53,54,107,21,4,25,17,39,28,10,17,119,141
2020,2,22000976,5/3/2021,1610612764,Washington Wizards,1,1,1610612754,Indiana Pacers,0,0,54,27,81,9,13,22,63,40,103,19,5,24,12,32,50,8,17,117,154
2018,2,21801074,3/21/2019,1610612750,Minnesota Timberwolves,0,0,1610612766,Charlotte Hornets,1,1,29,31,60,10,18,28,39,49,88,18,11,29,12,42,23,5,13,103,106
2018,2,21801074,3/21/2019,1610612766,Charlotte Hornets,1,1,1610612750,Minnesota Timberwolves,0,0,34,37,71,9,20,29,43,57,100,18,6,24,18,43,26,6,10,102,113
2018,2,21800936,3/2/2019,1610612753,Orlando Magic,0,1,1610612754,Indiana Pacers,1,0,36,27,63,10,18,28,46,45,91,15,4,19,14,35,28,5,9,95,117
2018,2,21800936,3/2/2019,1610612754,Indiana Pacers,1,0,1610612753,Orlando Magic,0,1,35,15,50,7,20,27,42,35,77,21,3,24,5,31,31,7,11,96,112
2022,2,22201219,4/9/2023,1610612753,Orlando Magic,0,0,1610612748,Miami Heat,1,1,21,22,43,17,30,47,38,52,90,17,7,24,15,41,29,10,14,99,110
2023,2,22300386,12/22/2023,1610612744,Golden State Warriors,1,1,1610612764,Washington Wizards,0,0,29,23,52,18,27,45,47,50,97,17,3,20,17,34,33,7,12,102,129
2021,2,22100324,12/1/2021,1610612749,Milwaukee Bucks,1,1,1610612766,Charlotte Hornets,0,0,32,26,58,14,22,36,46,48,94,21,5,26,12,38,29,8,13,107,127
2021,2,22100324,12/1/2021,1610612766,Charlotte Hornets,0,0,1610612749,Milwaukee Bucks,1,1,22,14,36,21,30,51,43,44,87,18,3,21,9,36,30,10,17,108,125
2020,2,22000128,1/8/2021,1610612751,Brooklyn Nets,0,0,1610612763,Memphis Grizzlies,1,1,24,26,50,14,17,31,38,43,81,20,1,21,7,36,26,14,21,102,110
2020,2,22000128,1/8/2021,1610612763,Memphis Grizzlies,1,1,1610612751,Brooklyn Nets,0,0,32,34,66,13,19,32,45,53,98,12,2,14,17,38,29,6,14,101,115
2017,2,21700116,11/1/2017,1610612742,Dallas Mavericks,0,0,1610612746,LA Clippers,1,1,23,30,53,12,24,36,35,54,89,16,4,20,12,44,20,9,14,101,98
2017,2,21700116,11/1/2017,1610612746,LA Clippers,1,1,1610612742,Dallas Mavericks,0,0,28,22,50,13,15,28,41,37,78,24,5,29,9,29,27,8,16,100,119
2019,2,21900112,11/7/2019,1610612738,Boston Celtics,0,1,1610612766,Charlotte Hornets,1,0,30,30,60,10,23,33,40,53,93,18,5,23,13,43,29,7,13,105,108
2014,2,21400988,3/15/2015,1610612752,New York Knicks,0,0,1610612756,Phoenix Suns,1,1,27,32,59,5,9,14,32,41,73,20,10,30,8,41,22,9,13,92,89
2019,2,21900112,11/7/2019,1610612766,Charlotte Hornets,1,0,1610612738,Boston Celtics,0,1,27,28,55,6,25,31,33,53,86,15,6,21,13,43,21,13,21,105,87
2016,2,21600749,2/3/2017,1610612741,Chicago Bulls,0,0,1610612745,Houston Rockets,1,1,40,35,75,8,17,25,48,52,100,13,5,18,15,42,30,7,15,106,117
2016,2,21600749,2/3/2017,1610612745,Houston Rockets,1,1,1610612741,Chicago Bulls,0,0,28,27,55,16,27,43,44,54,98,17,8,25,18,40,24,7,12,107,121
2016,2,21600265,11/29/2016,1610612745,Houston Rockets,0,0,1610612762,Utah Jazz,1,1,26,35,61,11,19,30,37,54,91,16,6,22,20,36,14,4,7,89,101
2022,2,22201171,4/2/2023,1610612747,Los Angeles Lakers,0,1,1610612745,Houston Rockets,1,0,43,20,63,9,21,30,52,41,93,21,7,28,12,32,36,4,6,98,134
2016,2,21600265,11/29/2016,1610612762,Utah Jazz,1,1,1610612745,Houston Rockets,0,0,26,20,46,15,13,28,41,33,74,23,4,27,10,23,23,5,10,87,120
2022,2,22201220,4/9/2023,1610612754,Indiana Pacers,0,1,1610612752,New York Knicks,1,0,27,28,55,19,15,34,46,43,89,30,8,38,9,37,33,8,15,110,141
2018,2,21801225,4/10/2019,1610612744,Golden State Warriors,0,0,1610612763,Memphis Grizzlies,1,1,33,29,62,13,17,30,46,46,92,12,2,14,12,35,32,9,14,101,117
2018,2,21801225,4/10/2019,1610612763,Memphis Grizzlies,1,1,1610612744,Golden State Warriors,0,0,27,25,52,21,25,46,48,50,98,15,3,18,18,34,25,3,11,100,132
2023,2,22300358,12/18/2023,1610612758,Sacramento Kings,1,1,1610612764,Washington Wizards,0,0,36,21,57,17,26,43,53,47,100,20,6,26,14,35,35,3,7,104,143
2018,2,21801073,3/20/2019,1610612742,Dallas Mavericks,0,0,1610612757,Portland Trail Blazers,1,1,33,24,57,10,20,30,43,44,87,22,3,25,8,37,20,6,14,104,118
2018,2,21801073,3/20/2019,1610612757,Portland Trail Blazers,1,1,1610612742,Dallas Mavericks,0,0,29,26,55,16,20,36,45,46,91,20,5,25,14,34,23,8,14,103,126
2023,2,22300035,11/17/2023,1610612756,Phoenix Suns,0,1,1610612762,Utah Jazz,1,0,27,26,53,18,15,33,45,41,86,23,3,26,12,31,35,3,9,96,131
2023,2,22300386,12/22/2023,1610612764,Washington Wizards,0,0,1610612744,Golden State Warriors,1,1,33,29,62,11,24,35,44,53,97,19,5,24,12,45,25,5,9,102,118
2023,2,22300414,12/26/2023,1610612766,Charlotte Hornets,0,0,1610612746,LA Clippers,1,1,37,27,64,6,23,29,43,50,93,12,4,16,14,37,31,7,11,98,104
2021,2,22100323,12/1/2021,1610612739,Cleveland Cavaliers,0,1,1610612748,Miami Heat,1,0,21,16,37,16,15,31,37,31,68,21,2,23,8,24,27,8,21,93,111
2021,2,22100323,12/1/2021,1610612748,Miami Heat,1,0,1610612739,Cleveland Cavaliers,0,1,20,28,48,12,25,37,32,53,85,9,4,13,13,43,21,8,13,92,85
2019,2,21900344,12/9/2019,1610612738,Boston Celtics,1,1,1610612739,Cleveland Cavaliers,0,0,30,21,51,15,12,27,45,33,78,5,3,8,7,27,22,8,18,92,110
2019,2,21900344,12/9/2019,1610612739,Cleveland Cavaliers,0,0,1610612738,Boston Celtics,1,1,29,31,60,7,24,31,36,55,91,9,10,19,26,35,18,8,18,93,88
2014,2,21400988,3/15/2015,1610612756,Phoenix Suns,1,1,1610612752,New York Knicks,0,0,35,30,65,6,12,18,41,42,83,14,9,23,16,32,24,10,13,92,102
2014,2,21400392,12/19/2014,1610612747,Los Angeles Lakers,1,0,1610612760,Oklahoma City Thunder,0,1,31,29,60,10,15,25,41,44,85,11,4,15,12,36,28,5,11,93,103
2014,2,21400392,12/19/2014,1610612760,Oklahoma City Thunder,0,1,1610612747,Los Angeles Lakers,1,0,29,36,65,8,13,21,37,49,86,22,7,29,12,40,21,3,7,93,104
2020,2,22000975,5/3/2021,1610612753,Orlando Magic,0,1,1610612765,Detroit Pistons,1,0,35,30,65,10,13,23,45,43,88,19,6,25,11,34,27,8,11,98,119
2020,2,22000975,5/3/2021,1610612765,Detroit Pistons,1,0,1610612753,Orlando Magic,0,1,33,25,58,11,24,35,44,49,93,13,5,18,13,39,24,6,11,98,112
2018,2,21801224,4/10/2019,1610612741,Chicago Bulls,0,0,1610612755,Philadelphia 76ers,1,1,36,35,71,9,15,24,45,50,95,10,5,15,15,39,21,4,8,95,109
2018,2,21801224,4/10/2019,1610612755,Philadelphia 76ers,1,1,1610612741,Chicago Bulls,0,0,40,27,67,12,14,26,52,41,93,9,6,15,12,33,30,4,7,94,125
2018,2,21800731,1/26/2019,1610612754,Indiana Pacers,0,0,1610612763,Memphis Grizzlies,1,1,23,24,47,9,18,27,32,42,74,30,6,36,14,31,20,8,18,98,103
2018,2,21800731,1/26/2019,1610612763,Memphis Grizzlies,1,1,1610612754,Indiana Pacers,0,0,30,22,52,9,19,28,39,41,80,19,9,28,10,36,29,7,14,96,106
2020,2,22000127,1/8/2021,1610612745,Houston Rockets,1,1,1610612753,Orlando Magic,0,0,29,15,44,22,25,47,51,40,91,8,3,11,9,33,34,5,8,96,132
2020,2,22000127,1/8/2021,1610612753,Orlando Magic,0,0,1610612745,Houston Rockets,1,1,26,34,60,8,21,29,34,55,89,14,2,16,14,43,17,6,13,95,90
2017,2,21700115,11/1/2017,1610612757,Portland Trail Blazers,0,0,1610612762,Utah Jazz,1,1,28,31,59,9,25,34,37,56,93,20,7,27,13,48,17,9,17,109,103
2017,2,21700115,11/1/2017,1610612762,Utah Jazz,1,1,1610612757,Portland Trail Blazers,0,0,21,40,61,13,16,29,34,56,90,31,5,36,13,46,16,8,14,107,112
2022,2,22201172,4/2/2023,1610612760,Oklahoma City Thunder,1,0,1610612756,Phoenix Suns,0,1,25,31,56,11,21,32,36,52,88,35,6,41,20,36,21,4,8,98,118
2023,2,22300269,11/30/2023,1610612741,Chicago Bulls,1,1,1610612749,Milwaukee Bucks,0,0,32,29,61,13,24,37,45,53,98,17,5,22,20,37,32,12,21,111,120
2023,2,22300341,12/16/2023,1610612757,Portland Trail Blazers,1,0,1610612742,Dallas Mavericks,0,1,40,22,62,7,25,32,47,47,94,19,3,22,11,37,17,7,11,102,120
2023,2,22300414,12/26/2023,1610612746,LA Clippers,1,1,1610612766,Charlotte Hornets,0,0,26,25,51,14,20,34,40,45,85,19,6,25,12,36,24,8,13,97,113
2023,2,22300453,1/1/2024,1610612745,Houston Rockets,1,1,1610612765,Detroit Pistons,0,0,36,20,56,15,20,35,51,40,91,19,5,24,9,33,34,3,10,103,136
2018,2,21800935,3/2/2019,1610612739,Cleveland Cavaliers,1,0,1610612765,Detroit Pistons,0,1,14,31,45,13,21,34,27,52,79,26,6,32,12,44,15,5,12,95,93
2018,2,21800935,3/2/2019,1610612765,Detroit Pistons,0,1,1610612739,Cleveland Cavaliers,1,0,27,23,50,20,17,37,47,40,87,15,2,17,13,27,27,7,12,95,129
2018,2,21800823,2/8/2019,1610612740,New Orleans Pelicans,1,1,1610612750,Minnesota Timberwolves,0,0,34,27,61,9,21,30,43,48,91,27,1,28,10,39,27,6,11,108,122
2018,2,21800823,2/8/2019,1610612750,Minnesota Timberwolves,0,0,1610612740,New Orleans Pelicans,1,1,37,33,70,9,12,21,46,45,91,16,6,22,10,38,22,11,16,105,117
2023,2,22300271,11/30/2023,1610612747,Los Angeles Lakers,0,0,1610612760,Oklahoma City Thunder,1,1,25,23,48,11,22,33,36,45,81,27,5,32,7,40,24,9,14,102,110
2021,2,22100322,12/1/2021,1610612738,Boston Celtics,1,1,1610612755,Philadelphia 76ers,0,0,22,29,51,11,17,28,33,46,79,11,4,15,9,39,18,7,13,91,88
2021,2,22100322,12/1/2021,1610612755,Philadelphia 76ers,0,0,1610612738,Boston Celtics,1,1,25,33,58,8,23,31,33,56,89,13,4,17,13,44,20,5,7,92,87
2020,2,22000126,1/8/2021,1610612740,New Orleans Pelicans,1,0,1610612766,Charlotte Hornets,0,1,23,16,39,15,23,38,38,39,77,19,7,26,12,31,29,10,19,96,110
2020,2,22000126,1/8/2021,1610612766,Charlotte Hornets,0,1,1610612740,New Orleans Pelicans,1,0,25,20,45,16,26,42,41,46,87,20,5,25,19,28,33,6,15,95,118
2020,2,22000974,5/2/2021,1610612747,Los Angeles Lakers,1,0,1610612761,Toronto Raptors,0,1,30,26,56,11,18,29,41,44,85,21,10,31,11,38,32,11,14,102,114
2020,2,22000974,5/2/2021,1610612761,Toronto Raptors,0,1,1610612747,Los Angeles Lakers,1,0,27,29,56,15,23,38,42,52,94,22,9,31,19,39,24,7,13,103,121
2023,2,22300341,12/16/2023,1610612742,Dallas Mavericks,0,1,1610612757,Portland Trail Blazers,1,0,32,18,50,16,31,47,48,49,97,19,2,21,14,37,27,8,13,104,131
2016,2,21600748,2/3/2017,1610612750,Minnesota Timberwolves,0,0,1610612765,Detroit Pistons,1,1,39,33,72,5,12,17,44,45,89,15,4,19,14,34,25,7,13,96,108
2016,2,21600748,2/3/2017,1610612765,Detroit Pistons,1,1,1610612750,Minnesota Timberwolves,0,0,33,39,72,11,15,26,44,54,98,17,5,22,23,32,24,5,11,97,116
2016,2,21600264,11/29/2016,1610612753,Orlando Magic,0,1,1610612759,San Antonio Spurs,1,0,33,38,71,6,9,15,39,47,86,11,1,12,12,36,25,9,13,93,95
2016,2,21600264,11/29/2016,1610612759,San Antonio Spurs,1,0,1610612753,Orlando Magic,0,1,23,33,56,5,15,20,28,48,76,22,4,26,16,33,19,12,19,92,83
2014,2,21400391,12/19/2014,1610612743,Denver Nuggets,1,1,1610612746,LA Clippers,0,0,27,24,51,11,18,29,38,42,80,22,8,30,16,30,30,14,21,98,109
2014,2,21400391,12/19/2014,1610612746,LA Clippers,0,0,1610612743,Denver Nuggets,1,1,36,31,67,3,15,18,39,46,85,25,8,33,16,34,21,6,11,98,106
2023,2,22300407,12/26/2023,1610612753,Orlando Magic,0,1,1610612764,Washington Wizards,1,0,37,30,67,12,14,26,49,44,93,17,8,25,14,37,30,10,16,106,127
2023,2,22300358,12/18/2023,1610612764,Washington Wizards,0,0,1610612758,Sacramento Kings,1,1,26,21,47,18,20,38,44,41,85,25,5,30,7,36,26,8,12,104,131
2023,2,22300453,1/1/2024,1610612765,Detroit Pistons,0,0,1610612745,Houston Rockets,1,1,27,27,54,13,16,29,40,43,83,20,7,27,11,35,27,11,18,103,113
2017,2,21700114,11/1/2017,1610612743,Denver Nuggets,1,1,1610612761,Toronto Raptors,0,0,31,25,56,16,16,32,47,41,88,19,10,29,14,31,35,7,12,99,129
2017,2,21700114,11/1/2017,1610612761,Toronto Raptors,0,0,1610612743,Denver Nuggets,1,1,31,23,54,11,20,31,42,43,85,16,9,25,10,37,20,9,14,100,111
2019,2,21900343,12/9/2019,1610612746,LA Clippers,0,1,1610612754,Indiana Pacers,1,0,30,35,65,10,22,32,40,57,97,20,7,27,13,46,19,7,11,107,110
2019,2,21900343,12/9/2019,1610612754,Indiana Pacers,1,0,1610612746,LA Clippers,0,1,24,38,62,10,25,35,34,63,97,21,7,28,18,47,16,7,13,106,99
2014,2,21400987,3/15/2015,1610612757,Portland Trail Blazers,0,1,1610612761,Toronto Raptors,1,0,32,25,57,13,16,29,45,41,86,10,6,16,12,33,27,5,10,92,113
2014,2,21400987,3/15/2015,1610612761,Toronto Raptors,1,0,1610612757,Portland Trail Blazers,0,1,32,28,60,5,13,18,37,41,78,18,5,23,12,33,20,6,16,92,97
2018,2,21801223,4/10/2019,1610612752,New York Knicks,1,0,1610612765,Detroit Pistons,0,1,22,25,47,9,21,30,31,46,77,18,7,25,4,47,23,5,11,95,89
2018,2,21801223,4/10/2019,1610612765,Detroit Pistons,0,1,1610612752,New York Knicks,1,0,27,25,52,14,19,33,41,44,85,19,1,20,14,31,25,7,14,95,115
2021,2,22100321,12/1/2021,1610612750,Minnesota Timberwolves,0,0,1610612764,Washington Wizards,1,1,26,25,51,11,26,37,37,51,88,22,4,26,14,40,15,6,13,99,107
2021,2,22100321,12/1/2021,1610612764,Washington Wizards,1,1,1610612750,Minnesota Timberwolves,0,0,35,24,59,10,22,32,45,46,91,15,6,21,17,32,34,3,14,100,115
2020,2,22000125,1/8/2021,1610612752,New York Knicks,1,0,1610612760,Oklahoma City Thunder,0,1,25,44,69,9,18,27,34,62,96,12,8,20,15,52,19,2,5,95,89
2020,2,22000125,1/8/2021,1610612760,Oklahoma City Thunder,0,1,1610612752,New York Knicks,1,0,27,26,53,11,23,34,38,49,87,14,7,21,14,38,16,8,11,94,101
2017,2,21700113,11/1/2017,1610612740,New Orleans Pelicans,1,0,1610612750,Minnesota Timberwolves,0,1,28,25,53,8,23,31,36,48,84,18,3,21,13,36,27,13,19,103,98
2017,2,21700113,11/1/2017,1610612750,Minnesota Timberwolves,0,1,1610612740,New Orleans Pelicans,1,0,35,26,61,6,16,22,41,42,83,16,8,24,14,30,20,13,22,102,104
2019,2,21900111,11/6/2019,1610612746,LA Clippers,1,0,1610612749,Milwaukee Bucks,0,1,28,39,67,13,18,31,41,57,98,29,7,36,18,42,21,7,19,115,124
2019,2,21900111,11/6/2019,1610612749,Milwaukee Bucks,0,1,1610612746,LA Clippers,1,0,24,25,49,18,31,49,42,56,98,27,7,34,15,42,18,4,15,116,129
2020,2,22000973,5/2/2021,1610612755,Philadelphia 76ers,0,1,1610612759,San Antonio Spurs,1,0,31,33,64,11,19,30,42,52,94,18,7,25,17,40,23,9,13,103,113
2020,2,22000973,5/2/2021,1610612759,San Antonio Spurs,1,0,1610612755,Philadelphia 76ers,0,1,31,34,65,12,19,31,43,53,96,13,4,17,16,39,20,7,14,102,111
2016,2,21600263,11/29/2016,1610612740,New Orleans Pelicans,1,1,1610612747,Los Angeles Lakers,0,0,30,27,57,8,23,31,38,50,88,21,4,25,15,38,24,8,9,95,105
2016,2,21600263,11/29/2016,1610612747,Los Angeles Lakers,0,0,1610612740,New Orleans Pelicans,1,1,32,25,57,5,25,30,37,50,87,9,9,18,12,43,26,10,12,95,88
2023,2,22300043,11/24/2023,1610612738,Boston Celtics,0,0,1610612753,Orlando Magic,1,1,24,23,47,7,22,29,31,45,76,27,10,37,8,40,17,5,15,100,96
2018,2,21801072,3/20/2019,1610612760,Oklahoma City Thunder,1,0,1610612761,Toronto Raptors,0,1,30,30,60,13,30,43,43,60,103,15,14,29,22,47,22,11,17,111,114
2023,2,22300359,12/18/2023,1610612752,New York Knicks,0,1,1610612747,Los Angeles Lakers,1,0,32,26,58,10,20,30,42,46,88,20,3,23,12,36,21,9,16,101,114
2018,2,21801072,3/20/2019,1610612761,Toronto Raptors,0,1,1610612760,Oklahoma City Thunder,1,0,31,20,51,14,22,36,45,42,87,19,2,21,7,35,30,6,19,110,123
2018,2,21800730,1/26/2019,1610612740,New Orleans Pelicans,1,0,1610612759,San Antonio Spurs,0,1,38,31,69,7,20,27,45,51,96,17,7,24,12,44,26,5,8,102,114
2018,2,21800730,1/26/2019,1610612759,San Antonio Spurs,0,1,1610612740,New Orleans Pelicans,1,0,36,31,67,11,13,24,47,44,91,21,4,25,12,33,30,6,10,102,126
2021,2,22100320,12/1/2021,1610612743,Denver Nuggets,0,0,1610612753,Orlando Magic,1,1,29,17,46,10,24,34,39,41,80,15,6,21,8,39,22,8,15,98,103
2021,2,22100320,12/1/2021,1610612753,Orlando Magic,1,1,1610612743,Denver Nuggets,0,0,38,16,54,6,21,27,44,37,81,14,5,19,4,36,26,5,13,99,108
2020,2,22000124,1/8/2021,1610612738,Boston Celtics,1,1,1610612764,Washington Wizards,0,0,29,25,54,12,20,32,41,45,86,22,8,30,16,34,21,9,21,105,116
2020,2,22000124,1/8/2021,1610612764,Washington Wizards,0,0,1610612738,Boston Celtics,1,1,30,29,59,11,18,29,41,47,88,14,2,16,8,39,22,11,17,104,107
2017,2,21700112,11/1/2017,1610612753,Orlando Magic,0,1,1610612763,Memphis Grizzlies,1,0,25,21,46,13,16,29,38,37,75,12,2,14,8,30,25,12,24,96,101
2017,2,21700112,11/1/2017,1610612763,Memphis Grizzlies,1,0,1610612753,Orlando Magic,0,1,29,23,52,10,20,30,39,43,82,11,5,16,9,36,21,6,15,96,99
2014,2,21400986,3/15/2015,1610612750,Minnesota Timberwolves,0,0,1610612759,San Antonio Spurs,1,1,31,40,71,7,8,15,38,48,86,14,4,18,14,37,25,13,16,95,97
2014,2,21400986,3/15/2015,1610612759,San Antonio Spurs,1,1,1610612750,Minnesota Timberwolves,0,0,37,25,62,12,10,22,49,35,84,13,2,15,8,29,38,8,14,95,123
2014,2,21400390,12/19/2014,1610612757,Portland Trail Blazers,0,1,1610612759,San Antonio Spurs,1,0,34,41,75,13,22,35,47,63,110,22,1,23,21,43,18,8,14,115,129
2014,2,21400390,12/19/2014,1610612759,San Antonio Spurs,1,0,1610612757,Portland Trail Blazers,0,1,37,52,89,8,12,20,45,64,109,21,5,26,22,44,24,12,20,119,119
2022,2,22201172,4/2/2023,1610612756,Phoenix Suns,0,1,1610612760,Oklahoma City Thunder,1,0,33,14,47,13,21,34,46,35,81,23,5,28,7,30,31,7,13,98,128
2023,2,22300043,11/24/2023,1610612753,Orlando Magic,1,1,1610612738,Boston Celtics,0,0,32,25,57,11,17,28,43,42,85,16,6,22,14,31,23,10,18,99,113
2023,2,22300267,11/30/2023,1610612748,Miami Heat,1,1,1610612754,Indiana Pacers,0,0,40,25,65,8,13,21,48,38,86,38,7,45,15,26,25,11,14,106,142
2021,2,22100319,12/1/2021,1610612737,Atlanta Hawks,0,1,1610612754,Indiana Pacers,1,0,28,25,53,16,17,33,44,42,86,10,2,12,7,36,24,8,13,97,114
2021,2,22100319,12/1/2021,1610612754,Indiana Pacers,1,0,1610612737,Atlanta Hawks,0,1,34,23,57,10,23,33,44,46,90,13,3,16,11,37,23,4,10,97,111
2020,2,22000123,1/8/2021,1610612756,Phoenix Suns,0,0,1610612765,Detroit Pistons,1,1,24,15,39,17,35,52,41,50,91,6,7,13,13,41,24,13,21,108,105
2020,2,22000123,1/8/2021,1610612765,Detroit Pistons,1,1,1610612756,Phoenix Suns,0,0,26,30,56,11,23,34,37,53,90,25,4,29,13,43,23,10,17,108,110
2019,2,21900342,12/8/2019,1610612747,Los Angeles Lakers,1,1,1610612750,Minnesota Timberwolves,0,0,41,22,63,14,17,31,55,39,94,18,2,20,12,27,32,5,11,103,142
2019,2,21900342,12/8/2019,1610612750,Minnesota Timberwolves,0,0,1610612747,Los Angeles Lakers,1,1,29,18,47,15,22,37,44,40,84,22,4,26,9,32,27,9,16,102,125
2019,2,21900110,11/6/2019,1610612755,Philadelphia 76ers,0,0,1610612762,Utah Jazz,1,1,25,30,55,8,17,25,33,47,80,30,4,34,13,36,20,9,16,99,104
2019,2,21900110,11/6/2019,1610612762,Utah Jazz,1,1,1610612755,Philadelphia 76ers,0,0,33,34,67,8,14,22,41,48,89,16,8,24,16,37,21,9,13,98,106
2020,2,22000972,5/2/2021,1610612756,Phoenix Suns,0,1,1610612760,Oklahoma City Thunder,1,0,33,20,53,12,19,31,45,39,84,21,6,27,9,31,27,7,11,98,123
2020,2,22000972,5/2/2021,1610612760,Oklahoma City Thunder,1,0,1610612756,Phoenix Suns,0,1,32,30,62,13,17,30,45,47,92,17,7,24,20,32,23,9,15,98,120
2017,2,21700111,11/1/2017,1610612745,Houston Rockets,0,1,1610612752,New York Knicks,1,0,23,13,36,19,33,52,42,46,88,16,5,21,11,37,21,8,14,101,119
2017,2,21700111,11/1/2017,1610612752,New York Knicks,1,0,1610612745,Houston Rockets,0,1,31,33,64,8,18,26,39,51,90,11,2,13,13,39,23,6,19,101,97
2016,2,21600747,2/3/2017,1610612751,Brooklyn Nets,1,0,1610612754,Indiana Pacers,0,1,21,37,58,11,17,28,32,54,86,22,1,23,15,39,20,11,19,102,97
2016,2,21600747,2/3/2017,1610612754,Indiana Pacers,0,1,1610612751,Brooklyn Nets,1,0,29,37,66,8,12,20,37,49,86,24,7,31,16,36,20,7,17,103,106
2023,2,22300512,1/9/2024,1610612765,Detroit Pistons,1,0,1610612758,Sacramento Kings,0,1,26,22,48,14,23,37,40,45,85,16,5,21,14,35,27,8,21,101,110
2014,2,21400389,12/19/2014,1610612741,Chicago Bulls,0,1,1610612763,Memphis Grizzlies,1,0,22,25,47,10,16,26,32,41,73,29,4,33,9,33,17,4,11,91,103
2014,2,21400389,12/19/2014,1610612763,Memphis Grizzlies,1,0,1610612741,Chicago Bulls,0,1,35,46,81,2,11,13,37,57,94,21,3,24,16,44,12,2,4,92,97
2023,2,22300018,11/14/2023,1610612737,Atlanta Hawks,0,1,1610612765,Detroit Pistons,1,0,33,21,54,12,21,33,45,42,87,24,2,26,12,31,28,9,14,102,126
2021,2,22100318,11/30/2021,1610612747,Los Angeles Lakers,0,1,1610612758,Sacramento Kings,1,0,35,29,64,11,17,28,46,46,92,14,6,20,17,33,21,11,15,97,117
2021,2,22100318,11/30/2021,1610612758,Sacramento Kings,1,0,1610612747,Los Angeles Lakers,0,1,29,21,50,6,23,29,35,44,79,16,6,22,11,38,22,10,20,97,92
2020,2,22000122,1/7/2021,1610612750,Minnesota Timberwolves,0,0,1610612757,Portland Trail Blazers,1,1,25,27,52,14,27,41,39,54,93,25,8,33,19,39,24,10,16,107,117
2020,2,22000122,1/7/2021,1610612757,Portland Trail Blazers,1,1,1610612750,Minnesota Timberwolves,0,0,31,18,49,18,23,41,49,41,90,19,4,23,9,33,25,11,15,107,135
2014,2,21400985,3/15/2015,1610612739,Cleveland Cavaliers,0,1,1610612753,Orlando Magic,1,0,27,14,41,18,17,35,45,31,76,15,4,19,7,27,26,10,17,95,123
2014,2,21400985,3/15/2015,1610612753,Orlando Magic,1,0,1610612739,Cleveland Cavaliers,0,1,33,36,69,9,10,19,42,46,88,15,12,27,19,34,24,9,13,94,108
2014,2,21400388,12/19/2014,1610612748,Miami Heat,1,0,1610612764,Washington Wizards,0,1,31,25,56,9,10,19,40,35,75,14,5,19,11,26,22,6,16,88,103
2014,2,21400388,12/19/2014,1610612764,Washington Wizards,0,1,1610612748,Miami Heat,1,0,36,29,65,3,11,14,39,40,79,24,9,33,15,30,24,7,9,88,105
2016,2,21600262,11/29/2016,1610612739,Cleveland Cavaliers,0,0,1610612749,Milwaukee Bucks,1,1,18,18,36,14,25,39,32,43,75,23,8,31,11,36,17,15,20,100,101
2016,2,21600262,11/29/2016,1610612749,Milwaukee Bucks,1,1,1610612739,Cleveland Cavaliers,0,0,39,28,67,7,12,19,46,40,86,19,4,23,13,29,27,7,17,99,118
2023,2,22300272,11/30/2023,1610612737,Atlanta Hawks,0,1,1610612759,San Antonio Spurs,1,0,35,28,63,14,19,33,49,47,96,25,4,29,12,38,24,4,10,108,137
2023,2,22300036,11/17/2023,1610612757,Portland Trail Blazers,1,0,1610612747,Los Angeles Lakers,0,1,26,26,52,10,27,37,36,53,89,13,5,18,20,36,17,11,19,95,95
2021,2,22100317,11/30/2021,1610612757,Portland Trail Blazers,1,1,1610612765,Detroit Pistons,0,0,27,27,54,14,28,42,41,55,96,14,4,18,17,40,24,4,11,99,110
2021,2,22100317,11/30/2021,1610612765,Detroit Pistons,0,0,1610612757,Portland Trail Blazers,1,1,20,21,41,9,26,35,29,47,76,25,5,30,12,37,17,8,19,98,92
2020,2,22000121,1/7/2021,1610612747,Los Angeles Lakers,1,0,1610612759,San Antonio Spurs,0,1,33,23,56,10,20,30,43,43,86,13,8,21,10,37,21,4,13,98,109
2020,2,22000121,1/7/2021,1610612759,San Antonio Spurs,0,1,1610612747,Los Angeles Lakers,1,0,27,30,57,16,19,35,43,49,92,16,1,17,9,40,28,2,8,99,118
2017,2,21700110,11/1/2017,1610612741,Chicago Bulls,0,0,1610612748,Miami Heat,1,1,29,32,61,7,21,28,36,53,89,12,7,19,10,46,20,8,12,101,91
2017,2,21700110,11/1/2017,1610612748,Miami Heat,1,1,1610612741,Chicago Bulls,0,0,22,30,52,12,19,31,34,49,83,17,2,19,3,47,21,7,11,99,97
2018,2,21800934,3/1/2019,1610612747,Los Angeles Lakers,1,0,1610612749,Milwaukee Bucks,0,1,33,23,56,13,27,40,46,50,96,15,3,18,11,41,29,4,9,102,120
2018,2,21800934,3/1/2019,1610612749,Milwaukee Bucks,0,1,1610612747,Los Angeles Lakers,1,0,34,19,53,14,26,40,48,45,93,21,3,24,12,35,30,4,11,102,131
2018,2,21800822,2/8/2019,1610612744,Golden State Warriors,0,1,1610612756,Phoenix Suns,1,0,31,21,52,10,19,29,41,40,81,25,10,35,16,30,30,12,18,102,117
2018,2,21800822,2/8/2019,1610612756,Phoenix Suns,1,0,1610612744,Golden State Warriors,0,1,33,37,70,6,25,31,39,62,101,23,7,30,25,42,23,5,12,101,107
2018,2,21800729,1/25/2019,1610612750,Minnesota Timberwolves,0,0,1610612762,Utah Jazz,1,1,30,34,64,8,18,26,38,52,90,18,3,21,19,35,20,9,15,96,102
2018,2,21800729,1/25/2019,1610612762,Utah Jazz,1,1,1610612750,Minnesota Timberwolves,0,0,24,30,54,13,27,40,37,57,94,19,6,25,21,38,25,5,11,96,106
2018,2,21800575,1/4/2019,1610612757,Portland Trail Blazers,1,0,1610612760,Oklahoma City Thunder,0,1,32,32,64,9,22,31,41,54,95,18,3,21,15,41,30,9,12,104,109
2018,2,21800575,1/4/2019,1610612760,Oklahoma City Thunder,0,1,1610612757,Portland Trail Blazers,1,0,32,37,69,8,17,25,40,54,94,23,3,26,14,41,18,6,11,103,111
2023,2,22300036,11/17/2023,1610612747,Los Angeles Lakers,0,1,1610612757,Portland Trail Blazers,1,0,28,24,52,12,17,29,40,41,81,15,7,22,14,29,27,11,18,95,107
2023,2,22300209,11/19/2023,1610612754,Indiana Pacers,1,0,1610612753,Orlando Magic,0,1,34,30,64,8,23,31,42,53,95,24,7,31,17,39,24,10,16,108,116
2021,2,22100316,11/30/2021,1610612744,Golden State Warriors,0,0,1610612756,Phoenix Suns,1,1,22,24,46,14,26,40,36,50,86,10,4,14,20,31,25,12,23,95,96
2021,2,22100316,11/30/2021,1610612756,Phoenix Suns,1,1,1610612744,Golden State Warriors,0,0,31,26,57,12,18,30,43,44,87,6,5,11,10,37,28,7,13,95,104
2020,2,22000120,1/7/2021,1610612742,Dallas Mavericks,0,1,1610612743,Denver Nuggets,1,0,26,21,47,16,24,40,42,45,87,24,7,31,8,41,27,8,13,105,124
2020,2,22000120,1/7/2021,1610612743,Denver Nuggets,1,0,1610612742,Dallas Mavericks,0,1,28,25,53,15,29,44,43,54,97,16,5,21,15,40,25,12,14,107,117
2019,2,21900341,12/8/2019,1610612757,Portland Trail Blazers,1,0,1610612760,Oklahoma City Thunder,0,1,27,40,67,9,24,33,36,64,100,15,3,18,22,44,16,7,8,96,96
2019,2,21900341,12/8/2019,1610612760,Oklahoma City Thunder,0,1,1610612757,Portland Trail Blazers,1,0,24,29,53,11,21,32,35,50,85,27,7,34,16,37,12,7,10,95,108
2017,2,21700109,11/1/2017,1610612738,Boston Celtics,1,1,1610612758,Sacramento Kings,0,0,23,18,41,17,24,41,40,42,82,16,3,19,19,23,30,10,18,90,113
2023,2,22300273,11/30/2023,1610612746,LA Clippers,0,0,1610612744,Golden State Warriors,1,1,30,33,63,12,20,32,42,53,95,18,6,24,18,40,26,3,6,94,114
2017,2,21700109,11/1/2017,1610612758,Sacramento Kings,0,0,1610612738,Boston Celtics,1,1,29,32,61,6,14,20,35,46,81,10,2,12,11,37,24,10,15,89,86
2020,2,22000971,5/2/2021,1610612745,Houston Rockets,1,0,1610612752,New York Knicks,0,1,26,18,44,8,27,35,34,45,79,21,11,32,16,35,19,10,18,97,97
2020,2,22000971,5/2/2021,1610612752,New York Knicks,0,1,1610612745,Houston Rockets,1,0,27,24,51,18,17,35,45,41,86,14,2,16,8,33,22,6,13,98,122
2016,2,21600746,2/3/2017,1610612753,Orlando Magic,1,1,1610612761,Toronto Raptors,0,0,32,34,66,5,9,14,37,43,80,23,9,32,13,32,22,5,11,92,102
2016,2,21600746,2/3/2017,1610612761,Toronto Raptors,0,0,1610612753,Orlando Magic,1,1,24,35,59,10,18,28,34,53,87,16,5,21,17,38,15,4,13,92,94
2023,2,22300332,12/15/2023,1610612745,Houston Rockets,0,1,1610612763,Memphis Grizzlies,1,0,21,38,59,11,18,29,32,56,88,28,4,32,18,39,18,4,11,98,103
2018,2,21801222,4/10/2019,1610612753,Orlando Magic,0,1,1610612766,Charlotte Hornets,1,0,37,21,58,11,19,30,48,40,88,15,5,20,12,30,24,3,6,92,122
2018,2,21801222,4/10/2019,1610612766,Charlotte Hornets,1,0,1610612753,Orlando Magic,0,1,33,16,49,8,21,29,41,37,78,24,3,27,7,31,21,5,8,93,114
2018,2,21801071,3/20/2019,1610612748,Miami Heat,0,1,1610612759,San Antonio Spurs,1,0,24,27,51,16,19,35,40,46,86,14,4,18,10,37,23,2,10,96,110
2018,2,21801071,3/20/2019,1610612759,San Antonio Spurs,1,0,1610612748,Miami Heat,0,1,24,30,54,14,20,34,38,50,88,15,6,21,11,42,30,6,8,95,105
2023,2,22300454,1/1/2024,1610612749,Milwaukee Bucks,1,0,1610612754,Indiana Pacers,0,1,31,22,53,10,30,40,41,52,93,21,5,26,13,41,27,7,11,104,113
2023,2,22300490,1/5/2024,1610612765,Detroit Pistons,0,0,1610612744,Golden State Warriors,1,1,31,23,54,13,31,44,44,54,98,8,2,10,16,40,25,3,11,100,109
2020,2,22000119,1/7/2021,1610612739,Cleveland Cavaliers,0,1,1610612763,Memphis Grizzlies,1,0,23,26,49,13,17,30,36,43,79,9,7,16,9,39,24,13,16,93,94
2020,2,22000119,1/7/2021,1610612763,Memphis Grizzlies,1,0,1610612739,Cleveland Cavaliers,0,1,25,27,52,11,20,31,36,47,83,7,1,8,14,34,27,11,18,92,90
2019,2,21900340,12/8/2019,1610612742,Dallas Mavericks,1,0,1610612758,Sacramento Kings,0,1,24,18,42,17,27,44,41,45,86,7,1,8,15,30,24,7,13,91,106
2019,2,21900340,12/8/2019,1610612758,Sacramento Kings,0,1,1610612742,Dallas Mavericks,1,0,31,20,51,13,21,34,44,41,85,9,2,11,11,31,24,3,11,90,110
2019,2,21900109,11/6/2019,1610612742,Dallas Mavericks,1,1,1610612753,Orlando Magic,0,0,25,28,53,11,20,31,36,48,84,24,6,30,16,35,20,14,17,100,107
2019,2,21900109,11/6/2019,1610612753,Orlando Magic,0,0,1610612742,Dallas Mavericks,1,1,33,23,56,6,18,24,39,41,80,22,6,28,12,31,25,4,18,100,106
2017,2,21700108,11/1/2017,1610612756,Phoenix Suns,0,1,1610612764,Washington Wizards,1,0,32,27,59,9,15,24,41,42,83,31,7,38,12,33,23,5,10,99,122
2017,2,21700108,11/1/2017,1610612764,Washington Wizards,1,0,1610612756,Phoenix Suns,0,1,31,31,62,10,20,30,41,51,92,24,6,30,18,36,20,5,12,98,116
2023,2,22300271,11/30/2023,1610612760,Oklahoma City Thunder,1,1,1610612747,Los Angeles Lakers,0,0,36,16,52,14,28,42,50,44,94,19,3,22,9,36,29,6,9,103,133
2014,2,21400387,12/19/2014,1610612761,Toronto Raptors,0,1,1610612765,Detroit Pistons,1,0,34,27,61,8,19,27,42,46,88,18,6,24,12,36,24,5,9,97,110
2014,2,21400387,12/19/2014,1610612765,Detroit Pistons,1,0,1610612761,Toronto Raptors,0,1,33,36,69,8,17,25,41,53,94,10,5,15,18,39,28,4,11,96,100
2018,2,21800933,3/1/2019,1610612746,LA Clippers,0,1,1610612758,Sacramento Kings,1,0,28,33,61,12,19,31,40,52,92,24,9,33,19,38,19,6,12,101,116
2018,2,21800933,3/1/2019,1610612758,Sacramento Kings,1,0,1610612746,LA Clippers,0,1,35,37,72,6,15,21,41,52,93,21,4,25,12,42,27,4,8,100,109
2018,2,21800360,12/5/2018,1610612763,Memphis Grizzlies,1,1,1610612746,LA Clippers,0,0,30,27,57,7,21,28,37,48,85,15,9,24,14,37,18,9,16,99,96
2023,2,22300035,11/17/2023,1610612762,Utah Jazz,1,0,1610612756,Phoenix Suns,0,1,27,22,49,16,20,36,43,42,85,26,5,31,12,31,27,5,8,97,128
2021,2,22100315,11/30/2021,1610612761,Toronto Raptors,1,0,1610612763,Memphis Grizzlies,0,1,26,26,52,10,29,39,36,55,91,9,3,12,16,39,14,13,18,98,91
2021,2,22100315,11/30/2021,1610612763,Memphis Grizzlies,0,1,1610612761,Toronto Raptors,1,0,26,33,59,10,24,34,36,57,93,16,3,19,22,37,18,7,17,97,98
2023,2,22300273,11/30/2023,1610612744,Golden State Warriors,1,1,1610612746,LA Clippers,0,0,26,17,43,15,24,39,41,41,82,23,8,31,13,29,30,5,9,93,120
2023,2,22300195,11/15/2023,1610612749,Milwaukee Bucks,0,1,1610612761,Toronto Raptors,1,0,24,22,46,20,19,39,44,41,85,20,1,21,10,32,25,10,13,98,128
2016,2,21600745,2/2/2017,1610612744,Golden State Warriors,0,1,1610612746,LA Clippers,1,0,38,27,65,14,20,34,52,47,99,15,3,18,20,29,38,7,12,100,133
2020,2,22000970,5/2/2021,1610612742,Dallas Mavericks,1,0,1610612758,Sacramento Kings,0,1,28,18,46,6,29,35,34,47,81,25,6,31,17,34,16,9,17,96,99
2020,2,22000970,5/2/2021,1610612758,Sacramento Kings,0,1,1610612742,Dallas Mavericks,1,0,34,19,53,11,17,28,45,36,81,10,6,16,10,29,27,12,20,94,111
2016,2,21600745,2/2/2017,1610612746,LA Clippers,1,0,1610612744,Golden State Warriors,0,1,30,25,55,10,15,25,40,40,80,30,9,39,12,33,24,10,15,101,120
2023,2,22300210,11/19/2023,1610612743,Denver Nuggets,0,0,1610612739,Cleveland Cavaliers,1,1,25,28,53,14,15,29,39,43,82,17,6,23,11,36,23,6,13,96,109
2023,2,22300408,12/26/2023,1610612741,Chicago Bulls,1,1,1610612737,Atlanta Hawks,0,0,35,32,67,7,18,25,42,50,92,27,4,31,21,30,23,6,10,97,118
2023,2,22300321,12/14/2023,1610612750,Minnesota Timberwolves,0,1,1610612742,Dallas Mavericks,1,0,30,27,57,14,17,31,44,44,88,17,8,25,16,32,30,6,17,101,119
2023,2,22300452,1/1/2024,1610612761,Toronto Raptors,1,1,1610612739,Cleveland Cavaliers,0,0,31,26,57,11,19,30,42,45,87,29,11,40,13,39,25,9,11,100,124
2023,2,22300342,12/16/2023,1610612762,Utah Jazz,0,0,1610612758,Sacramento Kings,1,1,26,23,49,12,25,37,38,48,86,16,5,21,11,39,28,6,13,97,104
2017,2,21700107,11/1/2017,1610612737,Atlanta Hawks,0,0,1610612755,Philadelphia 76ers,1,1,33,38,71,8,15,23,41,53,94,19,8,27,14,41,22,10,18,111,109
2020,2,22000118,1/7/2021,1610612751,Brooklyn Nets,1,1,1610612755,Philadelphia 76ers,0,0,29,31,60,15,22,37,44,53,97,19,10,29,14,45,30,6,13,109,122
2020,2,22000118,1/7/2021,1610612755,Philadelphia 76ers,0,0,1610612751,Brooklyn Nets,1,1,32,29,61,9,17,26,41,46,87,18,2,20,7,40,23,11,20,108,109
2019,2,21900339,12/8/2019,1610612746,LA Clippers,0,1,1610612764,Washington Wizards,1,0,35,21,56,15,25,40,50,46,96,20,7,27,17,32,27,5,12,103,135
2019,2,21900339,12/8/2019,1610612764,Washington Wizards,1,0,1610612746,LA Clippers,0,1,26,29,55,14,19,33,40,48,88,25,5,30,12,40,28,8,14,103,119
2019,2,21900108,11/6/2019,1610612750,Minnesota Timberwolves,0,0,1610612763,Memphis Grizzlies,1,1,27,24,51,16,29,45,43,53,96,19,7,26,15,42,29,4,11,107,121
2019,2,21900108,11/6/2019,1610612763,Memphis Grizzlies,1,1,1610612750,Minnesota Timberwolves,0,0,38,27,65,12,11,23,50,38,88,25,5,30,13,28,34,9,17,105,137
2020,2,22000969,5/2/2021,1610612748,Miami Heat,0,1,1610612766,Charlotte Hornets,1,0,34,16,50,11,27,38,45,43,88,20,7,27,14,32,30,9,11,96,121
2020,2,22000969,5/2/2021,1610612766,Charlotte Hornets,1,0,1610612748,Miami Heat,0,1,26,22,48,14,19,33,40,41,81,17,5,22,10,33,30,10,15,97,111
2017,2,21700107,11/1/2017,1610612755,Philadelphia 76ers,1,1,1610612737,Atlanta Hawks,0,0,33,31,64,13,22,35,46,53,99,14,11,25,19,39,36,11,16,111,119
2023,2,22300332,12/15/2023,1610612763,Memphis Grizzlies,1,0,1610612745,Houston Rockets,0,1,26,26,52,11,29,40,37,55,92,11,4,15,19,37,19,10,18,97,96
2014,2,21400984,3/15/2015,1610612740,New Orleans Pelicans,1,0,1610612743,Denver Nuggets,0,1,40,37,77,6,16,22,46,53,99,13,8,21,17,40,32,9,19,111,111
2018,2,21801070,3/20/2019,1610612745,Houston Rockets,0,0,1610612763,Memphis Grizzlies,1,1,21,25,46,21,27,48,42,52,94,20,0,20,14,38,19,8,14,102,125
2018,2,21801070,3/20/2019,1610612763,Memphis Grizzlies,1,1,1610612745,Houston Rockets,0,0,28,24,52,13,24,37,41,48,89,31,8,39,23,30,20,10,17,104,126
2014,2,21400984,3/15/2015,1610612743,Denver Nuggets,0,1,1610612740,New Orleans Pelicans,1,0,36,37,73,10,21,31,46,58,104,16,4,20,16,44,25,3,11,110,118
2014,2,21400386,12/19/2014,1610612739,Cleveland Cavaliers,1,1,1610612751,Brooklyn Nets,0,0,22,31,53,9,15,24,31,46,77,24,5,29,14,33,22,8,16,94,95
2014,2,21400386,12/19/2014,1610612751,Brooklyn Nets,0,0,1610612739,Cleveland Cavaliers,1,1,28,26,54,9,15,24,37,41,78,8,4,12,7,37,23,7,16,94,91
2020,2,22000117,1/6/2021,1610612741,Chicago Bulls,0,0,1610612758,Sacramento Kings,1,1,35,18,53,14,26,40,49,44,93,12,3,15,17,30,27,8,16,99,124
2020,2,22000117,1/6/2021,1610612758,Sacramento Kings,1,1,1610612741,Chicago Bulls,0,0,33,21,54,14,23,37,47,44,91,20,7,27,13,34,30,3,7,98,128
2021,2,22100314,11/30/2021,1610612751,Brooklyn Nets,1,1,1610612752,New York Knicks,0,0,33,24,57,8,20,28,41,44,85,22,3,25,13,33,27,5,9,94,112
2021,2,22100314,11/30/2021,1610612752,New York Knicks,0,0,1610612751,Brooklyn Nets,1,1,33,26,59,11,21,32,44,47,91,11,1,12,16,31,27,7,11,94,110
2017,2,21700106,11/1/2017,1610612739,Cleveland Cavaliers,1,0,1610612754,Indiana Pacers,0,1,36,19,55,7,24,31,43,43,86,14,6,20,9,36,25,9,16,101,107
2017,2,21700106,11/1/2017,1610612754,Indiana Pacers,0,1,1610612739,Cleveland Cavaliers,1,0,33,31,64,16,10,26,49,41,90,10,3,13,10,33,35,6,14,101,124
2018,2,21801221,4/10/2019,1610612748,Miami Heat,0,0,1610612751,Brooklyn Nets,1,1,30,27,57,8,33,41,38,60,98,10,5,15,12,52,22,7,15,109,94
2018,2,21801221,4/10/2019,1610612751,Brooklyn Nets,1,1,1610612748,Miami Heat,0,0,22,34,56,21,37,58,43,71,114,6,1,7,22,50,29,9,12,107,113
2018,2,21800728,1/25/2019,1610612743,Denver Nuggets,1,1,1610612756,Phoenix Suns,0,0,32,26,58,15,21,36,47,47,94,23,6,29,17,35,26,4,12,102,132
2018,2,21800728,1/25/2019,1610612756,Phoenix Suns,0,0,1610612743,Denver Nuggets,1,1,25,21,46,7,23,30,32,44,76,24,2,26,2,42,20,9,16,102,95
2018,2,21800574,1/4/2019,1610612747,Los Angeles Lakers,1,0,1610612752,New York Knicks,0,1,32,29,61,11,26,37,43,55,98,15,5,20,14,44,23,12,17,108,112
2018,2,21800574,1/4/2019,1610612752,New York Knicks,0,1,1610612747,Los Angeles Lakers,1,0,26,36,62,11,26,37,37,62,99,34,7,41,17,46,20,4,6,107,119
2020,2,22000116,1/6/2021,1610612744,Golden State Warriors,1,0,1610612746,LA Clippers,0,1,31,25,56,8,22,30,39,47,86,15,4,19,10,39,25,6,13,98,101
2020,2,22000116,1/6/2021,1610612746,LA Clippers,0,1,1610612744,Golden State Warriors,1,0,25,22,47,11,23,34,36,45,81,25,0,25,14,31,19,10,20,97,108
2019,2,21900338,12/8/2019,1610612755,Philadelphia 76ers,1,1,1610612761,Toronto Raptors,0,0,26,21,47,14,18,32,40,39,79,16,5,21,11,32,31,13,21,99,110
2019,2,21900338,12/8/2019,1610612761,Toronto Raptors,0,0,1610612755,Philadelphia 76ers,1,1,27,28,55,11,22,33,38,50,88,17,3,20,16,36,21,7,18,100,104
2020,2,22000968,5/2/2021,1610612738,Boston Celtics,1,0,1610612757,Portland Trail Blazers,0,1,23,27,50,20,19,39,43,46,89,13,2,15,14,33,29,8,18,102,119
2020,2,22000968,5/2/2021,1610612757,Portland Trail Blazers,0,1,1610612738,Boston Celtics,1,0,25,22,47,19,19,38,44,41,85,22,4,26,6,37,27,3,10,101,129
2016,2,21600744,2/2/2017,1610612755,Philadelphia 76ers,0,0,1610612759,San Antonio Spurs,1,1,21,42,63,9,16,25,30,58,88,17,6,23,15,46,21,13,22,105,86
2016,2,21600744,2/2/2017,1610612759,San Antonio Spurs,1,1,1610612755,Philadelphia 76ers,0,0,32,36,68,6,15,21,38,51,89,20,7,27,17,36,26,10,19,104,102
2014,2,21400983,3/15/2015,1610612745,Houston Rockets,0,1,1610612746,LA Clippers,1,0,25,31,56,7,23,30,32,54,86,29,7,36,13,44,17,8,13,102,100
2014,2,21400983,3/15/2015,1610612746,LA Clippers,1,0,1610612745,Houston Rockets,0,1,24,32,56,12,14,26,36,46,82,14,10,24,13,38,24,7,20,101,98
2014,2,21400385,12/19/2014,1610612738,Boston Celtics,1,1,1610612750,Minnesota Timberwolves,0,0,40,22,62,8,15,23,48,37,85,10,4,14,14,26,29,8,13,92,114
2014,2,21400385,12/19/2014,1610612750,Minnesota Timberwolves,0,0,1610612738,Boston Celtics,1,1,36,45,81,6,6,12,42,51,93,8,8,16,21,33,23,9,13,92,98
2021,2,22100313,11/29/2021,1610612740,New Orleans Pelicans,0,1,1610612746,LA Clippers,1,0,34,25,59,14,21,35,48,46,94,13,3,16,17,31,30,2,8,91,123
2021,2,22100313,11/29/2021,1610612746,LA Clippers,1,0,1610612740,New Orleans Pelicans,0,1,23,13,36,14,22,36,37,35,72,16,5,21,5,33,17,11,15,91,104
2017,2,21700105,11/1/2017,1610612749,Milwaukee Bucks,0,0,1610612766,Charlotte Hornets,1,1,26,29,55,19,17,36,45,46,91,12,3,15,13,34,29,5,14,98,121
2017,2,21700105,11/1/2017,1610612766,Charlotte Hornets,1,1,1610612749,Milwaukee Bucks,0,0,31,28,59,14,11,25,45,39,84,22,7,29,11,33,21,3,11,97,126
2020,2,22000115,1/6/2021,1610612756,Phoenix Suns,1,1,1610612761,Toronto Raptors,0,0,19,24,43,21,19,40,40,43,83,22,2,24,10,33,30,6,12,96,123
2020,2,22000115,1/6/2021,1610612761,Toronto Raptors,0,0,1610612756,Phoenix Suns,1,1,25,19,44,14,21,35,39,40,79,23,9,32,11,35,18,4,12,95,115
2016,2,21600261,11/29/2016,1610612746,LA Clippers,0,0,1610612751,Brooklyn Nets,1,1,33,36,69,13,27,40,46,63,109,17,5,22,15,50,21,9,14,120,122
2016,2,21600261,11/29/2016,1610612751,Brooklyn Nets,1,1,1610612746,LA Clippers,0,0,32,34,66,13,25,38,45,59,104,24,12,36,15,49,22,10,13,120,127
2019,2,21900107,11/6/2019,1610612744,Golden State Warriors,0,0,1610612745,Houston Rockets,1,1,25,38,63,13,20,33,38,58,96,23,5,28,19,41,22,7,11,101,112
2014,2,21400982,3/15/2015,1610612741,Chicago Bulls,0,0,1610612760,Oklahoma City Thunder,1,1,28,26,54,9,20,29,37,46,83,17,7,24,10,40,20,4,11,95,100
2014,2,21400982,3/15/2015,1610612760,Oklahoma City Thunder,1,1,1610612741,Chicago Bulls,0,0,32,34,66,8,13,21,40,47,87,21,9,30,23,31,16,5,17,95,109
2019,2,21900107,11/6/2019,1610612745,Houston Rockets,1,1,1610612744,Golden State Warriors,0,0,27,25,52,21,24,45,48,49,97,12,7,19,19,36,31,7,13,102,129
2014,2,21400384,12/19/2014,1610612755,Philadelphia 76ers,1,0,1610612766,Charlotte Hornets,0,1,20,25,45,12,14,26,32,39,71,15,2,17,6,33,23,10,25,100,91
2014,2,21400384,12/19/2014,1610612766,Charlotte Hornets,0,1,1610612755,Philadelphia 76ers,1,0,33,41,74,10,14,24,43,55,98,13,4,17,22,35,25,6,15,99,109
2017,2,21700104,10/31/2017,1610612747,Los Angeles Lakers,1,1,1610612765,Detroit Pistons,0,0,33,32,65,12,14,26,45,46,91,11,3,14,14,35,30,7,14,96,113
2021,2,22100312,11/29/2021,1610612757,Portland Trail Blazers,0,0,1610612762,Utah Jazz,1,1,31,29,60,11,20,31,42,49,91,12,5,17,13,38,19,6,9,94,107
2017,2,21700104,10/31/2017,1610612765,Detroit Pistons,0,0,1610612747,Los Angeles Lakers,1,1,31,30,61,10,23,33,41,53,94,1,2,3,11,42,21,9,12,96,93
2021,2,22100312,11/29/2021,1610612762,Utah Jazz,1,1,1610612757,Portland Trail Blazers,0,0,28,15,43,19,27,46,47,42,89,16,7,23,11,31,30,1,5,93,129
2014,2,21400383,12/19/2014,1610612753,Orlando Magic,1,0,1610612762,Utah Jazz,0,1,25,36,61,12,10,22,37,46,83,8,4,12,12,37,28,4,12,89,94
2014,2,21400383,12/19/2014,1610612762,Utah Jazz,0,1,1610612753,Orlando Magic,1,0,35,27,62,4,7,11,39,34,73,19,5,24,11,26,24,6,16,89,101
2020,2,22000967,5/2/2021,1610612749,Milwaukee Bucks,1,1,1610612751,Brooklyn Nets,0,0,33,28,61,15,22,37,48,50,98,6,6,12,12,41,19,5,10,102,117
2020,2,22000967,5/2/2021,1610612751,Brooklyn Nets,0,0,1610612749,Milwaukee Bucks,1,1,24,30,54,17,25,42,41,55,96,15,2,17,17,38,18,9,16,102,114
2018,2,21801220,4/10/2019,1610612737,Atlanta Hawks,1,0,1610612754,Indiana Pacers,0,1,26,36,62,17,24,41,43,60,103,31,7,38,30,34,29,12,17,108,134
2021,2,22100311,11/29/2021,1610612759,San Antonio Spurs,1,1,1610612764,Washington Wizards,0,0,41,33,74,8,10,18,49,43,92,10,6,16,18,29,28,5,10,89,116
2021,2,22100311,11/29/2021,1610612764,Washington Wizards,0,0,1610612759,San Antonio Spurs,1,1,32,29,61,9,22,31,41,51,92,8,5,13,16,37,26,4,7,90,99
2020,2,22000114,1/6/2021,1610612740,New Orleans Pelicans,1,0,1610612760,Oklahoma City Thunder,0,1,40,27,67,4,18,22,44,45,89,18,5,23,13,35,25,10,15,103,110
2020,2,22000114,1/6/2021,1610612760,Oklahoma City Thunder,0,1,1610612740,New Orleans Pelicans,1,0,21,20,41,19,27,46,40,47,87,12,4,16,5,45,28,11,14,102,111
2019,2,21900337,12/8/2019,1610612741,Chicago Bulls,0,0,1610612748,Miami Heat,1,1,22,22,44,13,23,36,35,45,80,22,5,27,9,38,20,9,15,100,105
2019,2,21900337,12/8/2019,1610612748,Miami Heat,1,1,1610612741,Chicago Bulls,0,0,21,21,42,11,24,35,32,45,77,35,9,44,16,34,20,8,17,101,110
2017,2,21700103,10/31/2017,1610612749,Milwaukee Bucks,1,0,1610612760,Oklahoma City Thunder,0,1,23,23,46,9,22,31,32,45,77,18,4,22,8,40,24,6,15,93,91
2017,2,21700103,10/31/2017,1610612760,Oklahoma City Thunder,0,1,1610612749,Milwaukee Bucks,1,0,28,25,53,12,16,28,40,41,81,18,3,21,13,28,24,8,16,94,110
2016,2,21600260,11/29/2016,1610612765,Detroit Pistons,0,1,1610612766,Charlotte Hornets,1,0,33,31,64,12,16,28,45,47,92,10,1,11,13,35,21,7,12,94,112
2016,2,21600260,11/29/2016,1610612766,Charlotte Hornets,1,0,1610612765,Detroit Pistons,0,1,22,29,51,9,18,27,31,47,78,18,3,21,7,40,21,7,13,93,89
2014,2,21400382,12/18/2014,1610612744,Golden State Warriors,1,1,1610612760,Oklahoma City Thunder,0,0,36,27,63,12,19,31,48,46,94,6,4,10,10,38,32,5,10,98,114
2014,2,21400382,12/18/2014,1610612760,Oklahoma City Thunder,0,0,1610612744,Golden State Warriors,1,1,30,31,61,11,14,25,41,45,86,16,8,24,14,34,17,9,16,98,109
2017,2,21700102,10/31/2017,1610612751,Brooklyn Nets,1,0,1610612756,Phoenix Suns,0,1,33,38,71,9,22,31,42,60,102,21,9,30,9,56,15,5,7,113,114
2017,2,21700102,10/31/2017,1610612756,Phoenix Suns,0,1,1610612751,Brooklyn Nets,1,0,35,39,74,10,12,22,45,51,96,22,2,24,13,39,18,9,20,113,122
2014,2,21400981,3/14/2015,1610612744,Golden State Warriors,1,1,1610612752,New York Knicks,0,0,26,30,56,19,15,34,45,45,90,16,1,17,11,34,34,6,11,98,125
2023,2,22300946,3/13/2024,1610612765,Detroit Pistons,1,1,1610612761,Toronto Raptors,0,0,28,30,58,11,19,30,39,49,88,24,7,31,15,36,27,13,22,110,113
2014,2,21400981,3/14/2015,1610612752,New York Knicks,0,0,1610612744,Golden State Warriors,1,1,29,42,71,9,16,25,38,58,96,9,7,16,23,36,25,13,16,97,94
2014,2,21400381,12/18/2014,1610612749,Milwaukee Bucks,0,1,1610612758,Sacramento Kings,1,0,24,28,52,13,10,23,37,38,75,21,6,27,8,35,24,5,16,97,108
2021,2,22100310,11/29/2021,1610612739,Cleveland Cavaliers,0,1,1610612742,Dallas Mavericks,1,0,35,26,61,10,9,19,45,35,80,14,4,18,8,28,29,8,20,98,114
2021,2,22100310,11/29/2021,1610612742,Dallas Mavericks,1,0,1610612739,Cleveland Cavaliers,0,1,27,23,50,12,27,39,39,50,89,6,9,15,9,44,20,3,10,99,96
2014,2,21400381,12/18/2014,1610612758,Sacramento Kings,1,0,1610612749,Milwaukee Bucks,0,1,32,21,53,6,8,14,38,29,67,25,8,33,6,26,24,7,21,98,107
2019,2,21900106,11/6/2019,1610612758,Sacramento Kings,0,0,1610612761,Toronto Raptors,1,1,22,29,51,20,24,44,42,53,95,16,5,21,17,40,23,10,14,101,120
2019,2,21900106,11/6/2019,1610612761,Toronto Raptors,1,1,1610612758,Sacramento Kings,0,0,29,20,49,14,15,29,43,35,78,24,5,29,5,32,28,8,14,100,124
2021,2,22100309,11/29/2021,1610612750,Minnesota Timberwolves,1,1,1610612754,Indiana Pacers,0,0,27,20,47,9,26,35,36,46,82,19,7,26,10,39,25,6,14,98,100
2021,2,22100309,11/29/2021,1610612754,Indiana Pacers,0,0,1610612750,Minnesota Timberwolves,1,1,27,27,54,9,28,37,36,55,91,17,4,21,16,41,27,8,14,99,98
2020,2,22000113,1/6/2021,1610612749,Milwaukee Bucks,1,1,1610612765,Detroit Pistons,0,0,30,17,47,19,24,43,49,41,90,13,8,21,12,33,35,6,14,102,130
2020,2,22000113,1/6/2021,1610612765,Detroit Pistons,0,0,1610612749,Milwaukee Bucks,1,1,25,31,56,13,28,41,38,59,97,26,4,30,19,42,20,5,9,102,115
2020,2,22000966,5/1/2021,1610612743,Denver Nuggets,0,1,1610612746,LA Clippers,1,0,27,21,48,12,20,32,39,41,80,20,1,21,11,30,26,8,11,88,110
2020,2,22000966,5/1/2021,1610612746,LA Clippers,1,0,1610612743,Denver Nuggets,0,1,22,27,49,14,20,34,36,47,83,18,6,24,13,38,21,2,6,88,104
2018,2,21801220,4/10/2019,1610612754,Indiana Pacers,0,1,1610612737,Atlanta Hawks,1,0,33,35,68,12,18,30,45,53,98,33,6,39,16,40,22,5,8,107,135
2018,2,21800932,3/1/2019,1610612740,New Orleans Pelicans,0,1,1610612756,Phoenix Suns,1,0,34,26,60,16,11,27,50,37,87,14,6,20,11,28,34,17,25,111,130
2018,2,21800932,3/1/2019,1610612756,Phoenix Suns,1,0,1610612740,New Orleans Pelicans,0,1,28,32,60,12,22,34,40,54,94,24,4,28,15,42,25,13,19,112,116
2023,2,22300272,11/30/2023,1610612759,San Antonio Spurs,1,0,1610612737,Atlanta Hawks,0,1,30,18,48,18,23,41,48,41,89,21,2,23,11,31,34,14,21,108,135
2023,2,22300269,11/30/2023,1610612749,Milwaukee Bucks,0,0,1610612741,Chicago Bulls,1,1,28,22,50,16,32,48,44,54,98,9,4,13,15,39,28,14,21,110,113
2021,2,22100308,11/29/2021,1610612745,Houston Rockets,1,1,1610612760,Oklahoma City Thunder,0,0,25,25,50,15,31,46,40,56,96,7,4,11,14,44,31,10,14,101,102
2021,2,22100308,11/29/2021,1610612760,Oklahoma City Thunder,0,0,1610612745,Houston Rockets,1,1,24,20,44,7,36,43,31,56,87,20,6,26,8,52,16,7,13,102,89
2020,2,22000112,1/6/2021,1610612752,New York Knicks,1,1,1610612762,Utah Jazz,0,0,37,28,65,8,14,22,45,42,87,14,5,19,13,33,22,5,13,96,112
2020,2,22000112,1/6/2021,1610612762,Utah Jazz,0,0,1610612752,New York Knicks,1,1,26,21,47,14,30,44,40,51,91,6,5,11,15,39,20,10,15,98,100
2019,2,21900336,12/8/2019,1610612737,Atlanta Hawks,0,1,1610612766,Charlotte Hornets,1,0,26,20,46,18,27,45,44,47,91,16,1,17,15,33,28,8,14,97,122
2019,2,21900336,12/8/2019,1610612766,Charlotte Hornets,1,0,1610612737,Atlanta Hawks,0,1,25,34,59,11,20,31,36,54,90,24,5,29,17,39,22,8,11,96,107
2016,2,21600743,2/2/2017,1610612737,Atlanta Hawks,0,1,1610612745,Houston Rockets,1,0,36,19,55,8,22,30,44,41,85,17,6,23,10,34,26,11,21,106,113
2016,2,21600743,2/2/2017,1610612745,Houston Rockets,1,0,1610612737,Atlanta Hawks,0,1,22,20,42,13,38,51,35,58,93,25,8,33,11,50,19,8,9,106,108
2020,2,22000111,1/6/2021,1610612738,Boston Celtics,0,1,1610612748,Miami Heat,1,0,30,34,64,12,23,35,42,57,99,11,1,12,19,39,22,2,7,93,107
2020,2,22000111,1/6/2021,1610612748,Miami Heat,1,0,1610612738,Boston Celtics,0,1,22,23,45,13,23,36,35,46,81,22,4,26,9,38,26,7,9,92,105
2017,2,21700101,10/31/2017,1610612754,Indiana Pacers,1,1,1610612758,Sacramento Kings,0,0,24,32,56,12,17,29,36,49,85,17,5,22,16,38,25,8,15,93,101
2017,2,21700101,10/31/2017,1610612758,Sacramento Kings,0,0,1610612754,Indiana Pacers,1,1,35,39,74,2,12,14,37,51,88,7,7,14,15,38,15,8,15,94,83
2016,2,21600259,11/28/2016,1610612737,Atlanta Hawks,0,0,1610612744,Golden State Warriors,1,1,29,27,56,7,22,29,36,49,85,21,9,30,18,36,20,6,19,99,100
2016,2,21600259,11/28/2016,1610612744,Golden State Warriors,1,1,1610612737,Atlanta Hawks,0,0,25,25,50,12,23,35,37,48,85,19,5,24,12,39,25,11,15,99,105
2023,2,22300455,1/1/2024,1610612743,Denver Nuggets,1,1,1610612766,Charlotte Hornets,0,0,26,19,45,15,23,38,41,42,83,14,4,18,7,38,27,4,11,95,111
2014,2,21400380,12/18/2014,1610612740,New Orleans Pelicans,0,1,1610612745,Houston Rockets,1,0,33,31,64,5,13,18,38,44,82,18,4,22,13,34,21,8,12,90,99
2014,2,21400380,12/18/2014,1610612745,Houston Rockets,1,0,1610612740,New Orleans Pelicans,0,1,27,34,61,6,19,25,33,53,86,18,5,23,16,38,19,4,11,92,90
2017,2,21700100,10/30/2017,1610612744,Golden State Warriors,0,1,1610612746,LA Clippers,1,0,38,22,60,14,15,29,52,37,89,23,7,30,15,26,37,4,12,103,141
2017,2,21700100,10/30/2017,1610612746,LA Clippers,1,0,1610612744,Golden State Warriors,0,1,29,32,61,10,15,25,39,47,86,25,5,30,14,34,21,8,14,103,113
2022,2,22201173,4/2/2023,1610612739,Cleveland Cavaliers,1,1,1610612754,Indiana Pacers,0,0,35,31,66,9,15,24,44,46,90,18,8,26,14,34,23,5,13,100,115
2021,2,22100307,11/29/2021,1610612741,Chicago Bulls,1,1,1610612766,Charlotte Hornets,0,0,39,20,59,14,16,30,53,36,89,13,6,19,9,29,35,7,11,100,133
2022,2,22201160,3/31/2023,1610612743,Denver Nuggets,0,0,1610612756,Phoenix Suns,1,1,32,37,69,6,20,26,38,57,95,11,9,20,18,42,19,8,11,97,93
2023,2,22300209,11/19/2023,1610612753,Orlando Magic,0,1,1610612754,Indiana Pacers,1,0,36,31,67,7,13,20,43,44,87,35,7,42,14,32,21,10,15,108,128
2023,2,22300391,12/23/2023,1610612753,Orlando Magic,0,1,1610612754,Indiana Pacers,1,0,33,22,55,6,12,18,39,34,73,33,8,41,11,28,22,7,15,94,117
2023,2,22301221,12/8/2023,1610612750,Minnesota Timberwolves,0,1,1610612763,Memphis Grizzlies,1,0,29,21,50,15,23,38,44,44,88,24,2,26,21,23,30,7,13,94,127
2023,2,22300037,11/17/2023,1610612746,LA Clippers,1,1,1610612745,Houston Rockets,0,0,23,26,49,13,21,34,36,47,83,21,9,30,12,38,22,6,14,99,106
2023,2,22300163,11/8/2023,1610612747,Los Angeles Lakers,0,0,1610612745,Houston Rockets,1,1,29,31,60,7,18,25,36,49,85,15,9,24,7,46,20,4,9,99,94
2023,2,22300161,11/8/2023,1610612759,San Antonio Spurs,0,0,1610612752,New York Knicks,1,1,35,21,56,9,25,34,44,46,90,8,5,13,12,37,31,7,13,96,105
2023,2,22300417,12/27/2023,1610612751,Brooklyn Nets,1,0,1610612749,Milwaukee Bucks,0,1,38,31,69,7,25,32,45,56,101,25,4,29,22,36,29,6,9,100,122
2023,2,22301218,12/8/2023,1610612737,Atlanta Hawks,0,0,1610612755,Philadelphia 76ers,1,1,28,37,65,13,26,39,41,63,104,19,2,21,29,36,20,6,14,99,114
2023,2,22300490,1/5/2024,1610612744,Golden State Warriors,1,1,1610612765,Detroit Pistons,0,0,22,22,44,16,22,38,38,44,82,21,4,25,13,32,24,8,19,98,113
2023,2,22300411,12/26/2023,1610612750,Minnesota Timberwolves,0,0,1610612760,Oklahoma City Thunder,1,1,22,24,46,12,15,27,34,39,73,26,6,32,11,29,22,9,24,100,106
2021,2,22100307,11/29/2021,1610612766,Charlotte Hornets,0,0,1610612741,Chicago Bulls,1,1,24,25,49,18,21,39,42,46,88,17,4,21,9,37,23,3,9,98,119
2020,2,22000110,1/6/2021,1610612737,Atlanta Hawks,1,0,1610612766,Charlotte Hornets,0,1,29,27,56,7,33,40,36,60,96,15,3,18,17,45,25,11,13,100,94
2020,2,22000110,1/6/2021,1610612766,Charlotte Hornets,0,1,1610612737,Atlanta Hawks,1,0,21,28,49,11,25,36,32,53,85,27,6,33,10,45,22,6,10,101,102
2019,2,21900335,12/8/2019,1610612743,Denver Nuggets,0,0,1610612751,Brooklyn Nets,1,1,18,29,47,18,24,42,36,53,89,12,2,14,12,41,25,5,13,98,102
2019,2,21900335,12/8/2019,1610612751,Brooklyn Nets,1,1,1610612743,Denver Nuggets,0,0,33,26,59,7,21,28,40,47,87,18,5,23,15,35,25,4,13,97,105
2019,2,21900105,11/6/2019,1610612737,Atlanta Hawks,1,0,1610612741,Chicago Bulls,0,1,24,20,44,6,24,30,30,44,74,27,8,35,7,41,18,11,24,106,93
2017,2,21700099,10/30/2017,1610612757,Portland Trail Blazers,1,0,1610612761,Toronto Raptors,0,1,23,31,54,8,18,26,31,49,80,15,4,19,10,40,13,10,13,92,85
2017,2,21700099,10/30/2017,1610612761,Toronto Raptors,0,1,1610612757,Portland Trail Blazers,1,0,31,32,63,8,16,24,39,48,87,13,4,17,14,34,17,5,10,93,99
2019,2,21900105,11/6/2019,1610612741,Chicago Bulls,0,1,1610612737,Atlanta Hawks,1,0,28,21,49,13,20,33,41,41,82,18,9,27,8,38,26,7,20,106,113
2020,2,22000965,5/1/2021,1610612761,Toronto Raptors,0,0,1610612762,Utah Jazz,1,1,30,31,61,12,21,33,42,52,94,6,3,9,12,41,26,3,10,97,102
2020,2,22000965,5/1/2021,1610612762,Utah Jazz,1,1,1610612761,Toronto Raptors,0,0,20,17,37,17,24,41,37,41,78,15,3,18,11,31,20,12,21,95,106
2016,2,21600742,2/2/2017,1610612747,Los Angeles Lakers,0,0,1610612764,Washington Wizards,1,1,28,20,48,12,27,39,40,47,87,16,6,22,16,35,19,11,20,102,108
2023,2,22300210,11/19/2023,1610612739,Cleveland Cavaliers,1,1,1610612743,Denver Nuggets,0,0,34,21,55,11,16,27,45,37,82,20,6,26,12,28,30,7,14,95,121
2018,2,21800080,10/27/2018,1610612756,Phoenix Suns,0,0,1610612763,Memphis Grizzlies,1,1,27,18,45,9,24,33,36,42,78,15,4,19,8,36,28,12,19,96,96
2018,2,21800080,10/27/2018,1610612763,Memphis Grizzlies,1,1,1610612756,Phoenix Suns,0,0,35,18,53,9,17,26,44,35,79,20,2,22,6,31,30,5,12,96,117
2016,2,21600742,2/2/2017,1610612764,Washington Wizards,1,1,1610612747,Los Angeles Lakers,0,0,32,31,63,12,21,33,44,52,96,16,5,21,17,37,27,6,12,102,116
2014,2,21400379,12/18/2014,1610612741,Chicago Bulls,1,1,1610612752,New York Knicks,0,0,22,30,52,12,11,23,34,41,75,23,7,30,17,28,23,7,13,88,103
2014,2,21400379,12/18/2014,1610612752,New York Knicks,0,0,1610612741,Chicago Bulls,1,1,32,41,73,6,3,9,38,44,82,15,4,19,21,25,19,9,16,88,97
2018,2,21801069,3/20/2019,1610612741,Chicago Bulls,1,1,1610612764,Washington Wizards,0,0,38,45,83,12,11,23,50,56,106,14,3,17,19,39,29,10,14,108,126
2018,2,21801069,3/20/2019,1610612764,Washington Wizards,0,0,1610612741,Chicago Bulls,1,1,30,21,51,14,28,42,44,49,93,18,5,23,12,38,25,10,16,107,120
2018,2,21800931,3/1/2019,1610612738,Boston Celtics,1,1,1610612764,Washington Wizards,0,0,32,27,59,10,25,35,42,52,94,13,4,17,11,44,26,7,12,103,107
2018,2,21800931,3/1/2019,1610612764,Washington Wizards,0,0,1610612738,Boston Celtics,1,1,26,25,51,10,28,38,36,53,89,14,5,19,12,43,20,12,18,104,96
2018,2,21800652,1/15/2019,1610612750,Minnesota Timberwolves,0,0,1610612755,Philadelphia 76ers,1,1,27,40,67,8,15,23,35,55,90,29,6,35,12,46,18,6,11,106,107
2018,2,21800652,1/15/2019,1610612755,Philadelphia 76ers,1,1,1610612750,Minnesota Timberwolves,0,0,34,15,49,21,22,43,55,37,92,18,3,21,12,27,40,10,15,104,149
2021,2,22100306,11/29/2021,1610612743,Denver Nuggets,0,1,1610612748,Miami Heat,1,0,25,14,39,18,17,35,43,31,74,16,5,21,5,29,32,2,13,91,120
2021,2,22100306,11/29/2021,1610612748,Miami Heat,1,0,1610612743,Denver Nuggets,0,1,28,19,47,15,29,44,43,48,91,10,5,15,16,35,32,2,9,93,111
2020,2,22000109,1/6/2021,1610612755,Philadelphia 76ers,1,1,1610612764,Washington Wizards,0,0,32,20,52,18,11,29,50,31,81,23,10,33,4,31,33,9,18,110,141
2020,2,22000109,1/6/2021,1610612764,Washington Wizards,0,0,1610612755,Philadelphia 76ers,1,1,31,26,57,16,21,37,47,47,94,26,9,35,14,37,27,9,13,112,136
2019,2,21900334,12/7/2019,1610612762,Utah Jazz,1,1,1610612763,Memphis Grizzlies,0,0,26,20,46,19,15,34,45,35,80,17,1,18,11,24,32,15,22,100,126
2019,2,21900334,12/7/2019,1610612763,Memphis Grizzlies,0,0,1610612762,Utah Jazz,1,1,33,13,46,10,25,35,43,38,81,16,9,25,7,35,23,8,14,100,112
2017,2,21700098,10/30/2017,1610612742,Dallas Mavericks,0,0,1610612762,Utah Jazz,1,1,22,30,52,12,12,24,34,42,76,9,2,11,13,30,17,16,24,93,89
2017,2,21700098,10/30/2017,1610612762,Utah Jazz,1,1,1610612742,Dallas Mavericks,0,0,22,24,46,16,19,35,38,43,81,12,3,15,10,35,25,4,14,93,104
2018,2,21800079,10/27/2018,1610612748,Miami Heat,1,1,1610612757,Portland Trail Blazers,0,0,29,28,57,15,24,39,44,52,96,17,9,26,20,37,21,7,13,99,120
2019,2,21900104,11/6/2019,1610612754,Indiana Pacers,1,1,1610612764,Washington Wizards,0,0,32,32,64,12,18,30,44,50,94,21,5,26,15,36,35,3,13,102,121
2019,2,21900104,11/6/2019,1610612764,Washington Wizards,0,0,1610612754,Indiana Pacers,1,1,24,31,55,13,27,40,37,58,95,19,0,19,20,38,24,8,17,102,106
2018,2,21800079,10/27/2018,1610612757,Portland Trail Blazers,0,0,1610612748,Miami Heat,1,1,25,30,55,12,21,33,37,51,88,25,3,28,11,42,14,7,9,99,111
2017,2,21700097,10/30/2017,1610612740,New Orleans Pelicans,1,0,1610612753,Orlando Magic,0,1,32,25,57,7,21,28,39,46,85,14,4,18,11,40,30,10,20,103,99
2017,2,21700097,10/30/2017,1610612753,Orlando Magic,0,1,1610612740,New Orleans Pelicans,1,0,27,24,51,16,18,34,43,42,85,13,5,18,9,35,27,9,17,102,115
2018,2,21800078,10/27/2018,1610612755,Philadelphia 76ers,1,1,1610612766,Charlotte Hornets,0,0,25,38,63,10,18,28,35,56,91,25,5,30,16,43,18,3,11,98,105
2018,2,21800078,10/27/2018,1610612766,Charlotte Hornets,0,0,1610612755,Philadelphia 76ers,1,1,28,32,60,9,26,35,37,58,95,20,4,24,16,44,19,4,9,100,103
2020,2,22000964,5/1/2021,1610612742,Dallas Mavericks,1,1,1610612764,Washington Wizards,0,0,30,19,49,17,21,38,47,40,87,14,8,22,11,33,31,5,11,98,125
2020,2,22000964,5/1/2021,1610612764,Washington Wizards,0,0,1610612742,Dallas Mavericks,1,1,41,31,72,6,13,19,47,44,91,24,7,31,16,32,19,6,11,98,124
2023,2,22300814,2/24/2024,1610612753,Orlando Magic,0,1,1610612765,Detroit Pistons,1,0,31,32,63,12,12,24,43,44,87,14,7,21,17,31,25,7,13,92,112
2021,2,22100305,11/29/2021,1610612753,Orlando Magic,0,0,1610612755,Philadelphia 76ers,1,1,29,28,57,8,25,33,37,53,90,14,4,18,10,44,20,7,12,101,96
2021,2,22100305,11/29/2021,1610612755,Philadelphia 76ers,1,1,1610612753,Orlando Magic,0,0,29,35,64,10,23,33,39,58,97,13,5,18,15,47,24,7,11,101,101
2020,2,22000108,1/6/2021,1610612739,Cleveland Cavaliers,0,0,1610612753,Orlando Magic,1,1,32,27,59,4,22,26,36,49,85,18,8,26,15,38,24,4,10,93,94
2020,2,22000108,1/6/2021,1610612753,Orlando Magic,1,1,1610612739,Cleveland Cavaliers,0,0,28,24,52,12,17,29,40,41,81,13,5,18,11,32,20,9,16,93,105
2019,2,21900333,12/7/2019,1610612745,Houston Rockets,1,1,1610612756,Phoenix Suns,0,0,30,21,51,11,29,40,41,50,91,22,8,30,14,40,21,4,16,108,115
2019,2,21900333,12/7/2019,1610612756,Phoenix Suns,0,0,1610612745,Houston Rockets,1,1,29,32,61,11,24,35,40,56,96,18,10,28,17,43,29,10,16,108,109
2019,2,21900103,11/6/2019,1610612752,New York Knicks,0,0,1610612765,Detroit Pistons,1,1,28,27,55,11,14,25,39,41,80,13,8,21,7,37,24,7,14,99,102
2019,2,21900103,11/6/2019,1610612765,Detroit Pistons,1,1,1610612752,New York Knicks,0,0,29,20,49,15,15,30,44,35,79,19,5,24,9,28,37,9,17,97,122
2018,2,21800077,10/27/2018,1610612739,Cleveland Cavaliers,1,0,1610612754,Indiana Pacers,0,1,33,28,61,7,18,25,40,46,86,20,2,22,20,26,21,13,18,93,107
2018,2,21800077,10/27/2018,1610612754,Indiana Pacers,0,1,1610612739,Cleveland Cavaliers,1,0,43,18,61,5,8,13,48,26,74,18,8,26,8,23,28,9,15,92,119
2020,2,22000107,1/6/2021,1610612745,Houston Rockets,0,0,1610612754,Indiana Pacers,1,1,31,20,51,8,22,30,39,42,81,21,5,26,11,31,19,10,16,99,107
2020,2,22000107,1/6/2021,1610612754,Indiana Pacers,1,1,1610612745,Houston Rockets,0,0,33,33,66,9,14,23,42,47,89,21,5,26,16,34,21,7,14,99,114
2017,2,21700096,10/30/2017,1610612763,Memphis Grizzlies,1,0,1610612766,Charlotte Hornets,0,1,24,34,58,8,27,35,32,61,93,27,6,33,17,47,17,3,7,99,99
2017,2,21700096,10/30/2017,1610612766,Charlotte Hornets,0,1,1610612763,Memphis Grizzlies,1,0,30,42,72,7,10,17,37,52,89,23,6,29,16,39,15,7,12,98,104
2016,2,21600741,2/1/2017,1610612744,Golden State Warriors,1,1,1610612766,Charlotte Hornets,0,0,26,22,48,21,27,48,47,49,96,11,3,14,11,40,35,4,10,100,126
2016,2,21600741,2/1/2017,1610612766,Charlotte Hornets,0,0,1610612744,Golden State Warriors,1,1,30,27,57,9,22,31,39,49,88,24,2,26,10,39,33,9,10,101,111
2016,2,21600258,11/28/2016,1610612750,Minnesota Timberwolves,1,0,1610612762,Utah Jazz,0,1,29,33,62,7,12,19,36,45,81,24,1,25,11,35,26,9,15,95,103
2016,2,21600258,11/28/2016,1610612762,Utah Jazz,0,1,1610612750,Minnesota Timberwolves,1,0,36,25,61,4,14,18,40,39,79,28,6,34,13,30,19,8,12,94,112
2014,2,21400980,3/14/2015,1610612762,Utah Jazz,1,1,1610612765,Detroit Pistons,0,0,27,28,55,6,8,14,33,36,69,16,8,24,11,30,17,8,17,87,88
2014,2,21400980,3/14/2015,1610612765,Detroit Pistons,0,0,1610612762,Utah Jazz,1,1,24,37,61,8,15,23,32,52,84,13,9,22,21,37,18,8,14,87,85
2018,2,21801219,4/9/2019,1610612747,Los Angeles Lakers,1,0,1610612757,Portland Trail Blazers,0,1,30,35,65,10,19,29,40,54,94,11,6,17,22,34,29,8,17,98,101
2018,2,21801219,4/9/2019,1610612757,Portland Trail Blazers,0,1,1610612747,Los Angeles Lakers,1,0,26,27,53,11,26,37,37,53,90,19,3,22,16,38,18,6,14,98,104
2021,2,22100304,11/28/2021,1610612747,Los Angeles Lakers,1,1,1610612765,Detroit Pistons,0,0,34,20,54,9,23,32,43,43,86,15,10,25,7,42,32,5,12,102,110
2021,2,22100304,11/28/2021,1610612765,Detroit Pistons,0,0,1610612747,Los Angeles Lakers,1,1,25,31,56,13,20,33,38,51,89,17,2,19,14,37,29,11,17,104,106
2020,2,22000106,1/5/2021,1610612741,Chicago Bulls,0,1,1610612757,Portland Trail Blazers,1,0,24,26,50,16,25,41,40,51,91,15,3,18,15,36,27,8,15,98,111
2020,2,22000106,1/5/2021,1610612757,Portland Trail Blazers,1,0,1610612741,Chicago Bulls,0,1,20,23,43,19,32,51,39,55,94,11,6,17,14,44,23,5,11,99,108
2019,2,21900332,12/7/2019,1610612739,Cleveland Cavaliers,0,0,1610612755,Philadelphia 76ers,1,1,27,34,61,9,26,35,36,60,96,13,4,17,20,43,20,13,18,100,94
2019,2,21900332,12/7/2019,1610612755,Philadelphia 76ers,1,1,1610612739,Cleveland Cavaliers,0,0,46,18,64,11,15,26,57,33,90,16,7,23,11,25,43,4,8,99,141
2023,2,22300193,11/15/2023,1610612737,Atlanta Hawks,1,0,1610612752,New York Knicks,0,1,29,15,44,12,19,31,41,34,75,20,6,26,7,31,28,9,15,94,114
2023,2,22300321,12/14/2023,1610612742,Dallas Mavericks,1,0,1610612750,Minnesota Timberwolves,0,1,32,19,51,7,25,32,39,44,83,16,2,18,7,37,21,9,16,100,101
2020,2,22000963,5/1/2021,1610612754,Indiana Pacers,0,1,1610612760,Oklahoma City Thunder,1,0,36,18,54,21,12,33,57,30,87,17,5,22,4,28,41,8,17,108,152
2020,2,22000963,5/1/2021,1610612760,Oklahoma City Thunder,1,0,1610612754,Indiana Pacers,0,1,30,43,73,8,30,38,38,73,111,11,12,23,27,53,23,7,14,110,95
2017,2,21700095,10/30/2017,1610612745,Houston Rockets,1,0,1610612755,Philadelphia 76ers,0,1,20,16,36,13,34,47,33,50,83,28,10,38,14,42,17,10,15,102,107
2017,2,21700095,10/30/2017,1610612755,Philadelphia 76ers,0,1,1610612745,Houston Rockets,1,0,34,22,56,10,14,24,44,36,80,17,7,24,11,28,27,12,21,102,115
2014,2,21400979,3/14/2015,1610612749,Milwaukee Bucks,0,0,1610612763,Memphis Grizzlies,1,1,25,28,53,5,14,19,30,42,72,18,9,27,11,35,17,10,16,90,83
2023,2,22300419,12/27/2023,1610612760,Oklahoma City Thunder,1,1,1610612752,New York Knicks,0,0,35,23,58,14,18,32,49,41,90,17,5,22,6,36,20,2,4,99,129
2014,2,21400979,3/14/2015,1610612763,Memphis Grizzlies,1,1,1610612749,Milwaukee Bucks,0,0,29,35,64,8,6,14,37,41,78,14,2,16,11,32,23,6,15,89,96
2023,2,22301223,12/8/2023,1610612759,San Antonio Spurs,1,0,1610612741,Chicago Bulls,0,1,22,19,41,17,25,42,39,44,83,17,3,20,12,32,35,9,13,94,112
2023,2,22301223,12/8/2023,1610612741,Chicago Bulls,0,1,1610612759,San Antonio Spurs,1,0,34,40,74,13,15,28,47,55,102,14,10,24,26,36,27,4,8,93,121
2023,2,22300503,1/7/2024,1610612763,Memphis Grizzlies,0,1,1610612756,Phoenix Suns,1,0,26,22,48,17,32,49,43,54,97,18,6,24,21,36,29,5,18,104,121
2023,2,22300513,1/9/2024,1610612750,Minnesota Timberwolves,0,1,1610612753,Orlando Magic,1,0,31,19,50,12,18,30,43,37,80,15,4,19,8,31,34,13,18,98,113
2023,2,22300162,11/8/2023,1610612741,Chicago Bulls,1,0,1610612756,Phoenix Suns,0,1,28,35,63,14,19,33,42,54,96,17,6,23,13,43,30,7,14,109,115
2021,2,22100303,11/28/2021,1610612758,Sacramento Kings,0,0,1610612763,Memphis Grizzlies,1,1,24,31,55,9,33,42,33,64,97,26,11,37,17,54,17,4,8,106,101
2017,2,21700094,10/30/2017,1610612743,Denver Nuggets,0,0,1610612752,New York Knicks,1,1,17,27,44,18,23,41,35,50,85,22,9,31,15,40,20,8,13,99,110
2021,2,22100303,11/28/2021,1610612763,Memphis Grizzlies,1,1,1610612758,Sacramento Kings,0,0,37,28,65,13,26,39,50,54,104,15,5,20,17,38,30,5,10,106,128
2020,2,22000105,1/5/2021,1610612746,LA Clippers,1,0,1610612759,San Antonio Spurs,0,1,28,23,51,15,20,35,43,43,86,12,1,13,9,35,29,9,13,96,113
2020,2,22000105,1/5/2021,1610612759,San Antonio Spurs,0,1,1610612746,LA Clippers,1,0,24,32,56,20,20,40,44,52,96,8,3,11,14,40,23,6,11,96,116
2017,2,21700094,10/30/2017,1610612752,New York Knicks,1,1,1610612743,Denver Nuggets,0,0,28,22,50,13,19,32,41,41,82,21,2,23,18,24,27,13,23,99,116
2018,2,21800076,10/27/2018,1610612737,Atlanta Hawks,1,0,1610612741,Chicago Bulls,0,1,15,29,44,12,28,40,27,57,84,19,4,23,11,47,20,14,22,106,85
2019,2,21900102,11/5/2019,1610612743,Denver Nuggets,1,1,1610612748,Miami Heat,0,0,36,27,63,9,14,23,45,41,86,10,6,16,12,34,35,12,20,97,109
2023,2,22300017,11/14/2023,1610612766,Charlotte Hornets,1,0,1610612748,Miami Heat,0,1,21,28,49,15,17,32,36,45,81,18,4,22,14,32,21,12,18,95,105
2019,2,21900102,11/5/2019,1610612748,Miami Heat,0,0,1610612743,Denver Nuggets,1,1,23,36,59,9,20,29,32,56,88,16,9,25,19,42,23,10,15,97,89
2018,2,21800076,10/27/2018,1610612741,Chicago Bulls,0,1,1610612737,Atlanta Hawks,1,0,24,26,50,12,21,33,36,47,83,13,3,16,10,38,25,9,23,105,97
2023,2,22300410,12/26/2023,1610612740,New Orleans Pelicans,1,0,1610612763,Memphis Grizzlies,0,1,32,34,66,10,21,31,42,55,97,21,12,33,17,45,18,10,15,112,115
2021,2,22100302,11/28/2021,1610612738,Boston Celtics,0,1,1610612761,Toronto Raptors,1,0,22,26,48,12,22,34,34,48,82,29,2,31,19,31,24,6,18,97,109
2021,2,22100302,11/28/2021,1610612761,Toronto Raptors,1,0,1610612738,Boston Celtics,0,1,22,29,51,13,29,42,35,58,93,14,2,16,15,45,19,5,11,96,97
2020,2,22000104,1/5/2021,1610612743,Denver Nuggets,1,1,1610612750,Minnesota Timberwolves,0,0,33,21,54,8,17,25,41,38,79,33,12,45,13,32,22,8,16,104,123
2020,2,22000104,1/5/2021,1610612750,Minnesota Timberwolves,0,0,1610612743,Denver Nuggets,1,1,31,26,57,11,23,34,42,49,91,21,6,27,13,39,24,9,14,104,116
2018,2,21800075,10/27/2018,1610612740,New Orleans Pelicans,1,0,1610612762,Utah Jazz,0,1,31,30,61,9,25,34,40,55,95,22,7,29,17,40,22,7,16,108,111
2018,2,21800075,10/27/2018,1610612762,Utah Jazz,0,1,1610612740,New Orleans Pelicans,1,0,36,20,56,10,22,32,46,42,88,30,7,37,11,34,32,4,13,107,132
2017,2,21700093,10/30/2017,1610612748,Miami Heat,1,0,1610612750,Minnesota Timberwolves,0,1,42,24,66,7,20,27,49,44,93,17,8,25,18,30,17,16,24,110,122
2017,2,21700093,10/30/2017,1610612750,Minnesota Timberwolves,0,1,1610612748,Miami Heat,1,0,30,38,68,11,12,23,41,50,91,32,3,35,12,40,20,8,16,110,125
2018,2,21800074,10/27/2018,1610612738,Boston Celtics,0,1,1610612765,Detroit Pistons,1,0,25,27,52,14,20,34,39,47,86,17,8,25,10,41,25,4,13,102,109
2021,2,22100301,11/28/2021,1610612749,Milwaukee Bucks,0,1,1610612754,Indiana Pacers,1,0,38,17,55,8,27,35,46,44,90,18,4,22,14,33,27,6,14,99,118
2021,2,22100301,11/28/2021,1610612754,Indiana Pacers,1,0,1610612749,Milwaukee Bucks,0,1,26,21,47,12,33,45,38,54,92,12,4,16,14,42,21,7,13,99,100
2023,2,22300166,11/8/2023,1610612750,Minnesota Timberwolves,1,1,1610612740,New Orleans Pelicans,0,0,30,15,45,15,22,37,45,37,82,17,7,24,11,32,30,6,18,102,122
2018,2,21800074,10/27/2018,1610612765,Detroit Pistons,1,0,1610612738,Boston Celtics,0,1,26,26,52,7,30,37,33,56,89,16,4,20,9,48,16,4,11,101,89
2019,2,21900101,11/5/2019,1610612753,Orlando Magic,0,0,1610612760,Oklahoma City Thunder,1,1,29,31,60,3,19,22,32,50,82,27,4,31,18,34,15,9,14,94,94
2019,2,21900101,11/5/2019,1610612760,Oklahoma City Thunder,1,1,1610612753,Orlando Magic,0,0,25,28,53,12,21,33,37,49,86,16,4,20,12,39,21,5,9,94,102
2023,2,22300408,12/26/2023,1610612737,Atlanta Hawks,0,0,1610612741,Chicago Bulls,1,1,28,16,44,13,32,45,41,48,89,18,3,21,17,33,24,10,16,98,113
2023,2,22300060,11/28/2023,1610612758,Sacramento Kings,1,1,1610612744,Golden State Warriors,0,0,26,21,47,15,29,44,41,50,91,27,15,42,14,45,25,6,10,105,124
2018,2,21801068,3/20/2019,1610612752,New York Knicks,1,0,1610612762,Utah Jazz,0,1,32,23,55,13,18,31,45,41,86,13,8,21,10,35,23,7,14,99,116
2018,2,21801068,3/20/2019,1610612762,Utah Jazz,0,1,1610612752,New York Knicks,1,0,28,15,43,20,22,42,48,37,85,21,4,25,8,32,38,6,10,99,137
2023,2,22300342,12/16/2023,1610612758,Sacramento Kings,1,1,1610612762,Utah Jazz,0,0,24,16,40,22,23,45,46,39,85,11,4,15,12,29,36,8,18,98,125
2023,2,22300343,12/16/2023,1610612746,LA Clippers,1,1,1610612752,New York Knicks,0,0,34,21,55,16,17,33,50,38,88,28,6,34,11,28,36,7,9,101,144
2021,2,22100300,11/28/2021,1610612744,Golden State Warriors,0,1,1610612746,LA Clippers,1,0,21,25,46,17,23,40,38,48,86,12,10,22,15,36,25,8,17,101,105
2021,2,22100300,11/28/2021,1610612746,LA Clippers,1,0,1610612744,Golden State Warriors,0,1,23,29,52,9,19,28,32,48,80,17,8,25,17,33,18,19,25,99,90
2020,2,22000103,1/5/2021,1610612747,Los Angeles Lakers,0,1,1610612763,Memphis Grizzlies,1,0,29,27,56,9,22,31,38,49,87,9,2,11,14,36,24,14,17,97,94
2020,2,22000103,1/5/2021,1610612763,Memphis Grizzlies,1,0,1610612747,Los Angeles Lakers,0,1,26,35,61,10,16,26,36,51,87,10,3,13,9,45,24,7,13,95,92
2019,2,21900331,12/7/2019,1610612752,New York Knicks,1,0,1610612754,Indiana Pacers,0,1,29,36,65,10,21,31,39,57,96,15,6,21,20,40,24,7,11,99,103
2019,2,21900331,12/7/2019,1610612754,Indiana Pacers,0,1,1610612752,New York Knicks,1,0,29,28,57,12,16,28,41,44,85,10,3,13,9,38,26,11,17,98,104
2017,2,21700092,10/30/2017,1610612738,Boston Celtics,1,1,1610612759,San Antonio Spurs,0,0,31,26,57,11,20,31,42,46,88,13,3,16,17,30,24,8,15,93,108
2017,2,21700092,10/30/2017,1610612759,San Antonio Spurs,0,0,1610612738,Boston Celtics,1,1,24,37,61,12,14,26,36,51,87,10,10,20,15,42,24,10,11,92,94
2018,2,21800073,10/26/2018,1610612758,Sacramento Kings,1,1,1610612764,Washington Wizards,0,0,30,28,58,14,23,37,44,51,95,14,9,23,16,38,25,8,19,108,116
2018,2,21800073,10/26/2018,1610612764,Washington Wizards,0,0,1610612758,Sacramento Kings,1,1,26,18,44,14,28,42,40,46,86,18,5,23,10,39,22,8,21,109,112
2020,2,22000962,5/1/2021,1610612740,New Orleans Pelicans,0,1,1610612750,Minnesota Timberwolves,1,0,33,23,56,14,22,36,47,45,92,32,14,46,16,39,34,17,21,120,140
2020,2,22000962,5/1/2021,1610612750,Minnesota Timberwolves,1,0,1610612740,New Orleans Pelicans,0,1,33,25,58,15,33,48,48,58,106,25,7,32,19,42,35,8,16,121,136
2018,2,21801218,4/9/2019,1610612745,Houston Rockets,0,0,1610612760,Oklahoma City Thunder,1,1,20,15,35,18,35,53,38,50,88,17,3,20,11,42,18,5,11,96,111
2018,2,21801218,4/9/2019,1610612760,Oklahoma City Thunder,1,1,1610612745,Houston Rockets,0,0,24,31,55,16,25,41,40,56,96,16,4,20,22,35,20,7,12,95,112
2014,2,21400378,12/17/2014,1610612743,Denver Nuggets,1,0,1610612745,Houston Rockets,0,1,27,42,69,13,17,30,40,59,99,18,5,23,18,45,30,7,18,112,111
2014,2,21400378,12/17/2014,1610612745,Houston Rockets,0,1,1610612743,Denver Nuggets,1,0,27,30,57,8,20,28,35,50,85,37,11,48,13,42,17,8,16,111,115
2018,2,21800821,2/8/2019,1610612742,Dallas Mavericks,1,0,1610612749,Milwaukee Bucks,0,1,14,20,34,22,31,53,36,51,87,13,7,20,13,41,23,4,14,99,107
2018,2,21800821,2/8/2019,1610612749,Milwaukee Bucks,0,1,1610612742,Dallas Mavericks,1,0,41,16,57,10,26,36,51,42,93,10,2,12,14,29,25,6,13,97,122
2018,2,21800498,12/25/2018,1610612745,Houston Rockets,1,1,1610612760,Oklahoma City Thunder,0,0,30,23,53,14,30,44,44,53,97,11,6,17,21,35,18,12,20,102,113
2018,2,21800498,12/25/2018,1610612760,Oklahoma City Thunder,0,0,1610612745,Houston Rockets,1,1,34,34,68,9,21,30,43,55,98,14,7,21,21,39,23,9,15,103,109
2018,2,21800245,11/19/2018,1610612743,Denver Nuggets,0,0,1610612749,Milwaukee Bucks,1,1,28,25,53,12,29,41,40,54,94,6,3,9,17,38,30,8,18,100,98
2018,2,21800245,11/19/2018,1610612749,Milwaukee Bucks,1,1,1610612743,Denver Nuggets,0,0,29,23,52,11,25,36,40,48,88,13,9,22,17,34,21,6,18,99,104
2016,2,21600740,2/1/2017,1610612741,Chicago Bulls,0,1,1610612760,Oklahoma City Thunder,1,0,43,23,66,6,9,15,49,32,81,24,6,30,6,27,25,6,9,99,128
2016,2,21600740,2/1/2017,1610612760,Oklahoma City Thunder,1,0,1610612741,Chicago Bulls,0,1,28,35,63,10,27,37,38,62,100,14,3,17,18,45,17,7,9,100,100
2016,2,21600257,11/28/2016,1610612763,Memphis Grizzlies,1,0,1610612766,Charlotte Hornets,0,1,29,31,60,7,22,29,36,53,89,6,7,13,14,42,21,3,12,96,85
2016,2,21600257,11/28/2016,1610612766,Charlotte Hornets,0,1,1610612763,Memphis Grizzlies,1,0,27,29,56,9,17,26,36,46,82,23,8,31,15,35,24,10,14,95,104
2023,2,22300017,11/14/2023,1610612748,Miami Heat,0,1,1610612766,Charlotte Hornets,1,0,32,20,52,8,23,31,40,43,83,23,5,28,11,33,26,6,8,94,111
2014,2,21400978,3/14/2015,1610612751,Brooklyn Nets,0,1,1610612755,Philadelphia 76ers,1,0,35,32,67,2,15,17,37,47,84,18,8,26,13,38,20,7,16,101,94
2014,2,21400978,3/14/2015,1610612755,Philadelphia 76ers,1,0,1610612751,Brooklyn Nets,0,1,27,30,57,8,29,37,35,59,94,9,5,14,16,45,21,9,17,101,87
2020,2,22000961,5/1/2021,1610612753,Orlando Magic,1,1,1610612763,Memphis Grizzlies,0,0,27,33,60,11,14,25,38,47,85,25,3,28,10,39,20,6,11,100,112
2020,2,22000961,5/1/2021,1610612763,Memphis Grizzlies,0,0,1610612753,Orlando Magic,1,1,34,33,67,10,19,29,44,52,96,13,8,21,24,32,21,10,17,99,111
2023,2,22301217,12/8/2023,1610612765,Detroit Pistons,0,0,1610612753,Orlando Magic,1,1,28,23,51,6,24,30,34,47,81,17,7,24,10,41,17,5,16,99,91
2023,2,22300412,12/26/2023,1610612759,San Antonio Spurs,1,0,1610612762,Utah Jazz,0,1,28,35,63,16,19,35,44,54,98,14,7,21,14,42,36,4,9,103,118
2023,2,22300343,12/16/2023,1610612752,New York Knicks,0,0,1610612746,LA Clippers,1,1,33,26,59,11,24,35,44,50,94,23,3,26,15,37,20,8,10,102,122
2023,2,22300459,1/2/2024,1610612755,Philadelphia 76ers,1,1,1610612741,Chicago Bulls,0,0,26,24,50,12,18,30,38,42,80,22,8,30,11,33,28,9,19,102,110
2018,2,21800497,12/25/2018,1610612749,Milwaukee Bucks,0,1,1610612752,New York Knicks,1,0,34,23,57,6,26,32,40,49,89,23,11,34,10,44,22,4,8,103,109
2018,2,21800497,12/25/2018,1610612752,New York Knicks,1,0,1610612749,Milwaukee Bucks,0,1,27,41,68,8,21,29,35,62,97,17,4,21,18,46,17,9,14,103,95
2018,2,21800426,12/14/2018,1610612743,Denver Nuggets,1,1,1610612760,Oklahoma City Thunder,0,0,31,18,49,11,23,34,42,41,83,14,1,15,15,27,29,9,20,96,109
2018,2,21800426,12/14/2018,1610612760,Oklahoma City Thunder,0,0,1610612743,Denver Nuggets,1,1,30,41,71,7,12,19,37,53,90,17,12,29,21,38,14,8,13,96,98
2017,2,21700091,10/29/2017,1610612744,Golden State Warriors,1,0,1610612765,Detroit Pistons,0,1,34,16,50,10,17,27,44,33,77,9,3,12,12,22,29,16,26,93,107
2021,2,22100299,11/27/2021,1610612740,New Orleans Pelicans,0,0,1610612762,Utah Jazz,1,1,32,26,58,8,27,35,40,53,93,17,4,21,18,39,27,9,15,100,105
2021,2,22100299,11/27/2021,1610612762,Utah Jazz,1,1,1610612740,New Orleans Pelicans,0,0,25,20,45,20,15,35,45,35,80,17,5,22,8,31,24,8,18,101,127
2020,2,22000102,1/5/2021,1610612751,Brooklyn Nets,1,1,1610612762,Utah Jazz,0,0,38,19,57,14,22,36,52,41,93,12,4,16,10,33,31,6,13,101,130
2020,2,22000102,1/5/2021,1610612762,Utah Jazz,0,0,1610612751,Brooklyn Nets,1,1,22,30,52,11,23,34,33,53,86,19,8,27,13,45,17,11,15,101,96
2019,2,21900330,12/7/2019,1610612740,New Orleans Pelicans,0,0,1610612742,Dallas Mavericks,1,1,29,28,57,3,29,32,32,57,89,17,4,21,12,48,17,8,15,101,84
2019,2,21900330,12/7/2019,1610612742,Dallas Mavericks,1,1,1610612740,New Orleans Pelicans,0,0,33,15,48,13,25,38,46,40,86,25,6,31,10,31,25,4,13,102,130
2023,2,22300412,12/26/2023,1610612762,Utah Jazz,0,1,1610612759,San Antonio Spurs,1,0,31,21,52,16,27,43,47,48,95,20,2,22,17,32,34,8,14,102,130
2017,2,21700091,10/29/2017,1610612765,Detroit Pistons,0,1,1610612744,Golden State Warriors,1,0,31,35,66,12,15,27,43,50,93,17,0,17,20,30,22,3,14,94,115
2018,2,21800072,10/26/2018,1610612740,New Orleans Pelicans,1,1,1610612751,Brooklyn Nets,0,0,35,40,75,9,14,23,44,54,98,20,6,26,18,40,23,6,11,102,117
2018,2,21800072,10/26/2018,1610612751,Brooklyn Nets,0,0,1610612740,New Orleans Pelicans,1,1,24,34,58,19,21,40,43,55,98,10,5,15,22,34,26,11,21,102,115
2014,2,21400377,12/17/2014,1610612746,LA Clippers,1,1,1610612754,Indiana Pacers,0,0,28,32,60,6,12,18,34,44,78,28,17,45,16,33,20,6,12,97,102
2014,2,21400377,12/17/2014,1610612754,Indiana Pacers,0,0,1610612746,LA Clippers,1,1,36,35,71,4,15,19,40,50,90,16,7,23,16,37,27,7,12,97,100
2018,2,21801067,3/20/2019,1610612738,Boston Celtics,0,0,1610612755,Philadelphia 76ers,1,1,33,31,64,12,20,32,45,51,96,13,3,16,13,39,22,5,9,99,115
2018,2,21801067,3/20/2019,1610612755,Philadelphia 76ers,1,1,1610612738,Boston Celtics,0,0,23,34,57,11,22,33,34,56,90,39,4,43,20,37,23,1,9,99,118
2018,2,21800929,3/1/2019,1610612751,Brooklyn Nets,1,0,1610612766,Charlotte Hornets,0,1,34,20,54,10,22,32,44,42,86,14,4,18,10,33,27,6,17,100,112
2018,2,21800929,3/1/2019,1610612766,Charlotte Hornets,0,1,1610612751,Brooklyn Nets,1,0,41,32,73,9,12,21,50,44,94,14,3,17,15,31,24,2,14,102,123
2023,2,22300513,1/9/2024,1610612753,Orlando Magic,1,0,1610612750,Minnesota Timberwolves,0,1,21,31,52,13,29,42,34,60,94,11,7,18,18,44,20,8,13,98,92
2017,2,21700090,10/29/2017,1610612739,Cleveland Cavaliers,1,0,1610612752,New York Knicks,0,1,21,27,48,10,23,33,31,50,81,23,4,27,10,40,20,9,15,98,95
2017,2,21700090,10/29/2017,1610612752,New York Knicks,0,1,1610612739,Cleveland Cavaliers,1,0,29,32,61,13,15,28,42,47,89,17,4,21,15,36,27,5,14,99,114
2020,2,22000101,1/4/2021,1610612744,Golden State Warriors,1,1,1610612758,Sacramento Kings,0,0,28,26,54,23,20,43,51,46,97,12,2,14,6,41,41,5,11,107,137
2020,2,22000101,1/4/2021,1610612758,Sacramento Kings,0,0,1610612744,Golden State Warriors,1,1,24,31,55,10,25,35,34,56,90,28,11,39,15,47,20,4,15,109,106
2018,2,21800071,10/26/2018,1610612749,Milwaukee Bucks,0,1,1610612750,Minnesota Timberwolves,1,0,30,16,46,19,27,46,49,43,92,8,3,11,7,37,32,10,18,108,125
2018,2,21800071,10/26/2018,1610612750,Minnesota Timberwolves,1,0,1610612749,Milwaukee Bucks,0,1,26,43,69,10,33,43,36,76,112,13,5,18,20,59,19,4,8,107,95
2019,2,21900100,11/5/2019,1610612741,Chicago Bulls,1,0,1610612747,Los Angeles Lakers,0,1,29,24,53,14,18,32,43,42,85,12,11,23,8,39,22,10,16,103,112
2019,2,21900100,11/5/2019,1610612747,Los Angeles Lakers,0,1,1610612741,Chicago Bulls,1,0,34,25,59,11,22,33,45,47,92,17,7,24,14,38,26,11,16,104,118
2023,2,22300419,12/27/2023,1610612752,New York Knicks,0,0,1610612760,Oklahoma City Thunder,1,1,27,21,48,14,20,34,41,41,82,24,6,30,15,29,24,6,18,100,120
2023,2,22300949,3/13/2024,1610612748,Miami Heat,1,0,1610612743,Denver Nuggets,0,1,29,30,59,5,16,21,34,46,80,15,3,18,11,36,18,4,9,88,88
2023,2,22300333,12/15/2023,1610612756,Phoenix Suns,1,0,1610612752,New York Knicks,0,1,36,26,62,11,17,28,47,43,90,17,4,21,13,30,30,9,12,97,122
2020,2,22000100,1/4/2021,1610612740,New Orleans Pelicans,1,0,1610612754,Indiana Pacers,0,1,35,39,74,9,18,27,44,57,101,19,5,24,21,39,26,10,18,106,116
2017,2,21700089,10/29/2017,1610612758,Sacramento Kings,1,0,1610612764,Washington Wizards,0,1,26,34,60,6,16,22,32,50,82,13,3,16,14,36,13,9,20,96,83
2017,2,21700089,10/29/2017,1610612764,Washington Wizards,0,1,1610612758,Sacramento Kings,1,0,23,28,51,17,17,34,40,45,85,13,7,20,15,33,28,8,17,96,110
2021,2,22100298,11/27/2021,1610612742,Dallas Mavericks,1,0,1610612764,Washington Wizards,0,1,28,23,51,14,24,38,42,47,89,16,6,22,12,38,23,4,7,95,114
2021,2,22100298,11/27/2021,1610612764,Washington Wizards,0,1,1610612742,Dallas Mavericks,1,0,36,18,54,9,15,24,45,33,78,21,5,26,9,27,28,7,15,95,120
2023,2,22300018,11/14/2023,1610612765,Detroit Pistons,1,0,1610612737,Atlanta Hawks,0,1,37,24,61,10,19,29,47,43,90,16,7,23,15,32,36,9,17,102,120
2020,2,22000100,1/4/2021,1610612754,Indiana Pacers,0,1,1610612740,New Orleans Pelicans,1,0,26,22,48,19,26,45,45,48,93,9,4,13,6,44,32,5,14,106,118
2019,2,21900329,12/6/2019,1610612747,Los Angeles Lakers,0,1,1610612757,Portland Trail Blazers,1,0,29,20,49,17,19,36,46,39,85,27,6,33,11,31,26,9,19,108,136
2019,2,21900329,12/6/2019,1610612757,Portland Trail Blazers,1,0,1610612747,Los Angeles Lakers,0,1,29,23,52,10,24,34,39,47,86,25,4,29,8,42,20,10,15,108,113
2019,2,21900099,11/5/2019,1610612737,Atlanta Hawks,1,1,1610612759,San Antonio Spurs,0,0,32,28,60,11,19,30,43,47,90,11,5,16,15,33,22,9,18,102,108
2019,2,21900099,11/5/2019,1610612759,San Antonio Spurs,0,0,1610612737,Atlanta Hawks,1,1,30,28,58,8,25,33,38,53,91,16,7,23,15,42,18,9,15,102,100
2020,2,22000960,5/1/2021,1610612739,Cleveland Cavaliers,1,0,1610612748,Miami Heat,0,1,17,17,34,20,20,40,37,37,74,13,4,17,10,28,30,12,19,92,107
2020,2,22000960,5/1/2021,1610612748,Miami Heat,0,1,1610612739,Cleveland Cavaliers,1,0,29,22,51,18,18,36,47,40,87,12,3,15,11,32,30,3,8,92,124
2018,2,21800070,10/26/2018,1610612745,Houston Rockets,1,0,1610612746,LA Clippers,0,1,23,34,57,15,26,41,38,60,98,22,3,25,21,40,21,8,13,102,113
2018,2,21800070,10/26/2018,1610612746,LA Clippers,0,1,1610612745,Houston Rockets,1,0,31,25,56,12,11,23,43,36,79,35,3,38,11,26,17,11,16,103,133
2022,2,22200554,1/2/2023,1610612740,New Orleans Pelicans,0,0,1610612755,Philadelphia 76ers,1,1,31,24,55,11,18,29,42,42,84,16,4,20,15,30,26,9,17,98,111
2017,2,21700088,10/29/2017,1610612753,Orlando Magic,0,0,1610612766,Charlotte Hornets,1,1,30,34,64,11,22,33,41,56,97,20,6,26,13,48,28,6,11,105,113
2017,2,21700088,10/29/2017,1610612766,Charlotte Hornets,1,1,1610612753,Orlando Magic,0,0,47,32,79,6,12,18,53,44,97,8,9,17,18,30,31,11,17,106,120
2018,2,21800069,10/26/2018,1610612742,Dallas Mavericks,0,0,1610612761,Toronto Raptors,1,1,26,36,62,12,18,30,38,54,92,19,5,24,17,40,22,10,15,102,107
2022,2,22200554,1/2/2023,1610612755,Philadelphia 76ers,1,1,1610612740,New Orleans Pelicans,0,0,26,25,51,15,20,35,41,45,86,23,5,28,9,39,26,3,10,97,120
2020,2,22000099,1/4/2021,1610612749,Milwaukee Bucks,1,1,1610612765,Detroit Pistons,0,0,35,16,51,14,20,34,49,36,85,13,3,16,11,27,32,9,19,100,125
2020,2,22000099,1/4/2021,1610612765,Detroit Pistons,0,0,1610612749,Milwaukee Bucks,1,1,26,32,58,17,23,40,43,55,98,12,0,12,11,44,27,6,9,100,115
2022,2,22201160,3/31/2023,1610612756,Phoenix Suns,1,1,1610612743,Denver Nuggets,0,0,27,34,61,10,17,27,37,51,88,16,5,21,17,37,28,11,16,98,100
2023,2,22300196,11/15/2023,1610612741,Chicago Bulls,1,0,1610612753,Orlando Magic,0,1,24,26,50,9,24,33,33,50,83,19,3,22,16,36,16,12,19,97,94
2023,2,22300428,12/28/2023,1610612766,Charlotte Hornets,0,0,1610612747,Los Angeles Lakers,1,1,25,27,52,15,18,33,40,45,85,17,11,28,11,40,29,11,19,105,112
2018,2,21801217,4/9/2019,1610612743,Denver Nuggets,0,0,1610612762,Utah Jazz,1,1,29,34,63,12,13,25,41,47,88,14,8,22,8,43,24,5,7,98,108
2018,2,21801217,4/9/2019,1610612762,Utah Jazz,1,1,1610612743,Denver Nuggets,0,0,31,20,51,10,17,27,41,37,78,26,8,34,11,28,24,9,15,96,118
2018,2,21800930,3/1/2019,1610612757,Portland Trail Blazers,0,0,1610612761,Toronto Raptors,1,1,28,24,52,14,19,33,42,43,85,19,4,23,14,31,24,9,18,101,117
2018,2,21800930,3/1/2019,1610612761,Toronto Raptors,1,1,1610612757,Portland Trail Blazers,0,0,35,18,53,10,18,28,45,36,81,19,2,21,3,34,29,9,14,101,119
2023,2,22300435,12/29/2023,1610612760,Oklahoma City Thunder,0,1,1610612743,Denver Nuggets,1,0,34,22,56,12,23,35,46,45,91,15,1,16,13,33,29,6,12,99,119
2018,2,21800727,1/25/2019,1610612749,Milwaukee Bucks,1,1,1610612766,Charlotte Hornets,0,0,35,23,58,6,25,31,41,48,89,20,3,23,8,43,17,4,12,102,108
2018,2,21800727,1/25/2019,1610612766,Charlotte Hornets,0,0,1610612749,Milwaukee Bucks,1,1,26,25,51,10,29,39,36,54,90,17,8,25,14,44,20,9,17,103,99
2023,2,22300411,12/26/2023,1610612760,Oklahoma City Thunder,1,1,1610612750,Minnesota Timberwolves,0,0,31,11,42,18,21,39,49,32,81,13,3,16,4,29,35,8,15,98,129
2023,2,22300437,12/29/2023,1610612759,San Antonio Spurs,0,0,1610612757,Portland Trail Blazers,1,1,34,27,61,14,19,33,48,46,94,18,7,25,18,30,31,8,14,103,128
2023,2,22300501,1/7/2024,1610612742,Dallas Mavericks,1,1,1610612750,Minnesota Timberwolves,0,0,28,27,55,15,25,40,43,52,95,14,6,20,22,33,20,6,11,93,115
2021,2,22100297,11/27/2021,1610612745,Houston Rockets,1,1,1610612766,Charlotte Hornets,0,0,28,18,46,23,26,49,51,44,95,21,10,31,17,31,36,10,16,108,146
2021,2,22100297,11/27/2021,1610612766,Charlotte Hornets,0,0,1610612745,Houston Rockets,1,1,28,25,53,20,30,50,48,55,103,27,3,30,20,36,31,5,10,107,143
2019,2,21900328,12/6/2019,1610612758,Sacramento Kings,0,0,1610612759,San Antonio Spurs,1,1,31,37,68,9,25,34,40,62,102,15,3,18,23,41,19,10,15,106,104
2019,2,21900328,12/6/2019,1610612759,San Antonio Spurs,1,1,1610612758,Sacramento Kings,0,0,30,34,64,11,21,32,41,55,96,12,5,17,16,41,25,10,16,105,105
2014,2,21400376,12/17/2014,1610612749,Milwaukee Bucks,0,0,1610612757,Portland Trail Blazers,1,1,30,28,58,7,12,19,37,40,77,16,6,22,7,37,16,4,13,94,97
2018,2,21800069,10/26/2018,1610612761,Toronto Raptors,1,1,1610612742,Dallas Mavericks,0,0,33,31,64,11,16,27,44,47,91,17,3,20,13,35,23,6,13,101,116
2014,2,21400376,12/17/2014,1610612757,Portland Trail Blazers,1,1,1610612749,Milwaukee Bucks,0,0,34,30,64,7,16,23,41,46,87,15,14,29,20,31,25,8,14,94,104
2018,2,21801216,4/9/2019,1610612742,Dallas Mavericks,1,1,1610612756,Phoenix Suns,0,0,25,26,51,16,24,40,41,50,91,22,5,27,20,35,28,13,22,106,120
2018,2,21801216,4/9/2019,1610612756,Phoenix Suns,0,0,1610612742,Dallas Mavericks,1,1,25,28,53,13,22,35,38,50,88,20,8,28,9,48,21,6,14,106,109
2023,2,22300333,12/15/2023,1610612752,New York Knicks,0,1,1610612756,Phoenix Suns,1,0,32,21,53,17,12,29,49,33,82,24,4,28,9,27,28,4,11,95,139
2023,2,22300409,12/26/2023,1610612745,Houston Rockets,1,0,1610612754,Indiana Pacers,0,1,42,31,73,5,19,24,47,50,97,18,4,22,17,35,19,5,11,100,117
2023,2,22300501,1/7/2024,1610612750,Minnesota Timberwolves,0,0,1610612742,Dallas Mavericks,1,1,28,25,53,13,28,41,41,53,94,13,8,21,22,34,22,7,13,95,108
2023,2,22300194,11/15/2023,1610612738,Boston Celtics,0,1,1610612755,Philadelphia 76ers,1,0,24,14,38,18,32,50,42,46,88,15,4,19,15,33,23,5,10,92,117
2017,2,21700087,10/29/2017,1610612743,Denver Nuggets,0,1,1610612751,Brooklyn Nets,1,0,36,38,74,11,9,20,47,47,94,19,3,22,5,43,23,5,6,104,124
2020,2,22000098,1/4/2021,1610612742,Dallas Mavericks,0,1,1610612745,Houston Rockets,1,0,23,20,43,16,23,39,39,43,82,19,1,20,14,29,24,5,18,95,113
2020,2,22000098,1/4/2021,1610612745,Houston Rockets,1,0,1610612742,Dallas Mavericks,0,1,19,18,37,11,29,40,30,47,77,29,7,36,9,42,17,4,12,95,100
2023,2,22300193,11/15/2023,1610612752,New York Knicks,0,1,1610612737,Atlanta Hawks,1,0,29,31,60,16,18,34,45,49,94,10,1,11,22,27,29,11,17,94,116
2017,2,21700087,10/29/2017,1610612751,Brooklyn Nets,1,0,1610612743,Denver Nuggets,0,1,27,38,65,12,19,31,39,57,96,21,10,31,21,42,24,7,15,105,111
2016,2,21600739,2/1/2017,1610612746,LA Clippers,0,1,1610612756,Phoenix Suns,1,0,39,27,66,5,14,19,44,41,85,31,7,38,11,33,20,5,10,103,124
2020,2,22000959,5/1/2021,1610612737,Atlanta Hawks,1,1,1610612741,Chicago Bulls,0,0,23,15,38,14,22,36,37,37,74,20,6,26,7,33,19,11,15,95,108
2020,2,22000959,5/1/2021,1610612741,Chicago Bulls,0,0,1610612737,Atlanta Hawks,1,1,34,27,61,6,18,24,40,45,85,11,6,17,10,39,22,11,13,95,97
2016,2,21600739,2/1/2017,1610612756,Phoenix Suns,1,0,1610612746,LA Clippers,0,1,32,44,76,7,13,20,39,57,96,29,6,35,19,39,21,9,12,102,114
2023,2,22300695,2/2/2024,1610612760,Oklahoma City Thunder,1,1,1610612766,Charlotte Hornets,0,0,27,12,39,17,19,36,44,31,75,21,6,27,4,29,31,12,19,102,126
2017,2,21700086,10/29/2017,1610612754,Indiana Pacers,1,1,1610612759,San Antonio Spurs,0,0,26,29,55,10,12,22,36,41,77,15,5,20,11,31,21,12,19,95,97
2017,2,21700086,10/29/2017,1610612759,San Antonio Spurs,0,0,1610612754,Indiana Pacers,1,1,27,35,62,9,19,28,36,54,90,13,5,18,18,41,19,9,17,96,94
2021,2,22100296,11/27/2021,1610612741,Chicago Bulls,1,0,1610612748,Miami Heat,0,1,27,15,42,11,28,39,38,43,81,17,4,21,15,29,22,13,23,96,104
2021,2,22100296,11/27/2021,1610612748,Miami Heat,0,1,1610612741,Chicago Bulls,1,0,23,23,46,14,26,40,37,49,86,19,3,22,11,39,23,6,10,96,107
2018,2,21800068,10/26/2018,1610612744,Golden State Warriors,0,1,1610612752,New York Knicks,1,0,35,19,54,16,17,33,51,36,87,10,2,12,6,31,26,6,14,101,128
2018,2,21800068,10/26/2018,1610612752,New York Knicks,1,0,1610612744,Golden State Warriors,0,1,26,25,51,13,26,39,39,51,90,9,3,12,16,36,17,10,20,103,100
2019,2,21900327,12/6/2019,1610612746,LA Clippers,0,0,1610612749,Milwaukee Bucks,1,1,25,37,62,8,24,32,33,61,94,17,2,19,20,42,18,11,21,105,91
2014,2,21400977,3/14/2015,1610612758,Sacramento Kings,0,0,1610612764,Washington Wizards,1,1,29,29,58,6,13,19,35,42,77,21,7,28,12,35,24,8,17,94,97
2019,2,21900327,12/6/2019,1610612749,Milwaukee Bucks,1,1,1610612746,LA Clippers,0,0,30,28,58,14,22,36,44,50,94,17,4,21,15,37,29,9,16,105,119
2019,2,21900098,11/5/2019,1610612738,Boston Celtics,0,1,1610612739,Cleveland Cavaliers,1,0,36,19,55,12,18,30,48,37,85,11,4,15,5,33,24,3,14,102,119
2019,2,21900098,11/5/2019,1610612739,Cleveland Cavaliers,1,0,1610612738,Boston Celtics,0,1,27,35,62,13,20,33,40,55,95,20,2,22,13,42,22,5,9,101,113
2014,2,21400977,3/14/2015,1610612764,Washington Wizards,1,1,1610612758,Sacramento Kings,0,0,30,25,55,13,13,26,43,38,81,14,3,17,10,29,28,4,13,92,113
2014,2,21400375,12/17/2014,1610612759,San Antonio Spurs,1,0,1610612763,Memphis Grizzlies,0,1,26,44,70,17,18,35,43,62,105,13,14,27,23,47,31,12,16,111,116
2014,2,21400375,12/17/2014,1610612763,Memphis Grizzlies,0,1,1610612759,San Antonio Spurs,1,0,38,42,80,10,17,27,48,59,107,11,3,14,18,41,29,6,12,108,117
2018,2,21801066,3/20/2019,1610612740,New Orleans Pelicans,0,0,1610612753,Orlando Magic,1,1,28,40,68,10,24,34,38,64,102,10,3,13,19,46,24,8,13,103,96
2018,2,21801066,3/20/2019,1610612753,Orlando Magic,1,1,1610612740,New Orleans Pelicans,0,0,31,33,64,15,23,38,46,56,102,12,2,14,20,38,28,9,14,102,119
2018,2,21800820,2/8/2019,1610612741,Chicago Bulls,0,1,1610612751,Brooklyn Nets,1,0,32,25,57,14,14,28,46,39,85,19,5,24,12,30,27,9,18,102,125
2018,2,21800820,2/8/2019,1610612751,Brooklyn Nets,1,0,1610612741,Chicago Bulls,0,1,26,27,53,13,28,41,39,55,94,15,1,16,13,43,26,5,13,102,106
2017,2,21700085,10/29/2017,1610612737,Atlanta Hawks,1,0,1610612749,Milwaukee Bucks,0,1,23,25,48,13,16,29,36,41,77,21,5,26,5,40,27,9,16,101,106
2021,2,22100295,11/27/2021,1610612739,Cleveland Cavaliers,1,1,1610612753,Orlando Magic,0,0,27,24,51,14,25,39,41,49,90,9,3,12,13,38,28,11,13,96,105
2021,2,22100295,11/27/2021,1610612753,Orlando Magic,0,0,1610612739,Cleveland Cavaliers,1,1,27,29,56,8,24,32,35,53,88,14,9,23,12,44,21,3,9,96,92
2020,2,22000097,1/4/2021,1610612738,Boston Celtics,0,1,1610612761,Toronto Raptors,1,0,26,29,55,15,14,29,41,43,84,29,5,34,15,30,19,13,20,103,126
2020,2,22000097,1/4/2021,1610612761,Toronto Raptors,1,0,1610612738,Boston Celtics,0,1,23,30,53,13,24,37,36,54,90,29,9,38,13,47,20,3,10,104,114
2017,2,21700085,10/29/2017,1610612749,Milwaukee Bucks,0,1,1610612737,Atlanta Hawks,1,0,31,24,55,13,13,26,44,37,81,16,5,21,5,35,30,9,14,100,117
2018,2,21800067,10/26/2018,1610612741,Chicago Bulls,0,0,1610612766,Charlotte Hornets,1,1,21,28,49,16,20,36,37,48,85,16,6,22,11,40,21,10,14,99,106
2019,2,21900097,11/5/2019,1610612754,Indiana Pacers,0,0,1610612766,Charlotte Hornets,1,1,39,25,64,12,18,30,51,43,94,6,1,7,9,34,27,7,18,106,120
2019,2,21900097,11/5/2019,1610612766,Charlotte Hornets,1,1,1610612754,Indiana Pacers,0,0,32,25,57,10,21,31,42,46,88,28,14,42,14,39,22,5,13,106,122
2018,2,21800067,10/26/2018,1610612766,Charlotte Hornets,1,1,1610612741,Chicago Bulls,0,0,39,22,61,14,18,32,53,40,93,15,1,16,13,27,30,5,12,98,135
2016,2,21600256,11/28/2016,1610612738,Boston Celtics,0,1,1610612748,Miami Heat,1,0,29,27,56,11,16,27,40,43,83,21,5,26,10,36,26,6,10,96,112
2016,2,21600256,11/28/2016,1610612748,Miami Heat,1,0,1610612738,Boston Celtics,0,1,32,18,50,6,24,30,38,42,80,22,10,32,10,35,24,4,13,97,104
2018,2,21800300,11/26/2018,1610612744,Golden State Warriors,1,1,1610612753,Orlando Magic,0,0,28,21,49,13,22,35,41,43,84,21,2,23,14,29,21,11,15,97,116
2018,2,21800300,11/26/2018,1610612753,Orlando Magic,0,0,1610612744,Golden State Warriors,1,1,26,34,60,14,16,30,40,50,90,16,5,21,12,39,28,8,11,98,110
2018,2,21800138,11/4/2018,1610612750,Minnesota Timberwolves,0,0,1610612757,Portland Trail Blazers,1,1,22,41,63,7,23,30,29,64,93,16,5,21,16,50,18,7,11,100,81
2018,2,21800138,11/4/2018,1610612757,Portland Trail Blazers,1,1,1610612750,Minnesota Timberwolves,0,0,31,27,58,7,21,28,38,48,86,28,4,32,20,29,15,9,17,98,111
2021,2,22100294,11/27/2021,1610612751,Brooklyn Nets,1,0,1610612756,Phoenix Suns,0,1,35,26,61,7,16,23,42,42,84,16,5,21,12,32,25,11,20,101,107
2020,2,22000096,1/4/2021,1610612748,Miami Heat,1,1,1610612760,Oklahoma City Thunder,0,0,30,17,47,16,18,34,46,35,81,10,8,18,7,33,34,6,16,99,118
2021,2,22100294,11/27/2021,1610612756,Phoenix Suns,0,1,1610612751,Brooklyn Nets,1,0,28,26,54,13,25,38,41,51,92,18,3,21,15,38,17,7,13,102,113
2020,2,22000096,1/4/2021,1610612760,Oklahoma City Thunder,0,0,1610612748,Miami Heat,1,1,16,15,31,13,35,48,29,50,79,19,8,27,10,45,20,7,18,100,90
2019,2,21900326,12/6/2019,1610612750,Minnesota Timberwolves,0,0,1610612760,Oklahoma City Thunder,1,1,37,21,58,13,25,38,50,46,96,14,6,20,13,35,25,8,13,106,127
2019,2,21900326,12/6/2019,1610612760,Oklahoma City Thunder,1,1,1610612750,Minnesota Timberwolves,0,0,44,26,70,5,13,18,49,39,88,36,4,40,13,28,19,8,10,107,139
2017,2,21700084,10/28/2017,1610612746,LA Clippers,1,0,1610612765,Detroit Pistons,0,1,13,33,46,15,23,38,28,56,84,16,6,22,18,40,19,11,19,96,87
2017,2,21700084,10/28/2017,1610612765,Detroit Pistons,0,1,1610612746,LA Clippers,1,0,27,33,60,9,19,28,36,52,88,14,7,21,17,38,16,6,13,96,95
2020,2,22000958,5/1/2021,1610612744,Golden State Warriors,0,1,1610612745,Houston Rockets,1,0,21,17,38,18,28,46,39,45,84,17,7,24,7,41,32,9,17,105,113
2020,2,22000958,5/1/2021,1610612745,Houston Rockets,1,0,1610612744,Golden State Warriors,0,1,23,24,47,9,33,42,32,57,89,14,8,22,14,47,20,10,20,105,87
2018,2,21800066,10/25/2018,1610612743,Denver Nuggets,0,0,1610612747,Los Angeles Lakers,1,1,40,29,69,6,17,23,46,46,92,16,4,20,15,35,22,13,19,105,114
2018,2,21800066,10/25/2018,1610612747,Los Angeles Lakers,1,1,1610612743,Denver Nuggets,0,0,36,27,63,10,19,29,46,46,92,19,4,23,13,35,27,8,14,104,121
2016,2,21600738,2/1/2017,1610612749,Milwaukee Bucks,0,0,1610612762,Utah Jazz,1,1,23,27,50,9,14,23,32,41,73,15,10,25,10,38,19,11,17,93,88
2016,2,21600738,2/1/2017,1610612762,Utah Jazz,1,1,1610612749,Milwaukee Bucks,0,0,25,24,49,11,18,29,36,42,78,21,6,27,12,32,22,10,16,92,104
2018,2,21801215,4/9/2019,1610612740,New Orleans Pelicans,1,0,1610612744,Golden State Warriors,0,1,35,31,66,9,24,33,44,55,99,6,4,10,10,48,29,8,10,102,103
2023,2,22300491,1/5/2024,1610612747,Los Angeles Lakers,1,0,1610612763,Memphis Grizzlies,0,1,32,25,57,10,18,28,42,43,85,19,8,27,10,38,26,8,14,101,113
2021,2,22100293,11/27/2021,1610612737,Atlanta Hawks,1,0,1610612752,New York Knicks,0,1,24,32,56,9,28,37,33,60,93,15,5,20,17,44,18,4,7,92,90
2021,2,22100293,11/27/2021,1610612752,New York Knicks,0,1,1610612737,Atlanta Hawks,1,0,25,28,53,11,18,29,36,46,82,16,6,22,10,39,20,8,10,92,99
2020,2,22000095,1/4/2021,1610612737,Atlanta Hawks,1,0,1610612752,New York Knicks,0,1,30,26,56,10,21,31,40,47,87,18,5,23,13,36,24,9,13,98,108
2020,2,22000095,1/4/2021,1610612752,New York Knicks,0,1,1610612737,Atlanta Hawks,1,0,36,28,64,7,14,21,43,42,85,20,5,25,14,30,26,4,16,98,113
2022,2,22201159,3/31/2023,1610612758,Sacramento Kings,0,1,1610612757,Portland Trail Blazers,1,0,35,14,49,19,20,39,54,34,88,11,4,15,10,26,38,9,13,100,138
2019,2,21900325,12/6/2019,1610612741,Chicago Bulls,1,0,1610612744,Golden State Warriors,0,1,22,25,47,17,24,41,39,49,88,3,2,5,13,38,21,9,15,94,98
2019,2,21900325,12/6/2019,1610612744,Golden State Warriors,0,1,1610612741,Chicago Bulls,1,0,29,18,47,9,15,24,38,33,71,15,7,22,8,27,24,11,20,93,100
2019,2,21900096,11/4/2019,1610612744,Golden State Warriors,1,1,1610612757,Portland Trail Blazers,0,0,32,28,60,10,16,26,42,44,86,33,3,36,14,30,28,5,10,100,127
2019,2,21900096,11/4/2019,1610612757,Portland Trail Blazers,0,0,1610612744,Golden State Warriors,1,1,34,31,65,13,27,40,47,58,105,11,3,14,19,40,16,4,6,101,118
2017,2,21700083,10/28/2017,1610612756,Phoenix Suns,0,0,1610612757,Portland Trail Blazers,1,1,28,33,61,9,17,26,37,50,87,24,6,30,14,42,21,8,17,105,107
2017,2,21700083,10/28/2017,1610612757,Portland Trail Blazers,1,1,1610612756,Phoenix Suns,0,0,29,36,65,11,15,26,40,51,91,23,5,28,15,36,27,12,15,105,114
2022,2,22201174,4/2/2023,1610612749,Milwaukee Bucks,1,1,1610612755,Philadelphia 76ers,0,0,36,16,52,10,18,28,46,34,80,15,6,21,11,26,28,3,12,91,117
2023,2,22300060,11/28/2023,1610612744,Golden State Warriors,0,0,1610612758,Sacramento Kings,1,1,23,19,42,17,24,41,40,43,83,26,4,30,10,36,25,8,20,105,123
2023,2,22301217,12/8/2023,1610612753,Orlando Magic,1,1,1610612765,Detroit Pistons,0,0,39,24,63,10,16,26,49,40,89,15,4,19,8,32,26,3,10,99,123
2023,2,22300602,1/21/2024,1610612764,Washington Wizards,1,0,1610612743,Denver Nuggets,0,1,31,33,64,8,19,27,39,52,91,18,4,22,16,39,31,9,13,98,104
2022,2,22201158,3/31/2023,1610612759,San Antonio Spurs,0,0,1610612744,Golden State Warriors,1,1,27,26,53,15,23,38,42,49,91,16,7,23,18,35,27,5,15,100,115
2020,2,22000094,1/4/2021,1610612755,Philadelphia 76ers,1,1,1610612766,Charlotte Hornets,0,0,35,28,63,11,21,32,46,49,95,15,8,23,14,40,34,4,10,102,118
2020,2,22000094,1/4/2021,1610612766,Charlotte Hornets,0,0,1610612755,Philadelphia 76ers,1,1,23,24,47,13,26,39,36,50,86,16,6,22,12,42,30,7,17,102,101
2021,2,22100292,11/27/2021,1610612750,Minnesota Timberwolves,0,1,1610612755,Philadelphia 76ers,1,0,34,26,60,14,22,36,48,48,96,11,5,16,15,35,22,13,21,112,121
2021,2,22100292,11/27/2021,1610612755,Philadelphia 76ers,1,0,1610612750,Minnesota Timberwolves,0,1,27,32,59,12,22,34,39,54,93,30,9,39,17,45,27,7,16,112,120
2018,2,21800065,10/25/2018,1610612738,Boston Celtics,0,1,1610612760,Oklahoma City Thunder,1,0,22,32,54,11,21,32,33,53,86,24,9,33,15,43,19,5,12,99,101
2018,2,21800065,10/25/2018,1610612760,Oklahoma City Thunder,1,0,1610612738,Boston Celtics,0,1,30,36,66,7,21,28,37,57,94,14,11,25,21,41,19,7,16,101,95
2020,2,22000957,5/1/2021,1610612765,Detroit Pistons,0,0,1610612766,Charlotte Hornets,1,1,22,32,54,13,24,37,35,56,91,11,6,17,18,43,27,8,13,95,94
2020,2,22000957,5/1/2021,1610612766,Charlotte Hornets,1,1,1610612765,Detroit Pistons,0,0,28,22,50,14,23,37,42,45,87,9,11,20,16,34,24,6,14,94,107
2018,2,21801215,4/9/2019,1610612744,Golden State Warriors,0,1,1610612740,New Orleans Pelicans,1,0,31,28,59,12,18,30,43,46,89,14,7,21,11,38,25,9,15,102,112
2020,2,22000093,1/4/2021,1610612739,Cleveland Cavaliers,0,0,1610612753,Orlando Magic,1,1,23,34,57,10,18,28,33,52,85,7,5,12,15,39,20,9,16,93,83
2017,2,21700082,10/28/2017,1610612747,Los Angeles Lakers,0,0,1610612762,Utah Jazz,1,1,26,33,59,5,17,22,31,50,81,14,6,20,18,35,17,9,16,91,81
2017,2,21700082,10/28/2017,1610612762,Utah Jazz,1,1,1610612747,Los Angeles Lakers,0,0,24,24,48,13,18,31,37,42,79,9,4,13,19,25,18,12,23,91,96
2014,2,21400976,3/14/2015,1610612738,Boston Celtics,0,1,1610612754,Indiana Pacers,1,0,27,28,55,8,20,28,35,48,83,15,6,21,12,38,28,4,12,93,93
2021,2,22100291,11/26/2021,1610612747,Los Angeles Lakers,1,0,1610612758,Sacramento Kings,0,1,36,22,58,15,29,44,51,51,102,20,8,28,12,43,32,11,19,123,137
2021,2,22100291,11/26/2021,1610612758,Sacramento Kings,0,1,1610612747,Los Angeles Lakers,1,0,40,35,75,14,31,45,54,66,120,19,10,29,25,45,32,9,15,123,141
2020,2,22000093,1/4/2021,1610612753,Orlando Magic,1,1,1610612739,Cleveland Cavaliers,0,0,23,31,54,15,19,34,38,50,88,12,1,13,22,28,22,12,21,93,103
2014,2,21400976,3/14/2015,1610612754,Indiana Pacers,1,0,1610612738,Boston Celtics,0,1,25,36,61,9,15,24,34,51,85,12,3,15,14,40,16,7,17,94,89
2016,2,21600255,11/28/2016,1610612752,New York Knicks,1,0,1610612760,Oklahoma City Thunder,0,1,30,42,72,6,13,19,36,55,91,25,3,28,16,40,20,4,5,96,103
2023,2,22300858,3/1/2024,1610612766,Charlotte Hornets,0,0,1610612755,Philadelphia 76ers,1,1,29,22,51,14,19,33,43,41,84,14,3,17,10,34,24,5,5,86,114
2016,2,21600255,11/28/2016,1610612760,Oklahoma City Thunder,0,1,1610612752,New York Knicks,1,0,38,32,70,8,14,22,46,46,92,12,6,18,21,31,25,9,14,95,112
2023,2,22300427,12/28/2023,1610612759,San Antonio Spurs,0,1,1610612757,Portland Trail Blazers,1,0,31,18,49,10,26,36,41,44,85,26,2,28,10,36,33,6,11,99,118
2023,2,22300219,11/20/2023,1610612749,Milwaukee Bucks,0,1,1610612764,Washington Wizards,1,0,44,21,65,11,18,29,55,39,94,21,7,28,20,22,33,6,15,101,142
2023,2,22300884,3/4/2024,1610612760,Oklahoma City Thunder,0,0,1610612747,Los Angeles Lakers,1,1,22,33,55,15,24,39,37,57,94,15,1,16,13,44,22,8,10,97,104
2021,2,22100290,11/26/2021,1610612744,Golden State Warriors,1,1,1610612757,Portland Trail Blazers,0,0,35,15,50,12,25,37,47,40,87,12,4,16,11,30,31,7,15,97,118
2021,2,22100290,11/26/2021,1610612757,Portland Trail Blazers,0,0,1610612744,Golden State Warriors,1,1,23,25,48,13,25,38,36,50,86,18,5,23,12,39,23,8,10,97,103
2023,2,22300884,3/4/2024,1610612747,Los Angeles Lakers,1,1,1610612760,Oklahoma City Thunder,0,0,25,21,46,16,18,34,41,39,80,18,7,25,14,27,29,12,21,98,116
2018,2,21800064,10/25/2018,1610612753,Orlando Magic,1,0,1610612757,Portland Trail Blazers,0,1,31,25,56,12,18,30,43,43,86,16,4,20,12,33,29,6,14,95,114
2018,2,21800064,10/25/2018,1610612757,Portland Trail Blazers,0,1,1610612753,Orlando Magic,1,0,37,23,60,11,16,27,48,39,87,21,5,26,12,30,24,5,11,97,128
2019,2,21900324,12/6/2019,1610612748,Miami Heat,1,1,1610612764,Washington Wizards,0,0,32,26,58,10,18,28,42,44,86,18,6,24,16,31,28,6,14,95,112
2019,2,21900324,12/6/2019,1610612764,Washington Wizards,0,0,1610612748,Miami Heat,1,1,27,25,52,12,27,39,39,52,91,13,1,14,13,40,29,6,11,95,103
2019,2,21900095,11/4/2019,1610612755,Philadelphia 76ers,0,0,1610612756,Phoenix Suns,1,1,29,31,60,13,16,29,42,47,89,12,8,20,13,40,21,6,20,105,109
2019,2,21900095,11/4/2019,1610612756,Phoenix Suns,1,1,1610612755,Philadelphia 76ers,0,0,30,19,49,11,17,28,41,36,77,21,6,27,7,32,24,11,20,103,114
2022,2,22201159,3/31/2023,1610612757,Portland Trail Blazers,1,0,1610612758,Sacramento Kings,0,1,21,26,47,19,19,38,40,45,85,15,8,23,15,35,29,11,20,100,114
2020,2,22000956,4/30/2021,1610612747,Los Angeles Lakers,1,0,1610612758,Sacramento Kings,0,1,35,20,55,7,21,28,42,41,83,15,6,21,15,29,24,10,21,99,106
2020,2,22000956,4/30/2021,1610612758,Sacramento Kings,0,1,1610612747,Los Angeles Lakers,1,0,27,26,53,12,21,33,39,47,86,20,2,22,15,33,29,9,17,99,110
2018,2,21800928,3/1/2019,1610612737,Atlanta Hawks,1,0,1610612741,Chicago Bulls,0,1,39,24,63,22,38,60,61,62,123,17,8,25,12,55,33,10,20,142,161
2018,2,21800928,3/1/2019,1610612741,Chicago Bulls,0,1,1610612737,Atlanta Hawks,1,0,35,36,71,21,27,48,56,63,119,35,13,48,17,53,30,11,17,142,168
2018,2,21800651,1/15/2019,1610612754,Indiana Pacers,1,1,1610612756,Phoenix Suns,0,0,34,30,64,12,13,25,46,43,89,27,9,36,12,36,31,8,14,106,131
2017,2,21700081,10/28/2017,1610612742,Dallas Mavericks,1,0,1610612755,Philadelphia 76ers,0,1,19,15,34,19,21,40,38,36,74,15,4,19,7,33,22,10,18,96,110
2017,2,21700081,10/28/2017,1610612755,Philadelphia 76ers,0,1,1610612742,Dallas Mavericks,1,0,27,25,52,16,19,35,43,44,87,10,4,14,14,31,25,7,14,95,112
2020,2,22000092,1/3/2021,1610612744,Golden State Warriors,1,1,1610612757,Portland Trail Blazers,0,0,36,18,54,13,21,34,49,39,88,26,8,34,13,29,23,7,15,105,137
2014,2,21400975,3/13/2015,1610612757,Portland Trail Blazers,1,1,1610612765,Detroit Pistons,0,0,35,24,59,11,10,21,46,34,80,15,2,17,8,27,28,5,10,89,118
2021,2,22100289,11/26/2021,1610612740,New Orleans Pelicans,0,1,1610612762,Utah Jazz,1,0,27,35,62,11,16,27,38,51,89,11,2,13,14,38,27,6,14,96,98
2021,2,22100289,11/26/2021,1610612762,Utah Jazz,1,0,1610612740,New Orleans Pelicans,0,1,23,24,47,13,20,33,36,44,80,12,6,18,12,34,17,8,18,95,97
2020,2,22000092,1/3/2021,1610612757,Portland Trail Blazers,0,0,1610612744,Golden State Warriors,1,1,27,28,55,14,29,43,41,57,98,26,7,33,18,42,16,4,12,106,122
2022,2,22201158,3/31/2023,1610612744,Golden State Warriors,1,1,1610612759,San Antonio Spurs,0,0,26,18,44,21,28,49,47,46,93,15,6,21,17,34,37,8,15,99,130
2014,2,21400975,3/13/2015,1610612765,Detroit Pistons,0,0,1610612757,Portland Trail Blazers,1,1,34,32,66,7,18,25,41,50,91,10,2,12,14,37,23,2,6,90,99
2022,2,22201173,4/2/2023,1610612754,Indiana Pacers,0,0,1610612739,Cleveland Cavaliers,1,1,27,32,59,9,15,24,36,47,83,24,5,29,15,34,21,7,17,100,105
2018,2,21801214,4/9/2019,1610612750,Minnesota Timberwolves,1,0,1610612761,Toronto Raptors,0,1,25,24,49,13,29,42,38,53,91,11,3,14,8,48,26,10,12,101,100
2018,2,21801214,4/9/2019,1610612761,Toronto Raptors,0,1,1610612750,Minnesota Timberwolves,1,0,30,21,51,16,21,37,46,42,88,12,5,17,12,31,24,10,18,102,120
2023,2,22300879,3/4/2024,1610612751,Brooklyn Nets,1,0,1610612763,Memphis Grizzlies,0,1,20,17,37,15,27,42,35,44,79,17,13,30,16,36,27,6,13,90,102
2018,2,21801065,3/20/2019,1610612739,Cleveland Cavaliers,1,1,1610612749,Milwaukee Bucks,0,0,28,26,54,11,28,39,39,54,93,18,6,24,16,41,18,9,12,100,107
2018,2,21801065,3/20/2019,1610612749,Milwaukee Bucks,0,0,1610612739,Cleveland Cavaliers,1,1,23,36,59,13,19,32,36,55,91,17,4,21,14,42,24,4,10,99,102
2018,2,21800819,2/8/2019,1610612739,Cleveland Cavaliers,0,0,1610612764,Washington Wizards,1,1,24,34,58,12,26,38,36,60,96,22,3,25,19,43,21,10,14,103,106
2018,2,21800819,2/8/2019,1610612764,Washington Wizards,1,1,1610612739,Cleveland Cavaliers,0,0,34,23,57,12,23,35,46,46,92,15,1,16,11,36,35,6,16,102,119
2018,2,21800726,1/25/2019,1610612742,Dallas Mavericks,1,1,1610612765,Detroit Pistons,0,0,23,22,45,14,22,36,37,44,81,18,12,30,12,36,24,6,10,92,106
2018,2,21800726,1/25/2019,1610612765,Detroit Pistons,0,0,1610612742,Dallas Mavericks,1,1,23,24,47,12,26,38,35,50,85,19,6,25,17,35,22,8,13,93,101
2017,2,21700080,10/28/2017,1610612745,Houston Rockets,0,0,1610612763,Memphis Grizzlies,1,1,15,24,39,14,24,38,29,48,77,17,4,21,11,40,18,10,19,94,89
2017,2,21700080,10/28/2017,1610612763,Memphis Grizzlies,1,1,1610612745,Houston Rockets,0,0,26,26,52,14,19,33,40,45,85,9,3,12,7,37,26,4,9,93,103
2018,2,21800063,10/25/2018,1610612739,Cleveland Cavaliers,0,0,1610612765,Detroit Pistons,1,1,33,32,65,8,16,24,41,48,89,13,2,15,9,40,18,4,9,96,103
2019,2,21900323,12/6/2019,1610612738,Boston Celtics,1,1,1610612743,Denver Nuggets,0,0,31,16,47,13,22,35,44,38,82,7,1,8,8,30,21,5,16,94,108
2019,2,21900323,12/6/2019,1610612743,Denver Nuggets,0,0,1610612738,Boston Celtics,1,1,34,30,64,5,25,30,39,55,94,12,3,15,21,35,18,5,14,95,95
2019,2,21900094,11/4/2019,1610612749,Milwaukee Bucks,0,1,1610612750,Minnesota Timberwolves,1,0,36,18,54,14,25,39,50,43,93,20,10,30,13,35,24,12,17,111,134
2019,2,21900094,11/4/2019,1610612750,Minnesota Timberwolves,1,0,1610612749,Milwaukee Bucks,0,1,24,36,60,13,30,43,37,66,103,19,3,22,18,49,20,8,16,111,106
2018,2,21800063,10/25/2018,1610612765,Detroit Pistons,1,1,1610612739,Cleveland Cavaliers,0,0,30,20,50,11,17,28,41,37,78,17,12,29,16,24,21,11,20,95,110
2020,2,22000955,4/30/2021,1610612756,Phoenix Suns,1,1,1610612762,Utah Jazz,0,0,37,18,55,11,22,33,48,40,88,14,5,19,13,30,27,8,11,94,121
2020,2,22000955,4/30/2021,1610612762,Utah Jazz,0,0,1610612756,Phoenix Suns,1,1,21,20,41,14,25,39,35,45,80,16,2,18,8,38,22,7,14,94,100
2017,2,21700079,10/28/2017,1610612741,Chicago Bulls,1,0,1610612760,Oklahoma City Thunder,0,1,12,29,41,10,27,37,22,56,78,15,5,20,15,42,16,16,20,94,69
2017,2,21700079,10/28/2017,1610612760,Oklahoma City Thunder,0,1,1610612741,Chicago Bulls,1,0,26,28,54,13,21,34,39,49,88,10,4,14,15,37,28,9,12,93,101
2021,2,22100288,11/26/2021,1610612743,Denver Nuggets,1,0,1610612749,Milwaukee Bucks,0,1,23,22,45,17,30,47,40,52,92,12,2,14,12,40,24,3,8,95,109
2021,2,22100288,11/26/2021,1610612749,Milwaukee Bucks,0,1,1610612743,Denver Nuggets,1,0,30,10,40,16,17,33,46,27,73,12,8,20,9,22,24,9,22,95,120
2020,2,22000091,1/3/2021,1610612746,LA Clippers,0,1,1610612756,Phoenix Suns,1,0,23,31,54,17,12,29,40,43,83,15,4,19,11,33,24,4,10,92,112
2020,2,22000091,1/3/2021,1610612756,Phoenix Suns,1,0,1610612746,LA Clippers,0,1,27,15,42,10,23,33,37,38,75,23,5,28,10,30,23,5,14,92,107
2018,2,21800062,10/24/2018,1610612744,Golden State Warriors,1,1,1610612764,Washington Wizards,0,0,38,21,59,15,18,33,53,39,92,23,2,25,12,28,37,7,18,109,144
2018,2,21800062,10/24/2018,1610612764,Washington Wizards,0,0,1610612744,Golden State Warriors,1,1,30,21,51,12,30,42,42,51,93,26,2,28,10,42,22,6,12,110,122
2023,2,22300044,11/24/2023,1610612763,Memphis Grizzlies,1,0,1610612756,Phoenix Suns,0,1,28,19,47,9,24,33,37,43,80,6,4,10,8,37,22,10,15,92,89
2016,2,21600737,2/1/2017,1610612743,Denver Nuggets,1,0,1610612763,Memphis Grizzlies,0,1,23,32,55,9,16,25,32,48,80,26,9,35,15,39,25,6,17,98,99
2016,2,21600737,2/1/2017,1610612763,Memphis Grizzlies,0,1,1610612743,Denver Nuggets,1,0,31,31,62,14,16,30,45,47,92,15,5,20,13,37,28,7,8,98,119
2014,2,21400974,3/13/2015,1610612737,Atlanta Hawks,0,1,1610612756,Phoenix Suns,1,0,31,34,65,8,10,18,39,44,83,10,2,12,10,35,22,7,12,91,96
2014,2,21400974,3/13/2015,1610612756,Phoenix Suns,1,0,1610612737,Atlanta Hawks,0,1,22,30,52,10,16,26,32,46,78,13,8,21,16,33,19,11,18,92,87
2018,2,21800927,2/28/2019,1610612755,Philadelphia 76ers,0,1,1610612760,Oklahoma City Thunder,1,0,30,31,61,12,18,30,42,49,91,12,7,19,14,38,33,5,14,100,108
2018,2,21800927,2/28/2019,1610612760,Oklahoma City Thunder,1,0,1610612755,Philadelphia 76ers,0,1,30,30,60,8,19,27,38,49,87,20,8,28,12,41,28,9,12,100,104
2022,2,22201175,4/2/2023,1610612744,Golden State Warriors,0,0,1610612743,Denver Nuggets,1,1,33,30,63,9,33,42,42,63,105,17,0,17,29,34,26,11,15,102,110
2023,2,22301221,12/8/2023,1610612763,Memphis Grizzlies,1,0,1610612750,Minnesota Timberwolves,0,1,22,29,51,15,20,35,37,49,86,14,5,19,10,40,24,4,10,94,103
2023,2,22300695,2/2/2024,1610612766,Charlotte Hornets,0,0,1610612760,Oklahoma City Thunder,1,1,27,34,61,14,17,31,41,51,92,10,4,14,11,42,22,10,14,100,106
2023,2,22300172,11/9/2023,1610612737,Atlanta Hawks,0,1,1610612753,Orlando Magic,1,0,26,20,46,15,24,39,41,44,85,23,7,30,14,33,22,12,18,103,120
2020,2,22000090,1/3/2021,1610612741,Chicago Bulls,1,1,1610612742,Dallas Mavericks,0,0,26,22,48,13,24,37,39,46,85,27,3,30,14,34,16,6,16,100,118
2020,2,22000090,1/3/2021,1610612742,Dallas Mavericks,0,0,1610612741,Chicago Bulls,1,1,28,19,47,11,31,42,39,50,89,19,8,27,17,39,23,11,15,100,108
2019,2,21900322,12/6/2019,1610612754,Indiana Pacers,0,0,1610612765,Detroit Pistons,1,1,29,30,59,9,15,24,38,45,83,16,4,20,9,38,24,7,12,97,101
2019,2,21900322,12/6/2019,1610612765,Detroit Pistons,1,1,1610612754,Indiana Pacers,0,0,28,34,62,11,14,25,39,48,87,19,7,26,20,30,21,8,18,95,108
2019,2,21900093,11/4/2019,1610612745,Houston Rockets,0,1,1610612763,Memphis Grizzlies,1,0,18,25,43,17,33,50,35,58,93,20,9,29,20,42,20,13,18,102,107
2019,2,21900093,11/4/2019,1610612763,Memphis Grizzlies,1,0,1610612745,Houston Rockets,0,1,37,32,69,3,22,25,40,54,94,17,4,21,16,40,19,6,15,102,100
2020,2,22000954,4/30/2021,1610612741,Chicago Bulls,1,0,1610612749,Milwaukee Bucks,0,1,27,36,63,10,23,33,37,59,96,14,7,21,16,46,23,5,10,100,98
2020,2,22000954,4/30/2021,1610612749,Milwaukee Bucks,0,1,1610612741,Chicago Bulls,1,0,33,32,65,9,16,25,42,48,90,15,5,20,10,40,24,5,11,100,108
2017,2,21700078,10/28/2017,1610612738,Boston Celtics,0,1,1610612748,Miami Heat,1,0,28,30,58,6,17,23,34,47,81,22,4,26,15,35,15,6,12,92,96
2017,2,21700078,10/28/2017,1610612748,Miami Heat,1,0,1610612738,Boston Celtics,0,1,27,21,48,7,24,31,34,45,79,15,1,16,13,32,17,11,19,92,90
2020,2,22000089,1/3/2021,1610612759,San Antonio Spurs,1,0,1610612762,Utah Jazz,0,1,38,48,86,6,13,19,44,61,105,15,6,21,15,49,23,4,7,105,109
2021,2,22100287,11/26/2021,1610612738,Boston Celtics,0,0,1610612759,San Antonio Spurs,1,1,24,34,58,10,24,34,34,58,92,10,5,15,14,47,20,7,11,94,88
2021,2,22100287,11/26/2021,1610612759,San Antonio Spurs,1,1,1610612738,Boston Celtics,0,0,32,31,63,6,18,24,38,49,87,14,5,19,14,39,21,4,11,95,96
2020,2,22000089,1/3/2021,1610612762,Utah Jazz,0,1,1610612759,San Antonio Spurs,1,0,28,20,48,21,20,41,49,40,89,11,8,19,13,31,29,13,20,105,130
2017,2,21700077,10/28/2017,1610612739,Cleveland Cavaliers,0,0,1610612740,New Orleans Pelicans,1,1,24,22,46,12,20,32,36,42,78,17,6,23,6,39,19,10,18,100,101
2017,2,21700077,10/28/2017,1610612740,New Orleans Pelicans,1,1,1610612739,Cleveland Cavaliers,0,0,36,26,62,13,20,33,49,46,95,12,4,16,14,34,33,8,11,101,123
2020,2,22000953,4/30/2021,1610612753,Orlando Magic,0,0,1610612763,Memphis Grizzlies,1,1,21,39,60,6,20,26,27,59,86,15,5,20,17,43,16,10,20,98,75
2020,2,22000953,4/30/2021,1610612763,Memphis Grizzlies,1,1,1610612753,Orlando Magic,0,0,23,37,60,11,28,39,34,65,99,13,3,16,17,48,25,4,9,99,92
2020,2,22000088,1/3/2021,1610612743,Denver Nuggets,0,1,1610612750,Minnesota Timberwolves,1,0,26,21,47,19,26,45,45,47,92,15,6,21,22,29,34,11,15,97,124
2020,2,22000088,1/3/2021,1610612750,Minnesota Timberwolves,1,0,1610612743,Denver Nuggets,0,1,34,20,54,10,21,31,44,41,85,11,5,16,11,33,30,6,14,96,109
2023,2,22301220,12/8/2023,1610612748,Miami Heat,1,0,1610612739,Cleveland Cavaliers,0,1,22,22,44,15,27,42,37,49,86,10,5,15,11,41,23,13,18,100,99
2019,2,21900321,12/6/2019,1610612739,Cleveland Cavaliers,1,0,1610612753,Orlando Magic,0,1,25,24,49,10,24,34,35,48,83,7,3,10,13,37,22,10,18,93,87
2019,2,21900321,12/6/2019,1610612753,Orlando Magic,0,1,1610612739,Cleveland Cavaliers,1,0,23,33,56,9,17,26,32,50,82,20,3,23,16,36,19,9,17,93,93
2023,2,22300395,12/23/2023,1610612762,Utah Jazz,0,1,1610612761,Toronto Raptors,1,0,31,22,53,17,21,38,48,43,91,13,1,14,13,30,35,7,12,97,126
2019,2,21900092,11/4/2019,1610612740,New Orleans Pelicans,0,0,1610612751,Brooklyn Nets,1,1,35,30,65,13,19,32,48,49,97,16,5,21,15,37,18,13,21,110,125
2019,2,21900092,11/4/2019,1610612751,Brooklyn Nets,1,1,1610612740,New Orleans Pelicans,0,0,33,18,51,16,25,41,49,43,92,21,7,28,16,30,32,16,23,110,135
2014,2,21400973,3/13/2015,1610612743,Denver Nuggets,1,1,1610612744,Golden State Warriors,0,0,33,32,65,8,9,17,41,41,82,24,13,37,17,29,23,5,14,97,114
2018,2,21800061,10/24/2018,1610612758,Sacramento Kings,1,1,1610612763,Memphis Grizzlies,0,0,29,36,65,6,12,18,35,48,83,21,12,33,16,39,19,7,17,101,97
2018,2,21800061,10/24/2018,1610612763,Memphis Grizzlies,0,0,1610612758,Sacramento Kings,1,1,26,31,57,10,27,37,36,58,94,10,3,13,14,46,18,7,15,102,92
2016,2,21600736,2/1/2017,1610612742,Dallas Mavericks,1,1,1610612755,Philadelphia 76ers,0,0,30,30,60,10,16,26,40,46,86,23,5,28,15,34,22,5,11,95,113
2014,2,21400973,3/13/2015,1610612744,Golden State Warriors,0,0,1610612743,Denver Nuggets,1,1,31,42,73,8,11,19,39,53,92,17,5,22,13,42,29,4,8,96,103
2016,2,21600736,2/1/2017,1610612755,Philadelphia 76ers,0,0,1610612742,Dallas Mavericks,1,1,29,26,55,6,16,22,35,42,77,19,7,26,7,38,21,10,13,97,95
2023,2,22300456,1/1/2024,1610612757,Portland Trail Blazers,0,0,1610612756,Phoenix Suns,1,1,25,25,50,8,22,30,33,47,80,14,5,19,10,40,21,10,19,99,88
2018,2,21801213,4/9/2019,1610612741,Chicago Bulls,1,0,1610612752,New York Knicks,0,1,23,38,61,7,15,22,30,53,83,19,10,29,9,51,14,0,7,95,86
2021,2,22100286,11/26/2021,1610612760,Oklahoma City Thunder,1,0,1610612764,Washington Wizards,0,1,27,34,61,11,22,33,38,56,94,12,2,14,17,40,23,2,10,95,99
2021,2,22100286,11/26/2021,1610612764,Washington Wizards,0,1,1610612760,Oklahoma City Thunder,1,0,28,22,50,10,19,29,38,41,79,15,0,15,6,35,17,7,15,94,101
2023,2,22300397,12/23/2023,1610612747,Los Angeles Lakers,0,1,1610612760,Oklahoma City Thunder,1,0,31,27,58,16,16,32,47,43,90,19,4,23,13,32,37,6,9,97,129
2023,2,22300426,12/28/2023,1610612748,Miami Heat,0,1,1610612744,Golden State Warriors,1,0,34,26,60,10,21,31,44,47,91,16,6,22,17,33,26,4,10,94,114
2020,2,22000087,1/3/2021,1610612747,Los Angeles Lakers,0,1,1610612763,Memphis Grizzlies,1,0,29,25,54,12,23,35,41,48,89,14,5,19,14,37,24,6,10,94,108
2023,2,22300426,12/28/2023,1610612744,Golden State Warriors,1,0,1610612748,Miami Heat,0,1,29,26,55,8,25,33,37,51,88,20,5,25,15,39,27,6,13,96,102
2020,2,22000087,1/3/2021,1610612763,Memphis Grizzlies,1,0,1610612747,Los Angeles Lakers,0,1,30,32,62,9,24,33,39,56,95,7,1,8,18,39,23,9,13,94,94
2023,2,22300455,1/1/2024,1610612766,Charlotte Hornets,0,0,1610612743,Denver Nuggets,1,1,26,34,60,10,16,26,36,50,86,11,5,16,13,40,24,9,14,96,93
2017,2,21700076,10/27/2017,1610612747,Los Angeles Lakers,1,0,1610612761,Toronto Raptors,0,1,33,23,56,3,20,23,36,43,79,17,7,24,11,35,20,12,21,101,92
2017,2,21700076,10/27/2017,1610612761,Toronto Raptors,0,1,1610612747,Los Angeles Lakers,1,0,33,31,64,7,22,29,40,53,93,14,6,20,14,41,27,7,14,101,101
2018,2,21801213,4/9/2019,1610612752,New York Knicks,0,1,1610612741,Chicago Bulls,1,0,23,30,53,14,26,40,37,56,93,8,5,13,13,46,17,7,9,96,96
2018,2,21801064,3/19/2019,1610612746,LA Clippers,1,1,1610612754,Indiana Pacers,0,0,33,22,55,10,24,34,43,46,89,19,8,27,12,39,28,8,13,104,115
2023,2,22301206,12/6/2023,1610612765,Detroit Pistons,1,0,1610612763,Memphis Grizzlies,0,1,30,26,56,11,24,35,41,50,91,9,0,9,11,39,30,10,17,100,102
2023,2,22300334,12/16/2023,1610612749,Milwaukee Bucks,1,1,1610612765,Detroit Pistons,0,0,31,15,46,19,23,42,50,38,88,27,5,32,13,27,24,10,15,103,146
2023,2,22300195,11/15/2023,1610612761,Toronto Raptors,1,0,1610612749,Milwaukee Bucks,0,1,29,34,63,9,24,33,38,58,96,27,4,31,27,33,28,8,14,98,112
2023,2,22300396,12/23/2023,1610612739,Cleveland Cavaliers,0,1,1610612741,Chicago Bulls,1,0,27,16,43,12,33,45,39,49,88,19,7,26,21,32,28,6,13,92,109
2023,2,22300428,12/28/2023,1610612747,Los Angeles Lakers,1,1,1610612766,Charlotte Hornets,0,0,37,30,67,15,15,30,52,45,97,14,0,14,9,36,41,5,11,104,133
2023,2,22300456,1/1/2024,1610612756,Phoenix Suns,1,1,1610612757,Portland Trail Blazers,0,0,27,24,51,11,18,29,38,42,80,22,11,33,13,34,24,6,16,99,109
2021,2,22100285,11/26/2021,1610612737,Atlanta Hawks,0,1,1610612763,Memphis Grizzlies,1,0,39,23,62,13,14,27,52,37,89,15,6,21,11,28,33,8,12,100,132
2021,2,22100285,11/26/2021,1610612763,Memphis Grizzlies,1,0,1610612737,Atlanta Hawks,0,1,25,28,53,12,26,38,37,54,91,14,5,19,13,45,27,8,13,100,100
2019,2,21900320,12/6/2019,1610612751,Brooklyn Nets,0,1,1610612766,Charlotte Hornets,1,0,27,23,50,15,23,38,42,46,88,12,3,15,20,27,35,6,18,96,111
2019,2,21900320,12/6/2019,1610612766,Charlotte Hornets,1,0,1610612751,Brooklyn Nets,0,1,19,24,43,17,23,40,36,47,83,15,2,17,13,36,23,12,19,95,104
2022,2,22201174,4/2/2023,1610612755,Philadelphia 76ers,0,0,1610612749,Milwaukee Bucks,1,1,28,23,51,12,24,36,40,47,87,12,1,13,12,36,19,8,11,91,104
2023,2,22301220,12/8/2023,1610612739,Cleveland Cavaliers,0,1,1610612748,Miami Heat,1,0,26,23,49,14,24,38,40,47,87,17,9,26,13,37,21,5,13,98,111
2023,2,22300241,11/25/2023,1610612737,Atlanta Hawks,0,1,1610612764,Washington Wizards,1,0,34,31,65,18,19,37,52,50,102,14,6,20,19,34,29,5,10,101,136
2019,2,21900091,11/4/2019,1610612764,Washington Wizards,1,1,1610612765,Detroit Pistons,0,0,35,29,64,8,21,29,43,50,93,21,4,25,17,35,27,4,12,98,115
2019,2,21900091,11/4/2019,1610612765,Detroit Pistons,0,0,1610612764,Washington Wizards,1,1,21,34,55,13,14,27,34,48,82,18,5,23,17,32,21,9,21,96,99
2020,2,22000952,4/30/2021,1610612751,Brooklyn Nets,1,0,1610612757,Portland Trail Blazers,0,1,27,27,54,13,28,41,40,55,95,16,3,19,12,43,20,3,8,99,109
2020,2,22000952,4/30/2021,1610612757,Portland Trail Blazers,0,1,1610612751,Brooklyn Nets,1,0,31,24,55,16,20,36,47,44,91,18,2,20,12,32,24,6,10,100,128
2018,2,21800060,10/24/2018,1610612747,Los Angeles Lakers,0,1,1610612756,Phoenix Suns,1,0,42,30,72,10,18,28,52,48,100,17,6,23,17,35,34,4,8,104,131
2018,2,21800060,10/24/2018,1610612756,Phoenix Suns,1,0,1610612747,Los Angeles Lakers,0,1,34,19,53,10,21,31,44,40,84,15,6,21,10,32,27,13,20,104,113
2023,2,22300512,1/9/2024,1610612758,Sacramento Kings,0,1,1610612765,Detroit Pistons,1,0,41,20,61,13,20,33,54,40,94,10,4,14,14,28,39,12,18,104,131
2023,2,22300427,12/28/2023,1610612757,Portland Trail Blazers,1,0,1610612759,San Antonio Spurs,0,1,24,41,65,11,25,36,35,66,101,24,8,32,30,40,16,9,13,101,105
2023,2,22300458,1/1/2024,1610612748,Miami Heat,0,0,1610612746,LA Clippers,1,1,24,25,49,11,23,34,35,48,83,23,6,29,16,33,24,10,14,96,104
2023,2,22300185,11/12/2023,1610612756,Phoenix Suns,1,0,1610612760,Oklahoma City Thunder,0,1,23,31,54,9,20,29,32,51,83,26,5,31,21,33,20,9,17,94,99
2023,2,22300457,1/1/2024,1610612762,Utah Jazz,1,1,1610612742,Dallas Mavericks,0,0,37,15,52,12,32,44,49,47,96,17,1,18,14,33,37,6,13,102,127
2021,2,22100284,11/26/2021,1610612754,Indiana Pacers,1,1,1610612761,Toronto Raptors,0,0,36,22,58,11,28,39,47,50,97,9,2,11,22,29,31,8,13,93,114
2023,2,22300492,1/5/2024,1610612758,Sacramento Kings,1,1,1610612761,Toronto Raptors,0,0,31,31,62,21,17,38,52,48,100,10,5,15,20,31,35,5,16,103,135
2017,2,21700075,10/27/2017,1610612744,Golden State Warriors,1,1,1610612764,Washington Wizards,0,0,36,21,57,10,28,38,46,49,95,18,2,20,18,32,33,7,18,105,120
2017,2,21700075,10/27/2017,1610612764,Washington Wizards,0,0,1610612744,Golden State Warriors,1,1,28,36,64,15,18,33,43,54,97,16,6,22,18,37,30,7,15,106,117
2016,2,21600254,11/28/2016,1610612755,Philadelphia 76ers,0,0,1610612761,Toronto Raptors,1,1,22,30,52,14,20,34,36,50,86,9,4,13,16,36,27,11,16,92,95
2016,2,21600254,11/28/2016,1610612761,Toronto Raptors,1,1,1610612755,Philadelphia 76ers,0,0,29,29,58,13,6,19,42,35,77,25,6,31,12,27,22,9,12,92,122
2017,2,21700074,10/27/2017,1610612750,Minnesota Timberwolves,1,1,1610612760,Oklahoma City Thunder,0,0,34,30,64,8,14,22,42,44,86,27,8,35,21,27,23,8,16,97,119
2017,2,21700074,10/27/2017,1610612760,Oklahoma City Thunder,0,0,1610612750,Minnesota Timberwolves,1,1,35,23,58,8,20,28,43,43,86,22,3,25,15,30,19,5,14,97,116
2018,2,21800059,10/24/2018,1610612749,Milwaukee Bucks,1,1,1610612755,Philadelphia 76ers,0,0,28,29,57,13,30,43,41,59,100,28,2,30,14,46,24,4,11,109,123
2017,2,21700073,10/27/2017,1610612751,Brooklyn Nets,0,0,1610612752,New York Knicks,1,1,19,26,45,11,19,30,30,45,75,15,6,21,7,41,18,7,16,94,86
2017,2,21700073,10/27/2017,1610612752,New York Knicks,1,1,1610612751,Brooklyn Nets,0,0,35,36,71,9,18,27,44,54,98,10,7,17,23,34,19,5,12,94,107
2018,2,21800059,10/24/2018,1610612755,Philadelphia 76ers,0,0,1610612749,Milwaukee Bucks,1,1,27,31,58,11,23,34,38,54,92,21,9,30,14,46,29,7,16,109,108
2021,2,22100284,11/26/2021,1610612761,Toronto Raptors,0,0,1610612754,Indiana Pacers,1,1,30,29,59,7,23,30,37,52,89,16,6,22,16,40,17,6,11,94,97
2020,2,22000086,1/3/2021,1610612751,Brooklyn Nets,1,0,1610612764,Washington Wizards,0,1,26,23,49,14,18,32,40,41,81,28,3,31,7,36,25,9,20,108,122
2020,2,22000086,1/3/2021,1610612764,Washington Wizards,0,1,1610612751,Brooklyn Nets,1,0,31,40,71,12,21,33,43,61,104,25,9,34,19,47,27,5,7,109,123
2018,2,21801212,4/9/2019,1610612748,Miami Heat,1,1,1610612755,Philadelphia 76ers,0,0,33,27,60,13,14,27,46,41,87,17,6,23,9,35,29,11,15,103,122
2018,2,21801212,4/9/2019,1610612755,Philadelphia 76ers,0,0,1610612748,Miami Heat,1,1,35,38,73,5,20,25,40,58,98,14,2,16,18,40,22,6,15,103,99
2018,2,21801064,3/19/2019,1610612754,Indiana Pacers,0,0,1610612746,LA Clippers,1,1,38,28,66,7,14,21,45,42,87,12,5,17,12,32,30,14,20,103,109
2018,2,21800818,2/8/2019,1610612743,Denver Nuggets,0,0,1610612755,Philadelphia 76ers,1,1,40,28,68,6,20,26,46,48,94,12,1,13,11,37,35,7,13,103,110
2018,2,21800818,2/8/2019,1610612755,Philadelphia 76ers,1,1,1610612743,Denver Nuggets,0,0,29,27,56,10,12,22,39,39,78,29,3,32,9,33,23,5,17,102,117
2018,2,21800651,1/15/2019,1610612756,Phoenix Suns,0,0,1610612754,Indiana Pacers,1,1,32,36,68,8,19,27,40,55,95,9,9,18,16,44,26,11,19,107,97
2018,2,21800425,12/14/2018,1610612748,Miami Heat,0,1,1610612763,Memphis Grizzlies,1,0,21,22,43,15,24,39,36,46,82,13,5,18,20,27,30,9,17,88,100
2018,2,21800425,12/14/2018,1610612763,Memphis Grizzlies,1,0,1610612748,Miami Heat,0,1,27,27,54,8,21,29,35,48,83,19,6,25,13,38,21,3,8,90,97
2018,2,21800359,12/5/2018,1610612755,Philadelphia 76ers,0,0,1610612761,Toronto Raptors,1,1,29,24,53,11,24,35,40,48,88,11,3,14,13,36,26,12,21,102,102
2018,2,21800359,12/5/2018,1610612761,Toronto Raptors,1,1,1610612755,Philadelphia 76ers,0,0,35,36,71,8,21,29,43,57,100,19,3,22,21,39,25,7,11,102,113
2017,2,21700072,10/27/2017,1610612737,Atlanta Hawks,1,0,1610612743,Denver Nuggets,0,1,23,33,56,14,19,33,37,52,89,12,0,12,13,39,23,8,12,94,100
2017,2,21700072,10/27/2017,1610612743,Denver Nuggets,0,1,1610612737,Atlanta Hawks,1,0,38,33,71,4,16,20,42,49,91,17,6,23,21,32,25,7,12,95,105
2018,2,21800058,10/24/2018,1610612754,Indiana Pacers,0,1,1610612759,San Antonio Spurs,1,0,29,26,55,17,15,32,46,41,87,7,1,8,8,34,34,3,10,92,116
2018,2,21800058,10/24/2018,1610612759,San Antonio Spurs,1,0,1610612754,Indiana Pacers,0,1,29,39,68,6,13,19,35,52,87,20,1,21,17,36,16,9,13,92,96
2016,2,21600735,2/1/2017,1610612740,New Orleans Pelicans,0,0,1610612765,Detroit Pistons,1,1,36,25,61,5,16,21,41,41,82,11,3,14,4,40,21,9,15,99,98
2016,2,21600735,2/1/2017,1610612765,Detroit Pistons,1,1,1610612740,New Orleans Pelicans,0,0,38,24,62,10,16,26,48,40,88,12,5,17,7,35,28,6,10,99,118
2014,2,21400972,3/13/2015,1610612742,Dallas Mavericks,1,1,1610612746,LA Clippers,0,0,35,21,56,16,12,28,51,33,84,11,5,16,13,23,31,9,15,92,129
2014,2,21400972,3/13/2015,1610612746,LA Clippers,0,0,1610612742,Dallas Mavericks,1,1,29,21,50,12,20,32,41,41,82,5,7,12,11,34,27,11,15,91,99
2021,2,22100283,11/26/2021,1610612741,Chicago Bulls,0,1,1610612753,Orlando Magic,1,0,31,21,52,17,17,34,48,38,86,10,6,16,8,33,32,7,14,98,123
2021,2,22100283,11/26/2021,1610612753,Orlando Magic,1,0,1610612741,Chicago Bulls,0,1,23,25,48,7,25,32,30,50,80,21,9,30,13,42,18,11,15,97,88
2019,2,21900319,12/5/2019,1610612740,New Orleans Pelicans,1,0,1610612756,Phoenix Suns,0,1,27,19,46,17,24,41,44,43,87,27,8,35,12,34,27,16,24,117,132
2019,2,21901308,8/13/2020,1610612738,Boston Celtics,1,0,1610612764,Washington Wizards,0,1,27,26,53,8,27,35,35,53,88,12,2,14,15,40,22,11,19,99,90
2019,2,21901308,8/13/2020,1610612764,Washington Wizards,0,1,1610612738,Boston Celtics,1,0,24,38,62,10,16,26,34,54,88,18,6,24,20,39,22,8,18,98,96
2019,2,21901266,8/5/2020,1610612761,Toronto Raptors,0,1,1610612753,Orlando Magic,1,0,26,19,45,12,21,33,38,40,78,21,9,30,5,38,25,8,15,102,109
2019,2,21901251,8/3/2020,1610612743,Denver Nuggets,0,1,1610612760,Oklahoma City Thunder,1,0,35,27,62,7,18,25,42,45,87,30,9,39,13,37,23,4,13,107,121
2019,2,21901251,8/3/2020,1610612760,Oklahoma City Thunder,1,0,1610612743,Denver Nuggets,0,1,22,29,51,15,21,36,37,50,87,24,7,31,13,39,20,10,16,107,113
2019,2,21901238,7/31/2020,1610612742,Dallas Mavericks,1,0,1610612745,Houston Rockets,0,1,29,27,56,21,28,49,50,55,105,28,10,38,22,40,30,12,20,119,149
2019,2,21901238,7/31/2020,1610612745,Houston Rockets,0,1,1610612742,Dallas Mavericks,1,0,33,20,53,19,29,48,52,49,101,30,9,39,9,44,26,7,9,117,153
2019,2,21900927,3/5/2020,1610612745,Houston Rockets,1,0,1610612746,LA Clippers,0,1,28,27,55,7,35,42,35,62,97,28,8,36,18,48,19,5,11,104,105
2019,2,21900927,3/5/2020,1610612746,LA Clippers,0,1,1610612745,Houston Rockets,1,0,26,18,44,13,27,40,39,45,84,29,10,39,15,36,22,6,16,105,120
2019,2,21900913,3/3/2020,1610612743,Denver Nuggets,1,0,1610612744,Golden State Warriors,0,1,36,31,67,3,17,20,39,48,87,19,7,26,21,31,22,8,16,96,100
2019,2,21900913,3/3/2020,1610612744,Golden State Warriors,0,1,1610612743,Denver Nuggets,1,0,24,17,41,18,23,41,42,40,82,14,8,22,8,36,31,6,11,95,116
2019,2,21900879,2/28/2020,1610612761,Toronto Raptors,1,0,1610612766,Charlotte Hornets,0,1,23,29,52,10,33,43,33,62,95,20,9,29,19,49,19,3,5,94,96
2019,2,21900879,2/28/2020,1610612766,Charlotte Hornets,0,1,1610612761,Toronto Raptors,1,0,21,27,48,13,17,30,34,44,78,18,7,25,14,34,23,11,18,95,99
2019,2,21900836,2/22/2020,1610612751,Brooklyn Nets,0,1,1610612766,Charlotte Hornets,1,0,25,15,40,17,30,47,42,45,87,14,5,19,9,40,26,5,10,97,115
2019,2,21900836,2/22/2020,1610612766,Charlotte Hornets,1,0,1610612751,Brooklyn Nets,0,1,19,34,53,12,23,35,31,57,88,12,9,21,15,48,22,10,13,97,86
2019,2,21900826,2/21/2020,1610612742,Dallas Mavericks,0,1,1610612753,Orlando Magic,1,0,28,18,46,15,23,38,43,41,84,21,5,26,9,34,26,11,16,101,122
2019,2,21900826,2/21/2020,1610612753,Orlando Magic,1,0,1610612742,Dallas Mavericks,0,1,32,29,61,9,34,43,41,63,104,15,4,19,19,46,21,6,8,102,106
2019,2,21900796,2/10/2020,1610612750,Minnesota Timberwolves,0,0,1610612761,Toronto Raptors,1,1,21,25,46,18,22,40,39,47,86,30,5,35,15,33,24,15,23,109,126
2019,2,21900796,2/10/2020,1610612761,Toronto Raptors,1,1,1610612750,Minnesota Timberwolves,0,0,34,22,56,17,16,33,51,38,89,18,5,23,12,29,29,6,20,110,137
2019,2,21900783,2/8/2020,1610612744,Golden State Warriors,1,0,1610612747,Los Angeles Lakers,0,1,33,24,57,13,19,32,46,43,89,15,8,23,11,38,31,11,18,105,120
2019,2,21900783,2/8/2020,1610612747,Los Angeles Lakers,0,1,1610612744,Golden State Warriors,1,0,29,24,53,14,15,29,43,39,82,25,9,34,17,26,29,15,24,105,125
2019,2,21900319,12/5/2019,1610612756,Phoenix Suns,0,1,1610612740,New Orleans Pelicans,1,0,36,34,70,14,22,36,50,56,106,25,2,27,20,38,30,13,18,116,139
2019,2,21900090,11/3/2019,1610612746,LA Clippers,1,1,1610612762,Utah Jazz,0,0,29,31,60,7,25,32,36,56,92,26,8,34,24,33,15,4,9,96,105
2019,2,21900090,11/3/2019,1610612762,Utah Jazz,0,0,1610612746,LA Clippers,1,1,21,26,47,10,21,31,31,47,78,22,9,31,13,40,16,7,15,95,94
2018,2,21800650,1/14/2019,1610612740,New Orleans Pelicans,0,1,1610612746,LA Clippers,1,0,38,42,80,8,17,25,46,59,105,21,7,28,19,44,28,4,7,104,121
2018,2,21800650,1/14/2019,1610612746,LA Clippers,1,0,1610612740,New Orleans Pelicans,0,1,23,27,50,18,18,36,41,45,86,17,7,24,11,37,34,8,17,105,117
2018,2,21800192,11/12/2018,1610612740,New Orleans Pelicans,0,1,1610612761,Toronto Raptors,1,0,44,28,72,10,17,27,54,45,99,8,5,13,18,31,30,9,13,99,126
2018,2,21800192,11/12/2018,1610612761,Toronto Raptors,1,0,1610612740,New Orleans Pelicans,0,1,26,26,52,13,32,45,39,58,97,19,3,22,17,42,22,2,11,101,110
2019,2,21900774,2/7/2020,1610612745,Houston Rockets,0,0,1610612756,Phoenix Suns,1,1,18,19,37,11,37,48,29,56,85,22,4,26,15,43,16,10,16,100,91
2019,2,21900774,2/7/2020,1610612756,Phoenix Suns,1,1,1610612745,Houston Rockets,0,0,28,18,46,15,16,31,43,34,77,26,1,27,12,23,29,8,23,100,127
2020,2,22000085,1/3/2021,1610612738,Boston Celtics,0,1,1610612765,Detroit Pistons,1,0,34,20,54,15,18,33,49,38,87,9,4,13,16,26,35,8,18,95,122
2020,2,22000085,1/3/2021,1610612765,Detroit Pistons,1,0,1610612738,Boston Celtics,0,1,25,25,50,16,20,36,41,45,86,22,3,25,15,32,29,4,10,95,120
2021,2,22100282,11/26/2021,1610612752,New York Knicks,1,0,1610612756,Phoenix Suns,0,1,22,31,53,12,27,39,34,58,92,17,5,22,23,36,13,10,16,95,97
2021,2,22100282,11/26/2021,1610612756,Phoenix Suns,0,1,1610612752,New York Knicks,1,0,31,20,51,13,15,28,44,35,79,17,4,21,3,36,28,7,11,96,118
2016,2,21600253,11/28/2016,1610612758,Sacramento Kings,0,0,1610612764,Washington Wizards,1,1,35,37,72,3,18,21,38,55,93,16,10,26,17,43,20,11,20,108,95
2016,2,21600253,11/28/2016,1610612764,Washington Wizards,1,1,1610612758,Sacramento Kings,0,0,25,35,60,10,15,25,35,50,85,21,5,26,16,35,22,15,24,109,101
2019,2,21900966,3/10/2020,1610612756,Phoenix Suns,0,0,1610612757,Portland Trail Blazers,1,1,24,31,55,11,21,32,35,52,87,24,1,25,13,40,26,9,14,100,105
2019,2,21900966,3/10/2020,1610612757,Portland Trail Blazers,1,1,1610612756,Phoenix Suns,0,0,28,26,54,17,18,35,45,44,89,14,3,17,10,36,20,3,11,100,121
2019,2,21900952,3/8/2020,1610612742,Dallas Mavericks,1,0,1610612754,Indiana Pacers,0,1,25,23,48,14,29,43,39,52,91,17,8,25,13,45,19,5,11,101,109
2019,2,21900952,3/8/2020,1610612754,Indiana Pacers,0,1,1610612742,Dallas Mavericks,1,0,38,27,65,8,15,23,46,42,88,12,6,18,8,35,23,7,11,100,112
2019,2,21900897,3/1/2020,1610612746,LA Clippers,1,1,1610612755,Philadelphia 76ers,0,0,32,20,52,13,11,24,45,31,76,33,8,41,7,27,25,7,11,98,136
2019,2,21900897,3/1/2020,1610612755,Philadelphia 76ers,0,0,1610612746,LA Clippers,1,1,27,25,52,21,22,43,48,47,95,13,7,20,16,35,27,6,10,99,130
2019,2,21900814,2/12/2020,1610612742,Dallas Mavericks,1,1,1610612758,Sacramento Kings,0,0,31,14,45,17,23,40,48,37,85,17,4,21,8,31,34,7,12,100,130
2019,2,21900814,2/12/2020,1610612758,Sacramento Kings,0,0,1610612742,Dallas Mavericks,1,1,29,31,60,12,27,39,41,58,99,17,5,22,15,46,26,1,5,100,111
2019,2,21900789,2/9/2020,1610612763,Memphis Grizzlies,0,1,1610612764,Washington Wizards,1,0,38,32,70,5,27,32,43,59,102,15,10,25,20,42,19,7,15,110,106
2019,2,21900789,2/9/2020,1610612764,Washington Wizards,1,0,1610612763,Memphis Grizzlies,0,1,28,39,67,7,26,33,35,65,100,22,7,29,12,55,25,4,7,110,99
2019,2,21900765,2/6/2020,1610612740,New Orleans Pelicans,0,1,1610612741,Chicago Bulls,1,0,33,16,49,16,22,38,49,38,87,11,8,19,11,31,38,11,21,106,125
2019,2,21900765,2/6/2020,1610612741,Chicago Bulls,1,0,1610612740,New Orleans Pelicans,0,1,33,31,64,13,16,29,46,47,93,14,9,23,15,37,25,12,16,105,119
2019,2,21900756,2/5/2020,1610612738,Boston Celtics,1,1,1610612753,Orlando Magic,0,0,33,30,63,13,10,23,46,40,86,11,5,16,10,32,23,10,13,96,116
2019,2,21900756,2/5/2020,1610612753,Orlando Magic,0,0,1610612738,Boston Celtics,1,1,19,25,44,13,18,31,32,43,75,23,7,30,11,36,20,10,17,96,100
2019,2,21900748,2/3/2020,1610612763,Memphis Grizzlies,1,1,1610612765,Detroit Pistons,0,0,40,33,73,2,15,17,42,48,90,10,2,12,13,35,27,6,11,95,96
2019,2,21900748,2/3/2020,1610612765,Detroit Pistons,0,0,1610612763,Memphis Grizzlies,1,1,26,46,72,8,18,26,34,64,98,6,3,9,24,42,21,6,16,94,82
2019,2,21900741,2/3/2020,1610612753,Orlando Magic,0,1,1610612766,Charlotte Hornets,1,0,27,19,46,16,18,34,43,37,80,10,7,17,8,34,35,8,10,91,112
2018,2,21800926,2/28/2019,1610612743,Denver Nuggets,1,0,1610612762,Utah Jazz,0,1,33,41,74,7,18,25,40,59,99,17,7,24,22,41,25,6,13,101,104
2018,2,21800926,2/28/2019,1610612762,Utah Jazz,0,1,1610612743,Denver Nuggets,1,0,21,20,41,16,27,43,37,47,84,21,12,33,11,42,25,6,11,101,111
2018,2,21800573,1/4/2019,1610612746,LA Clippers,0,1,1610612756,Phoenix Suns,1,0,33,27,60,10,14,24,43,41,84,25,7,32,22,21,31,13,20,98,121
2018,2,21800573,1/4/2019,1610612756,Phoenix Suns,1,0,1610612746,LA Clippers,0,1,32,26,58,9,10,19,41,36,77,20,7,27,9,28,24,12,17,97,111
2018,2,21800496,12/23/2018,1610612747,Los Angeles Lakers,1,0,1610612763,Memphis Grizzlies,0,1,27,18,45,10,20,30,37,38,75,15,7,22,7,35,27,9,16,94,99
2018,2,21800496,12/23/2018,1610612763,Memphis Grizzlies,0,1,1610612747,Los Angeles Lakers,1,0,28,36,64,14,12,26,42,48,90,9,5,14,14,38,24,6,12,94,107
2020,2,22000084,1/2/2021,1610612740,New Orleans Pelicans,1,1,1610612761,Toronto Raptors,0,0,21,24,45,14,24,38,35,48,83,36,11,47,18,32,26,6,13,99,120
2020,2,22000084,1/2/2021,1610612761,Toronto Raptors,0,0,1610612740,New Orleans Pelicans,1,1,24,19,43,14,34,48,38,53,91,26,1,27,15,39,21,6,10,100,116
2017,2,21700071,10/27/2017,1610612753,Orlando Magic,1,1,1610612759,San Antonio Spurs,0,0,37,24,61,11,12,23,48,36,84,7,7,14,8,32,22,8,18,99,114
2017,2,21700071,10/27/2017,1610612759,San Antonio Spurs,0,0,1610612753,Orlando Magic,1,1,26,39,65,4,20,24,30,59,89,23,4,27,20,40,19,9,18,100,87
2018,2,21800057,10/24/2018,1610612745,Houston Rockets,1,0,1610612762,Utah Jazz,0,1,24,23,47,11,29,40,35,52,87,8,6,14,12,42,16,7,17,99,89
2018,2,21800057,10/24/2018,1610612762,Utah Jazz,0,1,1610612745,Houston Rockets,1,0,24,25,49,10,19,29,34,44,78,22,6,28,14,30,21,12,19,98,100
2014,2,21400971,3/13/2015,1610612750,Minnesota Timberwolves,0,0,1610612760,Oklahoma City Thunder,1,1,31,35,66,3,9,12,34,44,78,28,3,31,13,32,20,10,20,98,99
2019,2,21900318,12/5/2019,1610612745,Houston Rockets,0,1,1610612761,Toronto Raptors,1,0,18,25,43,22,33,55,40,58,98,17,2,19,26,33,29,14,23,101,119
2019,2,21900318,12/5/2019,1610612761,Toronto Raptors,1,0,1610612745,Houston Rockets,0,1,26,23,49,12,27,39,38,50,88,21,3,24,16,35,27,11,18,102,109
2014,2,21400971,3/13/2015,1610612760,Oklahoma City Thunder,1,1,1610612750,Minnesota Timberwolves,0,0,33,44,77,11,13,24,44,57,101,14,0,14,24,33,28,8,16,98,113
2018,2,21801211,4/9/2019,1610612738,Boston Celtics,0,1,1610612764,Washington Wizards,1,0,30,25,55,15,29,44,45,54,99,11,12,23,13,46,27,2,6,103,116
2019,2,21901290,8/9/2020,1610612745,Houston Rockets,0,1,1610612758,Sacramento Kings,1,0,25,9,34,18,39,57,43,48,91,25,5,30,11,40,21,9,15,110,129
2019,2,21901290,8/9/2020,1610612758,Sacramento Kings,1,0,1610612745,Houston Rockets,0,1,31,19,50,10,27,37,41,46,87,20,3,23,6,41,29,9,18,109,112
2019,2,21901265,8/5/2020,1610612747,Los Angeles Lakers,1,0,1610612760,Oklahoma City Thunder,0,1,26,25,51,5,32,37,31,57,88,19,10,29,12,51,17,9,11,102,86
2019,2,21901265,8/5/2020,1610612760,Oklahoma City Thunder,0,1,1610612747,Los Angeles Lakers,1,0,29,26,55,5,19,24,34,45,79,32,4,36,8,40,17,7,14,101,105
2019,2,21900965,3/10/2020,1610612742,Dallas Mavericks,0,0,1610612759,San Antonio Spurs,1,1,25,23,48,17,27,44,42,50,92,8,3,11,13,38,23,11,14,99,109
2019,2,21900965,3/10/2020,1610612759,San Antonio Spurs,1,1,1610612742,Dallas Mavericks,0,0,31,26,57,15,17,32,46,43,89,12,3,15,9,37,32,8,12,99,119
2019,2,21900939,3/6/2020,1610612747,Los Angeles Lakers,1,1,1610612749,Milwaukee Bucks,0,0,32,27,59,6,26,32,38,53,91,31,7,38,12,43,19,8,15,113,113
2019,2,21900939,3/6/2020,1610612749,Milwaukee Bucks,0,0,1610612747,Los Angeles Lakers,1,1,25,21,46,12,31,43,37,52,89,17,6,23,8,46,22,11,21,112,103
2019,2,21900926,3/5/2020,1610612743,Denver Nuggets,0,1,1610612766,Charlotte Hornets,1,0,36,21,57,8,18,26,44,39,83,18,2,20,14,27,29,7,13,91,114
2019,2,21900926,3/5/2020,1610612766,Charlotte Hornets,1,0,1610612743,Denver Nuggets,0,1,25,19,44,13,20,33,38,39,77,23,5,28,12,29,24,7,14,93,112
2019,2,21900912,3/3/2020,1610612746,LA Clippers,0,1,1610612760,Oklahoma City Thunder,1,0,27,21,48,11,25,36,38,46,84,22,4,26,10,37,19,7,10,97,109
2019,2,21900912,3/3/2020,1610612760,Oklahoma City Thunder,1,0,1610612746,LA Clippers,0,1,25,28,53,9,19,28,34,47,81,17,9,26,10,39,16,7,15,96,94
2019,2,21900857,2/25/2020,1610612754,Indiana Pacers,1,1,1610612766,Charlotte Hornets,0,0,39,24,63,10,13,23,49,37,86,11,2,13,9,28,35,10,15,98,119
2019,2,21900857,2/25/2020,1610612766,Charlotte Hornets,0,0,1610612754,Indiana Pacers,1,1,21,39,60,10,23,33,31,62,93,8,10,18,16,52,22,8,11,99,80
2019,2,21900847,2/23/2020,1610612740,New Orleans Pelicans,0,1,1610612744,Golden State Warriors,1,0,29,27,56,17,25,42,46,52,98,6,7,13,18,40,34,9,13,100,115
2018,2,21801211,4/9/2019,1610612764,Washington Wizards,1,0,1610612738,Boston Celtics,0,1,27,31,58,14,25,39,41,56,97,14,4,18,18,39,28,10,15,104,110
2018,2,21801063,3/19/2019,1610612751,Brooklyn Nets,0,1,1610612758,Sacramento Kings,1,0,35,24,59,12,23,35,47,47,94,17,6,23,15,34,28,13,18,107,123
2018,2,21801063,3/19/2019,1610612758,Sacramento Kings,1,0,1610612751,Brooklyn Nets,0,1,40,30,70,9,16,25,49,46,95,14,6,20,19,31,25,16,21,108,121
2020,2,22000951,4/30/2021,1610612739,Cleveland Cavaliers,1,0,1610612764,Washington Wizards,0,1,27,22,49,7,26,33,34,48,82,18,10,28,17,36,19,14,25,102,93
2020,2,22000951,4/30/2021,1610612764,Washington Wizards,0,1,1610612739,Cleveland Cavaliers,1,0,38,36,74,8,10,18,46,46,92,22,4,26,14,34,31,6,14,102,122
2018,2,21800725,1/25/2019,1610612758,Sacramento Kings,0,1,1610612763,Memphis Grizzlies,1,0,25,33,58,12,21,33,37,54,91,13,4,17,18,38,23,13,19,100,99
2018,2,21800725,1/25/2019,1610612763,Memphis Grizzlies,1,0,1610612758,Sacramento Kings,0,1,28,32,60,6,14,20,34,46,80,22,5,27,10,37,22,11,16,99,96
2021,2,22100281,11/26/2021,1610612750,Minnesota Timberwolves,0,0,1610612766,Charlotte Hornets,1,1,34,31,65,11,24,35,45,55,100,14,5,19,18,40,24,5,12,103,115
2021,2,22100281,11/26/2021,1610612766,Charlotte Hornets,1,1,1610612750,Minnesota Timberwolves,0,0,26,22,48,23,17,40,49,39,88,12,3,15,8,32,32,8,16,104,133
2017,2,21700070,10/27/2017,1610612745,Houston Rockets,0,1,1610612766,Charlotte Hornets,1,0,16,12,28,22,35,57,38,47,85,11,2,13,12,36,21,6,16,96,109
2017,2,21700070,10/27/2017,1610612766,Charlotte Hornets,1,0,1610612745,Houston Rockets,0,1,22,37,59,11,18,29,33,55,88,16,12,28,16,45,16,5,9,95,93
2018,2,21800056,10/24/2018,1610612741,Chicago Bulls,1,1,1610612766,Charlotte Hornets,0,0,27,21,48,10,19,29,37,40,77,28,7,35,13,29,21,5,14,95,112
2018,2,21800056,10/24/2018,1610612766,Charlotte Hornets,0,0,1610612741,Chicago Bulls,1,1,27,23,50,10,25,35,37,48,85,26,3,29,13,37,23,4,8,96,110
2016,2,21600734,2/1/2017,1610612737,Atlanta Hawks,0,0,1610612748,Miami Heat,1,1,27,33,60,7,19,26,34,52,86,18,3,21,13,41,13,10,16,99,93
2016,2,21600734,2/1/2017,1610612748,Miami Heat,1,1,1610612737,Atlanta Hawks,0,0,33,28,61,12,20,32,45,48,93,14,5,19,16,34,23,10,13,100,116
2020,2,22000083,1/2/2021,1610612737,Atlanta Hawks,1,0,1610612739,Cleveland Cavaliers,0,1,24,29,53,11,21,32,35,50,85,10,9,19,20,36,22,10,22,99,91
2020,2,22000083,1/2/2021,1610612739,Cleveland Cavaliers,0,1,1610612737,Atlanta Hawks,1,0,31,31,62,7,22,29,38,53,91,13,4,17,17,39,19,9,15,98,96
2019,2,21900317,12/5/2019,1610612743,Denver Nuggets,0,1,1610612752,New York Knicks,1,0,28,20,48,21,18,39,49,38,87,10,8,18,11,30,38,9,14,98,129
2019,2,21900317,12/5/2019,1610612752,New York Knicks,1,0,1610612743,Denver Nuggets,0,1,25,24,49,9,25,34,34,49,83,15,8,23,9,42,23,8,14,100,92
2019,2,21901307,8/12/2020,1610612743,Denver Nuggets,1,0,1610612746,LA Clippers,0,1,30,22,52,13,22,35,43,44,87,12,7,19,11,36,33,11,12,98,111
2019,2,21901307,8/12/2020,1610612746,LA Clippers,0,1,1610612743,Denver Nuggets,1,0,32,16,48,14,23,37,46,39,85,18,5,23,7,33,29,4,8,97,124
2019,2,21900896,3/1/2020,1610612742,Dallas Mavericks,0,1,1610612750,Minnesota Timberwolves,1,0,33,21,54,11,29,40,44,50,94,12,7,19,11,43,28,9,14,105,111
2019,2,21900896,3/1/2020,1610612750,Minnesota Timberwolves,1,0,1610612742,Dallas Mavericks,0,1,23,34,57,13,29,42,36,63,99,6,9,15,16,53,19,10,14,103,91
2019,2,21900878,2/28/2020,1610612737,Atlanta Hawks,1,1,1610612751,Brooklyn Nets,0,0,31,27,58,19,20,39,50,47,97,22,8,30,17,34,32,5,10,104,141
2019,2,21900878,2/28/2020,1610612751,Brooklyn Nets,0,0,1610612737,Atlanta Hawks,1,1,24,22,46,18,28,46,42,50,92,16,5,21,12,40,30,8,13,106,118
2019,2,21900847,2/23/2020,1610612744,Golden State Warriors,1,0,1610612740,New Orleans Pelicans,0,1,29,28,57,11,24,35,40,52,92,10,5,15,15,40,28,7,15,99,101
2019,2,21900835,2/22/2020,1610612746,LA Clippers,1,0,1610612758,Sacramento Kings,0,1,24,33,57,10,20,30,34,53,87,25,4,29,15,38,20,11,19,104,103
2019,2,21900835,2/22/2020,1610612758,Sacramento Kings,0,1,1610612746,LA Clippers,1,0,28,30,58,12,19,31,40,49,89,20,6,26,12,38,25,7,13,104,112
2019,2,21900805,2/11/2020,1610612759,San Antonio Spurs,0,1,1610612760,Oklahoma City Thunder,1,0,34,25,59,7,18,25,41,43,84,25,2,27,12,31,20,8,12,99,114
2019,2,21900805,2/11/2020,1610612760,Oklahoma City Thunder,1,0,1610612759,San Antonio Spurs,0,1,28,26,54,11,20,31,39,46,85,17,4,21,9,40,19,9,14,98,106
2019,2,21900741,2/3/2020,1610612766,Charlotte Hornets,1,0,1610612753,Orlando Magic,0,1,32,26,58,9,22,31,41,48,89,9,5,14,17,33,24,7,12,91,100
2019,2,21900733,2/1/2020,1610612737,Atlanta Hawks,0,0,1610612742,Dallas Mavericks,1,1,27,31,58,10,23,33,37,54,91,16,5,21,14,44,19,6,11,99,100
2019,2,21900733,2/1/2020,1610612742,Dallas Mavericks,1,1,1610612737,Atlanta Hawks,0,0,24,31,55,20,19,39,44,50,94,15,1,16,11,40,26,6,9,100,123
2019,2,21900720,1/31/2020,1610612761,Toronto Raptors,0,1,1610612765,Detroit Pistons,1,0,35,23,58,9,18,27,44,41,85,8,3,11,11,32,26,5,16,95,105
2019,2,21900720,1/31/2020,1610612765,Detroit Pistons,1,0,1610612761,Toronto Raptors,0,1,17,26,43,11,25,36,28,51,79,25,9,34,17,38,18,6,17,96,92
2018,2,21801062,3/19/2019,1610612744,Golden State Warriors,0,1,1610612750,Minnesota Timberwolves,1,0,25,24,49,19,23,42,44,47,91,10,4,14,10,40,39,7,13,100,117
2018,2,21801062,3/19/2019,1610612750,Minnesota Timberwolves,1,0,1610612744,Golden State Warriors,0,1,27,26,53,9,27,36,36,53,89,26,6,32,18,40,25,6,13,101,107
2018,2,21800925,2/28/2019,1610612745,Houston Rockets,1,1,1610612748,Miami Heat,0,0,19,12,31,19,27,46,38,39,77,26,2,28,11,29,22,9,16,95,121
2018,2,21800925,2/28/2019,1610612748,Miami Heat,0,0,1610612745,Houston Rockets,1,1,27,26,53,15,13,28,42,39,81,19,5,24,11,30,28,6,14,95,118
2018,2,21800817,2/8/2019,1610612752,New York Knicks,0,0,1610612765,Detroit Pistons,1,1,28,28,56,7,15,22,35,43,78,26,15,41,13,38,22,3,13,99,103
2018,2,21800817,2/8/2019,1610612765,Detroit Pistons,1,1,1610612752,New York Knicks,0,0,29,27,56,13,17,30,42,44,86,23,6,29,14,32,24,6,13,99,120
2018,2,21800724,1/25/2019,1610612745,Houston Rockets,1,1,1610612761,Toronto Raptors,0,0,31,14,45,10,36,46,41,50,91,29,4,33,18,35,17,4,12,102,121
2018,2,21800724,1/25/2019,1610612761,Toronto Raptors,0,0,1610612745,Houston Rockets,1,1,30,25,55,14,22,36,44,47,91,17,1,18,19,29,27,11,21,101,119
2018,2,21800649,1/14/2019,1610612757,Portland Trail Blazers,0,0,1610612758,Sacramento Kings,1,1,27,34,61,10,21,31,37,55,92,23,6,29,19,40,22,6,14,100,107
2018,2,21800649,1/14/2019,1610612758,Sacramento Kings,1,1,1610612757,Portland Trail Blazers,0,0,33,28,61,10,16,26,43,44,87,19,5,24,14,32,24,6,13,100,115
2017,2,21700069,10/26/2017,1610612740,New Orleans Pelicans,0,1,1610612758,Sacramento Kings,1,0,29,25,54,13,19,32,42,44,86,17,6,23,12,34,22,7,15,99,114
2017,2,21700069,10/26/2017,1610612758,Sacramento Kings,1,0,1610612740,New Orleans Pelicans,0,1,31,30,61,7,13,20,38,43,81,23,2,25,6,39,25,5,13,99,106
2016,2,21600252,11/27/2016,1610612737,Atlanta Hawks,0,0,1610612747,Los Angeles Lakers,1,1,27,26,53,12,23,35,39,49,88,4,6,10,13,40,25,7,12,93,94
2016,2,21600252,11/27/2016,1610612747,Los Angeles Lakers,1,1,1610612737,Atlanta Hawks,0,0,34,41,75,8,12,20,42,53,95,17,3,20,20,34,20,5,9,92,109
2022,2,22200515,12/28/2022,1610612753,Orlando Magic,0,0,1610612765,Detroit Pistons,1,1,30,33,63,5,17,22,35,50,85,26,8,34,16,38,24,7,13,98,101
2022,2,22200515,12/28/2022,1610612765,Detroit Pistons,1,1,1610612753,Orlando Magic,0,0,18,20,38,18,24,42,36,44,80,31,9,40,14,34,25,5,13,98,121
2020,2,22000082,1/2/2021,1610612755,Philadelphia 76ers,1,1,1610612766,Charlotte Hornets,0,0,31,13,44,16,19,35,47,32,79,17,7,24,9,26,35,15,22,103,127
2020,2,22000082,1/2/2021,1610612766,Charlotte Hornets,0,0,1610612755,Philadelphia 76ers,1,1,25,32,57,13,22,35,38,54,92,23,3,26,15,40,34,10,12,103,112
2019,2,21901289,8/9/2020,1610612755,Philadelphia 76ers,0,0,1610612757,Portland Trail Blazers,1,1,33,34,67,14,16,30,47,50,97,13,4,17,18,35,24,8,15,101,121
2019,2,21901289,8/9/2020,1610612757,Portland Trail Blazers,1,1,1610612755,Philadelphia 76ers,0,0,32,24,56,11,24,35,43,48,91,27,2,29,12,38,19,6,10,101,124
2019,2,21901264,8/5/2020,1610612743,Denver Nuggets,0,1,1610612759,San Antonio Spurs,1,0,36,19,55,14,22,36,50,41,91,18,3,21,15,28,31,10,13,98,132
2019,2,21901264,8/5/2020,1610612759,San Antonio Spurs,1,0,1610612743,Denver Nuggets,0,1,35,28,63,11,19,30,46,47,93,23,4,27,16,33,29,6,10,100,126
2019,2,21901250,8/3/2020,1610612748,Miami Heat,1,0,1610612761,Toronto Raptors,0,1,23,19,42,14,31,45,37,50,87,15,1,16,12,39,29,6,15,98,103
2019,2,21901250,8/3/2020,1610612761,Toronto Raptors,0,1,1610612748,Miami Heat,1,0,13,22,35,16,16,32,29,38,67,33,3,36,6,33,19,9,21,98,107
2019,2,21901237,7/31/2020,1610612758,Sacramento Kings,0,0,1610612759,San Antonio Spurs,1,1,34,23,57,12,26,38,46,49,95,16,4,20,15,34,22,6,18,108,120
2019,2,21901237,7/31/2020,1610612759,San Antonio Spurs,1,1,1610612758,Sacramento Kings,0,0,37,28,65,11,14,25,48,42,90,22,5,27,10,35,32,11,15,106,129
2019,2,21900964,3/10/2020,1610612753,Orlando Magic,0,1,1610612763,Memphis Grizzlies,1,0,29,30,59,14,19,33,43,49,92,20,2,22,17,34,31,7,16,102,120
2019,2,21900964,3/10/2020,1610612763,Memphis Grizzlies,1,0,1610612753,Orlando Magic,0,1,27,20,47,11,18,29,38,38,76,28,10,38,12,30,24,10,21,102,115
2019,2,21900951,3/8/2020,1610612748,Miami Heat,0,1,1610612764,Washington Wizards,1,0,19,19,38,13,15,28,32,34,66,23,5,28,8,29,21,11,23,94,100
2019,2,21900951,3/8/2020,1610612764,Washington Wizards,1,0,1610612748,Miami Heat,0,1,7,24,31,19,28,47,26,52,78,18,3,21,8,46,19,7,14,95,89
2019,2,21900925,3/4/2020,1610612757,Portland Trail Blazers,1,1,1610612764,Washington Wizards,0,0,29,21,50,13,18,31,42,39,81,28,4,32,10,31,24,8,16,101,125
2019,2,21900925,3/4/2020,1610612764,Washington Wizards,0,0,1610612757,Portland Trail Blazers,1,1,29,39,68,11,24,35,40,63,103,13,8,21,23,44,27,7,10,100,104
2019,2,21900825,2/20/2020,1610612744,Golden State Warriors,1,0,1610612745,Houston Rockets,0,1,37,19,56,7,26,33,44,45,89,10,2,12,16,30,26,14,23,99,105
2019,2,21900825,2/20/2020,1610612745,Houston Rockets,0,1,1610612744,Golden State Warriors,1,0,20,16,36,25,24,49,45,40,85,20,2,22,11,29,31,11,16,101,135
2019,2,21900813,2/12/2020,1610612750,Minnesota Timberwolves,1,0,1610612766,Charlotte Hornets,0,1,25,27,52,14,35,49,39,62,101,16,4,20,20,44,25,7,11,102,108
2019,2,21900813,2/12/2020,1610612766,Charlotte Hornets,0,1,1610612750,Minnesota Timberwolves,1,0,29,29,58,14,20,34,43,49,92,15,8,23,16,36,22,10,14,101,115
2019,2,21900795,2/10/2020,1610612737,Atlanta Hawks,0,0,1610612753,Orlando Magic,1,1,31,20,51,16,21,37,47,41,88,16,1,17,8,34,33,9,12,99,126
2019,2,21900795,2/10/2020,1610612753,Orlando Magic,1,1,1610612737,Atlanta Hawks,0,0,32,25,57,18,20,38,50,45,95,17,5,22,19,29,33,5,11,98,135
2019,2,21900773,2/7/2020,1610612760,Oklahoma City Thunder,1,1,1610612765,Detroit Pistons,0,0,34,19,53,5,18,23,39,37,76,25,5,30,13,26,21,7,12,89,108
2019,2,21900773,2/7/2020,1610612765,Detroit Pistons,0,0,1610612760,Oklahoma City Thunder,1,1,27,24,51,11,27,38,38,51,89,14,5,19,20,33,19,4,11,88,101
2019,2,21900755,2/5/2020,1610612756,Phoenix Suns,0,0,1610612765,Detroit Pistons,1,1,30,21,51,12,14,26,42,35,77,12,3,15,7,30,29,9,16,92,108
2019,2,21900755,2/5/2020,1610612765,Detroit Pistons,1,1,1610612756,Phoenix Suns,0,0,34,33,67,12,16,28,46,49,95,12,4,16,19,34,31,4,9,92,116
2019,2,21900089,11/3/2019,1610612739,Cleveland Cavaliers,1,0,1610612742,Dallas Mavericks,0,1,21,27,48,18,30,48,39,57,96,15,7,22,18,42,24,5,9,99,111
2019,2,21900089,11/3/2019,1610612742,Dallas Mavericks,0,1,1610612739,Cleveland Cavaliers,1,0,30,23,53,20,21,41,50,44,94,11,2,13,16,29,34,9,14,98,131
2020,2,22000950,4/30/2021,1610612738,Boston Celtics,1,1,1610612759,San Antonio Spurs,0,0,31,36,67,18,20,38,49,56,105,27,9,36,23,38,31,6,13,111,143
2020,2,22000950,4/30/2021,1610612759,San Antonio Spurs,0,0,1610612738,Boston Celtics,1,1,38,30,68,11,13,24,49,43,92,31,7,38,10,37,29,7,11,109,140
2017,2,21700068,10/26/2017,1610612746,LA Clippers,0,1,1610612757,Portland Trail Blazers,1,0,27,22,49,9,19,28,36,41,77,23,13,36,18,31,11,5,12,88,104
2017,2,21700068,10/26/2017,1610612757,Portland Trail Blazers,1,0,1610612746,LA Clippers,0,1,21,37,58,14,17,31,35,54,89,19,3,22,21,34,19,4,10,89,103
2018,2,21800055,10/24/2018,1610612750,Minnesota Timberwolves,0,0,1610612761,Toronto Raptors,1,1,25,41,66,15,15,30,40,56,96,10,6,16,22,36,25,9,16,100,105
2018,2,21800055,10/24/2018,1610612761,Toronto Raptors,1,1,1610612750,Minnesota Timberwolves,0,0,35,22,57,11,21,32,46,43,89,9,3,12,13,32,26,10,17,99,112
2014,2,21400970,3/13/2015,1610612748,Miami Heat,0,0,1610612761,Toronto Raptors,1,1,30,26,56,5,18,23,35,44,79,17,7,24,11,36,21,12,20,98,92
2014,2,21400970,3/13/2015,1610612761,Toronto Raptors,1,1,1610612748,Miami Heat,0,0,22,24,46,12,21,33,34,45,79,22,9,31,13,38,26,11,17,97,102
2019,2,21901306,8/12/2020,1610612748,Miami Heat,0,0,1610612760,Oklahoma City Thunder,1,1,28,16,44,14,28,42,42,44,86,17,3,20,8,38,24,7,12,100,115
2019,2,21901306,8/12/2020,1610612760,Oklahoma City Thunder,1,1,1610612748,Miami Heat,0,0,23,24,47,16,26,42,39,50,89,22,5,27,18,35,20,14,16,99,116
2019,2,21900938,3/6/2020,1610612756,Phoenix Suns,1,1,1610612757,Portland Trail Blazers,0,0,26,23,49,19,23,42,45,46,91,18,1,19,16,30,29,6,13,98,127
2019,2,21900938,3/6/2020,1610612757,Portland Trail Blazers,0,0,1610612756,Phoenix Suns,1,1,30,25,55,13,19,32,43,44,87,18,6,24,14,33,26,9,16,99,117
2019,2,21900911,3/3/2020,1610612740,New Orleans Pelicans,1,0,1610612750,Minnesota Timberwolves,0,1,38,23,61,14,25,39,52,48,100,16,11,27,17,36,37,11,15,110,134
2019,2,21900911,3/3/2020,1610612750,Minnesota Timberwolves,0,1,1610612740,New Orleans Pelicans,1,0,40,23,63,14,20,34,54,43,97,17,3,20,14,32,31,13,16,110,139
2019,2,21900895,3/1/2020,1610612749,Milwaukee Bucks,0,1,1610612766,Charlotte Hornets,1,0,28,28,56,7,24,31,35,52,87,16,5,21,17,37,20,7,17,97,93
2019,2,21900895,3/1/2020,1610612766,Charlotte Hornets,1,0,1610612749,Milwaukee Bucks,0,1,26,35,61,8,27,35,34,62,96,9,1,10,14,49,22,7,10,96,85
2019,2,21900877,2/28/2020,1610612750,Minnesota Timberwolves,0,0,1610612753,Orlando Magic,1,1,29,22,51,17,27,44,46,49,95,16,8,24,9,47,27,6,15,111,125
2019,2,21900877,2/28/2020,1610612753,Orlando Magic,1,1,1610612750,Minnesota Timberwolves,0,0,41,17,58,12,28,40,53,45,98,18,4,22,15,30,36,10,16,111,136
2019,2,21900782,2/8/2020,1610612746,LA Clippers,0,0,1610612750,Minnesota Timberwolves,1,1,32,28,60,9,17,26,41,45,86,24,5,29,8,39,24,8,15,105,115
2019,2,21900782,2/8/2020,1610612750,Minnesota Timberwolves,1,1,1610612746,LA Clippers,0,0,26,25,51,26,18,44,52,43,95,12,6,18,10,35,39,8,13,106,142
2019,2,21900764,2/6/2020,1610612752,New York Knicks,1,1,1610612753,Orlando Magic,0,0,37,35,72,6,14,20,43,49,92,13,6,19,16,34,27,8,14,98,105
2019,2,21900764,2/6/2020,1610612753,Orlando Magic,0,0,1610612752,New York Knicks,1,1,25,19,44,9,22,31,34,41,75,26,4,30,13,31,22,12,21,99,103
2019,2,21900732,2/1/2020,1610612738,Boston Celtics,1,1,1610612755,Philadelphia 76ers,0,0,30,20,50,8,22,30,38,42,80,32,9,41,13,35,15,6,11,97,116
2019,2,21900732,2/1/2020,1610612755,Philadelphia 76ers,0,0,1610612738,Boston Celtics,1,1,24,27,51,7,26,33,31,53,84,26,5,31,16,39,15,9,14,97,95
2019,2,21900719,1/30/2020,1610612746,LA Clippers,1,0,1610612758,Sacramento Kings,0,1,22,39,61,13,18,31,35,57,92,20,5,25,18,41,26,11,15,98,103
2019,2,21900719,1/30/2020,1610612758,Sacramento Kings,0,1,1610612746,LA Clippers,1,0,23,24,47,21,20,41,44,44,88,15,3,18,12,32,27,6,12,99,124
2019,2,21900684,1/25/2020,1610612747,Los Angeles Lakers,0,0,1610612755,Philadelphia 76ers,1,1,29,16,45,6,25,31,35,41,76,15,8,23,7,38,23,12,22,101,91
2019,2,21900684,1/25/2020,1610612755,Philadelphia 76ers,1,1,1610612747,Los Angeles Lakers,0,0,28,13,41,13,24,37,41,37,78,13,6,19,9,31,19,12,23,101,108
2019,2,21900674,1/24/2020,1610612741,Chicago Bulls,1,0,1610612758,Sacramento Kings,0,1,23,19,42,8,29,37,31,48,79,11,3,14,13,36,23,8,21,95,81
2019,2,21900674,1/24/2020,1610612758,Sacramento Kings,0,1,1610612741,Chicago Bulls,1,0,25,24,49,10,22,32,35,46,81,18,3,21,10,37,24,6,14,95,98
2020,2,22000081,1/2/2021,1610612753,Orlando Magic,1,0,1610612760,Oklahoma City Thunder,0,1,30,40,70,10,28,38,40,68,108,9,3,12,19,50,21,5,6,99,99
2020,2,22000081,1/2/2021,1610612760,Oklahoma City Thunder,0,1,1610612753,Orlando Magic,1,0,25,20,45,13,28,41,38,48,86,19,2,21,8,41,22,7,12,99,108
2018,2,21801210,4/9/2019,1610612763,Memphis Grizzlies,0,0,1610612765,Detroit Pistons,1,1,23,22,45,10,14,24,33,36,69,17,4,21,11,26,19,13,22,91,93
2018,2,21801210,4/9/2019,1610612765,Detroit Pistons,1,1,1610612763,Memphis Grizzlies,0,0,25,29,54,10,24,34,35,53,88,20,8,28,19,39,16,4,9,92,100
2018,2,21800572,1/4/2019,1610612737,Atlanta Hawks,0,0,1610612749,Milwaukee Bucks,1,1,23,21,44,14,27,41,37,48,85,24,11,35,9,44,26,11,21,112,112
2018,2,21800572,1/4/2019,1610612749,Milwaukee Bucks,1,1,1610612737,Atlanta Hawks,0,0,41,19,60,14,26,40,55,45,100,20,8,28,16,30,36,11,14,112,144
2018,2,21800424,12/14/2018,1610612754,Indiana Pacers,0,1,1610612755,Philadelphia 76ers,1,0,34,41,75,8,12,20,42,53,95,21,3,24,17,36,33,5,7,98,113
2018,2,21800424,12/14/2018,1610612755,Philadelphia 76ers,1,0,1610612754,Indiana Pacers,0,1,27,25,52,9,27,36,36,52,88,20,7,27,19,37,17,7,16,98,101
2018,2,21800054,10/24/2018,1610612748,Miami Heat,1,1,1610612752,New York Knicks,0,0,26,27,53,13,16,29,39,43,82,19,9,28,9,38,24,5,13,98,110
2018,2,21800054,10/24/2018,1610612752,New York Knicks,0,0,1610612748,Miami Heat,1,1,21,37,58,12,21,33,33,58,91,9,5,14,13,48,20,7,12,99,87
2016,2,21600733,2/1/2017,1610612751,Brooklyn Nets,1,0,1610612752,New York Knicks,0,1,32,31,63,5,20,25,37,51,88,11,5,16,18,38,17,16,21,99,90
2016,2,21600733,2/1/2017,1610612752,New York Knicks,0,1,1610612751,Brooklyn Nets,1,0,29,43,72,6,21,27,35,64,99,19,12,31,27,43,23,4,13,100,95
2019,2,21901288,8/9/2020,1610612738,Boston Celtics,1,1,1610612753,Orlando Magic,0,0,33,29,62,12,28,40,45,57,102,20,4,24,16,43,32,7,13,110,122
2019,2,21901288,8/9/2020,1610612753,Orlando Magic,0,0,1610612738,Boston Celtics,1,1,26,29,55,15,32,47,41,61,102,22,4,26,20,43,24,9,14,112,119
2019,2,21900963,3/10/2020,1610612745,Houston Rockets,1,1,1610612750,Minnesota Timberwolves,0,0,26,16,42,15,23,38,41,39,80,20,6,26,9,35,24,9,18,103,117
2019,2,21900963,3/10/2020,1610612750,Minnesota Timberwolves,0,0,1610612745,Houston Rockets,1,1,26,22,48,14,21,35,40,43,83,17,6,23,11,35,21,9,19,101,111
2019,2,21900856,2/24/2020,1610612746,LA Clippers,1,1,1610612763,Memphis Grizzlies,0,0,31,26,57,16,21,37,47,47,94,14,3,17,14,35,33,6,12,100,124
2019,2,21900856,2/24/2020,1610612763,Memphis Grizzlies,0,0,1610612746,LA Clippers,1,1,30,32,62,7,20,27,37,52,89,16,6,22,13,43,20,7,13,100,97
2019,2,21900834,2/21/2020,1610612740,New Orleans Pelicans,0,1,1610612757,Portland Trail Blazers,1,0,27,23,50,18,16,34,45,39,84,20,13,33,15,33,36,7,19,104,128
2019,2,21900834,2/21/2020,1610612757,Portland Trail Blazers,1,0,1610612740,New Orleans Pelicans,0,1,33,34,67,10,17,27,43,51,94,19,6,25,17,37,20,8,14,103,115
2019,2,21900824,2/20/2020,1610612758,Sacramento Kings,1,1,1610612763,Memphis Grizzlies,0,0,23,21,44,19,20,39,42,41,83,26,10,36,4,42,22,5,10,107,129
2019,2,21900824,2/20/2020,1610612763,Memphis Grizzlies,0,0,1610612758,Sacramento Kings,1,1,31,24,55,12,18,30,43,42,85,27,5,32,15,29,25,9,20,107,125
2019,2,21900804,2/11/2020,1610612740,New Orleans Pelicans,1,1,1610612757,Portland Trail Blazers,0,0,35,23,58,14,20,34,49,43,92,26,6,32,15,31,40,5,14,106,138
2019,2,21900804,2/11/2020,1610612757,Portland Trail Blazers,0,0,1610612740,New Orleans Pelicans,1,1,37,27,64,7,22,29,44,49,93,22,6,28,14,37,21,7,15,106,117
2019,2,21900763,2/5/2020,1610612746,LA Clippers,1,1,1610612748,Miami Heat,0,0,21,14,35,24,30,54,45,44,89,14,5,19,12,36,35,7,14,100,128
2019,2,21900763,2/5/2020,1610612748,Miami Heat,0,0,1610612746,LA Clippers,1,1,24,27,51,16,26,42,40,53,93,15,6,21,12,46,29,6,9,101,111
2019,2,21900747,2/3/2020,1610612748,Miami Heat,1,1,1610612755,Philadelphia 76ers,0,0,32,21,53,16,16,32,48,37,85,25,5,30,8,32,27,3,3,92,137
2019,2,21900747,2/3/2020,1610612755,Philadelphia 76ers,0,0,1610612748,Miami Heat,1,1,23,22,45,13,25,38,36,47,83,21,4,25,18,30,24,8,14,92,106
2019,2,21900731,2/1/2020,1610612751,Brooklyn Nets,0,0,1610612764,Washington Wizards,1,1,23,24,47,16,31,47,39,55,94,13,8,21,19,38,25,9,16,100,107
2019,2,21900731,2/1/2020,1610612764,Washington Wizards,1,1,1610612751,Brooklyn Nets,0,0,35,33,68,9,23,32,44,56,100,16,10,26,21,43,21,5,10,101,113
2019,2,21900718,1/30/2020,1610612743,Denver Nuggets,1,1,1610612762,Utah Jazz,0,0,31,27,58,9,18,27,40,45,85,17,4,21,12,33,25,4,10,94,106
2019,2,21900718,1/30/2020,1610612762,Utah Jazz,0,0,1610612743,Denver Nuggets,1,1,19,22,41,17,20,37,36,42,78,11,6,17,9,36,24,7,16,93,100
2019,2,21900676,1/24/2020,1610612740,New Orleans Pelicans,1,0,1610612743,Denver Nuggets,0,1,26,29,55,12,15,27,38,44,82,18,12,30,15,34,24,14,17,99,106
2019,2,21900676,1/24/2020,1610612743,Denver Nuggets,0,1,1610612740,New Orleans Pelicans,1,0,27,38,65,13,28,41,40,66,106,20,0,20,33,33,26,8,15,99,113
2019,2,21900673,1/24/2020,1610612746,LA Clippers,0,1,1610612748,Miami Heat,1,0,27,32,59,16,19,35,43,51,94,20,3,23,13,41,33,4,10,99,122
2019,2,21900673,1/24/2020,1610612748,Miami Heat,1,0,1610612746,LA Clippers,0,1,27,22,49,13,31,44,40,53,93,24,5,29,15,41,25,5,8,100,117
2019,2,21900669,1/24/2020,1610612749,Milwaukee Bucks,0,1,1610612766,Charlotte Hornets,1,0,34,17,51,10,26,36,44,43,87,18,6,24,12,32,26,6,16,102,116
2018,2,21800816,2/7/2019,1610612757,Portland Trail Blazers,1,1,1610612759,San Antonio Spurs,0,0,38,22,60,11,20,31,49,42,91,18,0,18,8,34,26,3,8,99,127
2018,2,21800816,2/7/2019,1610612759,San Antonio Spurs,0,0,1610612757,Portland Trail Blazers,1,1,36,34,70,12,9,21,48,43,91,10,4,14,15,30,19,11,18,98,118
2018,2,21800648,1/14/2019,1610612762,Utah Jazz,1,1,1610612765,Detroit Pistons,0,0,19,24,43,12,25,37,31,49,80,26,10,36,16,37,20,13,18,100,100
2018,2,21800648,1/14/2019,1610612765,Detroit Pistons,0,0,1610612762,Utah Jazz,1,1,24,30,54,11,25,36,35,55,90,13,3,16,9,48,16,5,11,100,94
2017,2,21700067,10/26/2017,1610612738,Boston Celtics,0,1,1610612749,Milwaukee Bucks,1,0,22,26,48,11,19,30,33,45,78,19,3,22,9,37,21,6,15,98,96
2017,2,21700067,10/26/2017,1610612749,Milwaukee Bucks,1,0,1610612738,Boston Celtics,0,1,24,28,52,11,14,25,35,42,77,8,6,14,5,40,22,7,18,97,89
2018,2,21800053,10/24/2018,1610612739,Cleveland Cavaliers,1,0,1610612751,Brooklyn Nets,0,1,31,40,71,3,15,18,34,55,89,15,1,16,17,38,18,8,15,95,86
2018,2,21800053,10/24/2018,1610612751,Brooklyn Nets,0,1,1610612739,Cleveland Cavaliers,1,0,24,29,53,14,20,34,38,49,87,12,3,15,12,39,23,5,14,95,102
2019,2,21901305,8/12/2020,1610612755,Philadelphia 76ers,1,0,1610612761,Toronto Raptors,0,1,22,22,44,17,23,40,39,45,84,26,7,33,10,38,27,8,17,106,121
2019,2,21901305,8/12/2020,1610612761,Toronto Raptors,0,1,1610612755,Philadelphia 76ers,1,0,22,25,47,18,25,43,40,50,90,27,13,40,15,40,28,9,12,107,125
2019,2,21901263,8/5/2020,1610612755,Philadelphia 76ers,0,1,1610612764,Washington Wizards,1,0,27,26,53,11,18,29,38,44,82,20,9,29,10,39,27,8,13,100,107
2019,2,21901263,8/5/2020,1610612764,Washington Wizards,1,0,1610612755,Philadelphia 76ers,0,1,29,35,64,7,14,21,36,49,85,19,5,24,11,38,17,11,16,100,98
2019,2,21901249,8/2/2020,1610612742,Dallas Mavericks,0,0,1610612756,Phoenix Suns,1,1,32,30,62,6,25,31,38,55,93,33,4,37,14,43,22,5,8,105,115
2019,2,21901249,8/2/2020,1610612756,Phoenix Suns,1,1,1610612742,Dallas Mavericks,0,0,30,30,60,12,21,33,42,51,93,21,2,23,10,41,22,8,11,104,117
2019,2,21901236,7/31/2020,1610612738,Boston Celtics,0,0,1610612749,Milwaukee Bucks,1,1,26,28,54,11,26,37,37,54,91,27,7,34,16,41,18,9,16,105,112
2019,2,21901236,7/31/2020,1610612749,Milwaukee Bucks,1,1,1610612738,Boston Celtics,0,0,26,17,43,13,28,41,39,45,84,28,6,34,10,37,25,8,15,106,119
2019,2,21900950,3/8/2020,1610612749,Milwaukee Bucks,0,0,1610612756,Phoenix Suns,1,1,38,24,62,13,20,33,51,44,95,16,5,21,8,40,23,6,10,105,131
2019,2,21900950,3/8/2020,1610612756,Phoenix Suns,1,1,1610612749,Milwaukee Bucks,0,0,28,14,42,19,24,43,47,38,85,27,4,31,10,30,30,7,15,105,140
2019,2,21900924,3/4/2020,1610612749,Milwaukee Bucks,1,1,1610612754,Indiana Pacers,0,0,30,18,48,13,33,46,43,51,94,20,2,22,14,38,26,12,18,111,119
2019,2,21900924,3/4/2020,1610612754,Indiana Pacers,0,0,1610612749,Milwaukee Bucks,1,1,35,35,70,7,20,27,42,55,97,9,2,11,8,47,22,8,16,110,100
2019,2,21900910,3/3/2020,1610612738,Boston Celtics,1,0,1610612751,Brooklyn Nets,0,1,29,25,54,15,34,49,44,59,103,17,6,23,20,42,24,6,14,110,120
2019,2,21900910,3/3/2020,1610612751,Brooklyn Nets,0,1,1610612738,Boston Celtics,1,0,29,22,51,14,35,49,43,57,100,29,9,38,28,36,22,11,22,110,129
2019,2,21900894,2/29/2020,1610612744,Golden State Warriors,0,1,1610612756,Phoenix Suns,1,0,32,25,57,9,21,30,41,46,87,24,8,32,15,36,30,3,10,99,115
2019,2,21900894,2/29/2020,1610612756,Phoenix Suns,1,0,1610612744,Golden State Warriors,0,1,22,32,54,12,17,29,34,49,83,19,4,23,15,36,24,9,20,98,99
2019,2,21900876,2/27/2020,1610612744,Golden State Warriors,1,0,1610612747,Los Angeles Lakers,0,1,25,23,48,9,23,32,34,46,80,9,1,10,7,39,27,13,27,106,86
2019,2,21900876,2/27/2020,1610612747,Los Angeles Lakers,0,1,1610612744,Golden State Warriors,1,0,37,27,64,8,16,24,45,43,88,18,9,27,12,35,24,7,17,106,116
2019,2,21900846,2/23/2020,1610612759,San Antonio Spurs,0,0,1610612760,Oklahoma City Thunder,1,1,27,38,65,11,27,38,38,65,103,16,3,19,15,51,27,7,9,106,103
2019,2,21900846,2/23/2020,1610612760,Oklahoma City Thunder,1,1,1610612759,San Antonio Spurs,0,0,40,25,65,10,12,22,50,37,87,21,3,24,7,31,28,5,13,105,131
2019,2,21900812,2/12/2020,1610612757,Portland Trail Blazers,0,0,1610612763,Memphis Grizzlies,1,1,23,37,60,13,24,37,36,61,97,19,5,24,19,44,21,8,11,103,104
2019,2,21900812,2/12/2020,1610612763,Memphis Grizzlies,1,1,1610612757,Portland Trail Blazers,0,0,39,33,72,6,17,23,45,50,95,15,7,22,16,38,26,7,12,102,111
2019,2,21900788,2/9/2020,1610612741,Chicago Bulls,0,0,1610612755,Philadelphia 76ers,1,1,31,25,56,12,20,32,43,45,88,13,4,17,16,30,23,12,18,99,111
2019,2,21900788,2/9/2020,1610612755,Philadelphia 76ers,1,1,1610612741,Chicago Bulls,0,0,31,26,57,11,16,27,42,42,84,23,9,32,17,29,29,8,16,99,118
2019,2,21900772,2/7/2020,1610612754,Indiana Pacers,1,0,1610612761,Toronto Raptors,0,1,29,23,52,10,24,34,39,47,86,18,4,22,16,33,26,12,20,100,106
2019,2,21900772,2/7/2020,1610612761,Toronto Raptors,0,1,1610612754,Indiana Pacers,1,0,25,25,50,17,21,38,42,46,88,14,3,17,12,37,28,5,16,101,115
2019,2,21900754,2/4/2020,1610612747,Los Angeles Lakers,1,1,1610612759,San Antonio Spurs,0,0,38,19,57,12,16,28,50,35,85,17,8,25,15,25,28,6,14,95,129
2019,2,21900754,2/4/2020,1610612759,San Antonio Spurs,0,0,1610612747,Los Angeles Lakers,1,1,27,37,64,13,14,27,40,51,91,9,6,15,8,47,21,5,6,96,102
2020,2,22000080,1/2/2021,1610612752,New York Knicks,0,1,1610612754,Indiana Pacers,1,0,30,26,56,12,15,27,42,41,83,10,3,13,14,28,23,6,16,92,106
2020,2,22000080,1/2/2021,1610612754,Indiana Pacers,1,0,1610612752,New York Knicks,0,1,15,19,34,19,31,50,34,50,84,15,3,18,8,44,22,4,9,93,102
2019,2,21900088,11/3/2019,1610612747,Los Angeles Lakers,0,1,1610612759,San Antonio Spurs,1,0,36,27,63,6,18,24,42,45,87,13,6,19,10,41,21,11,18,103,103
2019,2,21900088,11/3/2019,1610612759,San Antonio Spurs,1,0,1610612747,Los Angeles Lakers,0,1,27,31,58,6,19,25,33,50,83,24,5,29,11,41,23,8,18,103,96
2018,2,21801061,3/19/2019,1610612747,Los Angeles Lakers,0,0,1610612749,Milwaukee Bucks,1,1,17,26,43,16,27,43,33,53,86,19,4,23,11,43,20,9,19,105,101
2018,2,21801061,3/19/2019,1610612749,Milwaukee Bucks,1,1,1610612747,Los Angeles Lakers,0,0,26,16,42,15,32,47,41,48,89,18,9,27,15,37,25,9,18,106,115
2018,2,21800924,2/28/2019,1610612739,Cleveland Cavaliers,0,1,1610612752,New York Knicks,1,0,27,19,46,14,20,34,41,39,80,29,7,36,14,27,24,4,13,96,125
2018,2,21800924,2/28/2019,1610612752,New York Knicks,1,0,1610612739,Cleveland Cavaliers,0,1,35,28,63,11,21,32,46,49,95,15,8,23,18,33,26,5,10,97,118
2018,2,21800052,10/24/2018,1610612737,Atlanta Hawks,1,1,1610612742,Dallas Mavericks,0,0,22,31,53,15,23,38,37,54,91,22,9,31,11,45,28,7,15,110,111
2018,2,21800052,10/24/2018,1610612742,Dallas Mavericks,0,0,1610612737,Atlanta Hawks,1,1,26,25,51,12,28,40,38,53,91,16,10,26,12,47,25,6,17,111,104
2019,2,21901287,8/9/2020,1610612740,New Orleans Pelicans,1,0,1610612759,San Antonio Spurs,0,1,30,36,66,12,18,30,42,54,96,17,5,22,19,37,30,12,20,106,113
2019,2,21901287,8/9/2020,1610612759,San Antonio Spurs,0,1,1610612740,New Orleans Pelicans,1,0,29,32,61,11,17,28,40,49,89,31,1,32,17,32,22,5,17,106,122
2019,2,21900937,3/6/2020,1610612742,Dallas Mavericks,1,1,1610612763,Memphis Grizzlies,0,0,27,21,48,18,29,47,45,50,95,13,4,17,14,38,30,7,11,98,121
2019,2,21900937,3/6/2020,1610612763,Memphis Grizzlies,0,0,1610612742,Dallas Mavericks,1,1,30,24,54,9,21,30,39,45,84,9,4,13,11,36,29,11,19,99,96
2019,2,21900803,2/11/2020,1610612741,Chicago Bulls,0,0,1610612764,Washington Wizards,1,1,28,25,53,16,23,39,44,48,92,10,4,14,15,35,25,11,22,106,114
2019,2,21900803,2/11/2020,1610612764,Washington Wizards,1,1,1610612741,Chicago Bulls,0,0,37,20,57,11,21,32,48,41,89,19,5,24,11,34,28,9,17,107,126
2019,2,21900781,2/8/2020,1610612751,Brooklyn Nets,0,0,1610612761,Toronto Raptors,1,1,25,23,48,16,28,44,41,51,92,20,4,24,16,36,27,6,9,96,118
2019,2,21900781,2/8/2020,1610612761,Toronto Raptors,1,1,1610612751,Brooklyn Nets,0,0,31,29,60,14,21,35,45,50,95,15,6,21,16,34,22,5,7,96,119
2019,2,21900762,2/5/2020,1610612743,Denver Nuggets,0,1,1610612762,Utah Jazz,1,0,32,28,60,7,23,30,39,51,90,13,5,18,15,40,23,5,11,97,98
2019,2,21900762,2/5/2020,1610612762,Utah Jazz,1,0,1610612743,Denver Nuggets,0,1,22,25,47,14,25,39,36,50,86,9,5,14,11,41,20,8,14,97,95
2019,2,21900740,2/2/2020,1610612741,Chicago Bulls,0,0,1610612761,Toronto Raptors,1,1,20,22,42,15,33,48,35,55,90,17,9,26,22,38,25,6,16,97,102
2019,2,21900740,2/2/2020,1610612761,Toronto Raptors,1,1,1610612741,Chicago Bulls,0,0,31,19,50,16,18,34,47,37,84,19,4,23,13,25,28,10,15,96,129
2019,2,21900730,2/1/2020,1610612739,Cleveland Cavaliers,1,0,1610612744,Golden State Warriors,0,1,25,26,51,16,28,44,41,54,95,14,0,14,19,35,26,11,16,101,112
2019,2,21900730,2/1/2020,1610612744,Golden State Warriors,0,1,1610612739,Cleveland Cavaliers,1,0,30,25,55,18,17,35,48,42,90,17,2,19,10,33,39,8,11,101,131
2019,2,21900717,1/30/2020,1610612738,Boston Celtics,1,1,1610612744,Golden State Warriors,0,0,27,26,53,15,20,35,42,46,88,20,2,22,19,28,27,11,23,104,119
2019,2,21900717,1/30/2020,1610612744,Golden State Warriors,0,0,1610612738,Boston Celtics,1,1,21,17,38,12,27,39,33,44,77,26,4,30,5,39,24,12,17,104,104
2019,2,21900705,1/28/2020,1610612749,Milwaukee Bucks,1,1,1610612764,Washington Wizards,0,0,31,22,53,19,18,37,50,40,90,32,3,35,14,27,31,6,15,108,151
2019,2,21900705,1/28/2020,1610612764,Washington Wizards,0,0,1610612749,Milwaukee Bucks,1,1,30,32,62,14,18,32,44,50,94,29,5,34,15,37,28,3,11,109,131
2019,2,21900701,1/28/2020,1610612738,Boston Celtics,0,1,1610612748,Miami Heat,1,0,26,21,47,13,23,36,39,44,83,18,6,24,12,35,24,11,14,96,109
2019,2,21900701,1/28/2020,1610612748,Miami Heat,1,0,1610612738,Boston Celtics,0,1,24,28,52,9,28,37,33,56,89,26,5,31,19,40,15,5,11,98,101
2019,2,21900697,1/27/2020,1610612742,Dallas Mavericks,0,1,1610612760,Oklahoma City Thunder,1,0,22,26,48,19,32,51,41,58,99,6,3,9,15,44,21,2,9,98,107
2019,2,21900697,1/27/2020,1610612760,Oklahoma City Thunder,1,0,1610612742,Dallas Mavericks,0,1,22,34,56,12,18,30,34,52,86,17,2,19,8,45,23,3,10,98,97
2019,2,21900692,1/26/2020,1610612754,Indiana Pacers,0,0,1610612757,Portland Trail Blazers,1,1,35,30,65,13,15,28,48,45,93,20,1,21,10,35,31,1,7,99,129
2019,2,21900692,1/26/2020,1610612757,Portland Trail Blazers,1,1,1610612754,Indiana Pacers,0,0,29,26,55,20,15,35,49,41,90,21,4,25,17,26,27,5,17,100,139
2019,2,21900686,1/26/2020,1610612759,San Antonio Spurs,1,0,1610612761,Toronto Raptors,0,1,18,27,45,16,21,37,34,48,82,22,2,24,10,39,27,11,17,101,106
2019,2,21900686,1/26/2020,1610612761,Toronto Raptors,0,1,1610612759,San Antonio Spurs,1,0,25,24,49,16,34,50,41,58,99,12,3,15,16,43,31,5,9,101,110
2019,2,21900683,1/25/2020,1610612750,Minnesota Timberwolves,1,0,1610612760,Oklahoma City Thunder,0,1,28,19,47,12,31,43,40,50,90,12,6,18,11,42,33,8,13,102,104
2019,2,21900316,12/5/2019,1610612755,Philadelphia 76ers,0,0,1610612764,Washington Wizards,1,1,28,21,49,13,15,28,41,36,77,18,6,24,10,29,25,9,21,101,113
2019,2,21900316,12/5/2019,1610612764,Washington Wizards,1,1,1610612755,Philadelphia 76ers,0,0,30,33,63,11,16,27,41,49,90,26,6,32,15,37,25,7,12,101,119
2018,2,21801209,4/9/2019,1610612739,Cleveland Cavaliers,1,0,1610612766,Charlotte Hornets,0,1,29,30,59,11,19,30,40,49,89,6,2,8,15,34,24,8,14,91,97
2018,2,21801209,4/9/2019,1610612766,Charlotte Hornets,0,1,1610612739,Cleveland Cavaliers,1,0,23,11,34,22,22,44,45,33,78,12,5,17,7,29,35,3,10,89,124
2018,2,21800923,2/28/2019,1610612744,Golden State Warriors,0,0,1610612753,Orlando Magic,1,1,30,27,57,9,31,40,39,58,97,9,1,10,11,47,16,2,12,104,96
2018,2,21800923,2/28/2019,1610612753,Orlando Magic,1,1,1610612744,Golden State Warriors,0,0,29,29,58,11,20,31,40,49,89,12,3,15,9,42,24,5,15,103,103
2018,2,21800723,1/25/2019,1610612741,Chicago Bulls,1,0,1610612746,LA Clippers,0,1,30,37,67,10,25,35,40,62,102,11,1,12,16,47,20,3,11,102,101
2018,2,21800723,1/25/2019,1610612746,LA Clippers,0,1,1610612741,Chicago Bulls,1,0,30,31,61,8,13,21,38,44,82,22,7,29,10,38,27,11,16,103,106
2017,2,21700066,10/26/2017,1610612742,Dallas Mavericks,0,0,1610612763,Memphis Grizzlies,1,1,22,38,60,10,24,34,32,62,94,17,3,20,23,40,20,7,14,95,91
2017,2,21700066,10/26/2017,1610612763,Memphis Grizzlies,1,1,1610612742,Dallas Mavericks,0,0,20,19,39,10,24,34,30,43,73,26,4,30,9,36,18,10,18,95,96
2014,2,21400969,3/13/2015,1610612738,Boston Celtics,1,1,1610612753,Orlando Magic,0,0,27,33,60,10,16,26,37,49,86,11,9,20,14,41,19,9,17,98,95
2014,2,21400969,3/13/2015,1610612753,Orlando Magic,0,0,1610612738,Boston Celtics,1,1,28,32,60,6,14,20,34,46,80,14,14,28,13,39,20,7,20,99,88
2019,2,21901286,8/9/2020,1610612761,Toronto Raptors,1,1,1610612763,Memphis Grizzlies,0,0,19,13,32,15,24,39,34,37,71,25,8,33,6,35,25,14,26,108,108
2019,2,21901286,8/9/2020,1610612763,Memphis Grizzlies,0,0,1610612761,Toronto Raptors,1,1,23,26,49,14,28,42,37,54,91,11,5,16,15,42,24,17,22,108,99
2019,2,21901235,7/31/2020,1610612756,Phoenix Suns,0,1,1610612764,Washington Wizards,1,0,31,17,48,11,21,32,42,38,80,30,2,32,7,31,29,7,18,107,125
2019,2,21901235,7/31/2020,1610612764,Washington Wizards,1,0,1610612756,Phoenix Suns,0,1,34,35,69,8,14,22,42,49,91,20,3,23,12,37,18,10,18,108,112
2019,2,21900962,3/10/2020,1610612739,Cleveland Cavaliers,0,0,1610612741,Chicago Bulls,1,1,34,22,56,6,18,24,40,40,80,17,6,23,10,32,29,8,18,97,103
2019,2,21900962,3/10/2020,1610612741,Chicago Bulls,1,1,1610612739,Cleveland Cavaliers,0,0,30,20,50,12,22,34,42,42,84,12,3,15,15,28,23,9,21,96,108
2019,2,21900893,2/29/2020,1610612753,Orlando Magic,0,0,1610612759,San Antonio Spurs,1,1,26,21,47,15,22,37,41,43,84,16,7,23,14,33,28,11,19,102,113
2019,2,21900893,2/29/2020,1610612759,San Antonio Spurs,1,1,1610612753,Orlando Magic,0,0,30,23,53,14,17,31,44,40,84,12,4,16,8,33,28,9,17,102,114
2019,2,21900875,2/27/2020,1610612758,Sacramento Kings,0,0,1610612760,Oklahoma City Thunder,1,1,29,27,56,12,23,35,41,50,91,14,0,14,16,34,30,6,15,96,108
2019,2,21900875,2/27/2020,1610612760,Oklahoma City Thunder,1,1,1610612758,Sacramento Kings,0,0,32,26,58,9,17,26,41,43,84,21,8,29,12,38,20,6,11,95,112
2019,2,21900823,2/20/2020,1610612741,Chicago Bulls,1,0,1610612766,Charlotte Hornets,0,1,30,26,56,7,24,31,37,50,87,12,7,19,17,35,24,9,14,95,93
2019,2,21900823,2/20/2020,1610612766,Charlotte Hornets,0,1,1610612741,Chicago Bulls,1,0,27,19,46,8,20,28,35,39,74,25,4,29,12,28,22,12,18,94,103
2019,2,21900794,2/10/2020,1610612751,Brooklyn Nets,0,1,1610612754,Indiana Pacers,1,0,23,27,50,12,25,37,35,52,87,24,8,32,19,36,20,7,10,95,106
2019,2,21900794,2/10/2020,1610612754,Indiana Pacers,1,0,1610612751,Brooklyn Nets,0,1,38,24,62,7,23,30,45,47,92,8,3,11,9,39,28,5,6,94,105
2019,2,21900771,2/7/2020,1610612737,Atlanta Hawks,0,0,1610612738,Boston Celtics,1,1,22,25,47,13,26,39,35,51,86,24,2,26,15,37,21,5,14,98,107
2019,2,21900771,2/7/2020,1610612738,Boston Celtics,1,1,1610612737,Atlanta Hawks,0,0,21,28,49,16,21,37,37,49,86,22,5,27,15,38,23,7,13,99,112
2019,2,21900716,1/30/2020,1610612737,Atlanta Hawks,1,1,1610612755,Philadelphia 76ers,0,0,31,21,52,11,24,35,42,45,87,32,5,37,11,36,29,11,16,108,127
2019,2,21900716,1/30/2020,1610612755,Philadelphia 76ers,0,0,1610612737,Atlanta Hawks,1,1,29,22,51,9,22,31,38,44,82,32,13,45,9,42,22,5,12,106,117
2019,2,21900710,1/29/2020,1610612752,New York Knicks,1,0,1610612763,Memphis Grizzlies,0,1,30,33,63,9,19,28,39,52,91,19,10,29,17,42,26,7,18,104,106
2019,2,21900710,1/29/2020,1610612763,Memphis Grizzlies,0,1,1610612752,New York Knicks,1,0,30,28,58,13,15,28,43,43,86,28,5,33,8,37,25,9,12,102,127
2019,2,21900691,1/26/2020,1610612738,Boston Celtics,0,0,1610612740,New Orleans Pelicans,1,1,33,23,56,8,25,33,41,48,89,18,4,22,11,40,21,7,17,106,108
2019,2,21900691,1/26/2020,1610612740,New Orleans Pelicans,1,1,1610612738,Boston Celtics,0,0,28,28,56,16,20,36,44,48,92,19,10,29,21,32,31,6,20,105,123
2020,2,22000079,1/2/2021,1610612745,Houston Rockets,1,1,1610612758,Sacramento Kings,0,0,23,17,40,13,28,41,36,45,81,17,6,23,10,36,15,5,14,96,102
2020,2,22000079,1/2/2021,1610612758,Sacramento Kings,0,0,1610612745,Houston Rockets,1,1,26,36,62,9,19,28,35,55,90,15,6,21,17,43,11,10,15,96,94
2023,2,22301192,4/14/2024,1610612751,Brooklyn Nets,0,0,1610612755,Philadelphia 76ers,1,1,23,26,49,9,25,34,32,51,83,13,4,17,6,47,19,8,13,98,86
2019,2,21900315,12/4/2019,1610612757,Portland Trail Blazers,1,1,1610612758,Sacramento Kings,0,0,31,21,52,16,16,32,47,37,84,17,4,21,8,31,28,7,12,100,127
2019,2,21900315,12/4/2019,1610612758,Sacramento Kings,0,0,1610612757,Portland Trail Blazers,1,1,33,28,61,11,23,34,44,51,95,17,6,23,14,41,26,6,10,100,116
2019,2,21900087,11/3/2019,1610612752,New York Knicks,1,0,1610612758,Sacramento Kings,0,1,24,25,49,8,23,31,32,48,80,20,11,31,12,41,18,7,13,95,92
2019,2,21900087,11/3/2019,1610612758,Sacramento Kings,0,1,1610612752,New York Knicks,1,0,26,20,46,15,24,39,41,44,85,16,9,25,15,33,25,6,14,96,113
2018,2,21801208,4/7/2019,1610612747,Los Angeles Lakers,1,1,1610612762,Utah Jazz,0,0,39,25,64,7,18,25,46,43,89,14,7,21,20,25,28,11,17,96,113
2018,2,21801208,4/7/2019,1610612762,Utah Jazz,0,0,1610612747,Los Angeles Lakers,1,1,25,17,42,13,29,42,38,46,84,20,8,28,13,35,25,5,11,96,109
2018,2,21801060,3/19/2019,1610612737,Atlanta Hawks,1,0,1610612745,Houston Rockets,0,1,24,20,44,15,25,40,39,45,84,12,3,15,11,35,30,13,19,100,105
2018,2,21801060,3/19/2019,1610612745,Houston Rockets,0,1,1610612737,Atlanta Hawks,1,0,21,10,31,19,28,47,40,38,78,22,8,30,6,37,28,6,14,99,121
2018,2,21800571,1/4/2019,1610612750,Minnesota Timberwolves,1,1,1610612753,Orlando Magic,0,0,38,27,65,9,17,26,47,44,91,17,6,23,12,33,29,7,11,100,120
2018,2,21800571,1/4/2019,1610612753,Orlando Magic,0,0,1610612750,Minnesota Timberwolves,1,1,33,28,61,9,18,27,42,46,88,10,9,19,7,46,28,6,11,101,103
2017,2,21700065,10/26/2017,1610612737,Atlanta Hawks,0,0,1610612741,Chicago Bulls,1,1,21,32,53,11,17,28,32,49,81,11,2,13,7,43,22,5,10,91,86
2017,2,21700065,10/26/2017,1610612741,Chicago Bulls,1,1,1610612737,Atlanta Hawks,0,0,24,30,54,7,25,32,31,55,86,22,7,29,23,38,20,10,16,90,91
2018,2,21800051,10/23/2018,1610612743,Denver Nuggets,1,1,1610612758,Sacramento Kings,0,0,40,29,69,11,19,30,51,48,99,13,2,15,18,30,31,7,12,100,126
2018,2,21800051,10/23/2018,1610612758,Sacramento Kings,0,0,1610612743,Denver Nuggets,1,1,32,23,55,13,18,31,45,41,86,9,11,20,11,36,29,11,16,100,112
2019,2,21901304,8/12/2020,1610612745,Houston Rockets,1,0,1610612754,Indiana Pacers,0,1,16,13,29,16,41,57,32,54,86,24,4,28,11,44,20,15,20,110,104
2019,2,21901304,8/12/2020,1610612754,Indiana Pacers,0,1,1610612745,Houston Rockets,1,0,29,40,69,11,20,31,40,60,100,17,5,22,18,43,25,8,15,109,108
2019,2,21901285,8/9/2020,1610612760,Oklahoma City Thunder,1,1,1610612764,Washington Wizards,0,0,25,20,45,18,21,39,43,41,84,17,5,22,9,33,25,6,12,100,121
2019,2,21901285,8/9/2020,1610612764,Washington Wizards,0,0,1610612760,Oklahoma City Thunder,1,1,29,27,56,9,27,36,38,54,92,18,4,22,20,37,23,7,16,101,103
2019,2,21901262,8/5/2020,1610612762,Utah Jazz,1,1,1610612763,Memphis Grizzlies,0,0,20,19,39,18,27,45,38,46,84,30,3,33,15,32,25,7,18,105,124
2019,2,21901262,8/5/2020,1610612763,Memphis Grizzlies,0,0,1610612762,Utah Jazz,1,1,32,30,62,11,18,29,43,48,91,18,7,25,12,37,21,5,14,105,115
2019,2,21901248,8/2/2020,1610612745,Houston Rockets,1,1,1610612749,Milwaukee Bucks,0,0,15,15,30,21,40,61,36,55,91,27,4,31,9,49,22,6,9,106,120
2019,2,21901248,8/2/2020,1610612749,Milwaukee Bucks,0,0,1610612745,Houston Rockets,1,1,36,21,57,9,26,35,45,47,92,17,6,23,19,33,21,15,23,105,116
2019,2,21900949,3/8/2020,1610612738,Boston Celtics,1,0,1610612760,Oklahoma City Thunder,0,1,25,30,55,13,24,37,38,54,92,15,4,19,15,41,22,9,13,101,104
2019,2,21900949,3/8/2020,1610612760,Oklahoma City Thunder,0,1,1610612738,Boston Celtics,1,0,25,29,54,10,15,25,35,44,79,25,9,34,11,38,16,9,18,100,105
2019,2,21900909,3/3/2020,1610612759,San Antonio Spurs,0,1,1610612766,Charlotte Hornets,1,0,27,21,48,11,21,32,38,42,80,17,3,20,9,34,25,4,10,92,104
2019,2,21900909,3/3/2020,1610612766,Charlotte Hornets,1,0,1610612759,San Antonio Spurs,0,1,27,26,53,12,17,29,39,43,82,13,5,18,17,29,25,12,17,91,103
2019,2,21900855,2/24/2020,1610612756,Phoenix Suns,0,1,1610612762,Utah Jazz,1,0,37,30,67,12,8,20,49,38,87,21,3,24,15,25,33,8,15,100,131
2019,2,21900855,2/24/2020,1610612762,Utah Jazz,1,0,1610612756,Phoenix Suns,0,1,22,20,42,10,16,26,32,36,68,37,6,43,10,27,16,10,20,101,111
2019,2,21900845,2/23/2020,1610612741,Chicago Bulls,1,1,1610612764,Washington Wizards,0,0,27,17,44,18,19,37,45,36,81,18,10,28,13,30,27,15,29,107,126
2019,2,21900845,2/23/2020,1610612764,Washington Wizards,0,0,1610612741,Chicago Bulls,1,1,25,18,43,12,18,30,37,36,73,31,5,36,8,31,24,15,24,106,117
2019,2,21900780,2/8/2020,1610612740,New Orleans Pelicans,0,1,1610612754,Indiana Pacers,1,0,29,28,57,15,23,38,44,51,95,21,4,25,17,37,27,5,15,105,124
2019,2,21900780,2/8/2020,1610612754,Indiana Pacers,1,0,1610612740,New Orleans Pelicans,0,1,35,22,57,9,17,26,44,39,83,20,7,27,6,38,25,8,14,104,117
2019,2,21900761,2/5/2020,1610612742,Dallas Mavericks,1,0,1610612763,Memphis Grizzlies,0,1,17,34,51,17,26,43,34,60,94,22,2,24,16,45,19,6,9,100,107
2019,2,21900761,2/5/2020,1610612763,Memphis Grizzlies,0,1,1610612742,Dallas Mavericks,1,0,35,29,64,12,13,25,47,42,89,15,5,20,11,32,27,5,11,99,121
2019,2,21900753,2/4/2020,1610612743,Denver Nuggets,1,1,1610612757,Portland Trail Blazers,0,0,29,27,56,17,17,34,46,44,90,18,7,25,16,29,30,5,14,97,127
2019,2,21900753,2/4/2020,1610612757,Portland Trail Blazers,0,0,1610612743,Denver Nuggets,1,1,27,33,60,9,22,31,36,55,91,18,4,22,13,45,16,5,9,98,99
2019,2,21900746,2/3/2020,1610612751,Brooklyn Nets,1,1,1610612756,Phoenix Suns,0,0,28,27,55,15,19,34,43,46,89,18,3,21,16,32,28,7,17,100,119
2019,2,21900746,2/3/2020,1610612756,Phoenix Suns,0,0,1610612751,Brooklyn Nets,1,1,33,40,73,6,11,17,39,51,90,13,5,18,16,36,23,8,16,98,97
2019,2,21900739,2/2/2020,1610612749,Milwaukee Bucks,1,1,1610612756,Phoenix Suns,0,0,33,26,59,15,23,38,48,49,97,18,9,27,20,36,30,8,17,108,129
2019,2,21900739,2/2/2020,1610612756,Phoenix Suns,0,0,1610612749,Milwaukee Bucks,1,1,35,46,81,6,17,23,41,63,104,20,3,23,19,46,20,4,10,106,108
2016,2,21600732,2/1/2017,1610612738,Boston Celtics,1,1,1610612761,Toronto Raptors,0,0,24,27,51,12,24,36,36,51,87,25,5,30,19,35,24,6,10,91,109
2016,2,21600732,2/1/2017,1610612761,Toronto Raptors,0,0,1610612738,Boston Celtics,1,1,33,14,47,8,23,31,41,37,78,14,11,25,15,27,17,6,16,92,104
2016,2,21600251,11/27/2016,1610612745,Houston Rockets,0,1,1610612757,Portland Trail Blazers,1,0,29,17,46,17,19,36,46,36,82,21,7,28,8,31,26,7,11,99,130
2016,2,21600251,11/27/2016,1610612757,Portland Trail Blazers,1,0,1610612745,Houston Rockets,0,1,28,22,50,12,21,33,40,43,83,22,7,29,12,33,24,7,15,98,114
2018,2,21800922,2/28/2019,1610612750,Minnesota Timberwolves,0,0,1610612754,Indiana Pacers,1,1,34,29,63,8,18,26,42,47,89,23,11,34,25,27,16,8,18,97,115
2018,2,21800922,2/28/2019,1610612754,Indiana Pacers,1,1,1610612750,Minnesota Timberwolves,0,0,24,33,57,16,11,27,40,44,84,26,5,31,12,35,35,5,11,97,122
2018,2,21800358,12/5/2018,1610612751,Brooklyn Nets,1,0,1610612760,Oklahoma City Thunder,0,1,22,28,50,15,21,36,37,49,86,23,7,30,12,43,21,8,15,102,112
2018,2,21800358,12/5/2018,1610612760,Oklahoma City Thunder,0,1,1610612751,Brooklyn Nets,1,0,30,31,61,13,25,38,43,56,99,15,11,26,22,39,28,7,13,102,114
2017,2,21700064,10/25/2017,1610612747,Los Angeles Lakers,1,1,1610612764,Washington Wizards,0,0,34,28,62,7,23,30,41,51,92,13,3,16,12,40,27,11,22,109,102
2017,2,21700064,10/25/2017,1610612764,Washington Wizards,0,0,1610612747,Los Angeles Lakers,1,1,33,36,69,6,20,26,39,56,95,15,8,23,12,48,20,9,15,111,99
2018,2,21800050,10/23/2018,1610612740,New Orleans Pelicans,1,1,1610612746,LA Clippers,0,0,34,35,69,6,18,24,40,53,93,30,10,40,17,41,22,5,8,104,116
2018,2,21800050,10/23/2018,1610612746,LA Clippers,0,0,1610612740,New Orleans Pelicans,1,1,36,31,67,5,15,20,41,46,87,22,5,27,13,37,18,12,17,103,109
2019,2,21901284,8/8/2020,1610612742,Dallas Mavericks,1,1,1610612749,Milwaukee Bucks,0,0,31,31,62,17,36,53,48,67,115,23,2,25,20,47,37,3,7,115,136
2019,2,21901284,8/8/2020,1610612749,Milwaukee Bucks,0,0,1610612742,Dallas Mavericks,1,1,32,23,55,15,29,44,47,52,99,23,11,34,11,44,26,6,13,116,132
2019,2,21900923,3/4/2020,1610612740,New Orleans Pelicans,0,0,1610612742,Dallas Mavericks,1,1,33,35,68,17,29,46,50,64,114,6,5,11,21,45,28,6,14,112,123
2019,2,21900923,3/4/2020,1610612742,Dallas Mavericks,1,1,1610612740,New Orleans Pelicans,0,0,22,23,45,22,28,50,44,51,95,17,7,24,13,40,30,8,17,111,127
2019,2,21900822,2/20/2020,1610612751,Brooklyn Nets,0,0,1610612755,Philadelphia 76ers,1,1,26,42,68,10,24,34,36,66,102,22,6,28,27,41,22,10,16,105,104
2019,2,21900822,2/20/2020,1610612755,Philadelphia 76ers,1,1,1610612751,Brooklyn Nets,0,0,34,30,64,4,18,22,38,48,86,32,3,35,11,38,19,3,14,104,112
2019,2,21900802,2/11/2020,1610612746,LA Clippers,0,0,1610612755,Philadelphia 76ers,1,1,26,33,59,14,17,31,40,50,90,9,4,13,10,42,25,3,9,98,103
2019,2,21900802,2/11/2020,1610612755,Philadelphia 76ers,1,1,1610612746,LA Clippers,0,0,36,32,68,8,19,27,44,51,95,14,7,21,15,40,25,2,8,97,110
2019,2,21900770,2/7/2020,1610612742,Dallas Mavericks,0,0,1610612764,Washington Wizards,1,1,26,25,51,16,24,40,42,49,91,18,3,21,18,32,27,8,14,96,118
2019,2,21900770,2/7/2020,1610612764,Washington Wizards,1,1,1610612742,Dallas Mavericks,0,0,26,26,52,19,19,38,45,45,90,10,3,13,12,35,28,7,13,98,119
2019,2,21900729,2/1/2020,1610612748,Miami Heat,0,1,1610612753,Orlando Magic,1,0,18,26,44,15,18,33,33,44,77,21,5,26,13,32,24,5,13,91,102
2019,2,21900729,2/1/2020,1610612753,Orlando Magic,1,0,1610612748,Miami Heat,0,1,24,26,50,9,24,33,33,50,83,14,3,17,11,42,21,6,10,90,89
2019,2,21900715,1/30/2020,1610612764,Washington Wizards,1,1,1610612766,Charlotte Hornets,0,0,27,22,49,14,23,37,41,45,86,25,2,27,22,23,24,9,20,97,121
2019,2,21900715,1/30/2020,1610612766,Charlotte Hornets,0,0,1610612764,Washington Wizards,1,1,34,35,69,9,21,30,43,56,99,12,7,19,19,41,32,3,9,98,107
2019,2,21900683,1/25/2020,1610612760,Oklahoma City Thunder,0,1,1610612750,Minnesota Timberwolves,1,0,28,28,56,11,13,24,39,41,80,24,1,25,6,36,20,9,14,100,113
2019,2,21900680,1/25/2020,1610612742,Dallas Mavericks,0,0,1610612762,Utah Jazz,1,1,26,30,56,16,25,41,42,55,97,7,6,13,15,43,19,5,9,98,107
2019,2,21900680,1/25/2020,1610612762,Utah Jazz,1,1,1610612742,Dallas Mavericks,0,0,25,23,48,15,28,43,40,51,91,17,5,22,18,37,22,6,13,98,112
2019,2,21900678,1/24/2020,1610612756,Phoenix Suns,0,1,1610612759,San Antonio Spurs,1,0,31,24,55,8,21,29,39,45,84,17,4,21,13,35,25,9,14,95,103
2019,2,21900678,1/24/2020,1610612759,San Antonio Spurs,1,0,1610612756,Phoenix Suns,0,1,28,25,53,5,20,25,33,45,78,28,5,33,13,33,19,6,14,96,99
2019,2,21900672,1/24/2020,1610612752,New York Knicks,1,0,1610612761,Toronto Raptors,0,1,29,20,49,13,23,36,42,43,85,15,6,21,18,27,26,10,16,93,112
2019,2,21900672,1/24/2020,1610612761,Toronto Raptors,0,1,1610612752,New York Knicks,1,0,24,22,46,17,18,35,41,40,81,19,4,23,8,34,25,5,7,93,118
2019,2,21900670,1/24/2020,1610612763,Memphis Grizzlies,0,1,1610612765,Detroit Pistons,1,0,32,25,57,11,11,22,43,36,79,28,3,31,9,29,27,8,14,99,125
2019,2,21900670,1/24/2020,1610612765,Detroit Pistons,1,0,1610612763,Memphis Grizzlies,0,1,28,31,59,11,21,32,39,52,91,23,8,31,16,41,23,6,8,99,112
2019,2,21900669,1/24/2020,1610612766,Charlotte Hornets,1,0,1610612749,Milwaukee Bucks,0,1,18,29,47,14,25,39,32,54,86,25,5,30,11,45,24,8,13,103,103
2020,2,22000078,1/1/2021,1610612744,Golden State Warriors,1,0,1610612757,Portland Trail Blazers,0,1,24,20,44,7,28,35,31,48,79,29,4,33,7,43,19,11,16,102,98
2020,2,22000078,1/1/2021,1610612757,Portland Trail Blazers,0,1,1610612744,Golden State Warriors,1,0,20,29,49,20,23,43,40,52,92,23,7,30,13,42,23,4,9,101,123
2018,2,21800722,1/25/2019,1610612739,Cleveland Cavaliers,1,0,1610612748,Miami Heat,0,1,27,28,55,10,20,30,37,48,85,10,3,13,12,39,23,6,13,92,94
2018,2,21800722,1/25/2019,1610612748,Miami Heat,0,1,1610612739,Cleveland Cavaliers,1,0,28,28,56,9,14,23,37,42,79,17,8,25,13,33,19,8,14,93,100
2018,2,21800495,12/23/2018,1610612742,Dallas Mavericks,0,0,1610612757,Portland Trail Blazers,1,1,31,38,69,12,22,34,43,60,103,20,8,28,15,50,22,5,10,111,118
2018,2,21800495,12/23/2018,1610612757,Portland Trail Blazers,1,1,1610612742,Dallas Mavericks,0,0,38,28,66,11,27,38,49,55,104,12,5,17,12,44,29,1,10,111,121
2017,2,21700063,10/25/2017,1610612744,Golden State Warriors,1,1,1610612761,Toronto Raptors,0,0,31,20,51,12,14,26,43,34,77,19,3,22,6,28,32,10,17,99,117
2019,2,21901283,8/8/2020,1610612748,Miami Heat,1,0,1610612756,Phoenix Suns,0,1,30,18,48,11,25,36,41,43,84,19,3,22,6,40,28,5,12,101,112
2019,2,21901283,8/8/2020,1610612756,Phoenix Suns,0,1,1610612748,Miami Heat,1,0,32,28,60,12,20,32,44,48,92,19,1,20,13,35,27,6,11,99,119
2019,2,21901261,8/4/2020,1610612745,Houston Rockets,0,0,1610612757,Portland Trail Blazers,1,1,15,19,34,19,34,53,34,53,87,15,9,24,7,50,24,7,10,102,102
2019,2,21901261,8/4/2020,1610612757,Portland Trail Blazers,1,1,1610612745,Houston Rockets,0,0,27,37,64,12,19,31,39,56,95,20,9,29,20,40,18,7,12,102,110
2019,2,21901234,7/31/2020,1610612757,Portland Trail Blazers,1,1,1610612763,Memphis Grizzlies,0,0,36,25,61,13,17,30,49,42,91,29,5,34,11,33,27,9,17,113,140
2019,2,21901234,7/31/2020,1610612763,Memphis Grizzlies,0,0,1610612757,Portland Trail Blazers,1,1,29,23,52,13,28,41,42,51,93,38,12,50,17,36,25,10,13,112,135
2019,2,21900961,3/10/2020,1610612752,New York Knicks,0,0,1610612764,Washington Wizards,1,1,34,26,60,8,13,21,42,39,81,23,8,31,12,31,30,8,19,101,115
2019,2,21900961,3/10/2020,1610612764,Washington Wizards,1,1,1610612752,New York Knicks,0,0,21,18,39,14,21,35,35,39,74,38,7,45,12,29,23,10,19,102,122
2019,2,21900948,3/8/2020,1610612746,LA Clippers,1,0,1610612747,Los Angeles Lakers,0,1,27,28,55,7,24,31,34,52,86,28,9,37,19,37,12,8,16,101,103
2019,2,21900948,3/8/2020,1610612747,Los Angeles Lakers,0,1,1610612746,LA Clippers,1,0,29,23,52,10,25,35,39,48,87,24,4,28,14,37,22,5,14,102,112
2019,2,21900936,3/6/2020,1610612740,New Orleans Pelicans,1,1,1610612748,Miami Heat,0,0,24,29,53,14,24,38,38,53,91,20,8,28,21,36,28,11,17,102,110
2019,2,21900936,3/6/2020,1610612748,Miami Heat,0,0,1610612740,New Orleans Pelicans,1,1,28,25,53,9,24,33,37,49,86,21,10,31,15,40,27,7,16,101,104
2019,2,21900892,2/29/2020,1610612738,Boston Celtics,1,0,1610612745,Houston Rockets,0,1,26,32,58,13,29,42,39,61,100,19,6,25,19,45,22,10,14,107,110
2019,2,21900892,2/29/2020,1610612745,Houston Rockets,0,1,1610612738,Boston Celtics,1,0,26,17,43,15,40,55,41,57,98,14,4,18,16,43,17,11,16,107,111
2019,2,21900874,2/27/2020,1610612754,Indiana Pacers,1,1,1610612757,Portland Trail Blazers,0,0,32,33,65,8,17,25,40,50,90,18,5,23,17,36,21,5,14,99,106
2019,2,21900874,2/27/2020,1610612757,Portland Trail Blazers,0,0,1610612754,Indiana Pacers,1,1,32,27,59,9,21,30,41,48,89,9,5,14,13,36,14,8,14,99,100
2019,2,21900854,2/24/2020,1610612742,Dallas Mavericks,1,1,1610612750,Minnesota Timberwolves,0,0,35,22,57,16,28,44,51,50,101,21,7,28,17,38,28,4,13,110,139
2019,2,21900854,2/24/2020,1610612750,Minnesota Timberwolves,0,0,1610612742,Dallas Mavericks,1,1,27,26,53,15,27,42,42,53,95,24,10,34,11,46,16,7,12,110,123
2019,2,21900832,2/21/2020,1610612759,San Antonio Spurs,0,1,1610612762,Utah Jazz,1,0,30,41,71,10,10,20,40,51,91,23,3,26,9,43,22,4,7,101,113
2019,2,21900832,2/21/2020,1610612762,Utah Jazz,1,0,1610612759,San Antonio Spurs,0,1,23,26,49,12,21,33,35,47,82,22,4,26,9,41,25,12,17,102,104
2019,2,21900811,2/12/2020,1610612752,New York Knicks,1,0,1610612764,Washington Wizards,0,1,33,32,65,3,20,23,36,52,88,21,8,29,18,38,19,13,22,105,96
2019,2,21900811,2/12/2020,1610612764,Washington Wizards,0,1,1610612752,New York Knicks,1,0,30,26,56,10,18,28,40,44,84,24,9,33,7,40,25,10,14,106,114
2019,2,21900793,2/10/2020,1610612765,Detroit Pistons,1,0,1610612766,Charlotte Hornets,0,1,22,25,47,7,28,35,29,53,82,11,2,13,20,33,21,10,21,87,76
2019,2,21900793,2/10/2020,1610612766,Charlotte Hornets,0,1,1610612765,Detroit Pistons,1,0,24,28,52,9,27,36,33,55,88,12,2,14,20,37,19,4,12,87,87
2019,2,21900787,2/9/2020,1610612737,Atlanta Hawks,1,1,1610612752,New York Knicks,0,0,35,33,68,14,26,40,49,59,108,28,3,31,17,44,29,12,15,121,140
2019,2,21900787,2/9/2020,1610612752,New York Knicks,0,0,1610612737,Atlanta Hawks,1,1,39,37,76,13,21,34,52,58,110,18,7,25,21,40,30,9,18,121,135
2020,2,22000077,1/1/2021,1610612746,LA Clippers,0,0,1610612762,Utah Jazz,1,1,20,32,52,13,20,33,33,52,85,21,3,24,16,37,19,3,10,91,100
2020,2,22000077,1/1/2021,1610612762,Utah Jazz,1,1,1610612746,LA Clippers,0,0,26,21,47,15,27,42,41,48,89,9,5,14,19,33,28,6,14,90,106
2017,2,21700063,10/25/2017,1610612761,Toronto Raptors,0,0,1610612744,Golden State Warriors,1,1,35,25,60,8,26,34,43,51,94,18,1,19,20,32,30,10,18,101,112
2018,2,21800049,10/23/2018,1610612755,Philadelphia 76ers,0,0,1610612765,Detroit Pistons,1,1,35,20,55,14,29,43,49,49,98,20,8,28,13,38,32,4,11,110,132
2018,2,21800049,10/23/2018,1610612765,Detroit Pistons,1,1,1610612755,Philadelphia 76ers,0,0,39,36,75,12,21,33,51,57,108,19,8,27,21,41,22,3,8,109,133
2016,2,21600250,11/27/2016,1610612740,New Orleans Pelicans,0,0,1610612742,Dallas Mavericks,1,1,25,32,57,5,15,20,30,47,77,16,2,18,13,35,17,7,13,86,81
2016,2,21600250,11/27/2016,1610612742,Dallas Mavericks,1,1,1610612740,New Orleans Pelicans,0,0,22,28,50,10,17,27,32,45,77,17,3,20,12,34,19,8,12,86,91
2019,2,21900314,12/4/2019,1610612747,Los Angeles Lakers,0,1,1610612762,Utah Jazz,1,0,32,29,61,14,15,29,46,44,90,15,10,25,12,37,27,3,8,98,121
2019,2,21900314,12/4/2019,1610612762,Utah Jazz,1,0,1610612747,Los Angeles Lakers,0,1,20,32,52,14,17,31,34,49,83,14,5,19,14,38,20,13,20,98,96
2019,2,21900086,11/3/2019,1610612745,Houston Rockets,0,0,1610612748,Miami Heat,1,1,17,14,31,14,34,48,31,48,79,24,7,31,7,44,19,14,22,108,100
2019,2,21900086,11/3/2019,1610612748,Miami Heat,1,1,1610612745,Houston Rockets,0,0,29,19,48,18,23,41,47,42,89,17,5,22,10,34,38,6,18,108,129
2018,2,21801207,4/7/2019,1610612740,New Orleans Pelicans,0,1,1610612758,Sacramento Kings,1,0,33,26,59,19,23,42,52,49,101,10,2,12,16,33,28,10,16,107,133
2018,2,21801207,4/7/2019,1610612758,Sacramento Kings,1,0,1610612740,New Orleans Pelicans,0,1,34,35,69,16,24,40,50,59,109,13,4,17,19,42,27,4,6,106,129
2018,2,21800815,2/7/2019,1610612760,Oklahoma City Thunder,1,1,1610612763,Memphis Grizzlies,0,0,26,20,46,17,27,44,43,47,90,14,8,22,12,39,29,9,11,100,117
2018,2,21800815,2/7/2019,1610612763,Memphis Grizzlies,0,0,1610612760,Oklahoma City Thunder,1,1,27,26,53,7,17,24,34,43,77,20,3,23,11,34,19,17,24,101,95
2018,2,21800048,10/22/2018,1610612747,Los Angeles Lakers,1,0,1610612759,San Antonio Spurs,0,1,41,27,68,14,25,39,55,52,107,18,8,26,20,38,33,9,15,114,142
2019,2,21901303,8/11/2020,1610612749,Milwaukee Bucks,0,1,1610612764,Washington Wizards,1,0,26,23,49,18,20,38,44,43,87,20,8,28,12,36,25,2,16,107,126
2019,2,21901303,8/11/2020,1610612764,Washington Wizards,1,0,1610612749,Milwaukee Bucks,0,1,27,33,60,12,23,35,39,56,95,23,7,30,14,45,22,6,10,106,113
2019,2,21901282,8/8/2020,1610612747,Los Angeles Lakers,0,0,1610612754,Indiana Pacers,1,1,29,32,61,13,26,39,42,58,100,14,5,19,23,37,20,12,15,101,111
2019,2,21901282,8/8/2020,1610612754,Indiana Pacers,1,1,1610612747,Los Angeles Lakers,0,0,29,22,51,15,18,33,44,40,84,13,1,14,10,30,25,13,20,102,116
2019,2,21901247,8/2/2020,1610612753,Orlando Magic,1,1,1610612758,Sacramento Kings,0,0,25,19,44,18,20,38,43,39,82,28,7,35,12,31,31,10,18,104,132
2019,2,21901247,8/2/2020,1610612758,Sacramento Kings,0,0,1610612753,Orlando Magic,1,1,37,26,63,8,20,28,45,46,91,18,4,22,12,36,30,10,15,104,116
2019,2,21900922,3/4/2020,1610612741,Chicago Bulls,0,0,1610612750,Minnesota Timberwolves,1,1,34,30,64,11,19,30,45,49,94,7,4,11,12,39,24,5,10,99,108
2019,2,21900922,3/4/2020,1610612750,Minnesota Timberwolves,1,1,1610612741,Chicago Bulls,0,0,21,17,38,19,24,43,40,41,81,16,9,25,13,32,27,10,18,98,115
2019,2,21900908,3/2/2020,1610612754,Indiana Pacers,0,1,1610612759,San Antonio Spurs,1,0,24,23,47,15,16,31,39,39,78,23,3,26,9,32,22,6,13,95,116
2019,2,21900908,3/2/2020,1610612759,San Antonio Spurs,1,0,1610612754,Indiana Pacers,0,1,24,21,45,16,16,32,40,37,77,15,4,19,5,34,21,9,15,96,111
2019,2,21900844,2/23/2020,1610612743,Denver Nuggets,1,1,1610612750,Minnesota Timberwolves,0,0,42,18,60,11,19,30,53,37,90,11,6,17,8,29,29,7,14,105,128
2019,2,21900844,2/23/2020,1610612750,Minnesota Timberwolves,0,0,1610612743,Denver Nuggets,1,1,26,24,50,14,26,40,40,50,90,22,7,29,15,37,26,9,15,104,116
2019,2,21900821,2/20/2020,1610612737,Atlanta Hawks,1,1,1610612748,Miami Heat,0,0,25,25,50,16,19,35,41,44,85,31,4,35,8,39,22,9,16,109,129
2019,2,21900821,2/20/2020,1610612748,Miami Heat,0,0,1610612737,Atlanta Hawks,1,1,29,32,61,11,26,37,40,58,98,33,5,38,21,40,28,8,15,110,124
2019,2,21900801,2/10/2020,1610612747,Los Angeles Lakers,1,1,1610612756,Phoenix Suns,0,0,33,21,54,14,23,37,47,44,91,17,8,25,21,30,28,7,16,101,125
2019,2,21900801,2/10/2020,1610612756,Phoenix Suns,0,0,1610612747,Los Angeles Lakers,1,1,21,24,45,11,20,31,32,44,76,25,6,31,4,44,26,8,13,99,100
2019,2,21900714,1/30/2020,1610612739,Cleveland Cavaliers,1,0,1610612761,Toronto Raptors,0,1,29,25,54,13,23,36,42,48,90,12,2,14,18,32,23,13,23,100,109
2019,2,21900714,1/30/2020,1610612761,Toronto Raptors,0,1,1610612739,Cleveland Cavaliers,1,0,29,23,52,12,20,32,41,43,84,21,7,28,10,37,23,7,14,101,115
2019,2,21900709,1/29/2020,1610612751,Brooklyn Nets,1,1,1610612765,Detroit Pistons,0,0,28,18,46,15,24,39,43,42,85,24,6,30,10,36,26,6,10,101,125
2019,2,21900709,1/29/2020,1610612765,Detroit Pistons,0,0,1610612751,Brooklyn Nets,1,1,32,25,57,10,16,26,42,41,83,21,7,28,12,31,25,8,16,101,115
2019,2,21900696,1/27/2020,1610612750,Minnesota Timberwolves,1,0,1610612758,Sacramento Kings,0,1,20,23,43,23,23,46,43,46,89,20,13,33,18,36,29,6,22,112,129
2019,2,21900696,1/27/2020,1610612758,Sacramento Kings,0,1,1610612750,Minnesota Timberwolves,1,0,26,22,48,18,22,40,44,44,88,27,7,34,10,38,27,7,16,111,133
2020,2,22000076,1/1/2021,1610612743,Denver Nuggets,1,0,1610612756,Phoenix Suns,0,1,27,30,57,12,17,29,39,47,86,13,3,16,14,33,28,1,12,94,103
2020,2,22000076,1/1/2021,1610612756,Phoenix Suns,0,1,1610612743,Denver Nuggets,1,0,24,17,41,13,22,35,37,39,76,19,2,21,11,30,24,7,17,93,106
2018,2,21800048,10/22/2018,1610612759,San Antonio Spurs,0,1,1610612747,Los Angeles Lakers,1,0,35,34,69,15,13,28,50,47,97,28,10,38,12,41,32,5,9,114,143
2016,2,21600731,2/1/2017,1610612739,Cleveland Cavaliers,1,1,1610612750,Minnesota Timberwolves,0,0,33,19,52,15,22,37,48,41,89,14,8,22,15,30,37,7,10,95,125
2016,2,21600731,2/1/2017,1610612750,Minnesota Timberwolves,0,0,1610612739,Cleveland Cavaliers,1,1,34,39,73,7,14,21,41,53,94,8,2,10,17,37,26,10,13,96,97
2019,2,21901260,8/4/2020,1610612738,Boston Celtics,0,0,1610612748,Miami Heat,1,1,27,25,52,10,23,33,37,48,85,22,5,27,19,31,15,8,16,96,106
2019,2,21901260,8/4/2020,1610612748,Miami Heat,1,1,1610612738,Boston Celtics,0,0,19,15,34,15,28,43,34,43,77,29,10,39,14,34,22,7,13,95,112
2019,2,21901233,7/31/2020,1610612751,Brooklyn Nets,1,0,1610612753,Orlando Magic,0,1,31,18,49,13,29,42,44,47,91,17,6,23,11,39,30,8,14,103,118
2019,2,21901233,7/31/2020,1610612753,Orlando Magic,0,1,1610612751,Brooklyn Nets,1,0,35,21,56,11,20,31,46,41,87,25,3,28,10,33,31,4,14,104,128
2018,2,21801059,3/19/2019,1610612755,Philadelphia 76ers,0,1,1610612766,Charlotte Hornets,1,0,32,22,54,11,21,32,43,43,86,21,7,28,8,40,29,3,7,98,118
2018,2,21801059,3/19/2019,1610612766,Charlotte Hornets,1,0,1610612755,Philadelphia 76ers,0,1,27,21,48,9,26,35,36,47,83,33,11,44,15,39,16,5,9,100,114
2019,2,21900947,3/8/2020,1610612740,New Orleans Pelicans,0,1,1610612750,Minnesota Timberwolves,1,0,33,22,55,11,24,35,44,46,90,21,10,31,13,37,28,15,25,115,120
2019,2,21900947,3/8/2020,1610612750,Minnesota Timberwolves,1,0,1610612740,New Orleans Pelicans,0,1,29,32,61,8,25,33,37,57,94,25,6,31,12,47,20,7,17,115,107
2019,2,21900935,3/6/2020,1610612750,Minnesota Timberwolves,1,0,1610612753,Orlando Magic,0,1,36,25,61,10,27,37,46,52,98,16,4,20,15,40,30,5,8,103,118
2019,2,21900935,3/6/2020,1610612753,Orlando Magic,0,1,1610612750,Minnesota Timberwolves,1,0,44,19,63,7,14,21,51,33,84,23,8,31,8,28,31,6,11,101,132
2019,2,21900891,2/29/2020,1610612747,Los Angeles Lakers,0,0,1610612763,Memphis Grizzlies,1,1,27,25,52,9,26,35,36,51,87,7,5,12,15,40,26,10,16,94,88
2019,2,21900891,2/29/2020,1610612763,Memphis Grizzlies,1,1,1610612747,Los Angeles Lakers,0,0,33,31,64,10,21,31,43,52,95,9,2,11,18,34,27,5,10,94,105
2019,2,21900873,2/27/2020,1610612752,New York Knicks,0,0,1610612755,Philadelphia 76ers,1,1,34,26,60,8,15,23,42,41,83,14,10,24,11,35,28,4,7,90,106
2019,2,21900873,2/27/2020,1610612755,Philadelphia 76ers,1,1,1610612752,New York Knicks,0,0,30,30,60,15,16,31,45,46,91,10,3,13,14,32,32,3,7,92,115
2019,2,21900779,2/8/2020,1610612752,New York Knicks,0,1,1610612765,Detroit Pistons,1,0,30,33,63,8,14,22,38,47,85,11,6,17,20,28,24,5,16,88,95
2019,2,21900779,2/8/2020,1610612765,Detroit Pistons,1,0,1610612752,New York Knicks,0,1,21,19,40,13,16,29,34,35,69,11,5,16,5,33,21,5,15,88,92
2019,2,21900760,2/5/2020,1610612739,Cleveland Cavaliers,0,0,1610612760,Oklahoma City Thunder,1,1,26,25,51,15,23,38,41,48,89,6,5,11,14,38,31,9,20,101,103
2019,2,21900760,2/5/2020,1610612760,Oklahoma City Thunder,1,1,1610612739,Cleveland Cavaliers,0,0,29,26,55,9,17,26,38,43,81,24,6,30,8,38,21,4,12,101,109
2019,2,21900752,2/4/2020,1610612745,Houston Rockets,1,1,1610612766,Charlotte Hornets,0,0,23,14,37,20,40,60,43,54,97,19,4,23,11,46,25,2,5,100,125
2019,2,21900752,2/4/2020,1610612766,Charlotte Hornets,0,0,1610612745,Houston Rockets,1,1,26,24,50,13,20,33,39,44,83,19,5,24,12,35,22,11,17,100,110
2019,2,21900738,2/2/2020,1610612740,New Orleans Pelicans,0,0,1610612745,Houston Rockets,1,1,32,29,61,10,23,33,42,52,94,15,5,20,20,33,21,14,23,106,109
2019,2,21900738,2/2/2020,1610612745,Houston Rockets,1,1,1610612740,New Orleans Pelicans,0,0,25,29,54,16,35,51,41,64,105,19,3,22,15,50,22,6,8,107,117
2019,2,21900728,2/1/2020,1610612752,New York Knicks,0,1,1610612754,Indiana Pacers,1,0,27,29,56,7,19,26,34,48,82,17,6,23,17,34,19,4,13,92,92
2019,2,21900728,2/1/2020,1610612754,Indiana Pacers,1,0,1610612752,New York Knicks,0,1,24,28,52,8,16,24,32,44,76,13,8,21,5,44,21,5,11,91,85
2019,2,21900704,1/28/2020,1610612743,Denver Nuggets,0,0,1610612763,Memphis Grizzlies,1,1,15,26,41,17,28,45,32,54,86,15,3,18,16,39,23,12,19,97,96
2019,2,21900704,1/28/2020,1610612763,Memphis Grizzlies,1,1,1610612743,Denver Nuggets,0,0,40,24,64,6,12,18,46,36,82,6,8,14,7,33,32,9,16,98,104
2019,2,21900700,1/28/2020,1610612739,Cleveland Cavaliers,1,0,1610612740,New Orleans Pelicans,0,1,31,32,63,11,23,34,42,55,97,16,2,18,20,37,25,9,14,102,111
2019,2,21900700,1/28/2020,1610612740,New Orleans Pelicans,0,1,1610612739,Cleveland Cavaliers,1,0,34,20,54,13,21,34,47,41,88,18,6,24,13,32,29,7,18,102,125
2019,2,21900690,1/26/2020,1610612756,Phoenix Suns,0,0,1610612763,Memphis Grizzlies,1,1,24,39,63,11,18,29,35,57,92,28,7,35,16,42,23,10,18,111,109
2017,2,21700062,10/25/2017,1610612756,Phoenix Suns,1,1,1610612762,Utah Jazz,0,0,36,41,77,6,13,19,42,54,96,7,2,9,18,37,18,8,16,99,97
2017,2,21700062,10/25/2017,1610612762,Utah Jazz,0,0,1610612756,Phoenix Suns,1,1,26,26,52,6,19,25,32,45,77,18,7,25,11,40,20,8,23,101,88
2018,2,21800047,10/22/2018,1610612744,Golden State Warriors,1,1,1610612756,Phoenix Suns,0,0,31,20,51,14,23,37,45,43,88,19,7,26,10,36,35,8,14,104,123
2018,2,21800047,10/22/2018,1610612756,Phoenix Suns,0,0,1610612744,Golden State Warriors,1,1,30,22,52,9,25,34,39,47,86,16,2,18,13,34,24,12,21,102,103
2016,2,21600249,11/27/2016,1610612746,LA Clippers,0,0,1610612754,Indiana Pacers,1,1,18,28,46,4,20,24,22,48,70,22,5,27,9,41,11,8,20,94,70
2016,2,21600249,11/27/2016,1610612754,Indiana Pacers,1,1,1610612746,LA Clippers,0,0,35,38,73,5,14,19,40,52,92,6,1,7,17,36,26,9,14,94,91
2022,2,22200487,12/23/2022,1610612742,Dallas Mavericks,0,1,1610612745,Houston Rockets,1,0,20,16,36,16,28,44,36,44,80,24,3,27,11,36,20,9,14,97,112
2022,2,22200487,12/23/2022,1610612745,Houston Rockets,1,0,1610612742,Dallas Mavericks,0,1,29,26,55,8,18,26,37,44,81,24,4,28,13,32,26,10,15,96,106
2019,2,21901281,8/8/2020,1610612743,Denver Nuggets,1,1,1610612762,Utah Jazz,0,0,42,29,71,9,28,37,51,57,108,23,7,30,14,46,29,6,11,119,134
2019,2,21901281,8/8/2020,1610612762,Utah Jazz,0,0,1610612743,Denver Nuggets,1,1,25,25,50,22,33,55,47,58,105,16,6,22,19,43,34,10,23,120,132
2019,2,21900960,3/10/2020,1610612738,Boston Celtics,0,1,1610612754,Indiana Pacers,1,0,28,28,56,13,24,37,41,52,93,19,3,22,17,36,19,5,10,97,114
2019,2,21900960,3/10/2020,1610612754,Indiana Pacers,1,0,1610612738,Boston Celtics,0,1,37,32,69,9,15,24,46,47,93,10,1,11,12,36,23,9,12,98,111
2019,2,21900921,3/4/2020,1610612752,New York Knicks,1,0,1610612762,Utah Jazz,0,1,34,31,65,7,13,20,41,44,85,15,3,18,11,35,23,5,13,94,104
2019,2,21900921,3/4/2020,1610612762,Utah Jazz,0,1,1610612752,New York Knicks,1,0,31,14,45,10,26,36,41,40,81,20,5,25,11,31,26,3,14,95,112
2018,2,21800921,2/27/2019,1610612740,New Orleans Pelicans,0,0,1610612747,Los Angeles Lakers,1,1,39,28,67,7,28,35,46,56,102,20,7,27,21,37,31,7,13,106,119
2018,2,21800921,2/27/2019,1610612747,Los Angeles Lakers,1,1,1610612740,New Orleans Pelicans,0,0,41,28,69,8,17,25,49,45,94,19,12,31,12,38,37,6,8,105,125
2018,2,21800647,1/14/2019,1610612759,San Antonio Spurs,1,0,1610612766,Charlotte Hornets,0,1,31,31,62,7,13,20,38,44,82,10,2,12,7,39,21,7,12,92,93
2018,2,21800647,1/14/2019,1610612766,Charlotte Hornets,0,1,1610612759,San Antonio Spurs,1,0,30,26,56,13,23,36,43,49,92,9,2,11,13,37,24,4,8,92,108
2019,2,21900907,3/2/2020,1610612741,Chicago Bulls,1,1,1610612742,Dallas Mavericks,0,0,34,24,58,10,26,36,44,50,94,11,6,17,17,36,24,9,14,97,109
2019,2,21900907,3/2/2020,1610612742,Dallas Mavericks,0,0,1610612741,Chicago Bulls,1,1,28,14,42,12,30,42,40,44,84,15,5,20,15,30,26,7,18,98,107
2019,2,21900820,2/20/2020,1610612749,Milwaukee Bucks,0,1,1610612765,Detroit Pistons,1,0,37,23,60,10,23,33,47,46,93,22,5,27,9,40,24,3,7,102,126
2019,2,21900820,2/20/2020,1610612765,Detroit Pistons,1,0,1610612749,Milwaukee Bucks,0,1,27,19,46,13,24,37,40,43,83,13,3,16,11,33,25,14,23,103,106
2019,2,21900810,2/12/2020,1610612749,Milwaukee Bucks,0,0,1610612754,Indiana Pacers,1,1,24,30,54,13,24,37,37,54,91,24,1,25,17,37,18,10,18,104,111
2019,2,21900810,2/12/2020,1610612754,Indiana Pacers,1,1,1610612749,Milwaukee Bucks,0,0,36,23,59,9,18,27,45,41,86,19,5,24,10,33,28,7,16,105,118
2019,2,21900800,2/10/2020,1610612744,Golden State Warriors,1,0,1610612748,Miami Heat,0,1,19,24,43,11,23,34,30,47,77,30,4,34,9,42,23,10,16,99,101
2019,2,21900800,2/10/2020,1610612748,Miami Heat,0,1,1610612744,Golden State Warriors,1,0,31,23,54,12,21,33,43,44,87,15,6,21,11,37,36,8,12,100,113
2019,2,21900786,2/9/2020,1610612738,Boston Celtics,0,1,1610612760,Oklahoma City Thunder,1,0,22,26,48,16,20,36,38,46,84,20,7,27,14,34,19,3,9,94,112
2019,2,21900786,2/9/2020,1610612760,Oklahoma City Thunder,1,0,1610612738,Boston Celtics,0,1,28,31,59,11,16,27,39,47,86,22,7,29,15,39,14,6,10,95,111
2019,2,21900769,2/7/2020,1610612755,Philadelphia 76ers,1,1,1610612763,Memphis Grizzlies,0,0,34,31,65,14,11,25,48,42,90,9,6,15,14,33,34,13,21,106,119
2019,2,21900769,2/7/2020,1610612763,Memphis Grizzlies,0,0,1610612755,Philadelphia 76ers,1,1,33,39,72,5,16,21,38,55,93,26,5,31,15,42,25,8,14,106,107
2019,2,21900745,2/3/2020,1610612737,Atlanta Hawks,1,0,1610612738,Boston Celtics,0,1,30,24,54,12,18,30,42,42,84,19,2,21,10,33,22,10,17,102,115
2019,2,21900745,2/3/2020,1610612738,Boston Celtics,0,1,1610612737,Atlanta Hawks,1,0,36,25,61,12,17,29,48,42,90,15,2,17,13,31,21,9,15,101,123
2019,2,21900727,2/1/2020,1610612746,LA Clippers,1,1,1610612750,Minnesota Timberwolves,0,0,33,31,64,12,22,34,45,53,98,16,2,18,13,40,20,9,13,106,118
2019,2,21900727,2/1/2020,1610612750,Minnesota Timberwolves,0,0,1610612746,LA Clippers,1,1,27,18,45,7,32,39,34,50,84,31,6,37,11,41,24,8,17,107,106
2019,2,21900690,1/26/2020,1610612763,Memphis Grizzlies,1,1,1610612756,Phoenix Suns,0,0,36,29,65,8,11,19,44,40,84,18,8,26,12,32,25,14,26,112,114
2019,2,21900675,1/24/2020,1610612745,Houston Rockets,0,1,1610612750,Minnesota Timberwolves,1,0,36,23,59,11,21,32,47,44,91,26,5,31,9,38,24,8,11,109,131
2019,2,21900675,1/24/2020,1610612750,Minnesota Timberwolves,1,0,1610612745,Houston Rockets,0,1,37,29,66,11,21,32,48,50,98,17,3,20,15,37,28,11,17,108,124
2020,2,22000075,1/1/2021,1610612747,Los Angeles Lakers,0,1,1610612759,San Antonio Spurs,1,0,27,41,68,14,19,33,41,60,101,13,3,16,23,39,27,3,13,101,109
2020,2,22000075,1/1/2021,1610612759,San Antonio Spurs,1,0,1610612747,Los Angeles Lakers,0,1,23,28,51,13,21,34,36,49,85,18,8,26,10,42,23,8,13,100,103
2017,2,21700061,10/25/2017,1610612742,Dallas Mavericks,1,1,1610612763,Memphis Grizzlies,0,0,25,23,48,11,15,26,36,38,74,20,9,29,7,34,20,7,12,92,103
2017,2,21700061,10/25/2017,1610612763,Memphis Grizzlies,0,0,1610612742,Dallas Mavericks,1,1,21,20,41,12,19,31,33,39,72,16,8,24,9,33,14,6,17,91,94
2014,2,21400968,3/13/2015,1610612755,Philadelphia 76ers,1,1,1610612758,Sacramento Kings,0,0,36,27,63,9,23,32,45,50,95,15,8,23,19,36,30,9,16,104,114
2014,2,21400968,3/13/2015,1610612758,Sacramento Kings,0,0,1610612755,Philadelphia 76ers,1,1,31,42,73,4,10,14,35,52,87,33,7,40,21,34,22,11,18,104,107
2015,2,21501184,4/8/2016,1610612740,New Orleans Pelicans,1,1,1610612747,Los Angeles Lakers,0,0,32,25,57,10,12,22,42,37,79,16,5,21,12,28,29,9,16,95,110
2015,2,21501184,4/8/2016,1610612747,Los Angeles Lakers,0,0,1610612740,New Orleans Pelicans,1,1,23,34,57,11,13,24,34,47,81,23,4,27,12,36,18,5,13,95,102
2019,2,21900313,12/4/2019,1610612742,Dallas Mavericks,1,1,1610612750,Minnesota Timberwolves,0,0,35,20,55,11,26,37,46,46,92,18,5,23,17,32,24,5,9,97,121
2019,2,21900313,12/4/2019,1610612750,Minnesota Timberwolves,0,0,1610612742,Dallas Mavericks,1,1,20,31,51,17,21,38,37,52,89,23,3,26,19,35,23,5,13,96,114
2018,2,21801206,4/7/2019,1610612743,Denver Nuggets,0,0,1610612757,Portland Trail Blazers,1,1,29,33,62,13,20,33,42,53,95,11,9,20,13,45,24,5,11,101,108
2018,2,21801206,4/7/2019,1610612757,Portland Trail Blazers,1,1,1610612743,Denver Nuggets,0,0,32,29,61,9,19,28,41,48,89,24,5,29,17,32,22,9,16,102,115
2018,2,21801058,3/18/2019,1610612754,Indiana Pacers,0,0,1610612757,Portland Trail Blazers,1,1,25,34,59,10,14,24,35,48,83,18,4,22,14,35,25,8,14,94,98
2018,2,21801058,3/18/2019,1610612757,Portland Trail Blazers,1,1,1610612754,Indiana Pacers,0,0,24,23,47,13,19,32,37,42,79,19,2,21,14,29,24,12,18,95,106
2018,2,21800814,2/7/2019,1610612738,Boston Celtics,1,0,1610612747,Los Angeles Lakers,0,1,30,26,56,16,22,38,46,48,94,20,0,20,13,35,35,5,8,98,128
2018,2,21800814,2/7/2019,1610612747,Los Angeles Lakers,0,1,1610612738,Boston Celtics,1,0,28,28,56,22,19,41,50,47,97,7,11,18,13,39,35,7,8,100,129
2018,2,21800570,1/4/2019,1610612751,Brooklyn Nets,0,1,1610612763,Memphis Grizzlies,1,0,23,22,45,13,21,34,36,43,79,24,2,26,10,34,25,9,20,100,109
2018,2,21800570,1/4/2019,1610612763,Memphis Grizzlies,1,0,1610612751,Brooklyn Nets,0,1,37,32,69,5,19,24,42,51,93,11,4,15,12,42,23,6,14,101,100
2018,2,21800244,11/19/2018,1610612742,Dallas Mavericks,0,0,1610612763,Memphis Grizzlies,1,1,20,36,56,10,22,32,30,58,88,18,3,21,16,44,17,8,11,95,88
2018,2,21800244,11/19/2018,1610612763,Memphis Grizzlies,1,1,1610612742,Dallas Mavericks,0,0,25,24,49,12,18,30,37,42,79,12,2,14,6,36,29,8,16,94,98
2017,2,21700060,10/25/2017,1610612754,Indiana Pacers,0,0,1610612760,Oklahoma City Thunder,1,1,18,36,54,10,19,29,28,55,83,30,5,35,19,39,13,8,19,100,96
2017,2,21700060,10/25/2017,1610612760,Oklahoma City Thunder,1,1,1610612754,Indiana Pacers,0,0,33,29,62,10,17,27,43,46,89,18,8,26,20,30,26,13,21,99,114
2015,2,21501056,3/23/2016,1610612737,Atlanta Hawks,0,1,1610612764,Washington Wizards,1,0,28,14,42,17,25,42,45,39,84,15,7,22,10,34,32,7,16,100,122
2015,2,21501056,3/23/2016,1610612764,Washington Wizards,1,0,1610612737,Atlanta Hawks,0,1,27,35,62,12,18,30,39,53,92,11,1,12,17,36,25,10,18,100,101
2018,2,21800046,10/22/2018,1610612757,Portland Trail Blazers,1,0,1610612764,Washington Wizards,0,1,32,37,69,11,28,39,43,65,108,27,4,31,26,42,22,6,20,120,124
2018,2,21800046,10/22/2018,1610612764,Washington Wizards,0,1,1610612757,Portland Trail Blazers,1,0,31,42,73,15,22,37,46,64,110,18,8,26,12,56,23,6,10,118,125
2019,2,21901318,8/14/2020,1610612743,Denver Nuggets,0,0,1610612761,Toronto Raptors,1,1,20,29,49,16,22,38,36,51,87,21,2,23,13,40,27,8,16,99,109
2019,2,21901318,8/14/2020,1610612761,Toronto Raptors,1,1,1610612743,Denver Nuggets,0,0,27,28,55,18,17,35,45,45,90,9,5,14,17,33,27,9,19,99,117
2019,2,21901302,8/11/2020,1610612740,New Orleans Pelicans,0,0,1610612758,Sacramento Kings,1,1,35,23,58,7,17,24,42,40,82,15,4,19,9,33,25,4,19,102,106
2019,2,21901302,8/11/2020,1610612758,Sacramento Kings,1,1,1610612740,New Orleans Pelicans,0,0,32,30,62,11,15,26,43,45,88,15,1,16,16,30,27,8,21,102,112
2019,2,21901280,8/8/2020,1610612746,LA Clippers,0,1,1610612757,Portland Trail Blazers,1,0,27,24,51,15,19,34,42,43,85,23,5,28,13,34,24,5,14,100,122
2014,2,21400967,3/13/2015,1610612741,Chicago Bulls,0,0,1610612766,Charlotte Hornets,1,1,16,34,50,15,17,32,31,51,82,14,5,19,11,42,18,4,11,91,91
2014,2,21400967,3/13/2015,1610612766,Charlotte Hornets,1,1,1610612741,Chicago Bulls,0,0,26,44,70,7,12,19,33,56,89,28,5,33,23,34,15,4,12,92,101
2019,2,21901280,8/8/2020,1610612757,Portland Trail Blazers,1,0,1610612746,LA Clippers,0,1,27,20,47,17,26,43,44,46,90,12,5,17,10,38,24,5,11,100,117
2019,2,21901232,7/30/2020,1610612746,LA Clippers,0,0,1610612747,Los Angeles Lakers,1,1,16,22,38,16,20,36,32,42,74,21,7,28,8,35,17,6,22,101,101
2019,2,21901232,7/30/2020,1610612747,Los Angeles Lakers,1,1,1610612746,LA Clippers,0,0,21,25,46,11,25,36,32,50,82,28,9,37,14,41,21,6,16,101,103
2019,2,21900906,3/2/2020,1610612748,Miami Heat,1,1,1610612749,Milwaukee Bucks,0,0,19,30,49,18,19,37,37,49,86,13,5,18,8,43,28,4,10,98,105
2019,2,21900906,3/2/2020,1610612749,Milwaukee Bucks,0,0,1610612748,Miami Heat,1,1,28,24,52,7,27,34,35,51,86,12,7,19,13,42,19,4,15,97,89
2019,2,21900890,2/29/2020,1610612739,Cleveland Cavaliers,1,0,1610612754,Indiana Pacers,0,1,36,27,63,5,17,22,41,44,85,17,3,20,12,32,30,10,16,98,104
2019,2,21900890,2/29/2020,1610612754,Indiana Pacers,0,1,1610612739,Cleveland Cavaliers,1,0,39,25,64,8,15,23,47,40,87,11,3,14,10,32,30,9,13,98,113
2019,2,21900872,2/26/2020,1610612738,Boston Celtics,0,1,1610612762,Utah Jazz,1,0,34,24,58,11,15,26,45,39,84,13,3,16,12,28,21,5,9,88,114
2019,2,21900872,2/26/2020,1610612762,Utah Jazz,1,0,1610612738,Boston Celtics,0,1,28,21,49,12,28,40,40,49,89,11,4,15,15,37,16,7,10,89,103
2019,2,21900853,2/24/2020,1610612745,Houston Rockets,1,1,1610612752,New York Knicks,0,0,27,11,38,16,32,48,43,43,86,21,10,31,8,39,20,12,13,105,123
2019,2,21900853,2/24/2020,1610612752,New York Knicks,0,0,1610612745,Houston Rockets,1,1,29,33,62,11,18,29,40,51,91,21,9,30,19,37,20,11,17,104,112
2019,2,21900085,11/3/2019,1610612741,Chicago Bulls,0,0,1610612754,Indiana Pacers,1,1,27,28,55,9,20,29,36,48,84,14,11,25,13,41,27,6,18,102,95
2019,2,21900085,11/3/2019,1610612754,Indiana Pacers,1,1,1610612741,Chicago Bulls,0,0,32,27,59,8,18,26,40,45,85,20,7,27,12,37,28,8,18,102,108
2018,2,21801057,3/18/2019,1610612741,Chicago Bulls,0,1,1610612756,Phoenix Suns,1,0,42,31,73,4,12,16,46,43,89,20,4,24,14,30,21,5,13,96,116
2018,2,21801057,3/18/2019,1610612756,Phoenix Suns,1,0,1610612741,Chicago Bulls,0,1,32,26,58,7,19,26,39,45,84,16,10,26,11,40,24,9,12,98,101
2018,2,21800721,1/25/2019,1610612751,Brooklyn Nets,1,1,1610612752,New York Knicks,0,0,25,26,51,9,24,33,34,50,84,32,15,47,27,30,19,12,20,101,109
2018,2,21800721,1/25/2019,1610612752,New York Knicks,0,0,1610612751,Brooklyn Nets,1,1,29,27,56,8,23,31,37,50,87,17,9,26,8,43,17,5,8,100,99
2019,2,21900843,2/23/2020,1610612754,Indiana Pacers,0,0,1610612761,Toronto Raptors,1,1,23,39,62,8,25,33,31,64,95,11,6,17,18,48,23,9,18,102,81
2019,2,21900843,2/23/2020,1610612761,Toronto Raptors,1,1,1610612754,Indiana Pacers,0,0,30,18,48,17,27,44,47,45,92,16,2,18,16,29,32,13,17,102,127
2019,2,21900778,2/8/2020,1610612742,Dallas Mavericks,0,1,1610612766,Charlotte Hornets,1,0,27,25,52,17,18,35,44,43,87,11,0,11,15,28,29,5,12,90,116
2019,2,21900778,2/8/2020,1610612766,Charlotte Hornets,1,0,1610612742,Dallas Mavericks,0,1,27,24,51,11,25,36,38,49,87,13,5,18,16,37,15,5,11,90,100
2019,2,21900751,2/4/2020,1610612740,New Orleans Pelicans,1,0,1610612749,Milwaukee Bucks,0,1,24,26,50,14,35,49,38,61,99,18,6,24,14,48,26,11,17,115,108
2019,2,21900751,2/4/2020,1610612749,Milwaukee Bucks,0,1,1610612740,New Orleans Pelicans,1,0,37,29,66,11,25,36,48,54,102,13,4,17,13,43,34,10,17,114,120
2019,2,21900737,2/2/2020,1610612743,Denver Nuggets,0,0,1610612765,Detroit Pistons,1,1,38,26,64,10,22,32,48,48,96,17,5,22,16,33,30,4,10,101,123
2019,2,21900737,2/2/2020,1610612765,Detroit Pistons,1,1,1610612743,Denver Nuggets,0,0,34,29,63,14,17,31,48,46,94,18,6,24,16,33,33,7,12,102,128
2019,2,21900726,1/31/2020,1610612747,Los Angeles Lakers,1,0,1610612757,Portland Trail Blazers,0,1,34,30,64,11,21,32,45,51,96,18,10,28,20,39,28,10,19,107,119
2019,2,21900726,1/31/2020,1610612757,Portland Trail Blazers,0,1,1610612747,Los Angeles Lakers,1,0,36,25,61,13,23,36,49,48,97,16,5,21,8,43,25,2,7,107,127
2019,2,21900713,1/29/2020,1610612758,Sacramento Kings,1,0,1610612760,Oklahoma City Thunder,0,1,33,19,52,9,30,39,42,49,91,7,4,11,15,37,22,9,14,94,100
2019,2,21900713,1/29/2020,1610612760,Oklahoma City Thunder,0,1,1610612758,Sacramento Kings,1,0,29,25,54,15,19,34,44,44,88,17,3,20,16,29,32,6,13,96,120
2019,2,21900685,1/26/2020,1610612743,Denver Nuggets,1,1,1610612745,Houston Rockets,0,0,33,32,65,11,17,28,44,49,93,18,2,20,16,33,28,6,15,100,117
2019,2,21900685,1/26/2020,1610612745,Houston Rockets,0,0,1610612743,Denver Nuggets,1,1,29,26,55,11,22,33,40,48,88,19,8,27,16,36,19,10,18,101,110
2019,2,21900682,1/25/2020,1610612739,Cleveland Cavaliers,1,0,1610612741,Chicago Bulls,0,1,29,25,54,13,17,30,42,42,84,9,2,11,12,32,30,15,21,101,106
2019,2,21900682,1/25/2020,1610612741,Chicago Bulls,0,1,1610612739,Cleveland Cavaliers,1,0,32,20,52,12,21,33,44,41,85,18,6,24,9,34,24,5,11,101,118
2020,2,22000074,1/1/2021,1610612750,Minnesota Timberwolves,1,0,1610612764,Washington Wizards,0,1,29,23,52,13,23,36,42,46,88,12,9,21,13,38,17,9,20,103,109
2020,2,22000074,1/1/2021,1610612764,Washington Wizards,0,1,1610612750,Minnesota Timberwolves,1,0,33,23,56,16,17,33,49,40,89,16,5,21,10,33,35,9,16,102,130
2017,2,21700059,10/25/2017,1610612748,Miami Heat,1,0,1610612759,San Antonio Spurs,0,1,28,26,54,9,17,26,37,43,80,17,1,18,5,38,19,6,9,91,100
2017,2,21700059,10/25/2017,1610612759,San Antonio Spurs,0,1,1610612748,Miami Heat,1,0,32,27,59,10,7,17,42,34,76,23,7,30,11,28,18,6,13,93,117
2018,2,21800045,10/22/2018,1610612762,Utah Jazz,1,0,1610612763,Memphis Grizzlies,0,1,21,29,50,8,24,32,29,53,82,18,5,23,14,41,18,10,15,94,84
2018,2,21800045,10/22/2018,1610612763,Memphis Grizzlies,0,1,1610612762,Utah Jazz,1,0,22,34,56,9,19,28,31,53,84,21,5,26,13,42,18,6,11,94,92
2019,2,21901279,8/7/2020,1610612738,Boston Celtics,0,1,1610612761,Toronto Raptors,1,0,31,19,50,16,30,46,47,49,96,12,4,16,12,39,27,8,15,103,122
2019,2,21901279,8/7/2020,1610612761,Toronto Raptors,1,0,1610612738,Boston Celtics,0,1,28,23,51,10,28,38,38,51,89,14,3,17,10,44,20,8,18,104,100
2019,2,21900920,3/4/2020,1610612751,Brooklyn Nets,1,0,1610612763,Memphis Grizzlies,0,1,23,25,48,7,35,42,30,60,90,12,5,17,17,45,15,8,14,95,79
2019,2,21900920,3/4/2020,1610612763,Memphis Grizzlies,0,1,1610612751,Brooklyn Nets,1,0,23,33,56,20,24,44,43,57,100,12,2,14,25,32,21,6,12,96,118
2019,2,21900889,2/29/2020,1610612748,Miami Heat,1,1,1610612751,Brooklyn Nets,0,0,27,26,53,14,24,38,41,50,91,20,4,24,12,38,27,3,7,96,116
2019,2,21900889,2/29/2020,1610612751,Brooklyn Nets,0,0,1610612748,Miami Heat,1,1,24,18,42,16,28,44,40,46,86,17,6,23,11,38,30,4,10,95,113
2019,2,21900871,2/26/2020,1610612746,LA Clippers,0,1,1610612756,Phoenix Suns,1,0,23,23,46,14,24,38,37,47,84,14,1,15,13,34,22,8,16,95,102
2019,2,21900871,2/26/2020,1610612756,Phoenix Suns,1,0,1610612746,LA Clippers,0,1,25,28,53,9,25,34,34,53,87,15,3,18,17,37,29,11,16,96,92
2019,2,21900831,2/21/2020,1610612743,Denver Nuggets,0,0,1610612760,Oklahoma City Thunder,1,1,31,19,50,6,21,27,37,40,77,21,2,23,10,31,19,12,19,97,101
2019,2,21900831,2/21/2020,1610612760,Oklahoma City Thunder,1,1,1610612743,Denver Nuggets,0,0,31,30,61,9,17,26,40,47,87,24,3,27,15,34,19,7,12,98,113
2019,2,21900792,2/9/2020,1610612748,Miami Heat,0,0,1610612757,Portland Trail Blazers,1,1,19,30,49,20,29,49,39,59,98,11,3,14,17,43,31,9,13,100,109
2019,2,21900792,2/9/2020,1610612757,Portland Trail Blazers,1,1,1610612748,Miami Heat,0,0,21,22,43,19,23,42,40,45,85,16,6,22,8,38,20,6,14,101,115
2019,2,21900084,11/2/2019,1610612755,Philadelphia 76ers,0,1,1610612757,Portland Trail Blazers,1,0,43,31,74,11,22,33,54,53,107,10,2,12,18,36,36,7,11,106,129
2019,2,21900084,11/2/2019,1610612757,Portland Trail Blazers,1,0,1610612755,Philadelphia 76ers,0,1,26,18,44,19,15,34,45,33,78,19,6,25,4,33,21,11,18,104,128
2018,2,21800920,2/27/2019,1610612749,Milwaukee Bucks,0,1,1610612758,Sacramento Kings,1,0,37,30,67,17,28,45,54,58,112,16,5,21,15,45,36,6,11,119,141
2018,2,21800920,2/27/2019,1610612758,Sacramento Kings,1,0,1610612749,Milwaukee Bucks,0,1,41,44,85,12,21,33,53,65,118,22,8,30,21,48,30,3,8,119,140
2018,2,21800813,2/7/2019,1610612737,Atlanta Hawks,1,0,1610612761,Toronto Raptors,0,1,20,25,45,16,19,35,36,44,80,13,12,25,10,42,25,6,17,98,101
2019,2,21900777,2/8/2020,1610612749,Milwaukee Bucks,0,1,1610612753,Orlando Magic,1,0,27,27,54,15,24,39,42,51,93,12,4,16,14,39,26,10,16,104,111
2019,2,21900777,2/8/2020,1610612753,Orlando Magic,1,0,1610612749,Milwaukee Bucks,0,1,27,31,58,10,30,40,37,61,98,11,3,14,11,53,28,4,9,102,95
2019,2,21900759,2/5/2020,1610612737,Atlanta Hawks,0,1,1610612750,Minnesota Timberwolves,1,0,30,20,50,13,19,32,43,39,82,28,2,30,9,31,23,13,21,109,127
2019,2,21900759,2/5/2020,1610612750,Minnesota Timberwolves,1,0,1610612737,Atlanta Hawks,0,1,36,20,56,9,26,35,45,46,91,21,7,28,11,40,18,7,17,110,120
2019,2,21900725,1/31/2020,1610612756,Phoenix Suns,1,0,1610612760,Oklahoma City Thunder,0,1,27,25,52,9,15,24,36,40,76,26,3,29,13,28,20,13,20,98,107
2019,2,21900725,1/31/2020,1610612760,Oklahoma City Thunder,0,1,1610612756,Phoenix Suns,1,0,35,31,66,7,24,31,42,55,97,20,2,22,24,31,26,6,14,99,111
2019,2,21900708,1/29/2020,1610612741,Chicago Bulls,0,0,1610612754,Indiana Pacers,1,1,39,13,52,6,27,33,45,40,85,10,5,15,8,36,26,8,20,105,106
2019,2,21900708,1/29/2020,1610612754,Indiana Pacers,1,1,1610612741,Chicago Bulls,0,0,39,23,62,7,20,27,46,43,89,16,6,22,15,29,26,10,19,104,115
2019,2,21900695,1/27/2020,1610612741,Chicago Bulls,1,1,1610612759,San Antonio Spurs,0,0,28,28,56,14,23,37,42,51,93,12,3,15,16,37,28,2,12,97,110
2019,2,21900695,1/27/2020,1610612759,San Antonio Spurs,0,0,1610612741,Chicago Bulls,1,1,28,29,57,10,15,25,38,44,82,23,11,34,15,36,21,8,12,97,109
2019,2,21900689,1/26/2020,1610612746,LA Clippers,0,1,1610612753,Orlando Magic,1,0,24,25,49,13,17,30,37,42,79,25,4,29,16,29,20,9,18,96,112
2019,2,21900689,1/26/2020,1610612753,Orlando Magic,1,0,1610612746,LA Clippers,0,1,27,36,63,7,25,32,34,61,95,22,10,32,22,43,27,2,7,95,97
2019,2,21900677,1/24/2020,1610612737,Atlanta Hawks,0,0,1610612760,Oklahoma City Thunder,1,1,31,25,56,11,25,36,42,50,92,16,4,20,12,40,24,6,11,100,111
2019,2,21900677,1/24/2020,1610612760,Oklahoma City Thunder,1,1,1610612737,Atlanta Hawks,0,0,36,25,61,14,11,25,50,36,86,26,8,34,13,27,28,6,14,102,140
2020,2,22000073,1/1/2021,1610612741,Chicago Bulls,0,0,1610612749,Milwaukee Bucks,1,1,32,29,61,6,20,26,38,49,87,14,6,20,9,43,18,16,21,110,96
2020,2,22000073,1/1/2021,1610612749,Milwaukee Bucks,1,1,1610612741,Chicago Bulls,0,0,20,20,40,22,23,45,42,43,85,20,10,30,7,38,27,10,17,110,126
2018,2,21800044,10/22/2018,1610612741,Chicago Bulls,0,0,1610612742,Dallas Mavericks,1,1,28,29,57,13,10,23,41,39,80,14,7,21,10,33,18,8,19,99,109
2018,2,21800044,10/22/2018,1610612742,Dallas Mavericks,1,1,1610612741,Chicago Bulls,0,0,25,21,46,15,32,47,40,53,93,20,1,21,20,33,25,6,16,98,115
2016,2,21600730,2/1/2017,1610612753,Orlando Magic,1,0,1610612754,Indiana Pacers,0,1,25,28,53,6,18,24,31,46,77,20,8,28,14,36,17,5,16,94,88
2016,2,21600730,2/1/2017,1610612754,Indiana Pacers,0,1,1610612753,Orlando Magic,1,0,24,25,49,9,11,20,33,36,69,23,3,26,6,30,25,12,18,94,98
2016,2,21600248,11/27/2016,1610612749,Milwaukee Bucks,0,1,1610612753,Orlando Magic,1,0,33,29,62,8,16,24,41,45,86,14,6,20,11,37,24,6,11,95,104
2016,2,21600248,11/27/2016,1610612753,Orlando Magic,1,0,1610612749,Milwaukee Bucks,0,1,31,33,64,7,21,28,38,54,92,13,4,17,12,45,24,6,8,96,96
2019,2,21901301,8/11/2020,1610612738,Boston Celtics,0,1,1610612763,Memphis Grizzlies,1,0,28,21,49,16,21,37,44,42,86,18,5,23,14,32,29,8,15,96,122
2019,2,21901301,8/11/2020,1610612763,Memphis Grizzlies,1,0,1610612738,Boston Celtics,0,1,28,32,60,7,22,29,35,54,89,30,8,38,17,41,26,7,8,96,107
2019,2,21901278,8/7/2020,1610612740,New Orleans Pelicans,1,1,1610612764,Washington Wizards,0,0,30,23,53,12,23,35,42,46,88,22,4,26,17,33,25,9,20,103,118
2019,2,21901278,8/7/2020,1610612764,Washington Wizards,0,0,1610612740,New Orleans Pelicans,1,1,28,35,63,10,17,27,38,52,90,21,2,23,14,38,22,7,16,102,107
2019,2,21901259,8/4/2020,1610612753,Orlando Magic,0,0,1610612754,Indiana Pacers,1,1,27,21,48,12,22,34,39,43,82,19,4,23,12,33,21,10,18,97,109
2019,2,21901259,8/4/2020,1610612754,Indiana Pacers,1,1,1610612753,Orlando Magic,0,0,33,18,51,13,20,33,46,38,84,15,4,19,5,35,29,3,7,97,120
2019,2,21901246,8/2/2020,1610612759,San Antonio Spurs,0,1,1610612763,Memphis Grizzlies,1,0,24,33,57,12,17,29,36,50,86,24,9,33,15,39,22,5,17,105,108
2019,2,21901246,8/2/2020,1610612763,Memphis Grizzlies,1,0,1610612759,San Antonio Spurs,0,1,35,26,61,7,23,30,42,49,91,15,3,18,7,45,27,5,12,104,106
2019,2,21900959,3/9/2020,1610612761,Toronto Raptors,0,1,1610612762,Utah Jazz,1,0,23,24,47,13,23,36,36,47,83,16,2,18,17,31,22,12,20,95,101
2019,2,21900959,3/9/2020,1610612762,Utah Jazz,1,0,1610612761,Toronto Raptors,0,1,17,23,40,16,27,43,33,50,83,10,4,14,8,43,24,9,11,95,92
2019,2,21900946,3/8/2020,1610612741,Chicago Bulls,0,0,1610612751,Brooklyn Nets,1,1,27,31,58,12,22,34,39,53,92,17,8,25,8,49,23,4,7,104,107
2019,2,21900946,3/8/2020,1610612751,Brooklyn Nets,1,1,1610612741,Chicago Bulls,0,0,21,13,34,11,19,30,32,32,64,35,6,41,9,26,21,14,29,103,110
2019,2,21900934,3/6/2020,1610612741,Chicago Bulls,1,0,1610612754,Indiana Pacers,0,1,31,28,59,9,29,38,40,57,97,13,2,15,22,36,27,9,17,101,102
2019,2,21900934,3/6/2020,1610612754,Indiana Pacers,0,1,1610612741,Chicago Bulls,1,0,30,23,53,8,14,22,38,37,75,24,9,33,13,30,24,12,22,101,108
2019,2,21900905,3/2/2020,1610612737,Atlanta Hawks,1,0,1610612763,Memphis Grizzlies,0,1,23,41,64,9,26,35,32,67,99,15,1,16,19,48,20,12,17,104,88
2019,2,21900312,12/4/2019,1610612754,Indiana Pacers,0,1,1610612760,Oklahoma City Thunder,1,0,33,30,63,9,15,24,42,45,87,14,3,17,16,30,19,3,9,89,107
2019,2,21900312,12/4/2019,1610612760,Oklahoma City Thunder,1,0,1610612754,Indiana Pacers,0,1,32,26,58,9,17,26,41,43,84,9,1,10,13,31,25,5,13,89,100
2019,2,21900905,3/2/2020,1610612763,Memphis Grizzlies,0,1,1610612737,Atlanta Hawks,1,0,32,28,60,14,18,32,46,46,92,21,10,31,18,32,30,6,15,104,127
2019,2,21900888,2/29/2020,1610612737,Atlanta Hawks,1,1,1610612757,Portland Trail Blazers,0,0,28,14,42,18,24,42,46,38,84,19,3,22,8,33,34,9,19,105,129
2019,2,21900888,2/29/2020,1610612757,Portland Trail Blazers,0,0,1610612737,Atlanta Hawks,1,1,39,27,66,8,20,28,47,47,94,15,6,21,16,33,14,7,17,105,117
2019,2,21900870,2/26/2020,1610612745,Houston Rockets,1,1,1610612763,Memphis Grizzlies,0,0,29,14,43,23,27,50,52,41,93,13,2,15,11,31,22,9,19,106,140
2019,2,21900870,2/26/2020,1610612763,Memphis Grizzlies,0,0,1610612745,Houston Rockets,1,1,30,39,69,13,26,39,43,65,108,13,8,21,29,40,28,8,16,105,112
2019,2,21900842,2/23/2020,1610612738,Boston Celtics,0,0,1610612747,Los Angeles Lakers,1,1,25,24,49,13,21,34,38,45,83,23,7,30,12,38,20,9,17,104,112
2019,2,21900842,2/23/2020,1610612747,Los Angeles Lakers,1,1,1610612738,Boston Celtics,0,0,28,24,52,11,23,34,39,47,86,25,12,37,14,38,20,7,13,103,114
2019,2,21900819,2/13/2020,1610612740,New Orleans Pelicans,1,0,1610612760,Oklahoma City Thunder,0,1,28,23,51,14,21,35,42,44,86,20,7,27,11,37,31,11,17,102,118
2019,2,21900819,2/13/2020,1610612760,Oklahoma City Thunder,0,1,1610612740,New Orleans Pelicans,1,0,33,32,65,13,14,27,46,46,92,18,4,22,10,38,28,3,9,103,123
2019,2,21900809,2/12/2020,1610612751,Brooklyn Nets,1,1,1610612761,Toronto Raptors,0,0,27,26,53,9,26,35,36,52,88,20,5,25,17,39,27,6,17,99,101
2019,2,21900809,2/12/2020,1610612761,Toronto Raptors,0,0,1610612751,Brooklyn Nets,1,1,21,26,47,13,30,43,34,56,90,10,3,13,11,46,21,7,13,99,91
2019,2,21900799,2/10/2020,1610612743,Denver Nuggets,1,1,1610612759,San Antonio Spurs,0,0,27,18,45,18,17,35,45,35,80,19,4,23,9,28,34,7,11,94,127
2019,2,21900799,2/10/2020,1610612759,San Antonio Spurs,0,0,1610612743,Denver Nuggets,1,1,25,28,53,16,16,32,41,44,85,22,3,25,14,32,33,7,10,94,120
2020,2,22000072,1/1/2021,1610612737,Atlanta Hawks,0,1,1610612751,Brooklyn Nets,1,0,27,27,54,16,23,39,43,50,93,12,2,14,13,38,24,6,11,98,114
2020,2,22000072,1/1/2021,1610612751,Brooklyn Nets,1,0,1610612737,Atlanta Hawks,0,1,28,21,49,7,30,37,35,51,86,19,4,23,15,38,19,8,15,99,96
2017,2,21700058,10/25/2017,1610612739,Cleveland Cavaliers,0,0,1610612751,Brooklyn Nets,1,1,27,19,46,12,23,35,39,42,81,17,9,26,14,31,21,11,21,102,107
2017,2,21700058,10/25/2017,1610612751,Brooklyn Nets,1,1,1610612739,Cleveland Cavaliers,0,0,23,24,47,17,29,46,40,53,93,15,6,21,15,41,22,5,13,102,112
2018,2,21800043,10/22/2018,1610612750,Minnesota Timberwolves,1,1,1610612754,Indiana Pacers,0,0,29,23,52,7,26,33,36,49,85,22,2,24,15,34,24,6,16,97,101
2018,2,21800043,10/22/2018,1610612754,Indiana Pacers,0,0,1610612750,Minnesota Timberwolves,1,1,28,38,66,8,18,26,36,56,92,11,5,16,17,42,18,9,14,97,91
2014,2,21400966,3/12/2015,1610612747,Los Angeles Lakers,1,0,1610612752,New York Knicks,0,1,33,39,72,5,13,18,38,52,90,13,8,21,20,36,18,5,14,94,94
2014,2,21400966,3/12/2015,1610612752,New York Knicks,0,1,1610612747,Los Angeles Lakers,1,0,27,32,59,9,9,18,36,41,77,20,6,26,5,38,27,6,8,93,101
2018,2,21801205,4/7/2019,1610612744,Golden State Warriors,1,1,1610612746,LA Clippers,0,0,41,19,60,12,25,37,53,44,97,13,2,15,11,35,34,7,11,104,131
2018,2,21801205,4/7/2019,1610612746,LA Clippers,0,0,1610612744,Golden State Warriors,1,1,28,32,60,10,9,19,38,41,79,18,11,29,9,39,26,16,20,106,104
2018,2,21800813,2/7/2019,1610612761,Toronto Raptors,0,1,1610612737,Atlanta Hawks,1,0,27,20,47,13,27,40,40,47,87,26,7,33,14,36,29,5,8,98,119
2018,2,21800646,1/14/2019,1610612745,Houston Rockets,1,1,1610612763,Memphis Grizzlies,0,0,19,17,36,18,30,48,37,47,84,20,2,22,12,35,17,5,14,95,112
2018,2,21800646,1/14/2019,1610612763,Memphis Grizzlies,0,0,1610612745,Houston Rockets,1,1,26,23,49,10,12,22,36,35,71,12,10,22,11,30,31,12,24,95,94
2018,2,21800494,12/23/2018,1610612744,Golden State Warriors,1,1,1610612746,LA Clippers,0,0,28,25,53,14,26,40,42,51,93,31,5,36,16,38,22,1,7,100,129
2018,2,21800494,12/23/2018,1610612746,LA Clippers,0,0,1610612744,Golden State Warriors,1,1,25,32,57,18,5,23,43,37,80,23,6,29,9,31,23,9,17,100,127
2018,2,21800299,11/26/2018,1610612754,Indiana Pacers,0,1,1610612762,Utah Jazz,1,0,40,26,66,9,9,18,49,35,84,14,3,17,8,29,33,10,16,99,121
2018,2,21800299,11/26/2018,1610612762,Utah Jazz,1,0,1610612754,Indiana Pacers,0,1,26,24,50,8,23,31,34,47,81,12,5,17,11,37,25,13,19,98,88
2018,2,21800191,11/12/2018,1610612748,Miami Heat,1,0,1610612755,Philadelphia 76ers,0,1,24,22,46,13,18,31,37,40,77,27,6,33,10,34,19,5,15,98,114
2018,2,21800191,11/12/2018,1610612755,Philadelphia 76ers,0,1,1610612748,Miami Heat,1,0,24,23,47,15,21,36,39,44,83,31,8,39,13,34,24,5,10,99,124
2017,2,21700057,10/25/2017,1610612745,Houston Rockets,0,1,1610612755,Philadelphia 76ers,1,0,24,12,36,12,27,39,36,39,75,21,3,24,8,33,22,14,19,96,105
2017,2,21700057,10/25/2017,1610612755,Philadelphia 76ers,1,0,1610612745,Houston Rockets,0,1,31,30,61,12,24,36,43,54,97,6,4,10,22,34,29,11,16,97,104
2016,2,21600729,1/31/2017,1610612743,Denver Nuggets,0,0,1610612747,Los Angeles Lakers,1,1,26,46,72,15,12,27,41,58,99,19,4,23,24,36,26,7,11,100,116
2016,2,21600729,1/31/2017,1610612747,Los Angeles Lakers,1,1,1610612743,Denver Nuggets,0,0,35,28,63,12,14,26,47,42,89,14,4,18,13,32,25,12,15,99,120
2016,2,21600247,11/27/2016,1610612751,Brooklyn Nets,1,0,1610612758,Sacramento Kings,0,1,22,25,47,16,24,40,38,49,87,13,1,14,12,37,19,11,16,98,105
2016,2,21600247,11/27/2016,1610612758,Sacramento Kings,0,1,1610612751,Brooklyn Nets,1,0,33,30,63,13,10,23,46,40,86,17,5,22,10,33,24,7,15,98,122
2022,2,22200510,12/27/2022,1610612756,Phoenix Suns,0,1,1610612763,Memphis Grizzlies,1,0,26,30,56,17,14,31,43,44,87,22,3,25,19,28,26,9,22,101,125
2022,2,22200510,12/27/2022,1610612763,Memphis Grizzlies,1,0,1610612756,Phoenix Suns,0,1,28,33,61,8,22,30,36,55,91,28,6,34,19,38,18,7,15,102,108
2022,2,22201175,4/2/2023,1610612743,Denver Nuggets,1,1,1610612744,Golden State Warriors,0,0,35,32,67,9,24,33,44,56,100,15,3,18,21,35,24,9,13,102,112
2023,2,22300769,2/12/2024,1610612762,Utah Jazz,1,0,1610612744,Golden State Warriors,0,1,30,30,60,11,21,32,41,51,92,14,2,16,13,39,23,8,18,103,107
2023,2,22300059,11/28/2023,1610612742,Dallas Mavericks,1,1,1610612745,Houston Rockets,0,0,30,25,55,12,22,34,42,47,89,25,4,29,14,35,25,2,7,96,121
2023,2,22300492,1/5/2024,1610612761,Toronto Raptors,0,0,1610612758,Sacramento Kings,1,1,34,16,50,13,24,37,47,40,87,23,4,27,11,31,31,4,13,101,130
2023,2,22300394,12/23/2023,1610612765,Detroit Pistons,0,0,1610612751,Brooklyn Nets,1,1,24,20,44,15,20,35,39,40,79,22,7,29,8,35,26,10,14,97,115
2023,2,22300344,12/17/2023,1610612753,Orlando Magic,0,0,1610612738,Boston Celtics,1,1,23,30,53,11,25,36,34,55,89,18,6,24,12,46,18,4,9,98,97
2023,2,22300458,1/1/2024,1610612746,LA Clippers,1,1,1610612748,Miami Heat,0,0,33,18,51,14,15,29,47,33,80,13,1,14,9,24,25,7,17,95,121
2023,2,22300334,12/16/2023,1610612765,Detroit Pistons,0,0,1610612749,Milwaukee Bucks,1,1,37,31,68,6,22,28,43,53,96,22,4,26,12,44,25,5,8,104,114
2014,2,21400965,3/12/2015,1610612745,Houston Rockets,0,0,1610612762,Utah Jazz,1,1,27,20,47,7,25,32,34,45,79,16,8,24,10,40,19,5,9,89,91
2014,2,21400965,3/12/2015,1610612762,Utah Jazz,1,1,1610612745,Houston Rockets,0,0,33,26,59,11,22,33,44,48,92,10,7,17,24,29,23,8,14,88,109
2017,2,21700056,10/25/2017,1610612750,Minnesota Timberwolves,0,0,1610612765,Detroit Pistons,1,1,28,32,60,9,16,25,37,48,85,18,3,21,11,37,19,7,14,99,101
2017,2,21700056,10/25/2017,1610612765,Detroit Pistons,1,1,1610612750,Minnesota Timberwolves,0,0,33,25,58,15,19,34,48,44,92,11,6,17,14,32,32,5,14,99,122
2018,2,21800042,10/22/2018,1610612749,Milwaukee Bucks,1,1,1610612752,New York Knicks,0,0,28,28,56,17,23,40,45,51,96,17,7,24,21,35,27,6,15,101,124
2018,2,21800042,10/22/2018,1610612752,New York Knicks,0,0,1610612749,Milwaukee Bucks,1,1,35,35,70,10,19,29,45,54,99,13,2,15,18,37,22,5,12,101,113
2017,2,21700055,10/25/2017,1610612743,Denver Nuggets,0,0,1610612766,Charlotte Hornets,1,1,30,39,69,8,23,31,38,62,100,9,6,15,22,44,18,5,14,98,93
2017,2,21700055,10/25/2017,1610612766,Charlotte Hornets,1,1,1610612743,Denver Nuggets,0,0,25,25,50,13,18,31,38,43,81,21,5,26,11,34,17,6,14,97,110
2016,2,21600246,11/27/2016,1610612743,Denver Nuggets,0,1,1610612756,Phoenix Suns,1,0,26,34,60,13,16,29,39,50,89,29,3,32,12,38,21,5,12,104,120
2016,2,21600246,11/27/2016,1610612756,Phoenix Suns,1,0,1610612743,Denver Nuggets,0,1,25,39,64,11,14,25,36,53,89,31,5,36,14,41,11,5,11,105,114
2018,2,21800041,10/22/2018,1610612761,Toronto Raptors,1,1,1610612766,Charlotte Hornets,0,0,35,13,48,15,24,39,50,37,87,12,2,14,10,27,36,5,15,100,127
2018,2,21800041,10/22/2018,1610612766,Charlotte Hornets,0,0,1610612761,Toronto Raptors,1,1,32,37,69,9,19,28,41,56,97,15,3,18,17,41,21,10,12,100,106
2016,2,21600728,1/31/2017,1610612757,Portland Trail Blazers,1,1,1610612766,Charlotte Hornets,0,0,31,31,62,11,20,31,42,51,93,20,3,23,14,39,23,3,8,98,115
2016,2,21600728,1/31/2017,1610612766,Charlotte Hornets,0,0,1610612757,Portland Trail Blazers,1,1,22,30,52,11,20,31,33,50,83,21,4,25,7,44,20,8,10,98,98
2017,2,21700054,10/24/2017,1610612746,LA Clippers,1,1,1610612762,Utah Jazz,0,0,29,25,54,10,19,29,39,44,83,14,7,21,13,36,21,7,13,93,102
2017,2,21700054,10/24/2017,1610612762,Utah Jazz,0,0,1610612746,LA Clippers,1,1,27,24,51,7,21,28,34,45,79,9,2,11,10,36,20,12,18,93,84
2018,2,21800040,10/22/2018,1610612738,Boston Celtics,1,0,1610612753,Orlando Magic,0,1,28,23,51,9,31,40,37,54,91,7,2,9,12,43,21,6,12,95,90
2018,2,21800040,10/22/2018,1610612753,Orlando Magic,0,1,1610612738,Boston Celtics,1,0,28,30,58,10,25,35,38,55,93,7,3,10,13,44,28,6,9,94,93
2016,2,21600245,11/27/2016,1610612739,Cleveland Cavaliers,0,1,1610612755,Philadelphia 76ers,1,0,26,26,52,12,28,40,38,54,92,24,4,28,19,38,19,5,10,97,112
2016,2,21600245,11/27/2016,1610612755,Philadelphia 76ers,1,0,1610612739,Cleveland Cavaliers,0,1,28,30,58,15,19,34,43,49,92,7,3,10,15,36,29,5,16,96,108
2023,2,22300313,12/13/2023,1610612761,Toronto Raptors,1,1,1610612737,Atlanta Hawks,0,0,32,21,53,18,16,34,50,37,87,17,7,24,12,31,39,9,15,100,135
2017,2,21700053,10/24/2017,1610612740,New Orleans Pelicans,0,0,1610612757,Portland Trail Blazers,1,1,21,25,46,9,21,30,30,46,76,24,8,32,5,46,17,7,17,102,93
2017,2,21700053,10/24/2017,1610612757,Portland Trail Blazers,1,1,1610612740,New Orleans Pelicans,0,0,23,36,59,10,19,29,33,55,88,27,6,33,18,40,17,5,18,101,103
2018,2,21800039,10/21/2018,1610612745,Houston Rockets,0,0,1610612746,LA Clippers,1,1,28,26,54,15,20,35,43,46,89,11,4,15,9,39,28,8,12,99,112
2018,2,21800039,10/21/2018,1610612746,LA Clippers,1,1,1610612745,Houston Rockets,0,0,37,27,64,5,20,25,42,47,89,26,0,26,15,32,22,6,13,98,115
2014,2,21400964,3/12/2015,1610612739,Cleveland Cavaliers,0,1,1610612759,San Antonio Spurs,1,0,30,35,65,14,12,26,44,47,91,26,4,30,15,33,19,6,12,102,128
2014,2,21400964,3/12/2015,1610612759,San Antonio Spurs,1,0,1610612739,Cleveland Cavaliers,0,1,41,20,61,8,18,26,49,38,87,19,8,27,12,32,28,8,13,102,125
2017,2,21700052,10/24/2017,1610612750,Minnesota Timberwolves,1,0,1610612754,Indiana Pacers,0,1,33,29,62,9,15,24,42,44,86,14,8,22,11,37,27,8,14,99,107
2017,2,21700052,10/24/2017,1610612754,Indiana Pacers,0,1,1610612750,Minnesota Timberwolves,1,0,46,16,62,10,12,22,56,28,84,8,3,11,9,20,31,9,18,100,130
2018,2,21800038,10/21/2018,1610612743,Denver Nuggets,1,1,1610612744,Golden State Warriors,0,0,29,25,54,6,26,32,35,51,86,24,18,42,18,40,21,4,10,98,100
2018,2,21800038,10/21/2018,1610612744,Golden State Warriors,0,0,1610612743,Denver Nuggets,1,1,29,21,50,7,22,29,36,43,79,19,5,24,10,37,22,11,19,99,98
2016,2,21600727,1/31/2017,1610612759,San Antonio Spurs,1,1,1610612760,Oklahoma City Thunder,0,0,30,35,65,7,14,21,37,49,86,27,11,38,15,42,16,12,17,105,108
2016,2,21600727,1/31/2017,1610612760,Oklahoma City Thunder,0,0,1610612759,San Antonio Spurs,1,1,23,34,57,7,21,28,30,55,85,27,5,32,17,42,21,12,20,105,94
2016,2,21600244,11/26/2016,1610612744,Golden State Warriors,1,1,1610612750,Minnesota Timberwolves,0,0,34,25,59,11,11,22,45,36,81,14,3,17,13,24,25,8,18,94,115
2016,2,21600244,11/26/2016,1610612750,Minnesota Timberwolves,0,0,1610612744,Golden State Warriors,1,1,31,23,54,10,25,35,41,48,89,10,2,12,14,35,22,9,14,94,102
2017,2,21700051,10/24/2017,1610612738,Boston Celtics,1,1,1610612752,New York Knicks,0,0,23,23,46,14,15,29,37,38,75,22,5,27,7,32,26,8,14,94,110
2017,2,21700051,10/24/2017,1610612752,New York Knicks,0,0,1610612738,Boston Celtics,1,1,35,38,73,1,11,12,36,49,85,16,9,25,15,39,20,11,14,94,89
2014,2,21400963,3/12/2015,1610612763,Memphis Grizzlies,0,0,1610612764,Washington Wizards,1,1,28,33,61,3,16,19,31,49,80,22,8,30,19,34,18,12,24,94,87
2014,2,21400963,3/12/2015,1610612764,Washington Wizards,1,1,1610612763,Memphis Grizzlies,0,0,35,28,63,5,12,17,40,40,80,22,9,31,13,31,25,8,13,94,107
2023,2,22300398,12/23/2023,1610612759,San Antonio Spurs,0,0,1610612742,Dallas Mavericks,1,1,30,23,53,14,31,45,44,54,98,17,7,24,12,45,32,7,10,109,119
2023,2,22300245,11/26/2023,1610612749,Milwaukee Bucks,1,1,1610612757,Portland Trail Blazers,0,0,21,26,47,14,28,42,35,54,89,24,8,32,20,37,19,15,17,101,108
2023,2,22300344,12/17/2023,1610612738,Boston Celtics,1,1,1610612753,Orlando Magic,0,0,28,31,59,17,19,36,45,50,95,7,1,8,15,36,18,7,14,98,114
2023,2,22300457,1/1/2024,1610612742,Dallas Mavericks,0,0,1610612762,Utah Jazz,1,1,26,27,53,11,29,40,37,56,93,5,5,10,12,48,28,9,16,102,90
2023,2,22300518,1/10/2024,1610612758,Sacramento Kings,0,1,1610612766,Charlotte Hornets,1,0,33,21,54,13,22,35,46,43,89,18,5,23,17,29,24,2,10,94,123
2023,2,22300550,1/14/2024,1610612754,Indiana Pacers,0,0,1610612743,Denver Nuggets,1,1,35,28,63,8,21,29,43,49,92,15,7,22,15,38,28,8,13,99,109
2023,2,22300633,1/25/2024,1610612747,Los Angeles Lakers,1,1,1610612741,Chicago Bulls,0,0,33,23,56,20,11,31,53,34,87,15,5,20,7,29,35,7,14,102,141
2017,2,21700050,10/24/2017,1610612751,Brooklyn Nets,0,0,1610612753,Orlando Magic,1,1,29,32,61,11,24,35,40,56,96,30,4,34,20,39,21,8,15,105,121
2017,2,21700050,10/24/2017,1610612753,Orlando Magic,1,1,1610612751,Brooklyn Nets,0,0,33,27,60,8,15,23,41,42,83,35,5,40,10,36,20,8,11,104,125
2018,2,21800037,10/21/2018,1610612758,Sacramento Kings,0,1,1610612760,Oklahoma City Thunder,1,0,40,29,69,10,12,22,50,41,91,21,7,28,12,34,28,11,20,110,131
2018,2,21800037,10/21/2018,1610612760,Oklahoma City Thunder,1,0,1610612758,Sacramento Kings,0,1,37,28,65,9,30,39,46,58,104,19,11,30,26,40,23,11,18,108,120
2018,2,21800036,10/21/2018,1610612737,Atlanta Hawks,0,1,1610612739,Cleveland Cavaliers,1,0,26,25,51,22,25,47,48,50,98,13,4,17,14,37,32,5,12,104,131
2018,2,21800036,10/21/2018,1610612739,Cleveland Cavaliers,1,0,1610612737,Atlanta Hawks,0,1,36,36,72,10,17,27,46,53,99,9,5,14,19,36,23,9,18,103,111
2016,2,21600726,1/31/2017,1610612745,Houston Rockets,1,1,1610612758,Sacramento Kings,0,0,24,16,40,14,31,45,38,47,85,15,7,22,13,37,28,9,14,96,105
2016,2,21600726,1/31/2017,1610612758,Sacramento Kings,0,0,1610612745,Houston Rockets,1,1,22,35,57,8,21,29,30,56,86,15,11,26,12,50,22,4,11,97,83
2016,2,21600243,11/26/2016,1610612748,Miami Heat,1,0,1610612763,Memphis Grizzlies,0,1,29,21,50,11,20,31,40,41,81,16,8,24,12,32,18,5,10,91,107
2016,2,21600243,11/26/2016,1610612763,Memphis Grizzlies,0,1,1610612748,Miami Heat,1,0,28,20,48,9,16,25,37,36,73,27,6,33,6,33,23,3,6,91,110
2017,2,21700049,10/24/2017,1610612739,Cleveland Cavaliers,1,1,1610612741,Chicago Bulls,0,0,27,18,45,16,22,38,43,40,83,17,5,22,11,31,28,3,9,92,119
2017,2,21700049,10/24/2017,1610612741,Chicago Bulls,0,0,1610612739,Cleveland Cavaliers,1,1,25,30,55,17,16,33,42,46,88,11,2,13,12,34,28,5,12,93,112
2018,2,21800035,10/20/2018,1610612745,Houston Rockets,0,1,1610612747,Los Angeles Lakers,1,0,28,26,54,16,26,42,44,52,96,20,10,30,17,38,22,8,18,109,124
2018,2,21800035,10/20/2018,1610612747,Los Angeles Lakers,1,0,1610612745,Houston Rockets,0,1,40,28,68,8,24,32,48,52,100,11,7,18,11,44,28,7,11,109,115
2016,2,21600242,11/26/2016,1610612760,Oklahoma City Thunder,1,1,1610612765,Detroit Pistons,0,0,34,26,60,8,15,23,42,41,83,14,12,26,18,30,23,7,11,90,106
2016,2,21600242,11/26/2016,1610612765,Detroit Pistons,0,0,1610612760,Oklahoma City Thunder,1,1,36,27,63,1,18,19,37,45,82,13,4,17,11,36,11,4,9,89,88
2014,2,21400962,3/12/2015,1610612749,Milwaukee Bucks,0,0,1610612754,Indiana Pacers,1,1,31,46,77,4,10,14,35,56,91,29,7,36,15,44,17,7,15,107,103
2014,2,21400962,3/12/2015,1610612754,Indiana Pacers,1,1,1610612749,Milwaukee Bucks,0,0,30,27,57,9,13,22,39,40,79,22,6,28,6,38,24,11,20,105,109
2017,2,21700048,10/23/2017,1610612756,Phoenix Suns,1,1,1610612758,Sacramento Kings,0,0,32,15,47,10,20,30,42,35,77,23,4,27,10,26,20,13,20,101,117
2017,2,21700048,10/23/2017,1610612758,Sacramento Kings,0,0,1610612756,Phoenix Suns,1,1,34,43,77,9,13,22,43,56,99,20,9,29,19,41,19,6,9,102,115
2018,2,21800034,10/20/2018,1610612757,Portland Trail Blazers,1,1,1610612759,San Antonio Spurs,0,0,30,22,52,15,17,32,45,39,84,16,3,19,10,30,24,5,12,94,121
2018,2,21800034,10/20/2018,1610612759,San Antonio Spurs,0,0,1610612757,Portland Trail Blazers,1,1,29,41,70,13,17,30,42,58,100,11,3,14,18,42,29,5,6,95,108
2014,2,21400961,3/11/2015,1610612745,Houston Rockets,0,0,1610612757,Portland Trail Blazers,1,1,27,33,60,11,20,31,38,53,91,13,10,23,14,46,21,5,11,99,100
2014,2,21400961,3/11/2015,1610612757,Portland Trail Blazers,1,1,1610612745,Houston Rockets,0,0,32,27,59,10,23,33,42,50,92,11,3,14,21,30,25,12,20,99,105
2017,2,21700047,10/23/2017,1610612743,Denver Nuggets,1,0,1610612764,Washington Wizards,0,1,31,26,57,8,15,23,39,41,80,18,5,23,13,31,27,13,23,102,104
2017,2,21700047,10/23/2017,1610612764,Washington Wizards,0,1,1610612743,Denver Nuggets,1,0,28,26,54,9,21,30,37,47,84,26,2,28,11,37,24,5,15,102,109
2016,2,21600725,1/31/2017,1610612740,New Orleans Pelicans,0,0,1610612761,Toronto Raptors,1,1,28,36,64,12,18,30,40,54,94,14,5,19,14,42,17,5,13,102,106
2016,2,21600725,1/31/2017,1610612761,Toronto Raptors,1,1,1610612740,New Orleans Pelicans,0,0,33,30,63,10,21,31,43,51,94,12,3,15,16,35,19,11,15,102,108
2023,2,22300059,11/28/2023,1610612745,Houston Rockets,0,0,1610612742,Dallas Mavericks,1,1,34,22,56,8,21,29,42,43,85,23,6,29,15,30,33,5,12,96,115
2023,2,22300177,11/12/2023,1610612766,Charlotte Hornets,0,0,1610612752,New York Knicks,1,1,32,27,59,12,23,35,44,50,94,7,4,11,19,34,21,8,12,93,107
2023,2,22300440,12/30/2023,1610612761,Toronto Raptors,0,0,1610612765,Detroit Pistons,1,1,34,33,67,12,12,24,46,45,91,23,5,28,10,36,26,4,8,103,127
2023,2,22300399,12/23/2023,1610612744,Golden State Warriors,1,1,1610612757,Portland Trail Blazers,0,0,38,12,50,10,23,33,48,35,83,20,4,24,14,24,38,13,18,97,126
2023,2,22300632,1/25/2024,1610612758,Sacramento Kings,0,1,1610612744,Golden State Warriors,1,0,26,17,43,22,26,48,48,43,91,16,3,19,15,29,33,7,10,97,134
2017,2,21700046,10/23/2017,1610612759,San Antonio Spurs,1,1,1610612761,Toronto Raptors,0,0,35,35,70,5,15,20,40,50,90,16,7,23,22,31,19,11,20,98,101
2017,2,21700046,10/23/2017,1610612761,Toronto Raptors,0,0,1610612759,San Antonio Spurs,1,1,24,19,43,10,27,37,34,46,80,19,5,24,8,41,17,4,15,98,97
2018,2,21800033,10/20/2018,1610612743,Denver Nuggets,1,1,1610612756,Phoenix Suns,0,0,34,23,57,9,19,28,43,42,85,24,5,29,12,33,28,6,18,104,119
2018,2,21800033,10/20/2018,1610612756,Phoenix Suns,0,0,1610612743,Denver Nuggets,1,1,18,20,38,11,28,39,29,48,77,22,13,35,10,47,20,12,19,104,91
2016,2,21600241,11/26/2016,1610612752,New York Knicks,0,0,1610612766,Charlotte Hornets,1,1,25,42,67,12,20,32,37,62,99,16,4,20,17,47,26,3,8,99,102
2016,2,21600241,11/26/2016,1610612766,Charlotte Hornets,1,1,1610612752,New York Knicks,0,0,27,31,58,8,14,22,35,45,80,29,13,42,11,37,16,9,10,101,107
2014,2,21400960,3/11/2015,1610612744,Golden State Warriors,1,1,1610612765,Detroit Pistons,0,0,37,27,64,7,13,20,44,40,84,10,3,13,11,32,29,6,17,95,105
2014,2,21400960,3/11/2015,1610612765,Detroit Pistons,0,0,1610612744,Golden State Warriors,1,1,38,48,86,4,8,12,42,56,98,10,2,12,23,34,18,5,15,96,98
2017,2,21700045,10/23/2017,1610612742,Dallas Mavericks,1,0,1610612744,Golden State Warriors,0,1,29,38,67,9,20,29,38,58,96,18,12,30,21,44,21,6,12,104,103
2017,2,21700045,10/23/2017,1610612744,Golden State Warriors,0,1,1610612742,Dallas Mavericks,1,0,33,14,47,15,24,39,48,38,86,22,4,26,11,29,33,11,16,102,133
2018,2,21800032,10/20/2018,1610612742,Dallas Mavericks,1,1,1610612750,Minnesota Timberwolves,0,0,32,16,48,17,33,50,49,49,98,25,9,34,20,33,29,10,16,109,140
2018,2,21800032,10/20/2018,1610612750,Minnesota Timberwolves,0,0,1610612742,Dallas Mavericks,1,1,30,27,57,14,13,27,44,40,84,34,6,40,11,31,23,8,17,109,136
2018,2,21800031,10/20/2018,1610612741,Chicago Bulls,1,0,1610612765,Detroit Pistons,0,1,37,29,66,7,14,21,44,43,87,21,5,26,11,35,26,4,11,98,116
2018,2,21800031,10/20/2018,1610612765,Detroit Pistons,0,1,1610612741,Chicago Bulls,1,0,23,38,61,18,22,40,41,60,101,18,5,23,24,39,21,4,10,100,118
2016,2,21600724,1/31/2017,1610612752,New York Knicks,0,0,1610612764,Washington Wizards,1,1,29,40,69,5,19,24,34,59,93,28,7,35,23,39,18,4,12,97,101
2016,2,21600724,1/31/2017,1610612764,Washington Wizards,1,1,1610612752,New York Knicks,0,0,42,24,66,7,15,22,49,39,88,12,3,15,10,30,27,8,12,98,117
2014,2,21400959,3/11/2015,1610612750,Minnesota Timberwolves,0,0,1610612756,Phoenix Suns,1,1,35,33,68,1,12,13,36,45,81,24,2,26,12,33,19,7,10,92,97
2014,2,21400959,3/11/2015,1610612756,Phoenix Suns,1,1,1610612750,Minnesota Timberwolves,0,0,39,27,66,6,18,24,45,45,90,10,3,13,22,24,25,5,17,92,106
2023,2,22300245,11/26/2023,1610612757,Portland Trail Blazers,0,0,1610612749,Milwaukee Bucks,1,1,24,35,59,13,19,32,37,54,91,15,5,20,20,37,21,13,20,102,102
2017,2,21700044,10/23/2017,1610612749,Milwaukee Bucks,1,1,1610612766,Charlotte Hornets,0,0,31,28,59,9,17,26,40,45,85,14,2,16,7,39,24,3,13,97,103
2017,2,21700044,10/23/2017,1610612766,Charlotte Hornets,0,0,1610612749,Milwaukee Bucks,1,1,26,26,52,7,19,26,33,45,78,21,15,36,14,39,17,8,14,97,94
2018,2,21800030,10/20/2018,1610612748,Miami Heat,1,0,1610612766,Charlotte Hornets,0,1,30,25,55,11,23,34,41,48,89,19,8,27,20,30,21,6,16,98,112
2018,2,21800030,10/20/2018,1610612766,Charlotte Hornets,0,1,1610612748,Miami Heat,1,0,25,26,51,16,26,42,41,52,93,15,8,23,16,41,23,4,12,99,113
2014,2,21400958,3/11/2015,1610612737,Atlanta Hawks,0,0,1610612743,Denver Nuggets,1,1,25,29,54,9,18,27,34,47,81,25,2,27,13,35,18,8,18,101,102
2014,2,21400958,3/11/2015,1610612743,Denver Nuggets,1,1,1610612737,Atlanta Hawks,0,0,29,24,53,13,18,31,42,42,84,18,2,20,13,29,28,11,19,100,115
2017,2,21700043,10/23/2017,1610612745,Houston Rockets,1,0,1610612763,Memphis Grizzlies,0,1,23,16,39,9,29,38,32,45,77,17,6,23,12,38,25,5,17,92,90
2017,2,21700043,10/23/2017,1610612763,Memphis Grizzlies,0,1,1610612745,Houston Rockets,1,0,23,26,49,6,13,19,29,39,68,34,3,37,7,33,16,5,12,91,98
2016,2,21600240,11/26/2016,1610612759,San Antonio Spurs,0,1,1610612764,Washington Wizards,1,0,31,20,51,9,15,24,40,35,75,23,6,29,8,30,22,11,14,94,112
2016,2,21600240,11/26/2016,1610612764,Washington Wizards,1,0,1610612759,San Antonio Spurs,0,1,36,30,66,6,16,22,42,46,88,10,4,14,14,35,21,7,14,94,100
2023,2,22301230,12/7/2023,1610612747,Los Angeles Lakers,1,1,1610612740,New Orleans Pelicans,0,0,30,21,51,17,18,35,47,39,86,22,7,29,13,31,31,7,15,102,133
2023,2,22300399,12/23/2023,1610612757,Portland Trail Blazers,0,0,1610612744,Golden State Warriors,1,1,25,24,49,13,22,35,38,46,84,17,8,25,10,39,26,8,12,99,106
2017,2,21700042,10/23/2017,1610612737,Atlanta Hawks,0,0,1610612748,Miami Heat,1,1,29,30,59,7,10,17,36,40,76,14,4,18,9,34,14,12,21,101,93
2017,2,21700042,10/23/2017,1610612748,Miami Heat,1,1,1610612737,Atlanta Hawks,0,0,25,23,48,14,23,37,39,46,85,12,6,18,12,35,21,9,19,100,104
2018,2,21800029,10/20/2018,1610612753,Orlando Magic,0,0,1610612755,Philadelphia 76ers,1,1,25,36,61,16,13,29,41,49,90,17,5,22,19,33,31,8,16,97,115
2018,2,21800029,10/20/2018,1610612755,Philadelphia 76ers,1,1,1610612753,Orlando Magic,0,0,28,33,61,17,16,33,45,49,94,9,1,10,13,37,33,7,10,95,116
2016,2,21600239,11/25/2016,1610612745,Houston Rockets,0,1,1610612758,Sacramento Kings,1,0,19,16,35,21,29,50,40,45,85,16,4,20,14,34,27,7,16,98,117
2016,2,21600239,11/25/2016,1610612758,Sacramento Kings,1,0,1610612745,Houston Rockets,0,1,30,18,48,9,23,32,39,41,80,17,4,21,7,36,24,8,14,98,104
2014,2,21400957,3/11/2015,1610612746,LA Clippers,0,1,1610612760,Oklahoma City Thunder,1,0,20,26,46,15,15,30,35,41,76,35,12,47,14,32,22,5,14,98,120
2014,2,21400957,3/11/2015,1610612760,Oklahoma City Thunder,1,0,1610612746,LA Clippers,0,1,21,30,51,12,13,25,33,43,76,30,6,36,14,32,19,11,20,99,108
2015,2,21500891,3/1/2016,1610612756,Phoenix Suns,0,0,1610612766,Charlotte Hornets,1,1,27,37,64,6,21,27,33,58,91,20,7,27,18,44,14,8,12,99,92
2015,2,21500891,3/1/2016,1610612766,Charlotte Hornets,1,1,1610612756,Phoenix Suns,0,0,32,34,66,13,14,27,45,48,93,23,4,27,18,31,27,5,13,99,126
2015,2,21500827,2/21/2016,1610612751,Brooklyn Nets,1,0,1610612766,Charlotte Hornets,0,1,30,29,59,5,17,22,35,46,81,21,3,24,11,36,23,7,14,94,96
2015,2,21500827,2/21/2016,1610612766,Charlotte Hornets,0,1,1610612751,Brooklyn Nets,1,0,30,22,52,10,17,27,40,39,79,14,1,15,7,33,23,8,15,95,104
2015,2,21500494,1/1/2016,1610612747,Los Angeles Lakers,1,1,1610612755,Philadelphia 76ers,0,0,28,43,71,5,11,16,33,54,87,22,7,29,16,41,17,6,12,96,93
2015,2,21500494,1/1/2016,1610612755,Philadelphia 76ers,0,0,1610612747,Los Angeles Lakers,1,1,27,33,60,4,20,24,31,53,84,18,7,25,17,41,21,11,16,97,84
2015,2,21500392,12/18/2015,1610612750,Minnesota Timberwolves,1,1,1610612758,Sacramento Kings,0,0,33,31,64,6,12,18,39,43,82,15,1,16,17,27,25,10,18,91,99
2015,2,21500392,12/18/2015,1610612758,Sacramento Kings,0,0,1610612750,Minnesota Timberwolves,1,1,31,27,58,7,16,23,38,43,81,12,5,17,10,37,22,2,13,92,95
2016,2,21600723,1/30/2017,1610612756,Phoenix Suns,1,0,1610612763,Memphis Grizzlies,0,1,26,29,55,5,14,19,31,43,74,29,10,39,14,35,11,13,17,95,96
2016,2,21600723,1/30/2017,1610612763,Memphis Grizzlies,0,1,1610612756,Phoenix Suns,1,0,23,29,52,16,12,28,39,41,80,21,3,24,13,29,25,8,18,96,115
2014,2,21400956,3/11/2015,1610612749,Milwaukee Bucks,1,1,1610612753,Orlando Magic,0,0,31,30,61,8,10,18,39,40,79,11,5,16,16,26,30,14,23,96,97
2014,2,21400956,3/11/2015,1610612753,Orlando Magic,0,0,1610612749,Milwaukee Bucks,1,1,24,43,67,10,8,18,34,51,85,13,0,13,9,42,21,7,14,96,91
2015,2,21500951,3/9/2016,1610612745,Houston Rockets,0,1,1610612755,Philadelphia 76ers,1,0,27,26,53,11,22,33,38,48,86,31,10,41,23,31,22,8,13,96,118
2015,2,21500951,3/9/2016,1610612755,Philadelphia 76ers,1,0,1610612745,Houston Rockets,0,1,23,30,53,12,21,33,35,51,86,22,10,32,24,29,23,14,19,96,104
2023,2,22300241,11/25/2023,1610612764,Washington Wizards,1,0,1610612737,Atlanta Hawks,0,1,33,17,50,10,28,38,43,45,88,12,0,12,11,34,33,13,20,103,108
2017,2,21700041,10/23/2017,1610612755,Philadelphia 76ers,0,1,1610612765,Detroit Pistons,1,0,26,25,51,9,15,24,35,40,75,18,6,24,11,32,25,5,21,96,97
2017,2,21700041,10/23/2017,1610612765,Detroit Pistons,1,0,1610612755,Philadelphia 76ers,0,1,27,28,55,6,24,30,33,52,85,14,5,19,13,41,14,11,14,97,86
2018,2,21800028,10/20/2018,1610612738,Boston Celtics,0,1,1610612752,New York Knicks,1,0,24,33,57,9,16,25,33,49,82,28,5,33,12,38,21,8,15,101,103
2018,2,21800028,10/20/2018,1610612752,New York Knicks,1,0,1610612738,Boston Celtics,0,1,24,28,52,12,23,35,36,51,87,17,10,27,14,39,23,8,16,103,101
2016,2,21600722,1/30/2017,1610612739,Cleveland Cavaliers,0,0,1610612742,Dallas Mavericks,1,1,23,20,43,12,20,32,35,40,75,15,6,21,9,35,17,11,17,94,97
2016,2,21600722,1/30/2017,1610612742,Dallas Mavericks,1,1,1610612739,Cleveland Cavaliers,0,0,30,24,54,9,23,32,39,47,86,17,1,18,11,37,19,6,9,92,104
2014,2,21400955,3/11/2015,1610612748,Miami Heat,1,1,1610612751,Brooklyn Nets,0,0,31,29,60,6,15,21,37,44,81,24,14,38,15,33,23,8,11,95,104
2014,2,21400955,3/11/2015,1610612751,Brooklyn Nets,0,0,1610612748,Miami Heat,1,1,26,30,56,6,11,17,32,41,73,28,11,39,18,30,15,14,21,96,98
2017,2,21700040,10/22/2017,1610612740,New Orleans Pelicans,0,1,1610612747,Los Angeles Lakers,1,0,37,14,51,10,22,32,47,36,83,15,6,21,7,30,26,7,17,102,119
2017,2,21700040,10/22/2017,1610612747,Los Angeles Lakers,1,0,1610612740,New Orleans Pelicans,0,1,35,28,63,9,18,27,44,46,90,15,5,20,11,40,27,14,18,104,112
2018,2,21800027,10/20/2018,1610612761,Toronto Raptors,0,1,1610612764,Washington Wizards,1,0,29,30,59,10,19,29,39,49,88,29,7,36,20,33,21,11,17,101,117
2018,2,21800027,10/20/2018,1610612764,Washington Wizards,1,0,1610612761,Toronto Raptors,0,1,24,26,50,13,26,39,37,52,89,26,6,32,13,42,20,5,11,102,113
2023,2,22300392,12/23/2023,1610612740,New Orleans Pelicans,1,0,1610612745,Houston Rockets,0,1,30,21,51,8,23,31,38,44,82,20,9,29,17,32,21,9,16,94,104
2023,2,22300550,1/14/2024,1610612743,Denver Nuggets,1,1,1610612754,Indiana Pacers,0,0,36,15,51,10,10,20,46,25,71,15,8,23,5,23,31,11,22,99,117
2023,2,22300440,12/30/2023,1610612765,Detroit Pistons,1,1,1610612761,Toronto Raptors,0,0,29,25,54,12,16,28,41,41,82,35,5,40,12,32,29,9,12,102,129
2023,2,22300443,12/30/2023,1610612747,Los Angeles Lakers,0,0,1610612750,Minnesota Timberwolves,1,1,30,34,64,7,17,24,37,51,88,25,7,32,13,41,23,8,10,99,106
2017,2,21700039,10/22/2017,1610612750,Minnesota Timberwolves,0,1,1610612760,Oklahoma City Thunder,1,0,33,28,61,10,15,25,43,43,86,19,4,23,16,28,25,9,18,100,115
2017,2,21700039,10/22/2017,1610612760,Oklahoma City Thunder,1,0,1610612750,Minnesota Timberwolves,0,1,35,30,65,11,20,31,46,50,96,10,6,16,14,39,26,5,11,100,113
2018,2,21800026,10/20/2018,1610612751,Brooklyn Nets,0,0,1610612754,Indiana Pacers,1,1,25,24,49,16,21,37,41,45,86,14,8,22,16,32,25,12,20,100,112
2018,2,21800026,10/20/2018,1610612754,Indiana Pacers,1,1,1610612751,Brooklyn Nets,0,0,35,33,68,16,8,24,51,41,92,14,8,22,13,31,21,6,11,100,132
2016,2,21600721,1/30/2017,1610612738,Boston Celtics,1,1,1610612765,Detroit Pistons,0,0,23,27,50,13,19,32,36,46,82,28,5,33,8,41,23,6,10,100,113
2016,2,21600721,1/30/2017,1610612765,Detroit Pistons,0,0,1610612738,Boston Celtics,1,1,40,30,70,3,24,27,43,54,97,20,9,29,17,42,18,6,7,101,109
2016,2,21600238,11/25/2016,1610612744,Golden State Warriors,0,1,1610612747,Los Angeles Lakers,1,0,32,23,55,11,17,28,43,40,83,12,5,17,8,34,31,12,18,100,109
2016,2,21600238,11/25/2016,1610612747,Los Angeles Lakers,1,0,1610612744,Golden State Warriors,0,1,27,41,68,5,17,22,32,58,90,16,7,23,19,42,20,10,18,101,85
2014,2,21400954,3/11/2015,1610612738,Boston Celtics,1,1,1610612763,Memphis Grizzlies,0,0,29,29,58,8,19,27,37,48,85,13,4,17,16,35,28,11,17,93,95
2014,2,21400954,3/11/2015,1610612763,Memphis Grizzlies,0,0,1610612738,Boston Celtics,1,1,32,34,66,5,7,12,37,41,78,13,0,13,12,29,21,11,21,93,92
2017,2,21700038,10/22/2017,1610612737,Atlanta Hawks,0,0,1610612751,Brooklyn Nets,1,1,25,42,67,7,20,27,32,62,94,33,3,36,22,42,21,12,16,104,104
2017,2,21700038,10/22/2017,1610612751,Brooklyn Nets,1,1,1610612737,Atlanta Hawks,0,0,30,30,60,11,16,27,41,46,87,23,11,34,17,35,27,6,18,104,116
2018,2,21800025,10/19/2018,1610612746,LA Clippers,1,1,1610612760,Oklahoma City Thunder,0,0,24,31,55,11,15,26,35,46,81,27,9,36,13,37,21,5,15,100,108
2018,2,21800025,10/19/2018,1610612760,Oklahoma City Thunder,0,0,1610612746,LA Clippers,1,1,27,35,62,7,26,33,34,61,95,17,6,23,20,42,18,3,13,100,92
2014,2,21400953,3/11/2015,1610612741,Chicago Bulls,0,1,1610612755,Philadelphia 76ers,1,0,30,33,63,10,14,24,40,47,87,14,6,20,10,39,24,12,18,106,104
2014,2,21400953,3/11/2015,1610612755,Philadelphia 76ers,1,0,1610612741,Chicago Bulls,0,1,25,38,63,11,30,41,36,68,104,12,13,25,22,54,16,6,10,106,95
2023,2,22300390,12/23/2023,1610612766,Charlotte Hornets,1,0,1610612743,Denver Nuggets,0,1,26,34,60,8,20,28,34,54,88,19,4,23,20,37,23,11,18,97,95
2017,2,21700037,10/21/2017,1610612746,LA Clippers,1,1,1610612756,Phoenix Suns,0,0,36,26,62,12,14,26,48,40,88,22,8,30,12,33,26,8,12,102,130
2017,2,21700037,10/21/2017,1610612756,Phoenix Suns,0,0,1610612746,LA Clippers,1,1,21,26,47,6,18,24,27,44,71,28,10,38,6,42,19,12,20,103,88
2016,2,21600237,11/25/2016,1610612740,New Orleans Pelicans,0,0,1610612757,Portland Trail Blazers,1,1,23,30,53,13,10,23,36,40,76,19,10,29,3,40,20,7,14,101,104
2016,2,21600237,11/25/2016,1610612757,Portland Trail Blazers,1,1,1610612740,New Orleans Pelicans,0,0,35,33,68,12,20,32,47,53,100,13,4,17,18,38,30,3,11,101,119
2014,2,21400952,3/11/2015,1610612758,Sacramento Kings,0,1,1610612766,Charlotte Hornets,1,0,32,33,65,8,12,20,40,45,85,25,5,30,12,35,25,5,13,99,113
2014,2,21400952,3/11/2015,1610612766,Charlotte Hornets,1,0,1610612758,Sacramento Kings,0,1,36,39,75,6,12,18,42,51,93,16,10,26,17,38,28,4,11,100,106
2017,2,21700036,10/21/2017,1610612760,Oklahoma City Thunder,0,0,1610612762,Utah Jazz,1,1,21,24,45,11,22,33,32,46,78,12,7,19,13,35,15,11,17,93,87
2017,2,21700036,10/21/2017,1610612762,Utah Jazz,1,1,1610612760,Oklahoma City Thunder,0,0,29,19,48,9,20,29,38,39,77,11,3,14,9,32,22,14,19,92,96
2018,2,21800024,10/19/2018,1610612744,Golden State Warriors,0,1,1610612762,Utah Jazz,1,0,39,29,68,10,9,19,49,38,87,16,2,18,9,30,27,11,16,102,124
2018,2,21800024,10/19/2018,1610612762,Utah Jazz,1,0,1610612744,Golden State Warriors,0,1,21,22,43,19,27,46,40,49,89,24,5,29,16,36,24,10,17,104,123
2016,2,21600720,1/30/2017,1610612750,Minnesota Timberwolves,1,1,1610612753,Orlando Magic,0,0,28,34,62,12,17,29,40,51,91,19,7,26,13,39,29,7,12,102,111
2016,2,21600720,1/30/2017,1610612753,Orlando Magic,0,0,1610612750,Minnesota Timberwolves,1,1,31,30,61,10,25,35,41,55,96,13,6,19,14,46,22,3,11,102,105
2014,2,21400951,3/10/2015,1610612747,Los Angeles Lakers,1,1,1610612765,Detroit Pistons,0,0,29,33,62,3,10,13,32,43,75,26,4,30,11,35,23,10,12,91,93
2014,2,21400951,3/10/2015,1610612765,Detroit Pistons,0,0,1610612747,Los Angeles Lakers,1,1,24,25,49,8,27,35,32,52,84,13,6,19,15,39,20,8,14,93,85
2018,2,21800023,10/19/2018,1610612749,Milwaukee Bucks,1,1,1610612754,Indiana Pacers,0,0,27,20,47,17,29,46,44,49,93,13,8,21,17,35,27,7,17,103,118
2018,2,21800023,10/19/2018,1610612754,Indiana Pacers,0,0,1610612749,Milwaukee Bucks,1,1,32,37,69,6,12,18,38,49,87,19,8,27,13,39,14,9,17,102,101
2016,2,21600236,11/25/2016,1610612750,Minnesota Timberwolves,0,1,1610612756,Phoenix Suns,1,0,27,36,63,7,15,22,34,51,85,23,2,25,14,38,16,11,17,99,98
2016,2,21600236,11/25/2016,1610612756,Phoenix Suns,1,0,1610612750,Minnesota Timberwolves,0,1,26,27,53,6,20,26,32,47,79,15,6,21,17,34,17,15,26,99,85
2017,2,21700035,10/21/2017,1610612743,Denver Nuggets,1,1,1610612758,Sacramento Kings,0,0,27,28,55,10,20,30,37,48,85,12,8,20,20,31,25,6,16,91,96
2017,2,21700035,10/21/2017,1610612758,Sacramento Kings,0,0,1610612743,Denver Nuggets,1,1,23,40,63,8,14,22,31,54,85,9,4,13,14,42,15,7,14,90,79
2018,2,21800022,10/19/2018,1610612740,New Orleans Pelicans,1,1,1610612758,Sacramento Kings,0,0,40,24,64,16,15,31,56,39,95,21,12,33,14,32,35,6,16,112,149
2018,2,21800022,10/19/2018,1610612758,Sacramento Kings,0,0,1610612740,New Orleans Pelicans,1,1,40,31,71,10,15,25,50,46,96,19,7,26,9,41,24,6,13,112,129
2014,2,21400950,3/10/2015,1610612752,New York Knicks,0,0,1610612762,Utah Jazz,1,1,26,40,66,5,8,13,31,48,79,15,2,17,12,37,17,8,14,88,82
2014,2,21400950,3/10/2015,1610612762,Utah Jazz,1,1,1610612752,New York Knicks,0,0,24,28,52,6,12,18,30,40,70,21,8,29,9,35,16,5,13,88,87
2023,2,22300156,11/6/2023,1610612740,New Orleans Pelicans,0,0,1610612743,Denver Nuggets,1,1,32,28,60,13,17,30,45,45,90,13,2,15,11,35,24,6,13,99,116
2023,2,22300442,12/30/2023,1610612755,Philadelphia 76ers,0,0,1610612741,Chicago Bulls,1,1,27,27,54,9,29,38,36,56,92,11,4,15,16,42,24,5,8,91,92
2018,2,21800021,10/19/2018,1610612739,Cleveland Cavaliers,0,0,1610612750,Minnesota Timberwolves,1,1,37,33,70,8,15,23,45,48,93,25,4,29,16,35,26,9,14,104,123
2018,2,21800021,10/19/2018,1610612750,Minnesota Timberwolves,1,1,1610612739,Cleveland Cavaliers,0,0,34,28,62,10,15,25,44,43,87,33,2,35,13,32,28,5,14,104,131
2016,2,21600719,1/30/2017,1610612748,Miami Heat,1,1,1610612751,Brooklyn Nets,0,0,28,28,56,11,15,26,39,43,82,15,8,23,9,39,22,7,11,95,104
2016,2,21600719,1/30/2017,1610612751,Brooklyn Nets,0,0,1610612748,Miami Heat,1,1,33,28,61,4,22,26,37,50,87,18,4,22,19,34,16,9,16,96,96
2016,2,21600235,11/25/2016,1610612743,Denver Nuggets,1,0,1610612760,Oklahoma City Thunder,0,1,36,31,67,12,22,34,48,53,101,21,6,27,19,37,34,11,17,112,129
2016,2,21600235,11/25/2016,1610612760,Oklahoma City Thunder,0,1,1610612743,Denver Nuggets,1,0,35,35,70,13,13,26,48,48,96,23,6,29,10,42,29,9,12,113,132
2014,2,21400949,3/10/2015,1610612759,San Antonio Spurs,1,1,1610612761,Toronto Raptors,0,0,30,37,67,11,7,18,41,44,85,24,6,30,16,30,24,6,11,94,117
2014,2,21400949,3/10/2015,1610612761,Toronto Raptors,0,0,1610612759,San Antonio Spurs,1,1,35,36,71,8,18,26,43,54,97,13,5,18,20,36,19,7,9,94,107
2017,2,21700034,10/21/2017,1610612749,Milwaukee Bucks,1,1,1610612757,Portland Trail Blazers,0,0,35,27,62,7,11,18,42,38,80,22,8,30,10,31,22,10,14,97,113
2017,2,21700034,10/21/2017,1610612757,Portland Trail Blazers,0,0,1610612749,Milwaukee Bucks,1,1,23,30,53,11,17,28,34,47,81,31,4,35,19,29,18,9,16,97,110
2023,2,22301230,12/7/2023,1610612740,New Orleans Pelicans,0,0,1610612747,Los Angeles Lakers,1,1,27,37,64,7,24,31,34,61,95,14,6,20,15,49,22,6,12,103,89
2023,2,22300335,12/16/2023,1610612766,Charlotte Hornets,1,0,1610612755,Philadelphia 76ers,0,1,26,30,56,7,28,35,33,58,91,9,2,11,13,45,15,10,13,100,82
2023,2,22300390,12/23/2023,1610612743,Denver Nuggets,0,1,1610612766,Charlotte Hornets,1,0,27,33,60,12,18,30,39,51,90,12,2,14,18,34,25,8,17,97,102
2023,2,22300323,12/14/2023,1610612762,Utah Jazz,0,1,1610612757,Portland Trail Blazers,1,0,38,21,59,11,22,33,49,43,92,13,1,14,15,29,27,9,11,94,122
2023,2,22300442,12/30/2023,1610612741,Chicago Bulls,1,1,1610612755,Philadelphia 76ers,0,0,33,21,54,7,18,25,40,39,79,18,12,30,19,25,21,12,17,90,105
2017,2,21700033,10/21/2017,1610612744,Golden State Warriors,0,0,1610612763,Memphis Grizzlies,1,1,21,25,46,12,26,38,33,51,84,23,4,27,16,37,20,8,17,101,101
2017,2,21700033,10/21/2017,1610612763,Memphis Grizzlies,1,1,1610612744,Golden State Warriors,0,0,26,24,50,10,17,27,36,41,77,29,8,37,8,37,20,10,14,100,111
2018,2,21800020,10/19/2018,1610612737,Atlanta Hawks,0,0,1610612763,Memphis Grizzlies,1,1,27,26,53,14,16,30,41,42,83,21,15,36,12,36,27,9,19,108,117
2018,2,21800020,10/19/2018,1610612763,Memphis Grizzlies,1,1,1610612737,Atlanta Hawks,0,0,31,24,55,13,13,26,44,37,81,30,13,43,12,31,32,9,17,107,131
2016,2,21600718,1/29/2017,1610612744,Golden State Warriors,0,1,1610612757,Portland Trail Blazers,1,0,28,25,53,8,18,26,36,43,79,33,6,39,11,34,28,11,18,105,113
2016,2,21600718,1/29/2017,1610612757,Portland Trail Blazers,1,0,1610612744,Golden State Warriors,0,1,36,30,66,10,17,27,46,47,93,9,3,12,12,36,26,13,18,104,111
2016,2,21600234,11/25/2016,1610612751,Brooklyn Nets,0,0,1610612754,Indiana Pacers,1,1,25,20,45,11,23,34,36,43,79,14,9,23,10,38,24,11,20,98,97
2016,2,21600234,11/25/2016,1610612754,Indiana Pacers,1,1,1610612751,Brooklyn Nets,0,0,37,24,61,11,15,26,48,39,87,11,5,16,12,30,25,8,15,99,118
2014,2,21400948,3/10/2015,1610612739,Cleveland Cavaliers,0,1,1610612742,Dallas Mavericks,1,0,29,26,55,15,17,32,44,43,87,24,5,29,17,28,25,6,14,98,127
2014,2,21400948,3/10/2015,1610612742,Dallas Mavericks,1,0,1610612739,Cleveland Cavaliers,0,1,28,33,61,5,15,20,33,48,81,23,10,33,15,38,18,11,16,98,94
2020,2,22000071,1/1/2021,1610612742,Dallas Mavericks,1,1,1610612748,Miami Heat,0,0,20,21,41,12,25,37,32,46,78,17,6,23,11,38,18,10,17,97,93
2020,2,22000071,1/1/2021,1610612748,Miami Heat,0,0,1610612742,Dallas Mavericks,1,1,22,23,45,7,26,33,29,49,78,18,7,25,9,45,20,9,16,97,83
2021,2,22100280,11/26/2021,1610612746,LA Clippers,1,1,1610612765,Detroit Pistons,0,0,28,25,53,11,27,38,39,52,91,18,1,19,13,39,26,8,15,102,107
2021,2,22100280,11/26/2021,1610612765,Detroit Pistons,0,0,1610612746,LA Clippers,1,1,25,32,57,8,25,33,33,57,90,22,4,26,14,44,17,9,15,102,96
2019,2,21900083,11/2/2019,1610612744,Golden State Warriors,1,0,1610612766,Charlotte Hornets,0,1,25,24,49,9,19,28,34,43,77,10,3,13,10,35,23,6,18,91,87
2019,2,21900083,11/2/2019,1610612766,Charlotte Hornets,0,1,1610612744,Golden State Warriors,1,0,31,25,56,5,24,29,36,49,85,16,7,23,19,35,18,5,13,91,93
2018,2,21801204,4/7/2019,1610612752,New York Knicks,1,1,1610612764,Washington Wizards,0,0,24,22,46,17,17,34,41,39,80,14,5,19,8,32,24,12,15,97,113
2018,2,21801204,4/7/2019,1610612764,Washington Wizards,0,0,1610612752,New York Knicks,1,1,33,36,69,10,24,34,43,60,103,14,4,18,23,38,24,5,9,97,110
2018,2,21800919,2/27/2019,1610612746,LA Clippers,0,0,1610612762,Utah Jazz,1,1,32,36,68,5,21,26,37,57,94,26,4,30,14,44,16,9,11,105,105
2018,2,21800919,2/27/2019,1610612762,Utah Jazz,1,1,1610612746,LA Clippers,0,0,27,31,58,11,23,34,38,54,92,24,8,32,20,39,22,11,16,105,111
2018,2,21800423,12/14/2018,1610612739,Cleveland Cavaliers,1,0,1610612749,Milwaukee Bucks,0,1,22,29,51,13,23,36,35,52,87,19,2,21,14,40,24,9,16,99,102
2018,2,21800423,12/14/2018,1610612749,Milwaukee Bucks,0,1,1610612739,Cleveland Cavaliers,1,0,28,25,53,12,29,41,40,54,94,22,6,28,16,41,26,7,11,100,114
2018,2,21800357,12/5/2018,1610612737,Atlanta Hawks,1,0,1610612764,Washington Wizards,0,1,29,25,54,12,26,38,41,51,92,23,8,31,11,43,28,9,17,112,117
2018,2,21800357,12/5/2018,1610612764,Washington Wizards,0,1,1610612737,Atlanta Hawks,1,0,34,23,57,12,26,38,46,49,95,27,5,32,15,36,35,13,16,111,131
2018,2,21800088,10/29/2018,1610612737,Atlanta Hawks,0,0,1610612755,Philadelphia 76ers,1,1,27,30,57,8,29,37,35,59,94,14,7,21,12,51,20,7,15,108,92
2018,2,21800088,10/29/2018,1610612755,Philadelphia 76ers,1,1,1610612737,Atlanta Hawks,0,0,27,25,52,14,33,47,41,58,99,17,1,18,19,39,33,10,19,109,113
2019,2,21901277,8/7/2020,1610612753,Orlando Magic,0,0,1610612755,Philadelphia 76ers,1,1,29,27,56,8,24,32,37,51,88,19,6,25,14,38,17,4,11,97,101
2019,2,21901277,8/7/2020,1610612755,Philadelphia 76ers,1,1,1610612753,Orlando Magic,0,0,30,34,64,8,21,29,38,55,93,24,9,33,22,40,19,5,9,98,108
2019,2,21900919,3/4/2020,1610612748,Miami Heat,1,1,1610612753,Orlando Magic,0,0,19,16,35,22,22,44,41,38,79,12,3,15,9,32,31,6,14,91,116
2019,2,21900919,3/4/2020,1610612753,Orlando Magic,0,0,1610612748,Miami Heat,1,1,31,23,54,13,17,30,44,40,84,12,2,14,9,32,28,8,12,93,113
2019,2,21900887,2/29/2020,1610612741,Chicago Bulls,0,0,1610612752,New York Knicks,1,1,24,30,54,17,18,35,41,48,89,16,7,23,15,36,26,6,8,96,115
2019,2,21900887,2/29/2020,1610612752,New York Knicks,1,1,1610612741,Chicago Bulls,0,0,39,26,65,8,12,20,47,38,85,23,10,33,22,21,29,12,17,94,125
2019,2,21900869,2/26/2020,1610612742,Dallas Mavericks,0,1,1610612759,San Antonio Spurs,1,0,19,22,41,17,28,45,36,50,86,20,10,30,12,44,25,8,16,103,109
2019,2,21900869,2/26/2020,1610612759,San Antonio Spurs,1,0,1610612742,Dallas Mavericks,0,1,28,31,59,11,22,33,39,53,92,14,5,19,15,40,22,11,16,102,103
2019,2,21900852,2/24/2020,1610612751,Brooklyn Nets,1,0,1610612753,Orlando Magic,0,1,30,29,59,16,21,37,46,50,96,5,3,8,16,37,29,6,12,99,113
2019,2,21900852,2/24/2020,1610612753,Orlando Magic,0,1,1610612751,Brooklyn Nets,1,0,31,24,55,13,21,34,44,45,89,14,3,17,10,37,27,6,10,98,115
2019,2,21900768,2/6/2020,1610612745,Houston Rockets,0,1,1610612747,Los Angeles Lakers,1,0,24,19,43,19,23,42,43,42,85,16,2,18,8,34,20,10,16,102,121
2019,2,21900768,2/6/2020,1610612747,Los Angeles Lakers,1,0,1610612745,Houston Rockets,0,1,36,24,60,9,22,31,45,46,91,12,4,16,13,35,33,8,16,103,111
2019,2,21900750,2/3/2020,1610612746,LA Clippers,1,1,1610612759,San Antonio Spurs,0,0,28,29,57,11,16,27,39,45,84,19,5,24,5,42,28,5,12,101,108
2019,2,21900750,2/3/2020,1610612759,San Antonio Spurs,0,0,1610612746,LA Clippers,1,1,28,30,58,12,25,37,40,55,95,13,3,16,9,47,21,3,8,102,105
2019,2,21900744,2/3/2020,1610612744,Golden State Warriors,0,1,1610612764,Washington Wizards,1,0,28,29,57,15,15,30,43,44,87,24,7,31,12,37,31,6,14,104,125
2017,2,21700032,10/21/2017,1610612742,Dallas Mavericks,0,0,1610612745,Houston Rockets,1,1,18,35,53,13,18,31,31,53,84,16,5,21,9,47,19,12,14,97,91
2017,2,21700032,10/21/2017,1610612745,Houston Rockets,1,1,1610612742,Dallas Mavericks,0,0,28,7,35,11,36,47,39,43,82,18,4,22,8,38,17,6,15,97,107
2023,2,22300993,3/19/2024,1610612751,Brooklyn Nets,1,0,1610612740,New Orleans Pelicans,0,1,19,25,44,12,28,40,31,53,84,17,5,22,20,37,19,7,14,90,91
2017,2,21700031,10/21/2017,1610612741,Chicago Bulls,1,0,1610612759,San Antonio Spurs,0,1,23,31,54,8,20,28,31,51,82,7,2,9,11,42,18,8,20,94,77
2017,2,21700031,10/21/2017,1610612759,San Antonio Spurs,0,1,1610612741,Chicago Bulls,1,0,37,44,81,1,11,12,38,55,93,10,6,16,18,40,25,3,11,94,87
2018,2,21800019,10/19/2018,1610612738,Boston Celtics,0,0,1610612761,Toronto Raptors,1,1,26,37,63,14,22,36,40,59,99,7,3,10,20,40,29,3,16,99,101
2018,2,21800019,10/19/2018,1610612761,Toronto Raptors,1,1,1610612738,Boston Celtics,0,0,30,27,57,13,22,35,43,49,92,14,5,19,15,37,24,4,13,99,113
2018,2,21800018,10/19/2018,1610612751,Brooklyn Nets,1,1,1610612752,New York Knicks,0,0,25,20,45,12,18,30,37,38,75,21,3,24,13,25,22,10,22,94,107
2018,2,21800018,10/19/2018,1610612752,New York Knicks,0,0,1610612751,Brooklyn Nets,1,1,30,39,69,9,19,28,39,58,97,18,2,20,14,44,14,2,3,95,105
2014,2,21400947,3/10/2015,1610612740,New Orleans Pelicans,0,1,1610612751,Brooklyn Nets,1,0,33,33,66,12,9,21,45,42,87,9,2,11,12,30,31,5,11,92,111
2014,2,21400947,3/10/2015,1610612751,Brooklyn Nets,1,0,1610612740,New Orleans Pelicans,0,1,29,39,68,6,10,16,35,49,84,15,8,23,17,36,19,10,12,91,91
2022,2,22200462,12/20/2022,1610612741,Chicago Bulls,0,1,1610612748,Miami Heat,1,0,27,15,42,13,18,31,40,33,73,20,4,24,8,26,24,9,17,95,113
2022,2,22200462,12/20/2022,1610612748,Miami Heat,1,0,1610612741,Chicago Bulls,0,1,23,14,37,15,29,44,38,43,81,12,5,17,9,36,26,7,13,93,103
2017,2,21700030,10/21/2017,1610612752,New York Knicks,1,0,1610612765,Detroit Pistons,0,1,29,22,51,8,22,30,37,44,81,25,6,31,18,29,20,5,14,94,107
2017,2,21700030,10/21/2017,1610612765,Detroit Pistons,0,1,1610612752,New York Knicks,1,0,35,26,61,9,21,30,44,47,91,14,1,15,16,30,21,6,13,93,111
2018,2,21801203,4/7/2019,1610612738,Boston Celtics,1,0,1610612753,Orlando Magic,0,1,30,28,58,12,19,31,42,47,89,12,2,14,9,39,28,9,14,101,108
2018,2,21801203,4/7/2019,1610612753,Orlando Magic,0,1,1610612738,Boston Celtics,1,0,29,28,57,12,21,33,41,49,90,22,0,22,14,35,29,9,16,101,116
2018,2,21800017,10/19/2018,1610612753,Orlando Magic,1,0,1610612766,Charlotte Hornets,0,1,30,33,63,6,25,31,36,58,94,10,4,14,14,47,18,6,18,104,88
2018,2,21800017,10/19/2018,1610612766,Charlotte Hornets,0,1,1610612753,Orlando Magic,1,0,26,28,54,17,21,38,43,49,92,17,3,20,15,35,32,8,16,104,120
2018,2,21801056,3/18/2019,1610612740,New Orleans Pelicans,0,1,1610612742,Dallas Mavericks,1,0,37,28,65,12,27,39,49,55,104,19,3,22,18,38,34,9,17,116,129
2018,2,21801056,3/18/2019,1610612742,Dallas Mavericks,1,0,1610612740,New Orleans Pelicans,0,1,37,33,70,9,26,35,46,59,105,24,5,29,18,42,27,7,16,116,125
2017,2,21700029,10/21/2017,1610612748,Miami Heat,1,1,1610612754,Indiana Pacers,0,0,31,22,53,14,20,34,45,42,87,8,6,14,11,35,24,9,14,96,112
2017,2,21700029,10/21/2017,1610612754,Indiana Pacers,0,0,1610612748,Miami Heat,1,1,36,41,77,7,12,19,43,53,96,15,6,21,18,40,18,6,10,97,108
2016,2,21600233,11/25/2016,1610612748,Miami Heat,0,1,1610612763,Memphis Grizzlies,1,0,21,33,54,12,19,31,33,52,85,12,6,18,13,41,17,3,9,90,90
2016,2,21600233,11/25/2016,1610612763,Memphis Grizzlies,1,0,1610612748,Miami Heat,0,1,25,38,63,4,15,19,29,53,82,19,4,23,19,36,14,8,18,91,81
2023,2,22300503,1/7/2024,1610612756,Phoenix Suns,1,0,1610612763,Memphis Grizzlies,0,1,38,36,74,8,20,28,46,56,102,15,7,22,18,42,29,7,12,104,115
2017,2,21700028,10/21/2017,1610612739,Cleveland Cavaliers,1,0,1610612753,Orlando Magic,0,1,26,35,61,7,18,25,33,53,86,20,7,27,17,40,15,7,16,98,93
2017,2,21700028,10/21/2017,1610612753,Orlando Magic,0,1,1610612739,Cleveland Cavaliers,1,0,23,32,55,17,18,35,40,50,90,17,3,20,15,35,28,4,12,98,114
2018,2,21800016,10/18/2018,1610612747,Los Angeles Lakers,0,0,1610612757,Portland Trail Blazers,1,1,38,25,63,7,23,30,45,48,93,22,7,29,9,42,23,9,15,113,119
2018,2,21800016,10/18/2018,1610612757,Portland Trail Blazers,1,1,1610612747,Los Angeles Lakers,0,0,31,32,63,13,24,37,44,56,100,27,2,29,18,40,21,10,17,112,128
2016,2,21600717,1/29/2017,1610612742,Dallas Mavericks,0,1,1610612759,San Antonio Spurs,1,0,27,26,53,12,22,34,39,48,87,15,1,16,8,40,20,2,7,95,105
2016,2,21600717,1/29/2017,1610612759,San Antonio Spurs,1,0,1610612742,Dallas Mavericks,0,1,31,30,61,8,14,22,39,44,83,15,8,23,10,40,26,6,11,94,101
2014,2,21400946,3/10/2015,1610612753,Orlando Magic,0,0,1610612754,Indiana Pacers,1,1,30,45,75,4,13,17,34,58,92,14,6,20,23,39,15,6,10,90,86
2014,2,21400946,3/10/2015,1610612754,Indiana Pacers,1,1,1610612753,Orlando Magic,0,0,28,23,51,17,17,34,45,40,85,11,1,12,14,27,37,9,14,91,118
2017,2,21700027,10/21/2017,1610612755,Philadelphia 76ers,0,0,1610612761,Toronto Raptors,1,1,24,34,58,8,16,24,32,50,82,22,14,36,13,44,18,5,20,109,94
2017,2,21700027,10/21/2017,1610612761,Toronto Raptors,1,1,1610612755,Philadelphia 76ers,0,0,29,16,45,13,31,44,42,47,89,31,6,37,12,38,23,5,13,108,128
2018,2,21800015,10/18/2018,1610612748,Miami Heat,0,1,1610612764,Washington Wizards,1,0,26,36,62,12,23,35,38,59,97,25,9,34,27,36,25,7,19,106,113
2018,2,21800015,10/18/2018,1610612764,Washington Wizards,1,0,1610612748,Miami Heat,0,1,31,24,55,7,19,26,38,43,81,29,10,39,9,37,19,6,14,106,112
2014,2,21400945,3/9/2015,1610612746,LA Clippers,1,1,1610612750,Minnesota Timberwolves,0,0,24,24,48,11,20,31,35,44,79,8,7,15,10,39,30,12,16,92,89
2016,2,21600232,11/25/2016,1610612749,Milwaukee Bucks,1,0,1610612761,Toronto Raptors,0,1,28,22,50,12,17,29,40,39,79,7,5,12,8,34,26,3,11,88,99
2016,2,21600232,11/25/2016,1610612761,Toronto Raptors,0,1,1610612749,Milwaukee Bucks,1,0,24,26,50,14,18,32,38,44,82,15,4,19,14,33,18,4,10,88,105
2014,2,21400945,3/9/2015,1610612750,Minnesota Timberwolves,0,0,1610612746,LA Clippers,1,1,29,46,75,2,6,8,31,52,83,12,9,21,16,40,25,11,15,92,76
2017,2,21700026,10/20/2017,1610612747,Los Angeles Lakers,0,1,1610612756,Phoenix Suns,1,0,36,31,67,12,14,26,48,45,93,24,9,33,8,42,22,8,18,118,132
2017,2,21700026,10/20/2017,1610612756,Phoenix Suns,1,0,1610612747,Los Angeles Lakers,0,1,31,32,63,14,15,29,45,47,92,26,12,38,12,41,17,8,19,118,130
2018,2,21800014,10/18/2018,1610612741,Chicago Bulls,0,0,1610612755,Philadelphia 76ers,1,1,33,35,68,11,22,33,44,57,101,9,3,12,11,49,28,10,12,106,108
2018,2,21800014,10/18/2018,1610612755,Philadelphia 76ers,1,1,1610612741,Chicago Bulls,0,0,32,25,57,12,24,36,44,49,93,27,3,30,14,37,30,4,13,106,127
2014,2,21400944,3/9/2015,1610612744,Golden State Warriors,0,1,1610612756,Phoenix Suns,1,0,22,30,52,13,18,31,35,48,83,15,4,19,13,36,17,11,18,98,98
2014,2,21400944,3/9/2015,1610612756,Phoenix Suns,1,0,1610612744,Golden State Warriors,0,1,25,41,66,4,7,11,29,48,77,18,5,23,9,42,13,11,19,97,80
2023,2,22301206,12/6/2023,1610612763,Memphis Grizzlies,0,1,1610612765,Detroit Pistons,1,0,36,29,65,11,15,26,47,44,91,11,3,14,11,35,26,9,14,101,116
2023,2,22300461,1/2/2024,1610612740,New Orleans Pelicans,1,1,1610612751,Brooklyn Nets,0,0,25,24,49,16,23,39,41,47,88,14,4,18,20,28,23,7,17,92,112
2018,2,21800013,10/17/2018,1610612742,Dallas Mavericks,0,0,1610612756,Phoenix Suns,1,1,28,27,55,10,23,33,38,50,88,14,6,20,13,40,28,5,9,94,100
2018,2,21800013,10/17/2018,1610612756,Phoenix Suns,1,1,1610612742,Dallas Mavericks,0,0,25,22,47,19,15,34,44,37,81,14,2,16,6,31,35,7,12,93,121
2016,2,21600231,11/25/2016,1610612737,Atlanta Hawks,0,0,1610612762,Utah Jazz,1,1,18,40,58,8,17,25,26,57,83,8,4,12,10,49,11,9,14,93,68
2016,2,21600231,11/25/2016,1610612762,Utah Jazz,1,1,1610612737,Atlanta Hawks,0,0,25,21,46,10,24,34,35,45,80,15,3,18,10,36,17,8,16,93,95
2014,2,21400943,3/9/2015,1610612743,Denver Nuggets,1,1,1610612752,New York Knicks,0,0,30,33,63,8,16,24,38,49,87,22,7,29,16,38,21,3,8,92,106
2014,2,21400943,3/9/2015,1610612752,New York Knicks,0,0,1610612743,Denver Nuggets,1,1,24,38,62,5,8,13,29,46,75,15,10,25,10,39,21,6,14,91,78
2017,2,21700025,10/20/2017,1610612740,New Orleans Pelicans,1,0,1610612744,Golden State Warriors,0,1,29,33,62,16,20,36,45,53,98,14,8,22,18,40,26,6,19,109,120
2017,2,21700025,10/20/2017,1610612744,Golden State Warriors,0,1,1610612740,New Orleans Pelicans,1,0,29,22,51,18,22,40,47,44,91,16,4,20,10,36,29,8,18,108,128
2016,2,21600716,1/29/2017,1610612741,Chicago Bulls,1,1,1610612755,Philadelphia 76ers,0,0,37,38,75,8,6,14,45,44,89,23,5,28,14,34,29,8,12,101,121
2016,2,21600716,1/29/2017,1610612755,Philadelphia 76ers,0,0,1610612741,Chicago Bulls,1,1,34,37,71,10,18,28,44,55,99,10,4,14,17,41,26,8,13,101,108
2022,2,22200551,1/2/2023,1610612747,Los Angeles Lakers,0,1,1610612766,Charlotte Hornets,1,0,35,28,63,10,20,30,45,48,93,21,9,30,12,42,26,8,15,108,121
2022,2,22200551,1/2/2023,1610612766,Charlotte Hornets,1,0,1610612747,Los Angeles Lakers,0,1,31,30,61,11,21,32,42,51,93,20,9,29,11,46,24,6,14,109,115
2023,2,22300461,1/2/2024,1610612751,Brooklyn Nets,0,0,1610612740,New Orleans Pelicans,1,1,24,31,55,11,32,43,35,63,98,4,4,8,25,40,26,10,15,93,85
2017,2,21700024,10/20/2017,1610612742,Dallas Mavericks,1,0,1610612758,Sacramento Kings,0,1,20,22,42,11,22,33,31,44,75,15,6,21,8,40,19,8,12,89,88
2017,2,21700024,10/20/2017,1610612758,Sacramento Kings,0,1,1610612742,Dallas Mavericks,1,0,27,37,64,10,13,23,37,50,87,9,4,13,20,33,20,8,15,90,93
2018,2,21800012,10/17/2018,1610612743,Denver Nuggets,0,1,1610612746,LA Clippers,1,0,25,38,63,8,16,24,33,54,87,33,9,42,17,40,20,3,11,102,107
2018,2,21800012,10/17/2018,1610612746,LA Clippers,1,0,1610612743,Denver Nuggets,0,1,27,33,60,8,20,28,35,53,88,20,4,24,11,44,21,6,14,100,98
2016,2,21600230,11/25/2016,1610612746,LA Clippers,0,0,1610612765,Detroit Pistons,1,1,28,24,52,7,14,21,35,38,73,20,6,26,8,33,26,7,14,92,97
2016,2,21600230,11/25/2016,1610612765,Detroit Pistons,1,1,1610612746,LA Clippers,0,0,38,33,71,9,10,19,47,43,90,5,2,7,13,31,26,4,10,91,108
2014,2,21400942,3/9/2015,1610612740,New Orleans Pelicans,0,1,1610612749,Milwaukee Bucks,1,0,35,25,60,9,6,15,44,31,75,17,4,21,13,20,26,11,18,91,114
2014,2,21400942,3/9/2015,1610612749,Milwaukee Bucks,1,0,1610612740,New Orleans Pelicans,0,1,33,23,56,4,11,15,37,34,71,25,6,31,11,26,20,7,14,91,103
2017,2,21700023,10/20/2017,1610612750,Minnesota Timberwolves,1,1,1610612762,Utah Jazz,0,0,29,30,59,7,15,22,36,45,81,21,5,26,15,33,17,10,16,95,100
2017,2,21700023,10/20/2017,1610612762,Utah Jazz,0,0,1610612750,Minnesota Timberwolves,1,1,28,27,55,9,13,22,37,40,77,14,3,17,9,34,23,11,19,95,97
2016,2,21600715,1/29/2017,1610612753,Orlando Magic,0,1,1610612761,Toronto Raptors,1,0,32,24,56,10,13,23,42,37,79,20,6,26,8,31,25,8,12,96,114
2016,2,21600715,1/29/2017,1610612761,Toronto Raptors,1,0,1610612753,Orlando Magic,0,1,24,27,51,12,16,28,36,43,79,29,7,36,13,33,19,6,13,96,113
2022,2,22200514,12/27/2022,1610612743,Denver Nuggets,0,1,1610612758,Sacramento Kings,1,0,28,21,49,13,24,37,41,45,86,18,3,21,12,34,34,8,13,99,113
2022,2,22200514,12/27/2022,1610612758,Sacramento Kings,1,0,1610612743,Denver Nuggets,0,1,30,17,47,10,25,35,40,42,82,16,3,19,9,34,20,12,16,98,106
2023,2,22300196,11/15/2023,1610612753,Orlando Magic,0,1,1610612741,Chicago Bulls,1,0,24,30,54,8,20,28,32,50,82,24,6,30,14,40,20,7,15,97,96
2023,2,22300561,1/15/2024,1610612739,Cleveland Cavaliers,1,1,1610612741,Chicago Bulls,0,0,19,19,38,20,37,57,39,56,95,11,0,11,16,40,28,8,14,98,109
2017,2,21700022,10/20/2017,1610612751,Brooklyn Nets,1,1,1610612753,Orlando Magic,0,0,37,28,65,9,18,27,46,46,92,25,10,35,18,33,22,9,18,106,126
2017,2,21700022,10/20/2017,1610612753,Orlando Magic,0,0,1610612751,Brooklyn Nets,1,1,27,29,56,18,15,33,45,44,89,13,2,15,11,34,30,13,22,105,121
2014,2,21400941,3/9/2015,1610612741,Chicago Bulls,1,0,1610612763,Memphis Grizzlies,0,1,25,33,58,10,12,22,35,45,80,11,3,14,10,36,18,13,17,93,91
2014,2,21400941,3/9/2015,1610612763,Memphis Grizzlies,0,1,1610612741,Chicago Bulls,1,0,37,33,70,5,9,14,42,42,84,12,5,17,10,36,25,7,11,93,101
2015,2,21501183,4/8/2016,1610612754,Indiana Pacers,0,0,1610612761,Toronto Raptors,1,1,29,27,56,8,19,27,37,46,83,16,4,20,12,36,22,4,10,91,98
2015,2,21501183,4/8/2016,1610612761,Toronto Raptors,1,1,1610612754,Indiana Pacers,0,0,27,19,46,10,12,22,37,31,68,27,11,38,12,24,21,7,17,92,111
2022,2,22200526,12/29/2022,1610612761,Toronto Raptors,1,0,1610612763,Memphis Grizzlies,0,1,29,39,68,10,18,28,39,57,96,18,6,24,20,41,21,4,8,95,106
2022,2,22200526,12/29/2022,1610612763,Memphis Grizzlies,0,1,1610612761,Toronto Raptors,1,0,35,31,66,13,16,29,48,47,95,10,4,14,20,30,37,11,16,96,119
2018,2,21800010,10/17/2018,1610612750,Minnesota Timberwolves,0,0,1610612759,San Antonio Spurs,1,1,33,39,72,6,13,19,39,52,91,24,3,27,18,35,20,3,11,96,108
2018,2,21800010,10/17/2018,1610612759,San Antonio Spurs,1,1,1610612750,Minnesota Timberwolves,0,0,29,39,68,11,14,25,40,53,93,21,8,29,24,32,22,9,12,95,112
2014,2,21400940,3/9/2015,1610612738,Boston Celtics,0,1,1610612748,Miami Heat,1,0,33,29,62,6,19,25,39,48,87,16,1,17,19,29,17,5,11,86,100
2014,2,21400940,3/9/2015,1610612748,Miami Heat,1,0,1610612738,Boston Celtics,0,1,25,27,52,4,13,17,29,40,69,28,6,34,12,30,15,7,13,86,90
2022,2,22200513,12/27/2022,1610612744,Golden State Warriors,1,1,1610612766,Charlotte Hornets,0,0,33,25,58,8,29,37,41,54,95,20,4,24,13,42,31,6,14,105,110
2022,2,22200513,12/27/2022,1610612766,Charlotte Hornets,0,0,1610612744,Golden State Warriors,1,1,28,26,54,10,28,38,38,54,92,19,6,25,13,42,22,3,14,105,105
2015,2,21501112,3/29/2016,1610612744,Golden State Warriors,1,1,1610612764,Washington Wizards,0,0,27,35,62,11,14,25,38,49,87,15,8,23,13,41,27,6,16,104,102
2015,2,21501112,3/29/2016,1610612764,Washington Wizards,0,0,1610612744,Golden State Warriors,1,1,31,32,63,5,18,23,36,50,86,17,10,27,9,48,26,11,17,103,94
2023,2,22300044,11/24/2023,1610612756,Phoenix Suns,0,1,1610612763,Memphis Grizzlies,1,0,28,17,45,11,20,31,39,37,76,21,7,28,10,31,22,6,13,92,110
2023,2,22300324,12/14/2023,1610612758,Sacramento Kings,1,1,1610612760,Oklahoma City Thunder,0,0,29,21,50,18,27,45,47,48,95,16,5,21,15,34,32,8,17,108,128
2017,2,21700021,10/20/2017,1610612739,Cleveland Cavaliers,0,1,1610612749,Milwaukee Bucks,1,0,33,22,55,11,15,26,44,37,81,17,0,17,13,24,25,9,18,94,116
2017,2,21700021,10/20/2017,1610612749,Milwaukee Bucks,1,0,1610612739,Cleveland Cavaliers,0,1,27,20,47,11,24,35,38,44,82,10,2,12,10,36,23,8,15,94,97
2018,2,21800009,10/17/2018,1610612740,New Orleans Pelicans,0,1,1610612745,Houston Rockets,1,0,42,31,73,10,15,25,52,46,98,17,5,22,17,32,36,8,12,103,131
2018,2,21800009,10/17/2018,1610612745,Houston Rockets,1,0,1610612740,New Orleans Pelicans,0,1,23,21,44,16,32,48,39,53,92,18,6,24,12,42,21,8,12,103,112
2016,2,21600714,1/29/2017,1610612740,New Orleans Pelicans,1,0,1610612764,Washington Wizards,0,1,28,24,52,10,22,32,38,46,84,8,7,15,13,37,25,9,15,94,94
2016,2,21600714,1/29/2017,1610612764,Washington Wizards,0,1,1610612740,New Orleans Pelicans,1,0,35,33,68,10,11,21,45,44,89,7,3,10,11,35,28,8,11,95,107
2016,2,21600229,11/25/2016,1610612741,Chicago Bulls,0,1,1610612755,Philadelphia 76ers,1,0,34,35,69,6,15,21,40,50,90,19,7,26,15,40,24,7,14,99,105
2016,2,21600229,11/25/2016,1610612755,Philadelphia 76ers,1,0,1610612741,Chicago Bulls,0,1,22,34,56,9,13,22,31,47,78,18,4,22,9,40,18,10,19,99,89
2014,2,21400939,3/9/2015,1610612737,Atlanta Hawks,1,1,1610612758,Sacramento Kings,0,0,33,19,52,20,16,36,53,35,88,4,3,7,12,25,42,10,13,92,130
2014,2,21400939,3/9/2015,1610612758,Sacramento Kings,0,0,1610612737,Atlanta Hawks,1,1,31,30,61,8,12,20,39,42,81,19,1,20,17,25,21,8,16,91,105
2017,2,21700020,10/20/2017,1610612764,Washington Wizards,1,1,1610612765,Detroit Pistons,0,0,34,24,58,6,11,17,40,35,75,29,6,35,8,29,25,12,18,101,115
2017,2,21700020,10/20/2017,1610612765,Detroit Pistons,0,0,1610612764,Washington Wizards,1,1,33,31,64,10,13,23,43,44,87,15,5,20,13,35,19,12,18,100,111
2018,2,21800008,10/17/2018,1610612739,Cleveland Cavaliers,0,0,1610612761,Toronto Raptors,1,1,27,39,66,7,12,19,34,51,85,29,10,39,21,37,17,6,16,99,104
2018,2,21800008,10/17/2018,1610612761,Toronto Raptors,1,1,1610612739,Cleveland Cavaliers,0,0,31,28,59,14,19,33,45,47,92,12,8,20,11,41,21,4,10,99,116
2015,2,21500950,3/9/2016,1610612740,New Orleans Pelicans,0,0,1610612766,Charlotte Hornets,1,1,30,22,52,10,23,33,40,45,85,23,5,28,9,39,22,6,11,99,113
2015,2,21500950,3/9/2016,1610612766,Charlotte Hornets,1,1,1610612740,New Orleans Pelicans,0,0,23,24,47,15,20,35,38,44,82,31,7,38,7,40,21,2,5,99,122
2015,2,21500782,2/8/2016,1610612740,New Orleans Pelicans,0,1,1610612750,Minnesota Timberwolves,1,0,37,36,73,10,14,24,47,50,97,12,8,20,14,42,22,0,4,96,116
2015,2,21500782,2/8/2016,1610612750,Minnesota Timberwolves,1,0,1610612740,New Orleans Pelicans,0,1,34,35,69,2,10,12,36,45,81,28,7,35,12,35,24,7,12,96,102
2015,2,21500737,2/3/2016,1610612738,Boston Celtics,1,1,1610612765,Detroit Pistons,0,0,35,40,75,7,14,21,42,54,96,11,2,13,11,44,28,3,10,102,102
2015,2,21500737,2/3/2016,1610612765,Detroit Pistons,0,0,1610612738,Boston Celtics,1,1,21,30,51,11,23,34,32,53,85,20,8,28,15,43,18,8,16,102,95
2015,2,21500690,1/27/2016,1610612762,Utah Jazz,1,1,1610612766,Charlotte Hornets,0,0,28,22,50,12,19,31,40,41,81,10,5,15,9,34,23,6,10,91,102
2015,2,21500690,1/27/2016,1610612766,Charlotte Hornets,0,0,1610612762,Utah Jazz,1,1,19,24,43,6,19,25,25,43,68,17,4,21,7,40,10,10,20,91,73
2014,2,21400938,3/9/2015,1610612764,Washington Wizards,0,1,1610612766,Charlotte Hornets,1,0,42,29,71,2,12,14,44,41,85,5,0,5,10,31,21,4,13,91,95
2014,2,21400938,3/9/2015,1610612766,Charlotte Hornets,1,0,1610612764,Washington Wizards,0,1,21,34,55,4,18,22,25,52,77,15,5,20,12,43,13,10,16,91,69
2016,2,21600228,11/25/2016,1610612752,New York Knicks,1,1,1610612766,Charlotte Hornets,0,0,34,35,69,11,17,28,45,52,97,12,1,13,15,37,26,6,17,104,113
2016,2,21600228,11/25/2016,1610612766,Charlotte Hornets,0,0,1610612752,New York Knicks,1,1,35,29,64,8,21,29,43,50,93,17,10,27,14,42,25,9,13,103,111
2015,2,21501055,3/22/2016,1610612747,Los Angeles Lakers,1,1,1610612763,Memphis Grizzlies,0,0,33,25,58,6,13,19,39,38,77,23,1,24,16,22,21,13,22,97,107
2015,2,21501055,3/22/2016,1610612763,Memphis Grizzlies,0,0,1610612747,Los Angeles Lakers,1,1,36,29,65,4,11,15,40,40,80,16,7,23,15,32,23,10,20,96,100
2023,2,22300514,1/9/2024,1610612757,Portland Trail Blazers,0,0,1610612752,New York Knicks,1,1,27,30,57,6,23,29,33,53,86,12,6,18,14,42,19,11,15,94,84
2023,2,22300417,12/27/2023,1610612749,Milwaukee Bucks,0,1,1610612751,Brooklyn Nets,1,0,29,9,38,23,28,51,52,37,89,17,6,23,9,31,41,7,10,101,144
2023,2,22300445,12/31/2023,1610612764,Washington Wizards,1,0,1610612737,Atlanta Hawks,0,1,29,16,45,17,36,53,46,52,98,17,4,21,10,46,35,5,9,108,126
2017,2,21700019,10/20/2017,1610612738,Boston Celtics,0,1,1610612755,Philadelphia 76ers,1,0,25,30,55,10,19,29,35,49,84,22,10,32,18,36,16,7,19,99,102
2017,2,21700019,10/20/2017,1610612755,Philadelphia 76ers,1,0,1610612738,Boston Celtics,0,1,25,35,60,10,22,32,35,57,92,12,4,16,18,41,20,4,17,98,92
2018,2,21800007,10/17/2018,1610612737,Atlanta Hawks,0,0,1610612752,New York Knicks,1,1,31,23,54,10,26,36,41,49,90,15,3,18,12,39,19,12,24,113,107
2018,2,21800007,10/17/2018,1610612752,New York Knicks,1,1,1610612737,Atlanta Hawks,0,0,33,33,66,12,21,33,45,54,99,24,7,31,18,40,21,7,16,111,126
2016,2,21600713,1/29/2017,1610612745,Houston Rockets,0,0,1610612754,Indiana Pacers,1,1,23,21,44,11,28,39,34,49,83,22,3,25,13,38,21,9,15,96,101
2016,2,21600713,1/29/2017,1610612754,Indiana Pacers,1,1,1610612745,Houston Rockets,0,0,42,24,66,5,16,21,47,40,87,21,5,26,10,32,28,7,10,97,120
2014,2,21400937,3/8/2015,1610612742,Dallas Mavericks,0,1,1610612747,Los Angeles Lakers,1,0,29,23,52,9,17,26,38,40,78,15,7,22,8,35,21,5,8,88,100
2014,2,21400937,3/8/2015,1610612747,Los Angeles Lakers,1,0,1610612742,Dallas Mavericks,0,1,36,32,68,2,12,14,38,44,82,15,6,21,19,28,23,10,16,89,93
2017,2,21700018,10/20/2017,1610612754,Indiana Pacers,1,0,1610612757,Portland Trail Blazers,0,1,31,29,60,4,14,18,35,43,78,22,11,33,9,40,15,5,12,97,96
2017,2,21700018,10/20/2017,1610612757,Portland Trail Blazers,0,1,1610612754,Indiana Pacers,1,0,37,39,76,9,10,19,46,49,95,13,4,17,15,35,19,1,9,97,114
2018,2,21800006,10/17/2018,1610612748,Miami Heat,0,0,1610612753,Orlando Magic,1,1,29,35,64,9,24,33,38,59,97,16,6,22,22,40,16,7,17,102,101
2015,2,21501182,4/8/2016,1610612764,Washington Wizards,0,0,1610612765,Detroit Pistons,1,1,32,35,67,6,13,19,38,48,86,17,6,23,14,39,19,5,12,96,99
2015,2,21501182,4/8/2016,1610612765,Detroit Pistons,1,1,1610612764,Washington Wizards,0,0,22,23,45,14,18,32,36,41,77,26,3,29,10,31,17,5,13,96,112
2018,2,21800006,10/17/2018,1610612753,Orlando Magic,1,1,1610612748,Miami Heat,0,0,32,37,69,7,18,25,39,55,94,19,12,31,19,40,20,4,12,101,104
2016,2,21600227,11/25/2016,1610612739,Cleveland Cavaliers,1,1,1610612742,Dallas Mavericks,0,0,23,19,42,20,23,43,43,42,85,22,2,24,14,30,30,5,14,96,128
2016,2,21600227,11/25/2016,1610612742,Dallas Mavericks,0,0,1610612739,Cleveland Cavaliers,1,1,29,27,56,8,27,35,37,54,91,8,4,12,15,42,29,9,14,97,90
2017,2,21700017,10/20/2017,1610612737,Atlanta Hawks,0,0,1610612766,Charlotte Hornets,1,1,29,36,65,7,23,30,36,59,95,12,2,14,13,46,19,5,13,102,91
2017,2,21700017,10/20/2017,1610612766,Charlotte Hornets,1,1,1610612737,Atlanta Hawks,0,0,26,24,50,11,25,36,37,49,86,24,6,30,18,34,17,11,21,101,109
2018,2,21800005,10/17/2018,1610612754,Indiana Pacers,1,1,1610612763,Memphis Grizzlies,0,0,37,20,57,10,16,26,47,36,83,7,6,13,17,22,29,11,20,92,111
2018,2,21800005,10/17/2018,1610612763,Memphis Grizzlies,0,0,1610612754,Indiana Pacers,1,1,15,40,55,10,19,29,25,59,84,23,5,28,15,47,16,2,10,92,83
2014,2,21400936,3/8/2015,1610612760,Oklahoma City Thunder,1,1,1610612761,Toronto Raptors,0,0,36,25,61,6,15,21,42,40,82,18,7,25,18,26,30,12,18,95,108
2014,2,21400936,3/8/2015,1610612761,Toronto Raptors,0,0,1610612760,Oklahoma City Thunder,1,1,31,40,71,11,16,27,42,56,98,9,0,9,17,39,24,6,8,93,104
2018,2,21800004,10/17/2018,1610612751,Brooklyn Nets,0,0,1610612765,Detroit Pistons,1,1,35,20,55,5,22,27,40,42,82,15,7,22,12,34,28,5,19,100,100
2018,2,21800004,10/17/2018,1610612765,Detroit Pistons,1,1,1610612751,Brooklyn Nets,0,0,33,35,68,6,18,24,39,53,92,19,3,22,18,36,21,9,17,100,103
2016,2,21600712,1/29/2017,1610612739,Cleveland Cavaliers,1,1,1610612760,Oklahoma City Thunder,0,0,33,30,63,8,21,29,41,51,92,17,5,22,9,43,22,5,10,103,107
2016,2,21600712,1/29/2017,1610612760,Oklahoma City Thunder,0,0,1610612739,Cleveland Cavaliers,1,1,31,43,74,6,20,26,37,63,100,11,5,16,19,44,20,9,16,105,91
2014,2,21400935,3/8/2015,1610612738,Boston Celtics,0,0,1610612753,Orlando Magic,1,1,20,35,55,15,19,34,35,54,89,13,3,16,18,38,24,8,16,93,98
2014,2,21400935,3/8/2015,1610612753,Orlando Magic,1,1,1610612738,Boston Celtics,0,0,31,34,65,7,15,22,38,49,87,20,10,30,21,32,20,9,15,93,103
2017,2,21700016,10/19/2017,1610612746,LA Clippers,0,1,1610612747,Los Angeles Lakers,1,0,30,44,74,12,21,33,42,65,107,12,1,13,25,40,23,8,15,104,108
2017,2,21700016,10/19/2017,1610612747,Los Angeles Lakers,1,0,1610612746,LA Clippers,0,1,33,42,75,4,12,16,37,54,91,14,9,23,15,43,21,12,20,104,92
2016,2,21600226,11/25/2016,1610612753,Orlando Magic,1,0,1610612764,Washington Wizards,0,1,28,29,57,7,16,23,35,45,80,14,6,20,16,32,18,10,19,92,91
2016,2,21600226,11/25/2016,1610612764,Washington Wizards,0,1,1610612753,Orlando Magic,1,0,34,25,59,6,23,29,40,48,88,8,2,10,13,36,26,5,12,94,94
2017,2,21700015,10/19/2017,1610612752,New York Knicks,0,0,1610612760,Oklahoma City Thunder,1,1,25,30,55,7,17,24,32,47,79,13,6,19,14,34,19,14,26,98,84
2017,2,21700015,10/19/2017,1610612760,Oklahoma City Thunder,1,1,1610612752,New York Knicks,0,0,28,24,52,11,27,38,39,51,90,16,6,22,20,34,26,8,20,100,105
2018,2,21800003,10/17/2018,1610612749,Milwaukee Bucks,0,1,1610612766,Charlotte Hornets,1,0,28,23,51,14,20,34,42,43,85,15,5,20,14,32,26,8,21,101,113
2018,2,21800003,10/17/2018,1610612766,Charlotte Hornets,1,0,1610612749,Milwaukee Bucks,0,1,25,29,54,16,22,38,41,51,92,14,8,22,11,46,21,5,11,102,112
2014,2,21400934,3/8/2015,1610612765,Detroit Pistons,1,0,1610612766,Charlotte Hornets,0,1,36,39,75,3,11,14,39,50,89,20,5,25,15,38,21,6,11,95,101
2014,2,21400934,3/8/2015,1610612766,Charlotte Hornets,0,1,1610612765,Detroit Pistons,1,0,35,27,62,6,11,17,41,38,79,20,3,23,7,32,32,8,10,94,108
2022,2,22200522,12/28/2022,1610612743,Denver Nuggets,0,0,1610612758,Sacramento Kings,1,1,37,21,58,12,15,27,49,36,85,16,2,18,11,25,31,10,16,101,126
2022,2,22200522,12/28/2022,1610612758,Sacramento Kings,1,1,1610612743,Denver Nuggets,0,0,33,25,58,14,17,31,47,42,89,19,6,25,15,30,32,6,12,99,127
2018,2,21800002,10/16/2018,1610612744,Golden State Warriors,1,1,1610612760,Oklahoma City Thunder,0,0,35,34,69,7,19,26,42,53,95,17,1,18,22,31,28,12,21,101,108
2018,2,21800002,10/16/2018,1610612760,Oklahoma City Thunder,0,0,1610612744,Golden State Warriors,1,1,23,31,54,10,27,37,33,58,91,24,13,37,23,43,21,7,15,103,100
2016,2,21600711,1/29/2017,1610612737,Atlanta Hawks,1,1,1610612752,New York Knicks,0,0,42,46,88,10,21,31,52,67,119,28,12,40,25,52,36,9,14,129,142
2015,2,21500736,2/3/2016,1610612737,Atlanta Hawks,0,1,1610612755,Philadelphia 76ers,1,0,38,34,72,10,10,20,48,44,92,18,7,25,17,32,28,7,19,105,124
2015,2,21500736,2/3/2016,1610612755,Philadelphia 76ers,1,0,1610612737,Atlanta Hawks,0,1,29,28,57,6,21,27,35,49,84,10,4,14,10,42,27,13,24,104,86
2014,2,21400933,3/8/2015,1610612751,Brooklyn Nets,1,0,1610612762,Utah Jazz,0,1,30,31,61,8,7,15,38,38,76,4,7,11,9,33,21,6,14,86,88
2014,2,21400933,3/8/2015,1610612762,Utah Jazz,0,1,1610612751,Brooklyn Nets,1,0,24,26,50,10,12,22,34,38,72,17,4,21,16,24,24,9,18,86,95
2016,2,21600711,1/29/2017,1610612752,New York Knicks,0,0,1610612737,Atlanta Hawks,1,1,33,44,77,18,33,51,51,77,128,19,4,23,25,53,32,4,14,129,139
2016,2,21600225,11/25/2016,1610612738,Boston Celtics,1,0,1610612759,San Antonio Spurs,0,1,30,27,57,12,22,34,42,49,91,7,2,9,13,37,32,4,10,94,103
2016,2,21600225,11/25/2016,1610612759,San Antonio Spurs,0,1,1610612738,Boston Celtics,1,0,27,30,57,11,13,24,38,43,81,22,3,25,17,28,24,8,17,93,109
2017,2,21700014,10/19/2017,1610612741,Chicago Bulls,0,0,1610612761,Toronto Raptors,1,1,27,30,57,10,22,32,37,52,89,16,2,18,15,37,22,10,19,101,100
2017,2,21700014,10/19/2017,1610612761,Toronto Raptors,1,1,1610612741,Chicago Bulls,0,0,26,28,54,13,16,29,39,44,83,26,2,28,14,30,26,7,17,100,117
2018,2,21800001,10/16/2018,1610612738,Boston Celtics,1,1,1610612755,Philadelphia 76ers,0,0,31,29,60,11,26,37,42,55,97,10,4,14,14,42,21,8,15,104,105
2018,2,21800001,10/16/2018,1610612755,Philadelphia 76ers,0,0,1610612738,Boston Celtics,1,1,29,32,61,5,21,26,34,53,87,14,9,23,10,47,18,7,16,105,87
2014,2,21400932,3/8/2015,1610612744,Golden State Warriors,1,1,1610612746,LA Clippers,0,0,30,28,58,10,12,22,40,40,80,16,7,23,11,32,23,8,15,95,106
2014,2,21400932,3/8/2015,1610612746,LA Clippers,0,0,1610612744,Golden State Warriors,1,1,32,26,58,8,17,25,40,43,83,10,4,14,13,32,25,13,18,95,98
2017,2,21700013,10/18/2017,1610612745,Houston Rockets,0,1,1610612758,Sacramento Kings,1,0,21,17,38,12,33,45,33,50,83,27,2,29,16,35,19,5,16,98,105
2017,2,21700013,10/18/2017,1610612758,Sacramento Kings,1,0,1610612745,Houston Rockets,0,1,34,31,65,8,15,23,42,46,88,8,2,10,14,34,19,7,18,99,100
2016,2,21600710,1/28/2017,1610612750,Minnesota Timberwolves,1,1,1610612751,Brooklyn Nets,0,0,38,35,73,9,11,20,47,46,93,26,6,32,15,35,27,6,11,104,129
2016,2,21600710,1/28/2017,1610612751,Brooklyn Nets,0,0,1610612750,Minnesota Timberwolves,1,1,34,30,64,7,14,21,41,44,85,20,5,25,8,38,20,8,15,103,109
2016,2,21600224,11/23/2016,1610612758,Sacramento Kings,1,1,1610612760,Oklahoma City Thunder,0,0,32,34,66,12,16,28,44,50,94,16,1,17,15,35,26,7,11,99,116
2014,2,21400931,3/8/2015,1610612741,Chicago Bulls,0,0,1610612759,San Antonio Spurs,1,1,32,26,58,5,10,15,37,36,73,26,3,29,10,29,20,15,22,98,105
2014,2,21400931,3/8/2015,1610612759,San Antonio Spurs,1,1,1610612741,Chicago Bulls,0,0,35,33,68,9,13,22,44,46,90,19,5,24,10,39,14,6,7,99,116
2016,2,21600224,11/23/2016,1610612760,Oklahoma City Thunder,0,0,1610612758,Sacramento Kings,1,1,25,26,51,7,18,25,32,44,76,30,8,38,5,42,18,4,9,98,101
2017,2,21700012,10/18/2017,1610612756,Phoenix Suns,1,0,1610612757,Portland Trail Blazers,0,1,21,41,62,7,20,27,28,61,89,13,5,18,16,45,10,8,16,99,76
2017,2,21700012,10/18/2017,1610612757,Portland Trail Blazers,0,1,1610612756,Phoenix Suns,1,0,30,36,66,14,10,24,44,46,90,22,6,28,22,26,22,9,18,98,124
2016,2,21600709,1/28/2017,1610612743,Denver Nuggets,0,1,1610612756,Phoenix Suns,1,0,31,24,55,8,17,25,39,41,80,37,5,42,11,33,17,9,15,101,123
2016,2,21600709,1/28/2017,1610612756,Phoenix Suns,1,0,1610612743,Denver Nuggets,0,1,35,35,70,6,15,21,41,50,91,24,8,32,14,41,20,7,11,100,112
2014,2,21400930,3/7/2015,1610612743,Denver Nuggets,1,0,1610612745,Houston Rockets,0,1,29,33,62,9,21,30,38,54,92,15,4,19,12,44,23,11,18,106,100
2014,2,21400930,3/7/2015,1610612745,Houston Rockets,0,1,1610612743,Denver Nuggets,1,0,30,28,58,10,18,28,40,46,86,24,8,32,16,34,25,16,22,107,114
2016,2,21600223,11/23/2016,1610612744,Golden State Warriors,1,1,1610612747,Los Angeles Lakers,0,0,34,16,50,19,17,36,53,33,86,24,11,35,7,32,47,5,10,105,149
2016,2,21600223,11/23/2016,1610612747,Los Angeles Lakers,0,0,1610612744,Golden State Warriors,1,1,32,41,73,8,12,20,40,53,93,18,4,22,12,43,22,7,12,104,106
2015,2,21501111,3/29/2016,1610612739,Cleveland Cavaliers,1,0,1610612745,Houston Rockets,0,1,17,29,46,14,26,40,31,55,86,24,4,28,16,42,21,7,13,96,100
2015,2,21501111,3/29/2016,1610612745,Houston Rockets,0,1,1610612739,Cleveland Cavaliers,1,0,29,25,54,9,16,25,38,41,79,21,21,42,19,33,23,5,15,96,106
2014,2,21400929,3/7/2015,1610612749,Milwaukee Bucks,1,1,1610612764,Washington Wizards,0,0,26,32,58,10,10,20,36,42,78,9,6,15,10,36,25,9,17,92,91
2014,2,21400929,3/7/2015,1610612764,Washington Wizards,0,0,1610612749,Milwaukee Bucks,1,1,22,31,53,9,19,28,31,50,81,14,8,22,15,38,19,7,17,94,85
2017,2,21700011,10/18/2017,1610612750,Minnesota Timberwolves,0,0,1610612759,San Antonio Spurs,1,1,29,37,66,8,11,19,37,48,85,17,6,23,12,37,23,8,13,94,99
2017,2,21700011,10/18/2017,1610612759,San Antonio Spurs,1,1,1610612750,Minnesota Timberwolves,0,0,33,35,68,8,13,21,41,48,89,17,2,19,17,33,22,7,11,93,107
2014,2,21400928,3/7/2015,1610612750,Minnesota Timberwolves,1,1,1610612757,Portland Trail Blazers,0,0,42,36,78,4,3,7,46,39,85,25,6,31,14,29,26,3,8,95,121
2014,2,21400928,3/7/2015,1610612757,Portland Trail Blazers,0,0,1610612750,Minnesota Timberwolves,1,1,29,32,61,14,13,27,43,45,88,13,4,17,10,35,18,7,10,96,113
2017,2,21700010,10/18/2017,1610612743,Denver Nuggets,0,0,1610612762,Utah Jazz,1,1,23,27,50,13,14,27,36,41,77,11,1,12,9,32,21,9,21,95,96
2017,2,21700010,10/18/2017,1610612762,Utah Jazz,1,1,1610612743,Denver Nuggets,0,0,32,25,57,9,15,24,41,40,81,15,1,16,8,32,28,4,15,95,106
2016,2,21600708,1/28/2017,1610612762,Utah Jazz,1,0,1610612763,Memphis Grizzlies,0,1,19,18,37,10,15,25,29,33,62,27,2,29,6,27,19,8,13,83,95
2016,2,21600708,1/28/2017,1610612763,Memphis Grizzlies,0,1,1610612762,Utah Jazz,1,0,30,24,54,11,15,26,41,39,80,9,1,10,10,29,13,3,7,83,102
2016,2,21600222,11/23/2016,1610612740,New Orleans Pelicans,1,1,1610612750,Minnesota Timberwolves,0,0,36,23,59,9,15,24,45,38,83,18,5,23,7,33,27,12,17,104,117
2016,2,21600222,11/23/2016,1610612750,Minnesota Timberwolves,0,0,1610612740,New Orleans Pelicans,1,1,30,39,69,3,14,17,33,53,86,27,6,33,13,43,23,10,17,105,96
2023,2,22300850,2/29/2024,1610612762,Utah Jazz,0,0,1610612753,Orlando Magic,1,1,18,25,43,16,21,37,34,46,80,23,5,28,11,36,25,9,13,96,107
2022,2,22200532,12/30/2022,1610612741,Chicago Bulls,1,1,1610612765,Detroit Pistons,0,0,41,24,65,12,15,27,53,39,92,14,1,15,15,24,21,8,14,98,132
2022,2,22200532,12/30/2022,1610612765,Detroit Pistons,0,0,1610612741,Chicago Bulls,1,1,24,23,47,17,22,39,41,45,86,19,5,24,18,30,28,10,16,97,118
2015,2,21501001,3/15/2016,1610612746,LA Clippers,0,0,1610612759,San Antonio Spurs,1,1,24,26,50,8,11,19,32,37,69,15,7,22,9,31,15,6,15,86,87
2015,2,21501001,3/15/2016,1610612759,San Antonio Spurs,1,1,1610612746,LA Clippers,0,0,36,26,62,8,12,20,44,38,82,12,4,16,14,25,25,5,10,86,108
2015,2,21500949,3/8/2016,1610612747,Los Angeles Lakers,1,1,1610612753,Orlando Magic,0,0,31,23,54,9,18,27,40,41,81,18,5,23,13,31,21,5,15,95,107
2014,2,21400927,3/7/2015,1610612737,Atlanta Hawks,0,0,1610612755,Philadelphia 76ers,1,1,19,33,52,11,14,25,30,47,77,13,3,16,6,42,20,14,19,99,84
2014,2,21400927,3/7/2015,1610612755,Philadelphia 76ers,1,1,1610612737,Atlanta Hawks,0,0,22,36,58,13,24,37,35,60,95,9,8,17,21,41,24,8,16,99,92
2017,2,21700009,10/18/2017,1610612737,Atlanta Hawks,0,1,1610612742,Dallas Mavericks,1,0,39,37,76,9,9,18,48,46,94,12,3,15,15,34,20,5,13,100,117
2017,2,21700009,10/18/2017,1610612742,Dallas Mavericks,1,0,1610612737,Atlanta Hawks,0,1,21,20,41,17,28,45,38,48,86,18,3,21,10,39,27,11,16,101,111
2016,2,21600707,1/28/2017,1610612744,Golden State Warriors,1,1,1610612746,LA Clippers,0,0,40,18,58,17,17,34,57,35,92,13,3,16,11,25,35,7,11,99,144
2016,2,21600707,1/28/2017,1610612746,LA Clippers,0,0,1610612744,Golden State Warriors,1,1,24,30,54,12,16,28,36,46,82,14,8,22,8,42,24,9,14,98,98
2016,2,21600221,11/23/2016,1610612743,Denver Nuggets,0,0,1610612762,Utah Jazz,1,1,19,42,61,9,18,27,28,60,88,18,13,31,15,50,14,4,10,98,83
2016,2,21600221,11/23/2016,1610612762,Utah Jazz,1,1,1610612743,Denver Nuggets,0,0,31,22,53,8,18,26,39,40,79,22,9,31,8,38,19,5,14,99,108
2022,2,22200488,12/23/2022,1610612740,New Orleans Pelicans,0,1,1610612760,Oklahoma City Thunder,1,0,28,29,57,13,24,37,41,53,94,33,7,40,17,38,30,9,21,119,128
2017,2,21700008,10/18/2017,1610612740,New Orleans Pelicans,0,0,1610612763,Memphis Grizzlies,1,1,23,31,54,7,18,25,30,49,79,24,5,29,17,32,15,9,18,94,91
2017,2,21700008,10/18/2017,1610612763,Memphis Grizzlies,1,1,1610612740,New Orleans Pelicans,0,0,30,33,63,9,20,29,39,53,92,16,12,28,24,37,19,4,12,95,103
2022,2,22200488,12/23/2022,1610612760,Oklahoma City Thunder,1,0,1610612740,New Orleans Pelicans,0,1,34,33,67,13,22,35,47,55,102,18,7,25,12,46,27,10,18,120,125
2023,2,22300212,11/19/2023,1610612758,Sacramento Kings,0,1,1610612742,Dallas Mavericks,1,0,31,19,50,17,23,40,48,42,90,16,5,21,15,30,34,8,13,96,129
2023,2,22300502,1/7/2024,1610612743,Denver Nuggets,1,1,1610612765,Detroit Pistons,0,0,37,16,53,10,17,27,47,33,80,27,4,31,10,25,35,6,13,96,131
2014,2,21400926,3/7/2015,1610612752,New York Knicks,1,0,1610612754,Indiana Pacers,0,1,27,36,63,3,12,15,30,48,78,23,7,30,18,33,13,5,13,88,86
2017,2,21700007,10/18/2017,1610612738,Boston Celtics,1,0,1610612749,Milwaukee Bucks,0,1,28,35,63,11,17,28,39,52,91,11,10,21,17,41,23,6,15,99,100
2017,2,21700007,10/18/2017,1610612749,Milwaukee Bucks,0,1,1610612738,Boston Celtics,1,0,31,24,55,7,14,21,38,38,76,25,5,30,7,33,19,12,15,100,108
2016,2,21600706,1/28/2017,1610612738,Boston Celtics,0,1,1610612749,Milwaukee Bucks,1,0,23,25,48,14,27,41,37,52,89,24,6,30,13,42,26,6,13,104,112
2016,2,21600706,1/28/2017,1610612749,Milwaukee Bucks,1,0,1610612738,Boston Celtics,0,1,28,38,66,9,12,21,37,50,87,25,7,32,13,41,23,6,16,104,108
2014,2,21400926,3/7/2015,1610612754,Indiana Pacers,0,1,1610612752,New York Knicks,1,0,23,38,61,7,11,18,30,49,79,25,5,30,19,32,16,4,12,87,92
2017,2,21700006,10/18/2017,1610612755,Philadelphia 76ers,0,0,1610612764,Washington Wizards,1,1,28,30,58,15,20,35,43,50,93,14,5,19,14,38,25,8,17,105,115
2017,2,21700006,10/18/2017,1610612764,Washington Wizards,1,1,1610612755,Philadelphia 76ers,0,0,36,39,75,6,16,22,42,55,97,30,8,38,19,39,21,6,10,106,120
2014,2,21400925,3/7/2015,1610612748,Miami Heat,1,1,1610612758,Sacramento Kings,0,0,34,22,56,7,17,24,41,39,80,25,8,33,6,37,23,7,14,104,114
2016,2,21600705,1/28/2017,1610612748,Miami Heat,1,1,1610612765,Detroit Pistons,0,0,28,24,52,14,14,28,42,38,80,18,5,23,11,30,18,6,11,90,116
2016,2,21600705,1/28/2017,1610612765,Detroit Pistons,0,0,1610612748,Miami Heat,1,1,42,35,77,4,8,12,46,43,89,7,5,12,16,31,11,6,12,91,103
2016,2,21600220,11/23/2016,1610612742,Dallas Mavericks,1,0,1610612746,LA Clippers,0,1,27,33,60,11,13,24,38,46,84,17,1,18,10,37,23,11,16,98,104
2016,2,21600220,11/23/2016,1610612746,LA Clippers,0,1,1610612742,Dallas Mavericks,1,0,28,25,53,15,17,32,43,42,85,23,8,31,11,36,26,7,10,100,124
2014,2,21400925,3/7/2015,1610612758,Sacramento Kings,0,0,1610612748,Miami Heat,1,1,30,33,63,10,15,25,40,48,88,19,5,24,16,35,26,13,22,106,109
2017,2,21700005,10/18/2017,1610612748,Miami Heat,0,0,1610612753,Orlando Magic,1,1,36,35,71,8,22,30,44,57,101,13,4,17,19,40,27,8,13,104,109
2017,2,21700005,10/18/2017,1610612753,Orlando Magic,1,1,1610612748,Miami Heat,0,0,35,34,69,8,13,21,43,47,90,22,7,29,16,35,22,6,15,103,116
2014,2,21400924,3/7/2015,1610612739,Cleveland Cavaliers,1,1,1610612756,Phoenix Suns,0,0,23,32,55,8,12,20,31,44,75,19,4,23,14,32,22,6,15,87,89
2014,2,21400924,3/7/2015,1610612756,Phoenix Suns,0,0,1610612739,Cleveland Cavaliers,1,1,21,38,59,9,16,25,30,54,84,10,4,14,17,39,20,5,11,86,79
2023,2,22300212,11/19/2023,1610612742,Dallas Mavericks,1,0,1610612758,Sacramento Kings,0,1,29,25,54,12,22,34,41,47,88,19,7,26,15,36,23,9,10,96,113
2023,2,22300323,12/14/2023,1610612757,Portland Trail Blazers,1,0,1610612762,Utah Jazz,0,1,27,31,58,16,29,45,43,60,103,12,6,18,29,35,30,9,11,95,114
2022,2,22200014,10/19/2022,1610612757,Portland Trail Blazers,0,1,1610612758,Sacramento Kings,1,0,28,32,60,11,17,28,39,49,88,26,7,33,14,39,20,8,11,101,115
2017,2,21700004,10/18/2017,1610612751,Brooklyn Nets,0,0,1610612754,Indiana Pacers,1,1,33,31,64,12,18,30,45,49,94,29,3,32,16,35,22,12,20,111,131
2017,2,21700004,10/18/2017,1610612754,Indiana Pacers,1,1,1610612751,Brooklyn Nets,0,0,44,24,68,9,25,34,53,49,102,25,7,32,20,34,29,7,14,111,140
2016,2,21600704,1/28/2017,1610612758,Sacramento Kings,0,1,1610612766,Charlotte Hornets,1,0,30,22,52,11,16,27,41,38,79,16,10,26,12,31,27,4,10,92,109
2016,2,21600704,1/28/2017,1610612766,Charlotte Hornets,1,0,1610612758,Sacramento Kings,0,1,24,14,38,12,25,37,36,39,75,22,2,24,8,32,24,6,11,91,106
2021,2,22100279,11/24/2021,1610612757,Portland Trail Blazers,0,0,1610612758,Sacramento Kings,1,1,32,24,56,12,26,38,44,50,94,21,4,25,17,34,27,4,15,102,121
2017,2,21700003,10/18/2017,1610612765,Detroit Pistons,1,1,1610612766,Charlotte Hornets,0,0,32,38,70,9,17,26,41,55,96,11,1,12,11,45,24,4,9,98,102
2017,2,21700003,10/18/2017,1610612766,Charlotte Hornets,0,0,1610612765,Detroit Pistons,1,1,20,23,43,9,21,30,29,44,73,23,6,29,7,39,16,14,17,99,90
2016,2,21600219,11/23/2016,1610612745,Houston Rockets,1,0,1610612761,Toronto Raptors,0,1,24,12,36,14,28,42,38,40,78,12,0,12,15,26,29,14,28,99,102
2016,2,21600219,11/23/2016,1610612761,Toronto Raptors,0,1,1610612745,Houston Rockets,1,0,31,34,65,12,11,23,43,45,88,17,4,21,16,31,28,6,16,98,115
2021,2,22100279,11/24/2021,1610612758,Sacramento Kings,1,1,1610612757,Portland Trail Blazers,0,0,33,20,53,12,21,33,45,41,86,23,11,34,15,31,21,9,14,100,125
2015,2,21501181,4/8/2016,1610612738,Boston Celtics,1,1,1610612749,Milwaukee Bucks,0,0,38,26,64,6,8,14,44,34,78,30,8,38,8,31,35,10,15,103,124
2015,2,21501181,4/8/2016,1610612749,Milwaukee Bucks,0,0,1610612738,Boston Celtics,1,1,34,33,67,7,10,17,41,43,84,20,9,29,15,33,30,6,21,101,109
2015,2,21500949,3/8/2016,1610612753,Orlando Magic,0,0,1610612747,Los Angeles Lakers,1,1,32,25,57,5,14,19,37,39,76,19,8,27,6,36,19,7,11,94,98
2015,2,21500649,1/22/2016,1610612748,Miami Heat,0,0,1610612761,Toronto Raptors,1,1,29,35,64,4,13,17,33,48,81,11,6,17,15,37,13,4,13,87,81
2015,2,21500649,1/22/2016,1610612761,Toronto Raptors,1,1,1610612748,Miami Heat,0,0,22,28,50,13,12,25,35,40,75,18,3,21,12,30,19,4,14,88,101
2015,2,21500290,12/5/2015,1610612744,Golden State Warriors,0,1,1610612761,Toronto Raptors,1,0,19,24,43,16,14,30,35,38,73,26,10,36,11,30,22,9,12,92,112
2015,2,21500290,12/5/2015,1610612761,Toronto Raptors,1,0,1610612744,Golden State Warriors,0,1,32,39,71,8,12,20,40,51,91,21,5,26,18,37,21,2,6,93,109
2015,2,21500194,11/21/2015,1610612745,Houston Rockets,1,0,1610612752,New York Knicks,0,1,23,30,53,12,16,28,35,46,81,20,8,28,21,29,18,4,12,86,102
2017,2,21700002,10/17/2017,1610612744,Golden State Warriors,1,0,1610612745,Houston Rockets,0,1,27,23,50,16,14,30,43,37,80,19,2,21,6,32,34,9,17,100,121
2017,2,21700002,10/17/2017,1610612745,Houston Rockets,0,1,1610612744,Golden State Warriors,1,0,32,24,56,15,26,41,47,50,97,13,6,19,18,37,28,5,13,101,122
2016,2,21600703,1/27/2017,1610612757,Portland Trail Blazers,1,1,1610612763,Memphis Grizzlies,0,0,22,24,46,16,19,35,38,43,81,20,1,21,11,32,24,6,12,92,112
2016,2,21600703,1/27/2017,1610612763,Memphis Grizzlies,0,0,1610612757,Portland Trail Blazers,1,1,28,23,51,9,17,26,37,40,77,26,7,33,11,30,24,2,11,92,109
2014,2,21400923,3/7/2015,1610612740,New Orleans Pelicans,1,1,1610612763,Memphis Grizzlies,0,0,30,27,57,8,15,23,38,42,80,11,2,13,11,32,24,15,18,95,95
2014,2,21400923,3/7/2015,1610612763,Memphis Grizzlies,0,0,1610612740,New Orleans Pelicans,1,1,26,32,58,6,10,16,32,42,74,19,10,29,8,38,26,8,14,94,89
2015,2,21501000,3/15/2016,1610612749,Milwaukee Bucks,1,0,1610612761,Toronto Raptors,0,1,32,32,64,2,11,13,34,43,77,19,7,26,12,36,18,4,7,88,89
2015,2,21501000,3/15/2016,1610612761,Toronto Raptors,0,1,1610612749,Milwaukee Bucks,1,0,25,28,53,14,16,30,39,44,83,15,2,17,14,30,27,8,10,87,107
2015,2,21500948,3/8/2016,1610612757,Portland Trail Blazers,1,1,1610612764,Washington Wizards,0,0,31,34,65,10,14,24,41,48,89,24,7,31,17,35,24,9,20,108,116
2015,2,21500948,3/8/2016,1610612764,Washington Wizards,0,0,1610612757,Portland Trail Blazers,1,1,37,42,79,8,12,20,45,54,99,11,12,23,15,46,26,2,12,107,109
2015,2,21500890,2/29/2016,1610612746,LA Clippers,1,1,1610612751,Brooklyn Nets,0,0,32,28,60,9,14,23,41,42,83,14,2,16,9,34,22,10,12,94,105
2016,2,21600702,1/27/2017,1610612737,Atlanta Hawks,1,0,1610612764,Washington Wizards,0,1,21,31,52,9,22,31,30,53,83,17,8,25,16,40,18,12,20,100,86
2016,2,21600702,1/27/2017,1610612764,Washington Wizards,0,1,1610612737,Atlanta Hawks,1,0,30,28,58,13,18,31,43,46,89,13,6,19,17,34,26,9,20,100,112
2014,2,21400922,3/6/2015,1610612742,Dallas Mavericks,0,0,1610612744,Golden State Warriors,1,1,26,41,67,6,14,20,32,55,87,19,7,26,12,46,17,5,13,101,89
2014,2,21400922,3/6/2015,1610612744,Golden State Warriors,1,1,1610612742,Dallas Mavericks,0,0,27,31,58,11,12,23,38,43,81,17,2,19,12,32,28,15,22,100,104
2023,2,22300460,1/2/2024,1610612763,Memphis Grizzlies,1,1,1610612759,San Antonio Spurs,0,0,25,17,42,12,26,38,37,43,80,20,5,25,10,36,24,6,15,97,106
2023,2,22300502,1/7/2024,1610612765,Detroit Pistons,0,0,1610612743,Denver Nuggets,1,1,33,32,65,9,15,24,42,47,89,21,9,30,19,35,28,6,13,97,114
2023,2,22300747,2/9/2024,1610612740,New Orleans Pelicans,0,0,1610612747,Los Angeles Lakers,1,1,35,25,60,11,18,29,46,43,89,19,4,23,13,32,28,5,13,100,122
2017,2,21700001,10/17/2017,1610612738,Boston Celtics,0,0,1610612739,Cleveland Cavaliers,1,1,28,28,56,8,24,32,36,52,88,19,6,25,13,43,24,3,12,99,99
2017,2,21700001,10/17/2017,1610612739,Cleveland Cavaliers,1,1,1610612738,Boston Celtics,0,0,33,28,61,5,17,22,38,45,83,21,4,25,11,37,19,11,17,99,102
2016,2,21600701,1/27/2017,1610612740,New Orleans Pelicans,1,1,1610612759,San Antonio Spurs,0,0,35,28,63,13,17,30,48,45,93,10,4,14,15,33,29,10,14,97,119
2016,2,21600701,1/27/2017,1610612759,San Antonio Spurs,0,0,1610612740,New Orleans Pelicans,1,1,21,36,57,12,16,28,33,52,85,25,4,29,14,39,20,8,12,100,103
2016,2,21600218,11/23/2016,1610612748,Miami Heat,0,0,1610612765,Detroit Pistons,1,1,20,29,49,7,19,26,27,48,75,23,7,30,10,41,19,8,14,94,84
2016,2,21600218,11/23/2016,1610612765,Detroit Pistons,1,1,1610612748,Miami Heat,0,0,34,28,62,6,13,19,40,41,81,21,4,25,13,30,22,5,14,93,107
2015,2,21501110,3/29/2016,1610612760,Oklahoma City Thunder,0,0,1610612765,Detroit Pistons,1,1,25,36,61,6,15,21,31,51,82,14,8,22,18,37,16,6,19,93,82
2015,2,21501110,3/29/2016,1610612765,Detroit Pistons,1,1,1610612760,Oklahoma City Thunder,0,0,29,39,68,4,15,19,33,54,87,18,2,20,20,36,20,10,16,93,88
2015,2,21500890,2/29/2016,1610612751,Brooklyn Nets,0,0,1610612746,LA Clippers,1,1,24,34,58,8,11,19,32,45,77,23,10,33,14,39,25,8,15,94,95
2015,2,21500826,2/21/2016,1610612756,Phoenix Suns,1,0,1610612759,San Antonio Spurs,0,1,34,35,69,9,15,24,43,50,93,16,6,22,17,37,26,10,14,101,111
2016,2,21600700,1/27/2017,1610612741,Chicago Bulls,1,0,1610612748,Miami Heat,0,1,30,35,65,3,10,13,33,45,78,19,6,25,12,35,19,14,21,97,88
2016,2,21600700,1/27/2017,1610612748,Miami Heat,0,1,1610612741,Chicago Bulls,1,0,32,33,65,9,15,24,41,48,89,9,2,11,10,40,25,7,12,97,100
2016,2,21600217,11/23/2016,1610612738,Boston Celtics,0,1,1610612751,Brooklyn Nets,1,0,30,30,60,15,23,38,45,53,98,6,2,8,14,40,26,7,14,101,111
2016,2,21600217,11/23/2016,1610612751,Brooklyn Nets,1,0,1610612738,Boston Celtics,0,1,24,31,55,10,21,31,34,52,86,14,8,22,15,40,18,13,19,102,92
2014,2,21400921,3/6/2015,1610612743,Denver Nuggets,0,0,1610612759,San Antonio Spurs,1,1,39,30,69,6,11,17,45,41,86,15,8,23,12,35,21,8,13,99,111
2014,2,21400921,3/6/2015,1610612759,San Antonio Spurs,1,1,1610612743,Denver Nuggets,0,0,34,21,55,9,15,24,43,36,79,25,8,33,5,33,24,7,9,99,120
2023,2,22300325,12/14/2023,1610612744,Golden State Warriors,0,0,1610612746,LA Clippers,1,1,24,23,47,16,29,45,40,52,92,17,2,19,18,34,22,6,13,96,113
2023,2,22300335,12/16/2023,1610612755,Philadelphia 76ers,0,1,1610612766,Charlotte Hornets,1,0,39,18,57,14,17,31,53,35,88,15,2,17,7,29,30,3,10,98,135
2023,2,22300747,2/9/2024,1610612747,Los Angeles Lakers,1,1,1610612740,New Orleans Pelicans,0,0,35,22,57,14,17,31,49,39,88,27,5,32,10,31,32,5,8,100,139
2023,2,22300345,12/17/2023,1610612759,San Antonio Spurs,1,0,1610612740,New Orleans Pelicans,0,1,25,27,52,15,27,42,40,54,94,15,6,21,11,43,29,11,13,108,110
2023,2,22300850,2/29/2024,1610612753,Orlando Magic,1,1,1610612762,Utah Jazz,0,0,32,15,47,10,20,30,42,35,77,21,10,31,11,31,27,8,15,96,115
2014,2,21400920,3/6/2015,1610612748,Miami Heat,0,0,1610612764,Washington Wizards,1,1,27,25,52,10,17,27,37,42,79,13,6,19,10,35,18,6,15,94,97
2014,2,21400920,3/6/2015,1610612764,Washington Wizards,1,1,1610612748,Miami Heat,0,0,31,28,59,7,16,23,38,44,82,16,2,18,15,30,24,5,17,95,99
2016,2,21600699,1/27/2017,1610612752,New York Knicks,1,1,1610612766,Charlotte Hornets,0,0,37,32,69,9,18,27,46,50,96,9,4,13,13,38,22,5,10,97,110
2016,2,21600699,1/27/2017,1610612766,Charlotte Hornets,0,0,1610612752,New York Knicks,1,1,27,26,53,13,24,37,40,50,90,14,1,15,13,38,18,8,13,99,107
2016,2,21600216,11/23/2016,1610612737,Atlanta Hawks,0,1,1610612754,Indiana Pacers,1,0,31,34,65,5,15,20,36,49,85,19,3,22,19,32,17,15,22,97,96
2016,2,21600216,11/23/2016,1610612754,Indiana Pacers,1,0,1610612737,Atlanta Hawks,0,1,27,30,57,7,20,27,34,50,84,10,4,14,12,41,16,11,20,97,85
2016,2,21600698,1/27/2017,1610612749,Milwaukee Bucks,0,0,1610612761,Toronto Raptors,1,1,24,33,57,7,16,23,31,49,80,17,7,24,16,35,19,9,19,94,86
2016,2,21600698,1/27/2017,1610612761,Toronto Raptors,1,1,1610612749,Milwaukee Bucks,0,0,27,32,59,10,15,25,37,47,84,18,5,23,15,33,20,6,16,95,102
2014,2,21400919,3/6/2015,1610612738,Boston Celtics,0,1,1610612740,New Orleans Pelicans,1,0,26,30,56,10,13,23,36,43,79,22,3,25,8,37,19,5,11,94,104
2014,2,21400919,3/6/2015,1610612740,New Orleans Pelicans,1,0,1610612738,Boston Celtics,0,1,30,29,59,8,13,21,38,42,80,14,1,15,12,31,22,8,18,95,98
2016,2,21600697,1/27/2017,1610612738,Boston Celtics,1,1,1610612753,Orlando Magic,0,0,34,21,55,16,18,34,50,39,89,12,3,15,8,33,39,7,10,98,128
2016,2,21600697,1/27/2017,1610612753,Orlando Magic,0,0,1610612738,Boston Celtics,1,1,29,33,62,9,16,25,38,49,87,13,5,18,10,41,29,8,12,98,98
2016,2,21600215,11/23/2016,1610612739,Cleveland Cavaliers,1,1,1610612757,Portland Trail Blazers,0,0,27,27,54,21,15,36,48,42,90,20,7,27,16,30,30,6,11,95,137
2016,2,21600215,11/23/2016,1610612757,Portland Trail Blazers,0,0,1610612739,Cleveland Cavaliers,1,1,34,27,61,13,16,29,47,43,90,18,1,19,11,33,27,6,9,95,125
2016,2,21600696,1/27/2017,1610612754,Indiana Pacers,1,1,1610612758,Sacramento Kings,0,0,28,22,50,10,18,28,38,40,78,29,4,33,9,33,19,7,10,93,115
2016,2,21600696,1/27/2017,1610612758,Sacramento Kings,0,0,1610612754,Indiana Pacers,1,1,22,23,45,13,12,25,35,35,70,28,8,36,13,25,22,14,19,94,111
2014,2,21400918,3/6/2015,1610612747,Los Angeles Lakers,0,0,1610612763,Memphis Grizzlies,1,1,34,38,72,5,7,12,39,45,84,7,2,9,8,37,22,7,10,89,90
2014,2,21400918,3/6/2015,1610612763,Memphis Grizzlies,1,1,1610612747,Los Angeles Lakers,0,0,33,33,66,1,10,11,34,43,77,28,5,33,9,39,18,6,8,91,97
2015,2,21501054,3/22/2016,1610612745,Houston Rockets,0,0,1610612760,Oklahoma City Thunder,1,1,27,28,55,13,24,37,40,52,92,14,3,17,18,36,26,10,17,101,107
2015,2,21501054,3/22/2016,1610612760,Oklahoma City Thunder,1,1,1610612745,Houston Rockets,0,0,33,23,56,8,27,35,41,50,91,21,8,29,20,35,22,9,13,101,111
2015,2,21500999,3/15/2016,1610612751,Brooklyn Nets,1,1,1610612755,Philadelphia 76ers,0,0,37,29,66,10,14,24,47,43,90,27,4,31,18,27,23,6,13,101,131
2015,2,21500999,3/15/2016,1610612755,Philadelphia 76ers,0,0,1610612751,Brooklyn Nets,1,1,30,28,58,11,19,30,41,47,88,21,5,26,11,40,26,12,17,102,114
2016,2,21600695,1/27/2017,1610612739,Cleveland Cavaliers,1,1,1610612751,Brooklyn Nets,0,0,36,20,56,13,23,36,49,43,92,13,7,20,13,34,26,9,14,102,124
2016,2,21600695,1/27/2017,1610612751,Brooklyn Nets,0,0,1610612739,Cleveland Cavaliers,1,1,27,27,54,16,17,33,43,44,87,14,2,16,6,39,23,4,11,102,116
2016,2,21600214,11/23/2016,1610612753,Orlando Magic,1,0,1610612756,Phoenix Suns,0,1,26,40,66,7,18,25,33,58,91,14,9,23,21,43,17,6,11,95,87
2016,2,21600214,11/23/2016,1610612756,Phoenix Suns,0,1,1610612753,Orlando Magic,1,0,24,27,51,9,13,22,33,40,73,17,5,22,7,36,15,9,17,94,92
2023,2,22300789,2/14/2024,1610612744,Golden State Warriors,1,0,1610612746,LA Clippers,0,1,29,27,56,18,29,47,47,56,103,13,5,18,17,41,34,6,9,104,125
2016,2,21600694,1/27/2017,1610612745,Houston Rockets,0,1,1610612755,Philadelphia 76ers,1,0,30,20,50,12,19,31,42,39,81,27,1,28,9,30,25,14,25,108,123
2016,2,21600694,1/27/2017,1610612755,Philadelphia 76ers,1,0,1610612745,Houston Rockets,0,1,32,21,53,10,15,25,42,36,78,24,8,32,6,36,29,10,22,108,118
2016,2,21600213,11/23/2016,1610612759,San Antonio Spurs,0,1,1610612766,Charlotte Hornets,1,0,31,24,55,13,18,31,44,42,86,18,2,20,11,32,28,3,10,96,119
2016,2,21600213,11/23/2016,1610612766,Charlotte Hornets,1,0,1610612759,San Antonio Spurs,0,1,34,35,69,11,9,20,45,44,89,13,5,18,17,30,30,9,16,95,114
2014,2,21400917,3/6/2015,1610612745,Houston Rockets,1,1,1610612765,Detroit Pistons,0,0,32,31,63,6,22,28,38,53,91,21,4,25,21,34,23,12,19,101,103
2014,2,21400917,3/6/2015,1610612765,Detroit Pistons,0,0,1610612745,Houston Rockets,1,1,31,42,73,6,23,29,37,65,102,13,4,17,23,45,20,6,13,101,93
2023,2,22300345,12/17/2023,1610612740,New Orleans Pelicans,0,1,1610612759,San Antonio Spurs,1,0,33,23,56,22,20,42,55,43,98,14,8,22,15,32,38,6,15,107,146
2023,2,22300789,2/14/2024,1610612746,LA Clippers,0,1,1610612744,Golden State Warriors,1,0,31,19,50,13,25,38,44,44,88,29,8,37,13,36,28,7,12,102,130
2023,2,22300462,1/2/2024,1610612760,Oklahoma City Thunder,1,1,1610612738,Boston Celtics,0,0,30,21,51,18,22,40,48,43,91,13,4,17,13,31,34,7,12,98,127
2023,2,22300504,1/7/2024,1610612761,Toronto Raptors,0,1,1610612744,Golden State Warriors,1,0,40,21,61,15,18,33,55,39,94,8,6,14,11,31,38,5,7,97,133
2016,2,21600693,1/26/2017,1610612747,Los Angeles Lakers,0,0,1610612762,Utah Jazz,1,1,32,38,70,4,10,14,36,48,84,12,1,13,12,36,13,7,13,90,88
2016,2,21600693,1/26/2017,1610612762,Utah Jazz,1,1,1610612747,Los Angeles Lakers,0,0,27,28,55,6,20,26,33,48,81,24,4,28,13,39,13,5,8,91,96
2014,2,21400916,3/6/2015,1610612751,Brooklyn Nets,1,0,1610612756,Phoenix Suns,0,1,26,49,75,8,14,22,34,63,97,24,5,29,22,43,21,13,20,110,100
2014,2,21400916,3/6/2015,1610612756,Phoenix Suns,0,1,1610612751,Brooklyn Nets,1,0,36,29,65,3,23,26,39,52,91,27,8,35,15,41,19,5,15,110,108
2015,2,21501180,4/8/2016,1610612752,New York Knicks,0,1,1610612755,Philadelphia 76ers,1,0,39,36,75,4,12,16,43,48,91,19,10,29,16,37,19,7,10,101,109
2023,2,22300415,12/27/2023,1610612755,Philadelphia 76ers,0,1,1610612753,Orlando Magic,1,0,35,33,68,10,18,28,45,51,96,12,5,17,18,38,14,5,9,95,112
2015,2,21501180,4/8/2016,1610612755,Philadelphia 76ers,1,0,1610612752,New York Knicks,0,1,18,36,54,14,23,37,32,59,91,24,12,36,17,49,25,6,9,101,102
2016,2,21600692,1/26/2017,1610612743,Denver Nuggets,1,1,1610612756,Phoenix Suns,0,0,35,28,63,9,14,23,44,42,86,30,5,35,22,21,29,8,15,96,127
2016,2,21600692,1/26/2017,1610612756,Phoenix Suns,0,0,1610612743,Denver Nuggets,1,1,38,27,65,10,14,24,48,41,89,14,3,17,13,28,21,5,11,96,120
2016,2,21600212,11/23/2016,1610612755,Philadelphia 76ers,1,0,1610612763,Memphis Grizzlies,0,1,23,34,57,12,24,36,35,58,93,17,6,23,20,41,24,13,27,113,99
2016,2,21600212,11/23/2016,1610612763,Memphis Grizzlies,0,1,1610612755,Philadelphia 76ers,1,0,28,42,70,10,19,29,38,61,99,18,6,24,13,50,24,9,15,111,104
2023,2,22300132,11/4/2023,1610612756,Phoenix Suns,0,0,1610612755,Philadelphia 76ers,1,1,23,31,54,9,26,35,32,57,89,27,6,33,17,42,22,5,11,98,100
2023,2,22300786,2/14/2024,1610612743,Denver Nuggets,1,0,1610612758,Sacramento Kings,0,1,26,37,63,9,17,26,35,54,89,19,3,22,13,42,27,7,12,100,98
2022,2,22200579,1/5/2023,1610612743,Denver Nuggets,1,1,1610612746,LA Clippers,0,0,31,22,53,14,22,36,45,44,89,18,3,21,13,34,28,7,12,99,122
2022,2,22200579,1/5/2023,1610612746,LA Clippers,0,0,1610612743,Denver Nuggets,1,1,29,25,54,5,32,37,34,57,91,18,7,25,13,48,24,6,8,99,91
2016,2,21600691,1/26/2017,1610612750,Minnesota Timberwolves,1,0,1610612754,Indiana Pacers,0,1,26,28,54,10,17,27,36,45,81,21,6,27,9,39,27,7,13,98,103
2016,2,21600691,1/26/2017,1610612754,Indiana Pacers,0,1,1610612750,Minnesota Timberwolves,1,0,32,31,63,10,8,18,42,39,81,15,2,17,9,31,21,13,19,97,109
2016,2,21600211,11/22/2016,1610612747,Los Angeles Lakers,1,1,1610612760,Oklahoma City Thunder,0,0,28,28,56,14,13,27,42,41,83,13,3,16,11,31,25,11,17,98,111
2015,2,21501053,3/22/2016,1610612740,New Orleans Pelicans,1,0,1610612748,Miami Heat,0,1,27,44,71,7,9,16,34,53,87,24,6,30,14,41,16,5,13,99,99
2015,2,21501053,3/22/2016,1610612748,Miami Heat,0,1,1610612740,New Orleans Pelicans,1,0,41,28,69,3,16,19,44,44,88,22,5,27,15,32,21,7,13,98,113
2014,2,21400915,3/6/2015,1610612737,Atlanta Hawks,1,1,1610612739,Cleveland Cavaliers,0,0,37,26,63,6,15,21,43,41,84,14,3,17,13,30,27,7,13,91,106
2014,2,21400915,3/6/2015,1610612739,Cleveland Cavaliers,0,0,1610612737,Atlanta Hawks,1,1,16,15,31,13,25,38,29,40,69,26,7,33,13,29,18,10,18,90,97
2016,2,21600211,11/22/2016,1610612760,Oklahoma City Thunder,0,0,1610612747,Los Angeles Lakers,1,1,34,31,65,11,16,27,45,47,92,8,3,11,16,32,29,8,16,97,109
2015,2,21500826,2/21/2016,1610612759,San Antonio Spurs,0,1,1610612756,Phoenix Suns,1,0,33,33,66,10,6,16,43,39,82,22,12,34,11,34,23,6,12,101,118
2015,2,21500781,2/8/2016,1610612757,Portland Trail Blazers,0,1,1610612763,Memphis Grizzlies,1,0,34,26,60,10,19,29,44,45,89,14,6,20,12,35,22,5,13,99,112
2015,2,21500781,2/8/2016,1610612763,Memphis Grizzlies,1,0,1610612757,Portland Trail Blazers,0,1,36,31,67,7,12,19,43,43,86,13,6,19,12,33,18,9,16,99,106
2015,2,21500592,1/14/2016,1610612744,Golden State Warriors,1,1,1610612747,Los Angeles Lakers,0,0,30,23,53,13,20,33,43,43,86,17,3,20,13,32,26,13,20,104,116
2015,2,21500592,1/14/2016,1610612747,Los Angeles Lakers,0,0,1610612744,Golden State Warriors,1,1,36,31,67,4,19,23,40,50,90,14,10,24,17,39,17,12,21,104,98
2015,2,21500493,1/1/2016,1610612741,Chicago Bulls,1,1,1610612752,New York Knicks,0,0,29,40,69,10,6,16,39,46,85,20,5,25,17,31,27,3,8,92,108
2015,2,21500493,1/1/2016,1610612752,New York Knicks,0,0,1610612741,Chicago Bulls,1,1,25,40,65,6,13,19,31,53,84,13,4,17,14,41,16,4,12,91,81
2015,2,21500391,12/18/2015,1610612741,Chicago Bulls,1,0,1610612765,Detroit Pistons,0,1,45,53,98,5,17,22,50,70,120,39,5,44,25,46,21,7,17,134,144
2015,2,21500391,12/18/2015,1610612765,Detroit Pistons,0,1,1610612741,Chicago Bulls,1,0,48,47,95,8,21,29,56,68,124,27,18,45,24,49,28,5,11,136,147
2015,2,21500194,11/21/2015,1610612752,New York Knicks,0,1,1610612745,Houston Rockets,1,0,22,33,55,12,13,25,34,46,80,27,7,34,24,27,20,6,13,85,107
2015,2,21500100,11/9/2015,1610612741,Chicago Bulls,0,1,1610612755,Philadelphia 76ers,1,0,31,40,71,10,15,25,41,55,96,19,4,23,15,42,28,6,14,105,111
2015,2,21500100,11/9/2015,1610612755,Philadelphia 76ers,1,0,1610612741,Chicago Bulls,0,1,30,45,75,5,20,25,35,65,100,13,10,23,24,46,19,6,17,105,88
2015,2,21500003,10/27/2015,1610612740,New Orleans Pelicans,0,0,1610612744,Golden State Warriors,1,1,29,36,65,6,12,18,35,48,83,19,8,27,13,38,21,8,19,102,95
2015,2,21500003,10/27/2015,1610612744,Golden State Warriors,1,1,1610612740,New Orleans Pelicans,0,0,32,34,66,9,21,30,41,55,96,20,2,22,25,31,29,9,20,103,111
2015,2,21501109,3/29/2016,1610612755,Philadelphia 76ers,1,0,1610612766,Charlotte Hornets,0,1,14,38,52,16,28,44,30,66,96,9,1,10,11,56,20,6,10,100,85
2015,2,21501109,3/29/2016,1610612766,Charlotte Hornets,0,1,1610612755,Philadelphia 76ers,1,0,31,31,62,7,18,25,38,49,87,17,1,18,12,37,26,8,16,101,100
2015,2,21500689,1/27/2016,1610612745,Houston Rockets,0,0,1610612759,San Antonio Spurs,1,1,20,23,43,8,22,30,28,45,73,35,17,52,15,39,14,7,15,100,99
2015,2,21500689,1/27/2016,1610612759,San Antonio Spurs,1,1,1610612745,Houston Rockets,0,0,38,29,67,12,11,23,50,40,90,18,3,21,13,28,34,7,14,101,130
2015,2,21500492,1/1/2016,1610612761,Toronto Raptors,1,1,1610612766,Charlotte Hornets,0,0,21,37,58,15,18,33,36,55,91,17,1,18,26,30,21,7,13,88,104
2015,2,21500492,1/1/2016,1610612766,Charlotte Hornets,0,0,1610612761,Toronto Raptors,1,1,24,29,53,10,22,32,34,51,85,16,2,18,17,34,15,6,11,88,94
2015,2,21500390,12/18/2015,1610612748,Miami Heat,1,0,1610612761,Toronto Raptors,0,1,26,23,49,9,16,25,35,39,74,15,2,17,7,33,19,11,13,88,94
2015,2,21500390,12/18/2015,1610612761,Toronto Raptors,0,1,1610612748,Miami Heat,1,0,33,26,59,8,13,21,41,39,80,18,4,22,11,30,18,4,7,89,108
2015,2,21500289,12/5/2015,1610612743,Denver Nuggets,0,1,1610612755,Philadelphia 76ers,1,0,26,24,50,11,20,31,37,44,81,23,15,38,17,36,25,11,17,99,108
2015,2,21500289,12/5/2015,1610612755,Philadelphia 76ers,1,0,1610612743,Denver Nuggets,0,1,22,21,43,15,16,31,37,37,74,16,10,26,8,34,22,8,20,99,105
2015,2,21500002,10/27/2015,1610612739,Cleveland Cavaliers,0,0,1610612741,Chicago Bulls,1,1,29,36,65,9,20,29,38,56,94,10,7,17,16,42,26,6,11,97,95
2015,2,21500002,10/27/2015,1610612741,Chicago Bulls,1,1,1610612739,Cleveland Cavaliers,0,0,30,38,68,7,12,19,37,50,87,16,7,23,13,41,13,5,13,97,97
2015,2,21501052,3/22/2016,1610612751,Brooklyn Nets,1,0,1610612766,Charlotte Hornets,0,1,26,30,56,8,10,18,34,40,74,24,3,27,7,34,21,7,16,95,100
2015,2,21501052,3/22/2016,1610612766,Charlotte Hornets,0,1,1610612751,Brooklyn Nets,1,0,29,25,54,10,18,28,39,43,82,17,4,21,6,39,21,4,8,96,105
2015,2,21500947,3/8/2016,1610612737,Atlanta Hawks,0,1,1610612762,Utah Jazz,1,0,30,25,55,8,17,25,38,42,80,7,7,14,6,41,15,10,16,95,91
2015,2,21500947,3/8/2016,1610612762,Utah Jazz,1,0,1610612737,Atlanta Hawks,0,1,23,37,60,7,19,26,30,56,86,17,6,23,20,39,16,9,20,96,84
2016,2,21600690,1/26/2017,1610612742,Dallas Mavericks,0,0,1610612760,Oklahoma City Thunder,1,1,27,31,58,11,15,26,38,46,84,11,2,13,9,39,17,7,12,93,98
2016,2,21600690,1/26/2017,1610612760,Oklahoma City Thunder,1,1,1610612742,Dallas Mavericks,0,0,28,22,50,9,13,22,37,35,72,26,10,36,12,28,13,10,17,92,109
2015,2,21500735,2/3/2016,1610612739,Cleveland Cavaliers,0,0,1610612766,Charlotte Hornets,1,1,28,27,55,10,18,28,38,45,83,11,3,14,7,39,16,4,8,91,97
2015,2,21500735,2/3/2016,1610612766,Charlotte Hornets,1,1,1610612739,Cleveland Cavaliers,0,0,30,22,52,9,18,27,39,40,79,19,4,23,15,27,26,9,14,92,106
2015,2,21500591,1/14/2016,1610612758,Sacramento Kings,0,1,1610612762,Utah Jazz,1,0,29,34,63,5,6,11,34,40,74,30,12,42,15,30,19,8,16,96,103
2015,2,21500591,1/14/2016,1610612762,Utah Jazz,1,0,1610612758,Sacramento Kings,0,1,29,20,49,6,28,34,35,48,83,25,9,34,14,41,12,12,13,96,101
2015,2,21500491,1/1/2016,1610612742,Dallas Mavericks,0,0,1610612748,Miami Heat,1,1,25,32,57,7,24,31,32,56,88,11,3,14,15,44,22,4,9,91,82
2015,2,21500491,1/1/2016,1610612748,Miami Heat,1,1,1610612742,Dallas Mavericks,0,0,38,26,64,8,10,18,46,36,82,6,3,9,10,28,24,6,13,89,106
2015,2,21500389,12/18/2015,1610612737,Atlanta Hawks,0,1,1610612738,Boston Celtics,1,0,37,31,68,4,16,20,41,47,88,23,6,29,12,39,23,5,13,105,109
2015,2,21500389,12/18/2015,1610612738,Boston Celtics,1,0,1610612737,Atlanta Hawks,0,1,24,30,54,10,13,23,34,43,77,23,8,31,9,37,19,11,22,103,101
2015,2,21500193,11/21/2015,1610612748,Miami Heat,1,1,1610612755,Philadelphia 76ers,0,0,25,26,51,5,13,18,30,39,69,31,14,45,10,35,16,7,16,96,96
2015,2,21500193,11/21/2015,1610612755,Philadelphia 76ers,0,0,1610612748,Miami Heat,1,1,21,30,51,10,21,31,31,51,82,19,5,24,15,40,16,7,17,95,91
2015,2,21500099,11/9/2015,1610612753,Orlando Magic,0,0,1610612754,Indiana Pacers,1,1,21,24,45,10,23,33,31,47,78,12,5,17,12,38,16,12,22,97,84
2015,2,21500099,11/9/2015,1610612754,Indiana Pacers,1,1,1610612753,Orlando Magic,0,0,23,29,52,11,14,25,34,43,77,18,4,22,7,38,25,9,18,97,97
2015,2,21500001,10/27/2015,1610612737,Atlanta Hawks,1,0,1610612765,Detroit Pistons,0,1,29,26,55,8,19,27,37,45,82,12,3,15,7,39,22,5,15,97,94
2015,2,21500001,10/27/2015,1610612765,Detroit Pistons,0,1,1610612737,Atlanta Hawks,1,0,25,42,67,12,17,29,37,59,96,20,6,26,28,35,23,9,15,98,106
2014,2,21400914,3/6/2015,1610612755,Philadelphia 76ers,1,0,1610612762,Utah Jazz,0,1,22,34,56,10,22,32,32,56,88,9,9,18,19,41,22,9,14,92,83
2014,2,21400914,3/6/2015,1610612762,Utah Jazz,0,1,1610612755,Philadelphia 76ers,1,0,21,38,59,6,6,12,27,44,71,29,12,41,19,30,17,13,19,92,89
2015,2,21501179,4/8/2016,1610612748,Miami Heat,0,0,1610612753,Orlando Magic,1,1,37,41,78,8,14,22,45,55,100,11,10,21,27,33,18,4,13,98,109
2015,2,21501179,4/8/2016,1610612753,Orlando Magic,1,1,1610612748,Miami Heat,0,0,38,33,71,5,6,11,43,39,82,21,7,28,9,32,23,6,11,97,112
2015,2,21500946,3/8/2016,1610612743,Denver Nuggets,1,1,1610612752,New York Knicks,0,0,39,39,78,6,15,21,45,54,99,14,5,19,17,39,28,1,6,96,110
2015,2,21500946,3/8/2016,1610612752,New York Knicks,0,0,1610612743,Denver Nuggets,1,1,27,30,57,6,12,18,33,42,75,22,4,26,9,35,21,9,16,97,94
2015,2,21500825,2/21/2016,1610612738,Boston Celtics,0,1,1610612743,Denver Nuggets,1,0,37,28,65,10,22,32,47,50,97,17,3,20,17,34,32,11,17,106,121
2015,2,21500825,2/21/2016,1610612743,Denver Nuggets,1,0,1610612738,Boston Celtics,0,1,28,24,52,6,15,21,34,39,73,27,7,34,7,35,19,11,24,106,101
2015,2,21500490,1/1/2016,1610612753,Orlando Magic,0,0,1610612764,Washington Wizards,1,1,35,30,65,5,15,20,40,45,85,6,2,8,9,38,29,11,16,96,91
2015,2,21500490,1/1/2016,1610612764,Washington Wizards,1,1,1610612753,Orlando Magic,0,0,35,31,66,8,18,26,43,49,92,9,1,10,12,37,25,6,10,95,103
2015,2,21500388,12/18/2015,1610612752,New York Knicks,0,1,1610612755,Philadelphia 76ers,1,0,34,32,66,6,13,19,40,45,85,21,7,28,16,33,24,7,15,96,107
2015,2,21500388,12/18/2015,1610612755,Philadelphia 76ers,1,0,1610612752,New York Knicks,0,1,31,22,53,6,18,24,37,40,77,17,13,30,9,38,15,8,15,97,97
2015,2,21500288,12/4/2015,1610612739,Cleveland Cavaliers,0,0,1610612740,New Orleans Pelicans,1,1,29,27,56,10,23,33,39,50,89,20,4,24,15,38,18,10,14,100,108
2015,2,21500288,12/4/2015,1610612740,New Orleans Pelicans,1,1,1610612739,Cleveland Cavaliers,0,0,33,27,60,9,16,25,42,43,85,21,10,31,14,32,25,8,15,102,114
2015,2,21501178,4/8/2016,1610612751,Brooklyn Nets,0,0,1610612766,Charlotte Hornets,1,1,29,38,67,10,15,25,39,53,92,11,9,20,25,34,24,11,15,92,99
2015,2,21501178,4/8/2016,1610612766,Charlotte Hornets,1,1,1610612751,Brooklyn Nets,0,0,27,19,46,14,23,37,41,42,83,17,3,20,15,29,26,9,13,92,113
2015,2,21501051,3/21/2016,1610612756,Phoenix Suns,1,0,1610612763,Memphis Grizzlies,0,1,19,29,48,11,17,28,30,46,76,26,8,34,12,39,22,10,17,99,97
2015,2,21501051,3/21/2016,1610612763,Memphis Grizzlies,0,1,1610612756,Phoenix Suns,1,0,31,39,70,8,12,20,39,51,90,17,2,19,13,40,18,8,13,98,103
2015,2,21500889,2/29/2016,1610612758,Sacramento Kings,1,0,1610612760,Oklahoma City Thunder,0,1,41,41,82,7,18,25,48,59,107,13,6,19,25,38,28,7,10,103,116
2015,2,21500889,2/29/2016,1610612760,Oklahoma City Thunder,0,1,1610612758,Sacramento Kings,1,0,33,15,48,14,20,34,47,35,82,23,3,26,12,24,28,11,21,104,131
2015,2,21500780,2/8/2016,1610612737,Atlanta Hawks,1,0,1610612753,Orlando Magic,0,1,31,32,63,12,17,29,43,49,92,12,8,20,10,42,31,11,14,107,110
2015,2,21500780,2/8/2016,1610612753,Orlando Magic,0,1,1610612737,Atlanta Hawks,1,0,37,27,64,9,20,29,46,47,93,16,6,22,11,39,37,9,13,105,117
2015,2,21500648,1/22/2016,1610612746,LA Clippers,0,1,1610612752,New York Knicks,1,0,30,23,53,13,10,23,43,33,76,17,7,24,6,30,27,5,11,95,116
2015,2,21500648,1/22/2016,1610612752,New York Knicks,1,0,1610612746,LA Clippers,0,1,29,38,67,4,14,18,33,52,85,18,2,20,14,38,24,10,17,94,88
2014,2,21400913,3/6/2015,1610612753,Orlando Magic,1,1,1610612758,Sacramento Kings,0,0,35,26,61,13,11,24,48,37,85,10,2,12,10,28,29,6,12,92,119
2015,2,21500489,12/31/2015,1610612757,Portland Trail Blazers,0,0,1610612762,Utah Jazz,1,1,19,23,42,16,20,36,35,43,78,10,4,14,12,31,19,7,11,83,96
2015,2,21500489,12/31/2015,1610612762,Utah Jazz,1,1,1610612757,Portland Trail Blazers,0,0,28,25,53,15,18,33,43,43,86,8,3,11,15,31,19,1,6,83,109
2015,2,21500387,12/18/2015,1610612753,Orlando Magic,1,1,1610612757,Portland Trail Blazers,0,0,37,32,69,2,13,15,39,45,84,22,9,31,14,36,19,3,13,97,102
2015,2,21500387,12/18/2015,1610612757,Portland Trail Blazers,0,0,1610612753,Orlando Magic,1,1,21,20,41,11,21,32,32,41,73,19,7,26,8,36,21,11,19,97,94
2014,2,21400913,3/6/2015,1610612758,Sacramento Kings,0,0,1610612753,Orlando Magic,1,1,28,30,58,10,17,27,38,47,85,28,10,38,25,29,18,10,14,92,114
2015,2,21500192,11/21/2015,1610612764,Washington Wizards,0,1,1610612765,Detroit Pistons,1,0,31,28,59,7,12,19,38,40,78,14,6,20,9,32,22,3,13,91,97
2015,2,21500192,11/21/2015,1610612765,Detroit Pistons,1,0,1610612764,Washington Wizards,0,1,28,25,53,8,18,26,36,43,79,15,6,21,11,34,20,10,13,92,95
2015,2,21500098,11/8/2015,1610612757,Portland Trail Blazers,1,0,1610612765,Detroit Pistons,0,1,32,19,51,9,16,25,41,35,76,12,6,18,9,28,24,13,23,99,103
2015,2,21500098,11/8/2015,1610612765,Detroit Pistons,0,1,1610612757,Portland Trail Blazers,1,0,36,30,66,11,19,30,47,49,96,15,7,22,19,34,16,5,9,98,120
2016,2,21600210,11/22/2016,1610612741,Chicago Bulls,0,0,1610612743,Denver Nuggets,1,1,37,40,77,6,12,18,43,52,95,15,3,18,14,39,22,5,7,96,107
2016,2,21600210,11/22/2016,1610612743,Denver Nuggets,1,1,1610612741,Chicago Bulls,0,0,33,45,78,10,12,22,43,57,100,14,3,17,21,39,26,6,10,96,110
2015,2,21501177,4/7/2016,1610612744,Golden State Warriors,1,1,1610612759,San Antonio Spurs,0,0,33,25,58,12,13,25,45,38,83,10,1,11,9,30,33,10,16,98,112
2015,2,21501177,4/7/2016,1610612759,San Antonio Spurs,0,0,1610612744,Golden State Warriors,1,1,32,32,64,7,9,16,39,41,80,16,7,23,5,38,28,8,12,97,101
2015,2,21501050,3/21/2016,1610612744,Golden State Warriors,0,1,1610612750,Minnesota Timberwolves,1,0,35,28,63,8,16,24,43,44,87,15,9,24,17,30,31,8,17,100,109
2015,2,21501050,3/21/2016,1610612750,Minnesota Timberwolves,1,0,1610612744,Golden State Warriors,0,1,29,34,63,7,12,19,36,46,82,25,5,30,16,32,26,13,18,99,104
2015,2,21500998,3/15/2016,1610612743,Denver Nuggets,0,0,1610612753,Orlando Magic,1,1,31,25,56,9,15,24,40,40,80,21,3,24,9,33,23,7,16,99,110
2015,2,21500998,3/15/2016,1610612753,Orlando Magic,1,1,1610612743,Denver Nuggets,0,0,36,20,56,8,17,25,44,37,81,20,5,25,8,31,28,8,13,99,116
2015,2,21500888,2/29/2016,1610612743,Denver Nuggets,1,0,1610612763,Memphis Grizzlies,0,1,32,18,50,8,17,25,40,35,75,8,2,10,10,26,27,7,20,90,96
2015,2,21500888,2/29/2016,1610612763,Memphis Grizzlies,0,1,1610612743,Denver Nuggets,1,0,33,22,55,3,17,20,36,39,75,28,8,36,9,34,27,3,9,91,103
2016,2,21600689,1/25/2017,1610612747,Los Angeles Lakers,0,0,1610612757,Portland Trail Blazers,1,1,26,38,64,11,19,30,37,57,94,13,1,14,17,41,16,5,15,100,98
2016,2,21600689,1/25/2017,1610612757,Portland Trail Blazers,1,1,1610612747,Los Angeles Lakers,0,0,39,36,75,4,11,15,43,47,90,15,5,20,10,40,17,5,11,98,105
2015,2,21500647,1/22/2016,1610612751,Brooklyn Nets,1,0,1610612762,Utah Jazz,0,1,27,32,59,6,10,16,33,42,75,14,4,18,10,33,24,5,12,87,86
2015,2,21500647,1/22/2016,1610612762,Utah Jazz,0,1,1610612751,Brooklyn Nets,1,0,34,25,59,9,7,16,43,32,75,13,2,15,14,18,28,5,18,88,108
2015,2,21500488,12/31/2015,1610612756,Phoenix Suns,0,0,1610612760,Oklahoma City Thunder,1,1,35,27,62,8,12,20,43,39,82,12,1,13,14,26,24,12,17,92,106
2015,2,21500488,12/31/2015,1610612760,Oklahoma City Thunder,1,1,1610612756,Phoenix Suns,0,0,35,24,59,7,14,21,42,38,80,19,5,24,14,26,29,10,13,91,110
2015,2,21500386,12/18/2015,1610612751,Brooklyn Nets,0,0,1610612754,Indiana Pacers,1,1,28,42,70,8,8,16,36,50,86,17,0,17,10,40,18,4,12,96,97
2015,2,21500386,12/18/2015,1610612754,Indiana Pacers,1,1,1610612751,Brooklyn Nets,0,0,30,31,61,7,21,28,37,52,89,23,3,26,17,36,17,7,11,98,104
2015,2,21500287,12/4/2015,1610612742,Dallas Mavericks,1,0,1610612745,Houston Rockets,0,1,29,23,52,8,21,29,37,44,81,14,6,20,15,33,23,12,18,94,96
2015,2,21500287,12/4/2015,1610612745,Houston Rockets,0,1,1610612742,Dallas Mavericks,1,0,27,31,58,12,14,26,39,45,84,10,8,18,17,33,20,8,18,93,100
2015,2,21500097,11/8/2015,1610612756,Phoenix Suns,0,0,1610612760,Oklahoma City Thunder,1,1,31,37,68,7,9,16,38,46,84,20,6,26,14,38,18,14,23,104,103
2015,2,21500097,11/8/2015,1610612760,Oklahoma City Thunder,1,1,1610612756,Phoenix Suns,0,0,45,29,74,4,16,20,49,45,94,22,8,30,18,28,26,7,15,105,124
2015,2,21501108,3/29/2016,1610612751,Brooklyn Nets,0,0,1610612753,Orlando Magic,1,1,32,33,65,5,9,14,37,42,79,26,13,39,16,32,19,11,18,98,105
2015,2,21501108,3/29/2016,1610612753,Orlando Magic,1,1,1610612751,Brooklyn Nets,0,0,42,22,64,14,13,27,56,35,91,13,6,19,13,25,40,7,10,100,139
2015,2,21501049,3/21/2016,1610612741,Chicago Bulls,1,1,1610612758,Sacramento Kings,0,0,29,38,67,12,12,24,41,50,91,15,8,23,14,39,28,6,9,98,109
2015,2,21501049,3/21/2016,1610612758,Sacramento Kings,0,0,1610612741,Chicago Bulls,1,1,31,28,59,9,20,29,40,48,88,13,3,16,18,32,23,13,20,99,102
2015,2,21500688,1/27/2016,1610612750,Minnesota Timberwolves,1,0,1610612760,Oklahoma City Thunder,0,1,45,31,76,5,9,14,50,40,90,18,10,28,15,33,31,0,9,94,123
2015,2,21500688,1/27/2016,1610612760,Oklahoma City Thunder,0,1,1610612750,Minnesota Timberwolves,1,0,38,33,71,10,10,20,48,43,91,20,1,21,18,25,23,6,13,95,126
2015,2,21500590,1/14/2016,1610612739,Cleveland Cavaliers,0,0,1610612759,San Antonio Spurs,1,1,28,28,56,10,16,26,38,44,82,9,2,11,10,36,15,6,18,94,95
2015,2,21500590,1/14/2016,1610612759,San Antonio Spurs,1,1,1610612739,Cleveland Cavaliers,0,0,33,33,66,5,12,17,38,45,83,18,4,22,12,35,17,4,12,94,99
2015,2,21500286,12/4/2015,1610612737,Atlanta Hawks,1,1,1610612747,Los Angeles Lakers,0,0,27,21,48,10,16,26,37,37,74,16,4,20,10,29,24,10,17,92,100
2015,2,21500286,12/4/2015,1610612747,Los Angeles Lakers,0,0,1610612737,Atlanta Hawks,1,1,19,40,59,13,14,27,32,54,86,10,3,13,18,36,19,11,16,91,87
2015,2,21500191,11/21/2015,1610612737,Atlanta Hawks,0,0,1610612739,Cleveland Cavaliers,1,1,21,37,58,11,17,28,32,54,86,22,3,25,14,41,22,4,12,95,97
2015,2,21500191,11/21/2015,1610612739,Cleveland Cavaliers,1,1,1610612737,Atlanta Hawks,0,0,30,26,56,11,18,29,41,44,85,16,3,19,14,31,27,10,14,96,109
2015,2,21500096,11/8/2015,1610612748,Miami Heat,1,1,1610612761,Toronto Raptors,0,0,27,36,63,8,12,20,35,48,83,18,7,25,17,32,18,8,11,90,96
2015,2,21500096,11/8/2015,1610612761,Toronto Raptors,0,0,1610612748,Miami Heat,1,1,25,27,52,3,16,19,28,43,71,17,5,22,10,36,17,8,18,91,76
2014,2,21400912,3/6/2015,1610612741,Chicago Bulls,0,0,1610612754,Indiana Pacers,1,1,26,37,63,5,18,23,31,55,86,17,2,19,18,38,20,7,13,91,84
2014,2,21400912,3/6/2015,1610612754,Indiana Pacers,1,1,1610612741,Chicago Bulls,0,0,28,32,60,6,14,20,34,46,80,24,9,33,17,35,23,5,11,90,98
2015,2,21501176,4/7/2016,1610612750,Minnesota Timberwolves,0,1,1610612758,Sacramento Kings,1,0,25,34,59,11,10,21,36,44,80,22,9,31,16,30,25,11,16,96,105
2016,2,21600209,11/22/2016,1610612737,Atlanta Hawks,1,0,1610612740,New Orleans Pelicans,0,1,29,27,56,10,19,29,39,46,85,6,4,10,10,37,22,11,15,96,94
2016,2,21600209,11/22/2016,1610612740,New Orleans Pelicans,0,1,1610612737,Atlanta Hawks,1,0,34,27,61,11,14,25,45,41,86,11,1,12,7,34,29,5,11,96,112
2015,2,21501176,4/7/2016,1610612758,Sacramento Kings,1,0,1610612750,Minnesota Timberwolves,0,1,30,38,68,6,11,17,36,49,85,19,2,21,20,30,19,11,20,95,97
2016,2,21600688,1/25/2017,1610612742,Dallas Mavericks,1,1,1610612752,New York Knicks,0,0,33,24,57,6,20,26,39,44,83,19,5,24,8,38,19,4,7,94,103
2016,2,21600688,1/25/2017,1610612752,New York Knicks,0,0,1610612742,Dallas Mavericks,1,1,32,37,69,7,16,23,39,53,92,10,2,12,22,32,17,10,18,94,95
2016,2,21600208,11/22/2016,1610612752,New York Knicks,1,1,1610612757,Portland Trail Blazers,0,0,36,31,67,9,20,29,45,51,96,8,0,8,14,37,26,5,13,100,107
2016,2,21600208,11/22/2016,1610612757,Portland Trail Blazers,0,0,1610612752,New York Knicks,1,1,32,32,64,6,16,22,38,48,86,21,5,26,14,37,18,8,16,100,103
2015,2,21500487,12/31/2015,1610612740,New Orleans Pelicans,1,0,1610612746,LA Clippers,0,1,29,28,57,7,18,25,36,46,82,10,5,15,13,34,21,8,16,93,89
2015,2,21500487,12/31/2015,1610612746,LA Clippers,0,1,1610612740,New Orleans Pelicans,1,0,25,31,56,10,24,34,35,55,90,15,4,19,18,39,24,6,12,94,95
2015,2,21500385,12/17/2015,1610612745,Houston Rockets,0,1,1610612747,Los Angeles Lakers,1,0,22,35,57,12,19,31,34,54,88,27,15,42,29,33,22,5,14,93,107
2015,2,21500385,12/17/2015,1610612747,Los Angeles Lakers,1,0,1610612745,Houston Rockets,0,1,31,29,60,5,19,24,36,48,84,10,8,18,16,36,22,9,14,94,87
2015,2,21500285,12/4/2015,1610612749,Milwaukee Bucks,0,0,1610612765,Detroit Pistons,1,1,35,34,69,4,14,18,39,48,87,13,1,14,10,39,21,8,15,100,95
2015,2,21500285,12/4/2015,1610612765,Detroit Pistons,1,1,1610612749,Milwaukee Bucks,0,0,27,32,59,7,16,23,34,48,82,27,12,39,12,43,18,6,10,100,102
2015,2,21500190,11/21/2015,1610612749,Milwaukee Bucks,0,0,1610612754,Indiana Pacers,1,1,29,33,62,5,12,17,34,45,79,13,6,19,14,34,19,15,23,97,86
2015,2,21500190,11/21/2015,1610612754,Indiana Pacers,1,1,1610612749,Milwaukee Bucks,0,0,32,29,61,15,15,30,47,44,91,14,9,23,18,31,28,9,14,99,123
2015,2,21500095,11/8/2015,1610612747,Los Angeles Lakers,0,0,1610612752,New York Knicks,1,1,27,40,67,9,18,27,36,58,94,14,9,23,20,44,19,5,10,95,95
2015,2,21500095,11/8/2015,1610612752,New York Knicks,1,1,1610612747,Los Angeles Lakers,0,0,24,33,57,9,18,27,33,51,84,24,5,29,14,38,22,7,9,94,99
2015,2,21501175,4/7/2016,1610612745,Houston Rockets,1,0,1610612756,Phoenix Suns,0,1,28,13,41,14,19,33,42,32,74,17,11,28,9,28,26,11,20,100,115
2015,2,21501175,4/7/2016,1610612756,Phoenix Suns,0,1,1610612745,Houston Rockets,1,0,32,31,63,12,19,31,44,50,94,24,5,29,30,23,31,13,21,100,124
2015,2,21501048,3/21/2016,1610612737,Atlanta Hawks,1,0,1610612764,Washington Wizards,0,1,25,20,45,13,20,33,38,40,78,13,4,17,3,37,23,10,14,96,102
2015,2,21501048,3/21/2016,1610612764,Washington Wizards,0,1,1610612737,Atlanta Hawks,1,0,33,33,66,13,12,25,46,45,91,12,8,20,15,33,27,5,9,95,117
2015,2,21500734,2/2/2016,1610612747,Los Angeles Lakers,1,1,1610612750,Minnesota Timberwolves,0,0,28,26,54,12,14,26,40,40,80,27,8,35,12,31,23,6,10,95,119
2015,2,21500734,2/2/2016,1610612750,Minnesota Timberwolves,0,0,1610612747,Los Angeles Lakers,1,1,42,21,63,4,13,17,46,34,80,19,6,25,12,26,36,9,15,96,115
2015,2,21500646,1/22/2016,1610612738,Boston Celtics,1,1,1610612741,Chicago Bulls,0,0,35,38,73,8,15,23,43,53,96,16,5,21,19,36,26,8,13,100,110
2015,2,21500646,1/22/2016,1610612741,Chicago Bulls,0,0,1610612738,Boston Celtics,1,1,35,41,76,3,10,13,38,51,89,22,4,26,20,33,11,13,19,100,101
2015,2,21500284,12/4/2015,1610612756,Phoenix Suns,0,0,1610612764,Washington Wizards,1,1,33,28,61,10,13,23,43,41,84,10,6,16,14,30,21,9,21,100,106
2015,2,21500284,12/4/2015,1610612764,Washington Wizards,1,1,1610612756,Phoenix Suns,0,0,30,26,56,10,16,26,40,42,82,19,6,25,19,26,19,8,23,98,109
2015,2,21500189,11/21/2015,1610612753,Orlando Magic,1,0,1610612758,Sacramento Kings,0,1,29,32,61,9,22,31,38,54,92,6,2,8,16,39,27,11,17,98,91
2015,2,21500189,11/21/2015,1610612758,Sacramento Kings,0,1,1610612753,Orlando Magic,1,0,24,37,61,7,13,20,31,50,81,28,3,31,14,36,23,8,16,99,97
2015,2,21500094,11/8/2015,1610612739,Cleveland Cavaliers,1,1,1610612754,Indiana Pacers,0,0,30,29,59,8,16,24,38,45,83,17,8,25,13,36,25,5,10,91,101
2015,2,21500094,11/8/2015,1610612754,Indiana Pacers,0,0,1610612739,Cleveland Cavaliers,1,1,33,39,72,6,12,18,39,51,90,13,6,19,16,39,22,5,7,92,97
2014,2,21400911,3/6/2015,1610612761,Toronto Raptors,0,0,1610612766,Charlotte Hornets,1,1,30,39,69,7,15,22,37,54,91,13,2,15,7,48,21,3,5,96,94
2014,2,21400911,3/6/2015,1610612766,Charlotte Hornets,1,1,1610612761,Toronto Raptors,0,0,35,30,65,5,15,20,40,45,85,18,2,20,15,30,26,5,16,95,103
2015,2,21501174,4/7/2016,1610612741,Chicago Bulls,0,0,1610612748,Miami Heat,1,1,32,32,64,3,11,14,35,43,78,25,3,28,13,32,18,8,14,93,98
2015,2,21501174,4/7/2016,1610612748,Miami Heat,1,1,1610612741,Chicago Bulls,0,0,40,38,78,4,10,14,44,48,92,14,3,17,17,32,16,6,10,93,106
2015,2,21500945,3/8/2016,1610612750,Minnesota Timberwolves,1,0,1610612759,San Antonio Spurs,0,1,32,32,64,4,11,15,36,43,79,15,4,19,9,38,18,13,15,93,91
2015,2,21500945,3/8/2016,1610612759,San Antonio Spurs,0,1,1610612750,Minnesota Timberwolves,1,0,43,23,66,4,15,19,47,38,85,18,1,19,10,29,28,5,9,95,116
2015,2,21500779,2/8/2016,1610612761,Toronto Raptors,0,1,1610612765,Detroit Pistons,1,0,28,22,50,11,9,20,39,31,70,14,3,17,3,28,22,7,15,92,103
2015,2,21500779,2/8/2016,1610612765,Detroit Pistons,1,0,1610612761,Toronto Raptors,0,1,28,24,52,8,20,28,36,44,80,9,8,17,14,34,22,11,16,92,89
2016,2,21600687,1/25/2017,1610612744,Golden State Warriors,0,1,1610612766,Charlotte Hornets,1,0,28,26,54,11,17,28,39,43,82,24,3,27,11,32,23,6,12,97,113
2016,2,21600687,1/25/2017,1610612766,Charlotte Hornets,1,0,1610612744,Golden State Warriors,0,1,31,38,69,7,16,23,38,54,92,20,1,21,17,38,26,7,15,97,103
2015,2,21500687,1/27/2016,1610612737,Atlanta Hawks,1,0,1610612746,LA Clippers,0,1,23,33,56,10,13,23,33,46,79,7,7,14,10,39,21,16,23,99,83
2015,2,21500687,1/27/2016,1610612746,LA Clippers,0,1,1610612737,Atlanta Hawks,1,0,28,30,58,5,22,27,33,52,85,14,7,21,11,45,18,6,12,97,85
2021,2,22100278,11/24/2021,1610612744,Golden State Warriors,1,1,1610612755,Philadelphia 76ers,0,0,27,15,42,15,23,38,42,38,80,17,7,24,6,36,32,10,16,100,116
2015,2,21500486,12/31/2015,1610612750,Minnesota Timberwolves,0,0,1610612765,Detroit Pistons,1,1,30,42,72,5,9,14,35,51,86,15,4,19,10,42,22,7,16,100,90
2015,2,21500486,12/31/2015,1610612765,Detroit Pistons,1,1,1610612750,Minnesota Timberwolves,0,0,27,24,51,14,21,35,41,45,86,19,9,28,16,33,24,9,17,100,115
2015,2,21500384,12/17/2015,1610612739,Cleveland Cavaliers,1,1,1610612760,Oklahoma City Thunder,0,0,29,30,59,12,17,29,41,47,88,10,3,13,19,31,29,7,18,91,104
2015,2,21500384,12/17/2015,1610612760,Oklahoma City Thunder,0,0,1610612739,Cleveland Cavaliers,1,1,29,25,54,6,14,20,35,39,74,24,4,28,11,29,23,6,12,90,100
2015,2,21500283,12/4/2015,1610612751,Brooklyn Nets,0,0,1610612752,New York Knicks,1,1,36,44,80,3,8,11,39,52,91,10,5,15,14,40,15,8,13,97,91
2015,2,21500283,12/4/2015,1610612752,New York Knicks,1,1,1610612751,Brooklyn Nets,0,0,27,33,60,12,15,27,39,48,87,18,3,21,11,38,25,9,13,99,108
2015,2,21500188,11/20/2015,1610612747,Los Angeles Lakers,1,0,1610612761,Toronto Raptors,0,1,27,25,52,8,17,25,35,42,77,13,4,17,11,31,21,7,15,92,91
2015,2,21500188,11/20/2015,1610612761,Toronto Raptors,0,1,1610612747,Los Angeles Lakers,1,0,19,26,45,15,18,33,34,44,78,19,5,24,13,32,21,8,13,91,102
2015,2,21500093,11/7/2015,1610612745,Houston Rockets,0,1,1610612746,LA Clippers,1,0,31,25,56,7,23,30,38,48,86,26,3,29,15,35,16,8,14,99,109
2015,2,21500093,11/7/2015,1610612746,LA Clippers,1,0,1610612745,Houston Rockets,0,1,38,28,66,4,18,22,42,46,88,17,8,25,13,38,29,7,12,98,105
2014,2,21400910,3/5/2015,1610612742,Dallas Mavericks,0,0,1610612757,Portland Trail Blazers,1,1,31,41,72,2,14,16,33,55,88,7,1,8,6,50,17,7,13,99,75
2014,2,21400910,3/5/2015,1610612757,Portland Trail Blazers,1,1,1610612742,Dallas Mavericks,0,0,27,33,60,7,15,22,34,48,82,19,2,21,11,37,20,10,16,98,94
2016,2,21600207,11/21/2016,1610612746,LA Clippers,1,1,1610612761,Toronto Raptors,0,0,29,20,49,10,15,25,39,35,74,35,7,42,6,31,23,10,15,102,123
2016,2,21600207,11/21/2016,1610612761,Toronto Raptors,0,0,1610612746,LA Clippers,1,1,32,29,61,8,11,19,40,40,80,27,5,32,4,38,19,5,11,100,115
2015,2,21500778,2/8/2016,1610612743,Denver Nuggets,0,0,1610612751,Brooklyn Nets,1,1,33,32,65,9,16,25,42,48,90,11,2,13,17,32,24,6,12,92,104
2015,2,21500778,2/8/2016,1610612751,Brooklyn Nets,1,1,1610612743,Denver Nuggets,0,0,33,29,62,9,10,19,42,39,81,12,3,15,10,32,23,10,15,93,105
2015,2,21500645,1/22/2016,1610612753,Orlando Magic,1,0,1610612766,Charlotte Hornets,0,1,34,34,68,11,12,23,45,46,91,15,4,19,14,35,31,10,19,105,116
2015,2,21500645,1/22/2016,1610612766,Charlotte Hornets,0,1,1610612753,Orlando Magic,1,0,35,39,74,10,17,27,45,56,101,20,2,22,16,41,23,6,9,104,120
2015,2,21500589,1/14/2016,1610612763,Memphis Grizzlies,1,1,1610612765,Detroit Pistons,0,0,28,32,60,9,7,16,37,39,76,20,5,25,11,29,21,3,16,92,103
2015,2,21500589,1/14/2016,1610612765,Detroit Pistons,0,0,1610612763,Memphis Grizzlies,1,1,22,18,40,15,17,32,37,35,72,12,5,17,11,26,18,13,20,92,101
2015,2,21500282,12/3/2015,1610612738,Boston Celtics,0,1,1610612758,Sacramento Kings,1,0,26,25,51,14,19,33,40,44,84,20,4,24,8,39,34,8,16,102,114
2015,2,21500282,12/3/2015,1610612758,Sacramento Kings,1,0,1610612738,Boston Celtics,0,1,22,34,56,7,14,21,29,48,77,32,9,41,14,38,21,14,19,103,97
2015,2,21500187,11/20/2015,1610612741,Chicago Bulls,0,0,1610612744,Golden State Warriors,1,1,28,38,66,7,15,22,35,53,88,17,6,23,17,39,22,7,12,95,94
2015,2,21500187,11/20/2015,1610612744,Golden State Warriors,1,1,1610612741,Chicago Bulls,0,0,29,21,50,10,19,29,39,40,79,18,6,24,14,30,20,11,16,94,106
2015,2,21500092,11/7/2015,1610612744,Golden State Warriors,0,1,1610612758,Sacramento Kings,1,0,30,23,53,8,31,39,38,54,92,19,3,22,22,34,27,9,18,101,103
2015,2,21500092,11/7/2015,1610612758,Sacramento Kings,1,0,1610612744,Golden State Warriors,0,1,32,36,68,6,13,19,38,49,87,12,4,16,17,33,26,13,22,100,94
2015,2,21501107,3/29/2016,1610612741,Chicago Bulls,0,1,1610612754,Indiana Pacers,1,0,27,34,61,10,16,26,37,50,87,14,2,16,17,33,22,9,17,94,98
2015,2,21501107,3/29/2016,1610612754,Indiana Pacers,1,0,1610612741,Chicago Bulls,0,1,36,35,71,3,16,19,39,51,90,15,2,17,18,34,20,5,12,95,96
2015,2,21501047,3/21/2016,1610612749,Milwaukee Bucks,0,0,1610612765,Detroit Pistons,1,1,36,31,67,5,4,9,41,35,76,4,3,7,5,32,23,6,13,87,91
2015,2,21501047,3/21/2016,1610612765,Detroit Pistons,1,1,1610612749,Milwaukee Bucks,0,0,26,26,52,9,24,33,35,50,85,13,4,17,16,36,18,5,12,89,92
2015,2,21500997,3/15/2016,1610612738,Boston Celtics,0,0,1610612754,Indiana Pacers,1,1,28,35,63,8,23,31,36,58,94,18,4,22,21,38,23,9,14,100,98
2015,2,21500997,3/15/2016,1610612754,Indiana Pacers,1,1,1610612738,Boston Celtics,0,0,34,38,72,5,7,12,39,45,84,20,8,28,14,34,18,6,14,99,103
2015,2,21500887,2/29/2016,1610612745,Houston Rockets,0,0,1610612749,Milwaukee Bucks,1,1,26,25,51,15,21,36,41,46,87,24,11,35,18,35,30,12,17,102,121
2015,2,21500887,2/29/2016,1610612749,Milwaukee Bucks,1,1,1610612745,Houston Rockets,0,0,40,26,66,8,7,15,48,33,81,24,9,33,13,26,30,12,18,101,128
2015,2,21500824,2/21/2016,1610612739,Cleveland Cavaliers,0,1,1610612760,Oklahoma City Thunder,1,0,31,26,57,10,13,23,41,39,80,23,4,27,15,27,25,9,13,92,115
2015,2,21500824,2/21/2016,1610612760,Oklahoma City Thunder,1,0,1610612739,Cleveland Cavaliers,0,1,32,37,69,5,16,21,37,53,90,13,6,19,18,38,22,4,10,91,92
2015,2,21500733,2/2/2016,1610612749,Milwaukee Bucks,0,0,1610612757,Portland Trail Blazers,1,1,33,39,72,5,9,14,38,48,86,14,10,24,14,40,23,6,14,97,95
2015,2,21500733,2/2/2016,1610612757,Portland Trail Blazers,1,1,1610612749,Milwaukee Bucks,0,0,28,26,54,11,20,31,39,46,85,18,7,25,14,36,25,7,15,98,107
2016,2,21600686,1/25/2017,1610612740,New Orleans Pelicans,1,0,1610612760,Oklahoma City Thunder,0,1,30,39,69,11,16,27,41,55,96,12,7,19,15,44,23,6,12,102,105
2016,2,21600686,1/25/2017,1610612760,Oklahoma City Thunder,0,1,1610612740,New Orleans Pelicans,1,0,32,32,64,10,17,27,42,49,91,20,8,28,16,38,24,7,16,102,114
2015,2,21500485,12/31/2015,1610612744,Golden State Warriors,0,1,1610612745,Houston Rockets,1,0,32,29,61,11,12,23,43,41,84,17,10,27,15,31,35,13,18,100,114
2015,2,21500485,12/31/2015,1610612745,Houston Rockets,1,0,1610612744,Golden State Warriors,0,1,24,24,48,12,18,30,36,42,78,26,3,29,8,34,21,8,15,100,110
2015,2,21500383,12/17/2015,1610612761,Toronto Raptors,0,0,1610612766,Charlotte Hornets,1,1,26,32,58,9,30,39,35,62,97,20,8,28,17,48,18,5,8,103,99
2015,2,21500383,12/17/2015,1610612766,Charlotte Hornets,1,1,1610612761,Toronto Raptors,0,0,27,29,56,10,19,29,37,48,85,25,6,31,11,41,23,7,14,103,109
2015,2,21500091,11/7/2015,1610612762,Utah Jazz,1,1,1610612763,Memphis Grizzlies,0,0,19,28,47,12,15,27,31,43,74,15,3,18,11,33,18,8,21,93,89
2015,2,21500091,11/7/2015,1610612763,Memphis Grizzlies,0,0,1610612762,Utah Jazz,1,1,24,48,72,6,13,19,30,61,91,13,1,14,19,43,16,7,14,93,79
2015,2,21501173,4/7/2016,1610612737,Atlanta Hawks,1,1,1610612761,Toronto Raptors,0,0,21,23,44,12,20,32,33,43,76,17,4,21,7,38,23,10,13,93,95
2015,2,21501173,4/7/2016,1610612761,Toronto Raptors,0,0,1610612737,Atlanta Hawks,1,1,24,39,63,8,13,21,32,52,84,15,5,20,14,39,16,4,12,93,87
2015,2,21500944,3/8/2016,1610612751,Brooklyn Nets,0,0,1610612761,Toronto Raptors,1,1,36,34,70,6,6,12,42,40,82,9,0,9,11,29,23,9,16,91,99
2015,2,21500944,3/8/2016,1610612761,Toronto Raptors,1,1,1610612751,Brooklyn Nets,0,0,27,28,55,10,13,23,37,41,78,20,5,25,16,27,24,7,17,90,104
2016,2,21600206,11/21/2016,1610612742,Dallas Mavericks,0,0,1610612759,San Antonio Spurs,1,1,27,20,47,8,19,27,35,39,74,13,7,20,11,31,16,9,17,90,91
2016,2,21600206,11/21/2016,1610612759,San Antonio Spurs,1,1,1610612742,Dallas Mavericks,0,0,27,28,55,8,12,20,35,40,75,18,7,25,10,34,24,10,14,91,96
2015,2,21500588,1/14/2016,1610612753,Orlando Magic,1,0,1610612761,Toronto Raptors,0,1,35,39,74,9,14,23,44,53,97,6,2,8,14,40,28,11,16,105,103
2015,2,21500588,1/14/2016,1610612761,Toronto Raptors,0,1,1610612753,Orlando Magic,1,0,29,37,66,8,16,24,37,53,90,24,7,31,15,40,20,4,12,103,106
2015,2,21500281,12/3/2015,1610612754,Indiana Pacers,0,0,1610612757,Portland Trail Blazers,1,1,25,33,58,13,17,30,38,50,88,22,2,24,16,35,18,11,12,96,111
2015,2,21500281,12/3/2015,1610612757,Portland Trail Blazers,1,1,1610612754,Indiana Pacers,0,0,26,23,49,18,18,36,44,41,85,17,3,20,16,27,26,4,16,95,123
2015,2,21500186,11/20/2015,1610612746,LA Clippers,0,0,1610612757,Portland Trail Blazers,1,1,31,31,62,7,17,24,38,48,86,8,8,16,12,42,24,8,13,95,91
2015,2,21500186,11/20/2015,1610612757,Portland Trail Blazers,1,1,1610612746,LA Clippers,0,0,30,35,65,8,17,25,38,52,90,18,6,24,22,34,16,6,14,95,102
2015,2,21500090,11/7/2015,1610612759,San Antonio Spurs,1,1,1610612766,Charlotte Hornets,0,0,36,24,60,9,12,21,45,36,81,15,8,23,9,30,35,7,13,97,114
2015,2,21500090,11/7/2015,1610612766,Charlotte Hornets,0,0,1610612759,San Antonio Spurs,1,1,28,26,54,6,13,19,34,39,73,20,11,31,8,36,15,11,15,97,94
2014,2,21400909,3/5/2015,1610612741,Chicago Bulls,1,1,1610612760,Oklahoma City Thunder,0,0,33,29,62,7,18,25,40,47,87,21,5,26,14,35,26,8,10,96,108
2014,2,21400909,3/5/2015,1610612760,Oklahoma City Thunder,0,0,1610612741,Chicago Bulls,1,1,33,35,68,8,12,20,41,47,88,15,4,19,11,38,20,4,10,95,105
2015,2,21501106,3/28/2016,1610612738,Boston Celtics,0,0,1610612746,LA Clippers,1,1,24,46,70,7,12,19,31,58,89,21,6,27,22,37,14,13,16,98,90
2015,2,21501106,3/28/2016,1610612746,LA Clippers,1,1,1610612738,Boston Celtics,0,0,33,26,59,11,14,25,44,40,84,15,3,18,11,31,29,7,15,97,114
2015,2,21500886,2/29/2016,1610612738,Boston Celtics,1,1,1610612762,Utah Jazz,0,0,31,35,66,6,12,18,37,47,84,20,9,29,13,39,27,6,9,94,100
2015,2,21500886,2/29/2016,1610612762,Utah Jazz,0,0,1610612738,Boston Celtics,1,1,31,46,77,7,17,24,38,63,101,12,5,17,26,41,23,6,10,95,95
2015,2,21500777,2/8/2016,1610612746,LA Clippers,0,1,1610612755,Philadelphia 76ers,1,0,30,43,73,5,17,22,35,60,95,23,8,31,18,47,21,7,12,106,98
2015,2,21500777,2/8/2016,1610612755,Philadelphia 76ers,1,0,1610612746,LA Clippers,0,1,28,37,65,6,19,25,34,56,90,18,3,21,17,42,20,12,21,105,92
2016,2,21600685,1/25/2017,1610612761,Toronto Raptors,0,0,1610612763,Memphis Grizzlies,1,1,29,29,58,10,24,34,39,53,92,11,8,19,20,38,16,3,9,89,99
2016,2,21600685,1/25/2017,1610612763,Memphis Grizzlies,1,1,1610612761,Toronto Raptors,0,0,26,30,56,10,12,22,36,42,78,19,6,25,11,35,18,6,10,88,101
2015,2,21500686,1/27/2016,1610612755,Philadelphia 76ers,0,0,1610612765,Detroit Pistons,1,1,32,31,63,7,12,19,39,43,82,12,5,17,15,30,24,9,17,94,97
2015,2,21500686,1/27/2016,1610612765,Detroit Pistons,1,1,1610612755,Philadelphia 76ers,0,0,34,36,70,5,16,21,39,52,91,27,11,38,29,30,15,6,14,93,110
2015,2,21500644,1/21/2016,1610612756,Phoenix Suns,1,0,1610612759,San Antonio Spurs,0,1,26,37,63,6,12,18,32,49,81,19,4,23,15,36,18,8,15,93,89
2015,2,21500644,1/21/2016,1610612759,San Antonio Spurs,0,1,1610612756,Phoenix Suns,1,0,33,39,72,9,5,14,42,44,86,24,4,28,12,35,24,3,8,94,117
2015,2,21500484,12/31/2015,1610612749,Milwaukee Bucks,0,1,1610612754,Indiana Pacers,1,0,39,24,63,6,8,14,45,32,77,24,11,35,8,30,18,9,17,102,120
2015,2,21500484,12/31/2015,1610612754,Indiana Pacers,1,0,1610612749,Milwaukee Bucks,0,1,28,24,52,13,17,30,41,41,82,21,5,26,12,29,27,12,20,104,116
2015,2,21500382,12/16/2015,1610612746,LA Clippers,1,1,1610612749,Milwaukee Bucks,0,0,25,29,54,11,10,21,36,39,75,20,4,24,15,26,25,9,16,86,103
2015,2,21500382,12/16/2015,1610612749,Milwaukee Bucks,0,0,1610612746,LA Clippers,1,1,33,39,72,5,11,16,38,50,88,9,2,11,20,31,21,7,12,85,90
2015,2,21501172,4/6/2016,1610612746,LA Clippers,0,1,1610612747,Los Angeles Lakers,1,0,30,28,58,7,18,25,37,46,83,10,4,14,12,36,23,6,11,91,91
2015,2,21501172,4/6/2016,1610612747,Los Angeles Lakers,1,0,1610612746,LA Clippers,0,1,28,43,71,4,15,19,32,58,90,13,4,17,20,40,12,10,12,90,81
2015,2,21501046,3/21/2016,1610612738,Boston Celtics,1,1,1610612753,Orlando Magic,0,0,33,30,63,7,15,22,40,45,85,20,4,24,13,32,22,9,15,97,107
2015,2,21501046,3/21/2016,1610612753,Orlando Magic,0,0,1610612738,Boston Celtics,1,1,34,40,74,5,14,19,39,54,93,13,6,19,17,40,15,8,11,97,96
2015,2,21500776,2/8/2016,1610612747,Los Angeles Lakers,0,0,1610612754,Indiana Pacers,1,1,21,37,58,8,27,35,29,64,93,21,5,26,17,49,13,8,12,100,87
2015,2,21500776,2/8/2016,1610612754,Indiana Pacers,1,1,1610612747,Los Angeles Lakers,0,0,27,24,51,4,23,27,31,47,78,23,10,33,10,39,13,10,16,99,89
2015,2,21500381,12/16/2015,1610612744,Golden State Warriors,1,1,1610612756,Phoenix Suns,0,0,31,25,56,15,17,32,46,42,88,21,6,27,10,34,32,11,17,109,128
2015,2,21500381,12/16/2015,1610612756,Phoenix Suns,0,0,1610612744,Golden State Warriors,1,1,36,33,69,5,17,22,41,50,91,16,2,18,11,40,28,12,21,108,103
2015,2,21500280,12/3/2015,1610612759,San Antonio Spurs,0,1,1610612763,Memphis Grizzlies,1,0,30,32,62,10,8,18,40,40,80,13,5,18,11,31,27,6,15,93,103
2015,2,21500280,12/3/2015,1610612763,Memphis Grizzlies,1,0,1610612759,San Antonio Spurs,0,1,28,36,64,2,14,16,30,50,80,21,4,25,12,38,19,8,11,94,83
2015,2,21500185,11/20/2015,1610612743,Denver Nuggets,1,0,1610612756,Phoenix Suns,0,1,36,30,66,5,19,24,41,49,90,20,6,26,18,33,24,7,12,98,107
2015,2,21500185,11/20/2015,1610612756,Phoenix Suns,0,1,1610612743,Denver Nuggets,1,0,25,27,52,15,12,27,40,39,79,19,6,25,15,27,22,8,20,98,114
2015,2,21500089,11/7/2015,1610612749,Milwaukee Bucks,1,1,1610612751,Brooklyn Nets,0,0,29,33,62,8,12,20,37,45,82,12,4,16,12,36,27,11,17,92,94
2015,2,21500089,11/7/2015,1610612751,Brooklyn Nets,0,0,1610612749,Milwaukee Bucks,1,1,31,42,73,3,6,9,34,48,82,15,4,19,18,33,18,9,18,91,86
2015,2,21500885,2/29/2016,1610612755,Philadelphia 76ers,0,0,1610612764,Washington Wizards,1,1,33,24,57,10,22,32,43,46,89,12,9,21,10,41,27,6,12,100,108
2015,2,21500885,2/29/2016,1610612764,Washington Wizards,1,1,1610612755,Philadelphia 76ers,0,0,37,32,69,6,14,20,43,46,89,24,7,31,19,29,25,8,17,101,116
2015,2,21500823,2/21/2016,1610612740,New Orleans Pelicans,0,1,1610612765,Detroit Pistons,1,0,37,29,66,4,16,20,41,45,86,25,4,29,16,30,23,9,15,100,111
2015,2,21500823,2/21/2016,1610612765,Detroit Pistons,1,0,1610612740,New Orleans Pelicans,0,1,25,31,56,12,21,33,37,52,89,20,12,32,14,43,18,5,11,100,106
2015,2,21500685,1/27/2016,1610612738,Boston Celtics,1,1,1610612743,Denver Nuggets,0,0,32,36,68,9,19,28,41,55,96,20,4,24,17,40,29,4,12,103,111
2015,2,21500685,1/27/2016,1610612743,Denver Nuggets,0,0,1610612738,Boston Celtics,1,1,29,34,63,7,14,21,36,48,84,24,8,32,17,35,23,15,20,102,103
2015,2,21500643,1/21/2016,1610612737,Atlanta Hawks,0,0,1610612758,Sacramento Kings,1,1,27,24,51,8,25,33,35,49,84,10,5,15,12,41,21,13,19,98,88
2015,2,21500643,1/21/2016,1610612758,Sacramento Kings,1,1,1610612737,Atlanta Hawks,0,0,26,42,68,7,17,24,33,59,92,18,6,24,25,36,24,15,19,98,91
2015,2,21500483,12/30/2015,1610612755,Philadelphia 76ers,0,1,1610612758,Sacramento Kings,1,0,31,32,63,9,22,31,40,54,94,21,13,34,18,45,23,5,13,105,110
2015,2,21500483,12/30/2015,1610612758,Sacramento Kings,1,0,1610612755,Philadelphia 76ers,0,1,28,21,49,8,17,25,36,38,74,25,16,41,11,38,23,10,22,105,105
2015,2,21500380,12/16/2015,1610612740,New Orleans Pelicans,0,1,1610612762,Utah Jazz,1,0,24,28,52,10,11,21,34,39,73,26,2,28,8,31,14,4,10,86,104
2015,2,21500380,12/16/2015,1610612762,Utah Jazz,1,0,1610612740,New Orleans Pelicans,0,1,25,22,47,7,13,20,32,35,67,23,6,29,7,30,17,9,13,88,94
2014,2,21400908,3/4/2015,1610612746,LA Clippers,1,0,1610612757,Portland Trail Blazers,0,1,26,39,65,11,20,31,37,59,96,8,10,18,10,54,25,3,9,106,93
2014,2,21400908,3/4/2015,1610612757,Portland Trail Blazers,0,1,1610612746,LA Clippers,1,0,26,29,55,8,24,32,34,53,87,22,7,29,12,44,19,6,16,105,98
2015,2,21500587,1/14/2016,1610612741,Chicago Bulls,0,1,1610612755,Philadelphia 76ers,1,0,34,37,71,7,10,17,41,47,88,26,5,31,22,28,17,13,23,103,115
2015,2,21500587,1/14/2016,1610612755,Philadelphia 76ers,1,0,1610612741,Chicago Bulls,0,1,30,36,66,12,15,27,42,51,93,15,5,20,14,37,23,9,14,104,111
2015,2,21500482,12/30/2015,1610612743,Denver Nuggets,0,0,1610612757,Portland Trail Blazers,1,1,25,35,60,12,15,27,37,50,87,17,2,19,14,37,20,8,14,96,103
2015,2,21500482,12/30/2015,1610612757,Portland Trail Blazers,1,1,1610612743,Denver Nuggets,0,0,29,26,55,12,20,32,41,46,87,16,4,20,15,34,22,9,15,97,110
2015,2,21500378,12/16/2015,1610612757,Portland Trail Blazers,0,0,1610612760,Oklahoma City Thunder,1,1,21,45,66,11,15,26,32,60,92,15,3,18,19,42,13,6,18,100,90
2015,2,21500378,12/16/2015,1610612760,Oklahoma City Thunder,1,1,1610612757,Portland Trail Blazers,0,0,36,29,65,2,12,14,38,41,79,28,9,37,16,30,13,6,19,100,106
2015,2,21500279,12/3/2015,1610612753,Orlando Magic,0,1,1610612762,Utah Jazz,1,0,32,34,66,8,15,23,40,49,89,15,0,15,14,35,19,4,11,96,103
2015,2,21500279,12/3/2015,1610612762,Utah Jazz,1,0,1610612753,Orlando Magic,0,1,17,22,39,14,19,33,31,41,72,18,6,24,10,33,18,13,21,95,94
2015,2,21500184,11/20/2015,1610612742,Dallas Mavericks,1,1,1610612762,Utah Jazz,0,0,31,24,55,8,20,28,39,44,83,16,1,17,13,31,24,4,9,89,102
2015,2,21500184,11/20/2015,1610612762,Utah Jazz,0,0,1610612742,Dallas Mavericks,1,1,29,31,60,6,14,20,35,45,80,17,4,21,20,28,14,10,17,88,93
2015,2,21500088,11/7/2015,1610612740,New Orleans Pelicans,0,0,1610612742,Dallas Mavericks,1,1,30,28,58,9,19,28,39,47,86,11,2,13,10,38,21,5,12,96,98
2015,2,21500088,11/7/2015,1610612742,Dallas Mavericks,1,1,1610612740,New Orleans Pelicans,0,0,31,29,60,9,15,24,40,44,84,18,4,22,9,36,20,7,11,95,107
2015,2,21501105,3/28/2016,1610612757,Portland Trail Blazers,1,1,1610612758,Sacramento Kings,0,0,24,27,51,14,15,29,38,42,80,15,3,18,9,35,25,11,19,99,105
2015,2,21501105,3/28/2016,1610612758,Sacramento Kings,0,0,1610612757,Portland Trail Blazers,1,1,30,44,74,7,8,15,37,52,89,12,7,19,15,39,20,6,15,99,93
2015,2,21500996,3/14/2016,1610612740,New Orleans Pelicans,0,0,1610612744,Golden State Warriors,1,1,28,40,68,7,18,25,35,58,93,30,4,34,20,40,18,6,9,99,107
2015,2,21500996,3/14/2016,1610612744,Golden State Warriors,1,1,1610612740,New Orleans Pelicans,0,0,35,21,56,12,13,25,47,34,81,19,4,23,10,25,30,14,18,97,125
2015,2,21500943,3/7/2016,1610612744,Golden State Warriors,1,1,1610612753,Orlando Magic,0,0,26,23,49,16,19,35,42,42,84,19,8,27,13,34,27,14,24,110,119
2015,2,21500943,3/7/2016,1610612753,Orlando Magic,0,0,1610612744,Golden State Warriors,1,1,35,34,69,5,16,21,40,50,90,28,6,34,11,40,24,13,15,110,113
2015,2,21500775,2/8/2016,1610612739,Cleveland Cavaliers,1,1,1610612758,Sacramento Kings,0,0,29,30,59,16,19,35,45,49,94,14,5,19,14,37,27,11,14,104,120
2015,2,21500775,2/8/2016,1610612758,Sacramento Kings,0,0,1610612739,Cleveland Cavaliers,1,1,27,32,59,9,14,23,36,46,82,19,10,29,9,41,28,7,17,104,100
2015,2,21500642,1/21/2016,1610612743,Denver Nuggets,1,0,1610612763,Memphis Grizzlies,0,1,27,23,50,9,21,30,36,44,80,20,6,26,11,36,26,7,10,90,101
2015,2,21500642,1/21/2016,1610612763,Memphis Grizzlies,0,1,1610612743,Denver Nuggets,1,0,30,21,51,6,15,21,36,36,72,24,5,29,7,31,21,6,13,89,102
2015,2,21500481,12/30/2015,1610612756,Phoenix Suns,0,0,1610612759,San Antonio Spurs,1,1,27,36,63,5,13,18,32,49,81,10,8,18,9,43,18,13,15,95,79
2015,2,21500481,12/30/2015,1610612759,San Antonio Spurs,1,1,1610612756,Phoenix Suns,0,0,37,25,62,6,8,14,43,33,76,20,13,33,7,31,26,6,13,96,112
2015,2,21500377,12/16/2015,1610612741,Chicago Bulls,1,1,1610612763,Memphis Grizzlies,0,0,29,33,62,9,15,24,38,48,86,13,6,19,14,36,22,6,15,95,98
2015,2,21500377,12/16/2015,1610612763,Memphis Grizzlies,0,0,1610612741,Chicago Bulls,1,1,27,30,57,5,14,19,32,44,76,16,12,28,12,37,27,5,17,96,85
2015,2,21500995,3/14/2016,1610612750,Minnesota Timberwolves,0,0,1610612756,Phoenix Suns,1,1,33,35,68,4,12,16,37,47,84,26,4,30,7,40,25,8,16,106,104
2015,2,21500995,3/14/2016,1610612756,Phoenix Suns,1,1,1610612750,Minnesota Timberwolves,0,0,29,31,60,11,24,35,40,55,95,16,4,20,22,33,22,13,24,106,107
2015,2,21500884,2/29/2016,1610612739,Cleveland Cavaliers,1,1,1610612754,Indiana Pacers,0,0,26,28,54,9,20,29,35,48,83,21,4,25,20,29,22,8,13,87,100
2015,2,21500884,2/29/2016,1610612754,Indiana Pacers,0,0,1610612739,Cleveland Cavaliers,1,1,29,33,62,8,10,18,37,43,80,14,1,15,12,31,23,4,12,86,96
2014,2,21400907,3/4/2015,1610612744,Golden State Warriors,1,1,1610612749,Milwaukee Bucks,0,0,23,16,39,14,20,34,37,36,73,14,11,25,10,31,30,11,18,94,102
2014,2,21400907,3/4/2015,1610612749,Milwaukee Bucks,0,0,1610612744,Golden State Warriors,1,1,29,37,66,5,9,14,34,46,80,20,5,25,21,30,17,16,24,95,93
2015,2,21500732,2/2/2016,1610612756,Phoenix Suns,1,0,1610612761,Toronto Raptors,0,1,25,23,48,12,19,31,37,42,79,11,4,15,12,31,23,9,17,93,97
2015,2,21500732,2/2/2016,1610612761,Toronto Raptors,0,1,1610612756,Phoenix Suns,1,0,26,21,47,9,18,27,35,39,74,25,7,32,11,31,15,5,13,93,104
2015,2,21500684,1/27/2016,1610612739,Cleveland Cavaliers,1,1,1610612756,Phoenix Suns,0,0,34,19,53,11,17,28,45,36,81,14,2,16,13,23,34,6,15,92,115
2015,2,21500684,1/27/2016,1610612756,Phoenix Suns,0,0,1610612739,Cleveland Cavaliers,1,1,25,25,50,8,12,20,33,37,70,19,6,25,14,28,25,12,23,91,93
2016,2,21600684,1/25/2017,1610612749,Milwaukee Bucks,1,0,1610612755,Philadelphia 76ers,0,1,35,28,63,7,21,28,42,49,91,18,5,23,18,35,26,9,19,100,109
2016,2,21600684,1/25/2017,1610612755,Philadelphia 76ers,0,1,1610612749,Milwaukee Bucks,1,0,28,21,49,12,14,26,40,35,75,22,3,25,12,25,32,11,24,99,114
2015,2,21500480,12/30/2015,1610612742,Dallas Mavericks,1,1,1610612744,Golden State Warriors,0,0,28,27,55,14,13,27,42,40,82,16,4,20,13,29,20,9,15,95,114
2015,2,21500480,12/30/2015,1610612744,Golden State Warriors,0,0,1610612742,Dallas Mavericks,1,1,26,36,62,7,12,19,33,48,81,18,6,24,9,42,20,6,12,94,91
2015,2,21500376,12/16/2015,1610612737,Atlanta Hawks,1,1,1610612755,Philadelphia 76ers,0,0,38,19,57,10,11,21,48,30,78,21,3,24,5,26,32,5,12,97,127
2015,2,21500376,12/16/2015,1610612755,Philadelphia 76ers,0,0,1610612737,Atlanta Hawks,1,1,27,22,49,12,14,26,39,36,75,16,8,24,13,25,20,11,24,96,106
2015,2,21500278,12/3/2015,1610612743,Denver Nuggets,0,1,1610612761,Toronto Raptors,1,0,26,28,54,12,15,27,38,43,81,18,0,18,9,34,30,9,11,92,106
2015,2,21500278,12/3/2015,1610612761,Toronto Raptors,1,0,1610612743,Denver Nuggets,0,1,31,34,65,8,19,27,39,53,92,19,3,22,14,40,21,2,5,93,105
2015,2,21500183,11/20/2015,1610612752,New York Knicks,0,1,1610612760,Oklahoma City Thunder,1,0,21,31,52,12,8,20,33,39,72,15,8,23,12,30,23,9,20,92,93
2015,2,21500183,11/20/2015,1610612760,Oklahoma City Thunder,1,0,1610612752,New York Knicks,0,1,32,31,63,3,26,29,35,57,92,17,6,23,26,34,12,10,15,93,90
2015,2,21500087,11/7/2015,1610612753,Orlando Magic,0,1,1610612755,Philadelphia 76ers,1,0,33,37,70,6,7,13,39,44,83,21,3,24,15,32,24,6,13,93,105
2015,2,21500087,11/7/2015,1610612755,Philadelphia 76ers,1,0,1610612753,Orlando Magic,0,1,25,22,47,11,22,33,36,44,80,14,12,26,15,34,24,10,17,93,97
2014,2,21400906,3/4/2015,1610612758,Sacramento Kings,0,0,1610612759,San Antonio Spurs,1,1,26,43,69,3,6,9,29,49,78,24,10,34,16,38,15,13,18,97,85
2014,2,21400906,3/4/2015,1610612759,San Antonio Spurs,1,1,1610612758,Sacramento Kings,0,0,35,27,62,10,13,23,45,40,85,12,4,16,10,31,23,14,17,98,112
2015,2,21501171,4/6/2016,1610612757,Portland Trail Blazers,1,1,1610612760,Oklahoma City Thunder,0,0,28,23,51,15,18,33,43,41,84,19,5,24,11,34,32,9,15,99,120
2015,2,21501171,4/6/2016,1610612760,Oklahoma City Thunder,0,0,1610612757,Portland Trail Blazers,1,1,34,35,69,9,13,22,43,48,91,20,11,31,22,34,18,11,17,101,115
2016,2,21600205,11/21/2016,1610612738,Boston Celtics,0,1,1610612750,Minnesota Timberwolves,1,0,26,20,46,12,26,38,38,46,84,11,3,14,8,39,20,5,12,95,99
2016,2,21600205,11/21/2016,1610612750,Minnesota Timberwolves,1,0,1610612738,Boston Celtics,0,1,32,30,62,4,20,24,36,50,86,17,8,25,19,37,23,5,15,95,93
2015,2,21500822,2/20/2016,1610612744,Golden State Warriors,0,1,1610612746,LA Clippers,1,0,31,20,51,11,20,31,42,40,82,20,6,26,7,34,32,9,14,100,115
2015,2,21500822,2/20/2016,1610612746,LA Clippers,1,0,1610612744,Golden State Warriors,0,1,29,29,58,13,23,36,42,52,94,15,3,18,17,36,24,8,14,101,112
2015,2,21500586,1/13/2016,1610612746,LA Clippers,1,1,1610612748,Miami Heat,0,0,29,40,69,11,14,25,40,54,94,13,3,16,12,44,26,5,8,98,104
2015,2,21500586,1/13/2016,1610612748,Miami Heat,0,0,1610612746,LA Clippers,1,1,22,24,46,9,15,24,31,39,70,19,10,29,10,34,26,18,24,98,90
2015,2,21500479,12/30/2015,1610612750,Minnesota Timberwolves,1,1,1610612762,Utah Jazz,0,0,31,36,67,5,5,10,36,41,77,17,10,27,14,32,27,8,12,89,94
2015,2,21500479,12/30/2015,1610612762,Utah Jazz,0,0,1610612750,Minnesota Timberwolves,1,1,18,23,41,10,29,39,28,52,80,14,6,20,19,37,15,13,19,89,80
2015,2,21500277,12/3/2015,1610612748,Miami Heat,1,1,1610612760,Oklahoma City Thunder,0,0,37,31,68,3,10,13,40,41,81,14,10,24,9,36,25,5,9,94,97
2015,2,21500277,12/3/2015,1610612760,Oklahoma City Thunder,0,0,1610612748,Miami Heat,1,1,31,32,63,4,12,16,35,44,79,21,3,24,14,32,15,10,16,94,95
2015,2,21501104,3/28/2016,1610612747,Los Angeles Lakers,0,0,1610612762,Utah Jazz,1,1,19,46,65,7,13,20,26,59,85,16,6,22,13,47,11,4,9,91,75
2015,2,21501104,3/28/2016,1610612762,Utah Jazz,1,1,1610612747,Los Angeles Lakers,0,0,29,28,57,17,15,32,46,43,89,14,5,19,14,33,26,5,7,91,123
2016,2,21600683,1/25/2017,1610612737,Atlanta Hawks,0,1,1610612741,Chicago Bulls,1,0,26,27,53,17,13,30,43,40,83,16,3,19,11,30,29,6,14,94,119
2016,2,21600683,1/25/2017,1610612741,Chicago Bulls,1,0,1610612737,Atlanta Hawks,0,1,35,32,67,8,19,27,43,51,94,20,6,26,18,35,18,5,7,96,114
2015,2,21500731,2/2/2016,1610612745,Houston Rockets,1,1,1610612748,Miami Heat,0,0,28,21,49,16,19,35,44,40,84,11,5,16,6,38,30,5,11,98,115
2015,2,21500731,2/2/2016,1610612748,Miami Heat,0,0,1610612745,Houston Rockets,1,1,32,36,68,6,11,17,38,47,85,20,7,27,18,32,26,9,17,98,102
2015,2,21500375,12/16/2015,1610612750,Minnesota Timberwolves,0,0,1610612752,New York Knicks,1,1,38,42,80,4,17,21,42,59,101,14,0,14,20,39,21,2,8,96,102
2015,2,21500375,12/16/2015,1610612752,New York Knicks,1,1,1610612750,Minnesota Timberwolves,0,0,29,35,64,8,13,21,37,48,85,25,5,30,16,34,28,12,15,97,107
2015,2,21500276,12/2/2015,1610612746,LA Clippers,1,0,1610612754,Indiana Pacers,0,1,24,28,52,6,21,27,30,49,79,25,14,39,15,41,19,7,15,100,91
2015,2,21500276,12/2/2015,1610612754,Indiana Pacers,0,1,1610612746,LA Clippers,1,0,25,31,56,7,13,20,32,44,76,32,7,39,10,35,16,4,15,100,103
2015,2,21500182,11/20/2015,1610612740,New Orleans Pelicans,1,1,1610612759,San Antonio Spurs,0,0,32,34,66,8,14,22,40,48,88,16,1,17,11,38,26,5,10,95,104
2015,2,21500182,11/20/2015,1610612759,San Antonio Spurs,0,0,1610612740,New Orleans Pelicans,1,1,25,42,67,9,8,17,34,50,84,13,3,16,6,46,22,3,8,96,90
2015,2,21500086,11/7/2015,1610612737,Atlanta Hawks,1,1,1610612764,Washington Wizards,0,0,30,29,59,13,20,33,43,49,92,15,0,15,15,34,37,11,14,99,114
2015,2,21500086,11/7/2015,1610612764,Washington Wizards,0,0,1610612737,Atlanta Hawks,1,1,30,24,54,8,16,24,38,40,78,15,2,17,12,30,27,12,25,99,99
2014,2,21400905,3/4/2015,1610612747,Los Angeles Lakers,0,0,1610612748,Miami Heat,1,1,31,39,70,7,11,18,38,50,88,11,6,17,11,44,23,8,14,99,94
2014,2,21400905,3/4/2015,1610612748,Miami Heat,1,1,1610612747,Los Angeles Lakers,0,0,29,34,63,3,13,16,32,47,79,33,10,43,17,35,16,11,15,99,100
2015,2,21500942,3/7/2016,1610612742,Dallas Mavericks,1,0,1610612746,LA Clippers,0,1,26,30,56,4,21,25,30,51,81,26,6,32,13,42,15,10,15,98,90
2015,2,21500942,3/7/2016,1610612746,LA Clippers,0,1,1610612742,Dallas Mavericks,1,0,27,24,51,12,20,32,39,44,83,19,10,29,8,41,18,5,10,100,109
2015,2,21500883,2/28/2016,1610612748,Miami Heat,0,1,1610612752,New York Knicks,1,0,39,37,76,1,7,8,40,44,84,17,4,21,18,29,25,8,16,93,98
2015,2,21500883,2/28/2016,1610612752,New York Knicks,1,0,1610612748,Miami Heat,0,1,26,46,72,6,9,15,32,55,87,11,1,12,12,44,16,9,12,93,81
2015,2,21500478,12/30/2015,1610612741,Chicago Bulls,1,1,1610612754,Indiana Pacers,0,0,31,37,68,6,12,18,37,49,86,22,5,27,20,32,15,14,22,102,102
2015,2,21500478,12/30/2015,1610612754,Indiana Pacers,0,0,1610612741,Chicago Bulls,1,1,30,45,75,7,15,22,37,60,97,19,5,24,21,42,18,6,13,102,100
2015,2,21500275,12/2/2015,1610612749,Milwaukee Bucks,0,0,1610612759,San Antonio Spurs,1,1,23,41,64,3,11,14,26,52,78,15,3,18,10,44,17,11,17,96,70
2015,2,21500275,12/2/2015,1610612759,San Antonio Spurs,1,1,1610612749,Milwaukee Bucks,0,0,30,39,69,7,14,21,37,53,90,14,6,20,15,41,25,7,11,95,95
2015,2,21501170,4/6/2016,1610612742,Dallas Mavericks,1,1,1610612745,Houston Rockets,0,0,23,24,47,10,23,33,33,47,80,12,2,14,15,32,19,6,14,86,88
2015,2,21501170,4/6/2016,1610612745,Houston Rockets,0,0,1610612742,Dallas Mavericks,1,1,28,30,58,6,14,20,34,44,78,12,6,18,15,33,19,9,16,87,86
2015,2,21501045,3/21/2016,1610612754,Indiana Pacers,1,1,1610612755,Philadelphia 76ers,0,0,25,30,55,10,16,26,35,46,81,11,2,13,12,35,18,4,15,91,91
2015,2,21501045,3/21/2016,1610612755,Philadelphia 76ers,0,0,1610612754,Indiana Pacers,1,1,27,35,62,4,14,18,31,49,80,9,5,14,12,41,15,7,16,91,75
2015,2,21500774,2/8/2016,1610612741,Chicago Bulls,0,0,1610612766,Charlotte Hornets,1,1,25,40,65,10,15,25,35,55,90,11,3,14,9,48,25,6,7,94,91
2015,2,21500774,2/8/2016,1610612766,Charlotte Hornets,1,1,1610612741,Chicago Bulls,0,0,21,23,44,14,22,36,35,45,80,24,7,31,13,36,20,5,13,95,108
2016,2,21600682,1/25/2017,1610612748,Miami Heat,0,1,1610612751,Brooklyn Nets,1,0,29,31,60,11,12,23,40,43,83,18,7,25,12,34,23,3,13,97,109
2016,2,21600682,1/25/2017,1610612751,Brooklyn Nets,1,0,1610612748,Miami Heat,0,1,22,23,45,13,22,35,35,45,80,23,3,26,9,38,20,7,15,98,106
2015,2,21500641,1/21/2016,1610612740,New Orleans Pelicans,1,1,1610612765,Detroit Pistons,0,0,41,33,74,5,7,12,46,40,86,18,0,18,12,28,26,5,10,95,115
2015,2,21500641,1/21/2016,1610612765,Detroit Pistons,0,0,1610612740,New Orleans Pelicans,1,1,31,30,61,7,23,30,38,53,91,16,4,20,22,33,17,8,15,94,99
2015,2,21500585,1/13/2016,1610612740,New Orleans Pelicans,0,1,1610612758,Sacramento Kings,1,0,26,41,67,16,17,33,42,58,100,9,2,11,16,44,27,4,7,97,109
2015,2,21500585,1/13/2016,1610612758,Sacramento Kings,1,0,1610612740,New Orleans Pelicans,0,1,35,26,61,6,17,23,41,43,84,9,5,14,13,33,21,10,18,97,97
2015,2,21500374,12/16/2015,1610612738,Boston Celtics,0,0,1610612765,Detroit Pistons,1,1,33,31,64,10,15,25,43,46,89,20,4,24,18,30,17,5,18,101,116
2015,2,21500374,12/16/2015,1610612765,Detroit Pistons,1,1,1610612738,Boston Celtics,0,0,27,30,57,11,10,21,38,40,78,32,11,43,9,39,13,4,12,101,119
2015,2,21500181,11/20/2015,1610612750,Minnesota Timberwolves,1,0,1610612765,Detroit Pistons,0,1,30,34,64,3,10,13,33,44,77,17,8,25,8,40,17,11,17,97,86
2015,2,21500181,11/20/2015,1610612765,Detroit Pistons,0,1,1610612750,Minnesota Timberwolves,1,0,34,25,59,6,22,28,40,47,87,10,3,13,11,37,13,7,14,98,96
2015,2,21500085,11/7/2015,1610612741,Chicago Bulls,1,0,1610612750,Minnesota Timberwolves,0,1,22,39,61,11,21,32,33,60,93,16,7,23,15,48,20,8,19,107,93
2015,2,21500085,11/7/2015,1610612750,Minnesota Timberwolves,0,1,1610612741,Chicago Bulls,1,0,32,48,80,7,9,16,39,57,96,17,10,27,17,45,26,7,15,108,102
2014,2,21400904,3/4/2015,1610612755,Philadelphia 76ers,0,0,1610612760,Oklahoma City Thunder,1,1,19,42,61,15,20,35,34,62,96,35,9,44,18,49,20,9,16,114,118
2014,2,21400904,3/4/2015,1610612760,Oklahoma City Thunder,1,1,1610612755,Philadelphia 76ers,0,0,37,38,75,7,14,21,44,52,96,28,6,34,11,45,19,8,15,115,123
2015,2,21500882,2/28/2016,1610612742,Dallas Mavericks,1,1,1610612750,Minnesota Timberwolves,0,0,34,19,53,13,23,36,47,42,89,21,0,21,10,32,34,5,8,98,128
2015,2,21500882,2/28/2016,1610612750,Minnesota Timberwolves,0,0,1610612742,Dallas Mavericks,1,1,27,40,67,7,16,23,34,56,90,26,11,37,25,37,19,9,15,97,101
2015,2,21500773,2/7/2016,1610612738,Boston Celtics,1,1,1610612758,Sacramento Kings,0,0,38,29,67,13,11,24,51,40,91,13,2,15,14,27,34,15,24,108,128
2015,2,21500773,2/7/2016,1610612758,Sacramento Kings,0,0,1610612738,Boston Celtics,1,1,37,32,69,10,16,26,47,48,95,15,4,19,11,38,32,9,14,107,119
2015,2,21500730,2/2/2016,1610612738,Boston Celtics,0,1,1610612752,New York Knicks,1,0,37,34,71,3,16,19,40,50,90,14,3,17,15,37,20,3,10,94,97
2015,2,21500730,2/2/2016,1610612752,New York Knicks,1,0,1610612738,Boston Celtics,0,1,25,37,62,6,14,20,31,51,82,21,7,28,19,37,13,9,17,93,89
2015,2,21500683,1/26/2016,1610612742,Dallas Mavericks,0,1,1610612747,Los Angeles Lakers,1,0,27,24,51,6,19,25,33,43,76,20,6,26,7,40,21,4,6,87,92
2015,2,21500683,1/26/2016,1610612747,Los Angeles Lakers,1,0,1610612742,Dallas Mavericks,0,1,23,26,49,7,18,25,30,44,74,23,5,28,15,32,15,5,14,89,90
2016,2,21600681,1/25/2017,1610612738,Boston Celtics,1,1,1610612745,Houston Rockets,0,0,36,23,59,11,21,32,47,44,91,15,1,16,17,27,33,8,18,100,120
2016,2,21600681,1/25/2017,1610612745,Houston Rockets,0,0,1610612738,Boston Celtics,1,1,26,20,46,10,21,31,36,41,77,27,11,38,10,38,28,10,17,100,109
2015,2,21500477,12/30/2015,1610612761,Toronto Raptors,1,1,1610612764,Washington Wizards,0,0,22,36,58,6,18,24,28,54,82,32,7,39,21,38,14,8,18,96,94
2015,2,21500477,12/30/2015,1610612764,Washington Wizards,0,0,1610612761,Toronto Raptors,1,1,27,38,65,8,14,22,35,52,87,13,4,17,10,42,24,5,10,96,91
2015,2,21500274,12/2/2015,1610612740,New Orleans Pelicans,0,0,1610612745,Houston Rockets,1,1,29,34,63,7,18,25,36,52,88,22,3,25,19,35,20,9,23,102,101
2015,2,21500274,12/2/2015,1610612745,Houston Rockets,1,1,1610612740,New Orleans Pelicans,0,0,28,32,60,8,19,27,36,51,87,28,11,39,14,44,20,5,10,102,108
2015,2,21500180,11/20/2015,1610612745,Houston Rockets,0,0,1610612763,Memphis Grizzlies,1,1,22,23,45,6,23,29,28,46,74,22,15,37,14,41,15,16,23,100,84
2015,2,21500180,11/20/2015,1610612763,Memphis Grizzlies,1,1,1610612745,Houston Rockets,0,0,28,33,61,8,16,24,36,49,85,16,3,19,8,43,26,11,12,99,96
2014,2,21400903,3/4/2015,1610612740,New Orleans Pelicans,1,1,1610612765,Detroit Pistons,0,0,35,43,78,2,10,12,37,53,90,12,4,16,18,36,18,8,15,96,88
2014,2,21400903,3/4/2015,1610612765,Detroit Pistons,0,0,1610612740,New Orleans Pelicans,1,1,36,43,79,2,12,14,38,55,93,7,2,9,21,35,25,7,19,96,85
2015,2,21501169,4/6/2016,1610612752,New York Knicks,1,0,1610612766,Charlotte Hornets,0,1,27,25,52,10,16,26,37,41,78,13,2,15,11,31,24,9,18,91,97
2015,2,21501169,4/6/2016,1610612766,Charlotte Hornets,0,1,1610612752,New York Knicks,1,0,30,34,64,12,14,26,42,48,90,15,2,17,15,35,19,5,8,91,111
2015,2,21500994,3/14/2016,1610612739,Cleveland Cavaliers,0,0,1610612762,Utah Jazz,1,1,25,20,45,10,33,43,35,53,88,5,3,8,18,35,18,3,8,82,85
2015,2,21500994,3/14/2016,1610612762,Utah Jazz,1,1,1610612739,Cleveland Cavaliers,0,0,23,21,44,12,15,27,35,36,71,12,2,14,11,27,20,6,13,82,94
2015,2,21500941,3/7/2016,1610612740,New Orleans Pelicans,1,1,1610612758,Sacramento Kings,0,0,38,31,69,7,18,25,45,49,94,18,8,26,12,41,23,12,17,110,115
2015,2,21500941,3/7/2016,1610612758,Sacramento Kings,0,0,1610612740,New Orleans Pelicans,1,1,34,24,58,7,18,25,41,42,83,23,4,27,9,34,27,17,24,110,112
2015,2,21500881,2/28/2016,1610612753,Orlando Magic,1,1,1610612755,Philadelphia 76ers,0,0,39,31,70,10,6,16,49,37,86,22,3,25,7,31,28,6,13,104,130
2015,2,21500881,2/28/2016,1610612755,Philadelphia 76ers,0,0,1610612753,Orlando Magic,1,1,36,19,55,5,17,22,41,36,77,29,8,37,10,30,20,9,18,105,116
2015,2,21500584,1/13/2016,1610612757,Portland Trail Blazers,1,1,1610612762,Utah Jazz,0,0,28,34,62,11,15,26,39,49,88,10,5,15,21,31,25,8,13,87,99
2015,2,21500584,1/13/2016,1610612762,Utah Jazz,0,0,1610612757,Portland Trail Blazers,1,1,23,34,57,8,11,19,31,45,76,15,7,22,14,37,20,7,14,87,85
2015,2,21500373,12/16/2015,1610612748,Miami Heat,0,1,1610612751,Brooklyn Nets,1,0,33,21,54,7,14,21,40,35,75,17,7,24,10,28,16,6,12,89,104
2015,2,21500373,12/16/2015,1610612751,Brooklyn Nets,1,0,1610612748,Miami Heat,0,1,38,35,73,4,12,16,42,47,89,10,4,14,12,37,24,4,6,90,98
2015,2,21500179,11/20/2015,1610612738,Boston Celtics,1,1,1610612751,Brooklyn Nets,0,0,41,17,58,10,19,29,51,36,87,8,2,10,7,31,39,10,16,102,120
2015,2,21500179,11/20/2015,1610612751,Brooklyn Nets,0,0,1610612738,Boston Celtics,1,1,27,43,70,8,11,19,35,54,89,17,7,24,20,37,17,10,20,103,95
2015,2,21500084,11/6/2015,1610612745,Houston Rockets,0,1,1610612758,Sacramento Kings,1,0,25,21,46,15,21,36,40,42,82,21,6,27,14,33,23,14,22,102,116
2015,2,21500084,11/6/2015,1610612758,Sacramento Kings,1,0,1610612745,Houston Rockets,0,1,31,34,65,9,19,28,40,53,93,21,8,29,17,39,26,8,15,104,110
2015,2,21501102,3/28/2016,1610612740,New Orleans Pelicans,1,1,1610612752,New York Knicks,0,0,24,32,56,8,11,19,32,43,75,27,10,37,8,39,18,9,13,99,99
2015,2,21501102,3/28/2016,1610612752,New York Knicks,0,0,1610612740,New Orleans Pelicans,1,1,26,32,58,10,21,31,36,53,89,9,4,13,12,43,26,11,14,99,91
2015,2,21501044,3/21/2016,1610612739,Cleveland Cavaliers,1,1,1610612743,Denver Nuggets,0,0,33,22,55,15,16,31,48,38,86,13,4,17,11,28,38,10,13,95,124
2015,2,21501044,3/21/2016,1610612743,Denver Nuggets,0,0,1610612739,Cleveland Cavaliers,1,1,24,35,59,8,14,22,32,49,81,19,6,25,13,38,19,10,17,95,91
2015,2,21500993,3/14/2016,1610612757,Portland Trail Blazers,0,0,1610612760,Oklahoma City Thunder,1,1,24,40,64,7,20,27,31,60,91,25,2,27,20,42,13,10,11,96,94
2015,2,21500993,3/14/2016,1610612760,Oklahoma City Thunder,1,1,1610612757,Portland Trail Blazers,0,0,40,26,66,9,8,17,49,34,83,21,5,26,12,25,31,4,13,95,128
2015,2,21500880,2/28/2016,1610612754,Indiana Pacers,1,0,1610612757,Portland Trail Blazers,0,1,37,42,79,3,11,14,40,53,93,19,6,25,19,38,21,4,9,94,102
2015,2,21500880,2/28/2016,1610612757,Portland Trail Blazers,0,1,1610612754,Indiana Pacers,1,0,27,30,57,14,10,24,41,40,81,15,6,21,10,34,19,7,13,95,111
2015,2,21500772,2/7/2016,1610612746,LA Clippers,0,1,1610612748,Miami Heat,1,0,28,28,56,9,16,25,37,44,81,17,16,33,11,41,17,2,6,92,100
2015,2,21500772,2/7/2016,1610612748,Miami Heat,1,0,1610612746,LA Clippers,0,1,26,40,66,7,10,17,33,50,83,20,9,29,19,36,14,8,13,92,93
2015,2,21500640,1/21/2016,1610612739,Cleveland Cavaliers,1,1,1610612746,LA Clippers,0,0,29,26,55,13,15,28,42,41,83,18,6,24,14,30,29,9,15,95,115
2015,2,21500640,1/21/2016,1610612746,LA Clippers,0,0,1610612739,Cleveland Cavaliers,1,1,30,25,55,6,19,25,36,44,80,24,12,36,11,37,19,5,9,96,102
2015,2,21500476,12/30/2015,1610612738,Boston Celtics,1,0,1610612747,Los Angeles Lakers,0,1,31,30,61,7,20,27,38,50,88,21,4,25,12,40,23,5,10,98,104
2015,2,21500476,12/30/2015,1610612747,Los Angeles Lakers,0,1,1610612738,Boston Celtics,1,0,34,41,75,9,10,19,43,51,94,17,6,23,15,39,22,7,10,99,112
2015,2,21500273,12/2/2015,1610612741,Chicago Bulls,1,1,1610612743,Denver Nuggets,0,0,30,42,72,6,11,17,36,53,89,21,6,27,20,36,22,8,14,97,99
2015,2,21500273,12/2/2015,1610612743,Denver Nuggets,0,0,1610612741,Chicago Bulls,1,1,31,47,78,5,10,15,36,57,93,13,9,22,14,48,26,3,7,97,90
2015,2,21500178,11/20/2015,1610612755,Philadelphia 76ers,0,0,1610612766,Charlotte Hornets,1,1,24,29,53,8,18,26,32,47,79,16,6,22,13,36,21,7,18,95,88
2015,2,21500178,11/20/2015,1610612766,Charlotte Hornets,1,1,1610612755,Philadelphia 76ers,0,0,28,28,56,12,13,25,40,41,81,21,1,22,8,33,25,5,11,95,113
2016,2,21600204,11/21/2016,1610612749,Milwaukee Bucks,1,1,1610612753,Orlando Magic,0,0,27,30,57,8,21,29,35,51,86,15,6,21,10,44,25,8,14,99,93
2016,2,21600204,11/21/2016,1610612753,Orlando Magic,0,0,1610612749,Milwaukee Bucks,1,1,25,27,52,7,18,25,32,45,77,18,6,24,16,31,21,16,25,99,89
2015,2,21500879,2/28/2016,1610612761,Toronto Raptors,0,0,1610612765,Detroit Pistons,1,1,29,30,59,10,11,21,39,41,80,13,5,18,9,33,21,2,5,83,101
2015,2,21500879,2/28/2016,1610612765,Detroit Pistons,1,1,1610612761,Toronto Raptors,0,0,29,19,48,12,11,23,41,30,71,20,7,27,9,24,28,5,12,83,114
2015,2,21500821,2/20/2016,1610612750,Minnesota Timberwolves,1,0,1610612752,New York Knicks,0,1,31,41,72,5,7,12,36,48,84,18,7,25,9,44,24,4,7,93,95
2015,2,21500821,2/20/2016,1610612752,New York Knicks,0,1,1610612750,Minnesota Timberwolves,1,0,37,29,66,5,12,17,42,41,83,14,2,16,14,27,17,9,17,95,103
2015,2,21500583,1/13/2016,1610612743,Denver Nuggets,1,1,1610612744,Golden State Warriors,0,0,32,33,65,5,17,22,37,50,87,33,4,37,18,34,22,9,13,100,112
2015,2,21500583,1/13/2016,1610612744,Golden State Warriors,0,0,1610612743,Denver Nuggets,1,1,32,30,62,10,16,26,42,46,88,16,4,20,9,39,25,7,13,100,110
2015,2,21500372,12/16/2015,1610612753,Orlando Magic,1,1,1610612766,Charlotte Hornets,0,0,29,24,53,14,10,24,43,34,77,13,2,15,8,27,28,12,17,92,113
2015,2,21500372,12/16/2015,1610612766,Charlotte Hornets,0,0,1610612753,Orlando Magic,1,1,22,23,45,14,20,34,36,43,79,12,3,15,8,37,23,12,16,94,98
2015,2,21500177,11/19/2015,1610612744,Golden State Warriors,0,1,1610612746,LA Clippers,1,0,21,22,43,17,13,30,38,35,73,31,5,36,10,27,31,11,19,101,124
2015,2,21500177,11/19/2015,1610612746,LA Clippers,1,0,1610612744,Golden State Warriors,0,1,31,28,59,13,16,29,44,44,88,16,8,24,11,37,21,4,11,100,117
2015,2,21500083,11/6/2015,1610612743,Denver Nuggets,0,0,1610612744,Golden State Warriors,1,1,31,37,68,8,16,24,39,53,92,18,4,22,15,41,23,10,19,107,104
2015,2,21500083,11/6/2015,1610612744,Golden State Warriors,1,1,1610612743,Denver Nuggets,0,0,29,27,56,17,20,37,46,47,93,10,8,18,16,36,40,13,20,107,119
2015,2,21501168,4/6/2016,1610612738,Boston Celtics,1,1,1610612740,New Orleans Pelicans,0,0,26,27,53,10,24,34,36,51,87,22,5,27,10,44,24,5,10,100,104
2015,2,21501168,4/6/2016,1610612740,New Orleans Pelicans,0,0,1610612738,Boston Celtics,1,1,25,29,54,9,15,24,34,44,78,20,3,23,11,34,21,10,23,100,97
2014,2,21400902,3/4/2015,1610612743,Denver Nuggets,0,1,1610612750,Minnesota Timberwolves,1,0,34,38,72,8,12,20,42,50,92,8,2,10,18,33,27,7,14,95,100
2014,2,21400902,3/4/2015,1610612750,Minnesota Timberwolves,1,0,1610612743,Denver Nuggets,0,1,29,35,64,3,15,18,32,50,82,18,7,25,14,39,18,8,13,95,85
2015,2,21500878,2/28/2016,1610612737,Atlanta Hawks,1,1,1610612766,Charlotte Hornets,0,0,30,30,60,8,9,17,38,39,77,3,2,5,9,32,29,7,17,88,87
2015,2,21500878,2/28/2016,1610612766,Charlotte Hornets,0,0,1610612737,Atlanta Hawks,1,1,20,29,49,7,25,32,27,54,81,15,8,23,13,45,16,4,7,87,76
2015,2,21500820,2/20/2016,1610612748,Miami Heat,1,1,1610612764,Washington Wizards,0,0,45,38,83,2,11,13,47,49,96,18,10,28,20,35,23,5,8,97,114
2015,2,21500820,2/20/2016,1610612764,Washington Wizards,0,0,1610612748,Miami Heat,1,1,37,40,77,3,19,22,40,59,99,11,10,21,17,48,13,2,6,98,94
2015,2,21500771,2/7/2016,1610612737,Atlanta Hawks,0,0,1610612753,Orlando Magic,1,1,22,41,63,13,15,28,35,56,91,11,4,15,20,37,22,9,16,95,94
2015,2,21500771,2/7/2016,1610612753,Orlando Magic,1,1,1610612737,Atlanta Hawks,0,0,32,28,60,7,18,25,39,46,85,11,1,12,15,32,24,7,18,95,96
2016,2,21600680,1/25/2017,1610612739,Cleveland Cavaliers,1,0,1610612758,Sacramento Kings,0,1,25,19,44,15,23,38,40,42,82,17,17,34,16,36,29,13,18,102,112
2016,2,21600680,1/25/2017,1610612758,Sacramento Kings,0,1,1610612739,Cleveland Cavaliers,1,0,32,32,64,11,20,31,43,52,95,19,3,22,16,36,29,9,12,102,116
2016,2,21600203,11/21/2016,1610612745,Houston Rockets,0,1,1610612765,Detroit Pistons,1,0,25,22,47,10,21,31,35,43,78,19,8,27,15,29,22,7,18,93,99
2016,2,21600203,11/21/2016,1610612765,Detroit Pistons,1,0,1610612745,Houston Rockets,0,1,29,41,70,7,10,17,36,51,87,17,7,24,18,36,19,4,14,95,96
2015,2,21500475,12/30/2015,1610612751,Brooklyn Nets,0,0,1610612753,Orlando Magic,1,1,32,31,63,3,17,20,35,48,83,20,2,22,14,35,23,6,12,91,93
2015,2,21500475,12/30/2015,1610612753,Orlando Magic,1,1,1610612751,Brooklyn Nets,0,0,27,29,56,9,17,26,36,46,82,19,2,21,20,27,21,12,17,89,100
2015,2,21500272,12/2/2015,1610612737,Atlanta Hawks,1,0,1610612761,Toronto Raptors,0,1,25,38,63,8,19,27,33,57,90,12,4,16,16,43,22,10,12,92,86
2015,2,21500272,12/2/2015,1610612761,Toronto Raptors,0,1,1610612737,Atlanta Hawks,1,0,30,24,54,6,19,25,36,43,79,18,6,24,13,34,12,8,13,93,96
2015,2,21500176,11/19/2015,1610612739,Cleveland Cavaliers,1,1,1610612749,Milwaukee Bucks,0,0,29,18,47,11,13,24,40,31,71,24,6,30,16,17,29,8,17,87,115
2015,2,21500176,11/19/2015,1610612749,Milwaukee Bucks,0,0,1610612739,Cleveland Cavaliers,1,1,35,30,65,3,5,8,38,35,73,21,5,26,8,31,22,3,11,87,100
2015,2,21500082,11/6/2015,1610612756,Phoenix Suns,1,0,1610612765,Detroit Pistons,0,1,27,35,62,10,20,30,37,55,92,8,5,13,15,42,14,8,16,100,92
2015,2,21500082,11/6/2015,1610612765,Detroit Pistons,0,1,1610612756,Phoenix Suns,1,0,29,23,52,8,14,22,37,37,74,18,18,36,7,37,15,8,16,100,100
2021,2,22100278,11/24/2021,1610612755,Philadelphia 76ers,0,0,1610612744,Golden State Warriors,1,1,26,26,52,8,20,28,34,46,80,20,2,22,10,37,17,7,21,101,96
2015,2,21500682,1/26/2016,1610612757,Portland Trail Blazers,1,1,1610612758,Sacramento Kings,0,0,35,25,60,9,21,30,44,46,90,15,4,19,11,38,28,7,13,100,112
2015,2,21500682,1/26/2016,1610612758,Sacramento Kings,0,0,1610612757,Portland Trail Blazers,1,1,29,38,67,7,12,19,36,50,86,18,14,32,17,39,26,6,14,101,97
2015,2,21500639,1/20/2016,1610612737,Atlanta Hawks,0,1,1610612757,Portland Trail Blazers,1,0,29,34,63,10,14,24,39,48,87,16,7,23,13,39,25,5,13,98,104
2015,2,21500639,1/20/2016,1610612757,Portland Trail Blazers,1,0,1610612737,Atlanta Hawks,0,1,32,31,63,9,22,31,41,53,94,7,4,11,16,38,23,7,13,97,98
2015,2,21500582,1/13/2016,1610612742,Dallas Mavericks,0,0,1610612760,Oklahoma City Thunder,1,1,26,25,51,6,25,31,32,50,82,19,6,25,13,41,18,11,16,99,89
2015,2,21500582,1/13/2016,1610612760,Oklahoma City Thunder,1,1,1610612742,Dallas Mavericks,0,0,23,26,49,15,18,33,38,44,82,17,12,29,17,34,24,7,18,98,108
2015,2,21500371,12/16/2015,1610612742,Dallas Mavericks,0,0,1610612754,Indiana Pacers,1,1,25,32,57,8,25,33,33,57,90,7,3,10,13,46,16,9,12,95,81
2015,2,21500371,12/16/2015,1610612754,Indiana Pacers,1,1,1610612742,Dallas Mavericks,0,0,32,28,60,11,18,29,43,46,89,10,7,17,11,39,28,2,8,94,107
2015,2,21500081,11/6/2015,1610612737,Atlanta Hawks,0,1,1610612740,New Orleans Pelicans,1,0,32,24,56,9,12,21,41,36,77,30,5,35,8,30,30,9,15,102,121
2015,2,21500081,11/6/2015,1610612740,New Orleans Pelicans,1,0,1610612737,Atlanta Hawks,0,1,32,22,54,10,20,30,42,42,84,21,3,24,7,36,30,10,13,100,115
2014,2,21400901,3/4/2015,1610612745,Houston Rockets,1,0,1610612763,Memphis Grizzlies,0,1,31,27,58,11,17,28,42,44,86,5,0,5,12,32,24,11,13,89,100
2014,2,21400901,3/4/2015,1610612763,Memphis Grizzlies,0,1,1610612745,Houston Rockets,1,0,38,29,67,4,12,16,42,41,83,14,3,17,13,29,27,7,10,89,102
2020,2,22000070,1/1/2021,1610612738,Boston Celtics,0,0,1610612765,Detroit Pistons,1,1,31,21,52,8,23,31,39,44,83,7,7,14,10,37,20,9,21,103,93
2022,2,22200525,12/29/2022,1610612738,Boston Celtics,1,1,1610612746,LA Clippers,0,0,33,19,52,11,28,39,44,47,91,17,5,22,14,36,22,4,12,100,116
2022,2,22200525,12/29/2022,1610612746,LA Clippers,0,0,1610612738,Boston Celtics,1,1,28,22,50,15,24,39,43,46,89,9,5,14,10,40,26,3,13,100,110
2020,2,22000949,4/30/2021,1610612737,Atlanta Hawks,0,0,1610612755,Philadelphia 76ers,1,1,26,28,54,10,18,28,36,46,82,22,6,28,14,34,19,8,18,100,104
2020,2,22000949,4/30/2021,1610612755,Philadelphia 76ers,1,1,1610612737,Atlanta Hawks,0,0,37,36,73,10,18,28,47,54,101,22,4,26,21,35,27,3,9,101,126
2015,2,21501043,3/21/2016,1610612759,San Antonio Spurs,0,0,1610612766,Charlotte Hornets,1,1,33,36,69,4,13,17,37,49,86,10,3,13,14,38,23,11,16,94,88
2015,2,21501043,3/21/2016,1610612766,Charlotte Hornets,1,1,1610612759,San Antonio Spurs,0,0,27,41,68,8,11,19,35,52,87,13,6,19,16,39,18,9,15,95,91
2015,2,21500729,2/1/2016,1610612749,Milwaukee Bucks,0,0,1610612758,Sacramento Kings,1,1,34,30,64,8,12,20,42,42,84,12,5,17,10,37,27,7,15,95,104
2015,2,21500729,2/1/2016,1610612758,Sacramento Kings,1,1,1610612749,Milwaukee Bucks,0,0,30,30,60,9,17,26,39,47,86,24,6,30,22,28,21,11,16,96,111
2015,2,21500681,1/26/2016,1610612749,Milwaukee Bucks,1,1,1610612753,Orlando Magic,0,0,33,31,64,5,8,13,38,39,77,26,5,31,14,28,22,6,12,91,107
2015,2,21500681,1/26/2016,1610612753,Orlando Magic,0,0,1610612749,Milwaukee Bucks,1,1,20,36,56,13,11,24,33,47,80,21,8,29,14,36,22,5,11,89,100
2015,2,21500581,1/13/2016,1610612745,Houston Rockets,1,1,1610612750,Minnesota Timberwolves,0,0,30,15,45,7,23,30,37,38,75,26,12,38,11,32,19,11,16,98,107
2015,2,21500581,1/13/2016,1610612750,Minnesota Timberwolves,0,0,1610612745,Houston Rockets,1,1,28,33,61,8,9,17,36,42,78,24,6,30,14,32,25,11,21,99,104
2015,2,21500474,12/30/2015,1610612746,LA Clippers,0,1,1610612766,Charlotte Hornets,1,0,22,19,41,15,15,30,37,34,71,33,8,41,8,31,27,8,13,94,122
2015,2,21500474,12/30/2015,1610612766,Charlotte Hornets,1,0,1610612746,LA Clippers,0,1,29,29,58,9,21,30,38,50,88,32,4,36,20,33,20,7,11,95,117
2015,2,21500370,12/15/2015,1610612747,Los Angeles Lakers,1,1,1610612749,Milwaukee Bucks,0,0,31,31,62,10,17,27,41,48,89,21,4,25,22,27,26,7,14,94,113
2015,2,21500370,12/15/2015,1610612749,Milwaukee Bucks,0,0,1610612747,Los Angeles Lakers,1,1,36,36,72,4,9,13,40,45,85,11,9,20,14,36,23,7,11,92,95
2015,2,21500271,12/2/2015,1610612752,New York Knicks,1,1,1610612755,Philadelphia 76ers,0,0,34,35,69,4,15,19,38,50,88,19,3,22,13,38,19,8,20,105,99
2015,2,21500271,12/2/2015,1610612755,Philadelphia 76ers,0,0,1610612752,New York Knicks,1,1,23,33,56,9,21,30,32,54,86,14,10,24,8,50,11,5,14,104,87
2015,2,21500175,11/19/2015,1610612748,Miami Heat,1,1,1610612758,Sacramento Kings,0,0,35,30,65,7,17,24,42,47,89,25,8,33,15,36,25,3,7,97,116
2015,2,21500175,11/19/2015,1610612758,Sacramento Kings,0,0,1610612748,Miami Heat,1,1,31,30,61,12,11,23,43,41,84,11,9,20,13,32,25,11,18,98,109
2015,2,21500080,11/6/2015,1610612748,Miami Heat,0,0,1610612754,Indiana Pacers,1,1,30,31,61,6,14,20,36,45,81,9,4,13,8,39,21,4,12,90,87
2015,2,21500080,11/6/2015,1610612754,Indiana Pacers,1,1,1610612748,Miami Heat,0,0,31,34,65,5,10,15,36,44,80,13,11,24,12,37,21,5,12,91,90
2015,2,21501167,4/6/2016,1610612751,Brooklyn Nets,0,0,1610612764,Washington Wizards,1,1,32,43,75,7,10,17,39,53,92,18,6,24,15,40,26,7,11,98,103
2015,2,21501167,4/6/2016,1610612764,Washington Wizards,1,1,1610612751,Brooklyn Nets,0,0,40,27,67,8,20,28,48,47,95,17,3,20,19,29,36,7,12,99,121
2015,2,21500638,1/20/2016,1610612747,Los Angeles Lakers,1,0,1610612758,Sacramento Kings,0,1,28,37,65,4,21,25,32,58,90,25,6,31,17,45,17,6,10,96,93
2015,2,21500638,1/20/2016,1610612758,Sacramento Kings,0,1,1610612747,Los Angeles Lakers,1,0,37,32,69,6,14,20,43,46,89,20,8,28,20,29,28,6,14,97,112
2015,2,21500580,1/13/2016,1610612738,Boston Celtics,1,1,1610612754,Indiana Pacers,0,0,31,33,64,9,17,26,40,50,90,14,6,20,15,39,24,12,19,104,103
2015,2,21500580,1/13/2016,1610612754,Indiana Pacers,0,0,1610612738,Boston Celtics,1,1,32,29,61,5,25,30,37,54,91,15,5,20,17,40,18,7,20,104,94
2015,2,21500369,12/15/2015,1610612745,Houston Rockets,0,0,1610612758,Sacramento Kings,1,1,22,21,43,12,27,39,34,48,82,17,6,23,10,42,22,13,22,107,97
2015,2,21500369,12/15/2015,1610612758,Sacramento Kings,1,1,1610612745,Houston Rockets,0,0,27,24,51,11,13,24,38,37,75,20,9,29,13,30,25,17,29,108,107
2015,2,21500079,11/6/2015,1610612749,Milwaukee Bucks,0,1,1610612752,New York Knicks,1,0,32,35,67,3,11,14,35,46,81,26,3,29,16,31,21,3,12,93,99
2015,2,21500079,11/6/2015,1610612752,New York Knicks,1,0,1610612749,Milwaukee Bucks,0,1,29,28,57,4,20,24,33,48,81,22,6,28,20,31,20,6,18,92,92
2014,2,21400900,3/4/2015,1610612739,Cleveland Cavaliers,0,1,1610612761,Toronto Raptors,1,0,25,17,42,15,21,36,40,38,78,25,9,34,13,27,27,5,9,89,120
2014,2,21400900,3/4/2015,1610612761,Toronto Raptors,1,0,1610612739,Cleveland Cavaliers,0,1,33,25,58,10,11,21,43,36,79,16,1,17,7,29,24,7,9,88,112
2015,2,21501166,4/6/2016,1610612753,Orlando Magic,1,0,1610612765,Detroit Pistons,0,1,39,36,75,4,11,15,43,47,90,14,5,19,17,34,25,9,14,98,104
2015,2,21501166,4/6/2016,1610612765,Detroit Pistons,0,1,1610612753,Orlando Magic,1,0,28,31,59,11,16,27,39,47,86,19,12,31,15,38,24,7,12,97,108
2015,2,21500992,3/14/2016,1610612745,Houston Rockets,1,1,1610612763,Memphis Grizzlies,0,0,30,22,52,16,17,33,46,39,85,22,12,34,14,31,29,7,13,102,130
2015,2,21500992,3/14/2016,1610612763,Memphis Grizzlies,0,0,1610612745,Houston Rockets,1,1,26,58,84,4,13,17,30,71,101,17,11,28,32,47,14,13,20,101,81
2015,2,21500877,2/28/2016,1610612739,Cleveland Cavaliers,0,0,1610612764,Washington Wizards,1,1,23,28,51,9,20,29,32,48,80,26,4,30,10,39,20,6,14,100,99
2015,2,21500877,2/28/2016,1610612764,Washington Wizards,1,1,1610612739,Cleveland Cavaliers,0,0,28,20,48,11,20,31,39,40,79,24,10,34,7,35,28,6,13,99,113
2015,2,21500579,1/13/2016,1610612751,Brooklyn Nets,1,1,1610612752,New York Knicks,0,0,36,33,69,9,8,17,45,41,86,11,3,14,10,32,24,10,15,100,110
2015,2,21500579,1/13/2016,1610612752,New York Knicks,0,0,1610612751,Brooklyn Nets,1,1,34,35,69,7,15,22,41,50,91,15,8,23,17,38,19,8,15,100,104
2015,2,21500473,12/29/2015,1610612739,Cleveland Cavaliers,0,1,1610612743,Denver Nuggets,1,0,34,30,64,4,18,22,38,48,86,13,9,22,12,42,17,8,12,97,93
2015,2,21500473,12/29/2015,1610612743,Denver Nuggets,1,0,1610612739,Cleveland Cavaliers,0,1,32,33,65,5,19,24,37,52,89,8,3,11,16,36,18,12,18,97,87
2015,2,21500368,12/15/2015,1610612743,Denver Nuggets,0,1,1610612750,Minnesota Timberwolves,1,0,31,24,55,10,8,18,41,32,73,20,7,27,14,22,24,6,15,89,112
2015,2,21500368,12/15/2015,1610612750,Minnesota Timberwolves,1,0,1610612743,Denver Nuggets,0,1,32,35,67,4,6,10,36,41,77,24,7,31,14,31,21,9,10,89,100
2015,2,21500270,12/2/2015,1610612756,Phoenix Suns,0,0,1610612765,Detroit Pistons,1,1,33,31,64,14,19,33,47,50,97,14,1,15,13,38,28,10,16,107,122
2015,2,21500270,12/2/2015,1610612765,Detroit Pistons,1,1,1610612756,Phoenix Suns,0,0,32,28,60,12,15,27,44,43,87,27,17,44,21,29,24,7,20,108,127
2015,2,21500174,11/18/2015,1610612741,Chicago Bulls,0,1,1610612756,Phoenix Suns,1,0,32,32,64,9,10,19,41,42,83,12,2,14,13,29,24,12,20,97,103
2015,2,21500174,11/18/2015,1610612756,Phoenix Suns,1,0,1610612741,Chicago Bulls,0,1,29,35,64,8,19,27,37,54,91,15,6,21,16,42,16,7,12,97,97
2015,2,21500078,11/6/2015,1610612739,Cleveland Cavaliers,1,1,1610612755,Philadelphia 76ers,0,0,35,27,62,10,16,26,45,43,88,8,4,12,14,32,29,9,17,95,108
2015,2,21500078,11/6/2015,1610612755,Philadelphia 76ers,0,0,1610612739,Cleveland Cavaliers,1,1,31,25,56,10,13,23,41,38,79,10,5,15,8,34,23,9,16,95,102
2015,2,21501101,3/28/2016,1610612750,Minnesota Timberwolves,1,1,1610612756,Phoenix Suns,0,0,34,21,55,7,19,26,41,40,81,32,8,40,12,32,22,9,18,105,121
2015,2,21501101,3/28/2016,1610612756,Phoenix Suns,0,0,1610612750,Minnesota Timberwolves,1,1,26,25,51,15,18,33,41,43,84,19,4,23,11,33,22,10,21,105,116
2015,2,21500940,3/7/2016,1610612741,Chicago Bulls,1,1,1610612749,Milwaukee Bucks,0,0,29,24,53,10,15,25,39,39,78,12,3,15,9,32,35,7,18,94,100
2015,2,21500940,3/7/2016,1610612749,Milwaukee Bucks,0,0,1610612741,Chicago Bulls,1,1,29,44,73,7,11,18,36,55,91,11,6,17,19,39,24,5,12,93,90
2015,2,21500770,2/7/2016,1610612743,Denver Nuggets,0,1,1610612752,New York Knicks,1,0,32,33,65,5,16,21,37,49,86,22,6,28,14,38,20,2,7,94,101
2015,2,21500770,2/7/2016,1610612752,New York Knicks,1,0,1610612743,Denver Nuggets,0,1,29,33,62,8,14,22,37,47,84,14,6,20,10,40,19,6,10,93,96
2016,2,21600679,1/24/2017,1610612750,Minnesota Timberwolves,0,1,1610612756,Phoenix Suns,1,0,38,29,67,6,11,17,44,40,84,18,6,24,12,32,24,7,15,98,112
2016,2,21600679,1/24/2017,1610612756,Phoenix Suns,1,0,1610612750,Minnesota Timberwolves,0,1,31,36,67,7,12,19,38,48,86,28,4,32,17,32,20,8,15,98,111
2015,2,21500637,1/20/2016,1610612742,Dallas Mavericks,1,1,1610612750,Minnesota Timberwolves,0,0,37,35,72,5,20,25,42,55,97,17,5,22,14,43,18,4,12,104,106
2015,2,21500637,1/20/2016,1610612750,Minnesota Timberwolves,0,0,1610612742,Dallas Mavericks,1,1,35,33,68,5,18,23,40,51,91,9,2,11,11,41,26,11,17,103,94
2015,2,21500578,1/13/2016,1610612749,Milwaukee Bucks,0,0,1610612764,Washington Wizards,1,1,37,27,64,1,7,8,38,34,72,24,10,34,14,24,23,18,27,102,101
2015,2,21500578,1/13/2016,1610612764,Washington Wizards,1,1,1610612749,Milwaukee Bucks,0,0,26,31,57,12,15,27,38,46,84,18,6,24,11,38,27,10,17,101,106
2015,2,21500077,11/6/2015,1610612747,Los Angeles Lakers,0,1,1610612751,Brooklyn Nets,1,0,26,29,55,7,16,23,33,45,78,31,9,40,12,35,14,6,16,100,104
2015,2,21500077,11/6/2015,1610612751,Brooklyn Nets,1,0,1610612747,Los Angeles Lakers,0,1,37,37,74,3,16,19,40,53,93,15,5,20,18,37,21,9,16,100,98
2014,2,21400899,3/4/2015,1610612751,Brooklyn Nets,1,0,1610612766,Charlotte Hornets,0,1,32,40,72,3,13,16,35,53,88,18,6,24,14,40,15,5,9,95,91
2014,2,21400899,3/4/2015,1610612766,Charlotte Hornets,0,1,1610612751,Brooklyn Nets,1,0,34,32,66,8,11,19,42,43,85,23,5,28,17,28,24,6,13,96,115
2015,2,21501165,4/6/2016,1610612739,Cleveland Cavaliers,0,0,1610612754,Indiana Pacers,1,1,27,18,45,8,21,29,35,39,74,31,3,34,8,32,15,9,10,94,109
2015,2,21501165,4/6/2016,1610612754,Indiana Pacers,1,1,1610612739,Cleveland Cavaliers,0,0,29,20,49,16,15,31,45,35,80,17,5,22,10,28,25,7,14,95,123
2015,2,21501042,3/20/2016,1610612752,New York Knicks,1,0,1610612758,Sacramento Kings,0,1,28,44,72,4,15,19,32,59,91,12,3,15,22,39,16,11,15,91,80
2015,2,21501042,3/20/2016,1610612758,Sacramento Kings,0,1,1610612752,New York Knicks,1,0,28,35,63,7,18,25,35,53,88,11,3,14,17,38,20,5,12,89,88
2016,2,21600678,1/24/2017,1610612743,Denver Nuggets,1,1,1610612762,Utah Jazz,0,0,25,25,50,10,16,26,35,41,76,23,8,31,10,34,28,6,14,95,103
2016,2,21600678,1/24/2017,1610612762,Utah Jazz,0,0,1610612743,Denver Nuggets,1,1,28,35,63,7,15,22,35,50,85,16,5,21,10,42,19,7,12,96,93
2015,2,21500577,1/13/2016,1610612737,Atlanta Hawks,0,0,1610612766,Charlotte Hornets,1,1,23,33,56,7,18,25,30,51,81,17,4,21,9,45,17,8,16,98,84
2015,2,21500577,1/13/2016,1610612766,Charlotte Hornets,1,1,1610612737,Atlanta Hawks,0,0,23,20,43,13,26,39,36,46,82,22,4,26,15,33,26,5,18,97,107
2015,2,21500472,12/29/2015,1610612749,Milwaukee Bucks,0,0,1610612760,Oklahoma City Thunder,1,1,39,45,84,10,6,16,49,51,100,15,7,22,23,30,29,12,14,102,123
2015,2,21500472,12/29/2015,1610612760,Oklahoma City Thunder,1,1,1610612749,Milwaukee Bucks,0,0,35,29,64,8,14,22,43,43,86,37,3,40,15,30,21,6,12,103,131
2015,2,21500367,12/15/2015,1610612738,Boston Celtics,1,0,1610612739,Cleveland Cavaliers,0,1,19,36,55,9,23,32,28,59,87,12,2,14,17,44,18,5,10,87,77
2015,2,21500367,12/15/2015,1610612739,Cleveland Cavaliers,0,1,1610612738,Boston Celtics,1,0,28,27,55,8,15,23,36,42,78,9,1,10,11,32,17,6,16,88,89
2015,2,21500269,12/2/2015,1610612747,Los Angeles Lakers,0,1,1610612764,Washington Wizards,1,0,33,38,71,8,17,25,41,55,96,18,2,20,17,38,17,11,17,107,108
2015,2,21500269,12/2/2015,1610612764,Washington Wizards,1,0,1610612747,Los Angeles Lakers,0,1,30,28,58,7,14,21,37,42,79,23,8,31,11,33,24,18,23,108,104
2015,2,21500173,11/18/2015,1610612761,Toronto Raptors,0,0,1610612762,Utah Jazz,1,1,29,31,60,5,15,20,34,46,80,16,2,18,12,35,14,9,14,90,89
2015,2,21500173,11/18/2015,1610612762,Utah Jazz,1,1,1610612761,Toronto Raptors,0,0,28,22,50,7,15,22,35,37,72,16,6,22,11,29,15,10,18,90,93
2015,2,21500076,11/6/2015,1610612738,Boston Celtics,1,1,1610612764,Washington Wizards,0,0,32,35,67,12,18,30,44,53,97,18,5,23,18,39,24,10,17,107,118
2015,2,21500076,11/6/2015,1610612764,Washington Wizards,0,0,1610612738,Boston Celtics,1,1,28,35,63,8,17,25,36,52,88,18,5,23,14,40,23,18,24,109,98
2015,2,21501164,4/5/2016,1610612746,LA Clippers,1,1,1610612747,Los Angeles Lakers,0,0,33,25,58,7,13,20,40,38,78,16,10,26,10,33,26,10,14,95,103
2015,2,21501164,4/5/2016,1610612747,Los Angeles Lakers,0,0,1610612746,LA Clippers,1,1,20,43,63,6,14,20,26,57,83,23,2,25,17,42,11,11,15,96,81
2015,2,21500819,2/20/2016,1610612737,Atlanta Hawks,1,0,1610612749,Milwaukee Bucks,0,1,35,30,65,9,32,41,44,62,106,12,6,18,14,53,31,12,16,117,109
2015,2,21500819,2/20/2016,1610612749,Milwaukee Bucks,0,1,1610612737,Atlanta Hawks,1,0,43,44,87,3,14,17,46,58,104,22,10,32,25,40,23,11,19,117,117
2015,2,21500636,1/20/2016,1610612760,Oklahoma City Thunder,1,1,1610612766,Charlotte Hornets,0,0,30,29,59,9,15,24,39,44,83,22,8,30,18,30,28,8,20,100,109
2015,2,21500636,1/20/2016,1610612766,Charlotte Hornets,0,0,1610612760,Oklahoma City Thunder,1,1,25,29,54,9,18,27,34,47,81,18,3,21,10,38,17,9,16,100,95
2015,2,21500576,1/12/2016,1610612740,New Orleans Pelicans,0,0,1610612747,Los Angeles Lakers,1,1,32,36,68,6,17,23,38,53,91,9,5,14,15,40,20,7,11,95,91
2015,2,21500576,1/12/2016,1610612747,Los Angeles Lakers,1,1,1610612740,New Orleans Pelicans,0,0,26,32,58,6,23,29,32,55,87,25,7,32,16,41,16,2,8,95,95
2015,2,21500471,12/29/2015,1610612748,Miami Heat,0,0,1610612763,Memphis Grizzlies,1,1,24,26,50,11,18,29,35,44,79,9,9,18,16,34,23,4,15,89,90
2015,2,21500471,12/29/2015,1610612763,Memphis Grizzlies,1,1,1610612748,Miami Heat,0,0,34,38,72,4,11,15,38,49,87,19,1,20,18,31,25,5,10,88,99
2015,2,21500268,12/2/2015,1610612744,Golden State Warriors,0,1,1610612766,Charlotte Hornets,1,0,30,24,54,16,18,34,46,42,88,8,3,11,13,31,31,10,21,100,116
2015,2,21500268,12/2/2015,1610612766,Charlotte Hornets,1,0,1610612744,Golden State Warriors,0,1,26,37,63,9,22,31,35,59,94,20,10,30,17,47,19,2,8,100,99
2015,2,21500075,11/6/2015,1610612753,Orlando Magic,1,1,1610612761,Toronto Raptors,0,0,24,28,52,9,16,25,33,44,77,17,5,22,13,33,22,5,13,87,92
2015,2,21500075,11/6/2015,1610612761,Toronto Raptors,0,0,1610612753,Orlando Magic,1,1,25,38,63,5,18,23,30,56,86,22,7,29,22,38,13,4,10,87,87
2015,2,21501100,3/28/2016,1610612759,San Antonio Spurs,0,1,1610612763,Memphis Grizzlies,1,0,32,25,57,5,10,15,37,35,72,22,8,30,12,27,23,8,15,90,101
2015,2,21501100,3/28/2016,1610612763,Memphis Grizzlies,1,0,1610612759,San Antonio Spurs,0,1,27,37,64,6,13,19,33,50,83,15,9,24,19,34,19,9,14,90,87
2016,2,21600677,1/24/2017,1610612741,Chicago Bulls,0,1,1610612753,Orlando Magic,1,0,28,27,55,7,15,22,35,42,77,23,7,30,8,39,12,7,13,97,100
2016,2,21600677,1/24/2017,1610612753,Orlando Magic,1,0,1610612741,Chicago Bulls,0,1,28,35,63,7,15,22,35,50,85,15,5,20,15,38,18,13,19,98,92
2015,2,21500939,3/7/2016,1610612754,Indiana Pacers,1,1,1610612759,San Antonio Spurs,0,0,25,37,62,7,9,16,32,46,78,28,2,30,9,37,19,5,9,93,99
2015,2,21500939,3/7/2016,1610612759,San Antonio Spurs,0,0,1610612754,Indiana Pacers,1,1,30,38,68,4,24,28,34,62,96,19,3,22,20,43,15,5,8,94,91
2015,2,21500769,2/6/2016,1610612744,Golden State Warriors,1,1,1610612760,Oklahoma City Thunder,0,0,41,30,71,7,19,26,48,49,97,13,7,20,14,39,24,10,10,101,116
2015,2,21500769,2/6/2016,1610612760,Oklahoma City Thunder,0,0,1610612744,Golden State Warriors,1,1,29,34,63,7,15,22,36,49,85,29,8,37,18,36,22,7,17,102,108
2016,2,21600676,1/24/2017,1610612738,Boston Celtics,0,0,1610612764,Washington Wizards,1,1,28,23,51,10,23,33,38,46,84,22,2,24,12,36,24,7,14,98,108
2016,2,21600676,1/24/2017,1610612764,Washington Wizards,1,1,1610612738,Boston Celtics,0,0,39,25,64,9,11,20,48,36,84,18,3,21,11,26,21,10,16,97,123
2015,2,21500470,12/29/2015,1610612737,Atlanta Hawks,0,1,1610612745,Houston Rockets,1,0,29,29,58,14,27,41,43,56,99,21,4,25,19,40,27,6,12,101,121
2015,2,21500470,12/29/2015,1610612745,Houston Rockets,1,0,1610612737,Atlanta Hawks,0,1,28,24,52,11,9,20,39,33,72,26,13,39,10,29,23,10,20,101,115
2015,2,21500366,12/14/2015,1610612740,New Orleans Pelicans,0,0,1610612757,Portland Trail Blazers,1,1,28,29,57,8,17,25,36,46,82,21,6,27,8,41,15,7,11,99,101
2015,2,21500366,12/14/2015,1610612757,Portland Trail Blazers,1,1,1610612740,New Orleans Pelicans,0,0,22,27,49,13,19,32,35,46,81,22,7,29,11,38,28,9,15,98,105
2015,2,21500267,12/1/2015,1610612742,Dallas Mavericks,0,1,1610612757,Portland Trail Blazers,1,0,34,31,65,9,20,29,43,51,94,20,4,24,14,39,23,6,12,104,115
2015,2,21500267,12/1/2015,1610612757,Portland Trail Blazers,1,0,1610612742,Dallas Mavericks,0,1,26,34,60,15,25,40,41,59,100,15,2,17,20,41,24,7,16,105,112
2015,2,21500172,11/18/2015,1610612743,Denver Nuggets,0,0,1610612759,San Antonio Spurs,1,1,33,50,83,5,10,15,38,60,98,17,1,18,18,43,25,5,6,95,98
2015,2,21500172,11/18/2015,1610612759,San Antonio Spurs,1,1,1610612743,Denver Nuggets,0,0,33,35,68,9,9,18,42,44,86,16,4,20,11,35,33,7,10,96,109
2015,2,21500074,11/5/2015,1610612757,Portland Trail Blazers,1,1,1610612763,Memphis Grizzlies,0,0,29,28,57,15,15,30,44,43,87,12,8,20,17,31,29,4,9,87,115
2015,2,21500074,11/5/2015,1610612763,Memphis Grizzlies,0,0,1610612757,Portland Trail Blazers,1,1,30,27,57,7,13,20,37,40,77,15,6,21,11,33,20,3,10,86,96
2015,2,21501163,4/5/2016,1610612744,Golden State Warriors,1,0,1610612750,Minnesota Timberwolves,0,1,37,26,63,12,23,35,49,49,98,7,1,8,11,38,35,14,24,115,117
2015,2,21501163,4/5/2016,1610612750,Minnesota Timberwolves,0,1,1610612744,Golden State Warriors,1,0,36,33,69,8,9,17,44,42,86,28,8,36,7,39,30,9,18,114,124
2015,2,21501041,3/20/2016,1610612749,Milwaukee Bucks,1,0,1610612762,Utah Jazz,0,1,31,26,57,3,5,8,34,31,65,14,3,17,4,28,21,8,14,84,85
2015,2,21501041,3/20/2016,1610612762,Utah Jazz,0,1,1610612749,Milwaukee Bucks,1,0,21,24,45,13,25,38,34,49,83,13,1,14,25,25,24,10,18,85,94
2015,2,21500876,2/27/2016,1610612751,Brooklyn Nets,0,1,1610612762,Utah Jazz,1,0,33,36,69,7,8,15,40,44,84,11,6,17,10,36,23,11,19,102,98
2015,2,21500876,2/27/2016,1610612762,Utah Jazz,1,0,1610612751,Brooklyn Nets,0,1,32,37,69,5,15,20,37,52,89,17,8,25,19,39,14,12,21,103,96
2015,2,21500728,2/1/2016,1610612741,Chicago Bulls,0,0,1610612762,Utah Jazz,1,1,34,35,69,5,16,21,39,51,90,13,7,20,15,41,19,5,15,102,96
2015,2,21500728,2/1/2016,1610612762,Utah Jazz,1,1,1610612741,Chicago Bulls,0,0,31,36,67,7,11,18,38,47,85,22,11,33,15,37,19,4,15,103,105
2015,2,21500680,1/26/2016,1610612761,Toronto Raptors,1,1,1610612764,Washington Wizards,0,0,24,26,50,11,18,29,35,44,79,25,7,32,18,32,20,7,18,96,106
2015,2,21500680,1/26/2016,1610612764,Washington Wizards,0,0,1610612761,Toronto Raptors,1,1,28,35,63,4,11,15,32,46,78,21,7,28,9,40,20,7,11,95,89
2015,2,21500575,1/12/2016,1610612739,Cleveland Cavaliers,0,1,1610612742,Dallas Mavericks,1,0,23,30,53,17,27,44,40,57,97,13,3,16,20,38,28,4,10,96,110
2015,2,21500575,1/12/2016,1610612742,Dallas Mavericks,1,0,1610612739,Cleveland Cavaliers,0,1,28,23,51,11,17,28,39,40,79,18,4,22,11,30,25,12,16,96,107
2015,2,21500469,12/29/2015,1610612752,New York Knicks,1,1,1610612765,Detroit Pistons,0,0,35,28,63,8,8,16,43,36,79,14,3,17,10,28,23,6,10,87,108
2015,2,21500469,12/29/2015,1610612765,Detroit Pistons,0,0,1610612752,New York Knicks,1,1,27,35,62,10,17,27,37,52,89,12,5,17,21,33,21,5,10,88,96
2015,2,21500073,11/5/2015,1610612743,Denver Nuggets,1,0,1610612762,Utah Jazz,0,1,23,29,52,5,15,20,28,44,72,23,11,34,14,36,16,6,14,92,84
2015,2,21500073,11/5/2015,1610612762,Utah Jazz,0,1,1610612743,Denver Nuggets,1,0,26,35,61,11,13,24,37,48,85,11,6,17,14,36,23,4,11,90,96
2014,2,21400898,3/4/2015,1610612738,Boston Celtics,1,1,1610612762,Utah Jazz,0,0,25,36,61,8,19,27,33,55,88,11,9,20,16,44,21,1,3,84,85
2014,2,21400898,3/4/2015,1610612762,Utah Jazz,0,0,1610612738,Boston Celtics,1,1,31,25,56,3,16,19,34,41,75,13,8,21,15,30,21,5,14,84,84
2015,2,21500818,2/19/2016,1610612747,Los Angeles Lakers,1,0,1610612759,San Antonio Spurs,0,1,30,29,59,10,12,22,40,41,81,23,3,26,15,27,20,6,16,93,113
2015,2,21500818,2/19/2016,1610612759,San Antonio Spurs,0,1,1610612747,Los Angeles Lakers,1,0,42,34,76,6,6,12,48,40,88,17,1,18,16,24,30,5,11,92,119
2015,2,21500727,2/1/2016,1610612743,Denver Nuggets,1,1,1610612761,Toronto Raptors,0,0,35,26,61,10,12,22,45,38,83,12,3,15,9,30,28,13,19,99,112
2015,2,21500727,2/1/2016,1610612761,Toronto Raptors,0,0,1610612743,Denver Nuggets,1,1,21,32,53,8,17,25,29,49,78,27,12,39,11,43,13,6,12,99,93
2015,2,21500635,1/20/2016,1610612745,Houston Rockets,1,0,1610612765,Detroit Pistons,0,1,31,40,71,12,12,24,43,52,95,16,2,18,13,40,21,8,13,103,114
2015,2,21500635,1/20/2016,1610612765,Detroit Pistons,0,1,1610612745,Houston Rockets,1,0,26,24,50,12,18,30,38,42,80,35,24,59,17,37,23,7,10,104,123
2015,2,21500468,12/28/2015,1610612744,Golden State Warriors,1,1,1610612758,Sacramento Kings,0,0,23,24,47,20,22,42,43,46,89,16,8,24,13,37,33,10,18,107,122
2015,2,21500468,12/28/2015,1610612758,Sacramento Kings,0,0,1610612744,Golden State Warriors,1,1,24,40,64,13,18,31,37,58,95,16,12,28,16,47,23,12,15,108,103
2015,2,21500365,12/14/2015,1610612743,Denver Nuggets,1,1,1610612745,Houston Rockets,0,0,34,23,57,8,17,25,42,40,82,22,3,25,18,22,26,14,18,94,114
2015,2,21500365,12/14/2015,1610612745,Houston Rockets,0,0,1610612743,Denver Nuggets,1,1,23,24,47,18,22,40,41,46,87,8,3,11,8,39,26,8,11,95,108
2015,2,21500266,12/1/2015,1610612740,New Orleans Pelicans,1,0,1610612763,Memphis Grizzlies,0,1,26,28,54,9,18,27,35,46,81,25,8,33,12,39,25,3,8,94,104
2015,2,21500266,12/1/2015,1610612763,Memphis Grizzlies,0,1,1610612740,New Orleans Pelicans,1,0,41,39,80,2,8,10,43,47,90,25,1,26,15,32,21,3,6,94,113
2015,2,21500171,11/18/2015,1610612740,New Orleans Pelicans,0,0,1610612760,Oklahoma City Thunder,1,1,35,28,63,8,24,32,43,52,95,9,0,9,16,36,21,6,11,97,103
2015,2,21500171,11/18/2015,1610612760,Oklahoma City Thunder,1,1,1610612740,New Orleans Pelicans,0,0,31,37,68,7,10,17,38,47,85,27,13,40,19,33,19,8,14,96,110
2015,2,21500072,11/5/2015,1610612742,Dallas Mavericks,1,0,1610612766,Charlotte Hornets,0,1,26,27,53,6,23,29,32,50,82,24,3,27,11,42,17,8,13,98,94
2015,2,21500072,11/5/2015,1610612766,Charlotte Hornets,0,1,1610612742,Dallas Mavericks,1,0,38,24,62,6,21,27,44,45,89,14,3,17,9,37,19,8,11,98,108
2014,2,21400897,3/4/2015,1610612753,Orlando Magic,1,0,1610612756,Phoenix Suns,0,1,36,31,67,5,15,20,41,46,87,13,2,15,16,30,21,10,21,102,100
2014,2,21400897,3/4/2015,1610612756,Phoenix Suns,0,1,1610612753,Orlando Magic,1,0,29,29,58,8,13,21,37,42,79,23,4,27,10,33,22,13,19,101,105
2015,2,21501099,3/28/2016,1610612737,Atlanta Hawks,0,1,1610612741,Chicago Bulls,1,0,31,32,63,5,17,22,36,49,85,25,3,28,9,42,22,4,8,99,102
2015,2,21501099,3/28/2016,1610612741,Chicago Bulls,1,0,1610612737,Atlanta Hawks,0,1,31,53,84,9,13,22,40,66,106,11,4,15,24,44,22,4,8,100,100
2015,2,21500938,3/7/2016,1610612739,Cleveland Cavaliers,1,0,1610612763,Memphis Grizzlies,0,1,29,22,51,7,22,29,36,44,80,24,5,29,18,28,23,16,25,100,103
2015,2,21500938,3/7/2016,1610612763,Memphis Grizzlies,0,1,1610612739,Cleveland Cavaliers,1,0,35,31,66,6,14,20,41,45,86,18,4,22,10,39,23,9,17,101,106
2016,2,21600675,1/24/2017,1610612746,LA Clippers,0,0,1610612755,Philadelphia 76ers,1,1,15,22,37,18,16,34,33,38,71,26,15,41,14,33,17,8,19,97,110
2016,2,21600675,1/24/2017,1610612755,Philadelphia 76ers,1,1,1610612746,LA Clippers,0,0,35,26,61,10,19,29,45,45,90,21,1,22,8,38,35,4,6,98,121
2016,2,21600202,11/21/2016,1610612744,Golden State Warriors,0,1,1610612754,Indiana Pacers,1,0,27,27,54,13,23,36,40,50,90,27,5,32,17,35,31,5,12,101,120
2016,2,21600202,11/21/2016,1610612754,Indiana Pacers,1,0,1610612744,Golden State Warriors,0,1,27,53,80,6,17,23,33,70,103,11,1,12,20,50,13,9,13,101,83
2015,2,21500574,1/12/2016,1610612750,Minnesota Timberwolves,1,0,1610612760,Oklahoma City Thunder,0,1,29,34,63,7,11,18,36,45,81,17,6,23,12,35,22,10,18,98,96
2015,2,21500574,1/12/2016,1610612760,Oklahoma City Thunder,0,1,1610612750,Minnesota Timberwolves,1,0,30,32,62,9,13,22,39,45,84,14,4,18,13,35,21,7,18,98,101
2015,2,21500467,12/28/2015,1610612755,Philadelphia 76ers,0,0,1610612762,Utah Jazz,1,1,31,34,65,5,16,21,36,50,86,14,5,19,15,39,20,11,18,95,91
2015,2,21500467,12/28/2015,1610612762,Utah Jazz,1,1,1610612755,Philadelphia 76ers,0,0,21,37,58,7,19,26,28,56,84,32,4,36,24,32,13,8,19,95,95
2022,2,22200517,12/28/2022,1610612737,Atlanta Hawks,1,0,1610612751,Brooklyn Nets,0,1,34,41,75,8,14,22,42,55,97,15,7,22,16,43,22,0,4,96,107
2022,2,22200517,12/28/2022,1610612751,Brooklyn Nets,0,1,1610612737,Atlanta Hawks,1,0,32,25,57,10,16,26,42,41,83,14,3,17,6,37,22,5,12,95,108
2015,2,21500170,11/18/2015,1610612745,Houston Rockets,1,1,1610612757,Portland Trail Blazers,0,0,18,30,48,14,30,44,32,60,92,30,5,35,19,42,22,11,18,109,108
2015,2,21500170,11/18/2015,1610612757,Portland Trail Blazers,0,0,1610612745,Houston Rockets,1,1,26,32,58,9,21,30,35,53,88,24,5,29,14,39,18,11,19,108,103
2015,2,21501162,4/5/2016,1610612757,Portland Trail Blazers,0,1,1610612758,Sacramento Kings,1,0,28,34,62,12,19,31,40,53,93,23,4,27,20,34,20,6,14,100,115
2015,2,21501162,4/5/2016,1610612758,Sacramento Kings,1,0,1610612757,Portland Trail Blazers,0,1,30,26,56,11,11,22,41,37,78,14,7,21,8,31,20,12,19,100,107
2015,2,21500991,3/14/2016,1610612741,Chicago Bulls,0,1,1610612761,Toronto Raptors,1,0,32,26,58,9,16,25,41,42,83,18,2,20,10,33,23,5,9,90,109
2015,2,21500991,3/14/2016,1610612761,Toronto Raptors,1,0,1610612741,Chicago Bulls,0,1,31,32,63,6,14,20,37,46,83,27,4,31,14,33,12,2,7,89,107
2015,2,21500875,2/27/2016,1610612756,Phoenix Suns,1,1,1610612763,Memphis Grizzlies,0,0,25,23,48,12,20,32,37,43,80,25,10,35,18,29,19,11,18,98,111
2015,2,21500875,2/27/2016,1610612763,Memphis Grizzlies,0,0,1610612756,Phoenix Suns,1,1,26,34,60,6,14,20,32,48,80,36,6,42,11,41,15,4,8,98,106
2023,2,22300786,2/14/2024,1610612758,Sacramento Kings,0,1,1610612743,Denver Nuggets,1,0,30,26,56,9,24,33,39,50,89,15,4,19,13,38,21,6,15,100,102
2015,2,21500466,12/28/2015,1610612739,Cleveland Cavaliers,0,1,1610612756,Phoenix Suns,1,0,16,14,30,17,24,41,33,38,71,18,7,25,12,32,21,8,17,88,101
2015,2,21500466,12/28/2015,1610612756,Phoenix Suns,1,0,1610612739,Cleveland Cavaliers,0,1,25,29,54,11,14,25,36,43,79,14,6,20,18,28,20,8,16,89,97
2015,2,21500364,12/14/2015,1610612759,San Antonio Spurs,1,1,1610612762,Utah Jazz,0,0,33,21,54,9,12,21,42,33,75,25,2,27,10,25,24,8,11,90,118
2015,2,21500364,12/14/2015,1610612762,Utah Jazz,0,0,1610612759,San Antonio Spurs,1,1,29,39,68,3,8,11,32,47,79,14,3,17,10,40,18,6,12,88,81
2015,2,21500265,12/1/2015,1610612750,Minnesota Timberwolves,1,0,1610612753,Orlando Magic,0,1,25,33,58,4,15,19,29,48,77,31,7,38,16,36,14,7,15,94,93
2015,2,21500265,12/1/2015,1610612753,Orlando Magic,0,1,1610612750,Minnesota Timberwolves,1,0,33,36,69,5,12,17,38,48,86,15,5,20,15,36,19,7,13,94,96
2015,2,21500169,11/18/2015,1610612737,Atlanta Hawks,1,1,1610612758,Sacramento Kings,0,0,29,30,59,9,21,30,38,51,89,18,6,24,14,41,23,7,12,100,103
2015,2,21500169,11/18/2015,1610612758,Sacramento Kings,0,0,1610612737,Atlanta Hawks,1,1,33,37,70,5,11,16,38,48,86,16,2,18,16,34,26,9,21,101,97
2015,2,21500071,11/5/2015,1610612748,Miami Heat,0,1,1610612750,Minnesota Timberwolves,1,0,33,29,62,4,10,14,37,39,76,18,7,25,8,37,14,7,16,97,96
2015,2,21500071,11/5/2015,1610612750,Minnesota Timberwolves,1,0,1610612748,Miami Heat,0,1,26,47,73,4,8,12,30,55,85,20,2,22,15,40,16,6,16,96,84
2014,2,21400896,3/4/2015,1610612752,New York Knicks,0,0,1610612754,Indiana Pacers,1,1,24,36,60,6,10,16,30,46,76,16,7,23,17,32,16,8,20,92,82
2014,2,21400896,3/4/2015,1610612754,Indiana Pacers,1,1,1610612752,New York Knicks,0,0,28,30,58,10,12,22,38,42,80,19,5,24,11,34,21,6,11,92,105
2015,2,21500990,3/14/2016,1610612743,Denver Nuggets,0,0,1610612748,Miami Heat,1,1,42,31,73,7,13,20,49,44,93,14,6,20,18,29,22,9,15,99,119
2015,2,21500990,3/14/2016,1610612748,Miami Heat,1,1,1610612743,Denver Nuggets,0,0,39,23,62,8,9,17,47,32,79,22,6,28,8,27,24,9,15,100,124
2015,2,21500817,2/19/2016,1610612738,Boston Celtics,0,0,1610612762,Utah Jazz,1,1,23,33,56,7,18,25,30,51,81,26,10,36,11,47,18,4,7,93,93
2015,2,21500817,2/19/2016,1610612762,Utah Jazz,1,1,1610612738,Boston Celtics,0,0,27,18,45,10,13,23,37,31,68,27,17,44,13,27,22,8,16,94,111
2015,2,21500726,2/1/2016,1610612753,Orlando Magic,0,0,1610612759,San Antonio Spurs,1,1,34,45,79,5,12,17,39,57,96,9,2,11,21,37,19,6,16,97,92
2015,2,21500726,2/1/2016,1610612759,San Antonio Spurs,1,1,1610612753,Orlando Magic,0,0,31,23,54,9,15,24,40,38,78,18,3,21,7,33,27,9,14,96,107
2015,2,21500679,1/26/2016,1610612752,New York Knicks,1,0,1610612760,Oklahoma City Thunder,0,1,33,39,72,11,12,23,44,51,95,23,7,30,12,43,24,7,9,107,122
2015,2,21500679,1/26/2016,1610612760,Oklahoma City Thunder,0,1,1610612752,New York Knicks,1,0,35,44,79,11,9,20,46,53,99,25,4,29,20,33,23,9,14,107,128
2015,2,21500634,1/20/2016,1610612741,Chicago Bulls,1,0,1610612744,Golden State Warriors,0,1,36,44,80,1,19,20,37,63,100,19,5,24,22,43,14,8,10,100,94
2015,2,21500634,1/20/2016,1610612744,Golden State Warriors,0,1,1610612741,Chicago Bulls,1,0,38,25,63,12,20,32,50,45,95,13,7,20,14,34,38,4,10,101,125
2015,2,21500573,1/12/2016,1610612741,Chicago Bulls,0,0,1610612749,Milwaukee Bucks,1,1,23,33,56,12,17,29,35,50,85,19,5,24,23,28,22,11,17,92,101
2015,2,21500573,1/12/2016,1610612749,Milwaukee Bucks,1,1,1610612741,Chicago Bulls,0,0,40,40,80,3,10,13,43,50,93,17,11,28,19,38,28,3,5,91,106
2015,2,21500168,11/18/2015,1610612738,Boston Celtics,1,0,1610612742,Dallas Mavericks,0,1,30,36,66,8,18,26,38,54,92,18,6,24,21,37,22,7,14,99,102
2015,2,21500168,11/18/2015,1610612742,Dallas Mavericks,0,1,1610612738,Boston Celtics,1,0,30,22,52,7,13,20,37,35,72,25,10,35,7,33,22,12,17,99,106
2015,2,21500768,2/6/2016,1610612756,Phoenix Suns,1,0,1610612762,Utah Jazz,0,1,21,35,56,9,15,24,30,50,80,20,6,26,16,36,19,7,10,89,89
2015,2,21500768,2/6/2016,1610612762,Utah Jazz,0,1,1610612756,Phoenix Suns,1,0,29,33,62,5,11,16,34,44,78,25,6,31,15,29,14,3,11,90,98
2015,2,21500465,12/28/2015,1610612750,Minnesota Timberwolves,0,0,1610612759,San Antonio Spurs,1,1,36,35,71,3,8,11,39,43,82,14,10,24,12,36,25,5,15,96,95
2015,2,21500465,12/28/2015,1610612759,San Antonio Spurs,1,1,1610612750,Minnesota Timberwolves,0,0,32,23,55,5,12,17,37,35,72,22,6,28,9,28,25,12,17,97,101
2015,2,21500363,12/14/2015,1610612742,Dallas Mavericks,1,1,1610612756,Phoenix Suns,0,0,26,19,45,12,20,32,38,39,77,16,5,21,6,37,17,9,16,96,104
2015,2,21500363,12/14/2015,1610612756,Phoenix Suns,0,0,1610612742,Dallas Mavericks,1,1,24,31,55,9,16,25,33,47,80,19,8,27,15,36,19,12,17,97,94
2015,2,21500264,12/1/2015,1610612751,Brooklyn Nets,1,1,1610612756,Phoenix Suns,0,0,37,34,71,4,9,13,41,43,84,8,4,12,10,36,23,9,16,94,94
2015,2,21500264,12/1/2015,1610612756,Phoenix Suns,0,0,1610612751,Brooklyn Nets,1,1,23,24,47,10,18,28,33,42,75,15,7,22,6,39,20,10,16,96,91
2015,2,21500167,11/18/2015,1610612754,Indiana Pacers,0,1,1610612755,Philadelphia 76ers,1,0,30,35,65,12,15,27,42,50,92,16,4,20,18,36,28,9,19,102,112
2015,2,21500167,11/18/2015,1610612755,Philadelphia 76ers,1,0,1610612754,Indiana Pacers,0,1,30,21,51,5,20,25,35,41,76,10,6,16,12,33,14,18,31,103,85
2015,2,21500070,11/5/2015,1610612741,Chicago Bulls,1,1,1610612760,Oklahoma City Thunder,0,0,33,39,72,7,11,18,40,50,90,17,4,21,16,36,20,2,6,91,104
2015,2,21500070,11/5/2015,1610612760,Oklahoma City Thunder,0,0,1610612741,Chicago Bulls,1,1,33,38,71,5,8,13,38,46,84,17,3,20,11,37,21,3,9,92,98
2014,2,21400895,3/3/2015,1610612743,Denver Nuggets,1,1,1610612749,Milwaukee Bucks,0,0,27,25,52,12,22,34,39,47,86,16,4,20,14,34,26,6,13,94,106
2014,2,21400895,3/3/2015,1610612749,Milwaukee Bucks,0,0,1610612743,Denver Nuggets,1,1,25,37,62,10,14,24,35,51,86,15,7,22,17,37,21,8,14,93,95
2015,2,21501161,4/5/2016,1610612759,San Antonio Spurs,0,1,1610612762,Utah Jazz,1,0,25,30,55,7,10,17,32,40,72,17,2,19,6,36,16,5,9,84,88
2015,2,21501161,4/5/2016,1610612762,Utah Jazz,1,0,1610612759,San Antonio Spurs,0,1,27,24,51,5,12,17,32,36,68,17,4,21,10,28,13,10,16,85,86
2016,2,21600674,1/24/2017,1610612759,San Antonio Spurs,0,1,1610612761,Toronto Raptors,1,0,31,30,61,7,17,24,38,47,85,25,8,33,16,37,20,9,12,97,108
2016,2,21600674,1/24/2017,1610612761,Toronto Raptors,1,0,1610612759,San Antonio Spurs,0,1,32,27,59,6,19,25,38,46,84,24,4,28,12,34,10,7,13,97,106
2015,2,21500874,2/27/2016,1610612744,Golden State Warriors,0,1,1610612760,Oklahoma City Thunder,1,0,31,32,63,14,18,32,45,50,95,17,8,25,5,49,25,6,11,112,121
2015,2,21500874,2/27/2016,1610612760,Oklahoma City Thunder,1,0,1610612744,Golden State Warriors,0,1,37,33,70,9,17,26,46,50,96,17,9,26,19,32,23,15,23,114,118
2015,2,21500816,2/19/2016,1610612743,Denver Nuggets,0,0,1610612758,Sacramento Kings,1,1,34,32,66,8,16,24,42,48,90,18,8,26,11,42,26,12,18,109,110
2015,2,21500816,2/19/2016,1610612758,Sacramento Kings,1,1,1610612743,Denver Nuggets,0,0,31,31,62,10,11,21,41,42,83,24,7,31,9,36,16,12,22,110,116
2015,2,21500572,1/12/2016,1610612745,Houston Rockets,0,1,1610612763,Memphis Grizzlies,1,0,15,27,42,18,17,35,33,44,77,23,4,27,23,23,21,9,17,84,107
2015,2,21500572,1/12/2016,1610612763,Memphis Grizzlies,1,0,1610612745,Houston Rockets,0,1,26,28,54,7,11,18,33,39,72,18,6,24,16,24,22,10,19,84,91
2015,2,21500362,12/14/2015,1610612763,Memphis Grizzlies,1,1,1610612764,Washington Wizards,0,0,34,29,63,10,5,15,44,34,78,14,1,15,7,27,26,9,17,96,112
2015,2,21500362,12/14/2015,1610612764,Washington Wizards,0,0,1610612763,Memphis Grizzlies,1,1,28,34,62,9,15,24,37,49,86,12,8,20,15,37,22,8,14,96,95
2015,2,21501098,3/28/2016,1610612760,Oklahoma City Thunder,0,1,1610612761,Toronto Raptors,1,0,30,30,60,11,15,26,41,45,86,26,6,32,17,30,29,4,10,94,119
2015,2,21501098,3/28/2016,1610612761,Toronto Raptors,1,0,1610612760,Oklahoma City Thunder,0,1,30,39,69,8,16,24,38,55,93,16,7,23,19,41,19,7,11,95,100
2015,2,21501040,3/20/2016,1610612740,New Orleans Pelicans,1,1,1610612746,LA Clippers,0,0,28,22,50,7,14,21,35,36,71,32,8,40,11,30,22,12,23,102,109
2015,2,21501040,3/20/2016,1610612746,LA Clippers,0,0,1610612740,New Orleans Pelicans,1,1,23,20,43,10,29,39,33,49,82,29,13,42,12,45,21,9,14,103,105
2015,2,21500989,3/14/2016,1610612764,Washington Wizards,1,1,1610612765,Detroit Pistons,0,0,43,29,72,8,10,18,51,39,90,14,4,18,9,32,34,5,10,98,124
2015,2,21500989,3/14/2016,1610612765,Detroit Pistons,0,0,1610612764,Washington Wizards,1,1,29,27,56,3,20,23,32,47,79,14,8,22,13,37,17,11,21,98,81
2015,2,21500937,3/7/2016,1610612750,Minnesota Timberwolves,0,0,1610612766,Charlotte Hornets,1,1,35,30,65,4,11,15,39,41,80,21,3,24,7,37,22,8,16,99,103
2015,2,21500937,3/7/2016,1610612766,Charlotte Hornets,1,1,1610612750,Minnesota Timberwolves,0,0,29,31,60,12,18,30,41,49,90,14,3,17,13,38,20,10,13,100,108
2015,2,21500725,2/1/2016,1610612760,Oklahoma City Thunder,1,1,1610612764,Washington Wizards,0,0,36,25,61,7,15,22,43,40,83,21,6,27,17,28,25,8,20,97,114
2015,2,21500725,2/1/2016,1610612764,Washington Wizards,0,0,1610612760,Oklahoma City Thunder,1,1,33,27,60,7,19,26,40,46,86,11,4,15,7,41,20,9,13,98,98
2015,2,21500633,1/20/2016,1610612738,Boston Celtics,0,0,1610612761,Toronto Raptors,1,1,31,28,59,12,14,26,43,42,85,11,4,15,12,32,30,7,14,94,109
2015,2,21500633,1/20/2016,1610612761,Toronto Raptors,1,1,1610612738,Boston Celtics,0,0,35,19,54,11,18,29,46,37,83,12,5,17,11,28,23,8,13,94,115
2016,2,21600673,1/23/2017,1610612760,Oklahoma City Thunder,0,1,1610612762,Utah Jazz,1,0,30,33,63,6,14,20,36,47,83,19,6,25,14,36,17,10,11,93,97
2016,2,21600673,1/23/2017,1610612762,Utah Jazz,1,0,1610612760,Oklahoma City Thunder,0,1,31,32,63,5,16,21,36,48,84,18,8,26,12,38,16,6,10,94,95
2015,2,21500464,12/28/2015,1610612742,Dallas Mavericks,1,1,1610612749,Milwaukee Bucks,0,0,28,34,62,10,12,22,38,46,84,17,9,26,6,44,25,4,4,94,103
2015,2,21500464,12/28/2015,1610612749,Milwaukee Bucks,0,0,1610612742,Dallas Mavericks,1,1,34,31,65,4,10,14,38,41,79,13,2,15,12,29,14,9,18,95,93
2016,2,21600201,11/21/2016,1610612763,Memphis Grizzlies,0,1,1610612766,Charlotte Hornets,1,0,28,30,58,12,14,26,40,44,84,13,4,17,13,33,24,6,10,88,105
2016,2,21600201,11/21/2016,1610612766,Charlotte Hornets,1,0,1610612763,Memphis Grizzlies,0,1,21,21,42,9,22,31,30,43,73,21,12,33,12,35,20,7,11,89,90
2015,2,21500361,12/14/2015,1610612741,Chicago Bulls,1,1,1610612755,Philadelphia 76ers,0,0,35,28,63,8,14,22,43,42,85,21,5,26,14,30,28,6,14,99,115
2015,2,21500361,12/14/2015,1610612755,Philadelphia 76ers,0,0,1610612741,Chicago Bulls,1,1,27,34,61,11,20,31,38,54,92,9,4,13,12,43,19,7,11,98,96
2015,2,21500263,12/1/2015,1610612747,Los Angeles Lakers,0,0,1610612755,Philadelphia 76ers,1,1,25,30,55,8,26,34,33,56,89,17,7,24,18,39,15,6,12,95,91
2015,2,21500263,12/1/2015,1610612755,Philadelphia 76ers,1,1,1610612747,Los Angeles Lakers,0,0,23,24,47,14,18,32,37,42,79,15,8,23,14,35,28,4,16,95,103
2015,2,21500166,11/18/2015,1610612750,Minnesota Timberwolves,0,0,1610612753,Orlando Magic,1,1,32,35,67,4,14,18,36,49,85,25,5,30,15,36,21,10,16,103,101
2015,2,21500166,11/18/2015,1610612753,Orlando Magic,1,1,1610612750,Minnesota Timberwolves,0,0,32,57,89,9,12,21,41,69,110,13,8,21,24,49,20,4,9,103,104
2015,2,21500069,11/4/2015,1610612744,Golden State Warriors,1,1,1610612746,LA Clippers,0,0,29,30,59,10,16,26,39,46,85,24,7,31,13,36,28,6,12,100,112
2015,2,21500069,11/4/2015,1610612746,LA Clippers,0,0,1610612744,Golden State Warriors,1,1,35,31,66,8,14,22,43,45,88,14,8,22,12,35,24,6,13,99,108
2015,2,21501160,4/5/2016,1610612743,Denver Nuggets,1,0,1610612760,Oklahoma City Thunder,0,1,27,31,58,10,20,30,37,51,88,18,9,27,13,44,28,10,13,100,102
2015,2,21501160,4/5/2016,1610612760,Oklahoma City Thunder,0,1,1610612743,Denver Nuggets,1,0,31,23,54,15,18,33,46,41,87,17,7,24,16,29,32,9,18,101,124
2015,2,21500936,3/6/2016,1610612745,Houston Rockets,0,1,1610612761,Toronto Raptors,1,0,25,24,49,13,16,29,38,40,78,24,13,37,11,37,27,8,11,94,113
2015,2,21500936,3/6/2016,1610612761,Toronto Raptors,1,0,1610612745,Houston Rockets,0,1,25,19,44,12,21,33,37,40,77,21,6,27,12,30,27,9,16,95,107
2015,2,21500815,2/19/2016,1610612744,Golden State Warriors,0,0,1610612757,Portland Trail Blazers,1,1,24,34,58,12,22,34,36,56,92,21,7,28,17,42,25,12,20,109,105
2015,2,21500815,2/19/2016,1610612757,Portland Trail Blazers,1,1,1610612744,Golden State Warriors,0,0,35,32,67,17,13,30,52,45,97,16,7,23,11,38,28,7,13,109,137
2015,2,21500767,2/6/2016,1610612747,Los Angeles Lakers,0,0,1610612759,San Antonio Spurs,1,1,24,32,56,10,20,30,34,52,86,24,3,27,16,37,19,4,9,92,102
2015,2,21500767,2/6/2016,1610612759,San Antonio Spurs,1,1,1610612747,Los Angeles Lakers,0,0,31,33,64,8,16,24,39,49,88,20,5,25,17,35,27,5,10,93,106
2015,2,21500678,1/26/2016,1610612748,Miami Heat,0,1,1610612751,Brooklyn Nets,1,0,42,32,74,3,6,9,45,38,83,9,1,10,7,31,27,5,12,93,102
2015,2,21500678,1/26/2016,1610612751,Brooklyn Nets,1,0,1610612748,Miami Heat,0,1,27,26,53,9,9,18,36,35,71,17,6,23,5,32,24,10,17,93,98
2015,2,21500571,1/12/2016,1610612738,Boston Celtics,0,0,1610612752,New York Knicks,1,1,33,24,57,9,20,29,42,44,86,21,5,26,8,38,25,5,9,100,114
2015,2,21500571,1/12/2016,1610612752,New York Knicks,1,1,1610612738,Boston Celtics,0,0,36,25,61,7,13,20,43,38,81,27,3,30,6,35,24,5,11,100,120
2016,2,21600672,1/23/2017,1610612752,New York Knicks,0,1,1610612754,Indiana Pacers,1,0,27,27,54,8,14,22,35,41,76,31,4,35,10,33,19,7,15,98,109
2016,2,21600672,1/23/2017,1610612754,Indiana Pacers,1,0,1610612752,New York Knicks,0,1,31,29,60,7,19,26,38,48,86,20,5,25,12,37,18,8,11,99,103
2015,2,21500360,12/14/2015,1610612737,Atlanta Hawks,1,0,1610612748,Miami Heat,0,1,25,26,51,8,25,33,33,51,84,14,1,15,11,41,25,6,14,96,88
2015,2,21500360,12/14/2015,1610612748,Miami Heat,0,1,1610612737,Atlanta Hawks,1,0,33,40,73,7,9,16,40,49,89,13,2,15,18,32,26,7,18,95,100
2015,2,21500814,2/19/2016,1610612745,Houston Rockets,0,1,1610612756,Phoenix Suns,1,0,30,24,54,7,17,24,37,41,78,35,21,56,17,35,20,7,20,107,116
2015,2,21500814,2/19/2016,1610612756,Phoenix Suns,1,0,1610612745,Houston Rockets,0,1,19,28,47,11,24,35,30,52,82,29,6,35,15,40,23,16,21,107,100
2015,2,21500632,1/20/2016,1610612752,New York Knicks,1,1,1610612762,Utah Jazz,0,0,40,33,73,7,10,17,47,43,90,17,1,18,16,28,20,4,11,96,118
2015,2,21500632,1/20/2016,1610612762,Utah Jazz,0,0,1610612752,New York Knicks,1,1,25,34,59,12,15,27,37,49,86,25,6,31,19,31,19,3,13,95,111
2015,2,21500570,1/12/2016,1610612759,San Antonio Spurs,0,1,1610612765,Detroit Pistons,1,0,36,35,71,5,9,14,41,44,85,22,5,27,14,31,20,8,17,104,109
2015,2,21500570,1/12/2016,1610612765,Detroit Pistons,1,0,1610612759,San Antonio Spurs,0,1,32,36,68,6,17,23,38,53,91,17,9,26,13,44,22,9,12,102,99
2015,2,21500463,12/28/2015,1610612741,Chicago Bulls,1,1,1610612761,Toronto Raptors,0,0,32,34,66,8,13,21,40,47,87,16,8,24,14,37,23,5,11,94,104
2015,2,21500463,12/28/2015,1610612761,Toronto Raptors,0,0,1610612741,Chicago Bulls,1,1,32,36,68,6,14,20,38,50,88,15,9,24,13,42,23,4,7,95,97
2015,2,21500262,12/1/2015,1610612739,Cleveland Cavaliers,1,0,1610612764,Washington Wizards,0,1,19,34,53,9,21,30,28,55,83,20,3,23,18,39,15,7,19,99,85
2015,2,21500262,12/1/2015,1610612764,Washington Wizards,0,1,1610612739,Cleveland Cavaliers,1,0,32,23,55,7,21,28,39,44,83,12,4,16,6,40,23,8,13,98,97
2015,2,21500165,11/18/2015,1610612751,Brooklyn Nets,0,0,1610612766,Charlotte Hornets,1,1,39,37,76,5,10,15,44,47,91,18,4,22,11,40,25,5,9,102,111
2015,2,21500165,11/18/2015,1610612766,Charlotte Hornets,1,1,1610612751,Brooklyn Nets,0,0,28,27,55,11,14,25,39,41,80,27,9,36,12,32,27,5,16,102,116
2015,2,21500068,11/4/2015,1610612757,Portland Trail Blazers,0,1,1610612762,Utah Jazz,1,0,30,22,52,11,14,25,41,36,77,15,17,32,18,26,11,12,19,92,108
2015,2,21500068,11/4/2015,1610612762,Utah Jazz,1,0,1610612757,Portland Trail Blazers,0,1,28,36,64,5,19,24,33,55,88,21,12,33,21,40,9,5,9,93,92
2014,2,21400894,3/3/2015,1610612762,Utah Jazz,0,1,1610612763,Memphis Grizzlies,1,0,31,24,55,5,20,25,36,44,80,16,3,19,17,29,22,7,16,89,93
2014,2,21400894,3/3/2015,1610612763,Memphis Grizzlies,1,0,1610612762,Utah Jazz,0,1,30,41,71,3,8,11,33,49,82,13,6,19,11,41,15,7,11,89,82
2015,2,21501159,4/5/2016,1610612739,Cleveland Cavaliers,0,1,1610612749,Milwaukee Bucks,1,0,23,16,39,18,18,36,41,34,75,9,1,10,4,30,30,7,16,91,109
2015,2,21501159,4/5/2016,1610612749,Milwaukee Bucks,1,0,1610612739,Cleveland Cavaliers,0,1,31,41,72,4,12,16,35,53,88,6,6,12,13,43,20,4,10,92,80
2015,2,21501097,3/28/2016,1610612748,Miami Heat,1,1,1610612751,Brooklyn Nets,0,0,43,25,68,5,11,16,48,36,84,9,3,12,8,28,25,8,13,95,110
2015,2,21501097,3/28/2016,1610612751,Brooklyn Nets,0,0,1610612748,Miami Heat,1,1,38,28,66,3,8,11,41,36,77,14,4,18,12,26,20,11,20,94,99
2015,2,21501039,3/20/2016,1610612738,Boston Celtics,0,1,1610612755,Philadelphia 76ers,1,0,36,33,69,10,15,25,46,48,94,18,3,21,19,28,28,5,13,100,120
2015,2,21501039,3/20/2016,1610612755,Philadelphia 76ers,1,0,1610612738,Boston Celtics,0,1,31,40,71,8,13,21,39,53,92,19,8,27,16,42,28,8,11,100,105
2015,2,21500935,3/6/2016,1610612748,Miami Heat,1,1,1610612755,Philadelphia 76ers,0,0,28,39,67,8,6,14,36,45,81,23,7,30,20,28,16,5,13,91,103
2015,2,21500935,3/6/2016,1610612755,Philadelphia 76ers,0,0,1610612748,Miami Heat,1,1,26,28,54,11,20,31,37,48,85,13,9,22,14,39,20,7,11,91,98
2015,2,21500873,2/27/2016,1610612749,Milwaukee Bucks,1,0,1610612765,Detroit Pistons,0,1,31,35,66,7,5,12,38,40,78,8,4,12,13,30,21,13,21,93,91
2015,2,21500873,2/27/2016,1610612765,Detroit Pistons,0,1,1610612749,Milwaukee Bucks,1,0,25,33,58,12,18,30,37,51,88,16,8,24,19,36,24,3,11,93,102
2015,2,21500569,1/12/2016,1610612754,Indiana Pacers,1,1,1610612756,Phoenix Suns,0,0,31,24,55,10,14,24,41,38,79,24,7,31,10,31,25,6,13,98,116
2015,2,21500569,1/12/2016,1610612756,Phoenix Suns,0,0,1610612754,Indiana Pacers,1,1,28,36,64,8,17,25,36,53,89,17,10,27,23,36,24,13,19,97,97
2015,2,21500359,12/14/2015,1610612746,LA Clippers,0,1,1610612765,Detroit Pistons,1,0,38,40,78,6,13,19,44,53,97,11,4,15,12,42,29,8,10,102,105
2015,2,21500359,12/14/2015,1610612765,Detroit Pistons,1,0,1610612746,LA Clippers,0,1,31,39,70,6,13,19,37,52,89,23,8,31,24,32,17,9,19,102,103
2015,2,21500261,11/30/2015,1610612746,LA Clippers,1,1,1610612757,Portland Trail Blazers,0,0,25,41,66,8,11,19,33,52,85,28,28,56,20,44,26,6,12,105,102
2015,2,21500261,11/30/2015,1610612757,Portland Trail Blazers,0,0,1610612746,LA Clippers,1,1,28,36,64,5,18,23,33,54,87,16,11,27,18,39,18,7,21,105,87
2015,2,21500988,3/14/2016,1610612742,Dallas Mavericks,0,1,1610612766,Charlotte Hornets,1,0,33,24,57,9,21,30,42,45,87,14,4,18,12,35,30,9,15,98,107
2015,2,21500988,3/14/2016,1610612766,Charlotte Hornets,1,0,1610612742,Dallas Mavericks,0,1,22,24,46,10,20,30,32,44,76,22,12,34,8,41,18,9,15,98,96
2016,2,21600671,1/23/2017,1610612739,Cleveland Cavaliers,0,0,1610612740,New Orleans Pelicans,1,1,28,28,56,15,22,37,43,50,93,21,4,25,14,38,24,8,11,102,122
2016,2,21600671,1/23/2017,1610612740,New Orleans Pelicans,1,1,1610612739,Cleveland Cavaliers,0,0,27,21,48,16,23,39,43,44,87,22,8,30,10,36,26,6,9,101,124
2015,2,21500568,1/11/2016,1610612744,Golden State Warriors,1,1,1610612748,Miami Heat,0,0,34,29,63,7,16,23,41,45,86,22,8,30,11,39,25,2,9,99,111
2015,2,21500568,1/11/2016,1610612748,Miami Heat,0,0,1610612744,Golden State Warriors,1,1,34,38,72,7,12,19,41,50,91,14,2,16,11,41,31,5,11,99,103
2015,2,21500462,12/28/2015,1610612748,Miami Heat,1,0,1610612751,Brooklyn Nets,0,1,26,28,54,10,14,24,36,42,78,23,7,30,11,36,20,8,14,95,105
2015,2,21500462,12/28/2015,1610612751,Brooklyn Nets,0,1,1610612748,Miami Heat,1,0,24,35,59,12,11,23,36,46,82,27,9,36,18,32,20,9,13,95,111
2015,2,21500260,11/30/2015,1610612742,Dallas Mavericks,0,0,1610612758,Sacramento Kings,1,1,27,20,47,9,28,37,36,48,84,17,5,22,11,38,22,1,16,101,98
2015,2,21500260,11/30/2015,1610612758,Sacramento Kings,1,1,1610612742,Dallas Mavericks,0,0,27,21,48,9,22,31,36,43,79,31,13,44,13,35,22,8,13,102,112
2015,2,21500164,11/17/2015,1610612744,Golden State Warriors,1,1,1610612761,Toronto Raptors,0,0,32,19,51,11,18,29,43,37,80,18,9,27,10,32,31,11,20,102,115
2015,2,21500164,11/17/2015,1610612761,Toronto Raptors,0,0,1610612744,Golden State Warriors,1,1,31,30,61,6,12,18,37,42,79,30,9,39,16,31,18,10,20,103,110
2015,2,21500067,11/4/2015,1610612756,Phoenix Suns,1,1,1610612758,Sacramento Kings,0,0,31,29,60,14,9,23,45,38,83,14,8,22,14,27,27,9,20,101,118
2015,2,21500067,11/4/2015,1610612758,Sacramento Kings,0,0,1610612756,Phoenix Suns,1,1,29,31,60,11,13,24,40,44,84,6,6,12,9,37,25,14,19,100,97
2014,2,21400893,3/3/2015,1610612741,Chicago Bulls,1,1,1610612764,Washington Wizards,0,0,24,25,49,9,20,29,33,45,78,22,8,30,16,31,20,10,16,92,97
2014,2,21400893,3/3/2015,1610612764,Washington Wizards,0,0,1610612741,Chicago Bulls,1,1,27,35,62,8,14,22,35,49,84,14,5,19,11,41,23,5,11,92,92
2015,2,21500813,2/19/2016,1610612749,Milwaukee Bucks,1,0,1610612766,Charlotte Hornets,0,1,29,33,62,7,12,19,36,45,81,16,5,21,15,33,22,13,22,100,95
2015,2,21500813,2/19/2016,1610612766,Charlotte Hornets,0,1,1610612749,Milwaukee Bucks,1,0,28,27,55,9,22,31,37,49,86,15,3,18,14,35,13,7,18,99,98
2015,2,21500631,1/20/2016,1610612739,Cleveland Cavaliers,0,1,1610612751,Brooklyn Nets,1,0,31,29,60,5,12,17,36,41,77,14,6,20,10,32,15,4,13,93,91
2015,2,21500631,1/20/2016,1610612751,Brooklyn Nets,1,0,1610612739,Cleveland Cavaliers,0,1,31,34,65,4,15,19,35,49,84,4,4,8,10,42,20,6,14,91,78
2015,2,21500567,1/11/2016,1610612741,Chicago Bulls,1,0,1610612764,Washington Wizards,0,1,25,34,59,9,13,22,34,47,81,23,4,27,13,37,18,10,17,99,100
2015,2,21500567,1/11/2016,1610612764,Washington Wizards,0,1,1610612741,Chicago Bulls,1,0,39,36,75,9,15,24,48,51,99,9,1,10,16,35,31,5,11,99,114
2015,2,21500358,12/14/2015,1610612751,Brooklyn Nets,1,0,1610612753,Orlando Magic,0,1,24,37,61,7,12,19,31,49,80,13,3,16,11,40,23,12,18,95,82
2015,2,21500358,12/14/2015,1610612753,Orlando Magic,0,1,1610612751,Brooklyn Nets,1,0,32,23,55,9,12,21,41,35,76,14,6,20,8,32,24,5,16,95,105
2015,2,21500259,11/30/2015,1610612744,Golden State Warriors,0,1,1610612762,Utah Jazz,1,0,26,27,53,14,15,29,40,42,82,12,3,15,16,27,21,9,15,88,106
2015,2,21500259,11/30/2015,1610612762,Utah Jazz,1,0,1610612744,Golden State Warriors,0,1,34,36,70,6,13,19,40,49,89,17,5,22,21,31,18,2,9,90,103
2015,2,21501038,3/20/2016,1610612753,Orlando Magic,0,0,1610612761,Toronto Raptors,1,1,32,29,61,8,14,22,40,43,83,12,6,18,11,35,20,8,14,94,100
2015,2,21501038,3/20/2016,1610612761,Toronto Raptors,1,1,1610612753,Orlando Magic,0,0,29,32,61,6,14,20,35,46,81,29,16,45,19,35,18,4,12,95,105
2016,2,21600670,1/23/2017,1610612745,Houston Rockets,0,0,1610612749,Milwaukee Bucks,1,1,25,17,42,14,21,35,39,38,77,22,6,28,8,33,26,17,22,103,114
2016,2,21600670,1/23/2017,1610612749,Milwaukee Bucks,1,1,1610612745,Houston Rockets,0,0,36,21,57,11,12,23,47,33,80,22,5,27,11,24,31,11,19,105,127
2015,2,21500766,2/6/2016,1610612741,Chicago Bulls,0,0,1610612750,Minnesota Timberwolves,1,1,32,33,65,8,12,20,40,45,85,17,2,19,14,31,27,7,12,92,105
2015,2,21500766,2/6/2016,1610612750,Minnesota Timberwolves,1,1,1610612741,Chicago Bulls,0,0,44,31,75,1,11,12,45,42,87,21,1,22,17,26,24,5,9,92,112
2015,2,21500677,1/26/2016,1610612755,Philadelphia 76ers,1,1,1610612756,Phoenix Suns,0,0,28,25,53,11,17,28,39,42,81,24,12,36,11,36,25,6,12,99,113
2015,2,21500677,1/26/2016,1610612756,Phoenix Suns,0,0,1610612755,Philadelphia 76ers,1,1,33,31,64,6,13,19,39,44,83,19,9,28,15,34,27,9,17,100,103
2015,2,21500566,1/11/2016,1610612751,Brooklyn Nets,1,0,1610612759,San Antonio Spurs,0,1,31,30,61,2,10,12,33,40,73,11,2,13,9,32,15,8,19,90,79
2015,2,21500566,1/11/2016,1610612759,San Antonio Spurs,0,1,1610612751,Brooklyn Nets,1,0,40,29,69,4,9,13,44,38,82,14,5,19,14,26,27,5,13,90,106
2015,2,21500461,12/28/2015,1610612746,LA Clippers,0,1,1610612764,Washington Wizards,1,0,34,21,55,7,16,23,41,37,78,19,6,25,7,33,23,10,16,98,108
2015,2,21500461,12/28/2015,1610612764,Washington Wizards,1,0,1610612746,LA Clippers,0,1,27,36,63,7,17,24,34,53,87,16,8,24,16,39,19,11,17,99,91
2015,2,21500258,11/30/2015,1610612743,Denver Nuggets,0,0,1610612749,Milwaukee Bucks,1,1,22,34,56,6,13,19,28,47,75,12,4,16,17,31,19,10,24,91,74
2015,2,21500258,11/30/2015,1610612749,Milwaukee Bucks,1,1,1610612743,Denver Nuggets,0,0,29,30,59,6,12,18,35,42,77,16,6,22,11,34,25,6,13,90,92
2015,2,21500163,11/17/2015,1610612740,New Orleans Pelicans,1,0,1610612743,Denver Nuggets,0,1,34,26,60,7,16,23,41,42,83,9,2,11,9,33,25,5,10,89,98
2015,2,21500163,11/17/2015,1610612743,Denver Nuggets,0,1,1610612740,New Orleans Pelicans,1,0,30,25,55,15,15,30,45,40,85,10,3,13,15,27,27,4,14,90,115
2015,2,21500066,11/4/2015,1610612760,Oklahoma City Thunder,1,0,1610612761,Toronto Raptors,0,1,31,28,59,8,15,23,39,43,82,12,2,14,11,34,26,14,19,96,98
2015,2,21500066,11/4/2015,1610612761,Toronto Raptors,0,1,1610612760,Oklahoma City Thunder,1,0,28,37,65,5,9,14,33,46,79,32,7,39,17,33,12,8,15,96,103
2014,2,21400892,3/3/2015,1610612737,Atlanta Hawks,1,1,1610612745,Houston Rockets,0,0,31,26,57,8,21,29,39,47,86,18,3,21,14,35,23,6,15,98,104
2014,2,21400892,3/3/2015,1610612745,Houston Rockets,0,0,1610612737,Atlanta Hawks,1,1,25,24,49,14,27,41,39,51,90,4,5,9,10,43,30,3,13,97,96
2015,2,21501158,4/5/2016,1610612741,Chicago Bulls,0,0,1610612763,Memphis Grizzlies,1,1,23,25,48,11,18,29,34,43,77,13,6,19,14,32,22,13,20,93,92
2015,2,21501158,4/5/2016,1610612763,Memphis Grizzlies,1,1,1610612741,Chicago Bulls,0,0,32,36,68,7,12,19,39,48,87,23,3,26,18,32,18,6,11,94,108
2016,2,21600200,11/21/2016,1610612756,Phoenix Suns,0,0,1610612764,Washington Wizards,1,1,28,36,64,11,16,27,39,52,91,12,3,15,18,34,22,8,21,100,101
2016,2,21600200,11/21/2016,1610612764,Washington Wizards,1,1,1610612756,Phoenix Suns,0,0,27,36,63,10,18,28,37,54,91,22,12,34,20,41,25,3,12,100,106
2015,2,21500987,3/13/2016,1610612747,Los Angeles Lakers,1,0,1610612752,New York Knicks,0,1,31,38,69,3,13,16,34,51,85,16,5,21,12,43,14,5,9,91,87
2015,2,21500987,3/13/2016,1610612752,New York Knicks,0,1,1610612747,Los Angeles Lakers,1,0,28,26,54,5,16,21,33,42,75,19,8,27,7,38,19,6,10,92,90
2015,2,21500630,1/20/2016,1610612748,Miami Heat,0,0,1610612764,Washington Wizards,1,1,26,27,53,7,8,15,33,35,68,14,4,18,11,25,23,11,21,87,87
2015,2,21500630,1/20/2016,1610612764,Washington Wizards,1,1,1610612748,Miami Heat,0,0,40,30,70,5,11,16,45,41,86,11,2,13,16,25,27,3,10,87,106
2015,2,21500565,1/10/2016,1610612747,Los Angeles Lakers,1,0,1610612762,Utah Jazz,0,1,26,42,68,3,18,21,29,60,89,13,2,15,19,41,15,8,11,87,74
2015,2,21500565,1/10/2016,1610612762,Utah Jazz,0,1,1610612747,Los Angeles Lakers,1,0,26,27,53,5,11,16,31,38,69,19,6,25,12,30,16,9,16,87,86
2015,2,21500357,12/14/2015,1610612754,Indiana Pacers,1,1,1610612761,Toronto Raptors,0,0,31,33,64,10,12,22,41,45,86,14,2,16,13,32,14,9,14,95,106
2015,2,21500357,12/14/2015,1610612761,Toronto Raptors,0,0,1610612754,Indiana Pacers,1,1,19,32,51,10,18,28,29,50,79,22,4,26,17,35,10,8,21,94,90
2015,2,21500257,11/30/2015,1610612741,Chicago Bulls,1,1,1610612759,San Antonio Spurs,0,0,31,39,70,6,10,16,37,49,86,12,8,20,16,37,25,5,11,91,92
2015,2,21500257,11/30/2015,1610612759,San Antonio Spurs,0,0,1610612741,Chicago Bulls,1,1,35,41,76,2,12,14,37,53,90,13,5,18,14,41,20,4,9,92,89
2015,2,21500065,11/4/2015,1610612749,Milwaukee Bucks,1,1,1610612755,Philadelphia 76ers,0,0,27,36,63,8,15,23,35,51,86,13,4,17,12,42,24,4,10,90,91
2015,2,21500065,11/4/2015,1610612755,Philadelphia 76ers,0,0,1610612749,Milwaukee Bucks,1,1,28,25,53,6,22,28,34,47,81,13,2,15,16,32,23,6,19,91,87
2015,2,21501096,3/27/2016,1610612747,Los Angeles Lakers,1,0,1610612764,Washington Wizards,0,1,26,33,59,7,21,28,33,54,87,15,2,17,15,39,15,12,18,97,88
2015,2,21501096,3/27/2016,1610612764,Washington Wizards,0,1,1610612747,Los Angeles Lakers,1,0,32,22,54,7,11,18,39,33,72,16,13,29,7,32,23,12,18,97,101
2015,2,21500872,2/27/2016,1610612745,Houston Rockets,1,0,1610612759,San Antonio Spurs,0,1,27,32,59,8,17,25,35,49,84,16,6,22,15,39,19,4,14,95,94
2015,2,21500872,2/27/2016,1610612759,San Antonio Spurs,0,1,1610612745,Houston Rockets,1,0,29,28,57,8,11,19,37,39,76,22,6,28,10,31,24,5,14,96,104
2015,2,21500812,2/19/2016,1610612754,Indiana Pacers,0,1,1610612760,Oklahoma City Thunder,1,0,30,36,66,9,13,22,39,49,88,14,8,22,12,41,27,6,13,98,101
2015,2,21500812,2/19/2016,1610612760,Oklahoma City Thunder,1,0,1610612754,Indiana Pacers,0,1,37,33,70,5,21,26,42,54,96,9,1,10,16,39,28,8,13,100,98
2015,2,21500724,2/1/2016,1610612740,New Orleans Pelicans,1,0,1610612763,Memphis Grizzlies,0,1,26,36,62,10,16,26,36,52,88,13,8,21,17,39,19,4,10,90,95
2015,2,21500724,2/1/2016,1610612763,Memphis Grizzlies,0,1,1610612740,New Orleans Pelicans,1,0,34,21,55,9,7,16,43,28,71,15,3,18,5,25,27,8,14,91,110
2015,2,21500564,1/10/2016,1610612757,Portland Trail Blazers,1,1,1610612760,Oklahoma City Thunder,0,0,23,33,56,19,25,44,42,58,100,12,2,14,23,36,27,8,17,100,115
2015,2,21500564,1/10/2016,1610612760,Oklahoma City Thunder,0,0,1610612757,Portland Trail Blazers,1,1,27,28,55,10,11,21,37,39,76,26,10,36,11,34,23,7,19,98,110
2015,2,21500460,12/28/2015,1610612740,New Orleans Pelicans,0,0,1610612753,Orlando Magic,1,1,32,31,63,5,15,20,37,46,83,10,5,15,12,36,23,7,13,91,89
2015,2,21500460,12/28/2015,1610612753,Orlando Magic,1,1,1610612740,New Orleans Pelicans,0,0,38,27,65,7,10,17,45,37,82,7,4,11,7,33,28,5,11,90,104
2015,2,21500256,11/30/2015,1610612737,Atlanta Hawks,1,1,1610612760,Oklahoma City Thunder,0,0,29,33,62,10,18,28,39,51,90,18,2,20,15,37,23,8,14,98,106
2015,2,21500256,11/30/2015,1610612760,Oklahoma City Thunder,0,0,1610612737,Atlanta Hawks,1,1,30,44,74,7,12,19,37,56,93,19,3,22,18,40,19,9,13,97,100
2015,2,21500064,11/4/2015,1610612745,Houston Rockets,1,1,1610612753,Orlando Magic,0,0,31,23,54,11,23,34,42,46,88,24,10,34,21,29,28,12,20,102,119
2015,2,21500064,11/4/2015,1610612753,Orlando Magic,0,0,1610612745,Houston Rockets,1,1,39,32,71,7,13,20,46,45,91,15,4,19,13,34,28,8,16,103,114
2014,2,21400891,3/3/2015,1610612738,Boston Celtics,0,0,1610612739,Cleveland Cavaliers,1,1,24,36,60,7,21,28,31,57,88,10,3,13,16,44,23,10,15,94,79
2014,2,21400891,3/3/2015,1610612739,Cleveland Cavaliers,1,1,1610612738,Boston Celtics,0,0,33,28,61,10,18,28,43,46,89,14,0,14,13,33,28,4,11,95,110
2021,2,22100277,11/24/2021,1610612737,Atlanta Hawks,0,1,1610612759,San Antonio Spurs,1,0,33,29,62,12,14,26,45,43,88,22,2,24,11,32,26,8,11,99,124
2015,2,21501037,3/20/2016,1610612742,Dallas Mavericks,1,1,1610612757,Portland Trail Blazers,0,0,34,30,64,15,10,25,49,40,89,19,4,23,11,31,31,9,16,105,132
2015,2,21501037,3/20/2016,1610612757,Portland Trail Blazers,0,0,1610612742,Dallas Mavericks,1,1,24,34,58,18,28,46,42,62,104,18,10,28,26,42,25,7,15,107,120
2015,2,21500871,2/27/2016,1610612741,Chicago Bulls,1,0,1610612757,Portland Trail Blazers,0,1,32,40,72,7,15,22,39,55,94,10,2,12,10,45,33,6,9,97,95
2015,2,21500871,2/27/2016,1610612757,Portland Trail Blazers,0,1,1610612741,Chicago Bulls,1,0,33,33,66,5,16,21,38,49,87,22,5,27,11,43,20,4,10,98,103
2016,2,21600669,1/23/2017,1610612758,Sacramento Kings,0,1,1610612765,Detroit Pistons,1,0,31,30,61,9,12,21,40,42,82,20,6,26,13,33,25,8,14,96,109
2016,2,21600669,1/23/2017,1610612765,Detroit Pistons,1,0,1610612758,Sacramento Kings,0,1,31,23,54,10,18,28,41,41,82,12,5,17,9,35,27,10,16,97,104
2016,2,21600199,11/21/2016,1610612748,Miami Heat,0,0,1610612755,Philadelphia 76ers,1,1,27,30,57,7,24,31,34,54,88,19,9,28,24,33,17,8,15,90,94
2015,2,21500765,2/6/2016,1610612742,Dallas Mavericks,0,1,1610612763,Memphis Grizzlies,1,0,23,27,50,15,23,38,38,50,88,23,10,33,12,44,26,3,6,100,114
2015,2,21500765,2/6/2016,1610612763,Memphis Grizzlies,1,0,1610612742,Dallas Mavericks,0,1,35,30,65,9,14,23,44,44,88,13,9,22,11,33,27,6,11,99,110
2016,2,21600668,1/23/2017,1610612744,Golden State Warriors,0,0,1610612748,Miami Heat,1,1,33,25,58,8,22,30,41,47,88,12,8,20,15,36,27,9,14,99,102
2015,2,21500459,12/28/2015,1610612737,Atlanta Hawks,0,0,1610612754,Indiana Pacers,1,1,25,24,49,6,19,25,31,43,74,19,6,25,14,32,16,16,22,94,87
2015,2,21500459,12/28/2015,1610612754,Indiana Pacers,1,1,1610612737,Atlanta Hawks,0,0,31,30,61,7,19,26,38,49,87,10,8,18,16,37,9,9,15,94,93
2015,2,21500356,12/13/2015,1610612760,Oklahoma City Thunder,1,1,1610612762,Utah Jazz,0,0,28,30,58,7,14,21,35,44,79,27,3,30,10,35,18,6,10,95,104
2015,2,21500356,12/13/2015,1610612762,Utah Jazz,0,0,1610612760,Oklahoma City Thunder,1,1,31,41,72,8,14,22,39,55,94,12,8,20,22,37,14,7,13,92,98
2015,2,21501157,4/5/2016,1610612737,Atlanta Hawks,1,1,1610612756,Phoenix Suns,0,0,28,33,61,11,23,34,39,56,95,14,5,19,16,42,26,13,17,106,103
2015,2,21501157,4/5/2016,1610612756,Phoenix Suns,0,0,1610612737,Atlanta Hawks,1,1,18,32,50,12,19,31,30,51,81,18,12,30,14,43,19,16,24,105,90
2015,2,21500986,3/13/2016,1610612758,Sacramento Kings,1,0,1610612762,Utah Jazz,0,1,29,31,60,9,12,21,38,43,81,14,7,21,9,37,25,8,12,94,99
2015,2,21500986,3/13/2016,1610612762,Utah Jazz,0,1,1610612758,Sacramento Kings,1,0,27,27,54,12,16,28,39,43,82,18,4,22,16,29,26,8,16,94,108
2016,2,21600668,1/23/2017,1610612748,Miami Heat,1,1,1610612744,Golden State Warriors,0,0,25,31,56,13,17,30,38,48,86,16,11,27,14,38,20,9,15,98,105
2016,2,21600199,11/21/2016,1610612755,Philadelphia 76ers,1,1,1610612748,Miami Heat,0,0,26,26,52,11,15,26,37,41,78,16,4,20,14,30,21,7,15,90,101
2015,2,21500563,1/10/2016,1610612743,Denver Nuggets,1,1,1610612766,Charlotte Hornets,0,0,20,30,50,12,15,27,32,45,77,19,4,23,9,36,25,6,15,94,95
2015,2,21500563,1/10/2016,1610612766,Charlotte Hornets,0,0,1610612743,Denver Nuggets,1,1,18,29,47,12,24,36,30,53,83,20,4,24,16,38,24,7,13,95,92
2015,2,21500458,12/28/2015,1610612747,Los Angeles Lakers,0,0,1610612766,Charlotte Hornets,1,1,26,30,56,9,20,29,35,50,85,19,4,23,10,41,24,7,12,99,98
2015,2,21500458,12/28/2015,1610612766,Charlotte Hornets,1,1,1610612747,Los Angeles Lakers,0,0,37,27,64,6,19,25,43,46,89,16,6,22,11,39,28,7,11,99,108
2015,2,21500355,12/13/2015,1610612755,Philadelphia 76ers,0,0,1610612761,Toronto Raptors,1,1,18,38,56,10,18,28,28,56,84,10,4,14,18,39,18,11,22,95,76
2015,2,21500355,12/13/2015,1610612761,Toronto Raptors,1,1,1610612755,Philadelphia 76ers,0,0,25,31,56,7,15,22,32,46,78,25,9,34,11,40,14,1,10,96,96
2015,2,21500255,11/30/2015,1610612738,Boston Celtics,0,1,1610612748,Miami Heat,1,0,30,30,60,8,12,20,38,42,80,21,4,25,15,29,23,9,16,95,105
2015,2,21500255,11/30/2015,1610612748,Miami Heat,1,0,1610612738,Boston Celtics,0,1,31,27,58,5,12,17,36,39,75,18,6,24,12,30,21,15,19,93,95
2015,2,21500161,11/17/2015,1610612748,Miami Heat,1,0,1610612750,Minnesota Timberwolves,0,1,31,24,55,5,19,24,36,43,79,14,16,30,12,41,20,12,22,102,91
2015,2,21500161,11/17/2015,1610612750,Minnesota Timberwolves,0,1,1610612748,Miami Heat,1,0,32,44,76,4,17,21,36,61,97,27,8,35,21,44,14,3,8,103,103
2015,2,21500063,11/4/2015,1610612739,Cleveland Cavaliers,1,1,1610612752,New York Knicks,0,0,26,30,56,7,20,27,33,50,83,23,9,32,16,37,21,6,13,95,96
2015,2,21500063,11/4/2015,1610612752,New York Knicks,0,0,1610612739,Cleveland Cavaliers,1,1,25,35,60,8,16,24,33,51,84,12,3,15,11,42,16,5,13,94,86
2021,2,22100277,11/24/2021,1610612759,San Antonio Spurs,1,0,1610612737,Atlanta Hawks,0,1,31,36,67,12,21,33,43,57,100,8,2,10,20,37,27,10,12,98,106
2015,2,21500934,3/6/2016,1610612757,Portland Trail Blazers,0,0,1610612765,Detroit Pistons,1,1,24,23,47,11,20,31,35,43,78,22,1,23,6,37,18,7,13,97,103
2015,2,21500934,3/6/2016,1610612765,Detroit Pistons,1,1,1610612757,Portland Trail Blazers,0,0,32,30,62,12,10,22,44,40,84,23,5,28,12,30,22,8,12,98,123
2015,2,21500723,2/1/2016,1610612737,Atlanta Hawks,1,1,1610612742,Dallas Mavericks,0,0,28,17,45,14,21,35,42,38,80,14,5,19,7,32,29,5,15,97,112
2015,2,21500723,2/1/2016,1610612742,Dallas Mavericks,0,0,1610612737,Atlanta Hawks,1,1,24,35,59,7,19,26,31,54,85,28,10,38,13,45,14,2,6,97,97
2015,2,21500676,1/26/2016,1610612746,LA Clippers,0,1,1610612754,Indiana Pacers,1,0,17,24,41,15,22,37,32,46,78,12,12,24,12,39,16,7,15,95,91
2015,2,21500676,1/26/2016,1610612754,Indiana Pacers,1,0,1610612746,LA Clippers,0,1,30,37,67,5,11,16,35,48,83,14,10,24,15,37,18,9,17,94,89
2015,2,21500457,12/27/2015,1610612757,Portland Trail Blazers,0,1,1610612758,Sacramento Kings,1,0,28,31,59,10,23,33,38,54,92,12,4,16,15,39,19,10,18,102,98
2015,2,21500457,12/27/2015,1610612758,Sacramento Kings,1,0,1610612757,Portland Trail Blazers,0,1,21,31,52,9,15,24,30,46,76,25,6,31,12,39,22,13,23,102,94
2015,2,21500354,12/13/2015,1610612748,Miami Heat,1,1,1610612763,Memphis Grizzlies,0,0,30,25,55,7,15,22,37,40,77,19,4,23,13,30,18,10,11,87,100
2015,2,21500354,12/13/2015,1610612763,Memphis Grizzlies,0,0,1610612748,Miami Heat,1,1,33,25,58,7,12,19,40,37,77,10,4,14,11,28,23,9,14,87,97
2015,2,21500160,11/17/2015,1610612739,Cleveland Cavaliers,0,0,1610612765,Detroit Pistons,1,1,27,20,47,11,22,33,38,42,80,12,8,20,5,40,21,11,14,99,99
2015,2,21500160,11/17/2015,1610612765,Detroit Pistons,1,1,1610612739,Cleveland Cavaliers,0,0,29,34,63,7,14,21,36,48,84,25,6,31,13,39,20,8,13,100,104
2014,2,21400890,3/3/2015,1610612747,Los Angeles Lakers,0,0,1610612766,Charlotte Hornets,1,1,33,36,69,6,11,17,39,47,86,19,2,21,9,40,24,10,11,99,103
2015,2,21501095,3/27/2016,1610612742,Dallas Mavericks,0,0,1610612758,Sacramento Kings,1,1,34,30,64,8,16,24,42,46,88,19,5,24,13,36,22,11,13,100,111
2015,2,21501095,3/27/2016,1610612758,Sacramento Kings,1,1,1610612742,Dallas Mavericks,0,0,42,20,62,9,11,20,51,31,82,22,8,30,7,29,32,6,11,101,133
2015,2,21500811,2/19/2016,1610612740,New Orleans Pelicans,1,1,1610612755,Philadelphia 76ers,0,0,34,30,64,7,10,17,41,40,81,32,8,40,14,31,22,11,16,103,121
2015,2,21500811,2/19/2016,1610612755,Philadelphia 76ers,0,0,1610612740,New Orleans Pelicans,1,1,28,21,49,12,15,27,40,36,76,22,4,26,5,32,20,12,20,103,114
2015,2,21500629,1/20/2016,1610612753,Orlando Magic,1,0,1610612755,Philadelphia 76ers,0,1,29,38,67,4,13,17,33,51,84,17,9,26,13,42,19,8,14,95,87
2015,2,21500629,1/20/2016,1610612755,Philadelphia 76ers,0,1,1610612753,Orlando Magic,1,0,27,28,55,9,10,19,36,38,74,15,6,21,5,35,20,12,15,96,96
2015,2,21500562,1/10/2016,1610612749,Milwaukee Bucks,0,0,1610612752,New York Knicks,1,1,29,38,67,3,10,13,32,48,80,21,9,30,17,35,19,5,12,89,88
2015,2,21500562,1/10/2016,1610612752,New York Knicks,1,1,1610612749,Milwaukee Bucks,0,0,32,28,60,7,17,24,39,45,84,15,3,18,16,30,25,7,12,88,100
2015,2,21500456,12/27/2015,1610612743,Denver Nuggets,0,0,1610612760,Oklahoma City Thunder,1,1,37,32,69,9,16,25,46,48,94,11,4,15,20,32,24,5,10,90,112
2015,2,21500456,12/27/2015,1610612760,Oklahoma City Thunder,1,1,1610612743,Denver Nuggets,0,0,40,28,68,8,7,15,48,35,83,18,3,21,16,20,27,6,14,91,122
2015,2,21500254,11/30/2015,1610612745,Houston Rockets,0,0,1610612765,Detroit Pistons,1,1,24,37,61,11,16,27,35,53,88,24,4,28,21,35,19,8,16,96,105
2015,2,21500254,11/30/2015,1610612765,Detroit Pistons,1,1,1610612745,Houston Rockets,0,0,37,25,62,8,15,23,45,40,85,18,19,37,19,31,22,11,12,97,116
2015,2,21500159,11/17/2015,1610612737,Atlanta Hawks,0,0,1610612751,Brooklyn Nets,1,1,21,26,47,12,17,29,33,43,76,10,4,14,10,36,22,14,20,92,88
2015,2,21500159,11/17/2015,1610612751,Brooklyn Nets,1,1,1610612737,Atlanta Hawks,0,0,28,36,64,9,11,20,37,47,84,7,6,13,11,36,22,7,12,91,90
2015,2,21500062,11/4/2015,1610612737,Atlanta Hawks,1,1,1610612751,Brooklyn Nets,0,0,29,25,54,8,14,22,37,39,76,19,5,24,11,30,27,9,15,93,101
2015,2,21500062,11/4/2015,1610612751,Brooklyn Nets,0,0,1610612737,Atlanta Hawks,1,1,31,31,62,5,16,21,36,47,83,10,3,13,17,30,24,15,19,93,87
2014,2,21400890,3/3/2015,1610612766,Charlotte Hornets,1,1,1610612747,Los Angeles Lakers,0,0,34,32,66,5,8,13,39,40,79,21,10,31,6,38,30,6,12,99,104
2015,2,21501156,4/5/2016,1610612761,Toronto Raptors,1,1,1610612766,Charlotte Hornets,0,0,28,27,55,6,17,23,34,44,78,22,9,31,13,36,19,5,11,90,96
2015,2,21501156,4/5/2016,1610612766,Charlotte Hornets,0,0,1610612761,Toronto Raptors,1,1,21,32,53,11,24,35,32,56,88,15,6,21,15,44,20,6,7,90,90
2015,2,21500870,2/27/2016,1610612740,New Orleans Pelicans,1,0,1610612750,Minnesota Timberwolves,0,1,29,28,57,10,17,27,39,45,84,22,4,26,11,37,22,9,15,100,110
2015,2,21500870,2/27/2016,1610612750,Minnesota Timberwolves,0,1,1610612740,New Orleans Pelicans,1,0,37,32,69,5,10,15,42,42,84,23,7,30,9,37,28,9,12,100,112
2015,2,21500455,12/27/2015,1610612747,Los Angeles Lakers,0,0,1610612763,Memphis Grizzlies,1,1,24,31,55,8,21,29,32,52,84,24,8,32,21,35,16,11,15,93,96
2015,2,21500455,12/27/2015,1610612763,Memphis Grizzlies,1,1,1610612747,Los Angeles Lakers,0,0,39,25,64,6,10,16,45,35,80,16,6,22,8,30,30,6,11,95,112
2015,2,21500353,12/13/2015,1610612750,Minnesota Timberwolves,0,0,1610612756,Phoenix Suns,1,1,25,29,54,8,11,19,33,40,73,27,7,34,15,29,22,16,25,97,101
2015,2,21500353,12/13/2015,1610612756,Phoenix Suns,1,1,1610612750,Minnesota Timberwolves,0,0,29,28,57,10,20,30,39,48,87,20,4,24,15,35,28,7,14,98,108
2015,2,21500158,11/17/2015,1610612749,Milwaukee Bucks,0,0,1610612764,Washington Wizards,1,1,21,30,51,10,11,21,31,41,72,14,10,24,9,37,22,8,19,94,86
2015,2,21500158,11/17/2015,1610612764,Washington Wizards,1,1,1610612749,Milwaukee Bucks,0,0,25,23,48,12,10,22,37,33,70,29,12,41,8,29,25,5,12,95,115
2014,2,21400889,3/2/2015,1610612740,New Orleans Pelicans,0,0,1610612742,Dallas Mavericks,1,1,25,28,53,10,11,21,35,39,74,13,3,16,11,30,19,7,13,84,93
2014,2,21400889,3/2/2015,1610612742,Dallas Mavericks,1,1,1610612740,New Orleans Pelicans,0,0,32,31,63,6,10,16,38,41,79,20,2,22,13,29,11,4,7,84,102
2015,2,21501036,3/19/2016,1610612744,Golden State Warriors,0,0,1610612759,San Antonio Spurs,1,1,22,24,46,9,27,36,31,51,82,8,2,10,12,40,24,4,11,86,79
2015,2,21501036,3/19/2016,1610612759,San Antonio Spurs,1,1,1610612744,Golden State Warriors,0,0,24,33,57,8,13,21,32,46,78,15,3,18,18,30,17,12,18,86,87
2015,2,21500985,3/13/2016,1610612749,Milwaukee Bucks,0,1,1610612751,Brooklyn Nets,1,0,39,36,75,6,8,14,45,44,89,13,8,21,20,29,27,3,13,92,109
2015,2,21500985,3/13/2016,1610612751,Brooklyn Nets,1,0,1610612749,Milwaukee Bucks,0,1,27,16,43,12,15,27,39,31,70,10,3,13,6,26,25,13,21,92,100
2015,2,21500933,3/6/2016,1610612742,Dallas Mavericks,0,0,1610612743,Denver Nuggets,1,1,25,27,52,16,25,41,41,52,93,16,4,20,12,43,29,8,12,105,114
2015,2,21500933,3/6/2016,1610612743,Denver Nuggets,1,1,1610612742,Dallas Mavericks,0,0,35,46,81,9,17,26,44,63,107,19,6,25,24,41,25,5,11,105,116
2015,2,21500722,2/1/2016,1610612751,Brooklyn Nets,1,0,1610612765,Detroit Pistons,0,1,33,33,66,7,9,16,40,42,82,13,2,15,12,31,28,5,11,91,100
2015,2,21500722,2/1/2016,1610612765,Detroit Pistons,0,1,1610612751,Brooklyn Nets,1,0,32,36,68,10,20,30,42,56,98,11,5,16,24,35,18,5,9,90,105
2015,2,21500561,1/10/2016,1610612745,Houston Rockets,1,1,1610612754,Indiana Pacers,0,0,25,26,51,14,24,38,39,50,89,15,8,23,17,38,24,12,23,106,107
2015,2,21500561,1/10/2016,1610612754,Indiana Pacers,0,0,1610612745,Houston Rockets,1,1,34,25,59,9,22,31,43,47,90,8,2,10,7,40,33,11,18,106,103
2015,2,21500253,11/29/2015,1610612747,Los Angeles Lakers,1,0,1610612754,Indiana Pacers,0,1,27,39,66,11,22,33,38,61,99,16,6,22,19,44,17,4,12,104,103
2015,2,21500253,11/29/2015,1610612754,Indiana Pacers,0,1,1610612747,Los Angeles Lakers,1,0,25,31,56,9,18,27,34,49,83,30,7,37,12,40,17,6,16,105,107
2015,2,21500061,11/4/2015,1610612759,San Antonio Spurs,0,0,1610612764,Washington Wizards,1,1,30,29,59,7,15,22,37,44,81,18,2,20,12,32,21,11,21,98,99
2015,2,21500061,11/4/2015,1610612764,Washington Wizards,1,1,1610612759,San Antonio Spurs,0,0,34,30,64,8,15,23,42,45,87,10,4,14,6,42,27,5,10,98,102
2015,2,21501155,4/5/2016,1610612748,Miami Heat,1,1,1610612765,Detroit Pistons,0,0,35,35,70,9,5,14,44,40,84,10,4,14,10,31,22,7,10,93,107
2015,2,21501155,4/5/2016,1610612765,Detroit Pistons,0,0,1610612748,Miami Heat,1,1,27,31,58,5,17,22,32,48,80,20,5,25,13,37,14,6,13,92,89
2016,2,21600667,1/23/2017,1610612737,Atlanta Hawks,1,0,1610612746,LA Clippers,0,1,28,31,59,9,20,29,37,51,88,22,4,26,13,39,28,4,8,95,105
2016,2,21600667,1/23/2017,1610612746,LA Clippers,0,1,1610612737,Atlanta Hawks,1,0,28,32,60,14,10,24,42,42,84,17,5,22,12,32,23,8,11,94,115
2016,2,21600198,11/20/2016,1610612741,Chicago Bulls,0,1,1610612747,Los Angeles Lakers,1,0,37,28,65,8,14,22,45,42,87,20,8,28,18,28,27,11,18,100,118
2015,2,21500675,1/25/2016,1610612744,Golden State Warriors,1,1,1610612759,San Antonio Spurs,0,0,33,26,59,11,15,26,44,41,85,21,4,25,13,29,31,11,21,105,120
2015,2,21500675,1/25/2016,1610612759,San Antonio Spurs,0,0,1610612744,Golden State Warriors,1,1,26,34,60,5,9,14,31,43,74,23,8,31,11,36,21,15,26,105,90
2015,2,21500454,12/27/2015,1610612738,Boston Celtics,1,1,1610612752,New York Knicks,0,0,28,37,65,8,12,20,36,49,85,20,9,29,12,40,18,6,10,97,100
2015,2,21500454,12/27/2015,1610612752,New York Knicks,0,0,1610612738,Boston Celtics,1,1,29,41,70,4,15,19,33,56,89,21,3,24,17,42,15,5,13,96,91
2015,2,21500352,12/12/2015,1610612752,New York Knicks,0,1,1610612757,Portland Trail Blazers,1,0,30,24,54,9,12,21,39,36,75,25,3,28,9,29,17,4,11,90,112
2015,2,21500352,12/12/2015,1610612757,Portland Trail Blazers,1,0,1610612752,New York Knicks,0,1,35,33,68,6,15,21,41,48,89,22,7,29,20,30,15,3,8,91,110
2015,2,21500157,11/16/2015,1610612747,Los Angeles Lakers,0,0,1610612756,Phoenix Suns,1,1,28,29,57,9,11,20,37,40,77,18,2,20,8,34,12,13,17,95,101
2015,2,21500157,11/16/2015,1610612756,Phoenix Suns,1,1,1610612747,Los Angeles Lakers,0,0,34,29,63,11,19,30,45,48,93,19,6,25,19,33,23,5,11,97,120
2015,2,21500984,3/13/2016,1610612737,Atlanta Hawks,1,1,1610612754,Indiana Pacers,0,0,25,30,55,15,15,30,40,45,85,9,1,10,13,32,27,9,17,94,104
2015,2,21500984,3/13/2016,1610612754,Indiana Pacers,0,0,1610612737,Atlanta Hawks,1,1,28,35,63,5,19,24,33,54,87,4,3,7,12,44,24,11,17,95,75
2015,2,21500932,3/6/2016,1610612756,Phoenix Suns,0,1,1610612763,Memphis Grizzlies,1,0,25,18,43,12,16,28,37,34,71,23,7,30,11,27,24,6,16,93,109
2015,2,21500932,3/6/2016,1610612763,Memphis Grizzlies,1,0,1610612756,Phoenix Suns,0,1,22,36,58,10,12,22,32,48,80,26,7,33,13,38,17,3,10,93,100
2015,2,21500869,2/27/2016,1610612738,Boston Celtics,1,1,1610612748,Miami Heat,0,0,34,46,80,5,11,16,39,57,96,18,4,22,16,43,26,7,11,100,101
2015,2,21500869,2/27/2016,1610612748,Miami Heat,0,0,1610612738,Boston Celtics,1,1,35,39,74,1,12,13,36,51,87,16,7,23,17,37,19,12,20,102,89
2016,2,21600198,11/20/2016,1610612747,Los Angeles Lakers,1,0,1610612741,Chicago Bulls,0,1,28,34,62,13,18,31,41,52,93,15,6,21,11,42,26,6,10,101,110
2015,2,21500628,1/19/2016,1610612754,Indiana Pacers,0,1,1610612756,Phoenix Suns,1,0,30,33,63,4,16,20,34,49,83,25,9,34,12,42,14,4,14,101,97
2015,2,21500628,1/19/2016,1610612756,Phoenix Suns,1,0,1610612754,Indiana Pacers,0,1,17,29,46,11,24,35,28,53,81,27,2,29,16,38,15,16,22,102,94
2015,2,21500560,1/10/2016,1610612738,Boston Celtics,0,0,1610612763,Memphis Grizzlies,1,1,30,36,66,7,15,22,37,51,88,17,6,23,16,38,22,8,16,101,98
2015,2,21500560,1/10/2016,1610612763,Memphis Grizzlies,1,1,1610612738,Boston Celtics,0,0,27,41,68,4,12,16,31,53,84,35,5,40,25,29,12,17,21,101,101
2015,2,21500252,11/29/2015,1610612745,Houston Rockets,0,1,1610612752,New York Knicks,1,0,36,34,70,7,18,25,43,52,95,23,13,36,20,39,16,5,8,101,116
2015,2,21500252,11/29/2015,1610612752,New York Knicks,1,0,1610612745,Houston Rockets,0,1,39,21,60,6,12,18,45,33,78,15,2,17,11,24,22,16,23,100,111
2015,2,21500060,11/4/2015,1610612738,Boston Celtics,0,0,1610612754,Indiana Pacers,1,1,25,31,56,10,17,27,35,48,83,18,4,22,17,32,20,10,19,95,98
2015,2,21500060,11/4/2015,1610612754,Indiana Pacers,1,1,1610612738,Boston Celtics,0,0,27,41,68,8,15,23,35,56,91,22,7,29,26,34,18,7,14,95,100
2014,2,21400888,3/2/2015,1610612746,LA Clippers,0,1,1610612750,Minnesota Timberwolves,1,0,32,27,59,12,21,33,44,48,92,10,9,19,14,40,24,6,12,100,110
2014,2,21400888,3/2/2015,1610612750,Minnesota Timberwolves,1,0,1610612746,LA Clippers,0,1,32,35,67,4,11,15,36,46,82,29,6,35,11,37,25,7,12,101,105
2015,2,21500764,2/6/2016,1610612751,Brooklyn Nets,0,0,1610612755,Philadelphia 76ers,1,1,30,31,61,5,10,15,35,41,76,23,3,26,14,29,19,12,19,97,98
2015,2,21500764,2/6/2016,1610612755,Philadelphia 76ers,1,1,1610612751,Brooklyn Nets,0,0,28,24,52,10,19,29,38,43,81,17,5,22,13,32,17,5,16,95,103
2015,2,21500559,1/10/2016,1610612739,Cleveland Cavaliers,0,1,1610612755,Philadelphia 76ers,1,0,26,32,58,9,23,32,35,55,90,16,7,23,16,43,20,6,11,95,95
2022,2,22200511,12/27/2022,1610612759,San Antonio Spurs,0,0,1610612760,Oklahoma City Thunder,1,1,36,34,70,10,19,29,46,53,99,12,2,14,23,32,20,10,15,98,114
2022,2,22200511,12/27/2022,1610612760,Oklahoma City Thunder,1,1,1610612759,San Antonio Spurs,0,0,33,29,62,13,11,24,46,40,86,25,6,31,15,28,25,9,14,98,130
2015,2,21500559,1/10/2016,1610612755,Philadelphia 76ers,1,0,1610612739,Cleveland Cavaliers,0,1,29,30,59,6,12,18,35,42,77,9,10,19,10,39,22,9,19,96,85
2015,2,21500453,12/26/2015,1610612739,Cleveland Cavaliers,0,0,1610612757,Portland Trail Blazers,1,1,17,29,46,11,20,31,28,49,77,9,6,15,10,42,21,9,17,91,76
2015,2,21500453,12/26/2015,1610612757,Portland Trail Blazers,1,1,1610612739,Cleveland Cavaliers,0,0,32,35,67,9,13,22,41,48,89,14,5,19,15,35,28,4,9,92,105
2015,2,21500351,12/12/2015,1610612744,Golden State Warriors,0,0,1610612749,Milwaukee Bucks,1,1,30,32,62,6,21,27,36,53,89,17,8,25,16,40,23,12,17,101,95
2015,2,21500351,12/12/2015,1610612749,Milwaukee Bucks,1,1,1610612744,Golden State Warriors,0,0,38,38,76,6,8,14,44,46,90,14,4,18,15,34,31,9,19,101,108
2015,2,21500156,11/16/2015,1610612757,Portland Trail Blazers,0,0,1610612759,San Antonio Spurs,1,1,24,32,56,7,12,19,31,44,75,11,2,13,5,41,15,9,12,88,80
2015,2,21500156,11/16/2015,1610612759,San Antonio Spurs,1,1,1610612757,Portland Trail Blazers,0,0,31,35,66,7,16,23,38,51,89,10,3,13,13,39,29,4,6,88,93
2015,2,21501094,3/27/2016,1610612744,Golden State Warriors,1,1,1610612755,Philadelphia 76ers,0,0,30,20,50,14,19,33,44,39,83,15,5,20,13,29,32,10,18,97,117
2015,2,21501094,3/27/2016,1610612755,Philadelphia 76ers,0,0,1610612744,Golden State Warriors,1,1,32,28,60,10,20,30,42,48,90,11,1,12,10,39,27,9,12,97,105
2015,2,21500931,3/6/2016,1610612744,Golden State Warriors,0,0,1610612747,Los Angeles Lakers,1,1,33,29,62,4,26,30,37,55,92,17,4,21,21,36,32,12,20,99,95
2015,2,21500931,3/6/2016,1610612747,Los Angeles Lakers,1,1,1610612744,Golden State Warriors,0,0,32,30,62,9,16,25,41,46,87,21,1,22,13,34,23,5,13,100,112
2015,2,21500810,2/19/2016,1610612750,Minnesota Timberwolves,0,0,1610612763,Memphis Grizzlies,1,1,20,29,49,11,15,26,31,44,75,31,0,31,13,31,25,13,22,97,104
2015,2,21500810,2/19/2016,1610612763,Memphis Grizzlies,1,1,1610612750,Minnesota Timberwolves,0,0,33,28,61,7,14,21,40,42,82,22,6,28,13,32,17,7,14,98,109
2015,2,21500558,1/10/2016,1610612740,New Orleans Pelicans,0,0,1610612746,LA Clippers,1,1,32,38,70,8,22,30,40,60,100,23,6,29,22,40,20,8,14,106,111
2015,2,21500558,1/10/2016,1610612746,LA Clippers,1,1,1610612740,New Orleans Pelicans,0,0,30,23,53,12,24,36,42,47,89,18,16,34,12,42,26,8,14,107,114
2015,2,21500251,11/29/2015,1610612755,Philadelphia 76ers,0,0,1610612763,Memphis Grizzlies,1,1,18,23,41,12,24,36,30,47,77,12,4,16,12,37,23,11,27,99,84
2015,2,21500251,11/29/2015,1610612763,Memphis Grizzlies,1,1,1610612755,Philadelphia 76ers,0,0,30,38,68,4,9,13,34,47,81,20,7,27,19,33,19,18,26,100,92
2015,2,21500059,11/3/2015,1610612743,Denver Nuggets,0,1,1610612747,Los Angeles Lakers,1,0,36,29,65,7,13,20,43,42,85,27,4,31,14,30,30,9,15,100,120
2015,2,21500059,11/3/2015,1610612747,Los Angeles Lakers,1,0,1610612743,Denver Nuggets,0,1,30,30,60,6,20,26,36,50,86,31,7,38,14,38,18,5,11,99,109
2014,2,21400887,3/2/2015,1610612748,Miami Heat,1,1,1610612756,Phoenix Suns,0,0,36,32,68,7,7,14,43,39,82,22,8,30,12,30,19,7,16,97,115
2014,2,21400887,3/2/2015,1610612756,Phoenix Suns,0,0,1610612748,Miami Heat,1,1,26,21,47,7,24,31,33,45,78,25,13,38,17,35,17,14,19,98,98
2015,2,21501154,4/5/2016,1610612740,New Orleans Pelicans,0,0,1610612755,Philadelphia 76ers,1,1,30,34,64,7,11,18,37,45,82,12,4,16,16,31,20,10,17,93,93
2015,2,21501154,4/5/2016,1610612755,Philadelphia 76ers,1,1,1610612740,New Orleans Pelicans,0,0,27,27,54,13,21,34,40,48,88,14,3,17,13,37,31,5,10,93,107
2015,2,21500868,2/26/2016,1610612747,Los Angeles Lakers,1,0,1610612763,Memphis Grizzlies,0,1,27,28,55,5,18,23,32,46,78,26,13,39,13,38,14,6,9,92,95
2015,2,21500868,2/26/2016,1610612763,Memphis Grizzlies,0,1,1610612747,Los Angeles Lakers,1,0,30,23,53,13,19,32,43,42,85,13,2,15,13,29,24,9,13,94,112
2015,2,21500763,2/6/2016,1610612739,Cleveland Cavaliers,1,1,1610612740,New Orleans Pelicans,0,0,25,24,49,14,27,41,39,51,90,7,0,7,20,31,21,5,14,90,99
2015,2,21500763,2/6/2016,1610612740,New Orleans Pelicans,0,0,1610612739,Cleveland Cavaliers,1,1,29,35,64,5,18,23,34,53,87,11,5,16,15,41,18,6,8,88,84
2015,2,21500627,1/19/2016,1610612743,Denver Nuggets,1,0,1610612760,Oklahoma City Thunder,0,1,28,35,63,7,13,20,35,48,83,27,9,36,14,40,21,11,18,103,104
2015,2,21500627,1/19/2016,1610612760,Oklahoma City Thunder,0,1,1610612743,Denver Nuggets,1,0,35,34,69,6,22,28,41,56,97,22,7,29,21,41,30,5,13,103,110
2015,2,21500557,1/10/2016,1610612742,Dallas Mavericks,0,1,1610612750,Minnesota Timberwolves,1,0,30,27,57,6,14,20,36,41,77,15,6,21,14,30,20,8,15,87,93
2015,2,21500557,1/10/2016,1610612750,Minnesota Timberwolves,1,0,1610612742,Dallas Mavericks,0,1,29,34,63,4,12,16,33,46,79,17,5,22,19,29,23,7,17,87,87
2015,2,21500452,12/26/2015,1610612746,LA Clippers,0,1,1610612762,Utah Jazz,1,0,25,28,53,13,13,26,38,41,79,20,4,24,14,29,24,7,13,92,109
2015,2,21500452,12/26/2015,1610612762,Utah Jazz,1,0,1610612746,LA Clippers,0,1,26,21,47,10,17,27,36,38,74,22,5,27,11,28,18,9,16,91,104
2015,2,21500350,12/12/2015,1610612742,Dallas Mavericks,1,0,1610612764,Washington Wizards,0,1,24,32,56,14,19,33,38,51,89,21,3,24,15,37,23,6,13,99,111
2015,2,21500350,12/12/2015,1610612764,Washington Wizards,0,1,1610612742,Dallas Mavericks,1,0,30,26,56,14,15,29,44,41,85,12,3,15,6,37,33,5,13,99,114
2015,2,21500250,11/29/2015,1610612756,Phoenix Suns,0,1,1610612761,Toronto Raptors,1,0,29,38,67,11,16,27,40,54,94,16,4,20,18,38,24,6,10,95,107
2015,2,21500250,11/29/2015,1610612761,Toronto Raptors,1,0,1610612756,Phoenix Suns,0,1,26,31,57,12,17,29,38,48,86,14,3,17,13,38,19,4,13,94,102
2015,2,21500155,11/16/2015,1610612760,Oklahoma City Thunder,0,0,1610612763,Memphis Grizzlies,1,1,31,26,57,10,14,24,41,40,81,22,9,31,20,24,22,11,19,95,114
2015,2,21500155,11/16/2015,1610612763,Memphis Grizzlies,1,1,1610612760,Oklahoma City Thunder,0,0,25,42,67,12,5,17,37,47,84,36,3,39,17,32,23,7,10,95,122
2015,2,21500058,11/3/2015,1610612758,Sacramento Kings,1,0,1610612763,Memphis Grizzlies,0,1,22,32,54,7,13,20,29,45,74,24,16,40,11,41,17,5,14,96,89
2015,2,21500058,11/3/2015,1610612763,Memphis Grizzlies,0,1,1610612758,Sacramento Kings,1,0,37,26,63,3,17,20,40,43,83,20,5,25,15,31,23,8,17,97,103
2015,2,21501093,3/27/2016,1610612745,Houston Rockets,0,0,1610612754,Indiana Pacers,1,1,31,21,52,7,26,33,38,47,85,18,9,27,15,36,17,9,14,95,101
2015,2,21501093,3/27/2016,1610612754,Indiana Pacers,1,1,1610612745,Houston Rockets,0,0,32,29,61,9,17,26,41,46,87,13,7,20,15,34,25,7,13,93,104
2015,2,21500983,3/13/2016,1610612739,Cleveland Cavaliers,0,1,1610612746,LA Clippers,1,0,23,24,47,18,19,37,41,43,84,14,6,20,12,35,23,5,10,92,114
2015,2,21500983,3/13/2016,1610612746,LA Clippers,1,0,1610612739,Cleveland Cavaliers,0,1,22,25,47,10,22,32,32,47,79,16,3,19,6,42,23,3,10,93,90
2015,2,21500930,3/6/2016,1610612749,Milwaukee Bucks,1,0,1610612760,Oklahoma City Thunder,0,1,31,40,71,3,16,19,34,56,90,25,5,30,16,42,22,5,10,98,96
2015,2,21500930,3/6/2016,1610612760,Oklahoma City Thunder,0,1,1610612749,Milwaukee Bucks,1,0,25,26,51,7,18,25,32,44,76,33,10,43,19,30,27,17,22,97,104
2015,2,21500349,12/12/2015,1610612745,Houston Rockets,1,1,1610612747,Los Angeles Lakers,0,0,32,25,57,15,18,33,47,43,90,17,11,28,16,31,32,11,16,103,126
2015,2,21500349,12/12/2015,1610612747,Los Angeles Lakers,0,0,1610612745,Houston Rockets,1,1,25,31,56,10,22,32,35,53,88,17,3,20,14,41,21,16,20,103,97
2015,2,21500249,11/29/2015,1610612738,Boston Celtics,0,0,1610612753,Orlando Magic,1,1,31,30,61,5,22,27,36,52,88,14,6,20,17,38,28,6,12,94,91
2015,2,21500249,11/29/2015,1610612753,Orlando Magic,1,1,1610612738,Boston Celtics,0,0,36,32,68,9,16,25,45,48,93,11,5,16,24,26,24,7,15,94,110
2015,2,21500057,11/3/2015,1610612742,Dallas Mavericks,1,0,1610612761,Toronto Raptors,0,1,26,37,63,7,16,23,33,53,86,18,7,25,17,41,20,8,16,97,91
2015,2,21500057,11/3/2015,1610612761,Toronto Raptors,0,1,1610612742,Dallas Mavericks,1,0,32,33,65,5,12,17,37,45,82,23,3,26,14,30,18,5,16,98,102
2014,2,21400886,3/2/2015,1610612744,Golden State Warriors,0,0,1610612751,Brooklyn Nets,1,1,31,29,60,11,19,30,42,48,90,13,5,18,20,29,26,7,15,94,108
2014,2,21400886,3/2/2015,1610612751,Brooklyn Nets,1,1,1610612744,Golden State Warriors,0,0,34,34,68,10,11,21,44,45,89,12,4,16,14,33,20,11,13,95,110
2015,2,21501035,3/19/2016,1610612746,LA Clippers,0,0,1610612763,Memphis Grizzlies,1,1,19,17,36,12,18,30,31,35,66,28,11,39,7,31,18,9,14,92,102
2015,2,21501035,3/19/2016,1610612763,Memphis Grizzlies,1,1,1610612746,LA Clippers,0,0,36,31,67,4,11,15,40,42,82,29,7,36,20,26,23,8,13,94,113
2015,2,21500721,2/1/2016,1610612739,Cleveland Cavaliers,0,1,1610612754,Indiana Pacers,1,0,37,29,66,7,15,22,44,44,88,16,7,23,16,30,22,11,16,100,111
2015,2,21500721,2/1/2016,1610612754,Indiana Pacers,1,0,1610612739,Cleveland Cavaliers,0,1,35,39,74,8,19,27,43,58,101,12,2,14,22,37,24,8,16,101,106
2015,2,21500556,1/9/2016,1610612744,Golden State Warriors,0,1,1610612758,Sacramento Kings,1,0,30,20,50,19,18,37,49,38,87,11,4,15,10,31,35,8,19,103,128
2015,2,21500556,1/9/2016,1610612758,Sacramento Kings,1,0,1610612744,Golden State Warriors,0,1,35,34,69,8,15,23,43,49,92,22,7,29,11,43,27,5,10,104,116
2015,2,21500451,12/26/2015,1610612755,Philadelphia 76ers,0,1,1610612756,Phoenix Suns,1,0,26,26,52,12,15,27,38,41,79,23,4,27,12,32,20,10,22,103,111
2015,2,21500451,12/26/2015,1610612756,Phoenix Suns,1,0,1610612755,Philadelphia 76ers,0,1,24,37,61,10,17,27,34,54,88,26,8,34,17,41,17,9,15,101,104
2015,2,21500348,12/12/2015,1610612740,New Orleans Pelicans,0,0,1610612741,Chicago Bulls,1,1,34,39,73,6,10,16,40,49,89,8,3,11,8,43,26,6,11,96,94
2015,2,21500348,12/12/2015,1610612741,Chicago Bulls,1,1,1610612740,New Orleans Pelicans,0,0,25,33,58,8,12,20,33,45,78,24,5,29,11,37,17,9,14,97,98
2015,2,21500248,11/29/2015,1610612751,Brooklyn Nets,1,1,1610612765,Detroit Pistons,0,0,31,38,69,4,8,12,35,46,81,13,3,16,9,37,15,11,19,98,87
2015,2,21500248,11/29/2015,1610612765,Detroit Pistons,0,0,1610612751,Brooklyn Nets,1,1,28,49,77,6,18,24,34,67,101,9,12,21,27,47,19,8,15,97,83
2015,2,21500154,11/16/2015,1610612738,Boston Celtics,0,1,1610612745,Houston Rockets,1,0,33,24,57,11,25,36,44,49,93,12,5,17,19,34,27,10,20,103,111
2015,2,21500154,11/16/2015,1610612745,Houston Rockets,1,0,1610612738,Boston Celtics,0,1,25,28,53,11,21,32,36,49,85,12,11,23,15,40,23,16,22,103,95
2015,2,21500056,11/3/2015,1610612740,New Orleans Pelicans,1,0,1610612753,Orlando Magic,0,1,20,34,54,12,24,36,32,58,90,18,7,25,13,47,23,5,14,104,94
2015,2,21500056,11/3/2015,1610612753,Orlando Magic,0,1,1610612740,New Orleans Pelicans,1,0,35,37,72,7,11,18,42,48,90,12,0,12,11,37,24,12,18,102,103
2022,2,22200505,12/27/2022,1610612747,Los Angeles Lakers,0,1,1610612753,Orlando Magic,1,0,32,15,47,17,26,43,49,41,90,14,3,17,13,30,32,8,14,102,129
2022,2,22200505,12/27/2022,1610612753,Orlando Magic,1,0,1610612747,Los Angeles Lakers,0,1,32,24,56,10,18,28,42,42,84,16,9,25,8,37,25,4,11,100,110
2014,2,21400885,3/2/2015,1610612755,Philadelphia 76ers,1,0,1610612761,Toronto Raptors,0,1,33,25,58,8,12,20,41,37,78,13,6,19,14,27,32,6,16,88,103
2015,2,21501153,4/3/2016,1610612738,Boston Celtics,0,1,1610612747,Los Angeles Lakers,1,0,33,28,61,8,22,30,41,50,91,17,5,22,14,38,30,6,12,102,107
2015,2,21501153,4/3/2016,1610612747,Los Angeles Lakers,1,0,1610612738,Boston Celtics,0,1,31,38,69,6,15,21,37,53,90,20,9,29,12,46,22,8,11,102,100
2015,2,21500809,2/19/2016,1610612741,Chicago Bulls,1,1,1610612761,Toronto Raptors,0,0,41,36,77,7,9,16,48,45,93,13,7,20,13,35,32,7,9,98,116
2015,2,21500809,2/19/2016,1610612761,Toronto Raptors,0,0,1610612741,Chicago Bulls,1,1,33,37,70,5,13,18,38,50,88,25,9,34,14,40,22,4,8,97,106
2016,2,21600666,1/23/2017,1610612751,Brooklyn Nets,1,0,1610612759,San Antonio Spurs,0,1,27,29,56,5,20,25,32,49,81,17,1,18,11,38,14,7,17,97,86
2016,2,21600666,1/23/2017,1610612759,San Antonio Spurs,0,1,1610612751,Brooklyn Nets,1,0,36,37,73,9,13,22,45,50,95,13,3,16,16,35,22,2,9,97,112
2014,2,21400885,3/2/2015,1610612761,Toronto Raptors,0,1,1610612755,Philadelphia 76ers,1,0,30,23,53,11,16,27,41,39,80,21,3,24,13,28,24,6,11,90,114
2015,2,21500626,1/19/2016,1610612740,New Orleans Pelicans,1,1,1610612750,Minnesota Timberwolves,0,0,32,28,60,10,13,23,42,41,83,20,3,23,14,27,21,10,15,95,114
2015,2,21500626,1/19/2016,1610612750,Minnesota Timberwolves,0,0,1610612740,New Orleans Pelicans,1,1,33,29,62,3,11,14,36,40,76,24,7,31,13,28,18,9,16,93,99
2015,2,21500347,12/12/2015,1610612737,Atlanta Hawks,1,0,1610612759,San Antonio Spurs,0,1,25,31,56,5,19,24,30,50,80,13,3,16,8,45,21,11,17,97,78
2015,2,21500347,12/12/2015,1610612759,San Antonio Spurs,0,1,1610612737,Atlanta Hawks,1,0,26,28,54,10,10,20,36,38,74,21,1,22,11,27,26,15,23,98,103
2015,2,21500055,11/3/2015,1610612737,Atlanta Hawks,0,1,1610612748,Miami Heat,1,0,30,39,69,7,14,21,37,53,90,17,5,22,19,37,25,10,16,97,98
2015,2,21500055,11/3/2015,1610612748,Miami Heat,1,0,1610612737,Atlanta Hawks,0,1,33,25,58,5,23,28,38,48,86,11,5,16,16,35,13,10,19,97,92
2015,2,21500720,1/31/2016,1610612747,Los Angeles Lakers,1,0,1610612766,Charlotte Hornets,0,1,19,32,51,8,21,29,27,53,80,20,3,23,8,46,13,8,15,97,82
2015,2,21500720,1/31/2016,1610612766,Charlotte Hornets,0,1,1610612747,Los Angeles Lakers,1,0,23,37,60,13,23,36,36,60,96,16,10,26,21,44,28,6,11,98,101
2015,2,21500674,1/25/2016,1610612758,Sacramento Kings,1,0,1610612766,Charlotte Hornets,0,1,41,27,68,7,16,23,48,43,91,25,7,32,13,33,36,11,23,115,128
2015,2,21500674,1/25/2016,1610612766,Charlotte Hornets,0,1,1610612758,Sacramento Kings,1,0,24,42,66,20,24,44,44,66,110,21,5,26,20,50,27,4,10,116,129
2015,2,21500555,1/9/2016,1610612748,Miami Heat,0,0,1610612762,Utah Jazz,1,1,28,35,63,6,13,19,34,48,82,9,8,17,19,33,14,10,17,88,83
2015,2,21500555,1/9/2016,1610612762,Utah Jazz,1,1,1610612748,Miami Heat,0,0,30,21,51,9,11,20,39,32,71,11,7,18,10,25,19,7,17,89,98
2015,2,21500450,12/26/2015,1610612743,Denver Nuggets,0,0,1610612759,San Antonio Spurs,1,1,33,35,68,5,13,18,38,48,86,5,1,6,15,34,25,11,15,89,86
2015,2,21500450,12/26/2015,1610612759,San Antonio Spurs,1,1,1610612743,Denver Nuggets,0,0,32,39,71,7,3,10,39,42,81,16,1,17,14,29,21,6,13,89,101
2015,2,21500346,12/12/2015,1610612754,Indiana Pacers,0,0,1610612765,Detroit Pistons,1,1,38,28,66,3,13,16,41,41,82,11,7,18,8,38,17,11,16,99,96
2015,2,21500346,12/12/2015,1610612765,Detroit Pistons,1,1,1610612754,Indiana Pacers,0,0,32,29,61,13,16,29,45,45,90,15,4,19,15,31,26,7,14,100,118
2015,2,21500247,11/29/2015,1610612746,LA Clippers,1,1,1610612750,Minnesota Timberwolves,0,0,31,22,53,8,14,22,39,36,75,21,12,33,9,34,24,7,13,96,107
2015,2,21500247,11/29/2015,1610612750,Minnesota Timberwolves,0,0,1610612746,LA Clippers,1,1,29,37,66,8,8,16,37,45,82,17,4,21,13,33,21,3,15,97,99
2015,2,21500153,11/16/2015,1610612741,Chicago Bulls,1,1,1610612754,Indiana Pacers,0,0,29,42,71,6,9,15,35,51,86,20,12,32,14,42,26,4,8,96,96
2015,2,21500153,11/16/2015,1610612754,Indiana Pacers,0,0,1610612741,Chicago Bulls,1,1,26,40,66,9,12,21,35,52,87,16,8,24,16,40,19,9,13,96,95
2015,2,21500054,11/3/2015,1610612754,Indiana Pacers,0,1,1610612765,Detroit Pistons,1,0,31,34,65,7,16,23,38,50,88,11,1,12,15,35,21,8,16,94,94
2015,2,21500054,11/3/2015,1610612765,Detroit Pistons,1,0,1610612754,Indiana Pacers,0,1,28,36,64,5,17,22,33,53,86,11,6,17,23,33,14,15,23,95,82
2015,2,21500982,3/12/2016,1610612753,Orlando Magic,0,0,1610612757,Portland Trail Blazers,1,1,27,38,65,7,19,26,34,57,91,9,9,18,17,43,19,2,15,97,84
2015,2,21500982,3/12/2016,1610612757,Portland Trail Blazers,1,1,1610612753,Orlando Magic,0,0,30,19,49,17,18,35,47,37,84,10,1,11,9,29,34,6,15,96,121
2015,2,21500929,3/5/2016,1610612737,Atlanta Hawks,0,1,1610612746,LA Clippers,1,0,30,32,62,10,17,27,40,49,89,17,3,20,15,36,26,10,18,103,107
2015,2,21500929,3/5/2016,1610612746,LA Clippers,1,0,1610612737,Atlanta Hawks,0,1,22,25,47,12,20,32,34,45,79,17,11,28,7,44,22,9,19,102,97
2015,2,21500449,12/26/2015,1610612741,Chicago Bulls,0,0,1610612742,Dallas Mavericks,1,1,34,23,57,8,13,21,42,36,78,19,7,26,14,26,20,10,18,94,111
2015,2,21500449,12/26/2015,1610612742,Dallas Mavericks,1,1,1610612741,Chicago Bulls,0,0,24,30,54,16,17,33,40,47,87,22,6,28,18,31,24,7,12,93,118
2015,2,21500345,12/12/2015,1610612738,Boston Celtics,0,1,1610612766,Charlotte Hornets,1,0,31,40,71,9,16,25,40,56,96,9,1,10,9,48,26,1,5,97,98
2015,2,21500345,12/12/2015,1610612766,Charlotte Hornets,1,0,1610612738,Boston Celtics,0,1,25,28,53,11,24,35,36,52,88,10,0,10,9,43,17,5,11,95,93
2015,2,21500152,11/16/2015,1610612742,Dallas Mavericks,0,1,1610612755,Philadelphia 76ers,1,0,23,29,52,7,17,24,30,46,76,25,5,30,9,39,16,9,19,102,92
2015,2,21500152,11/16/2015,1610612755,Philadelphia 76ers,1,0,1610612742,Dallas Mavericks,0,1,29,25,54,5,17,22,34,42,76,13,7,20,11,34,16,12,27,101,86
2015,2,21500053,11/3/2015,1610612741,Chicago Bulls,0,0,1610612766,Charlotte Hornets,1,1,30,30,60,14,16,30,44,46,90,3,5,8,8,42,26,6,13,99,105
2015,2,21500053,11/3/2015,1610612766,Charlotte Hornets,1,1,1610612741,Chicago Bulls,0,0,33,35,68,14,9,23,47,44,91,22,1,23,14,31,26,5,10,99,130
2016,2,21600197,11/20/2016,1610612743,Denver Nuggets,1,1,1610612762,Utah Jazz,0,0,34,30,64,8,14,22,42,44,86,13,17,30,16,37,31,3,9,90,105
2016,2,21600197,11/20/2016,1610612762,Utah Jazz,0,0,1610612743,Denver Nuggets,1,1,26,32,58,7,20,27,33,52,85,18,5,23,16,39,15,4,10,90,91
2015,2,21501034,3/19/2016,1610612741,Chicago Bulls,1,1,1610612762,Utah Jazz,0,0,33,28,61,6,13,19,39,41,80,8,3,11,12,29,24,5,12,85,92
2015,2,21501034,3/19/2016,1610612762,Utah Jazz,0,0,1610612741,Chicago Bulls,1,1,27,32,59,8,19,27,35,51,86,7,5,12,18,35,22,4,10,85,85
2015,2,21500867,2/26/2016,1610612746,LA Clippers,0,1,1610612758,Sacramento Kings,1,0,34,26,60,9,20,29,43,46,89,22,4,26,14,34,18,6,8,95,117
2015,2,21500867,2/26/2016,1610612758,Sacramento Kings,1,0,1610612746,LA Clippers,0,1,22,32,54,12,12,24,34,44,78,27,10,37,17,32,19,6,17,94,107
2016,2,21600665,1/23/2017,1610612764,Washington Wizards,0,1,1610612766,Charlotte Hornets,1,0,33,22,55,10,15,25,43,37,80,13,4,17,8,31,22,7,15,93,109
2016,2,21600665,1/23/2017,1610612766,Charlotte Hornets,1,0,1610612764,Washington Wizards,0,1,27,31,58,8,24,32,35,55,90,21,4,25,15,42,24,5,8,94,99
2015,2,21500554,1/9/2016,1610612755,Philadelphia 76ers,1,0,1610612761,Toronto Raptors,0,1,28,35,63,11,6,17,39,41,80,6,8,14,12,33,26,7,13,90,95
2015,2,21500554,1/9/2016,1610612761,Toronto Raptors,0,1,1610612755,Philadelphia 76ers,1,0,36,22,58,5,12,17,41,34,75,21,6,27,11,27,19,9,13,91,108
2015,2,21500448,12/26/2015,1610612750,Minnesota Timberwolves,1,0,1610612754,Indiana Pacers,0,1,31,32,63,4,8,12,35,40,75,14,4,18,10,32,22,10,22,95,88
2015,2,21500448,12/26/2015,1610612754,Indiana Pacers,0,1,1610612750,Minnesota Timberwolves,1,0,31,23,54,9,17,26,40,40,80,13,1,14,16,24,25,14,23,97,102
2015,2,21500344,12/12/2015,1610612746,LA Clippers,0,1,1610612751,Brooklyn Nets,1,0,35,27,62,8,16,24,43,43,86,11,7,18,11,36,28,5,12,99,105
2015,2,21500344,12/12/2015,1610612751,Brooklyn Nets,1,0,1610612746,LA Clippers,0,1,30,30,60,5,14,19,35,44,79,25,5,30,13,33,17,12,17,97,100
2015,2,21500246,11/29/2015,1610612749,Milwaukee Bucks,0,0,1610612766,Charlotte Hornets,1,1,25,29,54,8,20,28,33,49,82,8,6,14,15,37,25,6,14,88,82
2015,2,21500246,11/29/2015,1610612766,Charlotte Hornets,1,1,1610612749,Milwaukee Bucks,0,0,12,27,39,15,16,31,27,43,70,18,4,22,7,39,20,9,14,88,87
2015,2,21500151,11/15/2015,1610612747,Los Angeles Lakers,1,1,1610612765,Detroit Pistons,0,0,25,31,56,6,13,19,31,44,75,29,10,39,11,37,24,7,16,97,97
2015,2,21500151,11/15/2015,1610612765,Detroit Pistons,0,0,1610612747,Los Angeles Lakers,1,1,28,41,69,7,20,27,35,61,96,8,7,15,18,45,16,5,12,99,85
2014,2,21400884,3/1/2015,1610612740,New Orleans Pelicans,0,1,1610612743,Denver Nuggets,1,0,31,21,52,5,17,22,36,38,74,22,8,30,12,29,22,10,16,92,99
2014,2,21400884,3/1/2015,1610612743,Denver Nuggets,1,0,1610612740,New Orleans Pelicans,0,1,28,31,59,9,24,33,37,55,92,9,8,17,21,39,17,7,13,93,92
2015,2,21501152,4/3/2016,1610612744,Golden State Warriors,1,1,1610612757,Portland Trail Blazers,0,0,32,26,58,18,12,30,50,38,88,18,4,22,11,30,30,8,13,100,136
2015,2,21501152,4/3/2016,1610612757,Portland Trail Blazers,0,0,1610612744,Golden State Warriors,1,1,29,32,61,9,15,24,38,47,85,26,7,33,14,35,23,5,13,101,111
2015,2,21501092,3/27/2016,1610612743,Denver Nuggets,0,0,1610612746,LA Clippers,1,1,30,35,65,7,22,29,37,57,94,9,4,13,27,30,24,13,15,88,90
2015,2,21501092,3/27/2016,1610612746,LA Clippers,1,1,1610612743,Denver Nuggets,0,0,28,24,52,10,18,28,38,42,80,19,7,26,20,24,24,7,15,89,105
2015,2,21500928,3/5/2016,1610612758,Sacramento Kings,0,0,1610612759,San Antonio Spurs,1,1,31,34,65,6,10,16,37,44,81,14,7,21,11,36,21,6,21,99,94
2015,2,21500928,3/5/2016,1610612759,San Antonio Spurs,1,1,1610612758,Sacramento Kings,0,0,32,26,58,8,15,23,40,41,81,16,3,19,14,27,31,13,22,99,104
2015,2,21500866,2/26/2016,1610612742,Dallas Mavericks,1,1,1610612743,Denver Nuggets,0,0,34,25,59,11,18,29,45,43,88,21,6,27,13,32,25,7,14,103,122
2015,2,21500866,2/26/2016,1610612743,Denver Nuggets,0,0,1610612742,Dallas Mavericks,1,1,34,30,64,9,20,29,43,50,93,21,10,31,19,38,18,9,15,104,116
2015,2,21500762,2/6/2016,1610612754,Indiana Pacers,1,1,1610612765,Detroit Pistons,0,0,35,30,65,6,5,11,41,35,76,24,5,29,10,28,21,7,16,94,112
2015,2,21500762,2/6/2016,1610612765,Detroit Pistons,0,0,1610612754,Indiana Pacers,1,1,26,20,46,12,21,33,38,41,79,16,15,31,14,34,14,7,14,95,104
2016,2,21600664,1/22/2017,1610612743,Denver Nuggets,0,0,1610612750,Minnesota Timberwolves,1,1,35,23,58,7,17,24,42,40,82,17,4,21,13,28,26,11,18,99,108
2016,2,21600664,1/22/2017,1610612750,Minnesota Timberwolves,1,1,1610612743,Denver Nuggets,0,0,39,31,70,6,9,15,45,40,85,15,6,21,10,31,29,6,15,99,111
2015,2,21500447,12/26/2015,1610612751,Brooklyn Nets,1,0,1610612764,Washington Wizards,0,1,38,34,72,5,12,17,43,46,89,5,11,16,17,35,24,10,20,99,96
2015,2,21500447,12/26/2015,1610612764,Washington Wizards,0,1,1610612751,Brooklyn Nets,1,0,30,27,57,12,15,27,42,42,84,15,7,22,10,35,32,8,13,101,111
2015,2,21500343,12/11/2015,1610612756,Phoenix Suns,1,0,1610612757,Portland Trail Blazers,0,1,23,25,48,13,22,35,36,47,83,11,7,18,12,39,21,7,12,92,96
2015,2,21500343,12/11/2015,1610612757,Portland Trail Blazers,0,1,1610612756,Phoenix Suns,1,0,33,29,62,12,22,34,45,51,96,4,3,7,20,33,23,8,12,93,106
2015,2,21500150,11/15/2015,1610612758,Sacramento Kings,1,1,1610612761,Toronto Raptors,0,0,29,22,51,10,15,25,39,37,76,19,5,24,10,30,23,13,20,96,107
2015,2,21500150,11/15/2015,1610612761,Toronto Raptors,0,0,1610612758,Sacramento Kings,1,1,23,33,56,15,16,31,38,49,87,10,4,14,13,36,18,8,16,98,101
2015,2,21500052,11/2/2015,1610612746,LA Clippers,1,1,1610612756,Phoenix Suns,0,0,29,26,55,8,18,26,37,44,81,20,3,23,4,42,20,8,11,97,102
2015,2,21500052,11/2/2015,1610612756,Phoenix Suns,0,0,1610612746,LA Clippers,1,1,27,41,68,9,21,30,36,62,98,15,6,21,21,44,23,4,10,98,96
2015,2,21500981,3/12/2016,1610612744,Golden State Warriors,1,1,1610612756,Phoenix Suns,0,0,31,20,51,11,22,33,42,42,84,28,5,33,7,39,28,3,8,102,123
2015,2,21500981,3/12/2016,1610612756,Phoenix Suns,0,0,1610612744,Golden State Warriors,1,1,34,29,63,11,18,29,45,47,92,15,5,20,12,37,29,6,12,101,116
2015,2,21500719,1/31/2016,1610612750,Minnesota Timberwolves,0,0,1610612757,Portland Trail Blazers,1,1,31,33,64,4,12,16,35,45,80,19,9,28,17,33,20,7,17,93,93
2015,2,21500719,1/31/2016,1610612757,Portland Trail Blazers,1,1,1610612750,Minnesota Timberwolves,0,0,26,23,49,6,21,27,32,44,76,26,4,30,9,37,16,10,13,94,96
2015,2,21500673,1/25/2016,1610612762,Utah Jazz,1,0,1610612765,Detroit Pistons,0,1,25,31,56,9,20,29,34,51,85,15,3,18,15,38,18,7,13,92,92
2015,2,21500673,1/25/2016,1610612765,Detroit Pistons,0,1,1610612762,Utah Jazz,1,0,23,30,53,11,11,22,34,41,75,16,17,33,8,40,19,5,10,91,95
2015,2,21500625,1/19/2016,1610612748,Miami Heat,1,0,1610612749,Milwaukee Bucks,0,1,22,30,52,5,17,22,27,47,74,20,6,26,15,34,13,6,16,90,79
2015,2,21500625,1/19/2016,1610612749,Milwaukee Bucks,0,1,1610612748,Miami Heat,1,0,31,31,62,5,7,12,36,38,74,14,2,16,9,29,19,6,18,89,91
2015,2,21500553,1/9/2016,1610612751,Brooklyn Nets,0,0,1610612765,Detroit Pistons,1,1,33,40,73,5,4,9,38,44,82,8,2,10,6,39,24,10,14,94,89
2015,2,21500553,1/9/2016,1610612765,Detroit Pistons,1,1,1610612751,Brooklyn Nets,0,0,35,30,65,8,19,27,43,49,92,9,5,14,15,36,23,5,11,94,103
2015,2,21500446,12/26/2015,1610612738,Boston Celtics,0,1,1610612765,Detroit Pistons,1,0,35,26,61,4,19,23,39,45,84,17,6,23,14,35,20,11,15,96,99
2015,2,21500446,12/26/2015,1610612765,Detroit Pistons,1,0,1610612738,Boston Celtics,0,1,29,37,66,6,19,25,35,56,91,17,8,25,23,37,16,6,16,97,93
2015,2,21500342,12/11/2015,1610612747,Los Angeles Lakers,0,0,1610612759,San Antonio Spurs,1,1,27,36,63,9,16,25,36,52,88,6,4,10,14,39,20,9,16,95,87
2015,2,21500342,12/11/2015,1610612759,San Antonio Spurs,1,1,1610612747,Los Angeles Lakers,0,0,38,30,68,6,8,14,44,38,82,15,10,25,12,31,26,7,13,96,109
2015,2,21500245,11/28/2015,1610612744,Golden State Warriors,1,1,1610612758,Sacramento Kings,0,0,23,27,50,16,14,30,39,41,80,26,5,31,14,30,32,9,16,97,120
2015,2,21500245,11/28/2015,1610612758,Sacramento Kings,0,0,1610612744,Golden State Warriors,1,1,29,46,75,10,15,25,39,61,100,13,2,15,26,37,22,8,15,97,101
2015,2,21500149,11/15/2015,1610612738,Boston Celtics,0,1,1610612760,Oklahoma City Thunder,1,0,30,29,59,9,14,23,39,43,82,13,7,20,15,30,25,10,18,94,100
2015,2,21500149,11/15/2015,1610612760,Oklahoma City Thunder,1,0,1610612738,Boston Celtics,0,1,22,30,52,6,19,25,28,49,77,23,6,29,16,38,18,12,18,94,85
2014,2,21400883,3/1/2015,1610612739,Cleveland Cavaliers,0,0,1610612745,Houston Rockets,1,1,28,30,58,12,28,40,40,58,98,11,10,21,27,33,19,11,16,100,103
2014,2,21400883,3/1/2015,1610612745,Houston Rockets,1,1,1610612739,Cleveland Cavaliers,0,0,23,21,44,11,19,30,34,40,74,26,7,33,14,32,21,11,23,99,105
2015,2,21500808,2/19/2016,1610612737,Atlanta Hawks,1,0,1610612748,Miami Heat,0,1,25,26,51,16,20,36,41,46,87,13,0,13,9,37,27,13,21,106,111
2015,2,21500808,2/19/2016,1610612748,Miami Heat,0,1,1610612737,Atlanta Hawks,1,0,36,32,68,8,12,20,44,44,88,19,9,28,13,36,27,7,16,105,115
2015,2,21500624,1/18/2016,1610612745,Houston Rockets,0,0,1610612746,LA Clippers,1,1,33,23,56,11,21,32,44,44,88,33,19,52,18,35,31,10,14,109,132
2015,2,21500624,1/18/2016,1610612746,LA Clippers,1,1,1610612745,Houston Rockets,0,0,25,29,54,22,15,37,47,44,91,24,9,33,11,37,28,8,13,108,140
2015,2,21500445,12/26/2015,1610612740,New Orleans Pelicans,1,1,1610612745,Houston Rockets,0,0,25,26,51,13,11,24,38,37,75,21,5,26,13,27,25,8,16,90,110
2015,2,21500445,12/26/2015,1610612745,Houston Rockets,0,0,1610612740,New Orleans Pelicans,1,1,23,28,51,15,18,33,38,46,84,17,3,20,15,32,21,5,11,90,108
2015,2,21500341,12/11/2015,1610612760,Oklahoma City Thunder,0,1,1610612762,Utah Jazz,1,0,31,31,62,6,11,17,37,42,79,14,2,16,12,31,14,7,13,88,94
2015,2,21500341,12/11/2015,1610612762,Utah Jazz,1,0,1610612760,Oklahoma City Thunder,0,1,25,25,50,8,20,28,33,45,78,16,8,24,13,36,17,4,11,90,90
2015,2,21500148,11/15/2015,1610612737,Atlanta Hawks,1,0,1610612762,Utah Jazz,0,1,29,25,54,8,14,22,37,39,76,14,3,17,11,32,26,7,15,91,96
2015,2,21500148,11/15/2015,1610612762,Utah Jazz,0,1,1610612737,Atlanta Hawks,1,0,32,23,55,7,14,21,39,37,76,12,5,17,13,26,21,9,20,90,97
2015,2,21500051,11/2/2015,1610612744,Golden State Warriors,1,1,1610612763,Memphis Grizzlies,0,0,32,27,59,11,14,25,43,41,84,22,8,30,12,34,32,8,14,101,119
2015,2,21500051,11/2/2015,1610612763,Memphis Grizzlies,0,0,1610612744,Golden State Warriors,1,1,23,50,73,3,20,23,26,70,96,14,6,20,17,57,21,8,12,100,69
2015,2,21501091,3/26/2016,1610612755,Philadelphia 76ers,0,0,1610612757,Portland Trail Blazers,1,1,29,26,55,10,28,38,39,54,93,17,7,24,12,48,21,9,13,103,105
2015,2,21501091,3/26/2016,1610612757,Portland Trail Blazers,1,1,1610612755,Philadelphia 76ers,0,0,30,36,66,8,17,25,38,53,91,24,6,30,13,44,21,5,10,102,108
2015,2,21501033,3/19/2016,1610612739,Cleveland Cavaliers,0,0,1610612748,Miami Heat,1,1,30,22,52,10,14,24,40,36,76,11,2,13,6,31,19,7,14,91,101
2015,2,21501033,3/19/2016,1610612748,Miami Heat,1,1,1610612739,Cleveland Cavaliers,0,0,35,30,65,11,8,19,46,38,84,19,4,23,18,23,29,6,12,90,122
2015,2,21500927,3/5/2016,1610612741,Chicago Bulls,1,1,1610612745,Houston Rockets,0,0,27,31,58,9,12,21,36,43,79,27,7,34,15,29,28,17,26,108,108
2015,2,21500927,3/5/2016,1610612745,Houston Rockets,0,0,1610612741,Chicago Bulls,1,1,26,26,52,9,26,35,35,52,87,21,9,30,13,42,22,8,19,109,100
2015,2,21500865,2/26/2016,1610612737,Atlanta Hawks,1,1,1610612741,Chicago Bulls,0,0,30,25,55,7,27,34,37,52,89,22,2,24,16,37,28,3,11,97,103
2015,2,21500865,2/26/2016,1610612741,Chicago Bulls,0,0,1610612737,Atlanta Hawks,1,1,27,41,68,5,15,20,32,56,88,19,3,22,22,35,19,14,21,97,88
2015,2,21500807,2/19/2016,1610612751,Brooklyn Nets,1,1,1610612752,New York Knicks,0,0,34,35,69,8,9,17,42,44,86,17,3,20,7,37,26,6,7,96,109
2015,2,21500807,2/19/2016,1610612752,New York Knicks,0,0,1610612751,Brooklyn Nets,1,1,26,30,56,10,16,26,36,46,82,16,2,18,10,36,20,14,16,96,98
2015,2,21500761,2/6/2016,1610612764,Washington Wizards,0,0,1610612766,Charlotte Hornets,1,1,29,32,61,9,16,25,38,48,86,19,4,23,10,39,22,7,11,99,104
2015,2,21500761,2/6/2016,1610612766,Charlotte Hornets,1,1,1610612764,Washington Wizards,0,0,26,28,54,12,15,27,38,43,81,20,5,25,10,37,23,9,16,98,108
2015,2,21500672,1/25/2016,1610612737,Atlanta Hawks,0,1,1610612743,Denver Nuggets,1,0,34,25,59,9,18,27,43,43,86,24,2,26,12,32,28,10,14,101,119
2015,2,21500672,1/25/2016,1610612743,Denver Nuggets,1,0,1610612737,Atlanta Hawks,0,1,27,37,64,6,14,20,33,51,84,33,4,37,18,34,18,11,15,101,105
2016,2,21600663,1/22/2017,1610612756,Phoenix Suns,0,1,1610612761,Toronto Raptors,1,0,31,26,57,9,13,22,40,39,79,26,2,28,9,31,20,9,15,98,115
2016,2,21600663,1/22/2017,1610612761,Toronto Raptors,1,0,1610612756,Phoenix Suns,0,1,26,30,56,7,20,27,33,50,83,30,5,35,12,40,19,6,10,99,103
2015,2,21500552,1/9/2016,1610612753,Orlando Magic,1,0,1610612764,Washington Wizards,0,1,33,27,60,5,9,14,38,36,74,18,6,24,13,24,22,10,15,88,99
2015,2,21500552,1/9/2016,1610612764,Washington Wizards,0,1,1610612753,Orlando Magic,1,0,29,24,53,13,10,23,42,34,76,8,2,10,6,28,29,9,15,88,105
2015,2,21500444,12/26/2015,1610612748,Miami Heat,0,1,1610612753,Orlando Magic,1,0,28,29,57,10,10,20,38,39,77,22,1,23,12,27,22,7,9,87,108
2015,2,21500444,12/26/2015,1610612753,Orlando Magic,1,0,1610612748,Miami Heat,0,1,34,26,60,9,10,19,43,36,79,6,7,13,9,29,31,5,10,86,101
2015,2,21500244,11/28/2015,1610612747,Los Angeles Lakers,0,0,1610612757,Portland Trail Blazers,1,1,29,30,59,7,16,23,36,46,82,17,6,23,10,38,20,5,9,92,96
2015,2,21500244,11/28/2015,1610612757,Portland Trail Blazers,1,1,1610612747,Los Angeles Lakers,0,0,26,22,48,12,18,30,38,40,78,20,6,26,15,27,24,12,16,92,108
2015,2,21500147,11/15/2015,1610612757,Portland Trail Blazers,0,0,1610612766,Charlotte Hornets,1,1,30,38,68,5,16,21,35,54,89,19,2,21,17,36,20,6,12,93,94
2015,2,21500147,11/15/2015,1610612766,Charlotte Hornets,1,1,1610612757,Portland Trail Blazers,0,0,32,20,52,9,22,31,41,42,83,15,4,19,11,34,29,5,12,94,106
2014,2,21400882,3/1/2015,1610612753,Orlando Magic,1,0,1610612766,Charlotte Hornets,0,1,25,45,70,6,9,15,31,54,85,15,5,20,13,42,16,5,11,95,83
2014,2,21400882,3/1/2015,1610612766,Charlotte Hornets,0,1,1610612753,Orlando Magic,1,0,32,30,62,8,10,18,40,40,80,10,4,14,8,35,22,8,16,94,98
2021,2,22100276,11/24/2021,1610612760,Oklahoma City Thunder,1,0,1610612762,Utah Jazz,0,1,22,24,46,15,21,36,37,45,82,15,7,22,7,39,21,11,13,98,104
2021,2,22100276,11/24/2021,1610612762,Utah Jazz,0,1,1610612760,Oklahoma City Thunder,1,0,24,15,39,15,32,47,39,47,86,17,3,20,9,41,19,7,10,97,110
2015,2,21500551,1/9/2016,1610612737,Atlanta Hawks,1,1,1610612741,Chicago Bulls,0,0,39,31,70,10,14,24,49,45,94,12,3,15,11,36,33,7,16,104,120
2015,2,21500551,1/9/2016,1610612741,Chicago Bulls,0,0,1610612737,Atlanta Hawks,1,1,29,36,65,7,11,18,36,47,83,26,5,31,17,34,16,15,22,105,105
2015,2,21500443,12/26/2015,1610612763,Memphis Grizzlies,0,0,1610612766,Charlotte Hornets,1,1,30,41,71,7,12,19,37,53,90,11,10,21,22,37,21,10,13,92,92
2015,2,21500443,12/26/2015,1610612766,Charlotte Hornets,1,1,1610612763,Memphis Grizzlies,0,0,14,23,37,14,18,32,28,41,69,28,4,32,11,32,21,9,19,93,98
2015,2,21500340,12/11/2015,1610612743,Denver Nuggets,1,1,1610612750,Minnesota Timberwolves,0,0,27,31,58,11,17,28,38,48,86,24,9,33,13,39,21,5,12,104,111
2015,2,21500340,12/11/2015,1610612750,Minnesota Timberwolves,0,0,1610612743,Denver Nuggets,1,1,31,37,68,7,12,19,38,49,87,25,4,29,8,43,22,7,10,103,108
2015,2,21500050,11/2/2015,1610612750,Minnesota Timberwolves,1,0,1610612757,Portland Trail Blazers,0,1,31,35,66,3,10,13,34,45,79,30,9,39,12,35,22,5,15,99,101
2015,2,21500050,11/2/2015,1610612757,Portland Trail Blazers,0,1,1610612750,Minnesota Timberwolves,1,0,32,27,59,9,21,30,41,48,89,15,5,20,17,35,18,10,16,99,106
2014,2,21400881,3/1/2015,1610612754,Indiana Pacers,1,1,1610612755,Philadelphia 76ers,0,0,33,37,70,3,15,18,36,52,88,19,6,25,17,39,17,8,14,96,94
2014,2,21400881,3/1/2015,1610612755,Philadelphia 76ers,0,0,1610612754,Indiana Pacers,1,1,24,36,60,5,19,24,29,55,84,11,6,17,15,43,10,11,18,96,74
2015,2,21501151,4/3/2016,1610612752,New York Knicks,1,0,1610612754,Indiana Pacers,0,1,26,45,71,7,18,25,33,63,96,14,6,20,19,46,20,5,11,98,87
2015,2,21501151,4/3/2016,1610612754,Indiana Pacers,0,1,1610612752,New York Knicks,1,0,27,32,59,7,15,22,34,47,81,17,3,20,10,37,17,7,17,98,92
2015,2,21500980,3/12/2016,1610612743,Denver Nuggets,1,1,1610612764,Washington Wizards,0,0,34,22,56,8,16,24,42,38,80,24,5,29,12,27,24,13,22,105,116
2015,2,21500980,3/12/2016,1610612764,Washington Wizards,0,0,1610612743,Denver Nuggets,1,1,29,36,65,7,14,21,36,50,86,21,8,29,16,38,20,10,20,105,100
2015,2,21500863,2/26/2016,1610612752,New York Knicks,1,1,1610612753,Orlando Magic,0,0,33,31,64,4,12,16,37,43,80,30,6,36,13,33,18,6,11,95,108
2015,2,21500863,2/26/2016,1610612753,Orlando Magic,0,0,1610612752,New York Knicks,1,1,33,33,66,6,21,27,39,54,93,11,5,16,15,41,24,7,12,96,95
2015,2,21500718,1/31/2016,1610612744,Golden State Warriors,0,1,1610612752,New York Knicks,1,0,26,18,44,16,13,29,42,31,73,16,7,23,5,29,31,6,18,98,116
2015,2,21500718,1/31/2016,1610612752,New York Knicks,1,0,1610612744,Golden State Warriors,0,1,27,45,72,6,12,18,33,57,90,23,3,26,15,42,19,8,11,98,95
2015,2,21500671,1/25/2016,1610612740,New Orleans Pelicans,1,0,1610612745,Houston Rockets,0,1,29,33,62,13,16,29,42,49,91,14,11,25,18,35,23,7,12,97,111
2015,2,21500671,1/25/2016,1610612745,Houston Rockets,0,1,1610612740,New Orleans Pelicans,1,0,19,21,40,19,21,40,38,42,80,17,4,21,10,34,22,8,17,97,112
2015,2,21500623,1/18/2016,1610612738,Boston Celtics,0,0,1610612742,Dallas Mavericks,1,1,28,36,64,12,18,30,40,54,94,21,5,26,14,43,24,4,12,104,113
2015,2,21500623,1/18/2016,1610612742,Dallas Mavericks,1,1,1610612738,Boston Celtics,0,0,24,35,59,16,18,34,40,53,93,22,2,24,15,39,23,9,14,104,118
2015,2,21500550,1/9/2016,1610612746,LA Clippers,1,1,1610612766,Charlotte Hornets,0,0,32,28,60,8,23,31,40,51,91,9,1,10,14,37,19,4,9,92,97
2015,2,21500550,1/9/2016,1610612766,Charlotte Hornets,0,0,1610612746,LA Clippers,1,1,24,37,61,7,16,23,31,53,84,14,5,19,19,35,14,6,16,91,83
2016,2,21600196,11/20/2016,1610612758,Sacramento Kings,1,1,1610612761,Toronto Raptors,0,0,25,29,54,11,16,27,36,45,81,19,6,25,12,35,26,7,14,93,102
2016,2,21600196,11/20/2016,1610612761,Toronto Raptors,0,0,1610612758,Sacramento Kings,1,1,25,36,61,9,15,24,34,51,85,22,2,24,18,34,16,8,15,92,99
2016,2,21600662,1/22/2017,1610612742,Dallas Mavericks,1,1,1610612747,Los Angeles Lakers,0,0,26,22,48,17,22,39,43,44,87,19,0,19,16,28,27,3,10,92,122
2016,2,21600662,1/22/2017,1610612747,Los Angeles Lakers,0,0,1610612742,Dallas Mavericks,1,1,25,27,52,3,18,21,28,45,73,14,3,17,8,38,11,9,18,91,73
2015,2,21500243,11/28/2015,1610612740,New Orleans Pelicans,0,0,1610612762,Utah Jazz,1,1,24,28,52,5,12,17,29,40,69,24,6,30,6,37,19,11,17,94,87
2015,2,21500243,11/28/2015,1610612762,Utah Jazz,1,1,1610612740,New Orleans Pelicans,0,0,29,35,64,9,9,18,38,44,82,16,5,21,13,35,18,8,16,94,101
2015,2,21500146,11/15/2015,1610612750,Minnesota Timberwolves,1,0,1610612763,Memphis Grizzlies,0,1,36,30,66,5,11,16,41,41,82,19,2,21,11,31,20,7,12,94,106
2015,2,21500146,11/15/2015,1610612763,Memphis Grizzlies,0,1,1610612750,Minnesota Timberwolves,1,0,31,23,54,9,8,17,40,31,71,25,2,27,7,26,21,10,16,95,114
2015,2,21500862,2/26/2016,1610612755,Philadelphia 76ers,1,0,1610612764,Washington Wizards,0,1,27,30,57,8,17,25,35,47,82,16,5,21,9,40,21,7,13,96,94
2015,2,21500862,2/26/2016,1610612764,Washington Wizards,0,1,1610612755,Philadelphia 76ers,1,0,33,38,71,7,16,23,40,54,94,16,1,17,19,36,24,10,13,97,103
2015,2,21500549,1/8/2016,1610612747,Los Angeles Lakers,1,0,1610612760,Oklahoma City Thunder,0,1,31,27,58,9,17,26,40,44,84,24,1,25,13,31,19,8,13,96,113
2015,2,21500549,1/8/2016,1610612760,Oklahoma City Thunder,0,1,1610612747,Los Angeles Lakers,1,0,40,32,72,5,12,17,45,44,89,22,4,26,20,26,17,9,14,95,117
2015,2,21500442,12/26/2015,1610612737,Atlanta Hawks,1,1,1610612752,New York Knicks,0,0,39,25,64,8,16,24,47,41,88,15,3,18,12,30,33,6,9,94,117
2015,2,21500442,12/26/2015,1610612752,New York Knicks,0,0,1610612737,Atlanta Hawks,1,1,32,25,57,7,17,24,39,42,81,13,4,17,18,27,25,13,23,94,98
2015,2,21500339,12/11/2015,1610612740,New Orleans Pelicans,1,1,1610612764,Washington Wizards,0,0,23,29,52,16,11,27,39,40,79,13,5,18,10,32,21,10,16,95,107
2015,2,21500339,12/11/2015,1610612764,Washington Wizards,0,0,1610612740,New Orleans Pelicans,1,1,28,25,53,12,15,27,40,40,80,13,8,21,8,36,27,9,11,94,105
2015,2,21500242,11/28/2015,1610612737,Atlanta Hawks,0,0,1610612759,San Antonio Spurs,1,1,31,30,61,6,20,26,37,50,87,8,5,13,15,38,28,11,18,96,88
2015,2,21500242,11/28/2015,1610612759,San Antonio Spurs,1,1,1610612737,Atlanta Hawks,0,0,31,37,68,9,8,17,40,45,85,19,1,20,13,32,25,9,16,96,108
2015,2,21500049,11/2/2015,1610612745,Houston Rockets,1,1,1610612760,Oklahoma City Thunder,0,0,32,28,60,9,20,29,41,48,89,19,10,29,12,41,22,7,12,104,110
2015,2,21500049,11/2/2015,1610612760,Oklahoma City Thunder,0,0,1610612745,Houston Rockets,1,1,30,31,61,10,13,23,40,44,84,15,7,22,17,31,17,18,25,103,105
2015,2,21501090,3/26/2016,1610612738,Boston Celtics,0,1,1610612756,Phoenix Suns,1,0,27,28,55,8,21,29,35,49,84,24,3,27,18,33,14,7,19,98,102
2015,2,21501090,3/26/2016,1610612756,Phoenix Suns,1,0,1610612738,Boston Celtics,0,1,30,24,54,7,24,31,37,48,85,18,3,21,16,35,19,7,20,98,99
2015,2,21501032,3/19/2016,1610612752,New York Knicks,0,0,1610612764,Washington Wizards,1,1,22,38,60,10,11,21,32,49,81,15,2,17,14,36,21,7,18,94,89
2015,2,21501032,3/19/2016,1610612764,Washington Wizards,1,1,1610612752,New York Knicks,0,0,31,27,58,8,21,29,39,48,87,13,4,17,12,37,24,2,10,94,99
2015,2,21500760,2/6/2016,1610612745,Houston Rockets,1,0,1610612757,Portland Trail Blazers,0,1,18,23,41,7,29,36,25,52,77,22,8,30,17,38,13,15,23,99,79
2015,2,21500760,2/6/2016,1610612757,Portland Trail Blazers,0,1,1610612745,Houston Rockets,1,0,24,28,52,11,24,35,35,52,87,15,8,23,22,34,21,13,22,99,96
2015,2,21500548,1/8/2016,1610612744,Golden State Warriors,0,1,1610612757,Portland Trail Blazers,1,0,28,27,55,18,14,32,46,41,87,18,3,21,7,35,36,12,15,106,128
2015,2,21500548,1/8/2016,1610612757,Portland Trail Blazers,1,0,1610612744,Golden State Warriors,0,1,26,37,63,12,21,33,38,58,96,20,8,28,14,46,21,6,9,106,108
2015,2,21500241,11/28/2015,1610612742,Dallas Mavericks,1,1,1610612743,Denver Nuggets,0,0,26,25,51,7,19,26,33,44,77,19,8,27,12,37,18,9,13,92,92
2015,2,21500241,11/28/2015,1610612743,Denver Nuggets,0,0,1610612742,Dallas Mavericks,1,1,22,28,50,8,17,25,30,45,75,13,4,17,15,33,17,13,22,91,81
2015,2,21500145,11/15/2015,1610612740,New Orleans Pelicans,0,0,1610612752,New York Knicks,1,1,26,24,50,6,15,21,32,39,71,17,2,19,7,34,16,8,18,93,87
2015,2,21500145,11/15/2015,1610612752,New York Knicks,1,1,1610612740,New Orleans Pelicans,0,0,34,36,70,4,14,18,38,50,88,15,4,19,15,36,18,5,9,92,95
2014,2,21400880,3/1/2015,1610612738,Boston Celtics,1,0,1610612744,Golden State Warriors,0,1,32,46,78,8,23,31,40,69,109,13,4,17,28,42,21,4,8,97,101
2015,2,21501089,3/26/2016,1610612749,Milwaukee Bucks,1,0,1610612766,Charlotte Hornets,0,1,33,36,69,4,11,15,37,47,84,13,2,15,15,33,26,6,9,86,91
2015,2,21501089,3/26/2016,1610612766,Charlotte Hornets,0,1,1610612749,Milwaukee Bucks,1,0,25,20,45,16,13,29,41,33,74,17,4,21,8,28,30,6,10,87,115
2015,2,21500926,3/5/2016,1610612750,Minnesota Timberwolves,1,1,1610612751,Brooklyn Nets,0,0,42,16,58,10,8,18,52,24,76,18,4,22,6,21,36,7,12,93,132
2015,2,21500926,3/5/2016,1610612751,Brooklyn Nets,0,0,1610612750,Minnesota Timberwolves,1,1,36,30,66,9,17,26,45,47,92,19,7,26,24,27,19,8,16,94,118
2015,2,21500861,2/26/2016,1610612754,Indiana Pacers,1,0,1610612766,Charlotte Hornets,0,1,31,35,66,4,15,19,35,50,85,21,3,24,14,37,19,8,15,98,95
2015,2,21500861,2/26/2016,1610612766,Charlotte Hornets,0,1,1610612754,Indiana Pacers,1,0,25,30,55,11,17,28,36,47,83,13,6,19,8,43,23,8,14,98,96
2014,2,21400880,3/1/2015,1610612744,Golden State Warriors,0,1,1610612738,Boston Celtics,1,0,28,33,61,12,22,34,40,55,95,14,3,17,17,40,19,4,10,97,106
2015,2,21500717,1/31/2016,1610612742,Dallas Mavericks,1,1,1610612756,Phoenix Suns,0,0,23,26,49,8,21,29,31,47,78,21,2,23,15,34,15,7,15,89,91
2015,2,21500717,1/31/2016,1610612756,Phoenix Suns,0,0,1610612742,Dallas Mavericks,1,1,22,29,51,5,18,23,27,47,74,19,5,24,18,32,13,9,20,91,78
2015,2,21500670,1/25/2016,1610612753,Orlando Magic,0,0,1610612763,Memphis Grizzlies,1,1,30,28,58,10,18,28,40,46,86,12,2,14,9,38,24,12,19,102,102
2015,2,21500670,1/25/2016,1610612763,Memphis Grizzlies,1,1,1610612753,Orlando Magic,0,0,37,45,82,6,12,18,43,57,100,16,9,25,22,40,25,2,10,102,108
2016,2,21600195,11/20/2016,1610612754,Indiana Pacers,0,1,1610612760,Oklahoma City Thunder,1,0,29,38,67,11,11,22,40,49,89,24,7,31,16,37,23,10,22,110,115
2016,2,21600195,11/20/2016,1610612760,Oklahoma City Thunder,1,0,1610612754,Indiana Pacers,0,1,34,31,65,10,26,36,44,57,101,13,5,18,20,40,28,13,20,111,111
2015,2,21500547,1/8/2016,1610612748,Miami Heat,0,1,1610612756,Phoenix Suns,1,0,29,26,55,7,11,18,36,37,73,24,6,30,6,32,23,5,13,94,103
2015,2,21500547,1/8/2016,1610612756,Phoenix Suns,1,0,1610612748,Miami Heat,0,1,34,34,68,6,18,24,40,52,92,9,4,13,20,35,15,9,14,94,95
2015,2,21500441,12/26/2015,1610612749,Milwaukee Bucks,1,0,1610612761,Toronto Raptors,0,1,28,39,67,6,8,14,34,47,81,16,2,18,12,36,25,7,13,88,90
2015,2,21500441,12/26/2015,1610612761,Toronto Raptors,0,1,1610612749,Milwaukee Bucks,1,0,29,23,52,13,16,29,42,39,81,14,5,19,11,30,31,3,9,88,111
2015,2,21500338,12/11/2015,1610612763,Memphis Grizzlies,1,0,1610612766,Charlotte Hornets,0,1,25,35,60,7,13,20,32,48,80,28,9,37,14,38,19,5,12,97,99
2015,2,21500338,12/11/2015,1610612766,Charlotte Hornets,0,1,1610612763,Memphis Grizzlies,1,0,21,20,41,18,19,37,39,39,78,27,3,30,11,30,23,8,16,97,123
2015,2,21500240,11/28/2015,1610612739,Cleveland Cavaliers,1,1,1610612751,Brooklyn Nets,0,0,26,34,60,9,18,27,35,52,87,11,6,17,17,39,20,9,20,98,90
2015,2,21500240,11/28/2015,1610612751,Brooklyn Nets,0,0,1610612739,Cleveland Cavaliers,1,1,29,35,64,4,13,17,33,48,81,18,6,24,12,39,21,9,16,97,88
2015,2,21500048,11/2/2015,1610612752,New York Knicks,1,0,1610612759,San Antonio Spurs,0,1,28,48,76,4,9,13,32,57,89,16,5,21,19,40,17,6,10,90,84
2015,2,21500048,11/2/2015,1610612759,San Antonio Spurs,0,1,1610612752,New York Knicks,1,0,35,31,66,4,9,13,39,40,79,12,5,17,11,32,21,8,14,91,94
2015,2,21501150,4/3/2016,1610612741,Chicago Bulls,0,1,1610612749,Milwaukee Bucks,1,0,32,16,48,7,19,26,39,35,74,17,5,22,7,29,30,6,12,90,102
2015,2,21501150,4/3/2016,1610612749,Milwaukee Bucks,1,0,1610612741,Chicago Bulls,0,1,38,40,78,2,5,7,40,45,85,16,4,20,18,30,28,10,14,90,98
2015,2,21501088,3/26/2016,1610612759,San Antonio Spurs,0,0,1610612760,Oklahoma City Thunder,1,1,33,38,71,4,11,15,37,49,86,14,3,17,15,35,14,6,14,94,92
2015,2,21501088,3/26/2016,1610612760,Oklahoma City Thunder,1,1,1610612759,San Antonio Spurs,0,0,37,28,65,7,13,20,44,41,85,16,2,18,19,23,19,8,17,95,111
2015,2,21500979,3/12/2016,1610612759,San Antonio Spurs,1,1,1610612760,Oklahoma City Thunder,0,0,30,31,61,4,20,24,34,51,85,21,4,25,15,38,17,7,11,94,93
2015,2,21500979,3/12/2016,1610612760,Oklahoma City Thunder,0,0,1610612759,San Antonio Spurs,1,1,29,34,63,2,16,18,31,50,81,21,4,25,20,32,18,12,19,93,85
2015,2,21500925,3/5/2016,1610612740,New Orleans Pelicans,1,0,1610612762,Utah Jazz,0,1,29,44,73,9,10,19,38,54,92,9,2,11,12,44,25,4,8,93,94
2015,2,21500925,3/5/2016,1610612762,Utah Jazz,0,1,1610612740,New Orleans Pelicans,1,0,31,27,58,6,14,20,37,41,78,26,1,27,12,29,23,6,15,94,106
2015,2,21500239,11/28/2015,1610612761,Toronto Raptors,0,1,1610612764,Washington Wizards,1,0,20,28,48,11,13,24,31,41,72,11,3,14,7,35,17,11,22,94,84
2015,2,21500239,11/28/2015,1610612764,Washington Wizards,1,0,1610612761,Toronto Raptors,0,1,20,39,59,7,16,23,27,55,82,21,6,27,15,43,20,8,15,94,82
2015,2,21500144,11/14/2015,1610612744,Golden State Warriors,1,1,1610612751,Brooklyn Nets,0,0,31,32,63,12,22,34,43,54,97,9,1,10,13,42,31,12,15,105,107
2015,2,21500144,11/14/2015,1610612751,Brooklyn Nets,0,0,1610612744,Golden State Warriors,1,1,39,41,80,2,16,18,41,57,98,15,1,16,15,42,22,9,13,105,99
2014,2,21400879,3/1/2015,1610612757,Portland Trail Blazers,0,1,1610612758,Sacramento Kings,1,0,31,28,59,10,14,24,41,42,83,18,2,20,15,27,19,8,17,94,110
2014,2,21400879,3/1/2015,1610612758,Sacramento Kings,1,0,1610612757,Portland Trail Blazers,0,1,36,38,74,3,9,12,39,47,86,18,5,23,14,34,24,5,13,95,99
2015,2,21500860,2/25/2016,1610612759,San Antonio Spurs,0,1,1610612762,Utah Jazz,1,0,29,32,61,9,9,18,38,41,79,11,1,12,13,29,17,6,12,85,96
2015,2,21500860,2/25/2016,1610612762,Utah Jazz,1,0,1610612759,San Antonio Spurs,0,1,30,30,60,3,14,17,33,44,77,9,3,12,9,36,15,5,11,85,78
2015,2,21500806,2/19/2016,1610612764,Washington Wizards,1,1,1610612765,Detroit Pistons,0,0,29,27,56,7,15,22,36,42,78,19,7,26,8,37,26,2,9,91,98
2015,2,21500806,2/19/2016,1610612765,Detroit Pistons,0,0,1610612764,Washington Wizards,1,1,28,31,59,7,16,23,35,47,82,9,8,17,12,41,13,5,13,92,86
2015,2,21500622,1/18/2016,1610612739,Cleveland Cavaliers,1,0,1610612744,Golden State Warriors,0,1,30,28,58,7,12,19,37,40,77,17,8,25,9,34,22,7,16,96,98
2015,2,21500622,1/18/2016,1610612744,Golden State Warriors,0,1,1610612739,Cleveland Cavaliers,1,0,27,18,45,19,21,40,46,39,85,21,6,27,10,32,33,3,8,98,132
2015,2,21500546,1/8/2016,1610612752,New York Knicks,0,0,1610612759,San Antonio Spurs,1,1,29,41,70,9,12,21,38,53,91,14,3,17,15,39,19,5,9,93,99
2015,2,21500546,1/8/2016,1610612759,San Antonio Spurs,1,1,1610612752,New York Knicks,0,0,37,43,80,4,9,13,41,52,93,14,3,17,17,37,23,1,8,93,100
2015,2,21500440,12/25/2015,1610612746,LA Clippers,0,1,1610612747,Los Angeles Lakers,1,0,28,31,59,10,16,26,38,47,85,8,3,11,10,37,22,10,16,97,94
2015,2,21500440,12/25/2015,1610612747,Los Angeles Lakers,1,0,1610612746,LA Clippers,0,1,25,29,54,7,16,23,32,45,77,13,12,25,8,41,17,10,16,97,84
2015,2,21500337,12/11/2015,1610612749,Milwaukee Bucks,0,0,1610612761,Toronto Raptors,1,1,29,40,69,4,7,11,33,47,80,13,3,16,14,36,19,9,15,89,83
2015,2,21500337,12/11/2015,1610612761,Toronto Raptors,1,1,1610612749,Milwaukee Bucks,0,0,27,23,50,7,13,20,34,36,70,15,8,23,9,31,16,9,17,90,90
2015,2,21500047,11/2/2015,1610612749,Milwaukee Bucks,0,1,1610612751,Brooklyn Nets,1,0,29,21,50,9,14,23,38,35,73,18,8,26,12,26,24,3,14,91,103
2015,2,21500047,11/2/2015,1610612751,Brooklyn Nets,1,0,1610612749,Milwaukee Bucks,0,1,30,30,60,6,13,19,36,43,79,18,4,22,15,30,21,6,18,90,96
2014,2,21400878,3/1/2015,1610612747,Los Angeles Lakers,1,0,1610612760,Oklahoma City Thunder,0,1,31,34,65,9,16,25,40,50,90,12,6,18,11,41,25,5,9,97,101
2014,2,21400878,3/1/2015,1610612760,Oklahoma City Thunder,0,1,1610612747,Los Angeles Lakers,1,0,29,36,65,11,21,32,40,57,97,17,6,23,19,42,21,6,9,97,108
2015,2,21501230,4/13/2016,1610612743,Denver Nuggets,0,0,1610612757,Portland Trail Blazers,1,1,33,36,69,7,18,25,40,54,94,12,6,18,22,36,24,11,20,100,99
2015,2,21501230,4/13/2016,1610612757,Portland Trail Blazers,1,1,1610612743,Denver Nuggets,0,0,28,25,53,11,25,36,39,50,89,18,4,22,16,35,19,10,17,100,107
2016,2,21600661,1/22/2017,1610612744,Golden State Warriors,0,1,1610612753,Orlando Magic,1,0,23,24,47,19,23,42,42,47,89,15,4,19,17,31,27,9,19,100,118
2016,2,21600661,1/22/2017,1610612753,Orlando Magic,1,0,1610612744,Golden State Warriors,0,1,35,33,68,7,21,28,42,54,96,7,9,16,14,46,25,8,12,101,98
2015,2,21500669,1/25/2016,1610612741,Chicago Bulls,1,0,1610612748,Miami Heat,0,1,30,40,70,5,13,18,35,53,88,9,3,12,14,41,18,7,13,93,84
2015,2,21500669,1/25/2016,1610612748,Miami Heat,0,1,1610612741,Chicago Bulls,1,0,34,33,67,3,11,14,37,44,81,12,5,17,9,37,21,5,12,93,89
2015,2,21500238,11/27/2015,1610612740,New Orleans Pelicans,0,0,1610612746,LA Clippers,1,1,29,45,74,5,15,20,34,60,94,17,6,23,16,46,20,6,12,103,90
2015,2,21500238,11/27/2015,1610612746,LA Clippers,1,1,1610612740,New Orleans Pelicans,0,0,33,31,64,7,12,19,40,43,83,24,6,30,7,37,27,8,13,103,111
2015,2,21500143,11/14/2015,1610612743,Denver Nuggets,0,0,1610612756,Phoenix Suns,1,1,28,35,63,6,29,35,34,64,98,7,1,8,16,48,13,4,13,100,81
2015,2,21500143,11/14/2015,1610612756,Phoenix Suns,1,1,1610612743,Denver Nuggets,0,0,26,34,60,11,13,24,37,47,84,20,6,26,16,35,19,8,20,100,105
2014,2,21400877,3/1/2015,1610612741,Chicago Bulls,1,0,1610612746,LA Clippers,0,1,17,44,61,10,16,26,27,60,87,22,8,30,22,44,18,6,12,92,86
2015,2,21501149,4/3/2016,1610612756,Phoenix Suns,1,0,1610612762,Utah Jazz,0,1,25,26,51,8,19,27,33,45,78,12,7,19,16,32,16,9,22,93,86
2015,2,21501149,4/3/2016,1610612762,Utah Jazz,0,1,1610612756,Phoenix Suns,1,0,29,25,54,10,17,27,39,42,81,13,4,17,6,38,27,5,10,94,101
2015,2,21501087,3/26/2016,1610612750,Minnesota Timberwolves,1,0,1610612762,Utah Jazz,0,1,28,45,73,4,7,11,32,52,84,16,3,19,13,41,18,5,10,91,84
2015,2,21501087,3/26/2016,1610612762,Utah Jazz,0,1,1610612750,Minnesota Timberwolves,1,0,30,32,62,9,12,21,39,44,83,6,1,7,9,35,21,9,14,91,93
2020,2,22000070,1/1/2021,1610612765,Detroit Pistons,1,1,1610612738,Boston Celtics,0,0,25,29,54,11,23,34,36,52,88,13,7,20,15,39,18,12,20,102,96
2015,2,21500924,3/5/2016,1610612754,Indiana Pacers,0,1,1610612764,Washington Wizards,1,0,30,32,62,7,14,21,37,46,83,19,1,20,11,36,14,7,12,94,100
2015,2,21500924,3/5/2016,1610612764,Washington Wizards,1,0,1610612754,Indiana Pacers,0,1,33,41,74,6,9,15,39,50,89,15,9,24,20,34,25,8,17,96,99
2014,2,21400877,3/1/2015,1610612746,LA Clippers,0,1,1610612741,Chicago Bulls,1,0,31,29,60,7,20,27,38,49,87,13,11,24,17,37,15,2,9,93,96
2015,2,21500621,1/18/2016,1610612751,Brooklyn Nets,0,0,1610612761,Toronto Raptors,1,1,34,28,62,5,9,14,39,37,76,17,2,19,8,30,24,8,14,90,100
2015,2,21500621,1/18/2016,1610612761,Toronto Raptors,1,1,1610612751,Brooklyn Nets,0,0,30,31,61,13,11,24,43,42,85,13,5,18,12,35,24,4,8,91,112
2015,2,21500545,1/8/2016,1610612742,Dallas Mavericks,0,0,1610612749,Milwaukee Bucks,1,1,21,19,40,14,30,44,35,49,84,11,5,16,19,30,27,11,16,90,95
2015,2,21500545,1/8/2016,1610612749,Milwaukee Bucks,1,1,1610612742,Dallas Mavericks,0,0,33,38,71,4,5,9,37,43,80,18,11,29,18,29,24,6,15,89,96
2015,2,21500439,12/25/2015,1610612745,Houston Rockets,1,1,1610612759,San Antonio Spurs,0,0,25,34,59,7,8,15,32,42,74,17,9,26,11,36,23,11,17,94,88
2015,2,21500439,12/25/2015,1610612759,San Antonio Spurs,0,0,1610612745,Houston Rockets,1,1,31,37,68,5,15,20,36,52,88,7,1,8,16,36,24,8,17,94,84
2015,2,21500336,12/11/2015,1610612738,Boston Celtics,1,0,1610612744,Golden State Warriors,0,1,37,44,81,12,21,33,49,65,114,9,7,16,15,53,32,10,16,125,119
2015,2,21500336,12/11/2015,1610612744,Golden State Warriors,0,1,1610612738,Boston Celtics,1,0,33,43,76,9,22,31,42,65,107,31,8,39,22,46,28,7,18,123,124
2015,2,21500142,11/14/2015,1610612755,Philadelphia 76ers,0,0,1610612759,San Antonio Spurs,1,1,25,35,60,8,14,22,33,49,82,9,2,11,6,42,15,10,15,96,83
2015,2,21500142,11/14/2015,1610612759,San Antonio Spurs,1,1,1610612755,Philadelphia 76ers,0,0,28,41,69,5,11,16,33,52,85,21,4,25,18,39,23,7,14,96,92
2015,2,21500046,11/2/2015,1610612739,Cleveland Cavaliers,0,1,1610612755,Philadelphia 76ers,1,0,34,25,59,8,14,22,42,39,81,15,5,20,12,29,28,7,16,95,107
2015,2,21500046,11/2/2015,1610612755,Philadelphia 76ers,1,0,1610612739,Cleveland Cavaliers,0,1,31,30,61,7,17,24,38,47,85,17,6,23,14,37,22,5,14,95,100
2015,2,21501229,4/13/2016,1610612746,LA Clippers,0,0,1610612756,Phoenix Suns,1,1,34,31,65,9,22,31,43,53,96,10,2,12,12,42,23,10,15,106,105
2015,2,21501229,4/13/2016,1610612756,Phoenix Suns,1,1,1610612746,LA Clippers,0,0,38,35,73,7,19,26,45,54,99,17,5,22,21,36,26,9,17,104,114
2015,2,21501031,3/19/2016,1610612754,Indiana Pacers,1,0,1610612760,Oklahoma City Thunder,0,1,31,30,61,9,13,22,40,43,83,22,8,30,9,38,28,8,12,100,111
2015,2,21501031,3/19/2016,1610612760,Oklahoma City Thunder,0,1,1610612754,Indiana Pacers,1,0,32,20,52,10,18,28,42,38,80,21,5,26,12,29,26,11,18,100,115
2015,2,21500978,3/12/2016,1610612740,New Orleans Pelicans,0,0,1610612749,Milwaukee Bucks,1,1,29,31,60,6,23,29,35,54,89,16,5,21,16,41,19,11,16,101,92
2015,2,21500978,3/12/2016,1610612749,Milwaukee Bucks,1,1,1610612740,New Orleans Pelicans,0,0,36,32,68,4,9,13,40,41,81,19,5,24,6,37,22,7,14,99,103
2015,2,21500805,2/19/2016,1610612742,Dallas Mavericks,0,0,1610612753,Orlando Magic,1,1,18,30,48,19,22,41,37,52,89,11,7,18,7,50,23,10,18,108,104
2015,2,21500805,2/19/2016,1610612753,Orlando Magic,1,1,1610612742,Dallas Mavericks,0,0,28,39,67,13,22,35,41,61,102,15,2,17,16,46,25,8,12,108,110
2015,2,21500759,2/5/2016,1610612742,Dallas Mavericks,1,0,1610612759,San Antonio Spurs,0,1,30,28,58,3,12,15,33,40,73,21,6,27,8,37,17,6,15,94,90
2015,2,21500759,2/5/2016,1610612759,San Antonio Spurs,0,1,1610612742,Dallas Mavericks,1,0,29,29,58,12,10,22,41,39,80,22,3,25,9,31,19,7,14,95,116
2015,2,21500716,1/31/2016,1610612738,Boston Celtics,0,0,1610612753,Orlando Magic,1,1,23,24,47,16,30,46,39,54,93,20,5,25,17,40,17,7,11,100,114
2015,2,21500716,1/31/2016,1610612753,Orlando Magic,1,1,1610612738,Boston Celtics,0,0,34,24,58,10,14,24,44,38,82,21,14,35,13,31,27,9,15,99,119
2015,2,21500335,12/11/2015,1610612755,Philadelphia 76ers,1,0,1610612765,Detroit Pistons,0,1,30,32,62,6,12,18,36,44,80,17,7,24,15,32,22,9,21,97,95
2015,2,21500335,12/11/2015,1610612765,Detroit Pistons,0,1,1610612755,Philadelphia 76ers,1,0,33,33,66,10,17,27,43,50,93,11,5,16,19,33,18,5,14,98,107
2015,2,21500237,11/27/2015,1610612750,Minnesota Timberwolves,0,1,1610612758,Sacramento Kings,1,0,28,24,52,9,16,25,37,40,77,18,1,19,15,26,20,4,18,91,101
2015,2,21500237,11/27/2015,1610612758,Sacramento Kings,1,0,1610612750,Minnesota Timberwolves,0,1,29,35,64,8,14,22,37,49,86,9,6,15,16,36,21,4,15,91,91
2015,2,21501030,3/19/2016,1610612751,Brooklyn Nets,0,0,1610612765,Detroit Pistons,1,1,37,29,66,5,9,14,42,38,80,14,7,21,10,33,24,5,9,92,103
2015,2,21501030,3/19/2016,1610612765,Detroit Pistons,1,1,1610612751,Brooklyn Nets,0,0,36,34,70,10,14,24,46,48,94,13,8,21,19,34,30,3,8,92,115
2015,2,21500923,3/5/2016,1610612752,New York Knicks,1,1,1610612765,Detroit Pistons,0,0,38,25,63,4,12,16,42,37,79,14,4,18,10,28,19,6,11,90,102
2015,2,21500923,3/5/2016,1610612765,Detroit Pistons,0,0,1610612752,New York Knicks,1,1,30,36,66,6,20,26,36,56,92,11,4,15,19,39,13,4,9,90,89
2015,2,21500859,2/25/2016,1610612745,Houston Rockets,0,1,1610612757,Portland Trail Blazers,1,0,34,19,53,10,19,29,44,38,82,21,14,35,16,30,26,4,18,100,119
2015,2,21500859,2/25/2016,1610612757,Portland Trail Blazers,1,0,1610612745,Houston Rockets,0,1,24,21,45,13,22,35,37,43,80,18,4,22,13,34,22,14,21,101,105
2014,2,21400876,2/28/2015,1610612749,Milwaukee Bucks,0,0,1610612762,Utah Jazz,1,1,24,35,59,5,10,15,29,45,74,12,2,14,11,34,18,16,23,94,75
2014,2,21400876,2/28/2015,1610612762,Utah Jazz,1,1,1610612749,Milwaukee Bucks,0,0,23,31,54,6,16,22,29,47,76,18,5,23,18,31,18,15,23,94,82
2015,2,21500620,1/18/2016,1610612737,Atlanta Hawks,1,1,1610612753,Orlando Magic,0,0,32,29,61,9,10,19,41,39,80,7,3,10,8,32,31,11,17,95,98
2015,2,21500620,1/18/2016,1610612753,Orlando Magic,0,0,1610612737,Atlanta Hawks,1,1,24,41,65,6,16,22,30,57,87,15,5,20,15,44,21,9,13,95,81
2015,2,21500544,1/8/2016,1610612740,New Orleans Pelicans,1,0,1610612754,Indiana Pacers,0,1,22,32,54,9,20,29,31,52,83,15,5,20,11,42,21,7,16,98,86
2015,2,21500544,1/8/2016,1610612754,Indiana Pacers,0,1,1610612740,New Orleans Pelicans,1,0,31,29,60,5,16,21,36,45,81,14,5,19,17,31,21,21,25,99,91
2015,2,21500438,12/25/2015,1610612739,Cleveland Cavaliers,0,0,1610612744,Golden State Warriors,1,1,25,40,65,5,25,30,30,65,95,18,7,25,21,47,12,7,11,96,83
2015,2,21500438,12/25/2015,1610612744,Golden State Warriors,1,1,1610612739,Cleveland Cavaliers,0,0,27,33,60,5,13,18,32,46,78,20,7,27,11,39,21,6,16,97,89
2015,2,21500334,12/11/2015,1610612739,Cleveland Cavaliers,0,1,1610612753,Orlando Magic,1,0,30,21,51,11,10,21,41,31,72,18,9,27,11,25,28,8,19,92,111
2015,2,21500334,12/11/2015,1610612753,Orlando Magic,1,0,1610612739,Cleveland Cavaliers,0,1,22,28,50,6,16,22,28,44,72,14,6,20,9,38,16,12,20,93,76
2016,2,21600194,11/20/2016,1610612751,Brooklyn Nets,1,0,1610612757,Portland Trail Blazers,0,1,27,31,58,10,25,35,37,56,93,25,6,31,17,44,22,4,10,100,109
2016,2,21600194,11/20/2016,1610612757,Portland Trail Blazers,0,1,1610612751,Brooklyn Nets,1,0,34,15,49,15,21,36,49,36,85,16,5,21,10,28,23,5,15,99,129
2015,2,21500141,11/14/2015,1610612739,Cleveland Cavaliers,0,0,1610612749,Milwaukee Bucks,1,1,23,30,53,14,24,38,37,54,91,17,10,27,19,42,21,6,21,108,105
2015,2,21500141,11/14/2015,1610612749,Milwaukee Bucks,1,1,1610612739,Cleveland Cavaliers,0,0,37,49,86,6,10,16,43,59,102,16,6,22,19,42,20,6,13,107,108
2015,2,21500045,11/1/2015,1610612742,Dallas Mavericks,0,1,1610612747,Los Angeles Lakers,1,0,29,28,57,11,19,30,40,47,87,12,4,16,11,38,28,8,11,96,103
2015,2,21500045,11/1/2015,1610612747,Los Angeles Lakers,1,0,1610612742,Dallas Mavericks,0,1,21,30,51,10,24,34,31,54,85,21,7,28,13,43,18,5,12,97,93
2015,2,21501148,4/3/2016,1610612753,Orlando Magic,1,1,1610612763,Memphis Grizzlies,0,0,33,31,64,10,16,26,43,47,90,23,6,29,15,36,27,4,10,98,119
2015,2,21501148,4/3/2016,1610612763,Memphis Grizzlies,0,0,1610612753,Orlando Magic,1,1,33,35,68,8,13,21,41,48,89,17,9,26,19,33,22,10,14,98,107
2015,2,21501086,3/26/2016,1610612739,Cleveland Cavaliers,0,1,1610612752,New York Knicks,1,0,23,26,49,14,20,34,37,46,83,19,6,25,17,32,21,5,11,88,107
2015,2,21501086,3/26/2016,1610612752,New York Knicks,1,0,1610612739,Cleveland Cavaliers,0,1,25,31,56,8,15,23,33,46,79,19,9,28,12,39,20,6,8,88,93
2016,2,21600660,1/21/2017,1610612741,Chicago Bulls,1,1,1610612758,Sacramento Kings,0,0,28,38,66,6,11,17,34,49,83,28,5,33,19,32,22,7,11,90,102
2016,2,21600660,1/21/2017,1610612758,Sacramento Kings,0,0,1610612741,Chicago Bulls,1,1,28,30,58,9,17,26,37,47,84,16,5,21,14,36,20,7,10,91,99
2015,2,21500437,12/25/2015,1610612741,Chicago Bulls,0,1,1610612760,Oklahoma City Thunder,1,0,33,41,74,7,11,18,40,52,92,18,2,20,19,33,22,12,16,100,105
2015,2,21500437,12/25/2015,1610612760,Oklahoma City Thunder,1,0,1610612741,Chicago Bulls,0,1,31,41,72,6,18,24,37,59,96,16,7,23,21,42,20,8,14,98,96
2015,2,21500333,12/11/2015,1610612748,Miami Heat,0,0,1610612754,Indiana Pacers,1,1,30,31,61,5,15,20,35,46,81,8,5,13,9,39,14,13,19,99,83
2015,2,21500333,12/11/2015,1610612754,Indiana Pacers,1,1,1610612748,Miami Heat,0,0,30,28,58,6,22,28,36,50,86,18,2,20,9,42,22,6,12,98,96
2015,2,21500236,11/27/2015,1610612744,Golden State Warriors,0,1,1610612756,Phoenix Suns,1,0,24,19,43,22,16,38,46,35,81,21,10,31,15,24,32,13,24,108,135
2015,2,21500236,11/27/2015,1610612756,Phoenix Suns,1,0,1610612744,Golden State Warriors,0,1,35,31,66,10,16,26,45,47,92,16,7,23,9,44,21,7,14,106,116
2015,2,21500044,11/1/2015,1610612743,Denver Nuggets,0,0,1610612760,Oklahoma City Thunder,1,1,26,40,66,9,17,26,35,57,92,14,5,19,20,39,20,9,13,95,93
2015,2,21500044,11/1/2015,1610612760,Oklahoma City Thunder,1,1,1610612743,Denver Nuggets,0,0,32,29,61,13,12,25,45,41,86,14,4,18,19,24,32,8,19,94,117
2015,2,21501228,4/13/2016,1610612747,Los Angeles Lakers,1,1,1610612762,Utah Jazz,0,0,35,25,60,6,19,25,41,44,85,13,2,15,12,32,19,10,14,94,101
2015,2,21501228,4/13/2016,1610612762,Utah Jazz,0,0,1610612747,Los Angeles Lakers,1,1,30,23,53,9,21,30,39,44,83,9,6,15,9,39,27,6,14,93,96
2015,2,21500668,1/25/2016,1610612738,Boston Celtics,0,1,1610612764,Washington Wizards,1,0,35,33,68,9,13,22,44,46,90,19,4,23,8,39,31,5,11,102,116
2015,2,21500668,1/25/2016,1610612764,Washington Wizards,1,0,1610612738,Boston Celtics,0,1,25,26,51,7,17,24,32,43,75,20,10,30,9,37,24,12,20,104,91
2015,2,21500619,1/18/2016,1610612741,Chicago Bulls,0,1,1610612765,Detroit Pistons,1,0,35,28,63,9,12,21,44,40,84,14,6,20,9,34,28,8,10,93,111
2015,2,21500619,1/18/2016,1610612765,Detroit Pistons,1,0,1610612741,Chicago Bulls,0,1,37,32,69,5,21,26,42,53,95,12,8,20,24,34,18,6,11,93,101
2015,2,21500542,1/8/2016,1610612743,Denver Nuggets,0,0,1610612763,Memphis Grizzlies,1,1,28,40,68,4,15,19,32,55,87,16,3,19,24,33,19,10,18,91,84
2015,2,21500542,1/8/2016,1610612763,Memphis Grizzlies,1,1,1610612743,Denver Nuggets,0,0,22,42,64,8,10,18,30,52,82,23,7,30,15,42,14,2,8,91,91
2015,2,21500436,12/25/2015,1610612740,New Orleans Pelicans,0,0,1610612748,Miami Heat,1,1,30,40,70,6,14,20,36,54,90,10,1,11,7,47,19,10,19,105,88
2015,2,21500436,12/25/2015,1610612748,Miami Heat,1,1,1610612740,New Orleans Pelicans,0,0,29,33,62,6,20,26,35,53,88,18,9,27,14,43,19,10,18,105,94
2015,2,21500332,12/10/2015,1610612752,New York Knicks,0,0,1610612758,Sacramento Kings,1,1,24,30,54,9,20,29,33,50,83,22,6,28,16,36,17,6,19,101,97
2015,2,21500332,12/10/2015,1610612758,Sacramento Kings,1,1,1610612752,New York Knicks,0,0,39,38,77,3,13,16,42,51,93,12,4,16,11,42,24,9,12,101,99
2015,2,21500140,11/14/2015,1610612742,Dallas Mavericks,0,1,1610612745,Houston Rockets,1,0,35,26,61,8,20,28,43,46,89,16,5,21,12,35,24,9,11,98,110
2015,2,21500140,11/14/2015,1610612745,Houston Rockets,1,0,1610612742,Dallas Mavericks,0,1,23,27,50,9,25,34,32,52,84,25,7,32,16,41,22,6,14,97,98
2014,2,21400875,2/28/2015,1610612756,Phoenix Suns,1,0,1610612759,San Antonio Spurs,0,1,20,48,68,5,11,16,25,59,84,19,5,24,13,48,13,7,19,100,74
2014,2,21400875,2/28/2015,1610612759,San Antonio Spurs,0,1,1610612756,Phoenix Suns,1,0,37,36,73,4,15,19,41,51,92,15,2,17,15,40,18,7,14,99,101
2015,2,21500043,11/1/2015,1610612741,Chicago Bulls,1,1,1610612753,Orlando Magic,0,0,26,33,59,7,21,28,33,54,87,19,3,22,16,38,23,7,15,98,92
2015,2,21500043,11/1/2015,1610612753,Orlando Magic,0,0,1610612741,Chicago Bulls,1,1,28,39,67,7,16,23,35,55,90,10,7,17,19,38,21,7,17,98,87
2015,2,21501147,4/3/2016,1610612746,LA Clippers,1,1,1610612764,Washington Wizards,0,0,35,31,66,8,11,19,43,42,85,20,13,33,12,34,27,8,11,101,114
2015,2,21501147,4/3/2016,1610612764,Washington Wizards,0,0,1610612746,LA Clippers,1,1,32,32,64,11,19,30,43,51,94,12,9,21,19,36,31,9,14,102,109
2015,2,21500922,3/5/2016,1610612738,Boston Celtics,0,0,1610612739,Cleveland Cavaliers,1,1,27,30,57,10,13,23,37,43,80,19,8,27,14,34,17,8,14,95,103
2015,2,21500922,3/5/2016,1610612739,Cleveland Cavaliers,1,1,1610612738,Boston Celtics,0,0,32,20,52,10,20,30,42,40,82,26,8,34,17,27,27,8,15,95,120
2015,2,21500858,2/25/2016,1610612751,Brooklyn Nets,0,1,1610612756,Phoenix Suns,1,0,29,28,57,8,10,18,37,38,75,34,8,42,11,30,21,10,18,103,116
2015,2,21500858,2/25/2016,1610612756,Phoenix Suns,1,0,1610612751,Brooklyn Nets,0,1,33,38,71,9,18,27,42,56,98,13,10,23,26,36,16,12,21,104,106
2015,2,21500758,2/5/2016,1610612749,Milwaukee Bucks,0,0,1610612762,Utah Jazz,1,1,23,34,57,7,7,14,30,41,71,14,7,21,10,34,9,15,20,90,81
2015,2,21500758,2/5/2016,1610612762,Utah Jazz,1,1,1610612749,Milwaukee Bucks,0,0,22,28,50,8,19,27,30,47,77,16,7,23,15,36,13,12,17,90,84
2015,2,21500618,1/18/2016,1610612740,New Orleans Pelicans,0,0,1610612763,Memphis Grizzlies,1,1,30,25,55,6,13,19,36,38,74,21,2,23,9,30,19,9,15,90,99
2015,2,21500618,1/18/2016,1610612763,Memphis Grizzlies,1,1,1610612740,New Orleans Pelicans,0,0,27,29,56,8,11,19,35,40,75,23,7,30,12,31,27,8,11,89,101
2015,2,21500435,12/23/2015,1610612747,Los Angeles Lakers,1,0,1610612760,Oklahoma City Thunder,0,1,25,39,64,7,18,25,32,57,89,14,8,22,18,44,19,7,12,95,85
2015,2,21500435,12/23/2015,1610612760,Oklahoma City Thunder,0,1,1610612747,Los Angeles Lakers,1,0,46,30,76,5,14,19,51,44,95,13,4,17,23,24,23,6,17,94,120
2015,2,21500331,12/10/2015,1610612737,Atlanta Hawks,0,0,1610612760,Oklahoma City Thunder,1,1,25,25,50,10,18,28,35,43,78,14,9,23,5,44,21,6,10,94,94
2015,2,21500331,12/10/2015,1610612760,Oklahoma City Thunder,1,1,1610612737,Atlanta Hawks,0,0,30,33,63,9,8,17,39,41,80,20,6,26,14,30,24,9,14,95,107
2015,2,21500235,11/27/2015,1610612743,Denver Nuggets,1,0,1610612759,San Antonio Spurs,0,1,24,33,57,7,13,20,31,46,77,11,2,13,10,37,17,11,18,91,80
2015,2,21500235,11/27/2015,1610612759,San Antonio Spurs,0,1,1610612743,Denver Nuggets,1,0,28,25,53,8,14,22,36,39,75,11,3,14,9,32,22,8,19,92,91
2015,2,21500042,11/1/2015,1610612749,Milwaukee Bucks,0,0,1610612761,Toronto Raptors,1,1,24,26,50,5,14,19,29,40,69,24,0,24,9,31,21,12,18,90,87
2015,2,21500042,11/1/2015,1610612761,Toronto Raptors,1,1,1610612749,Milwaukee Bucks,0,0,30,35,65,11,14,25,41,49,90,13,7,20,24,28,22,6,14,90,106
2016,2,21600659,1/21/2017,1610612754,Indiana Pacers,0,0,1610612762,Utah Jazz,1,1,29,28,57,10,10,20,39,38,77,12,5,17,6,34,17,11,17,95,100
2016,2,21600659,1/21/2017,1610612762,Utah Jazz,1,1,1610612754,Indiana Pacers,0,0,33,27,60,6,18,24,39,45,84,25,7,32,17,32,24,10,14,96,109
2016,2,21600193,11/20/2016,1610612737,Atlanta Hawks,0,0,1610612752,New York Knicks,1,1,28,36,64,6,15,21,34,51,85,20,9,29,16,41,17,8,13,95,94
2016,2,21600193,11/20/2016,1610612752,New York Knicks,1,1,1610612737,Atlanta Hawks,0,0,32,29,61,10,17,27,42,46,88,10,4,14,13,35,21,7,15,95,104
2014,2,21400874,2/28/2015,1610612742,Dallas Mavericks,1,0,1610612751,Brooklyn Nets,0,1,26,28,54,9,19,28,35,47,82,15,3,18,10,38,23,5,13,94,94
2014,2,21400874,2/28/2015,1610612751,Brooklyn Nets,0,1,1610612742,Dallas Mavericks,1,0,30,24,54,10,13,23,40,37,77,14,9,23,12,30,20,10,15,92,104
2014,2,21400873,2/28/2015,1610612750,Minnesota Timberwolves,1,0,1610612763,Memphis Grizzlies,0,1,27,42,69,7,12,19,34,54,88,22,5,27,19,38,22,7,12,93,97
2014,2,21400873,2/28/2015,1610612763,Memphis Grizzlies,0,1,1610612750,Minnesota Timberwolves,1,0,34,19,53,4,7,11,38,26,64,21,8,29,8,22,21,12,24,93,101
2023,2,22300416,12/27/2023,1610612764,Washington Wizards,1,0,1610612761,Toronto Raptors,0,1,34,23,57,8,25,33,42,48,90,10,5,15,12,39,25,12,17,102,102
2023,2,22300420,12/27/2023,1610612742,Dallas Mavericks,1,0,1610612739,Cleveland Cavaliers,0,1,29,22,51,10,27,37,39,49,88,22,4,26,10,41,21,7,10,99,110
2023,2,22300504,1/7/2024,1610612744,Golden State Warriors,1,0,1610612761,Toronto Raptors,0,1,31,23,54,14,32,46,45,55,100,14,1,15,20,36,30,7,11,97,118
2016,2,21600658,1/21/2017,1610612743,Denver Nuggets,1,1,1610612746,LA Clippers,0,0,36,27,63,10,14,24,46,41,87,21,5,26,15,29,30,5,10,94,123
2016,2,21600658,1/21/2017,1610612746,LA Clippers,0,0,1610612743,Denver Nuggets,1,1,30,34,64,10,22,32,40,56,96,8,0,8,15,41,23,4,9,94,98
2016,2,21600192,11/19/2016,1610612741,Chicago Bulls,0,0,1610612746,LA Clippers,1,1,24,23,47,9,21,30,33,44,77,20,4,24,15,30,17,6,14,87,95
2016,2,21600192,11/19/2016,1610612746,LA Clippers,1,1,1610612741,Chicago Bulls,0,0,25,25,50,11,16,27,36,41,77,19,4,23,13,29,20,7,13,87,102
2023,2,22300460,1/2/2024,1610612759,San Antonio Spurs,0,0,1610612763,Memphis Grizzlies,1,1,26,28,54,10,21,31,36,49,85,16,7,23,14,39,21,5,16,98,98
2023,2,22300441,12/30/2023,1610612754,Indiana Pacers,1,1,1610612752,New York Knicks,0,0,27,15,42,23,20,43,50,35,85,17,4,21,9,29,40,12,16,101,140
2022,2,22201189,4/5/2023,1610612765,Detroit Pistons,1,0,1610612751,Brooklyn Nets,0,1,28,28,56,13,15,28,41,43,84,13,1,14,13,30,27,6,14,93,108
2023,2,22300785,2/14/2024,1610612759,San Antonio Spurs,0,0,1610612742,Dallas Mavericks,1,1,26,34,60,10,30,40,36,64,100,11,4,15,16,49,29,6,12,102,93
2023,2,22300418,12/27/2023,1610612745,Houston Rockets,1,0,1610612756,Phoenix Suns,0,1,23,32,55,17,24,41,40,56,96,16,6,22,17,39,20,4,10,100,113
2023,2,22300561,1/15/2024,1610612741,Chicago Bulls,0,0,1610612739,Cleveland Cavaliers,1,1,26,25,51,9,23,32,35,48,83,12,4,16,11,40,21,9,19,99,91
2019,2,21900311,12/4/2019,1610612741,Chicago Bulls,1,1,1610612763,Memphis Grizzlies,0,0,20,24,44,13,20,33,33,44,77,27,10,37,12,37,22,14,21,101,106
2019,2,21900311,12/4/2019,1610612763,Memphis Grizzlies,0,0,1610612741,Chicago Bulls,1,1,30,36,66,7,23,30,37,59,96,18,3,21,19,41,24,5,14,100,99
2020,2,22000948,4/29/2021,1610612743,Denver Nuggets,1,1,1610612761,Toronto Raptors,0,0,32,26,58,12,23,35,44,49,93,21,5,26,18,34,22,10,11,98,121
2020,2,22000948,4/29/2021,1610612761,Toronto Raptors,0,0,1610612743,Denver Nuggets,1,1,24,27,51,16,16,32,40,43,83,15,3,18,10,35,27,6,16,98,111
2021,2,22100275,11/24/2021,1610612740,New Orleans Pelicans,1,1,1610612764,Washington Wizards,0,0,32,35,67,12,17,29,44,52,96,27,5,32,15,39,33,5,11,107,127
2023,2,22300338,12/16/2023,1610612754,Indiana Pacers,0,0,1610612750,Minnesota Timberwolves,1,1,39,30,69,6,15,21,45,45,90,13,3,16,15,30,25,10,15,98,109
2021,2,22100275,11/24/2021,1610612764,Washington Wizards,0,0,1610612740,New Orleans Pelicans,1,1,29,24,53,7,24,31,36,48,84,23,13,36,14,40,23,13,19,105,102
2020,2,22000069,1/1/2021,1610612763,Memphis Grizzlies,0,1,1610612766,Charlotte Hornets,1,0,29,22,51,14,25,39,43,47,90,8,2,10,14,35,34,9,17,99,108
2020,2,22000069,1/1/2021,1610612766,Charlotte Hornets,1,0,1610612763,Memphis Grizzlies,0,1,26,29,55,9,22,31,35,51,86,14,7,21,14,41,23,10,19,100,93
2023,2,22300416,12/27/2023,1610612761,Toronto Raptors,0,1,1610612764,Washington Wizards,1,0,37,16,53,15,23,38,52,39,91,13,6,19,17,27,43,11,20,101,132
2016,2,21601230,4/12/2017,1610612740,New Orleans Pelicans,0,1,1610612757,Portland Trail Blazers,1,0,32,34,66,8,16,24,40,50,90,15,6,21,13,41,20,4,11,97,103
2023,2,22300420,12/27/2023,1610612739,Cleveland Cavaliers,0,1,1610612742,Dallas Mavericks,1,0,23,26,49,17,26,43,40,52,92,16,7,23,22,33,33,12,16,99,113
2023,2,22300444,12/30/2023,1610612744,Golden State Warriors,1,0,1610612742,Dallas Mavericks,0,1,28,27,55,19,29,48,47,56,103,9,4,13,20,38,32,5,11,99,122
2023,2,22300445,12/31/2023,1610612737,Atlanta Hawks,0,1,1610612764,Washington Wizards,1,0,35,28,63,12,20,32,47,48,95,24,13,37,15,37,27,5,12,107,130
2023,2,22300601,1/21/2024,1610612753,Orlando Magic,1,1,1610612748,Miami Heat,0,0,28,22,50,9,19,28,37,41,78,22,6,28,16,26,21,9,14,90,105
2020,2,22000068,12/31/2020,1610612756,Phoenix Suns,0,1,1610612762,Utah Jazz,1,0,24,27,51,17,16,33,41,43,84,7,3,10,8,36,26,8,14,95,106
2020,2,22000068,12/31/2020,1610612762,Utah Jazz,1,0,1610612756,Phoenix Suns,0,1,23,27,50,12,22,34,35,49,84,13,6,19,12,39,16,5,15,95,95
2016,2,21601230,4/12/2017,1610612757,Portland Trail Blazers,1,0,1610612740,New Orleans Pelicans,0,1,28,27,55,13,17,30,41,44,85,5,8,13,17,32,22,13,25,98,100
2019,2,21900082,11/2/2019,1610612749,Milwaukee Bucks,1,1,1610612761,Toronto Raptors,0,0,28,23,51,13,25,38,41,48,89,20,5,25,13,38,30,5,12,99,115
2019,2,21900082,11/2/2019,1610612761,Toronto Raptors,0,0,1610612749,Milwaukee Bucks,1,1,19,29,48,15,21,36,34,50,84,22,3,25,10,42,24,4,14,100,105
2016,2,21600657,1/21/2017,1610612739,Cleveland Cavaliers,1,0,1610612759,San Antonio Spurs,0,1,32,25,57,13,21,34,45,46,91,12,10,22,14,36,25,6,18,106,115
2020,2,22000947,4/29/2021,1610612740,New Orleans Pelicans,0,1,1610612760,Oklahoma City Thunder,1,0,40,32,72,5,24,29,45,56,101,14,5,19,17,42,26,6,12,106,109
2020,2,22000947,4/29/2021,1610612760,Oklahoma City Thunder,1,0,1610612740,New Orleans Pelicans,0,1,23,27,50,11,28,39,34,55,89,16,4,20,14,43,18,11,22,107,95
2016,2,21600657,1/21/2017,1610612759,San Antonio Spurs,0,1,1610612739,Cleveland Cavaliers,1,0,38,32,70,10,16,26,48,48,96,12,2,14,12,37,32,7,14,106,118
2016,2,21600191,11/19/2016,1610612744,Golden State Warriors,0,1,1610612749,Milwaukee Bucks,1,0,28,29,57,14,24,38,42,53,95,26,6,32,23,34,30,7,12,99,124
2016,2,21600191,11/19/2016,1610612749,Milwaukee Bucks,1,0,1610612744,Golden State Warriors,0,1,36,33,69,10,10,20,46,43,89,19,6,25,15,30,27,8,13,100,121
2014,2,21400872,2/28/2015,1610612752,New York Knicks,1,1,1610612761,Toronto Raptors,0,0,26,30,56,7,12,19,33,42,75,30,8,38,11,34,21,7,13,94,103
2014,2,21400872,2/28/2015,1610612761,Toronto Raptors,0,0,1610612752,New York Knicks,1,1,26,26,52,8,21,29,34,47,81,22,6,28,13,36,16,8,12,94,98
2018,2,21800918,2/27/2019,1610612742,Dallas Mavericks,1,1,1610612754,Indiana Pacers,0,0,24,20,44,16,21,37,40,41,81,14,9,23,12,35,27,10,17,94,110
2018,2,21800918,2/27/2019,1610612754,Indiana Pacers,0,0,1610612742,Dallas Mavericks,1,1,27,22,49,10,18,28,37,40,77,17,4,21,8,34,19,11,15,94,101
2022,2,22200210,11/15/2022,1610612751,Brooklyn Nets,0,0,1610612758,Sacramento Kings,1,1,29,24,53,11,17,28,40,41,81,30,3,33,5,36,25,9,17,108,121
2023,2,22300633,1/25/2024,1610612741,Chicago Bulls,0,0,1610612747,Los Angeles Lakers,1,1,35,16,51,12,25,37,47,41,88,26,3,29,16,27,27,10,17,102,132
2023,2,22300430,12/29/2023,1610612764,Washington Wizards,1,1,1610612751,Brooklyn Nets,0,0,31,22,53,15,23,38,46,45,91,3,4,7,9,38,28,5,7,93,110
2023,2,22300418,12/27/2023,1610612756,Phoenix Suns,0,1,1610612745,Houston Rockets,1,0,33,16,49,14,19,33,47,35,82,21,5,26,13,25,28,11,19,99,129
2023,2,22300437,12/29/2023,1610612757,Portland Trail Blazers,1,1,1610612759,San Antonio Spurs,0,0,32,36,68,16,11,27,48,47,95,22,5,27,19,30,28,9,14,103,134
2023,2,22300443,12/30/2023,1610612750,Minnesota Timberwolves,1,1,1610612747,Los Angeles Lakers,0,0,26,16,42,12,22,34,38,38,76,20,4,24,8,31,24,12,19,98,108
2023,2,22300601,1/21/2024,1610612748,Miami Heat,0,0,1610612753,Orlando Magic,1,1,18,25,43,12,25,37,30,50,80,15,3,18,16,35,22,5,18,90,87
2021,2,22100274,11/24/2021,1610612748,Miami Heat,0,0,1610612750,Minnesota Timberwolves,1,1,18,14,32,15,27,42,33,41,74,20,9,29,7,40,25,10,21,103,101
2021,2,22100274,11/24/2021,1610612750,Minnesota Timberwolves,1,1,1610612748,Miami Heat,0,0,20,18,38,18,37,55,38,55,93,19,2,21,17,38,24,6,18,103,113
2020,2,22000067,12/31/2020,1610612740,New Orleans Pelicans,0,1,1610612760,Oklahoma City Thunder,1,0,31,24,55,13,23,36,44,47,91,12,7,19,16,34,23,6,13,96,113
2020,2,22000067,12/31/2020,1610612760,Oklahoma City Thunder,1,0,1610612740,New Orleans Pelicans,0,1,15,17,32,15,33,48,30,50,80,5,10,15,9,45,24,9,19,97,80
2020,2,22000066,12/31/2020,1610612752,New York Knicks,0,0,1610612761,Toronto Raptors,1,1,29,23,52,3,33,36,32,56,88,16,4,20,13,47,21,7,16,100,83
2023,2,22300441,12/30/2023,1610612752,New York Knicks,0,0,1610612754,Indiana Pacers,1,1,28,30,58,17,20,37,45,50,95,19,8,27,20,30,24,6,14,102,126
2023,2,22300563,1/15/2024,1610612738,Boston Celtics,0,1,1610612761,Toronto Raptors,1,0,17,26,43,16,23,39,33,49,82,23,2,25,5,46,20,6,13,100,105
2020,2,22000066,12/31/2020,1610612761,Toronto Raptors,1,1,1610612752,New York Knicks,0,0,17,14,31,17,35,52,34,49,83,15,6,21,11,42,21,6,18,99,100
2020,2,22000946,4/29/2021,1610612744,Golden State Warriors,0,0,1610612750,Minnesota Timberwolves,1,1,27,20,47,15,23,38,42,43,85,15,6,21,5,42,28,5,10,100,114
2020,2,22000946,4/29/2021,1610612750,Minnesota Timberwolves,1,1,1610612744,Golden State Warriors,0,0,23,30,53,20,21,41,43,51,94,20,9,29,22,34,31,10,14,100,126
2018,2,21801202,4/7/2019,1610612737,Atlanta Hawks,0,0,1610612749,Milwaukee Bucks,1,1,23,32,55,17,28,45,40,60,100,10,9,19,12,52,25,8,11,107,107
2023,2,22300429,12/29/2023,1610612753,Orlando Magic,1,1,1610612752,New York Knicks,0,0,33,23,56,7,26,33,40,49,89,30,10,40,19,35,24,8,15,104,117
2021,2,22100273,11/24/2021,1610612749,Milwaukee Bucks,1,1,1610612765,Detroit Pistons,0,0,27,24,51,15,21,36,42,45,87,15,2,17,12,35,23,7,16,99,114
2021,2,22100273,11/24/2021,1610612765,Detroit Pistons,0,0,1610612749,Milwaukee Bucks,1,1,23,27,50,11,34,45,34,61,95,14,5,19,12,51,16,5,9,101,93
2023,2,22301229,12/7/2023,1610612749,Milwaukee Bucks,1,0,1610612754,Indiana Pacers,0,1,31,32,63,12,21,33,43,53,96,21,7,28,18,39,19,9,12,105,119
2023,2,22300473,1/3/2024,1610612746,LA Clippers,0,1,1610612756,Phoenix Suns,1,0,24,18,42,18,16,34,42,34,76,29,3,32,13,22,25,9,14,94,131
2023,2,22300444,12/30/2023,1610612742,Dallas Mavericks,0,1,1610612744,Golden State Warriors,1,0,33,15,48,16,24,40,49,39,88,18,4,22,8,32,25,8,9,98,132
2023,2,22300602,1/21/2024,1610612743,Denver Nuggets,0,1,1610612764,Washington Wizards,1,0,35,31,66,8,14,22,43,45,88,19,9,28,17,33,29,6,14,97,113
2020,2,22000065,12/31/2020,1610612745,Houston Rockets,1,1,1610612758,Sacramento Kings,0,0,32,18,50,13,23,36,45,41,86,19,6,25,10,35,26,11,18,105,122
2020,2,22000065,12/31/2020,1610612758,Sacramento Kings,0,0,1610612745,Houston Rockets,1,1,34,29,63,11,22,33,45,51,96,18,6,24,16,39,23,10,15,106,119
2019,2,21900310,12/4/2019,1610612738,Boston Celtics,1,1,1610612748,Miami Heat,0,0,19,19,38,16,25,41,35,44,79,26,6,32,13,35,21,7,11,95,112
2019,2,21900310,12/4/2019,1610612748,Miami Heat,0,0,1610612738,Boston Celtics,1,1,20,19,39,14,24,38,34,43,77,11,6,17,10,37,20,8,19,93,93
2023,2,22300438,12/29/2023,1610612763,Memphis Grizzlies,0,0,1610612746,LA Clippers,1,1,25,22,47,13,27,40,38,49,87,17,3,20,8,43,29,3,12,99,106
2022,2,22200553,1/2/2023,1610612754,Indiana Pacers,1,1,1610612761,Toronto Raptors,0,0,35,31,66,10,17,27,45,48,93,22,4,26,21,27,24,5,13,97,122
2022,2,22200553,1/2/2023,1610612761,Toronto Raptors,0,0,1610612754,Indiana Pacers,1,1,27,22,49,14,28,42,41,50,91,18,5,23,14,40,26,4,11,97,114
2023,2,22300480,1/5/2024,1610612754,Indiana Pacers,1,1,1610612737,Atlanta Hawks,0,0,41,14,55,19,20,39,60,34,94,11,2,13,10,25,50,6,16,106,150
2023,2,22300197,11/15/2023,1610612756,Phoenix Suns,1,1,1610612750,Minnesota Timberwolves,0,0,34,20,54,17,14,31,51,34,85,14,1,15,8,26,31,8,9,90,133
2023,2,22300438,12/29/2023,1610612746,LA Clippers,1,1,1610612763,Memphis Grizzlies,0,0,32,16,48,11,28,39,43,44,87,20,5,25,15,31,28,10,18,101,117
2023,2,22300435,12/29/2023,1610612743,Denver Nuggets,1,0,1610612760,Oklahoma City Thunder,0,1,26,22,48,10,27,37,36,49,85,11,4,15,10,42,30,10,17,100,93
2021,2,22100272,11/24/2021,1610612761,Toronto Raptors,0,1,1610612763,Memphis Grizzlies,1,0,33,26,59,14,16,30,47,42,89,18,3,21,16,29,25,6,10,93,126
2021,2,22100272,11/24/2021,1610612763,Memphis Grizzlies,1,0,1610612761,Toronto Raptors,0,1,33,20,53,9,20,29,42,40,82,20,6,26,14,28,25,8,15,94,113
2020,2,22000945,4/29/2021,1610612745,Houston Rockets,1,1,1610612749,Milwaukee Bucks,0,0,24,28,52,25,21,46,49,49,98,20,4,24,19,32,23,12,18,109,143
2020,2,22000945,4/29/2021,1610612749,Milwaukee Bucks,0,0,1610612745,Houston Rockets,1,1,33,21,54,16,23,39,49,44,93,22,3,25,10,36,27,6,14,108,136
2023,2,22300555,1/15/2024,1610612745,Houston Rockets,0,0,1610612755,Philadelphia 76ers,1,1,36,25,61,8,19,27,44,44,88,19,13,32,19,34,21,8,13,95,115
2023,2,22300507,1/8/2024,1610612738,Boston Celtics,0,0,1610612754,Indiana Pacers,1,1,30,25,55,17,18,35,47,43,90,20,9,29,16,32,26,6,14,101,131
2021,2,22100271,11/24/2021,1610612741,Chicago Bulls,0,0,1610612745,Houston Rockets,1,1,29,32,61,15,20,35,44,52,96,10,2,12,9,44,26,5,14,106,113
2021,2,22100271,11/24/2021,1610612745,Houston Rockets,1,1,1610612741,Chicago Bulls,0,0,25,23,48,17,19,36,42,42,84,17,5,22,10,34,27,12,22,107,118
2020,2,22000064,12/31/2020,1610612753,Orlando Magic,1,0,1610612755,Philadelphia 76ers,0,1,26,41,67,7,21,28,33,62,95,19,2,21,13,50,17,7,11,102,92
2020,2,22000064,12/31/2020,1610612755,Philadelphia 76ers,0,1,1610612753,Orlando Magic,1,0,29,29,58,15,18,33,44,47,91,13,2,15,10,38,23,2,15,103,116
2023,2,22300081,10/27/2023,1610612739,Cleveland Cavaliers,1,0,1610612760,Oklahoma City Thunder,0,1,26,21,47,12,33,45,38,54,92,17,6,23,12,45,20,8,14,105,105
2023,2,22300081,10/27/2023,1610612760,Oklahoma City Thunder,0,1,1610612739,Cleveland Cavaliers,1,0,27,34,61,13,13,26,40,47,87,15,4,19,9,40,22,10,18,105,108
2019,2,21900309,12/4/2019,1610612737,Atlanta Hawks,1,0,1610612751,Brooklyn Nets,0,1,39,25,64,9,17,26,48,42,90,13,8,21,13,36,24,8,16,100,118
2019,2,21900309,12/4/2019,1610612751,Brooklyn Nets,0,1,1610612737,Atlanta Hawks,1,0,36,34,70,14,17,31,50,51,101,16,2,18,23,29,26,8,15,101,130
2020,2,22000944,4/29/2021,1610612751,Brooklyn Nets,0,1,1610612754,Indiana Pacers,1,0,35,19,54,12,23,35,47,42,89,24,4,28,11,32,35,8,14,104,130
2020,2,22000944,4/29/2021,1610612754,Indiana Pacers,1,0,1610612751,Brooklyn Nets,0,1,30,27,57,11,28,39,41,55,96,20,1,21,12,43,23,3,10,103,113
2021,2,22100270,11/24/2021,1610612738,Boston Celtics,1,0,1610612751,Brooklyn Nets,0,1,23,20,43,11,37,48,34,57,91,25,3,28,17,42,25,8,11,98,104
2021,2,22100270,11/24/2021,1610612751,Brooklyn Nets,0,1,1610612738,Boston Celtics,1,0,29,21,50,14,21,35,43,42,85,23,7,30,13,32,29,6,10,96,123
2020,2,22000063,12/31/2020,1610612741,Chicago Bulls,0,1,1610612764,Washington Wizards,1,0,36,20,56,14,22,36,50,42,92,19,6,25,15,30,34,8,17,104,133
2020,2,22000063,12/31/2020,1610612764,Washington Wizards,1,0,1610612741,Chicago Bulls,0,1,28,27,55,14,15,29,42,42,84,32,9,41,13,36,27,9,14,103,130
2016,2,21601229,4/12/2017,1610612744,Golden State Warriors,1,1,1610612747,Los Angeles Lakers,0,0,29,25,54,12,24,36,41,49,90,15,7,22,19,34,26,13,21,105,109
2016,2,21601229,4/12/2017,1610612747,Los Angeles Lakers,0,0,1610612744,Golden State Warriors,1,1,37,39,76,4,13,17,41,52,93,8,6,14,12,43,23,14,18,105,94
2019,2,21900081,11/2/2019,1610612756,Phoenix Suns,0,1,1610612763,Memphis Grizzlies,1,0,30,24,54,14,20,34,44,44,88,12,4,16,11,35,26,9,17,101,114
2019,2,21900081,11/2/2019,1610612763,Memphis Grizzlies,1,0,1610612756,Phoenix Suns,0,1,33,25,58,9,19,28,42,44,86,12,7,19,15,32,26,9,20,102,105
2016,2,21600656,1/21/2017,1610612745,Houston Rockets,0,1,1610612763,Memphis Grizzlies,1,0,25,13,38,16,26,42,41,39,80,21,4,25,9,31,27,10,13,95,119
2021,2,22100269,11/24/2021,1610612753,Orlando Magic,1,0,1610612766,Charlotte Hornets,0,1,23,28,51,15,27,42,38,55,93,8,2,10,15,40,23,11,15,98,99
2021,2,22100269,11/24/2021,1610612766,Charlotte Hornets,0,1,1610612753,Orlando Magic,1,0,27,26,53,12,28,40,39,54,93,16,5,21,13,43,26,5,10,97,106
2020,2,22000062,12/31/2020,1610612739,Cleveland Cavaliers,0,0,1610612754,Indiana Pacers,1,1,25,34,59,12,11,23,37,45,82,13,11,24,14,36,22,12,18,98,99
2020,2,22000062,12/31/2020,1610612754,Indiana Pacers,1,1,1610612739,Cleveland Cavaliers,0,0,26,26,52,16,19,35,42,45,87,19,5,24,12,35,28,5,14,99,119
2020,2,22000943,4/29/2021,1610612742,Dallas Mavericks,0,1,1610612765,Detroit Pistons,1,0,27,32,59,13,17,30,40,49,89,22,1,23,12,37,22,7,12,99,115
2020,2,22000943,4/29/2021,1610612765,Detroit Pistons,1,0,1610612742,Dallas Mavericks,0,1,26,16,42,10,19,29,36,35,71,23,11,34,6,32,26,6,18,99,105
2016,2,21601228,4/12/2017,1610612746,LA Clippers,1,1,1610612758,Sacramento Kings,0,0,33,22,55,10,18,28,43,40,83,19,6,25,12,30,29,2,6,87,115
2016,2,21601228,4/12/2017,1610612758,Sacramento Kings,0,0,1610612746,LA Clippers,1,1,35,35,70,5,6,11,40,41,81,10,4,14,10,34,27,4,11,89,95
2016,2,21600656,1/21/2017,1610612763,Memphis Grizzlies,1,0,1610612745,Houston Rockets,0,1,24,31,55,9,25,34,33,56,89,20,8,28,16,44,19,11,12,97,95
2016,2,21600190,11/19/2016,1610612750,Minnesota Timberwolves,0,0,1610612763,Memphis Grizzlies,1,1,18,24,42,7,15,22,25,39,64,14,8,22,7,38,16,8,19,87,71
2023,2,22300367,12/20/2023,1610612750,Minnesota Timberwolves,0,0,1610612755,Philadelphia 76ers,1,1,33,24,57,9,16,25,42,40,82,20,4,24,10,32,22,9,19,99,113
2023,2,22300338,12/16/2023,1610612750,Minnesota Timberwolves,1,1,1610612754,Indiana Pacers,0,0,30,26,56,18,12,30,48,38,86,13,3,16,10,30,33,10,15,98,127
2023,2,22301229,12/7/2023,1610612754,Indiana Pacers,0,1,1610612749,Milwaukee Bucks,1,0,43,26,69,7,26,33,50,52,102,21,4,25,19,37,30,3,10,104,128
2023,2,22300474,1/3/2024,1610612762,Utah Jazz,1,1,1610612765,Detroit Pistons,0,0,37,34,71,16,16,32,53,50,103,32,3,35,20,32,28,5,12,112,154
2021,2,22100268,11/24/2021,1610612747,Los Angeles Lakers,0,1,1610612754,Indiana Pacers,1,0,27,31,58,15,22,37,42,53,95,25,4,29,13,43,20,3,12,108,124
2021,2,22100268,11/24/2021,1610612754,Indiana Pacers,1,0,1610612747,Los Angeles Lakers,0,1,29,29,58,13,33,46,42,62,104,19,5,24,16,49,25,5,11,108,116
2023,2,22300430,12/29/2023,1610612751,Brooklyn Nets,0,0,1610612764,Washington Wizards,1,1,30,33,63,9,19,28,39,52,91,17,10,27,21,37,24,5,10,92,104
2020,2,22000061,12/30/2020,1610612746,LA Clippers,1,1,1610612757,Portland Trail Blazers,0,0,29,28,57,18,20,38,47,48,95,16,6,22,14,36,30,5,11,103,128
2020,2,22000061,12/30/2020,1610612757,Portland Trail Blazers,0,0,1610612746,LA Clippers,1,1,20,18,38,12,26,38,32,44,76,29,5,34,9,37,14,13,19,102,105
2023,2,22300563,1/15/2024,1610612761,Toronto Raptors,1,0,1610612738,Boston Celtics,0,1,34,29,63,4,28,32,38,57,95,16,5,21,13,48,25,3,7,99,96
2023,2,22300510,1/8/2024,1610612762,Utah Jazz,0,1,1610612749,Milwaukee Bucks,1,0,27,19,46,20,24,44,47,43,90,18,4,22,13,30,33,6,11,99,132
2023,2,22300509,1/8/2024,1610612745,Houston Rockets,0,0,1610612748,Miami Heat,1,1,23,24,47,14,27,41,37,51,88,25,3,28,16,36,20,6,12,97,113
2021,2,22100267,11/24/2021,1610612739,Cleveland Cavaliers,1,0,1610612756,Phoenix Suns,0,1,31,27,58,12,27,39,43,54,97,17,8,25,17,40,22,4,10,103,115
2021,2,22100267,11/24/2021,1610612756,Phoenix Suns,0,1,1610612739,Cleveland Cavaliers,1,0,37,27,64,8,14,22,45,41,86,22,6,28,13,32,26,7,15,103,120
2020,2,22000060,12/30/2020,1610612747,Los Angeles Lakers,0,1,1610612759,San Antonio Spurs,1,0,32,24,56,14,12,26,46,36,82,15,5,20,7,32,25,8,17,102,121
2020,2,22000060,12/30/2020,1610612759,San Antonio Spurs,1,0,1610612747,Los Angeles Lakers,0,1,30,33,63,10,14,24,40,47,87,17,6,23,10,40,25,4,11,102,107
2019,2,21900308,12/4/2019,1610612753,Orlando Magic,1,1,1610612756,Phoenix Suns,0,0,35,25,60,14,11,25,49,36,85,16,4,20,14,23,27,10,19,97,128
2019,2,21900308,12/4/2019,1610612756,Phoenix Suns,0,0,1610612753,Orlando Magic,1,1,28,27,55,15,18,33,43,45,88,13,7,20,14,36,36,9,13,97,114
2020,2,22000942,4/28/2021,1610612758,Sacramento Kings,1,0,1610612762,Utah Jazz,0,1,35,31,66,7,14,21,42,45,87,14,3,17,8,40,24,4,13,99,105
2020,2,22000942,4/28/2021,1610612762,Utah Jazz,0,1,1610612758,Sacramento Kings,1,0,31,14,45,24,17,41,55,31,86,20,1,21,10,22,36,8,14,99,154
2016,2,21601227,4/12/2017,1610612759,San Antonio Spurs,0,0,1610612762,Utah Jazz,1,1,31,34,65,8,13,21,39,47,86,11,2,13,17,31,16,10,15,90,97
2023,2,22300529,1/11/2024,1610612757,Portland Trail Blazers,0,0,1610612760,Oklahoma City Thunder,1,1,17,35,52,11,38,49,28,73,101,10,6,16,19,55,16,6,10,101,77
2023,2,22300070,10/25/2023,1610612741,Chicago Bulls,1,0,1610612760,Oklahoma City Thunder,0,1,27,25,52,12,30,42,39,55,94,14,4,18,17,39,26,6,13,100,104
2023,2,22300511,1/8/2024,1610612746,LA Clippers,1,1,1610612756,Phoenix Suns,0,0,38,18,56,15,14,29,53,32,85,17,6,23,14,22,32,6,14,96,138
2023,2,22300482,1/5/2024,1610612739,Cleveland Cavaliers,1,1,1610612764,Washington Wizards,0,0,25,19,44,16,17,33,41,36,77,16,7,23,16,26,31,12,24,96,114
2023,2,22300310,12/13/2023,1610612765,Detroit Pistons,1,0,1610612755,Philadelphia 76ers,0,1,29,26,55,10,23,33,39,49,88,23,7,30,11,43,24,6,10,103,111
2023,2,22300436,12/29/2023,1610612756,Phoenix Suns,1,1,1610612766,Charlotte Hornets,0,0,28,16,44,18,12,30,46,28,74,23,1,24,9,20,34,5,15,92,133
2021,2,22100266,11/23/2021,1610612742,Dallas Mavericks,0,1,1610612746,LA Clippers,1,0,27,23,50,12,27,39,39,50,89,22,5,27,16,35,22,5,15,100,112
2021,2,22100266,11/23/2021,1610612746,LA Clippers,1,0,1610612742,Dallas Mavericks,0,1,25,28,53,10,22,32,35,50,85,24,5,29,18,35,17,11,19,101,104
2023,2,22300429,12/29/2023,1610612752,New York Knicks,0,0,1610612753,Orlando Magic,1,1,32,24,56,6,24,30,38,48,86,26,3,29,11,38,22,10,16,103,108
2016,2,21601227,4/12/2017,1610612762,Utah Jazz,1,1,1610612759,San Antonio Spurs,0,0,29,22,51,10,16,26,39,38,77,13,7,20,11,29,24,12,17,91,101
2016,2,21600190,11/19/2016,1610612763,Memphis Grizzlies,1,1,1610612750,Minnesota Timberwolves,0,0,27,31,58,2,16,18,29,47,76,33,5,38,16,33,15,5,10,87,93
2018,2,21801202,4/7/2019,1610612749,Milwaukee Bucks,1,1,1610612737,Atlanta Hawks,0,0,31,19,50,9,32,41,40,51,91,26,8,34,13,43,19,2,14,106,115
2018,2,21801055,3/18/2019,1610612744,Golden State Warriors,0,0,1610612759,San Antonio Spurs,1,1,28,21,49,13,26,39,41,47,88,10,2,12,10,38,27,7,13,96,105
2018,2,21801055,3/18/2019,1610612759,San Antonio Spurs,1,1,1610612744,Golden State Warriors,0,0,31,31,62,10,16,26,41,47,88,19,3,22,12,38,20,7,10,95,111
2019,2,21900080,11/2/2019,1610612750,Minnesota Timberwolves,0,1,1610612764,Washington Wizards,1,0,34,21,55,17,22,39,51,43,94,12,5,17,9,35,33,11,22,114,131
2019,2,21900080,11/2/2019,1610612764,Washington Wizards,1,0,1610612750,Minnesota Timberwolves,0,1,25,35,60,12,23,35,37,58,95,23,4,27,12,49,21,9,17,113,109
2016,2,21601226,4/12/2017,1610612737,Atlanta Hawks,0,0,1610612754,Indiana Pacers,1,1,19,24,43,11,18,29,30,42,72,15,4,19,11,34,19,5,20,90,86
2016,2,21601226,4/12/2017,1610612754,Indiana Pacers,1,1,1610612737,Atlanta Hawks,0,0,29,29,58,10,14,24,39,43,82,16,3,19,11,33,21,5,10,89,104
2016,2,21600655,1/21/2017,1610612748,Miami Heat,1,1,1610612749,Milwaukee Bucks,0,0,28,19,47,13,17,30,41,36,77,14,8,22,9,30,18,6,12,91,109
2018,2,21800812,2/7/2019,1610612750,Minnesota Timberwolves,0,0,1610612753,Orlando Magic,1,1,36,37,73,10,16,26,46,53,99,10,2,12,22,32,23,5,12,96,112
2018,2,21800812,2/7/2019,1610612753,Orlando Magic,1,1,1610612750,Minnesota Timberwolves,0,0,34,23,57,11,15,26,45,38,83,21,2,23,11,29,23,8,13,94,122
2018,2,21800569,1/4/2019,1610612741,Chicago Bulls,1,0,1610612754,Indiana Pacers,0,1,35,28,63,12,16,28,47,44,91,10,3,13,12,32,30,7,18,103,116
2018,2,21800569,1/4/2019,1610612754,Indiana Pacers,0,1,1610612741,Chicago Bulls,1,0,40,25,65,9,19,28,49,44,93,12,5,17,13,34,25,10,13,101,119
2016,2,21600655,1/21/2017,1610612749,Milwaukee Bucks,0,0,1610612748,Miami Heat,1,1,27,34,61,6,12,18,33,46,79,25,7,32,14,35,17,8,11,92,97
2015,2,21501227,4/13/2016,1610612744,Golden State Warriors,1,1,1610612763,Memphis Grizzlies,0,0,26,14,40,20,27,47,46,41,87,13,3,16,14,29,35,12,17,100,125
2015,2,21501227,4/13/2016,1610612763,Memphis Grizzlies,0,0,1610612744,Golden State Warriors,1,1,34,40,74,8,16,24,42,56,98,12,4,16,19,39,25,7,13,100,104
2015,2,21500715,1/31/2016,1610612737,Atlanta Hawks,0,0,1610612748,Miami Heat,1,1,22,26,48,5,17,22,27,43,70,28,4,32,4,39,13,10,17,98,87
2015,2,21500715,1/31/2016,1610612748,Miami Heat,1,1,1610612737,Atlanta Hawks,0,0,34,27,61,5,15,20,39,42,81,22,4,26,14,31,21,10,18,99,105
2015,2,21500617,1/18/2016,1610612757,Portland Trail Blazers,0,1,1610612764,Washington Wizards,1,0,26,27,53,17,14,31,43,41,84,5,6,11,12,33,25,6,15,92,108
2015,2,21500617,1/18/2016,1610612764,Washington Wizards,1,0,1610612757,Portland Trail Blazers,0,1,28,28,56,9,12,21,37,40,77,15,5,20,4,39,25,5,9,91,98
2015,2,21500541,1/8/2016,1610612751,Brooklyn Nets,1,0,1610612753,Orlando Magic,0,1,22,29,51,7,15,22,29,44,73,12,8,20,12,37,17,7,16,87,77
2015,2,21500541,1/8/2016,1610612753,Orlando Magic,0,1,1610612751,Brooklyn Nets,1,0,20,35,55,13,15,28,33,50,83,4,2,6,14,36,25,4,14,86,83
2015,2,21500330,12/10/2015,1610612741,Chicago Bulls,1,1,1610612746,LA Clippers,0,0,24,40,64,7,16,23,31,56,87,14,2,16,16,40,20,4,11,90,83
2015,2,21500330,12/10/2015,1610612746,LA Clippers,0,0,1610612741,Chicago Bulls,1,1,20,46,66,10,12,22,30,58,88,10,2,12,17,42,22,8,13,89,80
2015,2,21500139,11/14/2015,1610612753,Orlando Magic,0,0,1610612764,Washington Wizards,1,1,34,35,69,4,14,18,38,49,87,19,5,24,8,44,19,6,12,100,99
2015,2,21500139,11/14/2015,1610612764,Washington Wizards,1,1,1610612753,Orlando Magic,0,0,27,27,54,12,17,29,39,44,83,18,8,26,7,41,29,7,11,100,108
2015,2,21500041,11/1/2015,1610612745,Houston Rockets,0,0,1610612748,Miami Heat,1,1,22,21,43,10,26,36,32,47,79,15,3,18,10,38,20,11,18,97,89
2015,2,21500041,11/1/2015,1610612748,Miami Heat,1,1,1610612745,Houston Rockets,0,0,33,31,64,9,13,22,42,44,86,16,5,21,14,33,24,9,15,96,109
2014,2,21400871,2/28/2015,1610612737,Atlanta Hawks,0,1,1610612748,Miami Heat,1,0,24,30,54,10,15,25,34,45,79,15,5,20,11,35,23,12,20,98,93
2014,2,21400871,2/28/2015,1610612748,Miami Heat,1,0,1610612737,Atlanta Hawks,0,1,25,30,55,7,19,26,32,49,81,20,1,21,17,32,17,12,23,99,91
2015,2,21501085,3/26/2016,1610612737,Atlanta Hawks,0,1,1610612765,Detroit Pistons,1,0,30,31,61,13,21,34,43,52,95,13,1,14,12,40,34,2,5,96,112
2015,2,21501085,3/26/2016,1610612765,Detroit Pistons,1,0,1610612737,Atlanta Hawks,0,1,27,32,59,7,22,29,34,54,88,20,8,28,19,38,25,6,11,95,95
2015,2,21501029,3/19/2016,1610612737,Atlanta Hawks,1,1,1610612745,Houston Rockets,0,0,30,20,50,14,24,38,44,44,88,7,5,12,10,37,32,11,16,99,109
2015,2,21501029,3/19/2016,1610612745,Houston Rockets,0,0,1610612737,Atlanta Hawks,1,1,28,33,61,5,18,23,33,51,84,26,5,31,17,37,15,12,17,100,97
2015,2,21500804,2/18/2016,1610612746,LA Clippers,1,1,1610612759,San Antonio Spurs,0,0,27,26,53,12,13,25,39,39,78,15,5,20,13,29,23,11,20,96,105
2015,2,21500804,2/18/2016,1610612759,San Antonio Spurs,0,0,1610612746,LA Clippers,1,1,31,35,66,4,13,17,35,48,83,12,3,15,10,39,19,8,16,96,86
2016,2,21601225,4/12/2017,1610612743,Denver Nuggets,0,1,1610612760,Oklahoma City Thunder,1,0,32,28,60,7,18,25,39,46,85,26,6,32,10,39,22,10,17,107,111
2016,2,21601225,4/12/2017,1610612760,Oklahoma City Thunder,1,0,1610612743,Denver Nuggets,0,1,35,41,76,8,17,25,43,58,101,11,6,17,16,44,20,6,12,106,105
2015,2,21500434,12/23/2015,1610612744,Golden State Warriors,1,1,1610612762,Utah Jazz,0,0,30,30,60,9,14,23,39,44,83,16,0,16,12,32,26,9,16,94,103
2015,2,21500434,12/23/2015,1610612762,Utah Jazz,0,0,1610612744,Golden State Warriors,1,1,26,34,60,7,13,20,33,47,80,12,2,14,14,34,14,10,20,94,85
2015,2,21500234,11/27/2015,1610612760,Oklahoma City Thunder,1,1,1610612765,Detroit Pistons,0,0,30,25,55,7,17,24,37,42,79,22,4,26,18,27,19,9,19,95,103
2015,2,21500234,11/27/2015,1610612765,Detroit Pistons,0,0,1610612760,Oklahoma City Thunder,1,1,22,39,61,9,20,29,31,59,90,16,4,20,14,48,17,2,8,94,87
2015,2,21500040,11/1/2015,1610612738,Boston Celtics,1,0,1610612759,San Antonio Spurs,0,1,29,40,69,6,23,29,35,63,98,11,3,14,18,45,21,10,16,101,87
2015,2,21500040,11/1/2015,1610612759,San Antonio Spurs,0,1,1610612738,Boston Celtics,1,0,31,33,64,5,14,19,36,47,83,18,7,25,16,34,22,10,20,103,95
2015,2,21501146,4/3/2016,1610612742,Dallas Mavericks,0,1,1610612750,Minnesota Timberwolves,1,0,18,25,43,14,26,40,32,51,83,10,7,17,17,37,19,8,11,86,88
2015,2,21501146,4/3/2016,1610612750,Minnesota Timberwolves,1,0,1610612742,Dallas Mavericks,0,1,25,25,50,4,17,21,29,42,71,16,2,18,10,33,20,6,18,87,78
2015,2,21500921,3/4/2016,1610612737,Atlanta Hawks,0,1,1610612747,Los Angeles Lakers,1,0,24,16,40,13,15,28,37,31,68,19,7,26,4,31,31,5,10,89,106
2015,2,21500921,3/4/2016,1610612747,Los Angeles Lakers,1,0,1610612737,Atlanta Hawks,0,1,24,34,58,5,22,27,29,56,85,14,6,20,20,39,19,6,11,87,77
2016,2,21601224,4/12/2017,1610612745,Houston Rockets,1,1,1610612750,Minnesota Timberwolves,0,0,26,15,41,19,37,56,45,52,97,14,8,22,17,39,37,7,10,100,123
2016,2,21601224,4/12/2017,1610612750,Minnesota Timberwolves,0,0,1610612745,Houston Rockets,1,1,37,31,68,11,12,23,48,43,91,11,4,15,13,34,37,11,15,101,118
2015,2,21500540,1/8/2016,1610612761,Toronto Raptors,0,1,1610612764,Washington Wizards,1,0,29,32,61,5,9,14,34,41,75,24,2,26,13,28,11,9,23,98,97
2015,2,21500540,1/8/2016,1610612764,Washington Wizards,1,0,1610612761,Toronto Raptors,0,1,25,34,59,8,17,25,33,51,84,14,1,15,8,44,18,7,19,98,88
2015,2,21500329,12/10/2015,1610612751,Brooklyn Nets,1,1,1610612755,Philadelphia 76ers,0,0,31,29,60,6,8,14,37,37,74,20,7,27,12,27,22,14,19,94,100
2015,2,21500329,12/10/2015,1610612755,Philadelphia 76ers,0,0,1610612751,Brooklyn Nets,1,1,30,26,56,4,27,31,34,53,87,19,3,22,17,38,17,5,11,94,91
2015,2,21500233,11/27/2015,1610612737,Atlanta Hawks,0,1,1610612763,Memphis Grizzlies,1,0,21,15,36,14,25,39,35,40,75,32,4,36,8,32,25,3,10,94,116
2015,2,21500233,11/27/2015,1610612763,Memphis Grizzlies,1,0,1610612737,Atlanta Hawks,0,1,23,27,50,12,18,30,35,45,80,19,2,21,11,35,20,4,14,95,101
2015,2,21500138,11/14/2015,1610612746,LA Clippers,1,1,1610612765,Detroit Pistons,0,0,30,30,60,7,12,19,37,42,79,20,6,26,12,34,23,8,14,95,101
2015,2,21500138,11/14/2015,1610612765,Detroit Pistons,0,0,1610612746,LA Clippers,1,1,26,21,47,7,20,27,33,41,74,23,12,35,13,33,15,6,15,95,96
2014,2,21400870,2/28/2015,1610612764,Washington Wizards,1,1,1610612765,Detroit Pistons,0,0,30,28,58,7,13,20,37,41,78,18,7,25,12,34,21,8,13,91,99
2014,2,21400870,2/28/2015,1610612765,Detroit Pistons,0,0,1610612764,Washington Wizards,1,1,30,23,53,8,18,26,38,41,79,11,10,21,15,33,18,14,18,91,95
2015,2,21501226,4/13/2016,1610612740,New Orleans Pelicans,0,0,1610612750,Minnesota Timberwolves,1,1,29,33,62,11,19,30,40,52,92,18,4,22,14,39,31,14,16,105,109
2015,2,21501226,4/13/2016,1610612750,Minnesota Timberwolves,1,1,1610612740,New Orleans Pelicans,0,0,43,15,58,13,15,28,56,30,86,19,4,23,7,26,41,7,13,105,144
2016,2,21601223,4/12/2017,1610612742,Dallas Mavericks,0,1,1610612763,Memphis Grizzlies,1,0,24,17,41,9,25,34,33,42,75,25,6,31,13,34,21,4,12,89,100
2016,2,21601223,4/12/2017,1610612763,Memphis Grizzlies,1,0,1610612742,Dallas Mavericks,0,1,25,34,59,8,17,25,33,51,84,19,3,22,21,31,18,9,15,89,93
2016,2,21600654,1/21/2017,1610612752,New York Knicks,1,0,1610612756,Phoenix Suns,0,1,29,39,68,11,10,21,40,49,89,14,2,16,17,32,20,9,13,94,105
2016,2,21600654,1/21/2017,1610612756,Phoenix Suns,0,1,1610612752,New York Knicks,1,0,28,33,61,9,15,24,37,48,85,24,3,27,16,34,15,6,13,95,107
2015,2,21500539,1/7/2016,1610612747,Los Angeles Lakers,0,0,1610612758,Sacramento Kings,1,1,33,19,52,8,16,24,41,35,76,25,4,29,8,29,20,8,18,100,115
2015,2,21500539,1/7/2016,1610612758,Sacramento Kings,1,1,1610612747,Los Angeles Lakers,0,0,41,23,64,6,15,21,47,38,85,18,9,27,12,29,32,10,15,100,118
2015,2,21500433,12/23/2015,1610612743,Denver Nuggets,0,1,1610612756,Phoenix Suns,1,0,28,28,56,14,21,35,42,49,91,6,7,13,17,36,26,9,17,97,104
2015,2,21500433,12/23/2015,1610612756,Phoenix Suns,1,0,1610612743,Denver Nuggets,0,1,23,39,62,13,12,25,36,51,87,11,6,17,14,40,21,6,16,98,96
2015,2,21500232,11/27/2015,1610612745,Houston Rockets,1,1,1610612755,Philadelphia 76ers,0,0,27,26,53,11,9,20,38,35,73,29,8,37,12,27,21,18,23,100,116
2015,2,21500232,11/27/2015,1610612755,Philadelphia 76ers,0,0,1610612745,Houston Rockets,1,1,24,24,48,16,19,35,40,43,83,18,8,26,8,41,24,5,13,99,114
2015,2,21500137,11/13/2015,1610612751,Brooklyn Nets,0,0,1610612758,Sacramento Kings,1,1,34,34,68,8,13,21,42,47,89,17,4,21,13,36,24,11,15,101,109
2015,2,21500137,11/13/2015,1610612758,Sacramento Kings,1,1,1610612751,Brooklyn Nets,0,0,29,38,67,11,16,27,40,54,94,20,6,26,20,37,25,7,14,101,111
2015,2,21500039,11/1/2015,1610612737,Atlanta Hawks,0,1,1610612766,Charlotte Hornets,1,0,30,29,59,7,22,29,37,51,88,13,1,14,12,40,22,7,11,94,94
2015,2,21500039,11/1/2015,1610612766,Charlotte Hornets,1,0,1610612737,Atlanta Hawks,0,1,18,31,49,14,23,37,32,54,86,14,1,15,12,42,27,9,12,93,92
2015,2,21501145,4/3/2016,1610612745,Houston Rockets,1,1,1610612760,Oklahoma City Thunder,0,0,28,32,60,13,29,42,41,61,102,23,3,26,24,38,24,5,10,101,118
2015,2,21501145,4/3/2016,1610612760,Oklahoma City Thunder,0,0,1610612745,Houston Rockets,1,1,31,24,55,7,20,27,38,44,82,27,5,32,18,29,21,11,21,101,110
2015,2,21500977,3/12/2016,1610612748,Miami Heat,0,0,1610612761,Toronto Raptors,1,1,28,45,73,9,16,25,37,61,98,21,5,26,21,42,19,10,14,104,104
2015,2,21500977,3/12/2016,1610612761,Toronto Raptors,1,1,1610612748,Miami Heat,0,0,31,35,66,6,12,18,37,47,84,32,6,38,14,36,17,9,14,104,112
2015,2,21500857,2/25/2016,1610612740,New Orleans Pelicans,1,1,1610612760,Oklahoma City Thunder,0,0,35,35,70,12,8,20,47,43,90,17,1,18,16,28,29,4,12,95,123
2015,2,21500857,2/25/2016,1610612760,Oklahoma City Thunder,0,0,1610612740,New Orleans Pelicans,1,1,39,28,67,8,11,19,47,39,86,17,5,22,14,28,25,5,14,96,119
2016,2,21601222,4/12/2017,1610612741,Chicago Bulls,1,1,1610612751,Brooklyn Nets,0,0,27,38,65,14,16,30,41,54,95,16,5,21,15,39,28,8,13,102,112
2016,2,21601222,4/12/2017,1610612751,Brooklyn Nets,0,0,1610612741,Chicago Bulls,1,1,25,28,53,3,30,33,28,58,86,14,4,18,13,48,17,15,19,102,73
2015,2,21500714,1/31/2016,1610612741,Chicago Bulls,0,0,1610612746,LA Clippers,1,1,35,43,78,5,10,15,40,53,93,8,3,11,13,41,19,8,9,93,93
2015,2,21500714,1/31/2016,1610612746,LA Clippers,1,1,1610612741,Chicago Bulls,0,0,28,24,52,17,15,32,45,39,84,13,6,19,10,32,26,2,11,95,120
2015,2,21500667,1/25/2016,1610612739,Cleveland Cavaliers,1,1,1610612750,Minnesota Timberwolves,0,0,34,24,58,11,20,31,45,44,89,13,7,20,17,32,30,10,15,97,114
2015,2,21500667,1/25/2016,1610612750,Minnesota Timberwolves,0,0,1610612739,Cleveland Cavaliers,1,1,37,31,68,4,12,16,41,43,84,21,2,23,10,33,28,7,11,95,107
2015,2,21500616,1/18/2016,1610612762,Utah Jazz,0,0,1610612766,Charlotte Hornets,1,1,29,30,59,15,30,45,44,60,104,16,4,20,17,45,27,6,10,106,119
2015,2,21500616,1/18/2016,1610612766,Charlotte Hornets,1,1,1610612762,Utah Jazz,0,0,27,34,61,14,13,27,41,47,88,28,4,32,14,35,20,6,16,107,124
2015,2,21500538,1/7/2016,1610612745,Houston Rockets,1,1,1610612762,Utah Jazz,0,0,32,20,52,7,16,23,39,36,75,18,8,26,13,27,15,9,16,92,103
2015,2,21500538,1/7/2016,1610612762,Utah Jazz,0,0,1610612745,Houston Rockets,1,1,31,19,50,7,21,28,38,40,78,11,6,17,12,32,25,11,19,93,94
2015,2,21500231,11/27/2015,1610612741,Chicago Bulls,0,0,1610612754,Indiana Pacers,1,1,21,45,66,11,15,26,32,60,92,17,3,20,15,47,21,8,15,102,92
2015,2,21500231,11/27/2015,1610612754,Indiana Pacers,1,1,1610612741,Chicago Bulls,0,0,29,30,59,8,20,28,37,50,87,22,7,29,13,40,18,7,13,102,104
2015,2,21500136,11/13/2015,1610612743,Denver Nuggets,1,1,1610612745,Houston Rockets,0,0,28,33,61,9,11,20,37,44,81,24,8,32,16,33,25,10,19,100,107
2015,2,21500136,11/13/2015,1610612745,Houston Rockets,0,0,1610612743,Denver Nuggets,1,1,24,24,48,9,20,29,33,44,77,23,8,31,11,37,19,10,20,101,98
2015,2,21501028,3/19/2016,1610612743,Denver Nuggets,0,1,1610612766,Charlotte Hornets,1,0,29,40,69,9,9,18,38,49,87,16,7,23,17,35,19,6,14,95,101
2015,2,21501028,3/19/2016,1610612766,Charlotte Hornets,1,0,1610612743,Denver Nuggets,0,1,26,25,51,9,23,32,35,48,83,14,6,20,11,40,22,6,11,95,93
2015,2,21500856,2/25/2016,1610612738,Boston Celtics,1,1,1610612749,Milwaukee Bucks,0,0,36,25,61,5,18,23,41,43,84,25,8,33,13,33,21,9,16,103,112
2015,2,21500856,2/25/2016,1610612749,Milwaukee Bucks,0,0,1610612738,Boston Celtics,1,1,38,34,72,4,11,15,42,45,87,19,6,25,9,38,26,9,15,103,107
2015,2,21500803,2/18/2016,1610612739,Cleveland Cavaliers,1,1,1610612741,Chicago Bulls,0,0,35,32,67,7,17,24,42,49,91,15,2,17,14,36,21,4,11,97,106
2015,2,21500803,2/18/2016,1610612741,Chicago Bulls,0,0,1610612739,Cleveland Cavaliers,1,1,29,43,72,8,13,21,37,56,93,13,9,22,19,42,12,8,13,97,95
2015,2,21500757,2/5/2016,1610612741,Chicago Bulls,0,0,1610612743,Denver Nuggets,1,1,38,43,81,5,7,12,43,50,93,19,8,27,16,38,21,5,11,100,110
2015,2,21500757,2/5/2016,1610612743,Denver Nuggets,1,1,1610612741,Chicago Bulls,0,0,33,36,69,6,12,18,39,48,87,31,13,44,20,35,22,5,10,98,115
2016,2,21600189,11/19/2016,1610612755,Philadelphia 76ers,1,1,1610612756,Phoenix Suns,0,0,28,23,51,17,18,35,45,41,86,13,7,20,11,34,33,11,19,105,120
2016,2,21600189,11/19/2016,1610612756,Phoenix Suns,0,0,1610612755,Philadelphia 76ers,1,1,33,38,71,6,15,21,39,53,92,21,13,34,16,42,18,11,15,105,105
2015,2,21500537,1/7/2016,1610612738,Boston Celtics,0,0,1610612741,Chicago Bulls,1,1,30,43,73,5,20,25,35,63,98,17,5,22,19,47,17,4,11,103,92
2015,2,21500537,1/7/2016,1610612741,Chicago Bulls,1,1,1610612738,Boston Celtics,0,0,30,42,72,9,13,22,39,55,94,14,3,17,18,38,23,11,16,103,101
2015,2,21500432,12/23/2015,1610612740,New Orleans Pelicans,1,1,1610612757,Portland Trail Blazers,0,0,28,26,54,13,18,31,41,44,85,20,3,23,9,37,27,7,11,99,115
2015,2,21500432,12/23/2015,1610612757,Portland Trail Blazers,0,0,1610612740,New Orleans Pelicans,1,1,26,41,67,7,21,28,33,62,95,16,8,24,24,42,16,5,14,99,89
2015,2,21500230,11/27/2015,1610612748,Miami Heat,0,1,1610612752,New York Knicks,1,0,26,33,59,7,10,17,33,43,76,24,4,28,12,34,16,7,13,90,97
2015,2,21500230,11/27/2015,1610612752,New York Knicks,1,0,1610612748,Miami Heat,0,1,29,42,71,3,11,14,32,53,85,11,4,15,15,40,16,4,11,92,78
2015,2,21500135,11/13/2015,1610612742,Dallas Mavericks,1,1,1610612747,Los Angeles Lakers,0,0,23,32,55,7,20,27,30,52,82,23,6,29,12,43,19,10,15,98,90
2015,2,21500135,11/13/2015,1610612747,Los Angeles Lakers,0,0,1610612742,Dallas Mavericks,1,1,20,41,61,9,18,27,29,59,88,15,3,18,19,42,18,9,22,99,82
2015,2,21500038,10/31/2015,1610612746,LA Clippers,1,1,1610612758,Sacramento Kings,0,0,35,24,59,4,13,17,39,37,76,32,14,46,11,33,25,9,17,104,114
2015,2,21500038,10/31/2015,1610612758,Sacramento Kings,0,0,1610612746,LA Clippers,1,1,37,46,83,6,12,18,43,58,101,17,8,25,23,40,20,4,14,104,109
2015,2,21501084,3/26/2016,1610612740,New Orleans Pelicans,1,0,1610612761,Toronto Raptors,0,1,33,37,70,4,11,15,37,48,85,13,7,20,9,43,22,6,7,93,91
2015,2,21501084,3/26/2016,1610612761,Toronto Raptors,0,1,1610612740,New Orleans Pelicans,1,0,27,17,44,12,17,29,39,34,73,25,3,28,8,27,24,6,13,93,115
2015,2,21500920,3/4/2016,1610612743,Denver Nuggets,1,0,1610612751,Brooklyn Nets,0,1,40,30,70,6,20,26,46,50,96,22,3,25,22,29,28,5,15,102,120
2015,2,21500920,3/4/2016,1610612751,Brooklyn Nets,0,1,1610612743,Denver Nuggets,1,0,33,36,69,13,9,22,46,45,91,16,5,21,12,35,32,8,14,103,121
2015,2,21500536,1/7/2016,1610612737,Atlanta Hawks,0,1,1610612755,Philadelphia 76ers,1,0,36,24,60,13,19,32,49,43,92,15,4,19,15,31,36,9,17,102,126
2015,2,21500536,1/7/2016,1610612755,Philadelphia 76ers,1,0,1610612737,Atlanta Hawks,0,1,34,34,68,5,13,18,39,47,86,15,10,25,16,37,21,18,22,102,98
2015,2,21500327,12/9/2015,1610612752,New York Knicks,0,0,1610612762,Utah Jazz,1,1,23,34,57,8,13,21,31,47,78,15,12,27,9,45,20,6,11,92,85
2015,2,21500327,12/9/2015,1610612762,Utah Jazz,1,1,1610612752,New York Knicks,0,0,30,29,59,9,12,21,39,41,80,19,4,23,14,30,26,10,16,93,106
2015,2,21500229,11/27/2015,1610612738,Boston Celtics,1,1,1610612764,Washington Wizards,0,0,30,34,64,12,21,33,42,55,97,15,4,19,21,36,28,7,15,99,111
2015,2,21500229,11/27/2015,1610612764,Washington Wizards,0,0,1610612738,Boston Celtics,1,1,22,44,66,5,13,18,27,57,84,19,3,22,18,41,16,11,22,99,78
2015,2,21500134,11/13/2015,1610612755,Philadelphia 76ers,0,0,1610612760,Oklahoma City Thunder,1,1,25,44,69,5,12,17,30,56,86,20,8,28,17,41,16,9,18,101,85
2015,2,21500134,11/13/2015,1610612760,Oklahoma City Thunder,1,1,1610612755,Philadelphia 76ers,0,0,31,41,72,8,17,25,39,58,97,16,5,21,20,41,20,11,13,101,102
2014,2,21400869,2/27/2015,1610612757,Portland Trail Blazers,1,1,1610612760,Oklahoma City Thunder,0,0,29,34,63,10,16,26,39,50,89,27,4,31,13,38,20,5,9,99,115
2014,2,21400869,2/27/2015,1610612760,Oklahoma City Thunder,0,0,1610612757,Portland Trail Blazers,1,1,41,39,80,4,10,14,45,49,94,18,4,22,15,34,24,7,13,98,112
2015,2,21501225,4/13/2016,1610612749,Milwaukee Bucks,1,0,1610612754,Indiana Pacers,0,1,30,34,64,7,16,23,37,50,87,11,2,13,9,42,23,8,15,101,92
2015,2,21501225,4/13/2016,1610612754,Indiana Pacers,0,1,1610612749,Milwaukee Bucks,1,0,28,38,66,11,13,24,39,51,90,8,2,10,13,39,28,8,17,101,97
2015,2,21501144,4/3/2016,1610612739,Cleveland Cavaliers,1,1,1610612766,Charlotte Hornets,0,0,29,25,54,16,13,29,45,38,83,6,7,13,18,25,34,15,17,91,112
2015,2,21501144,4/3/2016,1610612766,Charlotte Hornets,0,0,1610612739,Cleveland Cavaliers,1,1,25,25,50,9,17,26,34,42,76,26,1,27,12,31,23,7,15,90,103
2015,2,21501027,3/18/2016,1610612747,Los Angeles Lakers,1,0,1610612756,Phoenix Suns,0,1,25,38,63,6,17,23,31,55,86,22,4,26,14,42,21,5,12,95,90
2015,2,21501027,3/18/2016,1610612756,Phoenix Suns,0,1,1610612747,Los Angeles Lakers,1,0,24,35,59,8,22,30,32,57,89,23,3,26,19,39,19,4,12,94,95
2015,2,21500976,3/12/2016,1610612755,Philadelphia 76ers,1,0,1610612765,Detroit Pistons,0,1,29,30,59,10,15,25,39,45,84,23,4,27,8,40,24,6,12,99,111
2015,2,21500976,3/12/2016,1610612765,Detroit Pistons,0,1,1610612755,Philadelphia 76ers,1,0,40,33,73,9,9,18,49,42,91,18,4,22,15,30,26,11,13,100,125
2016,2,21601221,4/12/2017,1610612748,Miami Heat,1,1,1610612764,Washington Wizards,0,0,38,26,64,8,16,24,46,42,88,10,2,12,16,27,19,9,18,95,110
2016,2,21601221,4/12/2017,1610612764,Washington Wizards,0,0,1610612748,Miami Heat,1,1,35,26,61,7,19,26,42,45,87,11,3,14,10,37,18,2,11,95,102
2016,2,21600653,1/21/2017,1610612737,Atlanta Hawks,1,1,1610612755,Philadelphia 76ers,0,0,38,33,71,7,13,20,45,46,91,13,10,23,13,38,24,8,14,103,110
2016,2,21600653,1/21/2017,1610612755,Philadelphia 76ers,0,0,1610612737,Atlanta Hawks,1,1,21,28,49,12,17,29,33,45,78,15,3,18,7,39,27,8,22,101,93
2015,2,21500535,1/6/2016,1610612746,LA Clippers,0,1,1610612757,Portland Trail Blazers,1,0,31,29,60,11,12,23,42,41,83,14,3,17,11,32,24,5,10,89,109
2015,2,21500535,1/6/2016,1610612757,Portland Trail Blazers,1,0,1610612746,LA Clippers,0,1,29,31,60,9,17,26,38,48,86,13,10,23,22,32,21,7,14,90,98
2015,2,21500431,12/23/2015,1610612750,Minnesota Timberwolves,1,0,1610612759,San Antonio Spurs,0,1,27,35,62,3,7,10,30,42,72,20,5,25,10,35,19,7,14,88,83
2015,2,21500431,12/23/2015,1610612759,San Antonio Spurs,0,1,1610612750,Minnesota Timberwolves,1,0,34,24,58,10,14,24,44,38,82,10,4,14,18,24,24,5,17,90,108
2015,2,21500228,11/27/2015,1610612749,Milwaukee Bucks,0,0,1610612753,Orlando Magic,1,1,23,25,48,8,18,26,31,43,74,20,2,22,9,34,20,9,22,99,90
2015,2,21500228,11/27/2015,1610612753,Orlando Magic,1,1,1610612749,Milwaukee Bucks,0,0,31,24,55,12,15,27,43,39,82,16,6,22,10,33,30,8,19,99,114
2015,2,21500133,11/13/2015,1610612757,Portland Trail Blazers,0,0,1610612763,Memphis Grizzlies,1,1,25,22,47,8,14,22,33,36,69,26,3,29,14,24,17,10,22,94,100
2015,2,21500133,11/13/2015,1610612763,Memphis Grizzlies,1,1,1610612757,Portland Trail Blazers,0,0,30,40,70,6,10,16,36,50,86,23,4,27,17,34,22,5,10,92,101
2015,2,21500037,10/31/2015,1610612756,Phoenix Suns,0,1,1610612757,Portland Trail Blazers,1,0,28,34,62,11,21,32,39,55,94,12,4,16,16,41,16,7,13,99,101
2015,2,21500037,10/31/2015,1610612757,Portland Trail Blazers,1,0,1610612756,Phoenix Suns,0,1,25,24,49,8,22,30,33,46,79,16,12,28,12,39,20,11,16,99,90
2014,2,21400868,2/27/2015,1610612747,Los Angeles Lakers,1,1,1610612749,Milwaukee Bucks,0,0,34,33,67,6,12,18,40,45,85,15,7,22,11,38,23,7,12,97,101
2014,2,21400868,2/27/2015,1610612749,Milwaukee Bucks,0,0,1610612747,Los Angeles Lakers,1,1,30,40,70,4,13,17,34,53,87,21,8,29,16,42,18,7,11,98,93
2016,2,21601220,4/12/2017,1610612752,New York Knicks,1,1,1610612755,Philadelphia 76ers,0,0,32,29,61,9,13,22,41,42,83,23,9,32,20,28,17,10,19,95,114
2016,2,21601220,4/12/2017,1610612755,Philadelphia 76ers,0,0,1610612752,New York Knicks,1,1,39,31,70,7,16,23,46,47,93,14,6,20,21,29,21,5,13,95,113
2016,2,21600652,1/21/2017,1610612751,Brooklyn Nets,0,0,1610612766,Charlotte Hornets,1,1,21,26,47,17,24,41,38,50,88,12,3,15,10,41,30,7,14,99,105
2016,2,21600652,1/21/2017,1610612766,Charlotte Hornets,1,1,1610612751,Brooklyn Nets,0,0,25,27,52,14,16,30,39,43,82,20,2,22,8,38,26,9,13,98,112
2015,2,21500666,1/24/2016,1610612746,LA Clippers,0,0,1610612761,Toronto Raptors,1,1,26,24,50,8,18,26,34,42,76,18,12,30,9,37,21,8,13,93,94
2015,2,21500666,1/24/2016,1610612761,Toronto Raptors,1,1,1610612746,LA Clippers,0,0,29,32,61,12,10,22,41,42,83,18,8,26,16,28,19,6,15,93,112
2015,2,21500615,1/18/2016,1610612752,New York Knicks,1,1,1610612755,Philadelphia 76ers,0,0,35,42,77,8,12,20,43,54,97,25,5,30,12,45,26,9,14,111,119
2015,2,21500615,1/18/2016,1610612755,Philadelphia 76ers,0,0,1610612752,New York Knicks,1,1,35,39,74,10,18,28,45,57,102,13,12,25,17,45,27,6,13,114,113
2015,2,21500534,1/6/2016,1610612760,Oklahoma City Thunder,1,1,1610612763,Memphis Grizzlies,0,0,30,36,66,8,9,17,38,45,83,28,5,33,18,31,20,9,16,96,112
2015,2,21500534,1/6/2016,1610612763,Memphis Grizzlies,0,0,1610612760,Oklahoma City Thunder,1,1,28,41,69,7,14,21,35,55,90,17,7,24,15,42,21,3,8,95,94
2015,2,21500326,12/9/2015,1610612753,Orlando Magic,0,0,1610612756,Phoenix Suns,1,1,28,32,60,12,13,25,40,45,85,12,4,16,12,36,28,9,16,96,104
2015,2,21500326,12/9/2015,1610612756,Phoenix Suns,1,1,1610612753,Orlando Magic,0,0,35,21,56,6,18,24,41,39,80,19,8,27,14,30,23,11,18,97,107
2015,2,21500227,11/27/2015,1610612739,Cleveland Cavaliers,0,1,1610612766,Charlotte Hornets,1,0,26,30,56,8,17,25,34,47,81,19,6,25,16,33,17,7,16,93,95
2015,2,21500227,11/27/2015,1610612766,Charlotte Hornets,1,0,1610612739,Cleveland Cavaliers,0,1,28,27,55,5,20,25,33,47,80,19,6,25,10,40,20,3,12,94,90
2015,2,21501143,4/3/2016,1610612740,New Orleans Pelicans,0,1,1610612751,Brooklyn Nets,1,0,34,20,54,8,14,22,42,34,76,14,9,23,8,32,31,5,13,93,106
2015,2,21501143,4/3/2016,1610612751,Brooklyn Nets,1,0,1610612740,New Orleans Pelicans,0,1,25,37,62,8,15,23,33,52,85,13,8,21,25,30,20,11,21,92,87
2015,2,21500919,3/4/2016,1610612749,Milwaukee Bucks,1,1,1610612750,Minnesota Timberwolves,0,0,29,30,59,14,10,24,43,40,83,16,4,20,12,29,24,9,20,100,116
2015,2,21500919,3/4/2016,1610612750,Minnesota Timberwolves,0,0,1610612749,Milwaukee Bucks,1,1,35,30,65,7,15,22,42,45,87,10,4,14,17,30,25,13,26,100,101
2015,2,21500855,2/25/2016,1610612744,Golden State Warriors,0,1,1610612753,Orlando Magic,1,0,40,23,63,13,12,25,53,35,88,11,5,16,9,30,35,11,21,107,130
2015,2,21500855,2/25/2016,1610612753,Orlando Magic,1,0,1610612744,Golden State Warriors,0,1,31,33,64,10,16,26,41,49,90,22,6,28,13,37,23,9,15,107,114
2016,2,21601219,4/12/2017,1610612738,Boston Celtics,1,1,1610612749,Milwaukee Bucks,0,0,29,25,54,12,25,37,41,50,91,18,8,26,17,38,31,6,8,96,112
2016,2,21601219,4/12/2017,1610612749,Milwaukee Bucks,0,0,1610612738,Boston Celtics,1,1,31,30,61,6,17,23,37,47,84,14,3,17,12,36,26,12,17,97,94
2015,2,21500533,1/6/2016,1610612756,Phoenix Suns,1,1,1610612766,Charlotte Hornets,0,0,22,29,51,19,14,33,41,43,84,10,3,13,7,36,25,9,12,98,111
2015,2,21500533,1/6/2016,1610612766,Charlotte Hornets,0,0,1610612756,Phoenix Suns,1,1,27,32,59,11,17,28,38,49,87,15,7,22,14,38,20,11,13,97,102
2015,2,21500430,12/23/2015,1610612749,Milwaukee Bucks,1,1,1610612755,Philadelphia 76ers,0,0,46,27,73,5,7,12,51,34,85,6,2,8,7,28,34,12,16,99,113
2015,2,21500430,12/23/2015,1610612755,Philadelphia 76ers,0,0,1610612749,Milwaukee Bucks,1,1,30,31,61,7,13,20,37,44,81,19,10,29,19,31,24,14,23,100,100
2015,2,21500132,11/13/2015,1610612741,Chicago Bulls,1,1,1610612766,Charlotte Hornets,0,0,33,35,68,4,12,16,37,47,84,24,7,31,14,36,27,9,11,96,102
2015,2,21500132,11/13/2015,1610612766,Charlotte Hornets,0,0,1610612741,Chicago Bulls,1,1,21,41,62,15,18,33,36,59,95,10,2,12,11,50,21,4,7,96,97
2015,2,21500036,10/31/2015,1610612751,Brooklyn Nets,0,0,1610612763,Memphis Grizzlies,1,1,35,31,66,3,10,13,38,41,79,12,6,18,10,34,21,6,12,92,91
2015,2,21500036,10/31/2015,1610612763,Memphis Grizzlies,1,1,1610612751,Brooklyn Nets,0,0,25,32,57,9,14,23,34,46,80,24,4,28,12,38,26,3,9,90,101
2014,2,21400867,2/27/2015,1610612758,Sacramento Kings,1,0,1610612759,San Antonio Spurs,0,1,37,38,75,1,3,4,38,41,79,19,4,23,10,33,15,8,17,97,96
2014,2,21400867,2/27/2015,1610612759,San Antonio Spurs,0,1,1610612758,Sacramento Kings,1,0,27,38,65,8,15,23,35,53,88,29,3,32,14,41,18,3,6,96,107
2015,2,21501224,4/13/2016,1610612745,Houston Rockets,1,1,1610612758,Sacramento Kings,0,0,37,25,62,10,25,35,47,50,97,12,7,19,17,37,33,11,14,104,116
2015,2,21501224,4/13/2016,1610612758,Sacramento Kings,0,0,1610612745,Houston Rockets,1,1,21,38,59,11,26,37,32,64,96,6,7,13,20,47,21,11,20,103,81
2016,2,21600188,11/19/2016,1610612738,Boston Celtics,0,1,1610612765,Detroit Pistons,1,0,21,30,51,12,19,31,33,49,82,16,1,17,10,40,22,5,8,88,94
2016,2,21600188,11/19/2016,1610612765,Detroit Pistons,1,0,1610612738,Boston Celtics,0,1,30,36,66,7,13,20,37,49,86,11,5,16,15,37,22,3,7,87,92
2015,2,21500328,12/9/2015,1610612737,Atlanta Hawks,0,1,1610612742,Dallas Mavericks,1,0,33,28,61,6,14,20,39,42,81,14,4,18,11,34,26,7,15,96,98
2015,2,21500328,12/9/2015,1610612742,Dallas Mavericks,1,0,1610612737,Atlanta Hawks,0,1,29,40,69,7,24,31,36,64,100,16,3,19,22,42,18,7,9,96,95
2015,2,21500713,1/30/2016,1610612739,Cleveland Cavaliers,1,1,1610612759,San Antonio Spurs,0,0,36,23,59,9,14,23,45,37,82,18,3,21,14,25,24,2,10,88,117
2015,2,21500713,1/30/2016,1610612759,San Antonio Spurs,0,0,1610612739,Cleveland Cavaliers,1,1,34,29,63,6,12,18,40,41,81,17,4,21,10,34,20,4,6,88,103
2015,2,21500665,1/24/2016,1610612742,Dallas Mavericks,0,0,1610612745,Houston Rockets,1,1,21,28,49,15,15,30,36,43,79,17,5,22,12,35,17,9,16,93,104
2015,2,21500665,1/24/2016,1610612745,Houston Rockets,1,1,1610612742,Dallas Mavericks,0,0,28,17,45,15,29,44,43,46,89,14,7,21,15,34,27,4,9,93,115
2015,2,21500614,1/17/2016,1610612745,Houston Rockets,0,1,1610612747,Los Angeles Lakers,1,0,38,32,70,6,15,21,44,47,91,18,6,24,16,35,21,8,14,100,112
2015,2,21500614,1/17/2016,1610612747,Los Angeles Lakers,1,0,1610612745,Houston Rockets,0,1,31,32,63,6,13,19,37,45,82,15,4,19,7,40,25,10,14,100,95
2015,2,21500532,1/6/2016,1610612759,San Antonio Spurs,1,1,1610612762,Utah Jazz,0,0,43,22,65,9,12,21,52,34,86,10,3,13,10,26,34,8,13,94,123
2015,2,21500532,1/6/2016,1610612762,Utah Jazz,0,0,1610612759,San Antonio Spurs,1,1,30,31,61,7,11,18,37,42,79,17,1,18,12,30,21,10,19,95,98
2015,2,21500325,12/9/2015,1610612747,Los Angeles Lakers,0,0,1610612750,Minnesota Timberwolves,1,1,39,31,70,9,14,23,48,45,93,17,10,27,10,36,19,4,9,104,122
2015,2,21500325,12/9/2015,1610612750,Minnesota Timberwolves,1,1,1610612747,Los Angeles Lakers,0,0,39,35,74,7,12,19,46,47,93,24,7,31,19,33,30,9,15,106,123
2015,2,21500226,11/25/2015,1610612746,LA Clippers,1,0,1610612762,Utah Jazz,0,1,34,29,63,4,8,12,38,37,75,11,6,17,13,28,18,12,19,89,91
2015,2,21500226,11/25/2015,1610612762,Utah Jazz,0,1,1610612746,LA Clippers,1,0,33,31,64,6,7,13,39,38,77,18,7,25,15,27,19,11,17,90,102
2015,2,21501223,4/13/2016,1610612742,Dallas Mavericks,1,0,1610612759,San Antonio Spurs,0,1,19,19,38,12,27,39,31,46,77,17,4,21,11,37,20,8,12,88,91
2015,2,21501223,4/13/2016,1610612759,San Antonio Spurs,0,1,1610612742,Dallas Mavericks,1,0,29,22,51,6,17,23,35,39,74,20,6,26,11,31,24,8,15,89,96
2015,2,21501083,3/26/2016,1610612741,Chicago Bulls,0,0,1610612753,Orlando Magic,1,1,30,34,64,6,18,24,36,52,88,11,6,17,17,39,20,5,13,96,89
2015,2,21501083,3/26/2016,1610612753,Orlando Magic,1,1,1610612741,Chicago Bulls,0,0,41,29,70,7,12,19,48,41,89,8,4,12,12,31,32,2,13,95,111
2015,2,21500975,3/12/2016,1610612745,Houston Rockets,0,0,1610612766,Charlotte Hornets,1,1,38,29,67,5,21,26,43,50,93,18,10,28,19,38,21,6,9,94,109
2015,2,21500975,3/12/2016,1610612766,Charlotte Hornets,1,1,1610612745,Houston Rockets,0,0,33,24,57,15,16,31,48,40,88,14,2,16,14,27,28,8,12,95,125
2015,2,21500802,2/11/2016,1610612740,New Orleans Pelicans,0,0,1610612760,Oklahoma City Thunder,1,1,35,37,72,3,13,16,38,50,88,16,8,24,10,44,17,4,9,99,95
2015,2,21500802,2/11/2016,1610612760,Oklahoma City Thunder,1,1,1610612740,New Orleans Pelicans,0,0,33,21,54,12,20,32,45,41,86,19,4,23,17,27,28,13,18,100,121
2016,2,21601218,4/12/2017,1610612739,Cleveland Cavaliers,1,0,1610612761,Toronto Raptors,0,1,18,21,39,10,27,37,28,48,76,17,7,24,11,40,20,8,15,90,83
2016,2,21601218,4/12/2017,1610612761,Toronto Raptors,0,1,1610612739,Cleveland Cavaliers,1,0,32,28,60,8,18,26,40,46,86,10,6,16,14,34,20,5,9,90,98
2015,2,21500531,1/6/2016,1610612740,New Orleans Pelicans,1,0,1610612742,Dallas Mavericks,0,1,27,35,62,7,23,30,34,58,92,16,4,20,18,42,22,7,10,94,91
2015,2,21500531,1/6/2016,1610612742,Dallas Mavericks,0,1,1610612740,New Orleans Pelicans,1,0,30,29,59,7,21,28,37,50,87,19,3,22,14,37,22,7,10,95,100
2015,2,21500429,12/23/2015,1610612737,Atlanta Hawks,1,1,1610612765,Detroit Pistons,0,0,37,32,69,6,14,20,43,46,89,15,5,20,15,33,25,7,15,99,107
2015,2,21500429,12/23/2015,1610612765,Detroit Pistons,0,0,1610612737,Atlanta Hawks,1,1,31,37,68,7,14,21,38,51,89,17,16,33,19,38,18,8,14,100,100
2015,2,21500324,12/9/2015,1610612746,LA Clippers,0,1,1610612749,Milwaukee Bucks,1,0,26,27,53,12,16,28,38,43,81,21,15,36,14,34,27,7,14,97,109
2015,2,21500324,12/9/2015,1610612749,Milwaukee Bucks,1,0,1610612746,LA Clippers,0,1,40,40,80,2,8,10,42,48,90,9,3,12,10,41,26,7,12,97,95
2015,2,21500131,11/13/2015,1610612740,New Orleans Pelicans,0,0,1610612761,Toronto Raptors,1,1,23,36,59,7,16,23,30,52,82,14,6,20,16,38,15,8,15,91,81
2015,2,21500131,11/13/2015,1610612761,Toronto Raptors,1,1,1610612740,New Orleans Pelicans,0,0,25,31,56,9,12,21,34,43,77,23,4,27,16,30,19,10,16,91,100
2015,2,21500035,10/31/2015,1610612740,New Orleans Pelicans,1,0,1610612744,Golden State Warriors,0,1,38,40,78,8,14,22,46,54,100,20,3,23,18,38,22,10,16,105,120
2015,2,21500035,10/31/2015,1610612744,Golden State Warriors,0,1,1610612740,New Orleans Pelicans,1,0,29,25,54,17,13,30,46,38,84,25,10,35,5,36,26,4,10,105,134
2014,2,21400866,2/27/2015,1610612743,Denver Nuggets,1,0,1610612762,Utah Jazz,0,1,20,32,52,8,24,32,28,56,84,18,11,29,23,38,22,13,15,92,82
2014,2,21400866,2/27/2015,1610612762,Utah Jazz,0,1,1610612743,Denver Nuggets,1,0,30,17,47,9,12,21,39,29,68,17,4,21,10,22,24,9,23,91,104
2015,2,21501026,3/18/2016,1610612742,Dallas Mavericks,1,0,1610612744,Golden State Warriors,0,1,32,32,64,9,20,29,41,52,93,21,1,22,14,38,25,8,13,104,112
2015,2,21501026,3/18/2016,1610612744,Golden State Warriors,0,1,1610612742,Dallas Mavericks,1,0,26,31,57,22,16,38,48,47,95,12,2,14,10,37,35,4,13,105,130
2015,2,21500854,2/24/2016,1610612758,Sacramento Kings,1,0,1610612759,San Antonio Spurs,0,1,33,45,78,6,12,18,39,57,96,8,7,15,15,46,27,13,14,102,92
2015,2,21500854,2/24/2016,1610612759,San Antonio Spurs,0,1,1610612758,Sacramento Kings,1,0,36,30,66,8,11,19,44,41,85,12,3,15,7,36,26,13,16,101,108
2015,2,21500756,2/5/2016,1610612752,New York Knicks,1,0,1610612763,Memphis Grizzlies,0,1,20,31,51,10,19,29,30,50,80,15,2,17,16,35,15,8,15,86,85
2015,2,21500756,2/5/2016,1610612763,Memphis Grizzlies,0,1,1610612752,New York Knicks,1,0,29,29,58,4,14,18,33,43,76,21,3,24,8,37,17,2,9,88,91
2015,2,21500712,1/30/2016,1610612758,Sacramento Kings,0,0,1610612763,Memphis Grizzlies,1,1,29,39,68,9,15,24,38,54,92,32,6,38,22,32,16,15,19,107,117
2015,2,21500712,1/30/2016,1610612763,Memphis Grizzlies,1,1,1610612758,Sacramento Kings,0,0,33,28,61,8,10,18,41,38,79,31,6,37,5,37,23,10,13,107,121
2015,2,21500530,1/6/2016,1610612743,Denver Nuggets,0,1,1610612750,Minnesota Timberwolves,1,0,21,40,61,8,12,20,29,52,81,12,5,17,19,35,21,5,11,83,78
2015,2,21500530,1/6/2016,1610612750,Minnesota Timberwolves,1,0,1610612743,Denver Nuggets,0,1,25,37,62,3,8,11,28,45,73,15,5,20,12,35,23,3,11,83,74
2015,2,21500323,12/9/2015,1610612759,San Antonio Spurs,0,0,1610612761,Toronto Raptors,1,1,27,24,51,7,18,25,34,42,76,19,5,24,13,32,23,10,17,90,94
2015,2,21500323,12/9/2015,1610612761,Toronto Raptors,1,1,1610612759,San Antonio Spurs,0,0,34,20,54,3,7,10,37,27,64,20,2,22,5,24,23,10,21,89,97
2015,2,21500225,11/25/2015,1610612740,New Orleans Pelicans,0,1,1610612756,Phoenix Suns,1,0,32,27,59,10,12,22,42,39,81,26,8,34,8,35,20,8,14,102,120
2015,2,21500225,11/25/2015,1610612756,Phoenix Suns,1,0,1610612740,New Orleans Pelicans,0,1,34,36,70,10,16,26,44,52,96,16,4,20,14,41,25,4,12,103,114
2015,2,21500034,10/31/2015,1610612752,New York Knicks,0,1,1610612764,Washington Wizards,1,0,32,35,67,9,10,19,41,45,86,26,6,32,15,32,21,9,19,106,117
2015,2,21500034,10/31/2015,1610612764,Washington Wizards,1,0,1610612752,New York Knicks,0,1,32,36,68,6,16,22,38,52,90,28,5,33,19,37,17,8,19,106,110
2016,2,21600651,1/21/2017,1610612764,Washington Wizards,0,0,1610612765,Detroit Pistons,1,1,31,34,65,8,18,26,39,52,91,26,7,33,15,38,23,9,11,104,112
2016,2,21600651,1/21/2017,1610612765,Detroit Pistons,1,1,1610612764,Washington Wizards,0,0,32,27,59,11,17,28,43,44,87,16,6,22,14,35,25,12,20,103,113
2015,2,21500918,3/4/2016,1610612762,Utah Jazz,0,0,1610612763,Memphis Grizzlies,1,1,27,29,56,5,14,19,32,43,75,19,10,29,12,37,21,8,17,90,88
2015,2,21500918,3/4/2016,1610612763,Memphis Grizzlies,1,1,1610612762,Utah Jazz,0,0,33,30,63,4,14,18,37,44,81,16,3,19,11,34,14,6,11,90,94
2015,2,21500664,1/24/2016,1610612751,Brooklyn Nets,1,1,1610612760,Oklahoma City Thunder,0,0,37,40,77,8,9,17,45,49,94,18,7,25,21,33,24,7,11,97,116
2015,2,21500664,1/24/2016,1610612760,Oklahoma City Thunder,0,0,1610612751,Brooklyn Nets,1,1,35,32,67,8,18,26,43,50,93,12,7,19,19,34,20,10,14,98,106
2015,2,21500529,1/6/2016,1610612751,Brooklyn Nets,1,0,1610612761,Toronto Raptors,0,1,26,36,62,5,11,16,31,47,78,7,5,12,9,41,18,12,19,94,74
2015,2,21500529,1/6/2016,1610612761,Toronto Raptors,0,1,1610612751,Brooklyn Nets,1,0,31,27,58,4,18,22,35,45,80,17,1,18,12,34,16,8,17,93,91
2015,2,21500428,12/23/2015,1610612742,Dallas Mavericks,0,1,1610612751,Brooklyn Nets,1,0,29,19,48,16,18,34,45,37,82,13,2,15,8,30,27,9,18,99,119
2015,2,21500428,12/23/2015,1610612751,Brooklyn Nets,1,0,1610612742,Dallas Mavericks,0,1,41,41,82,10,9,19,51,50,101,6,8,14,20,34,32,3,11,98,118
2015,2,21500322,12/9/2015,1610612763,Memphis Grizzlies,0,1,1610612765,Detroit Pistons,1,0,37,36,73,4,11,15,41,47,88,7,6,13,20,30,23,9,17,92,93
2015,2,21500322,12/9/2015,1610612765,Detroit Pistons,1,0,1610612763,Memphis Grizzlies,0,1,29,29,58,8,21,29,37,50,87,10,5,15,15,38,17,4,13,92,92
2015,2,21500130,11/13/2015,1610612739,Cleveland Cavaliers,0,1,1610612752,New York Knicks,1,0,27,23,50,6,22,28,33,45,78,18,13,31,14,39,12,7,12,91,90
2015,2,21500130,11/13/2015,1610612752,New York Knicks,1,0,1610612739,Cleveland Cavaliers,0,1,20,32,52,9,18,27,29,50,79,17,4,21,14,37,16,6,15,91,84
2015,2,21500033,10/31/2015,1610612754,Indiana Pacers,1,0,1610612762,Utah Jazz,0,1,24,29,53,4,13,17,28,42,70,16,5,21,11,34,10,13,24,92,76
2015,2,21500033,10/31/2015,1610612762,Utah Jazz,0,1,1610612754,Indiana Pacers,1,0,33,40,73,6,9,15,39,49,88,13,5,18,22,29,15,8,17,94,97
2015,2,21501142,4/2/2016,1610612748,Miami Heat,0,0,1610612757,Portland Trail Blazers,1,1,28,41,69,6,13,19,34,54,88,19,8,27,18,39,16,9,14,98,93
2015,2,21501142,4/2/2016,1610612757,Portland Trail Blazers,1,1,1610612748,Miami Heat,0,0,31,33,64,10,5,15,41,38,79,18,5,23,9,32,21,9,16,97,110
2015,2,21500974,3/12/2016,1610612737,Atlanta Hawks,1,1,1610612763,Memphis Grizzlies,0,0,25,25,50,11,23,34,36,48,84,12,5,17,10,42,27,10,11,93,95
2015,2,21500974,3/12/2016,1610612763,Memphis Grizzlies,0,0,1610612737,Atlanta Hawks,1,1,27,45,72,6,17,23,33,62,95,11,3,14,25,40,15,9,16,93,83
2021,2,22100265,11/23/2021,1610612743,Denver Nuggets,0,0,1610612757,Portland Trail Blazers,1,1,23,22,45,15,18,33,38,40,78,9,2,11,9,32,26,12,19,92,100
2021,2,22100265,11/23/2021,1610612757,Portland Trail Blazers,1,1,1610612743,Denver Nuggets,0,0,30,19,49,15,24,39,45,43,88,14,6,20,14,31,25,6,9,92,119
2015,2,21500853,2/24/2016,1610612743,Denver Nuggets,0,1,1610612746,LA Clippers,1,0,28,38,66,6,18,24,34,56,90,13,4,17,20,38,18,13,18,97,87
2015,2,21500853,2/24/2016,1610612746,LA Clippers,1,0,1610612743,Denver Nuggets,0,1,17,22,39,13,33,46,30,55,85,8,6,14,12,47,19,11,17,97,81
2015,2,21500711,1/30/2016,1610612745,Houston Rockets,1,0,1610612764,Washington Wizards,0,1,24,27,51,17,18,35,41,45,86,23,10,33,11,39,24,6,10,101,122
2015,2,21500711,1/30/2016,1610612764,Washington Wizards,0,1,1610612745,Houston Rockets,1,0,34,20,54,11,21,32,45,41,86,22,8,30,15,29,30,8,13,102,123
2015,2,21500613,1/17/2016,1610612743,Denver Nuggets,1,1,1610612754,Indiana Pacers,0,0,36,29,65,10,16,26,46,45,91,27,11,38,25,26,25,10,17,101,129
2015,2,21500613,1/17/2016,1610612754,Indiana Pacers,0,0,1610612743,Denver Nuggets,1,1,39,23,62,9,11,20,48,34,82,21,9,30,11,27,27,12,15,101,126
2015,2,21500528,1/6/2016,1610612738,Boston Celtics,1,0,1610612765,Detroit Pistons,0,1,28,35,63,6,22,28,34,57,91,20,7,27,19,39,23,4,10,96,94
2015,2,21500528,1/6/2016,1610612765,Detroit Pistons,0,1,1610612738,Boston Celtics,1,0,23,24,47,10,17,27,33,41,74,23,13,36,14,34,18,5,18,96,99
2015,2,21500427,12/23/2015,1610612763,Memphis Grizzlies,0,0,1610612764,Washington Wizards,1,1,30,25,55,3,14,17,33,39,72,22,10,32,9,35,12,3,10,88,91
2015,2,21500427,12/23/2015,1610612764,Washington Wizards,1,1,1610612763,Memphis Grizzlies,0,0,26,31,57,11,14,25,37,45,82,15,4,19,19,29,26,13,16,88,100
2015,2,21500321,12/9/2015,1610612745,Houston Rockets,0,1,1610612764,Washington Wizards,1,0,28,22,50,12,21,33,40,43,83,17,8,25,10,38,23,8,19,107,109
2015,2,21500321,12/9/2015,1610612764,Washington Wizards,1,0,1610612745,Houston Rockets,0,1,34,30,64,5,20,25,39,50,89,20,4,24,13,38,20,8,18,105,103
2015,2,21500224,11/25/2015,1610612742,Dallas Mavericks,0,0,1610612759,San Antonio Spurs,1,1,28,33,61,6,16,22,34,49,83,9,3,12,10,41,21,6,13,91,83
2015,2,21500224,11/25/2015,1610612759,San Antonio Spurs,1,1,1610612742,Dallas Mavericks,0,0,25,28,53,8,20,28,33,48,81,14,5,19,14,37,23,7,14,91,88
2016,2,21601217,4/12/2017,1610612753,Orlando Magic,1,1,1610612765,Detroit Pistons,0,0,29,33,62,13,12,25,42,45,87,16,1,17,8,37,27,6,11,99,113
2016,2,21601217,4/12/2017,1610612765,Detroit Pistons,0,0,1610612753,Orlando Magic,1,1,30,40,70,11,25,36,41,65,106,16,12,28,24,48,20,7,8,100,109
2015,2,21500032,10/30/2015,1610612756,Phoenix Suns,1,1,1610612757,Portland Trail Blazers,0,0,33,32,65,4,14,18,37,46,83,32,10,42,18,32,17,9,20,107,110
2015,2,21500032,10/30/2015,1610612757,Portland Trail Blazers,0,0,1610612756,Phoenix Suns,1,1,25,37,62,9,15,24,34,52,86,15,4,19,11,44,17,13,23,105,92
2015,2,21501222,4/13/2016,1610612741,Chicago Bulls,1,1,1610612755,Philadelphia 76ers,0,0,24,35,59,15,9,24,39,44,83,22,5,27,17,29,27,10,17,96,115
2015,2,21501222,4/13/2016,1610612755,Philadelphia 76ers,0,0,1610612741,Chicago Bulls,1,1,20,26,46,17,18,35,37,44,81,14,4,18,6,40,28,8,13,97,105
2015,2,21501025,3/18/2016,1610612740,New Orleans Pelicans,1,0,1610612757,Portland Trail Blazers,0,1,30,32,62,10,11,21,40,43,83,22,6,28,6,40,23,4,7,97,112
2015,2,21501025,3/18/2016,1610612757,Portland Trail Blazers,0,1,1610612740,New Orleans Pelicans,1,0,27,24,51,9,18,27,36,42,78,36,4,40,12,32,17,7,13,99,117
2016,2,21600187,11/19/2016,1610612742,Dallas Mavericks,0,0,1610612753,Orlando Magic,1,1,13,36,49,13,15,28,26,51,77,22,5,27,9,44,13,6,14,95,87
2016,2,21600187,11/19/2016,1610612753,Orlando Magic,1,1,1610612742,Dallas Mavericks,0,0,26,31,57,8,13,21,34,44,78,19,3,22,15,30,17,8,20,95,95
2015,2,21500710,1/30/2016,1610612740,New Orleans Pelicans,1,1,1610612751,Brooklyn Nets,0,0,32,34,66,11,16,27,43,50,93,8,2,10,16,35,24,6,10,92,105
2015,2,21500710,1/30/2016,1610612751,Brooklyn Nets,0,0,1610612740,New Orleans Pelicans,1,1,31,33,64,9,11,20,40,44,84,14,9,23,12,36,23,6,10,93,103
2015,2,21500663,1/23/2016,1610612754,Indiana Pacers,0,0,1610612758,Sacramento Kings,1,1,29,38,67,7,12,19,36,50,86,18,7,25,10,45,18,7,12,98,97
2015,2,21500663,1/23/2016,1610612758,Sacramento Kings,1,1,1610612754,Indiana Pacers,0,0,33,36,69,5,11,16,38,47,85,27,9,36,18,35,19,7,15,100,108
2014,2,21400865,2/27/2015,1610612740,New Orleans Pelicans,1,1,1610612748,Miami Heat,0,0,33,27,60,6,10,16,39,37,76,20,7,27,11,27,26,3,11,89,104
2014,2,21400865,2/27/2015,1610612748,Miami Heat,0,0,1610612740,New Orleans Pelicans,1,1,33,30,63,8,13,21,41,43,84,12,4,16,12,33,21,3,7,90,102
2015,2,21500527,1/6/2016,1610612739,Cleveland Cavaliers,0,1,1610612764,Washington Wizards,1,0,36,24,60,12,17,29,48,41,89,13,6,19,15,30,16,7,12,94,121
2015,2,21500527,1/6/2016,1610612764,Washington Wizards,1,0,1610612739,Cleveland Cavaliers,0,1,28,24,52,14,10,24,42,34,76,17,10,27,7,31,31,9,13,95,115
2015,2,21500426,12/23/2015,1610612745,Houston Rockets,0,0,1610612753,Orlando Magic,1,1,34,20,54,7,22,29,41,42,83,12,5,17,12,35,19,5,11,92,101
2015,2,21500426,12/23/2015,1610612753,Orlando Magic,1,1,1610612745,Houston Rockets,0,0,37,31,68,7,9,16,44,40,84,9,4,13,13,27,26,5,13,92,104
2015,2,21500320,12/9/2015,1610612748,Miami Heat,0,0,1610612766,Charlotte Hornets,1,1,23,31,54,6,15,21,29,46,75,17,7,24,10,39,17,9,18,95,81
2015,2,21500320,12/9/2015,1610612766,Charlotte Hornets,1,1,1610612748,Miami Heat,0,0,29,25,54,11,16,27,40,41,81,8,9,17,7,37,27,3,11,94,99
2015,2,21500129,11/13/2015,1610612737,Atlanta Hawks,0,0,1610612738,Boston Celtics,1,1,30,26,56,6,14,20,36,40,76,15,5,20,8,34,26,10,17,94,93
2015,2,21500129,11/13/2015,1610612738,Boston Celtics,1,1,1610612737,Atlanta Hawks,0,0,31,39,70,11,22,33,42,61,103,11,1,12,25,36,27,3,10,95,106
2015,2,21500031,10/30/2015,1610612747,Los Angeles Lakers,0,0,1610612758,Sacramento Kings,1,1,30,25,55,11,23,34,41,48,89,21,6,27,11,40,20,6,19,111,114
2015,2,21500031,10/30/2015,1610612758,Sacramento Kings,1,1,1610612747,Los Angeles Lakers,0,0,46,33,79,6,16,22,52,49,101,22,8,30,19,32,26,7,14,109,132
2014,2,21400864,2/27/2015,1610612746,LA Clippers,0,1,1610612763,Memphis Grizzlies,1,0,27,25,52,9,17,26,36,42,78,16,12,28,15,33,20,6,12,90,97
2014,2,21400864,2/27/2015,1610612763,Memphis Grizzlies,1,0,1610612746,LA Clippers,0,1,30,45,75,3,9,12,33,54,87,10,5,15,19,38,19,9,16,90,79
2015,2,21501082,3/26/2016,1610612751,Brooklyn Nets,1,1,1610612754,Indiana Pacers,0,0,37,29,66,5,6,11,42,35,77,31,5,36,10,27,24,15,21,105,120
2015,2,21501082,3/26/2016,1610612754,Indiana Pacers,0,0,1610612751,Brooklyn Nets,1,1,26,27,53,11,13,24,37,40,77,25,5,30,8,36,24,13,20,105,110
2016,2,21601216,4/11/2017,1610612756,Phoenix Suns,0,0,1610612758,Sacramento Kings,1,1,33,46,79,8,22,30,41,68,109,14,10,24,22,50,19,7,9,109,104
2016,2,21601216,4/11/2017,1610612758,Sacramento Kings,1,1,1610612756,Phoenix Suns,0,0,34,30,64,9,10,19,43,40,83,34,9,43,9,34,28,8,13,107,129
2015,2,21500852,2/24/2016,1610612742,Dallas Mavericks,1,0,1610612760,Oklahoma City Thunder,0,1,26,32,58,9,19,28,35,51,86,24,6,30,14,39,26,5,10,96,103
2015,2,21500852,2/24/2016,1610612760,Oklahoma City Thunder,0,1,1610612742,Dallas Mavericks,1,0,31,25,56,12,21,33,43,46,89,18,4,22,17,32,28,10,14,96,116
2015,2,21500709,1/30/2016,1610612743,Denver Nuggets,0,0,1610612754,Indiana Pacers,1,1,36,33,69,4,14,18,40,47,87,21,4,25,13,35,24,6,19,106,105
2015,2,21500709,1/30/2016,1610612754,Indiana Pacers,1,1,1610612743,Denver Nuggets,0,0,35,38,73,9,18,27,44,56,100,12,4,16,18,40,26,10,15,106,109
2016,2,21600650,1/21/2017,1610612738,Boston Celtics,1,0,1610612757,Portland Trail Blazers,0,1,29,28,57,13,22,35,42,50,92,26,5,31,21,30,26,12,21,108,123
2016,2,21600650,1/21/2017,1610612757,Portland Trail Blazers,0,1,1610612738,Boston Celtics,1,0,33,34,67,10,15,25,43,49,92,31,5,36,15,38,26,6,14,109,127
2015,2,21500425,12/23/2015,1610612754,Indiana Pacers,1,0,1610612758,Sacramento Kings,0,1,29,28,57,12,20,32,41,48,89,12,8,20,9,44,20,6,11,102,106
2015,2,21500425,12/23/2015,1610612758,Sacramento Kings,0,1,1610612754,Indiana Pacers,1,0,42,24,66,4,19,23,46,43,89,12,4,16,11,33,28,14,16,103,108
2015,2,21500223,11/25/2015,1610612751,Brooklyn Nets,0,0,1610612760,Oklahoma City Thunder,1,1,40,41,81,3,10,13,43,51,94,10,2,12,13,40,20,11,17,104,99
2015,2,21500223,11/25/2015,1610612760,Oklahoma City Thunder,1,1,1610612751,Brooklyn Nets,0,0,31,23,54,10,14,24,41,37,78,18,3,21,5,34,26,10,19,104,110
2015,2,21500128,11/13/2015,1610612753,Orlando Magic,1,1,1610612762,Utah Jazz,0,0,22,27,49,10,17,27,32,44,76,28,3,31,16,30,20,14,22,98,102
2015,2,21500128,11/13/2015,1610612762,Utah Jazz,0,0,1610612753,Orlando Magic,1,1,26,36,62,8,17,25,34,53,87,17,6,23,17,39,24,11,17,98,93
2015,2,21500030,10/30/2015,1610612744,Golden State Warriors,0,1,1610612745,Houston Rockets,1,0,34,33,67,9,17,26,43,50,93,17,8,25,13,41,26,3,8,100,112
2015,2,21500030,10/30/2015,1610612745,Houston Rockets,1,0,1610612744,Golden State Warriors,0,1,25,34,59,5,18,23,30,52,82,27,9,36,16,40,19,9,17,100,92
2020,2,22000059,12/30/2020,1610612742,Dallas Mavericks,1,0,1610612766,Charlotte Hornets,0,1,22,23,45,12,30,42,34,53,87,19,14,33,17,42,24,6,14,102,99
2020,2,22000059,12/30/2020,1610612766,Charlotte Hornets,0,1,1610612742,Dallas Mavericks,1,0,28,22,50,15,19,34,43,41,84,17,4,21,15,27,30,10,24,102,118
2016,2,21601215,4/11/2017,1610612740,New Orleans Pelicans,0,0,1610612747,Los Angeles Lakers,1,1,30,27,57,7,15,22,37,42,79,15,5,20,7,39,29,15,17,100,96
2016,2,21601215,4/11/2017,1610612747,Los Angeles Lakers,1,1,1610612740,New Orleans Pelicans,0,0,34,32,66,8,14,22,42,46,88,16,6,22,11,37,24,5,13,100,108
2016,2,21600649,1/20/2017,1610612747,Los Angeles Lakers,1,1,1610612754,Indiana Pacers,0,0,27,27,54,14,19,33,41,46,87,12,3,15,17,31,27,17,24,99,108
2016,2,21600649,1/20/2017,1610612754,Indiana Pacers,0,0,1610612747,Los Angeles Lakers,1,1,25,32,57,9,14,23,34,46,80,18,7,25,13,36,24,15,21,101,95
2015,2,21500851,2/24/2016,1610612747,Los Angeles Lakers,0,0,1610612763,Memphis Grizzlies,1,1,22,27,49,17,22,39,39,49,88,24,9,33,16,39,16,6,7,95,119
2015,2,21500851,2/24/2016,1610612763,Memphis Grizzlies,1,1,1610612747,Los Angeles Lakers,0,0,35,23,58,13,14,27,48,37,85,19,10,29,12,31,26,5,9,96,128
2016,2,21600186,11/19/2016,1610612748,Miami Heat,0,1,1610612764,Washington Wizards,1,0,30,28,58,13,14,27,43,42,85,15,11,26,20,27,21,9,17,94,114
2016,2,21600186,11/19/2016,1610612764,Washington Wizards,1,0,1610612748,Miami Heat,0,1,31,31,62,11,16,27,42,47,89,16,6,22,17,34,22,6,12,95,111
2015,2,21500755,2/5/2016,1610612738,Boston Celtics,0,1,1610612739,Cleveland Cavaliers,1,0,31,37,68,7,13,20,38,50,88,21,4,25,15,37,21,8,15,99,104
2015,2,21500755,2/5/2016,1610612739,Cleveland Cavaliers,1,0,1610612738,Boston Celtics,0,1,29,28,57,8,22,30,37,50,87,21,14,35,18,39,21,6,15,99,103
2015,2,21500526,1/6/2016,1610612753,Orlando Magic,1,0,1610612754,Indiana Pacers,0,1,26,22,48,6,25,31,32,47,79,16,1,17,12,35,17,11,17,93,86
2015,2,21500526,1/6/2016,1610612754,Indiana Pacers,0,1,1610612753,Orlando Magic,1,0,26,28,54,6,16,22,32,44,76,25,4,29,13,33,19,7,16,94,95
2015,2,21500424,12/23/2015,1610612739,Cleveland Cavaliers,1,1,1610612752,New York Knicks,0,0,27,34,61,5,17,22,32,51,83,22,3,25,15,38,23,5,8,87,91
2015,2,21500424,12/23/2015,1610612752,New York Knicks,0,0,1610612739,Cleveland Cavaliers,1,1,27,39,66,5,11,16,32,50,82,15,1,16,15,36,19,6,11,88,84
2015,2,21500319,12/9/2015,1610612738,Boston Celtics,1,1,1610612741,Chicago Bulls,0,0,33,36,69,5,18,23,38,54,92,24,4,28,19,36,22,7,12,99,105
2015,2,21500319,12/9/2015,1610612741,Chicago Bulls,0,0,1610612738,Boston Celtics,1,1,33,37,70,6,15,21,39,52,91,16,7,23,22,33,22,10,18,100,100
2015,2,21500222,11/25/2015,1610612737,Atlanta Hawks,0,0,1610612750,Minnesota Timberwolves,1,1,23,28,51,8,23,31,31,51,82,25,10,35,17,38,14,9,14,98,95
2015,2,21500222,11/25/2015,1610612750,Minnesota Timberwolves,1,1,1610612737,Atlanta Hawks,0,0,25,36,61,9,12,21,34,48,82,22,7,29,13,40,22,10,13,96,99
2015,2,21500127,11/13/2015,1610612750,Minnesota Timberwolves,0,0,1610612754,Indiana Pacers,1,1,35,28,63,7,13,20,42,41,83,12,1,13,11,31,16,9,16,96,103
2015,2,21500127,11/13/2015,1610612754,Indiana Pacers,1,1,1610612750,Minnesota Timberwolves,0,0,31,30,61,10,15,25,41,45,86,15,8,23,13,34,23,5,11,95,107
2015,2,21501221,4/13/2016,1610612737,Atlanta Hawks,0,0,1610612764,Washington Wizards,1,1,21,30,51,11,19,30,32,49,81,23,8,31,12,41,22,14,23,108,98
2015,2,21501221,4/13/2016,1610612764,Washington Wizards,1,1,1610612737,Atlanta Hawks,0,0,33,27,60,9,19,28,42,46,88,16,14,30,14,39,25,13,19,109,109
2015,2,21501141,4/2/2016,1610612743,Denver Nuggets,1,0,1610612758,Sacramento Kings,0,1,31,32,63,9,20,29,40,52,92,17,7,24,18,37,27,4,10,96,106
2015,2,21501141,4/2/2016,1610612758,Sacramento Kings,0,1,1610612743,Denver Nuggets,1,0,33,34,67,8,13,21,41,47,88,25,6,31,14,37,27,3,7,96,115
2015,2,21500917,3/4/2016,1610612739,Cleveland Cavaliers,1,1,1610612764,Washington Wizards,0,0,30,33,63,12,15,27,42,48,90,12,4,16,11,40,24,2,9,97,108
2015,2,21500917,3/4/2016,1610612764,Washington Wizards,0,0,1610612739,Cleveland Cavaliers,1,1,29,32,61,3,17,20,32,49,81,16,8,24,11,41,14,9,16,96,83
2015,2,21500850,2/24/2016,1610612741,Chicago Bulls,1,1,1610612764,Washington Wizards,0,0,36,29,65,8,15,23,44,44,88,13,3,16,11,34,26,11,16,100,109
2015,2,21500850,2/24/2016,1610612764,Washington Wizards,0,0,1610612741,Chicago Bulls,1,1,29,33,62,9,19,28,38,52,90,19,7,26,13,45,19,6,11,99,104
2015,2,21500801,2/11/2016,1610612749,Milwaukee Bucks,1,1,1610612764,Washington Wizards,0,0,32,36,68,4,10,14,36,46,82,23,9,32,18,32,24,8,19,98,99
2015,2,21500801,2/11/2016,1610612764,Washington Wizards,0,0,1610612749,Milwaukee Bucks,1,1,28,28,56,6,26,32,34,54,88,18,6,24,14,43,25,10,14,99,92
2015,2,21500754,2/5/2016,1610612751,Brooklyn Nets,1,1,1610612758,Sacramento Kings,0,0,30,28,58,18,10,28,48,38,86,14,1,15,12,27,29,15,22,102,128
2015,2,21500754,2/5/2016,1610612758,Sacramento Kings,0,0,1610612751,Brooklyn Nets,1,1,37,26,63,8,18,26,45,44,89,21,1,22,8,36,30,5,11,102,119
2015,2,21500708,1/30/2016,1610612761,Toronto Raptors,1,1,1610612765,Detroit Pistons,0,0,32,32,64,4,10,14,36,42,78,35,12,47,17,30,12,10,16,98,111
2015,2,21500708,1/30/2016,1610612765,Detroit Pistons,0,0,1610612761,Toronto Raptors,1,1,30,28,58,9,20,29,39,48,87,20,14,34,17,38,9,9,12,99,107
2015,2,21500612,1/17/2016,1610612742,Dallas Mavericks,0,0,1610612759,San Antonio Spurs,1,1,23,35,58,6,17,23,29,52,81,19,6,25,7,48,20,7,13,99,83
2015,2,21500612,1/17/2016,1610612759,San Antonio Spurs,1,1,1610612742,Dallas Mavericks,0,0,37,33,70,5,15,20,42,48,90,23,5,28,9,41,22,4,7,100,112
2015,2,21500423,12/23/2015,1610612738,Boston Celtics,0,1,1610612766,Charlotte Hornets,1,0,29,27,56,7,22,29,36,49,85,23,3,26,13,36,25,6,14,98,102
2015,2,21500423,12/23/2015,1610612766,Charlotte Hornets,1,0,1610612738,Boston Celtics,0,1,21,32,53,8,20,28,29,52,81,23,9,32,15,40,19,9,17,99,89
2015,2,21500221,11/25/2015,1610612749,Milwaukee Bucks,1,0,1610612758,Sacramento Kings,0,1,29,28,57,13,18,31,42,46,88,21,6,27,15,35,30,9,11,98,118
2015,2,21500221,11/25/2015,1610612758,Sacramento Kings,0,1,1610612749,Milwaukee Bucks,1,0,34,20,54,10,13,23,44,33,77,31,6,37,7,29,23,7,9,96,129
2015,2,21500126,11/12/2015,1610612746,LA Clippers,0,0,1610612756,Phoenix Suns,1,1,31,33,64,9,17,26,40,50,90,15,13,28,16,40,17,10,15,101,104
2015,2,21500126,11/12/2015,1610612756,Phoenix Suns,1,1,1610612746,LA Clippers,0,0,30,23,53,14,16,30,44,39,83,16,5,21,13,29,22,13,21,102,118
2015,2,21500029,10/30/2015,1610612743,Denver Nuggets,1,0,1610612750,Minnesota Timberwolves,0,1,24,46,70,5,20,25,29,66,95,15,5,20,24,43,15,7,15,97,78
2015,2,21500029,10/30/2015,1610612750,Minnesota Timberwolves,0,1,1610612743,Denver Nuggets,1,0,28,32,60,2,9,11,30,41,71,33,8,41,8,36,18,7,18,97,95
2014,2,21400863,2/27/2015,1610612745,Houston Rockets,1,1,1610612751,Brooklyn Nets,0,0,30,22,52,9,23,32,39,45,84,15,2,17,12,34,26,8,14,96,102
2014,2,21400863,2/27/2015,1610612751,Brooklyn Nets,0,0,1610612745,Houston Rockets,1,1,34,34,68,4,13,17,38,47,85,18,2,20,15,34,17,9,17,95,98
2016,2,21601214,4/11/2017,1610612742,Dallas Mavericks,1,0,1610612743,Denver Nuggets,0,1,23,25,48,12,28,40,35,53,88,9,2,11,9,44,24,7,13,97,91
2015,2,21501140,4/2/2016,1610612759,San Antonio Spurs,1,1,1610612761,Toronto Raptors,0,0,30,27,57,5,15,20,35,42,77,27,3,30,16,28,28,8,15,90,102
2015,2,21501140,4/2/2016,1610612761,Toronto Raptors,0,0,1610612759,San Antonio Spurs,1,1,34,28,62,6,12,18,40,40,80,9,1,10,8,33,18,11,13,92,95
2015,2,21501024,3/18/2016,1610612745,Houston Rockets,1,1,1610612750,Minnesota Timberwolves,0,0,37,19,56,11,18,29,48,37,85,9,5,14,15,24,31,14,17,96,116
2015,2,21501024,3/18/2016,1610612750,Minnesota Timberwolves,0,0,1610612745,Houston Rockets,1,1,37,32,69,6,10,16,43,42,85,19,5,24,14,30,30,9,12,95,111
2015,2,21500973,3/12/2016,1610612742,Dallas Mavericks,1,0,1610612754,Indiana Pacers,0,1,33,30,63,8,14,22,41,44,85,15,3,18,11,34,30,10,14,97,105
2015,2,21500973,3/12/2016,1610612754,Indiana Pacers,0,1,1610612742,Dallas Mavericks,1,0,29,24,53,9,19,28,38,43,81,27,2,29,11,34,24,7,14,98,112
2015,2,21500916,3/4/2016,1610612757,Portland Trail Blazers,0,0,1610612761,Toronto Raptors,1,1,28,28,56,11,16,27,39,44,83,26,9,35,16,32,14,5,12,97,115
2015,2,21500916,3/4/2016,1610612761,Toronto Raptors,1,1,1610612757,Portland Trail Blazers,0,0,28,27,55,6,6,12,34,33,67,43,11,54,11,27,12,5,13,95,117
2015,2,21500800,2/10/2016,1610612745,Houston Rockets,0,0,1610612757,Portland Trail Blazers,1,1,26,17,43,11,23,34,37,40,77,18,16,34,10,39,23,11,20,102,103
2015,2,21500800,2/10/2016,1610612757,Portland Trail Blazers,1,1,1610612745,Houston Rockets,0,0,33,28,61,8,20,28,41,48,89,26,8,34,17,33,21,6,13,103,116
2016,2,21601214,4/11/2017,1610612743,Denver Nuggets,0,1,1610612742,Dallas Mavericks,1,0,23,19,42,18,24,42,41,43,84,9,5,14,12,35,31,8,17,96,109
2016,2,21600185,11/19/2016,1610612740,New Orleans Pelicans,1,1,1610612766,Charlotte Hornets,0,0,29,33,62,14,22,36,43,55,98,21,4,25,12,45,27,7,12,109,121
2015,2,21500662,1/23/2016,1610612747,Los Angeles Lakers,0,0,1610612757,Portland Trail Blazers,1,1,27,25,52,7,10,17,34,35,69,28,4,32,9,28,14,12,19,94,103
2015,2,21500662,1/23/2016,1610612757,Portland Trail Blazers,1,1,1610612747,Los Angeles Lakers,0,0,37,25,62,10,21,31,47,46,93,17,5,22,18,28,26,4,9,95,121
2015,2,21500611,1/17/2016,1610612748,Miami Heat,0,0,1610612760,Oklahoma City Thunder,1,1,26,32,58,4,10,14,30,42,72,10,1,11,10,33,12,11,21,90,74
2015,2,21500611,1/17/2016,1610612760,Oklahoma City Thunder,1,1,1610612748,Miami Heat,0,0,33,33,66,7,15,22,40,48,88,12,0,12,17,31,24,6,14,91,99
2021,2,22100264,11/23/2021,1610612747,Los Angeles Lakers,0,0,1610612752,New York Knicks,1,1,23,32,55,11,25,36,34,57,91,21,9,30,17,45,23,7,12,98,100
2021,2,22100264,11/23/2021,1610612752,New York Knicks,1,1,1610612747,Los Angeles Lakers,0,0,22,26,48,15,19,34,37,45,82,17,4,21,9,38,23,8,17,98,106
2016,2,21600185,11/19/2016,1610612766,Charlotte Hornets,0,0,1610612740,New Orleans Pelicans,1,1,25,29,54,15,28,43,40,57,97,21,7,28,15,46,29,9,15,109,116
2015,2,21500525,1/6/2016,1610612748,Miami Heat,1,0,1610612752,New York Knicks,0,1,35,30,65,2,15,17,37,45,82,14,1,15,16,30,14,6,13,87,90
2015,2,21500525,1/6/2016,1610612752,New York Knicks,0,1,1610612748,Miami Heat,1,0,36,26,62,3,5,8,39,31,70,17,1,18,6,25,15,2,13,87,98
2015,2,21500422,12/22/2015,1610612743,Denver Nuggets,1,0,1610612747,Los Angeles Lakers,0,1,32,33,65,9,16,25,41,49,90,16,3,19,19,31,26,6,12,95,107
2015,2,21500422,12/22/2015,1610612747,Los Angeles Lakers,0,1,1610612743,Denver Nuggets,1,0,33,25,58,7,19,26,40,44,84,24,8,32,14,33,17,2,11,93,111
2015,2,21500318,12/8/2015,1610612758,Sacramento Kings,1,1,1610612762,Utah Jazz,0,0,33,16,49,10,18,28,43,34,77,18,6,24,11,26,29,7,16,94,114
2015,2,21500318,12/8/2015,1610612762,Utah Jazz,0,0,1610612758,Sacramento Kings,1,1,23,33,56,15,21,36,38,54,92,15,7,22,22,35,23,6,12,93,106
2015,2,21500220,11/25/2015,1610612745,Houston Rockets,1,0,1610612763,Memphis Grizzlies,0,1,20,17,37,10,24,34,30,41,71,23,4,27,8,36,19,8,20,97,93
2015,2,21500220,11/25/2015,1610612763,Memphis Grizzlies,0,1,1610612745,Houston Rockets,1,0,36,28,64,3,13,16,39,41,80,21,2,23,11,32,21,14,17,96,102
2015,2,21500125,11/12/2015,1610612744,Golden State Warriors,0,1,1610612750,Minnesota Timberwolves,1,0,30,21,51,18,20,38,48,41,89,15,1,16,9,33,34,4,11,99,129
2015,2,21500125,11/12/2015,1610612750,Minnesota Timberwolves,1,0,1610612744,Golden State Warriors,0,1,40,38,78,3,6,9,43,44,87,27,9,36,19,29,21,8,13,98,116
2014,2,21400862,2/27/2015,1610612741,Chicago Bulls,1,1,1610612750,Minnesota Timberwolves,0,0,28,37,65,9,22,31,37,59,96,13,3,16,25,38,24,7,10,91,96
2014,2,21400862,2/27/2015,1610612750,Minnesota Timberwolves,0,0,1610612741,Chicago Bulls,1,1,31,32,63,2,12,14,33,44,77,21,10,31,14,32,17,5,13,90,89
2015,2,21501220,4/13/2016,1610612739,Cleveland Cavaliers,1,0,1610612765,Detroit Pistons,0,1,39,40,79,7,11,18,46,51,97,11,4,15,14,38,21,5,10,99,110
2015,2,21501220,4/13/2016,1610612765,Detroit Pistons,0,1,1610612739,Cleveland Cavaliers,1,0,21,31,52,16,17,33,37,48,85,22,6,28,14,37,24,4,12,99,112
2016,2,21600648,1/20/2017,1610612742,Dallas Mavericks,1,0,1610612762,Utah Jazz,0,1,31,33,64,8,15,23,39,48,87,21,7,28,13,39,21,8,13,98,107
2016,2,21600648,1/20/2017,1610612762,Utah Jazz,0,1,1610612742,Dallas Mavericks,1,0,30,30,60,8,15,23,38,45,83,28,11,39,18,34,17,4,16,98,112
2016,2,21600184,11/19/2016,1610612745,Houston Rockets,1,1,1610612762,Utah Jazz,0,0,30,32,62,12,20,32,42,52,94,15,5,20,14,41,28,3,5,93,111
2015,2,21500753,2/5/2016,1610612755,Philadelphia 76ers,0,0,1610612764,Washington Wizards,1,1,28,33,61,9,17,26,37,50,87,11,3,14,10,41,23,7,15,98,94
2015,2,21500753,2/5/2016,1610612764,Washington Wizards,1,1,1610612755,Philadelphia 76ers,0,0,38,24,62,6,16,22,44,40,84,12,8,20,10,32,26,7,15,99,106
2015,2,21500219,11/25/2015,1610612739,Cleveland Cavaliers,0,0,1610612761,Toronto Raptors,1,1,22,31,53,14,15,29,36,46,82,13,3,16,12,35,22,8,10,88,99
2015,2,21500219,11/25/2015,1610612761,Toronto Raptors,1,1,1610612739,Cleveland Cavaliers,0,0,29,25,54,11,14,25,40,39,79,12,10,22,10,36,14,4,9,87,103
2015,2,21500028,10/30/2015,1610612751,Brooklyn Nets,0,0,1610612759,San Antonio Spurs,1,1,26,35,61,5,11,16,31,46,77,8,7,15,4,45,17,7,15,94,75
2015,2,21500028,10/30/2015,1610612759,San Antonio Spurs,1,1,1610612751,Brooklyn Nets,0,0,31,33,64,9,13,22,40,46,86,13,0,13,15,31,23,6,18,96,102
2016,2,21600184,11/19/2016,1610612762,Utah Jazz,0,0,1610612745,Houston Rockets,1,1,27,22,49,12,15,27,39,37,76,12,5,17,5,33,22,8,14,92,102
2015,2,21500849,2/24/2016,1610612750,Minnesota Timberwolves,0,0,1610612761,Toronto Raptors,1,1,31,33,64,6,4,10,37,37,74,25,8,33,12,27,25,7,17,92,105
2015,2,21500849,2/24/2016,1610612761,Toronto Raptors,1,1,1610612750,Minnesota Timberwolves,0,0,31,28,59,10,16,26,41,44,85,22,4,26,18,30,21,8,13,93,114
2015,2,21500707,1/30/2016,1610612744,Golden State Warriors,0,1,1610612755,Philadelphia 76ers,1,0,34,31,65,13,17,30,47,48,95,1,1,2,15,34,37,18,23,104,108
2015,2,21500707,1/30/2016,1610612755,Philadelphia 76ers,1,0,1610612744,Golden State Warriors,0,1,32,31,63,10,19,29,42,50,92,11,10,21,11,46,23,5,12,105,105
2015,2,21500524,1/5/2016,1610612744,Golden State Warriors,0,1,1610612747,Los Angeles Lakers,1,0,27,28,55,13,18,31,40,46,86,16,5,21,10,39,26,7,11,99,109
2015,2,21500524,1/5/2016,1610612747,Los Angeles Lakers,1,0,1610612744,Golden State Warriors,0,1,24,46,70,5,16,21,29,62,91,25,5,30,17,48,15,9,13,99,88
2015,2,21500421,12/22/2015,1610612742,Dallas Mavericks,0,0,1610612761,Toronto Raptors,1,1,29,34,63,11,18,29,40,52,92,8,3,11,7,46,23,4,6,94,99
2015,2,21500421,12/22/2015,1610612761,Toronto Raptors,1,1,1610612742,Dallas Mavericks,0,0,23,25,48,12,14,26,35,39,74,21,6,27,10,31,20,8,18,94,103
2015,2,21500317,12/8/2015,1610612743,Denver Nuggets,1,0,1610612753,Orlando Magic,0,1,21,39,60,7,17,24,28,56,84,11,9,20,15,45,19,9,19,98,74
2015,2,21500317,12/8/2015,1610612753,Orlando Magic,0,1,1610612743,Denver Nuggets,1,0,37,35,72,1,15,16,38,50,88,8,2,10,14,37,14,11,20,98,85
2015,2,21500218,11/25/2015,1610612748,Miami Heat,0,0,1610612765,Detroit Pistons,1,1,26,33,59,6,14,20,32,47,79,11,5,16,11,38,21,6,13,86,81
2015,2,21500218,11/25/2015,1610612765,Detroit Pistons,1,1,1610612748,Miami Heat,0,0,25,42,67,16,15,31,41,57,98,6,1,7,23,35,24,2,7,87,104
2015,2,21500124,11/12/2015,1610612748,Miami Heat,1,1,1610612762,Utah Jazz,0,0,32,32,64,4,9,13,36,41,77,16,9,25,11,32,14,10,15,93,92
2015,2,21500124,11/12/2015,1610612762,Utah Jazz,0,0,1610612748,Miami Heat,1,1,30,42,72,4,13,17,34,55,89,19,6,25,17,41,13,6,10,94,91
2015,2,21501139,4/2/2016,1610612741,Chicago Bulls,1,0,1610612765,Detroit Pistons,0,1,25,38,63,9,16,25,34,54,88,13,2,15,14,41,21,8,13,94,90
2015,2,21501139,4/2/2016,1610612765,Detroit Pistons,0,1,1610612741,Chicago Bulls,1,0,22,34,56,10,10,20,32,44,76,20,14,34,10,39,17,6,10,94,94
2015,2,21501081,3/25/2016,1610612743,Denver Nuggets,0,1,1610612747,Los Angeles Lakers,1,0,35,33,68,10,16,26,45,49,94,16,8,24,18,37,31,6,9,96,116
2015,2,21501081,3/25/2016,1610612747,Los Angeles Lakers,1,0,1610612743,Denver Nuggets,0,1,27,35,62,10,13,23,37,48,85,21,5,26,12,39,23,5,11,97,105
2015,2,21500915,3/4/2016,1610612738,Boston Celtics,1,1,1610612752,New York Knicks,0,0,37,33,70,4,16,20,41,49,90,19,6,25,16,35,20,4,9,96,105
2020,2,22000058,12/30/2020,1610612748,Miami Heat,1,1,1610612749,Milwaukee Bucks,0,0,25,18,43,15,24,39,40,42,82,24,5,29,14,31,25,14,22,104,119
2020,2,22000058,12/30/2020,1610612749,Milwaukee Bucks,0,0,1610612748,Miami Heat,1,1,24,37,61,16,25,41,40,62,102,12,1,13,18,45,26,5,13,104,108
2016,2,21601213,4/11/2017,1610612750,Minnesota Timberwolves,1,0,1610612760,Oklahoma City Thunder,0,1,33,33,66,5,15,20,38,48,86,17,8,25,16,37,24,7,11,92,98
2016,2,21601213,4/11/2017,1610612760,Oklahoma City Thunder,0,1,1610612750,Minnesota Timberwolves,1,0,30,34,64,7,15,22,37,49,86,19,6,25,25,26,22,12,17,92,100
2015,2,21500915,3/4/2016,1610612752,New York Knicks,0,0,1610612738,Boston Celtics,1,1,33,36,69,9,14,23,42,50,92,11,3,14,11,41,22,8,10,96,104
2015,2,21500799,2/10/2016,1610612744,Golden State Warriors,0,1,1610612756,Phoenix Suns,1,0,23,26,49,14,26,40,37,52,89,24,5,29,10,44,24,7,13,105,112
2015,2,21500799,2/10/2016,1610612756,Phoenix Suns,1,0,1610612744,Golden State Warriors,0,1,35,37,72,6,15,21,41,52,93,16,6,22,15,42,21,12,18,105,104
2015,2,21500610,1/17/2016,1610612750,Minnesota Timberwolves,1,1,1610612756,Phoenix Suns,0,0,32,19,51,7,11,18,39,30,69,32,8,40,10,22,23,5,17,96,117
2015,2,21500610,1/17/2016,1610612756,Phoenix Suns,0,0,1610612750,Minnesota Timberwolves,1,1,32,34,66,3,12,15,35,46,81,14,11,25,13,36,16,11,15,95,87
2015,2,21500217,11/25/2015,1610612738,Boston Celtics,1,1,1610612755,Philadelphia 76ers,0,0,22,40,62,9,20,29,31,60,91,13,5,18,18,45,18,11,17,99,84
2015,2,21500217,11/25/2015,1610612755,Philadelphia 76ers,0,0,1610612738,Boston Celtics,1,1,24,32,56,7,20,27,31,52,83,11,4,15,10,44,12,7,19,101,80
2015,2,21500027,10/30/2015,1610612749,Milwaukee Bucks,1,0,1610612764,Washington Wizards,0,1,35,23,58,7,17,24,42,40,82,22,6,28,10,33,33,7,16,100,113
2015,2,21500027,10/30/2015,1610612764,Washington Wizards,0,1,1610612749,Milwaukee Bucks,1,0,23,24,47,12,9,21,35,33,68,36,8,44,10,26,25,9,21,100,118
2015,2,21501219,4/13/2016,1610612753,Orlando Magic,0,0,1610612766,Charlotte Hornets,1,1,34,30,64,8,19,27,42,49,91,11,7,18,8,44,22,6,10,101,103
2015,2,21501219,4/13/2016,1610612766,Charlotte Hornets,1,1,1610612753,Orlando Magic,0,0,36,21,57,11,18,29,47,39,86,12,7,19,5,37,32,7,10,100,117
2015,2,21501138,4/2/2016,1610612754,Indiana Pacers,0,1,1610612755,Philadelphia 76ers,1,0,36,25,61,8,15,23,44,40,84,19,4,23,9,32,27,3,14,100,115
2015,2,21501138,4/2/2016,1610612755,Philadelphia 76ers,1,0,1610612754,Indiana Pacers,0,1,18,28,46,16,21,37,34,49,83,18,8,26,12,42,23,9,17,100,102
2015,2,21501023,3/18/2016,1610612738,Boston Celtics,0,0,1610612761,Toronto Raptors,1,1,27,34,61,9,12,21,36,46,82,10,2,12,10,37,18,10,16,94,91
2015,2,21501023,3/18/2016,1610612761,Toronto Raptors,1,1,1610612738,Boston Celtics,0,0,24,25,49,13,15,28,37,40,77,18,7,25,11,32,18,8,16,94,105
2015,2,21500972,3/11/2016,1610612746,LA Clippers,1,1,1610612752,New York Knicks,0,0,25,31,56,13,16,29,38,47,85,12,4,16,12,36,23,7,14,96,101
2015,2,21500972,3/11/2016,1610612752,New York Knicks,0,0,1610612746,LA Clippers,1,1,30,33,63,4,16,20,34,49,83,22,3,25,15,36,23,8,16,96,94
2015,2,21500752,2/5/2016,1610612746,LA Clippers,0,1,1610612753,Orlando Magic,1,0,32,15,47,8,19,27,40,34,74,19,4,23,6,29,15,6,22,102,107
2015,2,21500752,2/5/2016,1610612753,Orlando Magic,1,0,1610612746,LA Clippers,0,1,30,31,61,4,16,20,34,47,81,21,7,28,12,40,19,13,18,100,93
2015,2,21500523,1/5/2016,1610612742,Dallas Mavericks,1,1,1610612758,Sacramento Kings,0,0,33,36,69,12,17,29,45,53,98,15,8,23,15,42,22,16,17,111,117
2015,2,21500523,1/5/2016,1610612758,Sacramento Kings,0,0,1610612742,Dallas Mavericks,1,1,35,32,67,12,20,32,47,52,99,10,4,14,13,42,27,13,20,113,116
2015,2,21500420,12/22/2015,1610612748,Miami Heat,1,0,1610612765,Detroit Pistons,0,1,35,35,70,4,14,18,39,49,88,10,2,12,15,33,13,3,5,86,92
2015,2,21500420,12/22/2015,1610612765,Detroit Pistons,0,1,1610612748,Miami Heat,1,0,20,28,48,15,15,30,35,43,78,8,6,14,17,30,16,9,16,86,93
2015,2,21500316,12/8/2015,1610612760,Oklahoma City Thunder,0,1,1610612763,Memphis Grizzlies,1,0,34,24,58,13,13,26,47,37,84,18,5,23,13,26,31,6,12,94,125
2015,2,21500316,12/8/2015,1610612763,Memphis Grizzlies,1,0,1610612760,Oklahoma City Thunder,0,1,30,37,67,3,11,14,33,48,81,19,3,22,13,37,14,11,16,94,88
2015,2,21500216,11/25/2015,1610612752,New York Knicks,0,0,1610612753,Orlando Magic,1,1,22,34,56,9,18,27,31,52,83,20,5,25,18,37,16,2,12,90,91
2015,2,21500216,11/25/2015,1610612753,Orlando Magic,1,1,1610612752,New York Knicks,0,0,29,41,70,5,11,16,34,52,86,27,5,32,19,36,20,2,8,91,100
2015,2,21500123,11/11/2015,1610612757,Portland Trail Blazers,1,0,1610612759,San Antonio Spurs,0,1,30,36,66,9,13,22,39,49,88,14,9,23,17,36,26,4,9,93,101
2015,2,21500123,11/11/2015,1610612759,San Antonio Spurs,0,1,1610612757,Portland Trail Blazers,1,0,39,28,67,7,8,15,46,36,82,14,4,18,9,29,27,6,11,92,113
2014,2,21400861,2/27/2015,1610612744,Golden State Warriors,0,1,1610612761,Toronto Raptors,1,0,29,30,59,13,15,28,42,45,87,16,3,19,10,37,31,6,13,100,113
2014,2,21400861,2/27/2015,1610612761,Toronto Raptors,1,0,1610612744,Golden State Warriors,0,1,27,28,55,4,18,22,31,46,77,23,5,28,10,38,15,11,19,101,89
2015,2,21501137,4/1/2016,1610612756,Phoenix Suns,1,0,1610612764,Washington Wizards,0,1,29,41,70,7,16,23,36,57,93,20,6,26,23,37,19,6,16,99,99
2015,2,21501137,4/1/2016,1610612764,Washington Wizards,0,1,1610612756,Phoenix Suns,1,0,28,32,60,10,16,26,38,48,86,20,5,25,13,40,22,5,12,100,106
2016,2,21600183,11/18/2016,1610612746,LA Clippers,0,1,1610612758,Sacramento Kings,1,0,27,20,47,13,16,29,40,36,76,28,6,34,7,32,27,7,14,100,121
2016,2,21600183,11/18/2016,1610612758,Sacramento Kings,1,0,1610612746,LA Clippers,0,1,28,32,60,10,16,26,38,48,86,29,6,35,17,35,21,7,15,100,115
2015,2,21500914,3/4/2016,1610612748,Miami Heat,0,1,1610612755,Philadelphia 76ers,1,0,34,38,72,5,11,16,39,49,88,29,7,36,23,30,24,12,17,99,112
2015,2,21500914,3/4/2016,1610612755,Philadelphia 76ers,1,0,1610612748,Miami Heat,0,1,27,37,64,9,22,31,36,59,95,21,6,27,17,43,21,7,8,99,102
2015,2,21500848,2/24/2016,1610612744,Golden State Warriors,0,1,1610612748,Miami Heat,1,0,29,33,62,13,15,28,42,48,90,21,4,25,14,36,23,8,13,99,118
2015,2,21500848,2/24/2016,1610612748,Miami Heat,1,0,1610612744,Golden State Warriors,0,1,34,38,72,6,8,14,40,46,86,26,5,31,15,34,19,7,12,100,112
2016,2,21601212,4/11/2017,1610612737,Atlanta Hawks,1,1,1610612766,Charlotte Hornets,0,0,34,18,52,7,20,27,41,38,79,14,4,18,15,27,30,11,17,91,103
2016,2,21601212,4/11/2017,1610612766,Charlotte Hornets,0,0,1610612737,Atlanta Hawks,1,1,26,39,65,3,20,23,29,59,88,15,4,19,21,41,16,6,15,91,76
2015,2,21500706,1/29/2016,1610612746,LA Clippers,1,1,1610612747,Los Angeles Lakers,0,0,32,23,55,8,18,26,40,41,81,17,7,24,7,39,20,6,9,97,105
2015,2,21500706,1/29/2016,1610612747,Los Angeles Lakers,0,0,1610612746,LA Clippers,1,1,29,36,65,5,8,13,34,44,78,20,5,25,12,34,19,10,18,95,93
2015,2,21500661,1/23/2016,1610612743,Denver Nuggets,1,1,1610612765,Detroit Pistons,0,0,28,28,56,8,14,22,36,42,78,24,5,29,5,41,18,4,8,94,104
2015,2,21500661,1/23/2016,1610612765,Detroit Pistons,0,0,1610612743,Denver Nuggets,1,1,29,26,55,11,18,29,40,44,84,10,9,19,17,33,23,15,16,94,101
2015,2,21500609,1/16/2016,1610612746,LA Clippers,1,0,1610612758,Sacramento Kings,0,1,25,32,57,13,26,39,38,58,96,14,5,19,16,44,24,5,11,101,103
2015,2,21500609,1/16/2016,1610612758,Sacramento Kings,0,1,1610612746,LA Clippers,1,0,23,28,51,13,12,25,36,40,76,25,8,33,9,35,28,6,17,100,110
2015,2,21500522,1/5/2016,1610612741,Chicago Bulls,1,1,1610612749,Milwaukee Bucks,0,0,41,23,64,5,14,19,46,37,83,20,0,20,9,28,27,9,15,98,117
2015,2,21500522,1/5/2016,1610612749,Milwaukee Bucks,0,0,1610612741,Chicago Bulls,1,1,40,46,86,6,10,16,46,56,102,8,6,14,20,39,28,5,10,99,106
2016,2,21600647,1/20/2017,1610612737,Atlanta Hawks,1,1,1610612741,Chicago Bulls,0,0,30,30,60,9,13,22,39,43,82,15,4,19,13,32,23,12,20,99,102
2016,2,21600647,1/20/2017,1610612741,Chicago Bulls,0,0,1610612737,Atlanta Hawks,1,1,27,26,53,7,21,28,34,47,81,18,1,19,16,31,18,16,25,99,93
2015,2,21500315,12/8/2015,1610612745,Houston Rockets,0,0,1610612751,Brooklyn Nets,1,1,24,23,47,15,20,35,39,43,82,12,5,17,14,32,26,14,24,101,105
2015,2,21500315,12/8/2015,1610612751,Brooklyn Nets,1,1,1610612745,Houston Rockets,0,0,38,25,63,7,11,18,45,36,81,13,3,16,12,26,27,20,24,100,110
2015,2,21500215,11/25/2015,1610612764,Washington Wizards,0,0,1610612766,Charlotte Hornets,1,1,21,34,55,10,22,32,31,56,87,15,3,18,14,43,15,5,14,98,87
2015,2,21500215,11/25/2015,1610612766,Charlotte Hornets,1,1,1610612764,Washington Wizards,0,0,31,26,57,8,18,26,39,44,83,15,0,15,12,33,22,13,19,98,101
2015,2,21500026,10/30/2015,1610612737,Atlanta Hawks,1,1,1610612766,Charlotte Hornets,0,0,28,32,60,8,15,23,36,47,83,17,5,22,10,41,23,7,15,98,97
2015,2,21500026,10/30/2015,1610612766,Charlotte Hornets,0,0,1610612737,Atlanta Hawks,1,1,24,34,58,12,18,30,36,52,88,10,3,13,17,37,23,9,20,98,94
2016,2,21601211,4/10/2017,1610612744,Golden State Warriors,1,0,1610612762,Utah Jazz,0,1,30,25,55,9,16,25,39,41,80,12,5,17,9,36,25,8,13,93,99
2016,2,21601211,4/10/2017,1610612762,Utah Jazz,0,1,1610612744,Golden State Warriors,1,0,28,29,57,13,22,35,41,51,92,10,5,15,18,35,29,5,12,93,105
2015,2,21500913,3/4/2016,1610612753,Orlando Magic,1,0,1610612756,Phoenix Suns,0,1,28,46,74,7,20,27,35,66,101,7,7,14,18,52,20,8,14,104,84
2015,2,21500913,3/4/2016,1610612756,Phoenix Suns,0,1,1610612753,Orlando Magic,1,0,30,34,64,5,9,14,35,43,78,27,12,39,13,37,18,12,19,105,102
2015,2,21500798,2/10/2016,1610612740,New Orleans Pelicans,1,1,1610612762,Utah Jazz,0,0,31,32,63,8,11,19,39,43,82,14,7,21,11,36,23,6,9,92,100
2015,2,21500798,2/10/2016,1610612762,Utah Jazz,0,0,1610612740,New Orleans Pelicans,1,1,26,23,49,7,14,21,33,37,70,23,7,30,10,32,19,9,17,91,96
2015,2,21500751,2/5/2016,1610612748,Miami Heat,0,1,1610612766,Charlotte Hornets,1,0,43,42,85,0,9,9,43,51,94,12,6,18,13,42,20,5,8,94,98
2015,2,21500751,2/5/2016,1610612766,Charlotte Hornets,1,0,1610612748,Miami Heat,0,1,26,29,55,10,16,26,36,45,81,13,2,15,5,42,23,7,12,95,95
2015,2,21500521,1/5/2016,1610612737,Atlanta Hawks,1,0,1610612752,New York Knicks,0,1,22,26,48,15,24,39,37,50,87,12,7,19,17,38,22,7,13,90,101
2015,2,21500521,1/5/2016,1610612752,New York Knicks,0,1,1610612737,Atlanta Hawks,1,0,35,31,66,5,13,18,40,44,84,22,2,24,16,28,20,3,9,89,107
2015,2,21500419,12/22/2015,1610612755,Philadelphia 76ers,1,0,1610612763,Memphis Grizzlies,0,1,24,19,43,7,16,23,31,35,66,21,11,32,11,29,19,16,28,95,90
2015,2,21500419,12/22/2015,1610612763,Memphis Grizzlies,0,1,1610612755,Philadelphia 76ers,1,0,35,35,70,5,10,15,40,45,85,19,5,24,14,35,26,6,12,96,104
2015,2,21500314,12/8/2015,1610612744,Golden State Warriors,0,1,1610612754,Indiana Pacers,1,0,36,24,60,16,19,35,52,43,95,11,4,15,12,32,29,8,15,106,131
2015,2,21500314,12/8/2015,1610612754,Indiana Pacers,1,0,1610612744,Golden State Warriors,0,1,30,37,67,14,19,33,44,56,100,21,5,26,23,36,23,10,16,107,123
2015,2,21500122,11/11/2015,1610612758,Sacramento Kings,1,1,1610612765,Detroit Pistons,0,0,28,30,58,9,7,16,37,37,74,18,6,24,8,34,20,10,19,98,101
2015,2,21500122,11/11/2015,1610612765,Detroit Pistons,0,0,1610612758,Sacramento Kings,1,1,25,32,57,9,23,32,34,55,89,15,5,20,16,43,16,7,16,99,92
2015,2,21501218,4/13/2016,1610612751,Brooklyn Nets,1,0,1610612761,Toronto Raptors,0,1,29,34,63,10,16,26,39,50,89,8,4,12,9,44,26,5,8,92,96
2015,2,21501218,4/13/2016,1610612761,Toronto Raptors,0,1,1610612751,Brooklyn Nets,1,0,28,28,56,13,24,37,41,52,93,8,7,15,19,36,24,8,9,94,103
2015,2,21501136,4/1/2016,1610612738,Boston Celtics,0,1,1610612744,Golden State Warriors,1,0,33,31,64,8,15,23,41,46,87,19,11,30,16,35,28,12,14,101,109
2015,2,21501136,4/1/2016,1610612744,Golden State Warriors,1,0,1610612738,Boston Celtics,0,1,18,22,40,20,23,43,38,45,83,10,3,13,11,35,25,10,22,101,106
2015,2,21501080,3/25/2016,1610612742,Dallas Mavericks,0,0,1610612744,Golden State Warriors,1,1,25,36,61,18,17,35,43,53,96,16,5,21,20,35,31,8,11,98,120
2015,2,21501080,3/25/2016,1610612744,Golden State Warriors,1,1,1610612742,Dallas Mavericks,0,0,22,21,43,21,24,45,43,45,88,21,2,23,9,36,30,3,7,98,128
2015,2,21500912,3/4/2016,1610612754,Indiana Pacers,0,0,1610612766,Charlotte Hornets,1,1,28,34,62,9,19,28,37,53,90,18,3,21,16,39,23,4,10,93,101
2015,2,21500912,3/4/2016,1610612766,Charlotte Hornets,1,1,1610612754,Indiana Pacers,0,0,25,23,48,13,18,31,38,41,79,19,4,23,9,34,20,10,11,94,108
2016,2,21600182,11/18/2016,1610612747,Los Angeles Lakers,1,0,1610612759,San Antonio Spurs,0,1,27,35,62,12,13,25,39,48,87,17,4,21,18,34,24,8,14,95,107
2016,2,21600182,11/18/2016,1610612759,San Antonio Spurs,0,1,1610612747,Los Angeles Lakers,1,0,34,20,54,10,14,24,44,34,78,18,1,19,5,30,30,6,12,95,116
2016,2,21601210,4/10/2017,1610612745,Houston Rockets,0,0,1610612746,LA Clippers,1,1,24,20,44,9,31,40,33,51,84,21,6,27,12,42,23,9,15,99,96
2016,2,21601210,4/10/2017,1610612746,LA Clippers,1,1,1610612745,Houston Rockets,0,0,36,29,65,10,16,26,46,45,91,23,5,28,15,33,29,5,10,99,125
2016,2,21600646,1/20/2017,1610612744,Golden State Warriors,0,1,1610612745,Houston Rockets,1,0,32,19,51,15,23,38,47,42,89,16,5,21,13,31,30,8,15,101,125
2016,2,21600646,1/20/2017,1610612745,Houston Rockets,1,0,1610612744,Golden State Warriors,0,1,36,25,61,7,28,35,43,53,96,15,3,18,19,35,26,8,15,102,108
2015,2,21500520,1/4/2016,1610612744,Golden State Warriors,1,1,1610612766,Charlotte Hornets,0,0,30,23,53,15,19,34,45,42,87,6,0,6,6,36,32,7,11,95,111
2015,2,21500520,1/4/2016,1610612766,Charlotte Hornets,0,0,1610612744,Golden State Warriors,1,1,31,34,65,7,14,21,38,48,86,18,1,19,12,36,15,4,14,96,101
2015,2,21500313,12/8/2015,1610612739,Cleveland Cavaliers,1,1,1610612757,Portland Trail Blazers,0,0,31,27,58,9,12,21,40,39,79,16,4,20,8,31,18,3,9,89,105
2015,2,21500313,12/8/2015,1610612757,Portland Trail Blazers,0,0,1610612739,Cleveland Cavaliers,1,1,29,24,53,11,15,26,40,39,79,9,7,16,17,25,21,10,19,91,100
2015,2,21500214,11/24/2015,1610612744,Golden State Warriors,1,1,1610612747,Los Angeles Lakers,0,0,33,24,57,12,23,35,45,47,92,9,6,15,14,38,32,8,8,94,111
2015,2,21500214,11/24/2015,1610612747,Los Angeles Lakers,0,0,1610612744,Golden State Warriors,1,1,28,34,62,3,18,21,31,52,83,12,4,16,13,42,16,9,15,94,77
2015,2,21500025,10/30/2015,1610612741,Chicago Bulls,0,0,1610612765,Detroit Pistons,1,1,27,35,62,7,15,22,34,50,84,19,7,26,11,43,18,9,20,107,94
2015,2,21500025,10/30/2015,1610612765,Detroit Pistons,1,1,1610612741,Chicago Bulls,0,0,33,43,76,6,22,28,39,65,104,14,14,28,26,44,18,8,15,108,98
2014,2,21400860,2/27/2015,1610612752,New York Knicks,0,1,1610612765,Detroit Pistons,1,0,39,52,91,6,12,18,45,64,109,23,1,24,23,42,28,3,11,108,119
2014,2,21400860,2/27/2015,1610612765,Detroit Pistons,1,0,1610612752,New York Knicks,0,1,31,35,66,8,22,30,39,57,96,29,11,40,22,40,22,6,15,109,115
2015,2,21501217,4/13/2016,1610612738,Boston Celtics,1,1,1610612748,Miami Heat,0,0,32,40,72,5,9,14,37,49,86,19,3,22,16,33,20,5,7,89,98
2015,2,21501217,4/13/2016,1610612748,Miami Heat,0,0,1610612738,Boston Celtics,1,1,36,33,69,2,17,19,38,50,88,10,2,12,16,36,14,7,10,87,88
2015,2,21501135,4/1/2016,1610612748,Miami Heat,0,1,1610612758,Sacramento Kings,1,0,30,30,60,12,10,22,42,40,82,16,1,17,14,26,23,7,18,96,112
2015,2,21501135,4/1/2016,1610612758,Sacramento Kings,1,0,1610612748,Miami Heat,0,1,31,35,66,7,14,21,38,49,87,23,6,29,21,32,20,5,14,95,106
2015,2,21501022,3/18/2016,1610612758,Sacramento Kings,0,0,1610612765,Detroit Pistons,1,1,36,28,64,4,11,15,40,39,79,24,5,29,7,35,21,7,11,96,108
2015,2,21501022,3/18/2016,1610612765,Detroit Pistons,1,1,1610612758,Sacramento Kings,0,0,32,34,66,12,14,26,44,48,92,15,3,18,21,30,25,8,17,97,115
2015,2,21500911,3/3/2016,1610612744,Golden State Warriors,1,1,1610612760,Oklahoma City Thunder,0,0,36,17,53,11,23,34,47,40,87,16,5,21,6,36,33,3,9,100,121
2015,2,21500911,3/3/2016,1610612760,Oklahoma City Thunder,0,0,1610612744,Golden State Warriors,1,1,36,30,66,4,16,20,40,46,86,22,5,27,13,37,22,11,14,100,106
2015,2,21500797,2/10/2016,1610612750,Minnesota Timberwolves,1,1,1610612761,Toronto Raptors,0,0,31,31,62,4,10,14,35,41,76,43,10,53,16,29,22,3,7,92,117
2015,2,21500797,2/10/2016,1610612761,Toronto Raptors,0,0,1610612750,Minnesota Timberwolves,1,1,29,26,55,10,21,31,39,47,86,24,8,32,15,34,19,5,6,93,112
2016,2,21601209,4/10/2017,1610612757,Portland Trail Blazers,1,1,1610612759,San Antonio Spurs,0,0,25,37,62,12,15,27,37,52,89,13,2,15,15,39,18,4,9,90,99
2016,2,21601209,4/10/2017,1610612759,San Antonio Spurs,0,0,1610612757,Portland Trail Blazers,1,1,30,32,62,8,13,21,38,45,83,14,6,20,16,34,17,6,15,91,98
2015,2,21500705,1/29/2016,1610612757,Portland Trail Blazers,1,1,1610612766,Charlotte Hornets,0,0,38,34,72,7,13,20,45,47,92,12,4,16,15,36,24,9,11,94,109
2015,2,21500705,1/29/2016,1610612766,Charlotte Hornets,0,0,1610612757,Portland Trail Blazers,1,1,21,30,51,10,19,29,31,49,80,19,9,28,14,40,17,10,16,94,91
2015,2,21500608,1/16/2016,1610612747,Los Angeles Lakers,0,0,1610612762,Utah Jazz,1,1,22,45,67,9,14,23,31,59,90,11,7,18,22,41,16,8,14,92,82
2015,2,21500608,1/16/2016,1610612762,Utah Jazz,1,1,1610612747,Los Angeles Lakers,0,0,29,30,59,12,12,24,41,42,83,15,3,18,13,30,17,4,12,91,109
2020,2,22000057,12/30/2020,1610612737,Atlanta Hawks,0,0,1610612751,Brooklyn Nets,1,1,29,24,53,18,28,46,47,52,99,29,6,35,23,32,27,6,12,108,141
2020,2,22000057,12/30/2020,1610612751,Brooklyn Nets,1,1,1610612737,Atlanta Hawks,0,0,35,24,59,19,22,41,54,46,100,18,5,23,12,38,30,5,9,107,145
2015,2,21500519,1/4/2016,1610612757,Portland Trail Blazers,1,0,1610612763,Memphis Grizzlies,0,1,21,23,44,7,21,28,28,44,72,15,9,24,10,38,14,10,22,93,78
2015,2,21500519,1/4/2016,1610612763,Memphis Grizzlies,0,1,1610612757,Portland Trail Blazers,1,0,32,44,76,3,12,15,35,56,91,18,8,26,23,36,21,7,13,95,91
2015,2,21500418,12/21/2015,1610612746,LA Clippers,1,0,1610612760,Oklahoma City Thunder,0,1,34,31,65,7,15,22,41,46,87,10,4,14,14,35,21,10,13,94,99
2015,2,21500418,12/21/2015,1610612760,Oklahoma City Thunder,0,1,1610612746,LA Clippers,1,0,36,32,68,4,13,17,40,45,85,16,4,20,12,35,21,7,11,92,100
2015,2,21500312,12/7/2015,1610612738,Boston Celtics,0,1,1610612740,New Orleans Pelicans,1,0,28,25,53,12,16,28,40,41,81,19,5,24,11,33,24,8,17,99,111
2015,2,21500312,12/7/2015,1610612740,New Orleans Pelicans,1,0,1610612738,Boston Celtics,0,1,33,44,77,4,9,13,37,53,90,15,3,18,15,39,21,8,14,99,93
2015,2,21500121,11/11/2015,1610612743,Denver Nuggets,1,1,1610612749,Milwaukee Bucks,0,0,31,24,55,8,16,24,39,40,79,17,7,24,18,26,27,8,14,87,103
2015,2,21500121,11/11/2015,1610612749,Milwaukee Bucks,0,0,1610612743,Denver Nuggets,1,1,32,25,57,10,12,22,42,37,79,8,1,9,12,25,26,10,17,88,102
2015,2,21500024,10/30/2015,1610612738,Boston Celtics,1,0,1610612761,Toronto Raptors,0,1,25,34,59,7,19,26,32,53,85,32,9,41,13,45,23,11,17,108,103
2015,2,21500024,10/30/2015,1610612761,Toronto Raptors,0,1,1610612738,Boston Celtics,1,0,25,31,56,11,15,26,36,46,82,30,5,35,13,35,23,14,22,108,113
2015,2,21501216,4/12/2016,1610612746,LA Clippers,1,1,1610612763,Memphis Grizzlies,0,0,29,21,50,12,13,25,41,34,75,16,5,21,9,27,29,5,11,89,110
2015,2,21501216,4/12/2016,1610612763,Memphis Grizzlies,0,0,1610612746,LA Clippers,1,1,30,36,66,5,15,20,35,51,86,9,5,14,19,34,16,11,16,89,84
2015,2,21500971,3/11/2016,1610612744,Golden State Warriors,1,1,1610612757,Portland Trail Blazers,0,0,22,27,49,18,22,40,40,49,89,30,9,39,19,34,23,4,8,99,128
2015,2,21500971,3/11/2016,1610612757,Portland Trail Blazers,0,0,1610612744,Golden State Warriors,1,1,18,32,50,19,17,36,37,49,86,19,4,23,10,41,20,5,11,97,112
2015,2,21500847,2/24/2016,1610612755,Philadelphia 76ers,0,0,1610612765,Detroit Pistons,1,1,26,34,60,7,16,23,33,50,83,18,8,26,13,40,18,10,15,98,91
2022,2,22200378,12/9/2022,1610612754,Indiana Pacers,1,1,1610612764,Washington Wizards,0,0,25,19,44,18,23,41,43,42,85,17,3,20,18,26,23,6,12,91,121
2022,2,22200378,12/9/2022,1610612764,Washington Wizards,0,0,1610612754,Indiana Pacers,1,1,31,17,48,10,19,29,41,36,77,19,6,25,13,28,25,7,14,90,111
2015,2,21500847,2/24/2016,1610612765,Detroit Pistons,1,1,1610612755,Philadelphia 76ers,0,0,28,27,55,11,17,28,39,44,83,22,12,34,19,32,22,8,16,97,111
2015,2,21500750,2/5/2016,1610612737,Atlanta Hawks,1,1,1610612754,Indiana Pacers,0,0,29,20,49,10,17,27,39,37,76,14,6,20,7,35,29,6,15,93,102
2015,2,21500750,2/5/2016,1610612754,Indiana Pacers,0,0,1610612737,Atlanta Hawks,1,1,25,35,60,13,18,31,38,53,91,7,2,9,22,31,23,10,20,94,96
2016,2,21600181,11/18/2016,1610612743,Denver Nuggets,1,0,1610612761,Toronto Raptors,0,1,35,23,58,4,21,25,39,44,83,29,10,39,12,38,29,8,19,110,111
2016,2,21600181,11/18/2016,1610612761,Toronto Raptors,0,1,1610612743,Denver Nuggets,1,0,35,36,71,8,15,23,43,51,94,19,12,31,9,50,23,7,11,111,113
2015,2,21500607,1/16/2016,1610612752,New York Knicks,0,0,1610612763,Memphis Grizzlies,1,1,30,27,57,5,15,20,35,42,77,20,4,24,11,32,20,2,11,87,95
2015,2,21500607,1/16/2016,1610612763,Memphis Grizzlies,1,1,1610612752,New York Knicks,0,0,34,38,72,5,5,10,39,43,82,20,6,26,15,32,24,4,9,88,103
2015,2,21500518,1/4/2016,1610612745,Houston Rockets,0,1,1610612762,Utah Jazz,1,0,22,20,42,11,15,26,33,35,68,16,5,21,8,30,17,9,16,87,93
2015,2,21500518,1/4/2016,1610612762,Utah Jazz,1,0,1610612745,Houston Rockets,0,1,18,28,46,12,17,29,30,45,75,19,6,25,17,31,17,8,16,86,91
2015,2,21500023,10/30/2015,1610612755,Philadelphia 76ers,1,0,1610612762,Utah Jazz,0,1,13,35,48,6,9,15,19,44,63,27,10,37,10,38,15,10,19,90,71
2015,2,21500023,10/30/2015,1610612762,Utah Jazz,0,1,1610612755,Philadelphia 76ers,1,0,29,46,75,7,6,13,36,52,88,20,5,25,18,35,19,4,8,91,99
2014,2,21400859,2/27/2015,1610612738,Boston Celtics,1,1,1610612766,Charlotte Hornets,0,0,26,35,61,14,21,35,40,56,96,12,3,15,15,41,24,8,8,96,106
2014,2,21400859,2/27/2015,1610612766,Charlotte Hornets,0,0,1610612738,Boston Celtics,1,1,27,34,61,10,11,21,37,45,82,14,3,17,10,37,19,8,16,97,98
2015,2,21501215,4/12/2016,1610612759,San Antonio Spurs,1,1,1610612760,Oklahoma City Thunder,0,0,33,40,73,4,10,14,37,50,87,24,8,32,17,37,15,7,11,100,102
2015,2,21501215,4/12/2016,1610612760,Oklahoma City Thunder,0,0,1610612759,San Antonio Spurs,1,1,29,33,62,6,19,25,35,52,87,22,3,25,22,31,18,12,21,98,98
2015,2,21500910,3/3/2016,1610612742,Dallas Mavericks,1,0,1610612758,Sacramento Kings,0,1,38,27,65,7,22,29,45,49,94,4,2,6,16,34,25,8,15,97,101
2015,2,21500910,3/3/2016,1610612758,Sacramento Kings,0,1,1610612742,Dallas Mavericks,1,0,35,20,55,7,18,25,42,38,80,13,11,24,9,35,23,5,13,95,104
2015,2,21500749,2/4/2016,1610612745,Houston Rockets,0,1,1610612756,Phoenix Suns,1,0,22,22,44,15,27,42,37,49,86,22,10,32,19,36,24,9,16,101,111
2015,2,21500749,2/4/2016,1610612756,Phoenix Suns,1,0,1610612745,Houston Rockets,0,1,21,33,54,11,18,29,32,51,83,30,2,32,20,33,22,16,24,100,105
2015,2,21500704,1/29/2016,1610612750,Minnesota Timberwolves,0,0,1610612762,Utah Jazz,1,1,33,32,65,2,8,10,35,40,75,18,8,26,14,31,17,8,15,87,90
2015,2,21500704,1/29/2016,1610612762,Utah Jazz,1,1,1610612750,Minnesota Timberwolves,0,0,30,21,51,10,15,25,40,36,76,13,3,16,12,26,24,9,14,88,103
2015,2,21500660,1/23/2016,1610612737,Atlanta Hawks,0,0,1610612756,Phoenix Suns,1,1,22,28,50,12,22,34,34,50,84,15,3,18,13,39,23,10,16,96,95
2015,2,21500660,1/23/2016,1610612756,Phoenix Suns,1,1,1610612737,Atlanta Hawks,0,0,24,37,61,10,14,24,34,51,85,20,6,26,19,35,22,8,17,98,98
2015,2,21500606,1/16/2016,1610612755,Philadelphia 76ers,1,1,1610612757,Portland Trail Blazers,0,0,32,21,53,10,13,23,42,34,76,20,10,30,6,32,27,6,13,96,114
2015,2,21500606,1/16/2016,1610612757,Portland Trail Blazers,0,0,1610612755,Philadelphia 76ers,1,1,29,29,58,5,24,29,34,53,87,16,8,24,15,45,17,9,14,97,89
2015,2,21500517,1/4/2016,1610612758,Sacramento Kings,0,1,1610612760,Oklahoma City Thunder,1,0,33,39,72,7,10,17,40,49,89,29,10,39,20,33,26,7,15,102,116
2015,2,21500517,1/4/2016,1610612760,Oklahoma City Thunder,1,0,1610612758,Sacramento Kings,0,1,29,31,60,10,19,29,39,50,89,16,7,23,15,36,23,7,15,102,104
2015,2,21500417,12/21/2015,1610612756,Phoenix Suns,0,0,1610612762,Utah Jazz,1,1,24,31,55,7,17,24,31,48,79,20,2,22,13,36,12,8,16,94,89
2015,2,21500417,12/21/2015,1610612762,Utah Jazz,1,1,1610612756,Phoenix Suns,0,0,27,27,54,9,16,25,36,43,79,29,8,37,13,33,16,3,11,94,110
2015,2,21500311,12/7/2015,1610612746,LA Clippers,0,1,1610612750,Minnesota Timberwolves,1,0,30,31,61,8,17,25,38,48,86,26,3,29,15,36,21,10,18,102,110
2015,2,21500311,12/7/2015,1610612750,Minnesota Timberwolves,1,0,1610612746,LA Clippers,0,1,29,35,64,7,11,18,36,46,82,27,8,35,15,34,18,10,18,102,106
2015,2,21500213,11/24/2015,1610612741,Chicago Bulls,0,1,1610612757,Portland Trail Blazers,1,0,26,42,68,7,11,18,33,53,86,20,3,23,12,42,19,5,14,99,93
2015,2,21500213,11/24/2015,1610612757,Portland Trail Blazers,1,0,1610612741,Chicago Bulls,0,1,25,41,66,6,16,22,31,57,88,20,7,27,17,43,18,6,15,99,88
2015,2,21500120,11/11/2015,1610612744,Golden State Warriors,0,1,1610612763,Memphis Grizzlies,1,0,25,23,48,11,16,27,36,39,75,17,6,23,9,34,22,14,23,98,100
2015,2,21500120,11/11/2015,1610612763,Memphis Grizzlies,1,0,1610612744,Golden State Warriors,0,1,21,34,55,3,12,15,24,46,70,33,3,36,12,34,15,12,21,97,84
2016,2,21601208,4/10/2017,1610612764,Washington Wizards,0,1,1610612765,Detroit Pistons,1,0,35,29,64,7,12,19,42,41,83,14,2,16,10,31,27,9,17,97,105
2015,2,21501134,4/1/2016,1610612750,Minnesota Timberwolves,0,0,1610612762,Utah Jazz,1,1,26,30,56,9,14,23,35,44,79,6,4,10,13,34,25,9,15,85,85
2015,2,21501134,4/1/2016,1610612762,Utah Jazz,1,1,1610612750,Minnesota Timberwolves,0,0,30,20,50,8,14,22,38,34,72,14,9,23,14,24,13,11,16,85,98
2015,2,21501079,3/25/2016,1610612756,Phoenix Suns,0,0,1610612758,Sacramento Kings,1,1,26,36,62,9,23,32,35,59,94,15,8,23,20,42,20,10,22,108,94
2015,2,21501079,3/25/2016,1610612758,Sacramento Kings,1,1,1610612756,Phoenix Suns,0,0,33,35,68,7,15,22,40,50,90,29,10,39,14,39,28,4,12,108,116
2016,2,21601208,4/10/2017,1610612765,Detroit Pistons,1,0,1610612764,Washington Wizards,0,1,33,35,68,10,16,26,43,51,94,5,0,5,10,41,22,8,10,97,101
2016,2,21600645,1/20/2017,1610612740,New Orleans Pelicans,1,0,1610612751,Brooklyn Nets,0,1,32,39,71,11,23,34,43,62,105,17,6,23,20,45,21,5,9,107,114
2015,2,21500846,2/24/2016,1610612752,New York Knicks,0,0,1610612754,Indiana Pacers,1,1,22,29,51,13,13,26,35,42,77,22,3,25,11,34,22,8,14,93,105
2015,2,21500846,2/24/2016,1610612754,Indiana Pacers,1,1,1610612752,New York Knicks,0,0,43,33,76,3,12,15,46,45,91,13,3,16,13,33,22,4,8,93,108
2015,2,21500796,2/10/2016,1610612737,Atlanta Hawks,0,1,1610612741,Chicago Bulls,1,0,30,27,57,13,20,33,43,47,90,14,1,15,13,34,25,7,13,99,113
2015,2,21500796,2/10/2016,1610612741,Chicago Bulls,1,0,1610612737,Atlanta Hawks,0,1,33,39,72,5,9,14,38,48,86,9,3,12,12,38,21,16,19,99,90
2016,2,21600645,1/20/2017,1610612751,Brooklyn Nets,0,1,1610612740,New Orleans Pelicans,1,0,33,20,53,15,15,30,48,35,83,32,3,35,9,29,24,8,16,105,143
2015,2,21500516,1/4/2016,1610612749,Milwaukee Bucks,1,0,1610612759,San Antonio Spurs,0,1,34,31,65,3,9,12,37,40,77,21,9,30,13,32,23,11,16,94,98
2015,2,21500516,1/4/2016,1610612759,San Antonio Spurs,0,1,1610612749,Milwaukee Bucks,1,0,40,30,70,9,11,20,49,41,90,16,4,20,18,26,32,6,13,95,123
2015,2,21500416,12/21/2015,1610612754,Indiana Pacers,0,0,1610612759,San Antonio Spurs,1,1,31,40,71,7,12,19,38,52,90,9,6,15,15,40,21,8,14,95,92
2015,2,21500416,12/21/2015,1610612759,San Antonio Spurs,1,1,1610612754,Indiana Pacers,0,0,40,29,69,6,14,20,46,43,89,8,1,9,8,35,27,5,9,94,106
2015,2,21500212,11/24/2015,1610612743,Denver Nuggets,1,0,1610612746,LA Clippers,0,1,23,30,53,8,17,25,31,47,78,24,5,29,13,35,16,10,16,98,94
2015,2,21500212,11/24/2015,1610612746,LA Clippers,0,1,1610612743,Denver Nuggets,1,0,29,30,59,8,12,20,37,42,79,29,18,47,13,41,24,3,7,98,111
2015,2,21500119,11/11/2015,1610612745,Houston Rockets,1,0,1610612751,Brooklyn Nets,0,1,34,30,64,8,26,34,42,56,98,6,6,12,18,41,25,5,7,94,98
2015,2,21500119,11/11/2015,1610612751,Brooklyn Nets,0,1,1610612745,Houston Rockets,1,0,34,47,81,8,9,17,42,56,98,14,3,17,24,33,25,9,11,94,106
2015,2,21500022,10/30/2015,1610612753,Orlando Magic,1,0,1610612760,Oklahoma City Thunder,0,1,35,38,73,12,21,33,47,59,106,30,8,38,20,43,25,8,18,123,136
2015,2,21500022,10/30/2015,1610612760,Oklahoma City Thunder,0,1,1610612753,Orlando Magic,1,0,42,41,83,8,19,27,50,60,110,31,7,38,24,40,19,10,21,125,139
2014,2,21400858,2/27/2015,1610612737,Atlanta Hawks,1,1,1610612753,Orlando Magic,0,0,22,28,50,14,17,31,36,45,81,9,3,12,15,31,27,10,18,91,95
2014,2,21400858,2/27/2015,1610612753,Orlando Magic,0,0,1610612737,Atlanta Hawks,1,1,27,27,54,9,17,26,36,44,80,7,6,13,15,31,22,11,19,91,88
2015,2,21501214,4/12/2016,1610612755,Philadelphia 76ers,0,0,1610612761,Toronto Raptors,1,1,20,22,42,15,20,35,35,42,77,13,12,25,10,38,24,11,14,94,98
2015,2,21501214,4/12/2016,1610612761,Toronto Raptors,1,1,1610612755,Philadelphia 76ers,0,0,38,32,70,10,15,25,48,47,95,16,3,19,24,25,25,8,14,95,122
2015,2,21501021,3/18/2016,1610612755,Philadelphia 76ers,1,0,1610612760,Oklahoma City Thunder,0,1,25,35,60,10,19,29,35,54,89,17,10,27,11,48,24,3,8,98,97
2015,2,21501021,3/18/2016,1610612760,Oklahoma City Thunder,0,1,1610612755,Philadelphia 76ers,1,0,38,29,67,7,15,22,45,44,89,14,4,18,19,28,27,11,20,98,111
2016,2,21601207,4/10/2017,1610612749,Milwaukee Bucks,1,1,1610612766,Charlotte Hornets,0,0,19,32,51,16,11,27,35,43,78,3,2,5,11,33,28,11,16,85,89
2016,2,21601207,4/10/2017,1610612766,Charlotte Hornets,0,0,1610612749,Milwaukee Bucks,1,1,28,35,63,5,13,18,33,48,81,8,5,13,10,40,21,4,9,85,79
2015,2,21500605,1/16/2016,1610612744,Golden State Warriors,0,0,1610612765,Detroit Pistons,1,1,24,45,69,10,15,25,34,60,94,17,6,23,18,43,18,8,13,99,95
2015,2,21500605,1/16/2016,1610612765,Detroit Pistons,1,1,1610612744,Golden State Warriors,0,0,39,39,78,8,15,23,47,54,101,11,9,20,22,35,22,6,11,101,113
2015,2,21500415,12/21/2015,1610612745,Houston Rockets,1,1,1610612766,Charlotte Hornets,0,0,26,17,43,7,21,28,33,38,71,29,12,41,9,34,18,8,20,97,102
2015,2,21500415,12/21/2015,1610612766,Charlotte Hornets,0,0,1610612745,Houston Rockets,1,1,17,25,42,12,29,41,29,54,83,25,6,31,12,45,20,3,12,98,95
2015,2,21500310,12/7/2015,1610612749,Milwaukee Bucks,1,1,1610612757,Portland Trail Blazers,0,0,26,34,60,4,9,13,30,43,73,26,7,33,12,33,22,10,17,95,90
2015,2,21500310,12/7/2015,1610612757,Portland Trail Blazers,0,0,1610612749,Milwaukee Bucks,1,1,25,27,52,8,25,33,33,52,85,14,4,18,17,37,21,8,17,95,88
2015,2,21500118,11/11/2015,1610612742,Dallas Mavericks,1,1,1610612746,LA Clippers,0,0,31,21,52,11,13,24,42,34,76,23,7,30,8,29,23,4,14,96,118
2015,2,21500118,11/11/2015,1610612746,LA Clippers,0,0,1610612742,Dallas Mavericks,1,1,25,34,59,12,15,27,37,49,86,22,11,33,16,38,21,8,10,97,108
2016,2,21601206,4/10/2017,1610612741,Chicago Bulls,1,1,1610612753,Orlando Magic,0,0,36,27,63,12,14,26,48,41,89,14,2,16,14,28,33,5,13,96,122
2016,2,21601206,4/10/2017,1610612753,Orlando Magic,0,0,1610612741,Chicago Bulls,1,1,24,33,57,5,22,27,29,55,84,12,4,16,11,45,18,12,17,96,75
2015,2,21500970,3/11/2016,1610612753,Orlando Magic,0,1,1610612758,Sacramento Kings,1,0,37,27,64,4,11,15,41,38,79,21,13,34,14,29,22,9,19,102,107
2015,2,21500970,3/11/2016,1610612758,Sacramento Kings,1,0,1610612753,Orlando Magic,0,1,27,36,63,8,17,25,35,53,88,22,3,25,13,41,23,11,17,102,100
2015,2,21500748,2/4/2016,1610612757,Portland Trail Blazers,1,0,1610612761,Toronto Raptors,0,1,28,28,56,10,15,25,38,43,81,17,6,23,12,35,21,7,14,94,103
2015,2,21500748,2/4/2016,1610612761,Toronto Raptors,0,1,1610612757,Portland Trail Blazers,1,0,28,38,66,12,7,19,40,45,85,18,7,25,17,30,23,8,15,96,110
2015,2,21500703,1/29/2016,1610612748,Miami Heat,0,1,1610612749,Milwaukee Bucks,1,0,30,26,56,7,11,18,37,37,74,26,6,32,11,28,27,10,18,98,107
2015,2,21500703,1/29/2016,1610612749,Milwaukee Bucks,1,0,1610612748,Miami Heat,0,1,36,32,68,2,10,12,38,42,80,25,3,28,17,27,18,12,21,97,103
2015,2,21500515,1/4/2016,1610612748,Miami Heat,1,1,1610612754,Indiana Pacers,0,0,29,39,68,5,17,22,34,56,90,30,9,39,20,42,14,4,8,96,103
2015,2,21500515,1/4/2016,1610612754,Indiana Pacers,0,0,1610612748,Miami Heat,1,1,29,37,66,8,20,28,37,57,94,18,7,25,21,38,18,5,11,97,100
2015,2,21500414,12/21/2015,1610612741,Chicago Bulls,1,0,1610612751,Brooklyn Nets,0,1,34,35,69,9,17,26,43,52,95,7,6,13,17,37,32,9,13,97,102
2015,2,21500414,12/21/2015,1610612751,Brooklyn Nets,0,1,1610612741,Chicago Bulls,1,0,36,38,74,7,13,20,43,51,94,12,2,14,19,33,26,8,14,97,105
2015,2,21500211,11/24/2015,1610612742,Dallas Mavericks,0,0,1610612763,Memphis Grizzlies,1,1,19,24,43,11,23,34,30,47,77,25,3,28,9,38,22,12,19,103,96
2015,2,21500211,11/24/2015,1610612763,Memphis Grizzlies,1,1,1610612742,Dallas Mavericks,0,0,30,35,65,7,14,21,37,49,86,29,8,37,10,45,20,4,9,103,110
2016,2,21600180,11/18/2016,1610612742,Dallas Mavericks,1,0,1610612763,Memphis Grizzlies,0,1,16,32,48,5,20,25,21,52,73,17,5,22,13,42,9,7,17,88,64
2016,2,21600180,11/18/2016,1610612763,Memphis Grizzlies,0,1,1610612742,Dallas Mavericks,1,0,22,30,52,9,16,25,31,46,77,9,3,12,7,41,16,3,13,88,80
2015,2,21500117,11/11/2015,1610612737,Atlanta Hawks,1,1,1610612740,New Orleans Pelicans,0,0,32,28,60,10,16,26,42,44,86,12,4,16,11,34,26,6,13,98,106
2015,2,21500117,11/11/2015,1610612740,New Orleans Pelicans,0,0,1610612737,Atlanta Hawks,1,1,23,31,54,14,15,29,37,46,83,10,5,15,12,37,21,10,19,97,98
2015,2,21500021,10/30/2015,1610612739,Cleveland Cavaliers,1,1,1610612748,Miami Heat,0,0,33,28,61,6,19,25,39,47,86,18,3,21,16,33,25,5,11,92,102
2015,2,21500021,10/30/2015,1610612748,Miami Heat,0,0,1610612739,Cleveland Cavaliers,1,1,27,29,56,6,15,21,33,44,77,20,2,22,10,36,21,4,13,91,92
2016,2,21601205,4/10/2017,1610612739,Cleveland Cavaliers,0,0,1610612748,Miami Heat,1,1,30,24,54,14,21,35,44,45,89,19,3,22,10,37,19,9,21,111,121
2016,2,21601205,4/10/2017,1610612748,Miami Heat,1,1,1610612739,Cleveland Cavaliers,0,0,32,30,62,12,21,33,44,51,95,24,10,34,13,41,28,7,13,111,124
2016,2,21600644,1/20/2017,1610612758,Sacramento Kings,0,0,1610612763,Memphis Grizzlies,1,1,25,22,47,6,23,29,31,45,76,23,9,32,6,44,18,6,10,93,91
2016,2,21600644,1/20/2017,1610612763,Memphis Grizzlies,1,1,1610612758,Sacramento Kings,0,0,27,28,55,11,17,28,38,45,83,20,5,25,16,31,21,9,15,93,107
2015,2,21500413,12/21/2015,1610612737,Atlanta Hawks,1,1,1610612757,Portland Trail Blazers,0,0,28,20,48,9,20,29,37,40,77,23,5,28,5,37,21,5,10,96,106
2015,2,21500413,12/21/2015,1610612757,Portland Trail Blazers,0,0,1610612737,Atlanta Hawks,1,1,33,24,57,5,19,24,38,43,81,16,6,22,16,32,24,8,19,95,97
2015,2,21500309,12/7/2015,1610612741,Chicago Bulls,1,0,1610612756,Phoenix Suns,0,1,35,34,69,6,15,21,41,49,90,13,5,18,21,30,28,12,20,99,101
2015,2,21500309,12/7/2015,1610612756,Phoenix Suns,0,1,1610612741,Chicago Bulls,1,0,34,41,75,7,10,17,41,51,92,14,3,17,18,34,18,11,19,99,103
2015,2,21500116,11/11/2015,1610612738,Boston Celtics,1,0,1610612754,Indiana Pacers,0,1,28,25,53,4,20,24,32,45,77,23,9,32,13,35,18,9,18,99,91
2014,2,21400857,2/27/2015,1610612755,Philadelphia 76ers,1,1,1610612764,Washington Wizards,0,0,16,31,47,12,21,33,28,52,80,21,13,34,16,42,21,4,15,96,89
2014,2,21400857,2/27/2015,1610612764,Washington Wizards,0,0,1610612755,Philadelphia 76ers,1,1,26,50,76,4,13,17,30,63,93,17,5,22,21,44,20,7,13,96,81
2015,2,21500116,11/11/2015,1610612754,Indiana Pacers,0,1,1610612738,Boston Celtics,1,0,32,30,62,6,11,17,38,41,79,20,11,31,13,32,20,10,19,99,102
2014,2,21400856,2/27/2015,1610612739,Cleveland Cavaliers,0,0,1610612754,Indiana Pacers,1,1,24,39,63,9,20,29,33,59,92,11,3,14,21,40,20,8,15,91,86
2014,2,21400856,2/27/2015,1610612754,Indiana Pacers,1,1,1610612739,Cleveland Cavaliers,0,0,28,35,63,6,11,17,34,46,80,19,10,29,13,37,23,3,8,92,93
2015,2,21501078,3/25/2016,1610612759,San Antonio Spurs,1,1,1610612763,Memphis Grizzlies,0,0,37,22,59,7,11,18,44,33,77,15,3,18,11,23,25,11,14,90,110
2015,2,21501078,3/25/2016,1610612763,Memphis Grizzlies,0,0,1610612759,San Antonio Spurs,1,1,37,28,65,7,11,18,44,39,83,9,4,13,10,31,23,7,11,89,104
2015,2,21500845,2/24/2016,1610612739,Cleveland Cavaliers,1,1,1610612766,Charlotte Hornets,0,0,32,27,59,13,19,32,45,46,91,11,6,17,15,35,26,7,9,94,114
2015,2,21500845,2/24/2016,1610612766,Charlotte Hornets,0,0,1610612739,Cleveland Cavaliers,1,1,27,20,47,10,19,29,37,39,76,19,8,27,9,35,23,11,14,94,103
2016,2,21601204,4/10/2017,1610612738,Boston Celtics,1,1,1610612751,Brooklyn Nets,0,0,27,26,53,14,24,38,41,50,91,18,3,21,10,42,31,8,14,104,114
2016,2,21601204,4/10/2017,1610612751,Brooklyn Nets,0,0,1610612738,Boston Celtics,1,1,23,32,55,8,23,31,31,55,86,35,4,39,13,44,18,7,12,106,105
2015,2,21500604,1/16/2016,1610612738,Boston Celtics,0,1,1610612764,Washington Wizards,1,0,30,29,59,9,20,29,39,49,88,32,4,36,19,33,27,13,16,102,119
2015,2,21500604,1/16/2016,1610612764,Washington Wizards,1,0,1610612738,Boston Celtics,0,1,34,33,67,6,16,22,40,49,89,31,5,36,19,31,25,7,14,102,117
2015,2,21500514,1/4/2016,1610612753,Orlando Magic,0,0,1610612765,Detroit Pistons,1,1,30,31,61,6,14,20,36,45,81,11,0,11,9,36,17,6,11,86,89
2015,2,21500514,1/4/2016,1610612765,Detroit Pistons,1,1,1610612753,Orlando Magic,0,0,29,29,58,14,16,30,43,45,88,15,6,21,23,25,25,6,10,88,115
2015,2,21500412,12/21/2015,1610612752,New York Knicks,1,0,1610612753,Orlando Magic,0,1,32,20,52,7,17,24,39,37,76,14,2,16,12,27,21,8,15,88,99
2015,2,21500412,12/21/2015,1610612753,Orlando Magic,0,1,1610612752,New York Knicks,1,0,34,30,64,10,12,22,44,42,86,9,2,11,13,30,19,5,10,88,107
2015,2,21500210,11/24/2015,1610612737,Atlanta Hawks,1,1,1610612738,Boston Celtics,0,0,33,23,56,12,12,24,45,35,80,19,3,22,13,23,33,14,21,99,121
2015,2,21500210,11/24/2015,1610612738,Boston Celtics,0,0,1610612737,Atlanta Hawks,1,1,25,36,61,9,12,21,34,48,82,20,6,26,13,39,23,8,17,98,97
2015,2,21500115,11/11/2015,1610612755,Philadelphia 76ers,1,0,1610612761,Toronto Raptors,0,1,28,30,58,12,17,29,40,47,87,11,6,17,13,39,28,7,12,93,103
2015,2,21500115,11/11/2015,1610612761,Toronto Raptors,0,1,1610612755,Philadelphia 76ers,1,0,38,33,71,5,13,18,43,46,89,28,3,31,19,28,22,2,8,95,119
2015,2,21500020,10/29/2015,1610612742,Dallas Mavericks,0,0,1610612746,LA Clippers,1,1,29,38,67,6,24,30,35,62,97,12,3,15,16,48,22,6,13,101,88
2015,2,21500020,10/29/2015,1610612746,LA Clippers,1,1,1610612742,Dallas Mavericks,0,0,30,26,56,8,23,31,38,49,87,20,13,33,12,42,21,4,8,103,104
2015,2,21501213,4/12/2016,1610612748,Miami Heat,0,1,1610612765,Detroit Pistons,1,0,31,27,58,7,13,20,38,40,78,16,6,22,12,32,15,9,15,93,99
2015,2,21501213,4/12/2016,1610612765,Detroit Pistons,1,0,1610612748,Miami Heat,0,1,29,37,66,5,13,18,34,50,84,20,10,30,24,31,15,7,16,93,93
2015,2,21501133,4/1/2016,1610612749,Milwaukee Bucks,1,1,1610612753,Orlando Magic,0,0,43,26,69,4,13,17,47,39,86,15,10,25,10,34,31,13,16,102,113
2015,2,21501133,4/1/2016,1610612753,Orlando Magic,0,0,1610612749,Milwaukee Bucks,1,1,38,24,62,8,16,24,46,40,86,10,2,12,8,34,34,14,20,104,110
2015,2,21501020,3/18/2016,1610612739,Cleveland Cavaliers,0,1,1610612753,Orlando Magic,1,0,25,23,48,13,15,28,38,38,76,20,7,27,12,29,23,12,19,96,109
2015,2,21501020,3/18/2016,1610612753,Orlando Magic,1,0,1610612739,Cleveland Cavaliers,0,1,26,34,60,11,11,22,37,45,82,18,4,22,11,36,24,7,13,96,103
2015,2,21500969,3/11/2016,1610612762,Utah Jazz,1,1,1610612764,Washington Wizards,0,0,29,22,51,9,7,16,38,29,67,29,9,38,7,25,15,9,18,97,114
2015,2,21500969,3/11/2016,1610612764,Washington Wizards,0,0,1610612762,Utah Jazz,1,1,28,28,56,7,17,24,35,45,80,16,6,22,9,39,20,10,14,96,93
2015,2,21500909,3/3/2016,1610612740,New Orleans Pelicans,1,0,1610612759,San Antonio Spurs,0,1,27,38,65,8,16,24,35,54,89,8,0,8,10,44,23,8,11,93,86
2015,2,21500909,3/3/2016,1610612759,San Antonio Spurs,0,1,1610612740,New Orleans Pelicans,1,0,28,32,60,8,13,21,36,45,81,14,1,15,10,35,27,6,13,93,94
2015,2,21500702,1/29/2016,1610612742,Dallas Mavericks,1,1,1610612751,Brooklyn Nets,0,0,29,30,59,8,13,21,37,43,80,9,6,15,13,34,22,10,14,89,91
2015,2,21500702,1/29/2016,1610612751,Brooklyn Nets,0,0,1610612742,Dallas Mavericks,1,1,24,34,58,4,16,20,28,50,78,19,4,23,11,40,13,6,10,88,79
2015,2,21500659,1/23/2016,1610612739,Cleveland Cavaliers,1,0,1610612741,Chicago Bulls,0,1,31,39,70,4,20,24,35,59,94,9,13,22,21,44,17,2,4,87,83
2015,2,21500659,1/23/2016,1610612741,Chicago Bulls,0,1,1610612739,Cleveland Cavaliers,1,0,31,39,70,7,10,17,38,49,87,13,2,15,15,35,21,5,8,87,96
2016,2,21600643,1/20/2017,1610612749,Milwaukee Bucks,0,0,1610612753,Orlando Magic,1,1,24,34,58,10,15,25,34,49,83,18,8,26,16,39,21,9,12,92,96
2016,2,21600643,1/20/2017,1610612753,Orlando Magic,1,1,1610612749,Milwaukee Bucks,0,0,32,27,59,8,20,28,40,47,87,24,7,31,19,32,25,6,10,92,112
2015,2,21500411,12/21/2015,1610612738,Boston Celtics,1,1,1610612750,Minnesota Timberwolves,0,0,34,30,64,12,13,25,46,43,89,9,7,16,16,31,34,9,17,98,113
2015,2,21500411,12/21/2015,1610612750,Minnesota Timberwolves,0,0,1610612738,Boston Celtics,1,1,34,32,66,2,11,13,36,43,79,25,7,32,7,40,20,6,13,98,99
2015,2,21500308,12/7/2015,1610612747,Los Angeles Lakers,0,0,1610612761,Toronto Raptors,1,1,27,37,64,7,12,19,34,49,83,18,2,20,15,34,14,7,15,92,93
2015,2,21500308,12/7/2015,1610612761,Toronto Raptors,1,1,1610612747,Los Angeles Lakers,0,0,25,24,49,9,16,25,34,40,74,25,7,32,8,35,18,4,9,91,102
2015,2,21500114,11/11/2015,1610612747,Los Angeles Lakers,0,0,1610612753,Orlando Magic,1,1,32,25,57,7,15,22,39,40,79,14,4,18,10,32,25,7,14,90,99
2015,2,21500114,11/11/2015,1610612753,Orlando Magic,1,1,1610612747,Los Angeles Lakers,0,0,27,45,72,13,15,28,40,60,100,8,4,12,23,40,22,5,8,91,101
2016,2,21600179,11/18/2016,1610612738,Boston Celtics,1,0,1610612744,Golden State Warriors,0,1,20,31,51,11,21,32,31,52,83,15,4,19,11,42,19,10,13,95,88
2016,2,21600179,11/18/2016,1610612744,Golden State Warriors,0,1,1610612738,Boston Celtics,1,0,35,27,62,9,19,28,44,46,90,7,5,12,11,38,33,6,11,96,104
2015,2,21501212,4/12/2016,1610612752,New York Knicks,0,0,1610612754,Indiana Pacers,1,1,26,27,53,10,17,27,36,44,80,8,1,9,9,36,27,10,16,91,90
2015,2,21501212,4/12/2016,1610612754,Indiana Pacers,1,1,1610612752,New York Knicks,0,0,35,26,61,6,13,19,41,39,80,14,6,20,12,30,26,6,14,91,102
2016,2,21601203,4/10/2017,1610612754,Indiana Pacers,0,1,1610612755,Philadelphia 76ers,1,0,44,25,69,5,11,16,49,36,85,17,4,21,15,23,30,10,15,95,120
2016,2,21601203,4/10/2017,1610612755,Philadelphia 76ers,1,0,1610612754,Indiana Pacers,0,1,22,20,42,13,20,33,35,40,75,28,3,31,11,30,20,9,18,97,111
2015,2,21500747,2/4/2016,1610612740,New Orleans Pelicans,1,0,1610612747,Los Angeles Lakers,0,1,35,30,65,4,16,20,39,46,85,14,12,26,10,44,16,4,7,97,96
2015,2,21500747,2/4/2016,1610612747,Los Angeles Lakers,0,1,1610612740,New Orleans Pelicans,1,0,32,29,61,7,13,20,39,42,81,14,6,20,9,36,14,8,16,95,99
2016,2,21600642,1/20/2017,1610612761,Toronto Raptors,0,0,1610612766,Charlotte Hornets,1,1,22,34,56,7,23,30,29,57,86,13,1,14,13,45,10,9,12,92,78
2016,2,21600642,1/20/2017,1610612766,Charlotte Hornets,1,1,1610612761,Toronto Raptors,0,0,28,27,55,12,13,25,40,40,80,21,4,25,15,26,24,7,16,93,113
2015,2,21500513,1/4/2016,1610612738,Boston Celtics,0,1,1610612751,Brooklyn Nets,1,0,35,36,71,6,15,21,41,51,92,15,4,19,15,39,22,4,7,94,103
2015,2,21500513,1/4/2016,1610612751,Brooklyn Nets,1,0,1610612738,Boston Celtics,0,1,26,31,57,6,22,28,32,53,85,24,3,27,19,37,16,10,14,94,94
2015,2,21500410,12/21/2015,1610612758,Sacramento Kings,0,0,1610612764,Washington Wizards,1,1,30,39,69,7,15,22,37,54,91,18,4,22,18,36,24,9,15,98,99
2015,2,21500410,12/21/2015,1610612764,Washington Wizards,1,1,1610612758,Sacramento Kings,0,0,28,31,59,14,10,24,42,41,83,15,2,17,6,35,31,8,11,98,113
2015,2,21500209,11/24/2015,1610612754,Indiana Pacers,0,1,1610612764,Washington Wizards,1,0,25,29,54,19,7,26,44,36,80,16,7,23,9,32,25,9,20,103,123
2015,2,21500209,11/24/2015,1610612764,Washington Wizards,1,0,1610612754,Indiana Pacers,0,1,25,25,50,13,20,33,38,45,83,17,7,24,14,34,27,11,21,102,106
2015,2,21500019,10/29/2015,1610612737,Atlanta Hawks,0,1,1610612752,New York Knicks,1,0,32,27,59,10,14,24,42,41,83,18,8,26,10,33,26,10,16,101,112
2015,2,21500019,10/29/2015,1610612752,New York Knicks,1,0,1610612737,Atlanta Hawks,0,1,32,32,64,6,23,29,38,55,93,19,2,21,24,33,21,11,21,101,101
2016,2,21601202,4/9/2017,1610612747,Los Angeles Lakers,1,1,1610612750,Minnesota Timberwolves,0,0,32,27,59,10,17,27,42,44,86,16,4,20,13,35,26,8,16,97,110
2016,2,21601202,4/9/2017,1610612750,Minnesota Timberwolves,0,0,1610612747,Los Angeles Lakers,1,1,37,28,65,3,12,15,40,40,80,26,5,31,12,31,27,10,15,97,109
2015,2,21500908,3/3/2016,1610612748,Miami Heat,1,1,1610612756,Phoenix Suns,0,0,31,35,66,9,8,17,40,43,83,19,6,25,13,33,25,7,13,97,108
2015,2,21500908,3/3/2016,1610612756,Phoenix Suns,0,0,1610612748,Miami Heat,1,1,28,32,60,5,17,22,33,49,82,21,6,27,9,43,12,5,12,97,92
2015,2,21500844,2/23/2016,1610612751,Brooklyn Nets,0,0,1610612757,Portland Trail Blazers,1,1,40,38,78,3,9,12,43,47,90,15,4,19,13,35,18,6,13,98,104
2015,2,21500844,2/23/2016,1610612757,Portland Trail Blazers,1,1,1610612751,Brooklyn Nets,0,0,30,27,57,10,13,23,40,40,80,22,3,25,8,35,24,10,15,100,112
2015,2,21500795,2/10/2016,1610612739,Cleveland Cavaliers,1,1,1610612747,Los Angeles Lakers,0,0,35,28,63,13,18,31,48,46,94,11,7,18,15,35,26,5,7,94,120
2015,2,21500795,2/10/2016,1610612747,Los Angeles Lakers,0,0,1610612739,Cleveland Cavaliers,1,1,25,33,58,13,15,28,38,48,86,22,5,27,13,36,16,6,11,95,111
2015,2,21500701,1/29/2016,1610612745,Houston Rockets,0,0,1610612760,Oklahoma City Thunder,1,1,27,29,56,9,30,39,36,59,95,27,16,43,20,49,23,6,12,110,108
2015,2,21500701,1/29/2016,1610612760,Oklahoma City Thunder,1,1,1610612745,Houston Rockets,0,0,33,34,67,8,11,19,41,45,86,26,4,30,11,34,23,14,19,110,116
2016,2,21600641,1/20/2017,1610612755,Philadelphia 76ers,1,1,1610612757,Portland Trail Blazers,0,0,24,39,63,12,17,29,36,56,92,9,7,16,22,36,25,8,19,99,93
2016,2,21600641,1/20/2017,1610612757,Portland Trail Blazers,0,0,1610612755,Philadelphia 76ers,1,1,27,43,70,6,13,19,33,56,89,20,8,28,18,43,16,6,13,100,92
2015,2,21500409,12/20/2015,1610612740,New Orleans Pelicans,0,1,1610612743,Denver Nuggets,1,0,33,21,54,11,13,24,44,34,78,31,8,39,10,29,24,5,10,96,130
2015,2,21500409,12/20/2015,1610612743,Denver Nuggets,1,0,1610612740,New Orleans Pelicans,0,1,28,33,61,17,18,35,45,51,96,18,4,22,18,35,26,4,6,98,125
2015,2,21500307,12/7/2015,1610612742,Dallas Mavericks,0,1,1610612752,New York Knicks,1,0,24,27,51,13,18,31,37,45,82,17,3,20,7,37,21,4,9,92,104
2015,2,21500307,12/7/2015,1610612752,New York Knicks,1,0,1610612742,Dallas Mavericks,0,1,31,28,59,9,16,25,40,44,84,8,1,9,8,38,25,7,13,93,97
2015,2,21500208,11/23/2015,1610612760,Oklahoma City Thunder,0,1,1610612762,Utah Jazz,1,0,31,19,50,11,16,27,42,35,77,16,2,18,8,28,22,11,17,96,111
2015,2,21500208,11/23/2015,1610612762,Utah Jazz,1,0,1610612760,Oklahoma City Thunder,0,1,23,31,54,5,14,19,28,45,73,28,12,40,17,33,15,12,21,95,89
2015,2,21500113,11/11/2015,1610612752,New York Knicks,0,0,1610612766,Charlotte Hornets,1,1,38,27,65,4,17,21,42,44,86,5,2,7,15,30,20,11,17,92,93
2015,2,21500113,11/11/2015,1610612766,Charlotte Hornets,1,1,1610612752,New York Knicks,0,0,27,34,61,8,15,23,35,49,84,17,11,28,11,43,21,5,5,92,95
2014,2,21400855,2/26/2015,1610612756,Phoenix Suns,1,1,1610612760,Oklahoma City Thunder,0,0,39,32,71,9,17,26,48,49,97,12,8,20,16,38,21,6,16,109,117
2014,2,21400855,2/26/2015,1610612760,Oklahoma City Thunder,0,0,1610612756,Phoenix Suns,1,1,31,46,77,8,16,24,39,62,101,27,3,30,17,47,17,4,10,109,113
2015,2,21501211,4/11/2016,1610612756,Phoenix Suns,1,0,1610612758,Sacramento Kings,0,1,36,42,78,5,17,22,41,59,100,14,3,17,22,39,21,11,19,107,101
2015,2,21501211,4/11/2016,1610612758,Sacramento Kings,0,1,1610612756,Phoenix Suns,1,0,35,31,66,6,11,17,41,42,83,17,11,28,10,37,25,8,19,106,105
2015,2,21501132,4/1/2016,1610612761,Toronto Raptors,0,1,1610612763,Memphis Grizzlies,1,0,18,25,43,12,16,28,30,41,71,27,2,29,14,28,16,13,18,91,99
2015,2,21501132,4/1/2016,1610612763,Memphis Grizzlies,1,0,1610612761,Toronto Raptors,0,1,30,42,72,7,12,19,37,54,91,14,3,17,24,30,16,8,14,91,95
2015,2,21501019,3/17/2016,1610612756,Phoenix Suns,0,0,1610612762,Utah Jazz,1,1,22,34,56,6,20,26,28,54,82,7,7,14,13,44,14,14,21,96,69
2015,2,21501019,3/17/2016,1610612762,Utah Jazz,1,1,1610612756,Phoenix Suns,0,0,32,31,63,11,14,25,43,45,88,6,3,9,11,36,20,9,16,96,103
2016,2,21601201,4/9/2017,1610612763,Memphis Grizzlies,1,0,1610612765,Detroit Pistons,0,1,27,27,54,9,12,21,36,39,75,9,4,13,9,31,23,8,15,88,90
2016,2,21601201,4/9/2017,1610612765,Detroit Pistons,0,1,1610612763,Memphis Grizzlies,1,0,25,29,54,14,14,28,39,43,82,11,5,16,20,26,21,12,18,88,103
2016,2,21600640,1/19/2017,1610612746,LA Clippers,1,0,1610612750,Minnesota Timberwolves,0,1,38,27,65,4,18,22,42,45,87,13,11,24,18,32,24,3,11,94,101
2016,2,21600640,1/19/2017,1610612750,Minnesota Timberwolves,0,1,1610612746,LA Clippers,1,0,35,33,68,5,11,16,40,44,84,19,6,25,16,33,25,9,14,93,104
2015,2,21500603,1/16/2016,1610612749,Milwaukee Bucks,0,1,1610612766,Charlotte Hornets,1,0,34,26,60,5,7,12,39,33,72,22,4,26,11,24,23,8,15,92,105
2015,2,21500603,1/16/2016,1610612766,Charlotte Hornets,1,0,1610612749,Milwaukee Bucks,0,1,24,27,51,9,27,36,33,54,87,17,5,22,16,41,27,3,8,90,92
2015,2,21500512,1/4/2016,1610612750,Minnesota Timberwolves,0,0,1610612755,Philadelphia 76ers,1,1,37,31,68,2,3,5,39,34,73,19,5,24,10,25,26,11,17,90,99
2015,2,21500512,1/4/2016,1610612755,Philadelphia 76ers,1,1,1610612750,Minnesota Timberwolves,0,0,44,23,67,4,16,20,48,39,87,9,5,14,19,24,31,11,17,91,109
2015,2,21500408,12/20/2015,1610612758,Sacramento Kings,0,1,1610612761,Toronto Raptors,1,0,31,24,55,9,12,21,40,36,76,15,9,24,7,36,26,8,16,97,104
2015,2,21500408,12/20/2015,1610612761,Toronto Raptors,1,0,1610612758,Sacramento Kings,0,1,27,38,65,8,21,29,35,59,94,16,1,17,19,40,12,8,12,98,94
2015,2,21500207,11/23/2015,1610612756,Phoenix Suns,0,0,1610612759,San Antonio Spurs,1,1,27,27,54,7,12,19,34,39,73,9,1,10,10,30,23,18,28,96,84
2015,2,21500207,11/23/2015,1610612759,San Antonio Spurs,1,1,1610612756,Phoenix Suns,0,0,33,29,62,9,11,20,42,40,82,5,5,10,14,29,21,13,21,95,98
2015,2,21500018,10/29/2015,1610612754,Indiana Pacers,1,0,1610612763,Memphis Grizzlies,0,1,25,23,48,12,18,30,37,41,78,17,7,24,14,31,23,12,20,96,103
2015,2,21500018,10/29/2015,1610612763,Memphis Grizzlies,0,1,1610612754,Indiana Pacers,1,0,34,32,66,7,9,16,41,41,82,23,6,29,16,29,26,7,14,97,112
2014,2,21400854,2/26/2015,1610612739,Cleveland Cavaliers,1,1,1610612744,Golden State Warriors,0,0,27,22,49,9,19,28,36,41,77,29,6,35,11,32,15,10,16,100,110
2014,2,21400854,2/26/2015,1610612744,Golden State Warriors,0,0,1610612739,Cleveland Cavaliers,1,1,28,35,63,11,18,29,39,53,92,10,9,19,14,44,32,10,14,100,99
2015,2,21501077,3/25/2016,1610612745,Houston Rockets,1,1,1610612761,Toronto Raptors,0,0,30,29,59,12,10,22,42,39,81,16,19,35,15,33,25,9,17,97,112
2015,2,21501077,3/25/2016,1610612761,Toronto Raptors,0,0,1610612745,Houston Rockets,1,1,26,37,63,13,18,31,39,55,94,18,8,26,21,38,23,3,12,96,109
2015,2,21500968,3/11/2016,1610612750,Minnesota Timberwolves,0,1,1610612760,Oklahoma City Thunder,1,0,30,35,65,7,14,21,37,49,86,18,3,21,9,40,22,3,12,102,99
2015,2,21500968,3/11/2016,1610612760,Oklahoma City Thunder,1,0,1610612750,Minnesota Timberwolves,0,1,30,27,57,6,21,27,36,48,84,18,7,25,18,33,15,12,24,100,96
2015,2,21500843,2/23/2016,1610612745,Houston Rockets,0,0,1610612762,Utah Jazz,1,1,25,28,53,11,23,34,36,51,87,31,10,41,17,39,17,11,15,106,114
2015,2,21500843,2/23/2016,1610612762,Utah Jazz,1,1,1610612745,Houston Rockets,0,0,28,22,50,10,14,24,38,36,74,31,7,38,9,29,22,15,22,106,117
2016,2,21601200,4/9/2017,1610612745,Houston Rockets,0,1,1610612758,Sacramento Kings,1,0,27,10,37,18,25,43,45,35,80,27,4,31,6,32,26,8,18,104,135
2016,2,21601200,4/9/2017,1610612758,Sacramento Kings,1,0,1610612745,Houston Rockets,0,1,38,25,63,9,22,31,47,47,94,25,5,30,9,41,26,3,5,105,128
2015,2,21500700,1/29/2016,1610612752,New York Knicks,1,1,1610612756,Phoenix Suns,0,0,29,35,64,7,13,20,36,48,84,23,3,26,13,35,24,4,9,94,102
2015,2,21500700,1/29/2016,1610612756,Phoenix Suns,0,0,1610612752,New York Knicks,1,1,28,31,59,7,19,26,35,50,85,7,5,12,14,40,20,12,16,93,84
2015,2,21500658,1/23/2016,1610612750,Minnesota Timberwolves,1,1,1610612763,Memphis Grizzlies,0,0,29,22,51,5,12,17,34,34,68,33,3,36,9,25,26,9,16,92,106
2015,2,21500658,1/23/2016,1610612763,Memphis Grizzlies,0,0,1610612750,Minnesota Timberwolves,1,1,28,32,60,9,10,19,37,42,79,18,4,22,12,32,22,7,14,93,101
2015,2,21500511,1/4/2016,1610612739,Cleveland Cavaliers,1,1,1610612761,Toronto Raptors,0,0,24,17,41,17,16,33,41,33,74,23,3,26,13,20,25,9,14,88,122
2015,2,21500511,1/4/2016,1610612761,Toronto Raptors,0,0,1610612739,Cleveland Cavaliers,1,1,28,26,54,8,11,19,36,37,73,20,9,29,11,31,24,6,11,88,100
2015,2,21500407,12/20/2015,1610612737,Atlanta Hawks,0,1,1610612753,Orlando Magic,1,0,28,28,56,11,11,22,39,39,78,14,6,20,12,30,25,16,20,93,103
2015,2,21500407,12/20/2015,1610612753,Orlando Magic,1,0,1610612737,Atlanta Hawks,0,1,34,35,69,4,8,12,38,43,81,20,4,24,11,34,27,6,13,94,100
2015,2,21500306,12/7/2015,1610612748,Miami Heat,1,0,1610612764,Washington Wizards,0,1,36,17,53,5,11,16,41,28,69,16,6,22,4,27,25,7,17,92,103
2015,2,21500306,12/7/2015,1610612764,Washington Wizards,0,1,1610612748,Miami Heat,1,0,37,37,74,9,9,18,46,46,92,13,4,17,18,31,23,5,12,94,114
2015,2,21500206,11/23/2015,1610612750,Minnesota Timberwolves,1,1,1610612755,Philadelphia 76ers,0,0,33,33,66,3,9,12,36,42,78,25,2,27,13,31,20,10,17,95,100
2015,2,21500206,11/23/2015,1610612755,Philadelphia 76ers,0,0,1610612750,Minnesota Timberwolves,1,1,22,25,47,10,21,31,32,46,78,21,6,27,14,35,15,8,19,95,95
2015,2,21500112,11/10/2015,1610612740,New Orleans Pelicans,1,1,1610612742,Dallas Mavericks,0,0,32,27,59,14,19,33,46,46,92,14,4,18,11,37,25,4,11,102,120
2015,2,21500112,11/10/2015,1610612742,Dallas Mavericks,0,0,1610612740,New Orleans Pelicans,1,1,34,34,68,5,15,20,39,49,88,22,4,26,12,40,20,9,13,102,105
2015,2,21500017,10/28/2015,1610612747,Los Angeles Lakers,1,0,1610612750,Minnesota Timberwolves,0,1,26,30,56,9,25,34,35,55,90,32,3,35,22,35,18,3,14,99,111
2015,2,21500017,10/28/2015,1610612750,Minnesota Timberwolves,0,1,1610612747,Los Angeles Lakers,1,0,33,30,63,5,15,20,38,45,83,31,6,37,10,38,24,2,8,97,112
2015,2,21501076,3/25/2016,1610612737,Atlanta Hawks,1,1,1610612749,Milwaukee Bucks,0,0,36,29,65,5,27,32,41,56,97,14,3,17,22,35,26,4,11,92,101
2015,2,21501076,3/25/2016,1610612749,Milwaukee Bucks,0,0,1610612737,Atlanta Hawks,1,1,32,39,71,3,10,13,35,49,84,17,9,26,21,32,16,10,16,94,90
2015,2,21500967,3/11/2016,1610612740,New Orleans Pelicans,0,0,1610612763,Memphis Grizzlies,1,1,35,37,72,7,17,24,42,54,96,23,11,34,18,41,23,14,18,109,114
2015,2,21500967,3/11/2016,1610612763,Memphis Grizzlies,1,1,1610612740,New Orleans Pelicans,0,0,41,41,82,6,8,14,47,49,96,21,11,32,12,44,27,6,10,110,121
2015,2,21500907,3/2/2016,1610612746,LA Clippers,1,1,1610612760,Oklahoma City Thunder,0,0,31,35,66,9,23,32,40,58,98,14,7,21,16,46,26,3,6,97,103
2015,2,21500907,3/2/2016,1610612760,Oklahoma City Thunder,0,0,1610612746,LA Clippers,1,1,29,34,63,10,25,35,39,59,98,10,1,11,22,37,22,11,17,97,98
2022,2,22200521,12/28/2022,1610612744,Golden State Warriors,1,1,1610612762,Utah Jazz,0,0,21,21,42,16,29,45,37,50,87,22,5,27,11,42,22,3,13,102,112
2022,2,22200521,12/28/2022,1610612762,Utah Jazz,0,0,1610612744,Golden State Warriors,1,1,22,23,45,15,31,46,37,54,91,18,8,26,13,45,26,6,12,103,107
2015,2,21500794,2/10/2016,1610612743,Denver Nuggets,0,1,1610612765,Detroit Pistons,1,0,33,31,64,6,13,19,39,44,83,19,5,24,11,35,25,5,12,95,103
2015,2,21500794,2/10/2016,1610612765,Detroit Pistons,1,0,1610612743,Denver Nuggets,0,1,28,33,61,10,17,27,38,50,88,6,1,7,10,41,21,10,14,96,92
2016,2,21601199,4/9/2017,1610612742,Dallas Mavericks,0,0,1610612756,Phoenix Suns,1,1,25,27,52,16,29,45,41,56,97,13,6,19,21,38,23,6,10,94,111
2016,2,21601199,4/9/2017,1610612756,Phoenix Suns,1,1,1610612742,Dallas Mavericks,0,0,36,25,61,8,11,19,44,36,80,28,4,32,12,27,26,5,12,94,124
2016,2,21600178,11/18/2016,1610612751,Brooklyn Nets,0,0,1610612760,Oklahoma City Thunder,1,1,24,30,54,11,18,29,35,48,83,24,6,30,13,37,19,9,16,101,105
2016,2,21600178,11/18/2016,1610612760,Oklahoma City Thunder,1,1,1610612751,Brooklyn Nets,0,0,42,21,63,7,19,26,49,40,89,19,5,24,16,25,23,6,16,100,124
2015,2,21500510,1/3/2016,1610612747,Los Angeles Lakers,1,1,1610612756,Phoenix Suns,0,0,30,32,62,8,14,22,38,46,84,13,4,17,10,38,26,8,16,98,97
2015,2,21500510,1/3/2016,1610612756,Phoenix Suns,0,0,1610612747,Los Angeles Lakers,1,1,26,36,62,6,21,27,32,57,89,7,2,9,11,47,16,8,14,96,77
2015,2,21500406,12/20/2015,1610612749,Milwaukee Bucks,0,1,1610612756,Phoenix Suns,1,0,36,27,63,5,11,16,41,38,79,14,10,24,10,35,25,8,14,96,101
2015,2,21500406,12/20/2015,1610612756,Phoenix Suns,1,0,1610612749,Milwaukee Bucks,0,1,25,31,56,8,10,18,33,41,74,21,3,24,8,34,18,8,21,97,95
2015,2,21500305,12/7/2015,1610612755,Philadelphia 76ers,1,0,1610612759,San Antonio Spurs,0,1,22,29,51,4,20,24,26,49,75,12,9,21,11,43,14,4,13,88,68
2015,2,21500305,12/7/2015,1610612759,San Antonio Spurs,0,1,1610612755,Philadelphia 76ers,1,0,43,22,65,4,7,11,47,29,76,21,4,25,7,25,32,3,7,88,119
2023,2,22300466,1/3/2024,1610612749,Milwaukee Bucks,0,0,1610612754,Indiana Pacers,1,1,32,23,55,14,23,37,46,46,92,24,8,32,12,38,30,7,13,105,130
2023,2,22300466,1/3/2024,1610612754,Indiana Pacers,1,1,1610612749,Milwaukee Bucks,0,0,36,19,55,14,21,35,50,40,90,28,6,34,11,32,34,6,11,107,142
2015,2,21500016,10/28/2015,1610612746,LA Clippers,0,1,1610612758,Sacramento Kings,1,0,36,25,61,6,13,19,42,38,80,21,10,31,7,37,20,8,15,102,111
2015,2,21500016,10/28/2015,1610612758,Sacramento Kings,1,0,1610612746,LA Clippers,0,1,30,40,70,11,13,24,41,53,94,11,7,18,19,38,24,8,18,103,104
2014,2,21400853,2/25/2015,1610612757,Portland Trail Blazers,1,1,1610612759,San Antonio Spurs,0,0,30,29,59,13,13,26,43,42,85,12,3,15,15,29,25,8,14,90,111
2014,2,21400853,2/25/2015,1610612759,San Antonio Spurs,0,0,1610612757,Portland Trail Blazers,1,1,29,35,64,8,13,21,37,48,85,13,1,14,15,34,20,9,13,90,95
2015,2,21501018,3/17/2016,1610612757,Portland Trail Blazers,0,0,1610612759,San Antonio Spurs,1,1,29,38,67,10,12,22,39,50,89,22,8,30,19,36,23,8,13,98,110
2015,2,21501018,3/17/2016,1610612759,San Antonio Spurs,1,1,1610612757,Portland Trail Blazers,0,0,37,33,70,8,8,16,45,41,86,20,2,22,6,37,35,5,7,99,118
2015,2,21500746,2/4/2016,1610612752,New York Knicks,0,0,1610612765,Detroit Pistons,1,1,30,32,62,6,16,22,36,48,84,27,7,34,11,39,20,7,10,101,105
2015,2,21500746,2/4/2016,1610612765,Detroit Pistons,1,1,1610612752,New York Knicks,0,0,31,31,62,9,8,17,40,39,79,22,11,33,6,38,17,7,13,101,111
2015,2,21500602,1/16/2016,1610612737,Atlanta Hawks,1,1,1610612751,Brooklyn Nets,0,0,36,14,50,8,21,29,44,35,79,18,6,24,7,30,34,5,10,95,114
2015,2,21500602,1/16/2016,1610612751,Brooklyn Nets,0,0,1610612737,Atlanta Hawks,1,1,28,30,58,6,14,20,34,44,78,12,7,19,11,37,22,14,17,95,86
2015,2,21500509,1/3/2016,1610612743,Denver Nuggets,1,0,1610612757,Portland Trail Blazers,0,1,27,31,58,7,15,22,34,46,80,31,17,48,18,36,20,4,9,92,106
2015,2,21500509,1/3/2016,1610612757,Portland Trail Blazers,0,1,1610612743,Denver Nuggets,1,0,30,25,55,10,13,23,40,38,78,22,10,32,10,31,23,7,11,94,112
2015,2,21500405,12/20/2015,1610612739,Cleveland Cavaliers,1,1,1610612755,Philadelphia 76ers,0,0,29,31,60,11,14,25,40,45,85,17,4,21,8,39,25,6,12,101,108
2015,2,21500405,12/20/2015,1610612755,Philadelphia 76ers,0,0,1610612739,Cleveland Cavaliers,1,1,25,37,62,5,19,24,30,56,86,21,9,30,22,39,15,11,21,102,86
2015,2,21500304,12/7/2015,1610612765,Detroit Pistons,0,0,1610612766,Charlotte Hornets,1,1,22,31,53,10,24,34,32,55,87,10,12,22,12,48,17,5,13,99,84
2015,2,21500304,12/7/2015,1610612766,Charlotte Hornets,1,1,1610612765,Detroit Pistons,0,0,28,30,58,8,18,26,36,48,84,24,11,35,17,37,21,11,15,98,104
2015,2,21500205,11/23/2015,1610612749,Milwaukee Bucks,1,1,1610612765,Detroit Pistons,0,0,34,36,70,9,4,13,43,40,83,14,3,17,12,29,30,7,12,91,109
2015,2,21500205,11/23/2015,1610612765,Detroit Pistons,0,0,1610612749,Milwaukee Bucks,1,1,25,38,63,6,22,28,31,60,91,20,4,24,29,33,19,12,18,91,88
2015,2,21500111,11/10/2015,1610612750,Minnesota Timberwolves,1,0,1610612766,Charlotte Hornets,0,1,27,34,61,9,10,19,36,44,80,14,5,19,11,36,25,8,22,100,95
2015,2,21500111,11/10/2015,1610612766,Charlotte Hornets,0,1,1610612750,Minnesota Timberwolves,1,0,30,22,52,8,18,26,38,40,78,20,7,27,7,39,18,6,16,101,104
2015,2,21500015,10/28/2015,1610612740,New Orleans Pelicans,0,0,1610612757,Portland Trail Blazers,1,1,25,33,58,11,22,33,36,55,91,11,7,18,10,47,19,7,11,100,94
2015,2,21500015,10/28/2015,1610612757,Portland Trail Blazers,1,1,1610612740,New Orleans Pelicans,0,0,32,24,56,12,20,32,44,44,88,12,2,14,8,37,22,7,12,99,112
2014,2,21400852,2/25/2015,1610612758,Sacramento Kings,1,1,1610612763,Memphis Grizzlies,0,0,33,31,64,6,10,16,39,41,80,18,7,25,17,26,24,12,21,97,102
2014,2,21400852,2/25/2015,1610612763,Memphis Grizzlies,0,0,1610612758,Sacramento Kings,1,1,30,38,68,4,12,16,34,50,84,18,5,23,15,39,22,10,17,96,90
2015,2,21501210,4/11/2016,1610612742,Dallas Mavericks,0,1,1610612762,Utah Jazz,1,0,25,24,49,11,21,32,36,45,81,18,4,22,13,35,19,5,9,89,101
2015,2,21501210,4/11/2016,1610612762,Utah Jazz,1,0,1610612742,Dallas Mavericks,0,1,26,18,44,9,24,33,35,42,77,13,5,18,7,38,21,7,10,88,92
2015,2,21500906,3/2/2016,1610612743,Denver Nuggets,1,1,1610612747,Los Angeles Lakers,0,0,26,29,55,12,11,23,38,40,78,29,9,38,15,28,22,7,11,94,117
2015,2,21500906,3/2/2016,1610612747,Los Angeles Lakers,0,0,1610612743,Denver Nuggets,1,1,24,24,48,11,20,31,35,44,79,26,6,32,9,37,19,3,9,93,107
2015,2,21500842,2/23/2016,1610612743,Denver Nuggets,1,0,1610612758,Sacramento Kings,0,1,31,42,73,10,17,27,41,59,100,18,4,22,16,45,27,9,12,105,110
2015,2,21500842,2/23/2016,1610612758,Sacramento Kings,0,1,1610612743,Denver Nuggets,1,0,36,30,66,7,10,17,43,40,83,21,7,28,8,34,28,10,16,106,114
2015,2,21500745,2/3/2016,1610612746,LA Clippers,1,0,1610612750,Minnesota Timberwolves,0,1,22,21,43,11,21,32,33,42,75,25,9,34,13,33,20,6,13,91,102
2015,2,21500745,2/3/2016,1610612750,Minnesota Timberwolves,0,1,1610612746,LA Clippers,1,0,31,29,60,8,9,17,39,38,77,22,4,26,14,26,24,10,16,92,108
2015,2,21500699,1/29/2016,1610612739,Cleveland Cavaliers,0,1,1610612765,Detroit Pistons,1,0,30,30,60,9,14,23,39,44,83,27,2,29,13,31,20,5,8,94,114
2015,2,21500699,1/29/2016,1610612765,Detroit Pistons,1,0,1610612739,Cleveland Cavaliers,0,1,33,28,61,7,16,23,40,44,84,19,7,26,10,39,20,4,9,93,106
2015,2,21500508,1/3/2016,1610612748,Miami Heat,0,1,1610612764,Washington Wizards,1,0,30,33,63,9,14,23,39,47,86,10,2,12,10,38,27,5,13,94,97
2015,2,21500508,1/3/2016,1610612764,Washington Wizards,1,0,1610612748,Miami Heat,0,1,27,34,61,4,26,30,31,60,91,9,4,13,14,47,19,8,11,93,75
2015,2,21500404,12/20/2015,1610612748,Miami Heat,1,1,1610612757,Portland Trail Blazers,0,0,31,21,52,12,11,23,43,32,75,18,8,26,6,33,26,7,12,95,116
2015,2,21500404,12/20/2015,1610612757,Portland Trail Blazers,0,0,1610612748,Miami Heat,1,1,26,20,46,13,21,34,39,41,80,18,4,22,16,27,23,11,19,95,109
2015,2,21500303,12/6/2015,1610612758,Sacramento Kings,0,0,1610612760,Oklahoma City Thunder,1,1,28,36,64,7,17,24,35,53,88,18,12,30,17,43,20,8,14,100,95
2015,2,21500303,12/6/2015,1610612760,Oklahoma City Thunder,1,1,1610612758,Sacramento Kings,0,0,29,35,64,6,16,22,35,51,86,22,9,31,22,33,18,11,21,99,98
2015,2,21500014,10/28/2015,1610612742,Dallas Mavericks,0,1,1610612756,Phoenix Suns,1,0,30,34,64,10,11,21,40,45,85,21,10,31,6,43,24,3,8,103,111
2015,2,21500014,10/28/2015,1610612756,Phoenix Suns,1,0,1610612742,Dallas Mavericks,0,1,28,35,63,6,18,24,34,53,87,21,12,33,17,43,15,7,18,102,95
2015,2,21501131,4/1/2016,1610612737,Atlanta Hawks,1,0,1610612739,Cleveland Cavaliers,0,1,29,36,65,9,21,30,38,57,95,23,3,26,11,47,25,9,16,113,108
2015,2,21501131,4/1/2016,1610612739,Cleveland Cavaliers,0,1,1610612737,Atlanta Hawks,1,0,27,33,60,12,26,38,39,59,98,20,11,31,15,47,27,5,12,112,110
2015,2,21500966,3/11/2016,1610612741,Chicago Bulls,1,0,1610612748,Miami Heat,0,1,30,30,60,8,13,21,38,43,81,12,3,15,9,35,27,14,18,97,96
2015,2,21500966,3/11/2016,1610612748,Miami Heat,0,1,1610612741,Chicago Bulls,1,0,37,36,73,10,8,18,47,44,91,14,6,20,12,34,30,7,8,98,118
2016,2,21600639,1/19/2017,1610612743,Denver Nuggets,0,0,1610612759,San Antonio Spurs,1,1,27,33,60,10,21,31,37,54,91,20,6,26,20,38,27,12,15,98,104
2016,2,21600639,1/19/2017,1610612759,San Antonio Spurs,1,1,1610612743,Denver Nuggets,0,0,35,29,64,9,13,22,44,42,86,21,4,25,10,33,28,5,8,97,118
2016,2,21600177,11/18/2016,1610612740,New Orleans Pelicans,1,1,1610612757,Portland Trail Blazers,0,0,36,22,58,9,15,24,45,37,82,14,6,20,5,35,31,2,9,95,113
2016,2,21600177,11/18/2016,1610612757,Portland Trail Blazers,0,0,1610612740,New Orleans Pelicans,1,1,21,33,54,12,22,34,33,55,88,23,3,26,19,37,19,9,14,96,101
2015,2,21500657,1/23/2016,1610612740,New Orleans Pelicans,1,1,1610612749,Milwaukee Bucks,0,0,26,37,63,17,14,31,43,51,94,13,4,17,15,39,33,3,8,97,116
2015,2,21500657,1/23/2016,1610612749,Milwaukee Bucks,0,0,1610612740,New Orleans Pelicans,1,1,33,26,59,6,9,15,39,35,74,15,3,18,6,31,20,10,18,96,99
2015,2,21500204,11/23/2015,1610612748,Miami Heat,1,1,1610612752,New York Knicks,0,0,26,36,62,5,14,19,31,50,81,28,8,36,19,36,18,7,10,91,95
2015,2,21500204,11/23/2015,1610612752,New York Knicks,0,0,1610612748,Miami Heat,1,1,24,39,63,4,20,24,28,59,87,18,3,21,20,41,12,8,13,89,78
2015,2,21500110,11/10/2015,1610612738,Boston Celtics,0,1,1610612749,Milwaukee Bucks,1,0,31,25,56,7,23,30,38,48,86,16,3,19,16,34,21,10,13,92,99
2015,2,21500110,11/10/2015,1610612749,Milwaukee Bucks,1,0,1610612738,Boston Celtics,0,1,24,32,56,6,11,17,30,43,73,17,6,23,11,34,14,11,18,92,83
2015,2,21500013,10/28/2015,1610612759,San Antonio Spurs,0,0,1610612760,Oklahoma City Thunder,1,1,40,38,78,5,10,15,45,48,93,11,2,13,11,37,22,7,13,101,106
2015,2,21500013,10/28/2015,1610612760,Oklahoma City Thunder,1,1,1610612759,San Antonio Spurs,0,0,35,32,67,7,12,19,42,44,86,21,1,22,15,30,21,11,19,101,112
2014,2,21400851,2/25/2015,1610612747,Los Angeles Lakers,0,1,1610612762,Utah Jazz,1,0,38,40,78,2,9,11,40,49,89,18,3,21,16,35,17,3,10,92,100
2014,2,21400851,2/25/2015,1610612762,Utah Jazz,1,0,1610612747,Los Angeles Lakers,0,1,27,34,61,7,5,12,34,39,73,22,12,34,17,29,18,12,21,92,97
2015,2,21501130,4/1/2016,1610612751,Brooklyn Nets,0,0,1610612752,New York Knicks,1,1,32,45,77,4,20,24,36,65,101,15,5,20,24,44,20,4,11,95,91
2015,2,21501130,4/1/2016,1610612752,New York Knicks,1,1,1610612751,Brooklyn Nets,0,0,28,33,61,14,9,23,42,42,84,7,0,7,9,33,24,11,17,96,105
2015,2,21501075,3/25/2016,1610612748,Miami Heat,1,1,1610612753,Orlando Magic,0,0,35,30,65,5,10,15,40,40,80,23,10,33,15,31,23,7,14,95,108
2015,2,21501075,3/25/2016,1610612753,Orlando Magic,0,0,1610612748,Miami Heat,1,1,30,36,66,6,12,18,36,48,84,19,9,28,15,36,20,9,15,96,97
2016,2,21601198,4/9/2017,1610612743,Denver Nuggets,1,0,1610612760,Oklahoma City Thunder,0,1,29,21,50,11,23,34,40,44,84,14,1,15,5,40,22,7,12,97,105
2016,2,21601198,4/9/2017,1610612760,Oklahoma City Thunder,0,1,1610612743,Denver Nuggets,1,0,34,37,71,6,19,25,40,56,96,20,2,22,19,39,19,6,12,97,106
2015,2,21500601,1/15/2016,1610612739,Cleveland Cavaliers,0,1,1610612745,Houston Rockets,1,0,26,26,52,8,27,35,34,53,87,15,8,23,19,35,19,10,15,95,91
2015,2,21500601,1/15/2016,1610612745,Houston Rockets,1,0,1610612739,Cleveland Cavaliers,0,1,20,29,49,6,19,25,26,48,74,19,10,29,13,37,15,10,19,93,77
2015,2,21500507,1/3/2016,1610612741,Chicago Bulls,0,1,1610612761,Toronto Raptors,1,0,33,28,61,9,12,21,42,40,82,22,3,25,14,27,23,6,11,94,115
2015,2,21500507,1/3/2016,1610612761,Toronto Raptors,1,0,1610612741,Chicago Bulls,0,1,29,32,61,13,18,31,42,50,92,16,3,19,16,35,21,4,9,93,113
2015,2,21500403,12/20/2015,1610612750,Minnesota Timberwolves,0,1,1610612751,Brooklyn Nets,1,0,35,33,68,3,9,12,38,42,80,21,3,24,9,34,29,7,14,95,100
2015,2,21500403,12/20/2015,1610612751,Brooklyn Nets,1,0,1610612750,Minnesota Timberwolves,0,1,27,30,57,5,16,21,32,46,78,16,4,20,10,39,26,12,16,96,85
2015,2,21500302,12/6/2015,1610612742,Dallas Mavericks,0,1,1610612764,Washington Wizards,1,0,22,23,45,16,15,31,38,38,76,24,3,27,9,30,25,9,16,97,116
2015,2,21500302,12/6/2015,1610612764,Washington Wizards,1,0,1610612742,Dallas Mavericks,0,1,34,28,62,8,19,27,42,47,89,12,9,21,8,45,22,5,7,96,104
2015,2,21500012,10/28/2015,1610612749,Milwaukee Bucks,1,0,1610612752,New York Knicks,0,1,21,47,68,9,9,18,30,56,86,28,3,31,22,35,17,11,18,98,97
2015,2,21500012,10/28/2015,1610612752,New York Knicks,0,1,1610612749,Milwaukee Bucks,1,0,33,37,70,9,14,23,42,51,93,29,6,35,21,33,24,7,11,97,122
2015,2,21501017,3/17/2016,1610612749,Milwaukee Bucks,1,1,1610612763,Memphis Grizzlies,0,0,32,24,56,5,14,19,37,38,75,17,8,25,11,29,21,8,13,90,96
2015,2,21501017,3/17/2016,1610612763,Memphis Grizzlies,0,0,1610612749,Milwaukee Bucks,1,1,31,48,79,3,10,13,34,58,92,15,2,17,24,35,16,7,16,90,86
2015,2,21500965,3/11/2016,1610612738,Boston Celtics,1,0,1610612745,Houston Rockets,0,1,26,34,60,8,23,31,34,57,91,22,6,28,20,39,24,8,15,101,98
2015,2,21500965,3/11/2016,1610612745,Houston Rockets,0,1,1610612738,Boston Celtics,1,0,35,27,62,5,21,26,40,48,88,17,7,24,18,33,19,14,18,100,102
2015,2,21500905,3/2/2016,1610612759,San Antonio Spurs,1,1,1610612765,Detroit Pistons,0,0,40,30,70,3,11,14,43,41,84,8,1,9,5,37,25,3,8,91,97
2015,2,21500905,3/2/2016,1610612765,Detroit Pistons,0,0,1610612759,San Antonio Spurs,1,1,25,34,59,6,13,19,31,47,78,13,10,23,13,38,19,8,16,92,81
2015,2,21500841,2/23/2016,1610612740,New Orleans Pelicans,0,0,1610612764,Washington Wizards,1,1,23,37,60,6,17,23,29,54,83,25,8,33,11,49,17,9,17,103,89
2015,2,21500841,2/23/2016,1610612764,Washington Wizards,1,1,1610612740,New Orleans Pelicans,0,0,31,37,68,12,14,26,43,51,94,11,6,17,13,41,29,8,15,104,109
2014,2,21400850,2/25/2015,1610612743,Denver Nuggets,1,0,1610612756,Phoenix Suns,0,1,19,28,47,12,22,34,31,50,81,22,11,33,12,46,22,9,16,100,96
2014,2,21400850,2/25/2015,1610612756,Phoenix Suns,0,1,1610612743,Denver Nuggets,1,0,31,36,67,8,16,24,39,52,91,24,8,32,26,32,19,11,21,102,110
2015,2,21500698,1/29/2016,1610612738,Boston Celtics,1,1,1610612753,Orlando Magic,0,0,33,29,62,10,14,24,43,43,86,17,4,21,9,34,28,9,12,100,113
2015,2,21500698,1/29/2016,1610612753,Orlando Magic,0,0,1610612738,Boston Celtics,1,1,25,34,59,7,13,20,32,47,79,23,6,29,11,39,17,8,16,98,94
2015,2,21500203,11/23/2015,1610612739,Cleveland Cavaliers,1,1,1610612753,Orlando Magic,0,0,25,21,46,18,17,35,43,38,81,13,9,22,10,32,34,6,10,92,117
2015,2,21500203,11/23/2015,1610612753,Orlando Magic,0,0,1610612739,Cleveland Cavaliers,1,1,30,29,59,10,12,22,40,41,81,13,8,21,9,36,25,5,10,91,103
2015,2,21500109,11/10/2015,1610612752,New York Knicks,0,1,1610612761,Toronto Raptors,1,0,31,41,72,11,12,23,42,53,95,16,2,18,17,36,22,7,10,95,111
2015,2,21500109,11/10/2015,1610612761,Toronto Raptors,1,0,1610612752,New York Knicks,0,1,33,34,67,4,13,17,37,47,84,31,8,39,20,32,25,8,12,96,109
2015,2,21500011,10/28/2015,1610612739,Cleveland Cavaliers,0,1,1610612763,Memphis Grizzlies,1,0,28,27,55,13,16,29,41,43,84,11,6,17,15,32,29,8,19,98,106
2015,2,21500011,10/28/2015,1610612763,Memphis Grizzlies,1,0,1610612739,Cleveland Cavaliers,0,1,27,39,66,2,14,16,29,53,82,16,6,22,12,44,15,7,16,96,76
2015,2,21501209,4/11/2016,1610612747,Los Angeles Lakers,0,0,1610612760,Oklahoma City Thunder,1,1,16,34,50,7,24,31,23,58,81,26,4,30,12,48,15,8,15,100,79
2015,2,21501209,4/11/2016,1610612760,Oklahoma City Thunder,1,1,1610612747,Los Angeles Lakers,0,0,30,29,59,12,25,37,42,54,96,16,11,27,18,42,27,8,12,100,112
2015,2,21501016,3/17/2016,1610612741,Chicago Bulls,1,1,1610612751,Brooklyn Nets,0,0,35,35,70,11,13,24,46,48,94,15,0,15,19,29,26,7,9,93,118
2015,2,21501016,3/17/2016,1610612751,Brooklyn Nets,0,0,1610612741,Chicago Bulls,1,1,34,31,65,6,15,21,40,46,86,16,4,20,13,37,22,6,9,92,102
2015,2,21500792,2/10/2016,1610612738,Boston Celtics,1,1,1610612746,LA Clippers,0,0,34,28,62,13,20,33,47,48,95,32,5,37,13,39,34,7,10,107,139
2015,2,21500792,2/10/2016,1610612746,LA Clippers,0,0,1610612738,Boston Celtics,1,1,32,23,55,12,18,30,44,41,85,34,16,50,12,38,25,5,14,109,134
2015,2,21500744,2/3/2016,1610612741,Chicago Bulls,0,1,1610612758,Sacramento Kings,1,0,29,38,67,11,10,21,40,48,88,16,5,21,14,37,26,12,17,103,107
2015,2,21500744,2/3/2016,1610612758,Sacramento Kings,1,0,1610612741,Chicago Bulls,0,1,36,32,68,6,14,20,42,46,88,12,7,19,10,41,21,8,17,102,102
2015,2,21500697,1/28/2016,1610612741,Chicago Bulls,0,1,1610612747,Los Angeles Lakers,1,0,41,37,78,6,11,17,47,48,95,14,2,16,16,32,29,6,11,99,114
2015,2,21500697,1/28/2016,1610612747,Los Angeles Lakers,1,0,1610612741,Chicago Bulls,0,1,23,37,60,9,16,25,32,53,85,18,5,23,13,43,21,12,15,99,91
2015,2,21500656,1/24/2016,1610612738,Boston Celtics,0,1,1610612755,Philadelphia 76ers,1,0,32,40,72,11,14,25,43,54,97,15,4,19,19,36,29,12,17,106,112
2015,2,21500656,1/24/2016,1610612755,Philadelphia 76ers,1,0,1610612738,Boston Celtics,0,1,27,36,63,8,18,26,35,54,89,14,6,20,16,39,17,14,24,105,92
2015,2,21500506,1/3/2016,1610612737,Atlanta Hawks,0,0,1610612752,New York Knicks,1,1,29,29,58,8,18,26,37,47,84,15,5,20,14,36,26,8,15,94,97
2015,2,21500506,1/3/2016,1610612752,New York Knicks,1,1,1610612737,Atlanta Hawks,0,0,33,29,62,11,15,26,44,44,88,12,2,14,19,26,27,11,16,94,111
2015,2,21500402,12/19/2015,1610612754,Indiana Pacers,0,0,1610612763,Memphis Grizzlies,1,1,25,24,49,5,23,28,30,47,77,19,6,25,14,38,12,9,17,91,84
2015,2,21500402,12/19/2015,1610612763,Memphis Grizzlies,1,1,1610612754,Indiana Pacers,0,0,32,32,64,5,14,19,37,46,83,17,4,21,14,34,21,8,11,91,96
2015,2,21500301,12/6/2015,1610612747,Los Angeles Lakers,0,0,1610612765,Detroit Pistons,1,1,27,35,62,5,13,18,32,48,80,22,7,29,9,44,12,11,15,99,91
2015,2,21500301,12/6/2015,1610612765,Detroit Pistons,1,1,1610612747,Los Angeles Lakers,0,0,32,37,69,9,15,24,41,52,93,20,6,26,20,35,20,6,17,100,111
2015,2,21500108,11/10/2015,1610612747,Los Angeles Lakers,0,0,1610612748,Miami Heat,1,1,23,32,55,11,11,22,34,43,77,9,3,12,8,37,21,7,18,93,88
2015,2,21500108,11/10/2015,1610612748,Miami Heat,1,1,1610612747,Los Angeles Lakers,0,0,33,31,64,5,15,20,38,46,84,20,7,27,16,33,23,7,12,92,101
2015,2,21500010,10/28/2015,1610612743,Denver Nuggets,0,1,1610612745,Houston Rockets,1,0,27,25,52,13,14,27,40,39,79,12,6,18,12,30,26,13,21,97,105
2015,2,21500010,10/28/2015,1610612745,Houston Rockets,1,0,1610612743,Denver Nuggets,0,1,22,30,52,8,27,35,30,57,87,17,9,26,19,43,17,9,17,98,85
2016,2,21600638,1/19/2017,1610612752,New York Knicks,1,0,1610612764,Washington Wizards,0,1,35,31,66,7,17,24,42,48,90,19,3,22,17,32,20,7,11,94,110
2016,2,21600638,1/19/2017,1610612764,Washington Wizards,0,1,1610612752,New York Knicks,1,0,31,25,56,13,19,32,44,44,88,12,2,14,16,28,29,7,15,95,113
2015,2,21500904,3/2/2016,1610612750,Minnesota Timberwolves,1,0,1610612764,Washington Wizards,0,1,27,34,61,5,9,14,32,43,75,29,5,34,11,33,17,8,19,99,98
2015,2,21500904,3/2/2016,1610612764,Washington Wizards,0,1,1610612750,Minnesota Timberwolves,1,0,31,24,55,11,18,29,42,42,84,9,4,13,8,37,25,8,17,101,104
2016,2,21600176,11/18/2016,1610612754,Indiana Pacers,1,0,1610612756,Phoenix Suns,0,1,35,34,69,1,6,7,36,40,76,23,6,29,11,30,18,14,18,96,96
2016,2,21600176,11/18/2016,1610612756,Phoenix Suns,0,1,1610612754,Indiana Pacers,1,0,37,34,71,9,17,26,46,51,97,15,3,18,24,29,21,5,12,95,116
2015,2,21500696,1/28/2016,1610612740,New Orleans Pelicans,1,1,1610612758,Sacramento Kings,0,0,33,39,72,10,16,26,43,55,98,18,6,24,19,38,25,6,14,107,114
2015,2,21500696,1/28/2016,1610612758,Sacramento Kings,0,0,1610612740,New Orleans Pelicans,1,1,30,31,61,10,18,28,40,49,89,15,5,20,8,41,29,9,14,106,105
2015,2,21500202,11/23/2015,1610612758,Sacramento Kings,0,0,1610612766,Charlotte Hornets,1,1,44,29,73,8,23,31,52,52,104,10,6,16,12,43,34,10,20,119,122
2015,2,21500202,11/23/2015,1610612766,Charlotte Hornets,1,1,1610612758,Sacramento Kings,0,0,40,29,69,9,20,29,49,49,98,20,6,26,12,39,24,10,19,117,127
2015,2,21500107,11/10/2015,1610612760,Oklahoma City Thunder,0,1,1610612764,Washington Wizards,1,0,29,34,63,15,8,23,44,42,86,22,7,29,12,32,27,8,13,102,125
2015,2,21500107,11/10/2015,1610612764,Washington Wizards,1,0,1610612760,Oklahoma City Thunder,0,1,33,40,73,5,19,24,38,59,97,20,6,26,16,44,17,4,8,101,101
2015,2,21500009,10/28/2015,1610612754,Indiana Pacers,0,0,1610612761,Toronto Raptors,1,1,23,40,63,9,14,23,32,54,86,26,5,31,11,46,23,8,13,103,99
2015,2,21500009,10/28/2015,1610612761,Toronto Raptors,1,1,1610612754,Indiana Pacers,0,0,29,33,62,7,11,18,36,44,80,27,12,39,15,35,19,14,21,103,106
2014,2,21400849,2/25/2015,1610612740,New Orleans Pelicans,1,1,1610612751,Brooklyn Nets,0,0,27,22,49,11,14,25,38,36,74,15,4,19,8,30,26,6,20,97,102
2014,2,21400849,2/25/2015,1610612751,Brooklyn Nets,0,0,1610612740,New Orleans Pelicans,1,1,32,39,71,7,14,21,39,53,92,11,4,15,13,42,13,6,12,97,96
2015,2,21501129,4/1/2016,1610612742,Dallas Mavericks,0,1,1610612765,Detroit Pistons,1,0,31,30,61,8,16,24,39,46,85,12,2,14,10,36,18,4,10,92,98
2015,2,21501129,4/1/2016,1610612765,Detroit Pistons,1,0,1610612742,Dallas Mavericks,0,1,18,30,48,13,20,33,31,50,81,14,10,24,12,43,23,4,11,92,89
2015,2,21501074,3/25/2016,1610612765,Detroit Pistons,1,1,1610612766,Charlotte Hornets,0,0,34,27,61,8,22,30,42,49,91,20,6,26,17,36,22,8,14,101,112
2015,2,21501074,3/25/2016,1610612766,Charlotte Hornets,0,0,1610612765,Detroit Pistons,1,1,23,40,63,14,16,30,37,56,93,17,5,22,8,50,24,4,7,101,105
2016,2,21601197,4/9/2017,1610612737,Atlanta Hawks,1,1,1610612739,Cleveland Cavaliers,0,0,35,28,63,9,22,31,44,50,94,29,8,37,10,43,31,4,12,111,126
2016,2,21601197,4/9/2017,1610612739,Cleveland Cavaliers,0,0,1610612737,Atlanta Hawks,1,1,26,26,52,19,27,46,45,53,98,16,4,20,16,39,28,8,17,109,125
2015,2,21500695,1/28/2016,1610612749,Milwaukee Bucks,0,0,1610612763,Memphis Grizzlies,1,1,28,35,63,1,15,16,29,50,79,24,3,27,19,32,17,7,15,88,83
2015,2,21500695,1/28/2016,1610612763,Memphis Grizzlies,1,1,1610612749,Milwaukee Bucks,0,0,28,24,52,10,18,28,38,42,80,17,3,20,12,31,28,8,11,89,103
2015,2,21500600,1/15/2016,1610612743,Denver Nuggets,1,0,1610612748,Miami Heat,0,1,26,34,60,6,12,18,32,46,78,25,1,26,12,35,23,5,14,93,95
2015,2,21500600,1/15/2016,1610612748,Miami Heat,0,1,1610612743,Denver Nuggets,1,0,36,33,69,4,8,12,40,41,81,14,5,19,12,32,26,4,14,92,98
2015,2,21500505,1/2/2016,1610612746,LA Clippers,1,1,1610612755,Philadelphia 76ers,0,0,37,21,58,12,11,23,49,32,81,20,5,25,8,28,28,8,15,101,130
2015,2,21500505,1/2/2016,1610612755,Philadelphia 76ers,0,0,1610612746,LA Clippers,1,1,32,34,66,9,14,23,41,48,89,8,9,17,9,42,30,7,12,100,99
2015,2,21500401,12/19/2015,1610612745,Houston Rockets,1,1,1610612746,LA Clippers,0,0,26,25,51,8,17,25,34,42,76,31,18,49,16,35,22,10,19,103,107
2015,2,21500401,12/19/2015,1610612746,LA Clippers,0,0,1610612745,Houston Rockets,1,1,23,25,48,11,27,38,34,52,86,18,11,29,9,47,21,7,12,104,97
2015,2,21500300,12/6/2015,1610612744,Golden State Warriors,0,1,1610612751,Brooklyn Nets,1,0,30,23,53,14,19,33,44,42,86,12,11,23,12,36,25,8,12,97,114
2015,2,21500300,12/6/2015,1610612751,Brooklyn Nets,1,0,1610612744,Golden State Warriors,0,1,34,38,72,5,12,17,39,50,89,15,8,23,17,36,21,9,13,97,98
2015,2,21500106,11/10/2015,1610612739,Cleveland Cavaliers,1,1,1610612762,Utah Jazz,0,0,26,24,50,11,13,24,37,37,74,33,10,43,16,24,24,11,17,97,118
2015,2,21500106,11/10/2015,1610612762,Utah Jazz,0,0,1610612739,Cleveland Cavaliers,1,1,30,30,60,10,12,22,40,42,82,24,4,28,16,27,30,9,16,96,114
2015,2,21501208,4/11/2016,1610612740,New Orleans Pelicans,1,0,1610612741,Chicago Bulls,0,1,29,25,54,12,14,26,41,39,80,22,6,28,12,30,28,5,10,90,116
2015,2,21501208,4/11/2016,1610612741,Chicago Bulls,0,1,1610612740,New Orleans Pelicans,1,0,34,20,54,10,13,23,44,33,77,23,3,26,9,24,29,8,9,91,121
2015,2,21500964,3/11/2016,1610612751,Brooklyn Nets,0,0,1610612755,Philadelphia 76ers,1,1,28,42,70,5,12,17,33,54,87,18,4,22,15,40,22,5,12,96,89
2015,2,21500964,3/11/2016,1610612755,Philadelphia 76ers,1,1,1610612751,Brooklyn Nets,0,0,29,27,56,9,19,28,38,46,84,10,5,15,16,31,25,8,19,95,95
2015,2,21500903,3/2/2016,1610612749,Milwaukee Bucks,1,0,1610612754,Indiana Pacers,0,1,31,31,62,3,11,14,34,42,76,28,4,32,7,38,14,7,13,96,99
2015,2,21500903,3/2/2016,1610612754,Indiana Pacers,0,1,1610612749,Milwaukee Bucks,1,0,28,32,60,10,10,20,38,42,80,18,8,26,13,33,28,8,16,96,104
2015,2,21500791,2/10/2016,1610612755,Philadelphia 76ers,1,0,1610612758,Sacramento Kings,0,1,27,29,56,15,20,35,42,49,91,11,6,17,21,31,29,7,19,97,110
2015,2,21500791,2/10/2016,1610612758,Sacramento Kings,0,1,1610612755,Philadelphia 76ers,1,0,40,31,71,4,12,16,44,43,87,22,7,29,18,28,29,9,14,96,114
2016,2,21601196,4/9/2017,1610612752,New York Knicks,1,0,1610612761,Toronto Raptors,0,1,28,26,54,9,19,28,37,45,82,14,1,15,8,37,27,8,11,93,97
2016,2,21601196,4/9/2017,1610612761,Toronto Raptors,0,1,1610612752,New York Knicks,1,0,30,16,46,10,21,31,40,37,77,20,3,23,7,32,20,6,11,91,110
2015,2,21500655,1/23/2016,1610612752,New York Knicks,0,0,1610612766,Charlotte Hornets,1,1,22,31,53,7,17,24,29,48,77,19,13,32,12,42,23,5,15,96,84
2015,2,21500655,1/23/2016,1610612766,Charlotte Hornets,1,1,1610612752,New York Knicks,0,0,19,32,51,9,22,31,28,54,82,32,5,37,14,44,17,4,12,95,97
2015,2,21500201,11/22/2015,1610612747,Los Angeles Lakers,1,0,1610612757,Portland Trail Blazers,0,1,26,44,70,6,12,18,32,56,88,23,4,27,18,40,17,7,11,93,93
2015,2,21500201,11/22/2015,1610612757,Portland Trail Blazers,0,1,1610612747,Los Angeles Lakers,1,0,35,27,62,8,17,25,43,44,87,13,4,17,10,37,27,2,10,94,107
2015,2,21500105,11/9/2015,1610612746,LA Clippers,1,1,1610612763,Memphis Grizzlies,0,0,23,26,49,5,14,19,28,40,68,33,4,37,9,33,14,11,18,92,94
2015,2,21500105,11/9/2015,1610612763,Memphis Grizzlies,0,0,1610612746,LA Clippers,1,1,33,35,68,2,9,11,35,44,79,20,9,29,17,33,21,5,14,92,92
2015,2,21500008,10/28/2015,1610612748,Miami Heat,1,1,1610612766,Charlotte Hornets,0,0,24,29,53,12,8,20,36,37,73,20,1,21,4,33,23,4,13,93,104
2015,2,21500008,10/28/2015,1610612766,Charlotte Hornets,0,0,1610612748,Miami Heat,1,1,27,33,60,6,18,24,33,51,84,22,7,29,13,42,16,5,9,93,94
2015,2,21501015,3/17/2016,1610612737,Atlanta Hawks,1,1,1610612743,Denver Nuggets,0,0,28,26,54,12,14,26,40,40,80,24,4,28,9,33,32,6,12,97,116
2015,2,21501015,3/17/2016,1610612743,Denver Nuggets,0,0,1610612737,Atlanta Hawks,1,1,33,32,65,6,16,22,39,48,87,14,3,17,13,35,22,5,14,97,98
2016,2,21600175,11/18/2016,1610612739,Cleveland Cavaliers,1,1,1610612765,Detroit Pistons,0,0,29,29,58,11,14,25,40,43,83,13,1,14,9,34,26,5,13,95,104
2016,2,21600175,11/18/2016,1610612765,Detroit Pistons,0,0,1610612739,Cleveland Cavaliers,1,1,23,51,74,6,13,19,29,64,93,17,3,20,16,49,23,4,7,95,81
2014,2,21400848,2/25/2015,1610612750,Minnesota Timberwolves,1,1,1610612764,Washington Wizards,0,0,31,37,68,4,9,13,35,46,81,23,5,28,15,35,17,5,18,96,97
2014,2,21400848,2/25/2015,1610612764,Washington Wizards,0,0,1610612750,Minnesota Timberwolves,1,1,29,40,69,4,14,18,33,54,87,7,1,8,12,43,21,10,19,98,77
2015,2,21500840,2/23/2016,1610612753,Orlando Magic,0,1,1610612755,Philadelphia 76ers,1,0,34,37,71,7,7,14,41,44,85,35,6,41,15,31,26,7,14,103,124
2015,2,21500840,2/23/2016,1610612755,Philadelphia 76ers,1,0,1610612753,Orlando Magic,0,1,33,25,58,10,11,21,43,36,79,19,7,26,8,31,23,11,21,102,115
2015,2,21500504,1/2/2016,1610612743,Denver Nuggets,0,0,1610612744,Golden State Warriors,1,1,39,36,75,5,25,30,44,61,105,15,8,23,27,40,27,9,13,101,108
2015,2,21500504,1/2/2016,1610612744,Golden State Warriors,1,1,1610612743,Denver Nuggets,0,0,33,25,58,10,18,28,43,43,86,15,8,23,13,33,34,7,14,101,111
2015,2,21500400,12/19/2015,1610612741,Chicago Bulls,0,0,1610612752,New York Knicks,1,1,32,41,73,5,16,21,37,57,94,12,5,17,24,36,17,6,13,93,91
2015,2,21500400,12/19/2015,1610612752,New York Knicks,1,1,1610612741,Chicago Bulls,0,0,36,26,62,5,15,20,41,41,82,20,4,24,12,32,19,7,12,92,107
2015,2,21500299,12/6/2015,1610612756,Phoenix Suns,0,0,1610612763,Memphis Grizzlies,1,1,27,24,51,9,22,31,36,46,82,12,5,17,15,34,20,8,18,95,93
2015,2,21500299,12/6/2015,1610612763,Memphis Grizzlies,1,1,1610612756,Phoenix Suns,0,0,31,44,75,5,10,15,36,54,90,18,6,24,18,39,23,8,13,94,95
2015,2,21500200,11/22/2015,1610612743,Denver Nuggets,1,0,1610612744,Golden State Warriors,0,1,33,38,71,4,11,15,37,49,86,27,8,35,17,36,23,15,20,105,105
2015,2,21500200,11/22/2015,1610612744,Golden State Warriors,0,1,1610612743,Denver Nuggets,1,0,32,28,60,15,14,29,47,42,89,9,4,13,14,29,35,9,21,104,118
2015,2,21500104,11/9/2015,1610612744,Golden State Warriors,1,1,1610612765,Detroit Pistons,0,0,31,34,65,12,9,21,43,43,86,11,2,13,17,32,29,9,16,97,109
2015,2,21500104,11/9/2015,1610612765,Detroit Pistons,0,0,1610612744,Golden State Warriors,1,1,34,31,65,6,13,19,40,44,84,9,6,15,15,33,15,13,20,98,95
2016,2,21600637,1/19/2017,1610612742,Dallas Mavericks,0,0,1610612748,Miami Heat,1,1,23,23,46,14,22,36,37,45,82,7,4,11,8,40,17,4,10,88,95
2016,2,21600637,1/19/2017,1610612748,Miami Heat,1,1,1610612742,Dallas Mavericks,0,0,26,27,53,9,11,20,35,38,73,20,9,29,11,30,16,4,13,88,99
2015,2,21500839,2/22/2016,1610612746,LA Clippers,1,1,1610612756,Phoenix Suns,0,0,31,25,56,13,11,24,44,36,80,23,12,35,12,32,29,8,18,101,124
2015,2,21500839,2/22/2016,1610612756,Phoenix Suns,0,0,1610612746,LA Clippers,1,1,24,40,64,7,17,24,31,57,88,15,5,20,14,45,20,9,18,102,84
2015,2,21500790,2/10/2016,1610612753,Orlando Magic,1,0,1610612759,San Antonio Spurs,0,1,29,42,71,8,12,20,37,54,91,14,2,16,18,36,26,6,15,95,96
2015,2,21500790,2/10/2016,1610612759,San Antonio Spurs,0,1,1610612753,Orlando Magic,1,0,30,39,69,8,12,20,38,51,89,14,1,15,14,38,24,7,13,95,98
2015,2,21500503,1/2/2016,1610612762,Utah Jazz,1,1,1610612763,Memphis Grizzlies,0,0,22,26,48,9,18,27,31,44,75,21,7,28,13,35,17,8,17,94,92
2015,2,21500503,1/2/2016,1610612763,Memphis Grizzlies,0,0,1610612762,Utah Jazz,1,1,26,37,63,7,11,18,33,48,81,14,12,26,11,43,17,4,13,94,87
2015,2,21500199,11/22/2015,1610612742,Dallas Mavericks,0,0,1610612760,Oklahoma City Thunder,1,1,34,30,64,10,9,19,44,39,83,16,12,28,14,30,26,8,17,100,114
2015,2,21500199,11/22/2015,1610612760,Oklahoma City Thunder,1,1,1610612742,Dallas Mavericks,0,0,38,30,68,9,13,22,47,43,90,14,4,18,15,30,25,8,16,99,117
2015,2,21500103,11/9/2015,1610612758,Sacramento Kings,1,0,1610612759,San Antonio Spurs,0,1,27,38,65,7,12,19,34,50,84,13,6,19,15,39,25,11,19,99,88
2015,2,21500103,11/9/2015,1610612759,San Antonio Spurs,0,1,1610612758,Sacramento Kings,1,0,40,24,64,6,17,23,46,41,87,8,3,11,10,32,34,10,16,99,106
2015,2,21500007,10/28/2015,1610612762,Utah Jazz,0,0,1610612765,Detroit Pistons,1,1,33,30,63,2,10,12,35,40,75,15,6,21,5,36,15,2,12,91,87
2015,2,21500007,10/28/2015,1610612765,Detroit Pistons,1,1,1610612762,Utah Jazz,0,0,23,32,55,7,12,19,30,44,74,25,9,34,12,37,16,4,12,90,92
2015,2,21501128,4/1/2016,1610612755,Philadelphia 76ers,0,0,1610612766,Charlotte Hornets,1,1,23,28,51,10,29,39,33,57,90,15,6,21,12,48,24,9,10,99,91
2015,2,21501128,4/1/2016,1610612766,Charlotte Hornets,1,1,1610612755,Philadelphia 76ers,0,0,29,28,57,7,20,27,36,48,84,21,6,27,9,41,23,5,11,98,100
2015,2,21501073,3/25/2016,1610612750,Minnesota Timberwolves,0,1,1610612764,Washington Wizards,1,0,43,27,70,8,18,26,51,45,96,22,0,22,9,36,33,7,14,111,132
2015,2,21501073,3/25/2016,1610612764,Washington Wizards,1,0,1610612750,Minnesota Timberwolves,0,1,37,34,71,13,16,29,50,50,100,16,7,23,15,37,37,9,17,113,129
2015,2,21500902,3/2/2016,1610612758,Sacramento Kings,0,0,1610612763,Memphis Grizzlies,1,1,30,26,56,9,17,26,39,43,82,11,9,20,20,25,31,13,25,99,98
2015,2,21500902,3/2/2016,1610612763,Memphis Grizzlies,1,1,1610612758,Sacramento Kings,0,0,30,31,61,5,13,18,35,44,79,29,4,33,16,30,20,7,20,98,104
2015,2,21500743,2/3/2016,1610612743,Denver Nuggets,0,0,1610612762,Utah Jazz,1,1,22,30,52,4,14,18,26,44,70,25,8,33,11,34,11,4,14,87,81
2016,2,21600174,11/18/2016,1610612737,Atlanta Hawks,0,0,1610612766,Charlotte Hornets,1,1,32,24,56,7,21,28,39,45,84,11,6,17,12,37,25,11,17,98,96
2016,2,21600174,11/18/2016,1610612766,Charlotte Hornets,1,1,1610612737,Atlanta Hawks,0,0,27,34,61,10,19,29,37,53,90,16,8,24,14,42,25,9,11,96,100
2015,2,21500743,2/3/2016,1610612762,Utah Jazz,1,1,1610612743,Denver Nuggets,0,0,28,24,52,5,17,22,33,41,74,14,6,20,11,34,14,12,15,88,85
2015,2,21500694,1/28/2016,1610612752,New York Knicks,0,0,1610612761,Toronto Raptors,1,1,31,38,69,7,11,18,38,49,87,10,10,20,15,39,20,7,10,91,93
2015,2,21500694,1/28/2016,1610612761,Toronto Raptors,1,1,1610612752,New York Knicks,0,0,29,36,65,8,12,20,37,48,85,21,8,29,20,31,21,6,10,91,103
2016,2,21601195,4/8/2017,1610612740,New Orleans Pelicans,0,0,1610612744,Golden State Warriors,1,1,37,28,65,5,16,21,42,44,86,12,7,19,6,40,24,2,8,96,101
2016,2,21601195,4/8/2017,1610612744,Golden State Warriors,1,1,1610612740,New Orleans Pelicans,0,0,39,24,63,10,23,33,49,47,96,15,1,16,16,32,37,3,9,96,123
2015,2,21500599,1/15/2016,1610612737,Atlanta Hawks,0,0,1610612749,Milwaukee Bucks,1,1,34,36,70,9,21,30,43,57,100,6,0,6,13,44,29,9,18,110,101
2015,2,21500599,1/15/2016,1610612749,Milwaukee Bucks,1,1,1610612737,Atlanta Hawks,0,0,37,49,86,3,7,10,40,56,96,25,12,37,23,38,19,5,18,109,108
2015,2,21500502,1/2/2016,1610612745,Houston Rockets,0,0,1610612759,San Antonio Spurs,1,1,28,24,52,9,13,22,37,37,74,20,13,33,12,32,26,9,16,95,103
2015,2,21500502,1/2/2016,1610612759,San Antonio Spurs,1,1,1610612745,Houston Rockets,0,0,32,30,62,13,11,24,45,41,86,18,1,19,11,30,31,7,11,94,121
2015,2,21500399,12/19/2015,1610612764,Washington Wizards,1,1,1610612766,Charlotte Hornets,0,0,31,28,59,9,11,20,40,39,79,20,3,23,5,35,26,8,14,100,109
2015,2,21500399,12/19/2015,1610612766,Charlotte Hornets,0,0,1610612764,Washington Wizards,1,1,29,31,60,10,23,33,39,54,93,13,3,16,20,34,23,10,18,100,101
2015,2,21500298,12/5/2015,1610612746,LA Clippers,1,1,1610612753,Orlando Magic,0,0,25,26,51,12,19,31,37,45,82,17,8,25,12,39,25,8,14,96,103
2015,2,21500298,12/5/2015,1610612753,Orlando Magic,0,0,1610612746,LA Clippers,1,1,34,36,70,6,14,20,40,50,90,15,3,18,16,37,22,5,14,96,101
2015,2,21500198,11/22/2015,1610612740,New Orleans Pelicans,1,1,1610612756,Phoenix Suns,0,0,28,27,55,11,19,30,39,46,85,33,7,40,14,36,23,6,14,107,122
2015,2,21500198,11/22/2015,1610612756,Phoenix Suns,0,0,1610612740,New Orleans Pelicans,1,1,18,36,54,17,19,36,35,55,90,29,4,33,15,41,17,11,15,105,116
2015,2,21500963,3/11/2016,1610612765,Detroit Pistons,0,0,1610612766,Charlotte Hornets,1,1,27,19,46,9,21,30,36,40,76,22,5,27,7,36,19,9,12,96,103
2015,2,21500963,3/11/2016,1610612766,Charlotte Hornets,1,1,1610612765,Detroit Pistons,0,0,32,26,58,10,15,25,42,41,83,24,5,29,11,33,28,7,11,94,118
2015,2,21500789,2/10/2016,1610612754,Indiana Pacers,1,0,1610612766,Charlotte Hornets,0,1,36,38,74,4,14,18,40,52,92,11,4,15,14,40,19,6,11,96,95
2015,2,21500789,2/10/2016,1610612766,Charlotte Hornets,0,1,1610612754,Indiana Pacers,1,0,33,26,59,12,16,28,45,42,87,15,4,19,13,30,24,7,15,97,117
2016,2,21600636,1/19/2017,1610612739,Cleveland Cavaliers,1,1,1610612756,Phoenix Suns,0,0,24,19,43,19,23,42,43,42,85,13,6,19,9,37,29,10,12,97,118
2016,2,21600636,1/19/2017,1610612756,Phoenix Suns,0,0,1610612739,Cleveland Cavaliers,1,1,33,33,66,4,15,19,37,48,85,25,6,31,19,33,23,7,16,97,103
2015,2,21500654,2/18/2016,1610612762,Utah Jazz,0,0,1610612764,Washington Wizards,1,1,27,35,62,4,11,15,31,46,77,23,6,29,17,32,20,14,23,99,89
2015,2,21500654,2/18/2016,1610612764,Washington Wizards,1,1,1610612762,Utah Jazz,0,0,35,33,68,7,11,18,42,44,86,12,9,21,10,39,25,9,14,99,103
2014,2,21400847,2/25/2015,1610612749,Milwaukee Bucks,1,1,1610612755,Philadelphia 76ers,0,0,39,28,67,5,10,15,44,38,82,11,5,16,14,27,32,13,24,98,104
2014,2,21400847,2/25/2015,1610612755,Philadelphia 76ers,0,0,1610612749,Milwaukee Bucks,1,1,20,30,50,11,14,25,31,44,75,15,4,19,14,32,21,16,28,97,88
2015,2,21500501,1/2/2016,1610612740,New Orleans Pelicans,0,1,1610612742,Dallas Mavericks,1,0,34,29,63,6,14,20,40,43,83,19,5,24,13,32,19,10,19,103,105
2015,2,21500501,1/2/2016,1610612742,Dallas Mavericks,1,0,1610612740,New Orleans Pelicans,0,1,26,31,57,10,16,26,36,47,83,16,3,19,4,44,20,8,13,102,98
2015,2,21500297,12/5/2015,1610612754,Indiana Pacers,0,0,1610612762,Utah Jazz,1,1,28,36,64,12,17,29,40,53,93,27,7,34,18,38,17,7,16,105,119
2015,2,21500297,12/5/2015,1610612762,Utah Jazz,1,1,1610612754,Indiana Pacers,0,0,35,34,69,8,15,23,43,49,92,28,9,37,20,33,21,10,15,104,122
2015,2,21500197,11/22/2015,1610612738,Boston Celtics,0,0,1610612751,Brooklyn Nets,1,1,21,24,45,14,23,37,35,47,82,17,4,21,14,35,19,11,17,97,101
2015,2,21500197,11/22/2015,1610612751,Brooklyn Nets,1,1,1610612738,Boston Celtics,0,0,35,29,64,5,10,15,40,39,79,26,7,33,14,26,18,9,15,96,111
2015,2,21500102,11/9/2015,1610612743,Denver Nuggets,1,1,1610612757,Portland Trail Blazers,0,0,33,25,58,7,12,19,40,37,77,21,11,32,11,33,20,6,15,96,108
2015,2,21500102,11/9/2015,1610612757,Portland Trail Blazers,0,0,1610612743,Denver Nuggets,1,1,26,36,62,10,19,29,36,55,91,22,5,27,16,42,20,5,10,97,104
2015,2,21500006,10/28/2015,1610612741,Chicago Bulls,0,1,1610612751,Brooklyn Nets,1,0,28,22,50,14,14,28,42,36,78,17,3,20,9,29,20,11,20,101,115
2015,2,21500006,10/28/2015,1610612751,Brooklyn Nets,1,0,1610612741,Chicago Bulls,0,1,39,45,84,0,9,9,39,54,93,22,6,28,18,39,19,9,13,100,100
2014,2,21400846,2/25/2015,1610612745,Houston Rockets,1,1,1610612746,LA Clippers,0,0,19,25,44,17,27,44,36,52,88,21,9,30,18,38,27,1,10,97,110
2014,2,21400846,2/25/2015,1610612746,LA Clippers,0,0,1610612745,Houston Rockets,1,1,29,30,59,11,21,32,40,51,91,14,5,19,19,34,18,7,16,96,105
2015,2,21501014,3/17/2016,1610612748,Miami Heat,1,0,1610612766,Charlotte Hornets,0,1,33,25,58,7,10,17,40,35,75,19,5,24,7,31,22,3,15,91,106
2015,2,21501014,3/17/2016,1610612766,Charlotte Hornets,0,1,1610612748,Miami Heat,1,0,27,33,60,13,13,26,40,46,86,16,5,21,14,34,19,5,9,90,109
2015,2,21500901,3/2/2016,1610612740,New Orleans Pelicans,0,0,1610612745,Houston Rockets,1,1,22,31,53,14,23,37,36,54,90,9,4,13,9,45,24,15,23,110,95
2015,2,21500901,3/2/2016,1610612745,Houston Rockets,1,1,1610612740,New Orleans Pelicans,0,0,33,13,46,3,32,35,36,45,81,25,13,38,11,43,20,10,21,110,100
2015,2,21500838,2/22/2016,1610612738,Boston Celtics,0,0,1610612750,Minnesota Timberwolves,1,1,39,34,73,10,18,28,49,52,101,14,3,17,16,38,33,5,11,104,122
2015,2,21500838,2/22/2016,1610612750,Minnesota Timberwolves,1,1,1610612738,Boston Celtics,0,0,35,33,68,8,7,15,43,40,83,30,10,40,16,29,24,13,17,103,124
2015,2,21500598,1/15/2016,1610612740,New Orleans Pelicans,1,1,1610612766,Charlotte Hornets,0,0,31,29,60,12,15,27,43,44,87,11,2,13,9,36,29,1,8,92,109
2015,2,21500598,1/15/2016,1610612766,Charlotte Hornets,0,0,1610612740,New Orleans Pelicans,1,1,28,23,51,14,21,35,42,44,86,9,3,12,11,35,21,7,11,93,107
2015,2,21500500,1/2/2016,1610612749,Milwaukee Bucks,0,1,1610612750,Minnesota Timberwolves,1,0,24,35,59,8,8,16,32,43,75,23,5,28,12,33,20,10,13,90,95
2015,2,21500500,1/2/2016,1610612750,Minnesota Timberwolves,1,0,1610612749,Milwaukee Bucks,0,1,30,40,70,3,11,14,33,51,84,16,8,24,18,38,19,7,16,90,85
2015,2,21500398,12/19/2015,1610612747,Los Angeles Lakers,0,0,1610612760,Oklahoma City Thunder,1,1,22,36,58,8,20,28,30,56,86,10,7,17,13,47,14,6,14,94,78
2015,2,21500398,12/19/2015,1610612760,Oklahoma City Thunder,1,1,1610612747,Los Angeles Lakers,0,0,37,28,65,9,10,19,46,38,84,17,8,25,17,25,28,10,15,95,118
2015,2,21500296,12/5/2015,1610612738,Boston Celtics,0,0,1610612759,San Antonio Spurs,1,1,27,30,57,12,17,29,39,47,86,15,7,22,14,38,22,3,14,96,105
2015,2,21500296,12/5/2015,1610612759,San Antonio Spurs,1,1,1610612738,Boston Celtics,0,0,39,27,66,5,12,17,44,39,83,15,7,22,13,29,26,9,15,96,108
2015,2,21500196,11/22/2015,1610612746,LA Clippers,1,0,1610612761,Toronto Raptors,0,1,22,20,42,7,25,32,29,45,74,15,5,20,13,33,21,8,20,91,80
2015,2,21500196,11/22/2015,1610612761,Toronto Raptors,0,1,1610612746,LA Clippers,1,0,25,36,61,4,13,17,29,49,78,29,2,31,18,32,15,9,16,92,91
2021,2,22100263,11/23/2021,1610612748,Miami Heat,0,1,1610612765,Detroit Pistons,1,0,26,21,47,9,20,29,35,41,76,21,8,29,14,29,22,7,17,93,100
2016,2,21601194,4/8/2017,1610612757,Portland Trail Blazers,1,1,1610612762,Utah Jazz,0,0,24,37,61,13,17,30,37,54,91,14,2,16,14,40,15,2,3,89,101
2016,2,21601194,4/8/2017,1610612762,Utah Jazz,0,0,1610612757,Portland Trail Blazers,1,1,25,34,59,6,13,19,31,47,78,18,6,24,13,38,19,5,13,89,86
2022,2,22200429,12/16/2022,1610612758,Sacramento Kings,0,1,1610612765,Detroit Pistons,1,0,31,20,51,12,19,31,43,39,82,24,5,29,9,33,30,7,14,100,122
2022,2,22200429,12/16/2022,1610612765,Detroit Pistons,1,0,1610612758,Sacramento Kings,0,1,29,27,56,10,19,29,39,46,85,25,6,31,16,32,22,8,17,99,113
2016,2,21600635,1/18/2017,1610612754,Indiana Pacers,0,1,1610612758,Sacramento Kings,1,0,32,22,54,7,14,21,39,36,75,21,4,25,9,29,22,9,15,93,106
2016,2,21600635,1/18/2017,1610612758,Sacramento Kings,1,0,1610612754,Indiana Pacers,0,1,26,25,51,9,12,21,35,37,72,21,6,27,12,26,28,11,21,94,100
2016,2,21600173,11/17/2016,1610612741,Chicago Bulls,0,1,1610612762,Utah Jazz,1,0,28,45,73,5,12,17,33,57,90,14,2,16,19,39,8,4,8,87,85
2016,2,21600173,11/17/2016,1610612762,Utah Jazz,1,0,1610612741,Chicago Bulls,0,1,25,28,53,5,20,25,30,48,78,12,2,14,11,37,11,7,13,87,77
2022,2,22200391,12/10/2022,1610612741,Chicago Bulls,1,1,1610612742,Dallas Mavericks,0,0,35,16,51,19,15,34,54,31,85,17,7,24,5,30,33,5,10,100,144
2022,2,22200391,12/10/2022,1610612742,Dallas Mavericks,0,0,1610612741,Chicago Bulls,1,1,30,16,46,11,33,44,41,49,90,22,4,26,9,41,24,8,8,99,115
2019,2,21900307,12/4/2019,1610612749,Milwaukee Bucks,0,1,1610612765,Detroit Pistons,1,0,30,25,55,14,21,35,44,46,90,25,2,27,15,32,25,5,16,104,127
2019,2,21900307,12/4/2019,1610612765,Detroit Pistons,1,0,1610612749,Milwaukee Bucks,0,1,28,29,57,11,25,36,39,54,93,14,8,22,11,47,25,7,12,103,103
2022,2,22200430,12/16/2022,1610612738,Boston Celtics,1,0,1610612753,Orlando Magic,0,1,24,14,38,11,35,46,35,49,84,28,6,34,12,40,17,7,13,100,109
2022,2,22200430,12/16/2022,1610612753,Orlando Magic,0,1,1610612738,Boston Celtics,1,0,33,25,58,9,24,33,42,49,91,24,4,28,20,32,19,9,19,102,117
2021,2,22100263,11/23/2021,1610612765,Detroit Pistons,1,0,1610612748,Miami Heat,0,1,25,21,46,10,28,38,35,49,84,12,2,14,11,40,22,9,15,92,92
2019,2,21901300,8/11/2020,1610612742,Dallas Mavericks,1,0,1610612757,Portland Trail Blazers,0,1,22,15,37,20,24,44,42,39,81,27,6,33,7,36,28,9,17,106,131
2019,2,21901300,8/11/2020,1610612757,Portland Trail Blazers,0,1,1610612742,Dallas Mavericks,1,0,31,29,60,15,23,38,46,52,98,27,2,29,15,37,18,4,8,107,134
2019,2,21901276,8/7/2020,1610612751,Brooklyn Nets,1,1,1610612758,Sacramento Kings,0,0,25,21,46,17,23,40,42,44,86,18,10,28,10,40,30,3,11,102,119
2019,2,21901276,8/7/2020,1610612758,Sacramento Kings,0,0,1610612751,Brooklyn Nets,1,1,26,23,49,12,28,40,38,51,89,18,6,24,15,39,19,9,15,101,106
2019,2,21901245,8/2/2020,1610612738,Boston Celtics,1,1,1610612757,Portland Trail Blazers,0,0,24,23,47,18,12,30,42,35,77,26,8,34,9,28,24,8,14,97,128
2019,2,21901245,8/2/2020,1610612757,Portland Trail Blazers,0,0,1610612738,Boston Celtics,1,1,26,22,48,19,23,42,45,45,90,15,1,16,14,31,31,9,12,97,124
2019,2,21901231,7/30/2020,1610612740,New Orleans Pelicans,1,0,1610612762,Utah Jazz,0,1,29,34,63,11,20,31,40,54,94,13,5,18,21,36,22,11,21,101,104
2019,2,21901231,7/30/2020,1610612762,Utah Jazz,0,1,1610612740,New Orleans Pelicans,1,0,29,21,50,8,26,34,37,47,84,24,4,28,17,33,17,12,20,101,106
2019,2,21900945,3/7/2020,1610612757,Portland Trail Blazers,1,0,1610612758,Sacramento Kings,0,1,32,18,50,10,29,39,42,47,89,17,9,26,14,38,22,9,11,99,111
2019,2,21900945,3/7/2020,1610612758,Sacramento Kings,0,1,1610612757,Portland Trail Blazers,1,0,20,26,46,21,18,39,41,44,85,20,3,23,13,32,30,9,15,99,123
2019,2,21900904,3/2/2020,1610612753,Orlando Magic,1,0,1610612757,Portland Trail Blazers,0,1,23,30,53,14,29,43,37,59,96,19,3,22,15,44,29,6,6,99,107
2019,2,21900904,3/2/2020,1610612757,Portland Trail Blazers,0,1,1610612753,Orlando Magic,1,0,33,22,55,16,17,33,49,39,88,16,0,16,9,30,27,3,12,99,130
2019,2,21900868,2/26/2020,1610612748,Miami Heat,1,0,1610612750,Minnesota Timberwolves,0,1,30,22,52,11,15,26,41,37,78,33,10,43,12,29,30,16,22,107,126
2019,2,21900868,2/26/2020,1610612750,Minnesota Timberwolves,0,1,1610612748,Miami Heat,1,0,30,15,45,17,29,46,47,44,91,18,7,25,12,37,28,9,16,108,129
2019,2,21900830,2/21/2020,1610612738,Boston Celtics,0,1,1610612750,Minnesota Timberwolves,1,0,34,32,66,10,19,29,44,51,95,29,8,37,20,36,21,8,11,105,127
2019,2,21900830,2/21/2020,1610612750,Minnesota Timberwolves,1,0,1610612738,Boston Celtics,0,1,21,26,47,15,27,42,36,53,89,30,5,35,12,43,23,5,10,104,117
2022,2,22200420,12/14/2022,1610612757,Portland Trail Blazers,0,1,1610612759,San Antonio Spurs,1,0,31,10,41,18,22,40,49,32,81,12,5,17,9,26,26,9,17,97,128
2022,2,22200420,12/14/2022,1610612759,San Antonio Spurs,1,0,1610612757,Portland Trail Blazers,0,1,34,34,68,11,18,29,45,52,97,11,8,19,20,36,23,5,11,98,112
2018,2,21801054,3/18/2019,1610612748,Miami Heat,0,1,1610612760,Oklahoma City Thunder,1,0,37,31,68,9,20,29,46,51,97,15,1,16,14,38,30,4,9,102,116
2019,2,21900079,11/2/2019,1610612743,Denver Nuggets,0,1,1610612753,Orlando Magic,1,0,18,27,45,9,19,28,27,46,73,28,11,39,14,39,15,8,14,94,91
2019,2,21900079,11/2/2019,1610612753,Orlando Magic,1,0,1610612743,Denver Nuggets,0,1,31,26,57,6,23,29,37,49,86,7,4,11,14,37,22,8,16,94,87
2019,2,21900818,2/13/2020,1610612738,Boston Celtics,1,1,1610612746,LA Clippers,0,0,27,33,60,18,25,43,45,58,103,33,7,40,15,46,22,4,15,124,141
2019,2,21900818,2/13/2020,1610612746,LA Clippers,0,0,1610612738,Boston Celtics,1,1,35,40,75,11,24,35,46,64,110,30,7,37,20,47,19,9,16,125,133
2019,2,21900798,2/10/2020,1610612742,Dallas Mavericks,1,0,1610612762,Utah Jazz,0,1,24,16,40,15,28,43,39,44,83,26,5,31,7,39,24,5,7,99,119
2019,2,21900798,2/10/2020,1610612762,Utah Jazz,0,1,1610612742,Dallas Mavericks,1,0,31,12,43,15,20,35,46,32,78,16,5,21,11,24,27,8,21,98,123
2019,2,21900785,2/8/2020,1610612758,Sacramento Kings,1,1,1610612759,San Antonio Spurs,0,0,26,25,51,19,16,35,45,41,86,13,7,20,10,35,25,7,11,94,122
2019,2,21900785,2/8/2020,1610612759,San Antonio Spurs,0,0,1610612758,Sacramento Kings,1,1,34,23,57,7,17,24,41,40,81,13,5,18,10,33,23,6,15,94,102
2021,2,22100262,11/22/2021,1610612755,Philadelphia 76ers,0,1,1610612758,Sacramento Kings,1,0,27,26,53,9,23,32,36,49,85,21,6,27,14,38,19,4,7,91,102
2022,2,22200438,12/17/2022,1610612746,LA Clippers,1,1,1610612764,Washington Wizards,0,0,25,32,57,12,17,29,37,49,86,16,10,26,15,39,19,10,14,98,102
2022,2,22200438,12/17/2022,1610612764,Washington Wizards,0,0,1610612746,LA Clippers,1,1,27,32,59,9,16,25,36,48,84,12,1,13,10,38,20,6,16,97,93
2021,2,22100262,11/22/2021,1610612758,Sacramento Kings,1,0,1610612755,Philadelphia 76ers,0,1,26,23,49,7,24,31,33,47,80,21,8,29,16,34,17,9,14,91,94
2014,2,21400845,2/25/2015,1610612741,Chicago Bulls,1,0,1610612766,Charlotte Hornets,0,1,31,29,60,3,14,17,34,43,77,15,8,23,9,37,24,8,12,90,86
2014,2,21400845,2/25/2015,1610612766,Charlotte Hornets,0,1,1610612741,Chicago Bulls,1,0,35,35,70,4,10,14,39,45,84,16,5,21,14,34,16,6,9,90,98
2016,2,21600172,11/17/2016,1610612750,Minnesota Timberwolves,1,1,1610612755,Philadelphia 76ers,0,0,37,22,59,6,19,25,43,41,84,18,2,20,15,27,18,9,13,91,110
2016,2,21600172,11/17/2016,1610612755,Philadelphia 76ers,0,0,1610612750,Minnesota Timberwolves,1,1,22,29,51,9,23,32,31,52,83,15,4,19,18,36,15,7,17,92,86
2015,2,21501206,4/11/2016,1610612751,Brooklyn Nets,1,0,1610612764,Washington Wizards,0,1,34,33,67,10,21,31,44,54,98,13,8,21,16,42,24,8,10,102,111
2015,2,21501206,4/11/2016,1610612764,Washington Wizards,0,1,1610612751,Brooklyn Nets,1,0,37,27,64,9,16,25,46,43,89,19,5,24,12,33,27,9,14,103,120
2019,2,21901275,8/7/2020,1610612760,Oklahoma City Thunder,0,0,1610612763,Memphis Grizzlies,1,1,21,33,54,13,30,43,34,63,97,11,4,15,15,48,19,6,10,100,92
2019,2,21901275,8/7/2020,1610612763,Memphis Grizzlies,1,1,1610612760,Oklahoma City Thunder,0,0,35,17,52,11,20,31,46,37,83,18,2,20,13,25,24,12,20,98,121
2019,2,21900958,3/9/2020,1610612743,Denver Nuggets,1,1,1610612749,Milwaukee Bucks,0,0,25,28,53,16,25,41,41,53,94,11,1,12,9,44,28,8,14,104,109
2019,2,21900958,3/9/2020,1610612749,Milwaukee Bucks,0,0,1610612743,Denver Nuggets,1,1,19,21,40,15,35,50,34,56,90,12,6,18,13,45,23,11,17,105,95
2019,2,21900933,3/6/2020,1610612738,Boston Celtics,1,0,1610612762,Utah Jazz,0,1,25,33,58,10,26,36,35,59,94,14,4,18,22,39,19,8,13,96,94
2019,2,21900933,3/6/2020,1610612762,Utah Jazz,0,1,1610612738,Boston Celtics,1,0,19,16,35,17,28,45,36,44,80,10,2,12,11,34,23,6,18,94,99
2019,2,21900886,2/28/2020,1610612743,Denver Nuggets,0,0,1610612746,LA Clippers,1,1,32,34,66,9,16,25,41,50,91,12,4,16,17,37,19,6,15,97,103
2019,2,21900886,2/28/2020,1610612746,LA Clippers,1,1,1610612743,Denver Nuggets,0,0,30,20,50,18,21,39,48,41,89,18,2,20,15,28,35,7,12,98,132
2019,2,21900867,2/26/2020,1610612737,Atlanta Hawks,1,0,1610612753,Orlando Magic,0,1,29,29,58,13,23,36,42,52,94,23,2,25,12,40,30,7,9,103,120
2019,2,21900867,2/26/2020,1610612753,Orlando Magic,0,1,1610612737,Atlanta Hawks,1,0,35,33,68,14,18,32,49,51,100,18,7,25,17,37,30,5,9,104,130
2022,2,22200449,12/18/2022,1610612741,Chicago Bulls,0,0,1610612750,Minnesota Timberwolves,1,1,30,20,50,16,22,38,46,42,88,18,6,24,9,35,31,5,11,99,126
2022,2,22200449,12/18/2022,1610612750,Minnesota Timberwolves,1,1,1610612741,Chicago Bulls,0,0,34,10,44,23,20,43,57,30,87,13,3,16,7,25,38,6,13,100,150
2018,2,21801201,4/7/2019,1610612742,Dallas Mavericks,0,1,1610612763,Memphis Grizzlies,1,0,33,24,57,12,29,41,45,53,98,27,7,34,13,43,31,4,7,108,129
2018,2,21801201,4/7/2019,1610612763,Memphis Grizzlies,1,0,1610612742,Dallas Mavericks,0,1,23,31,54,19,25,44,42,56,98,24,4,28,15,43,32,4,9,107,127
2018,2,21801054,3/18/2019,1610612760,Oklahoma City Thunder,1,0,1610612748,Miami Heat,0,1,28,22,50,10,27,37,38,49,87,21,6,27,16,37,21,13,19,101,107
2019,2,21900841,2/22/2020,1610612745,Houston Rockets,0,1,1610612762,Utah Jazz,1,0,25,19,44,20,28,48,45,47,92,10,4,14,9,42,20,1,10,101,120
2019,2,21900841,2/22/2020,1610612762,Utah Jazz,1,0,1610612745,Houston Rockets,0,1,35,24,59,7,24,31,42,48,90,19,5,24,12,38,18,9,13,100,110
2022,2,22200444,12/17/2022,1610612740,New Orleans Pelicans,0,0,1610612756,Phoenix Suns,1,1,31,16,47,14,16,30,45,32,77,10,3,13,6,27,27,6,17,93,114
2022,2,22200444,12/17/2022,1610612756,Phoenix Suns,1,1,1610612740,New Orleans Pelicans,0,0,24,18,42,15,26,41,39,44,83,25,10,35,14,35,23,2,8,94,118
2016,2,21601193,4/8/2017,1610612746,LA Clippers,0,1,1610612759,San Antonio Spurs,1,0,36,26,62,6,16,22,42,42,84,8,6,14,11,35,21,3,8,89,98
2016,2,21601193,4/8/2017,1610612759,San Antonio Spurs,1,0,1610612746,LA Clippers,0,1,26,32,58,8,14,22,34,46,80,11,3,14,11,38,20,8,14,90,87
2016,2,21600634,1/18/2017,1610612744,Golden State Warriors,1,1,1610612760,Oklahoma City Thunder,0,0,36,28,64,10,11,21,46,39,85,19,8,27,17,25,35,11,18,102,121
2016,2,21600634,1/18/2017,1610612760,Oklahoma City Thunder,0,0,1610612744,Golden State Warriors,1,1,30,32,62,8,20,28,38,52,90,16,3,19,16,37,23,11,19,101,100
2021,2,22100261,11/22/2021,1610612762,Utah Jazz,1,0,1610612763,Memphis Grizzlies,0,1,24,20,44,17,26,43,41,46,87,19,6,25,13,37,26,10,14,99,118
2021,2,22100261,11/22/2021,1610612763,Memphis Grizzlies,0,1,1610612762,Utah Jazz,1,0,29,31,60,13,22,35,42,53,95,22,5,27,18,36,24,5,7,98,119
2019,2,21901316,8/14/2020,1610612748,Miami Heat,0,0,1610612754,Indiana Pacers,1,1,21,28,49,10,28,38,31,56,87,20,7,27,18,43,14,11,19,100,92
2019,2,21901316,8/14/2020,1610612754,Indiana Pacers,1,1,1610612748,Miami Heat,0,0,28,23,51,15,23,38,43,46,89,8,3,11,14,35,32,6,20,101,109
2019,2,21901299,8/11/2020,1610612755,Philadelphia 76ers,1,0,1610612756,Phoenix Suns,0,1,31,29,60,15,18,33,46,47,93,10,4,14,17,34,28,4,9,91,117
2019,2,21901299,8/11/2020,1610612756,Phoenix Suns,0,1,1610612755,Philadelphia 76ers,1,0,37,24,61,12,16,28,49,40,89,20,1,21,15,26,28,5,7,92,130
2019,2,21901274,8/7/2020,1610612759,San Antonio Spurs,1,1,1610612762,Utah Jazz,0,0,36,31,67,9,13,22,45,44,89,20,6,26,10,39,27,8,13,105,119
2019,2,21901274,8/7/2020,1610612762,Utah Jazz,0,0,1610612759,San Antonio Spurs,1,1,22,32,54,16,21,37,38,53,91,19,5,24,14,43,25,10,16,104,111
2019,2,21901258,8/4/2020,1610612746,LA Clippers,1,0,1610612756,Phoenix Suns,0,1,34,22,56,8,21,29,42,43,85,23,4,27,9,35,21,5,10,99,115
2019,2,21901258,8/4/2020,1610612756,Phoenix Suns,0,1,1610612746,LA Clippers,1,0,28,36,64,17,15,32,45,51,96,10,4,14,11,43,25,2,8,99,117
2019,2,21901244,8/2/2020,1610612751,Brooklyn Nets,1,1,1610612764,Washington Wizards,0,0,27,30,57,11,22,33,38,52,90,31,6,37,17,37,23,6,11,100,118
2019,2,21901244,8/2/2020,1610612764,Washington Wizards,0,0,1610612751,Brooklyn Nets,1,1,31,26,57,9,22,31,40,48,88,21,6,27,14,37,26,5,13,100,110
2019,2,21900973,3/11/2020,1610612742,Dallas Mavericks,1,1,1610612743,Denver Nuggets,0,0,30,27,57,12,23,35,42,50,92,17,6,23,16,37,23,6,11,99,113
2019,2,21900973,3/11/2020,1610612743,Denver Nuggets,0,0,1610612742,Dallas Mavericks,1,1,25,19,44,14,25,39,39,44,83,5,3,8,4,41,23,9,16,98,97
2019,2,21900903,3/2/2020,1610612745,Houston Rockets,0,0,1610612752,New York Knicks,1,1,19,19,38,20,36,56,39,55,94,25,2,27,11,46,25,6,12,107,123
2019,2,21900903,3/2/2020,1610612752,New York Knicks,1,1,1610612745,Houston Rockets,0,0,35,32,67,12,18,30,47,50,97,19,11,30,25,31,26,11,19,105,125
2019,2,21900851,2/24/2020,1610612749,Milwaukee Bucks,0,1,1610612764,Washington Wizards,1,0,32,17,49,17,20,37,49,37,86,22,5,27,4,36,26,8,21,117,137
2019,2,21900851,2/24/2020,1610612764,Washington Wizards,1,0,1610612749,Milwaukee Bucks,0,1,32,31,63,15,20,35,47,51,98,25,8,33,12,44,27,7,17,119,134
2019,2,21900808,2/12/2020,1610612753,Orlando Magic,1,1,1610612765,Detroit Pistons,0,0,32,28,60,12,24,36,44,52,96,16,2,18,11,41,34,5,13,108,116
2019,2,21900808,2/12/2020,1610612765,Detroit Pistons,0,0,1610612753,Orlando Magic,1,1,22,25,47,18,27,45,40,52,92,14,1,15,11,41,28,13,21,109,112
2019,2,21900791,2/9/2020,1610612739,Cleveland Cavaliers,1,0,1610612746,LA Clippers,0,1,28,34,62,7,26,33,35,60,95,15,7,22,19,45,22,11,16,102,92
2019,2,21900791,2/9/2020,1610612746,LA Clippers,0,1,1610612739,Cleveland Cavaliers,1,0,41,16,57,12,24,36,53,40,93,15,5,20,11,30,28,9,12,103,133
2018,2,21801200,4/7/2019,1610612745,Houston Rockets,1,1,1610612756,Phoenix Suns,0,0,26,17,43,27,30,57,53,47,100,16,5,21,14,37,34,8,9,104,149
2019,2,21900306,12/4/2019,1610612744,Golden State Warriors,0,0,1610612766,Charlotte Hornets,1,1,27,28,55,9,14,23,36,42,78,10,5,15,9,36,18,11,16,92,91
2019,2,21900306,12/4/2019,1610612766,Charlotte Hornets,1,1,1610612744,Golden State Warriors,0,0,19,20,39,21,27,48,40,47,87,5,3,8,14,34,30,7,15,92,106
2019,2,21900078,11/2/2019,1610612751,Brooklyn Nets,0,0,1610612765,Detroit Pistons,1,1,33,28,61,10,22,32,43,50,93,13,4,17,16,36,24,8,15,103,109
2019,2,21900078,11/2/2019,1610612765,Detroit Pistons,1,1,1610612751,Brooklyn Nets,0,0,33,31,64,8,19,27,41,50,91,23,6,29,11,42,21,4,8,102,113
2018,2,21801200,4/7/2019,1610612756,Phoenix Suns,0,0,1610612745,Houston Rockets,1,1,32,27,59,11,23,34,43,50,93,16,5,21,11,41,26,12,13,104,113
2018,2,21800720,1/25/2019,1610612753,Orlando Magic,1,0,1610612764,Washington Wizards,0,1,31,20,51,7,26,33,38,46,84,8,4,12,14,33,24,9,16,93,91
2018,2,21800720,1/25/2019,1610612764,Washington Wizards,0,1,1610612753,Orlando Magic,1,0,20,32,52,15,12,27,35,44,79,10,2,12,6,39,26,3,12,91,95
2020,2,22000056,12/30/2020,1610612738,Boston Celtics,1,1,1610612763,Memphis Grizzlies,0,0,33,19,52,16,23,39,49,42,91,12,2,14,11,33,27,8,16,101,126
2020,2,22000056,12/30/2020,1610612763,Memphis Grizzlies,0,0,1610612738,Boston Celtics,1,1,31,29,60,9,24,33,40,53,93,18,7,25,25,32,26,17,22,102,107
2016,2,21601192,4/8/2017,1610612748,Miami Heat,0,1,1610612764,Washington Wizards,1,0,30,32,62,7,11,18,37,43,80,25,11,36,13,35,23,7,13,95,106
2016,2,21601192,4/8/2017,1610612764,Washington Wizards,1,0,1610612748,Miami Heat,0,1,31,28,59,8,14,22,39,42,81,17,5,22,14,28,21,13,20,97,103
2021,2,22100260,11/22/2021,1610612756,Phoenix Suns,0,1,1610612759,San Antonio Spurs,1,0,33,28,61,12,15,27,45,43,88,13,3,16,13,33,25,9,15,99,115
2021,2,22100260,11/22/2021,1610612759,San Antonio Spurs,1,0,1610612756,Phoenix Suns,0,1,44,29,73,5,15,20,49,44,93,8,8,16,16,33,23,10,15,99,111
2016,2,21600171,11/17/2016,1610612745,Houston Rockets,1,1,1610612757,Portland Trail Blazers,0,0,32,31,63,14,18,32,46,49,95,20,5,25,18,34,26,6,13,99,126
2016,2,21600171,11/17/2016,1610612757,Portland Trail Blazers,0,0,1610612745,Houston Rockets,1,1,31,31,62,10,18,28,41,49,90,17,4,21,14,37,24,6,13,100,109
2014,2,21400844,2/25/2015,1610612738,Boston Celtics,1,1,1610612752,New York Knicks,0,0,28,24,52,14,17,31,42,41,83,17,3,20,8,34,29,6,14,98,115
2014,2,21400844,2/25/2015,1610612752,New York Knicks,0,0,1610612738,Boston Celtics,1,1,32,29,61,2,19,21,34,48,82,24,7,31,12,39,19,6,13,98,94
2019,2,21901273,8/6/2020,1610612745,Houston Rockets,1,1,1610612747,Los Angeles Lakers,0,0,15,12,27,21,36,57,36,48,84,20,3,23,11,38,26,11,20,107,113
2019,2,21901273,8/6/2020,1610612747,Los Angeles Lakers,0,0,1610612745,Houston Rockets,1,1,33,25,58,2,17,19,35,42,77,25,11,36,14,32,18,11,25,105,97
2019,2,21900957,3/9/2020,1610612737,Atlanta Hawks,1,1,1610612766,Charlotte Hornets,0,0,32,21,53,21,22,43,53,43,96,16,11,27,17,30,33,9,16,106,143
2019,2,21900957,3/9/2020,1610612766,Charlotte Hornets,0,0,1610612737,Atlanta Hawks,1,1,30,26,56,19,29,48,49,55,104,21,2,23,13,44,31,1,5,110,138
2019,2,21900944,3/7/2020,1610612744,Golden State Warriors,1,1,1610612755,Philadelphia 76ers,0,0,35,20,55,9,16,25,44,36,80,21,7,28,8,31,30,3,7,91,118
2019,2,21900944,3/7/2020,1610612755,Philadelphia 76ers,0,0,1610612744,Golden State Warriors,1,1,28,22,50,13,21,34,41,43,84,19,3,22,14,31,29,4,11,91,114
2019,2,21900932,3/6/2020,1610612752,New York Knicks,1,0,1610612760,Oklahoma City Thunder,0,1,37,30,67,4,20,24,41,50,91,17,5,22,16,36,19,8,12,97,103
2019,2,21900932,3/6/2020,1610612760,Oklahoma City Thunder,0,1,1610612752,New York Knicks,1,0,35,30,65,12,19,31,47,49,96,20,5,25,15,36,26,4,4,97,126
2019,2,21900918,3/4/2020,1610612760,Oklahoma City Thunder,0,1,1610612765,Detroit Pistons,1,0,36,15,51,10,14,24,46,29,75,12,5,17,2,29,25,8,16,96,114
2019,2,21900918,3/4/2020,1610612765,Detroit Pistons,1,0,1610612760,Oklahoma City Thunder,0,1,22,21,43,18,25,43,40,46,86,9,6,15,16,34,27,13,17,96,107
2019,2,21900885,2/28/2020,1610612762,Utah Jazz,1,1,1610612764,Washington Wizards,0,0,25,27,52,19,18,37,44,45,89,22,8,30,17,30,23,12,15,103,129
2019,2,21900885,2/28/2020,1610612764,Washington Wizards,0,0,1610612762,Utah Jazz,1,1,31,30,61,14,23,37,45,53,98,15,6,21,15,40,23,7,11,103,119
2019,2,21900866,2/26/2020,1610612751,Brooklyn Nets,0,0,1610612764,Washington Wizards,1,1,26,25,51,10,26,36,36,51,87,24,11,35,21,35,15,9,18,102,106
2019,2,21900866,2/26/2020,1610612764,Washington Wizards,1,1,1610612751,Brooklyn Nets,0,0,26,31,57,15,24,39,41,55,96,13,3,16,13,43,22,7,11,102,110
2018,2,21800917,2/27/2019,1610612759,San Antonio Spurs,1,1,1610612765,Detroit Pistons,0,0,33,31,64,9,8,17,42,39,81,12,5,17,7,35,24,6,12,92,105
2018,2,21800917,2/27/2019,1610612765,Detroit Pistons,0,0,1610612759,San Antonio Spurs,1,1,21,41,62,15,23,38,36,64,100,6,1,7,17,48,19,3,6,94,93
2018,2,21800645,1/14/2019,1610612738,Boston Celtics,0,0,1610612751,Brooklyn Nets,1,1,26,29,55,11,25,36,37,54,91,17,6,23,16,42,21,5,12,99,102
2018,2,21800645,1/14/2019,1610612751,Brooklyn Nets,1,1,1610612738,Boston Celtics,0,0,24,24,48,13,25,38,37,49,86,22,3,25,18,33,18,10,17,98,109
2021,2,22100259,11/22/2021,1610612740,New Orleans Pelicans,1,0,1610612750,Minnesota Timberwolves,0,1,31,25,56,6,26,32,37,51,88,16,2,18,20,32,24,14,23,98,96
2021,2,22100259,11/22/2021,1610612750,Minnesota Timberwolves,0,1,1610612740,New Orleans Pelicans,1,0,30,26,56,10,34,44,40,60,100,20,8,28,26,38,21,6,12,99,110
2016,2,21600633,1/18/2017,1610612737,Atlanta Hawks,0,0,1610612765,Detroit Pistons,1,1,24,29,53,6,19,25,30,48,78,29,8,37,10,43,22,6,13,97,95
2016,2,21600633,1/18/2017,1610612765,Detroit Pistons,1,1,1610612737,Atlanta Hawks,0,0,35,31,66,10,15,25,45,46,91,18,10,28,21,28,27,1,13,97,118
2022,2,22200437,12/16/2022,1610612743,Denver Nuggets,0,0,1610612747,Los Angeles Lakers,1,1,30,24,54,9,18,27,39,42,81,21,7,28,9,34,25,11,19,101,108
2022,2,22200437,12/16/2022,1610612747,Los Angeles Lakers,1,1,1610612743,Denver Nuggets,0,0,36,22,58,12,21,33,48,43,91,18,6,24,15,31,29,7,15,103,126
2016,2,21601191,4/8/2017,1610612749,Milwaukee Bucks,0,1,1610612755,Philadelphia 76ers,1,0,29,22,51,6,21,27,35,43,78,14,6,20,8,39,18,9,15,95,90
2016,2,21601191,4/8/2017,1610612755,Philadelphia 76ers,1,0,1610612749,Milwaukee Bucks,0,1,19,23,42,8,23,31,27,46,73,20,3,23,12,39,23,10,18,95,82
2023,2,22300949,3/13/2024,1610612743,Denver Nuggets,0,1,1610612748,Miami Heat,1,0,29,20,49,11,22,33,40,42,82,9,4,13,9,35,24,5,10,89,100
2021,2,22100258,11/22/2021,1610612749,Milwaukee Bucks,1,1,1610612753,Orlando Magic,0,0,26,23,49,18,27,45,44,50,94,17,7,24,20,33,28,6,13,101,123
2021,2,22100258,11/22/2021,1610612753,Orlando Magic,0,0,1610612749,Milwaukee Bucks,1,1,23,29,52,11,30,41,34,59,93,13,5,18,20,42,16,10,16,101,92
2019,2,21901243,8/1/2020,1610612747,Los Angeles Lakers,0,0,1610612761,Toronto Raptors,1,1,19,23,42,10,30,40,29,53,82,24,9,33,12,45,17,7,18,103,92
2019,2,21901243,8/1/2020,1610612761,Toronto Raptors,1,1,1610612747,Los Angeles Lakers,0,0,21,29,50,14,20,34,35,49,84,23,3,26,12,38,24,8,18,103,107
2019,2,21900865,2/26/2020,1610612739,Cleveland Cavaliers,1,1,1610612755,Philadelphia 76ers,0,0,30,24,54,11,13,24,41,37,78,15,2,17,12,25,24,13,19,93,108
2019,2,21900865,2/26/2020,1610612755,Philadelphia 76ers,0,0,1610612739,Cleveland Cavaliers,1,1,23,28,51,13,25,38,36,53,89,9,5,14,13,42,22,5,9,94,94
2019,2,21900829,2/21/2020,1610612756,Phoenix Suns,0,0,1610612761,Toronto Raptors,1,1,32,26,58,6,28,34,38,54,92,19,4,23,13,43,29,7,17,105,101
2019,2,21900829,2/21/2020,1610612761,Toronto Raptors,1,1,1610612756,Phoenix Suns,0,0,28,15,43,14,23,37,42,38,80,20,2,22,13,26,24,12,25,106,118
2019,2,21900758,2/5/2020,1610612754,Indiana Pacers,0,0,1610612761,Toronto Raptors,1,1,24,19,43,19,20,39,43,39,82,13,3,16,10,30,29,12,19,99,118
2019,2,21900758,2/5/2020,1610612761,Toronto Raptors,1,1,1610612754,Indiana Pacers,0,0,31,23,54,12,20,32,43,43,86,21,3,24,9,34,27,6,10,98,119
2019,2,21900744,2/3/2020,1610612764,Washington Wizards,1,0,1610612744,Golden State Warriors,0,1,33,28,61,9,13,22,42,41,83,24,5,29,5,37,28,8,11,103,117
2019,2,21900736,2/1/2020,1610612747,Los Angeles Lakers,0,1,1610612758,Sacramento Kings,1,0,25,18,43,19,24,43,44,42,86,22,5,27,14,32,33,5,15,100,129
2019,2,21900736,2/1/2020,1610612758,Sacramento Kings,1,0,1610612747,Los Angeles Lakers,0,1,25,22,47,14,30,44,39,52,91,21,5,26,18,37,21,10,16,101,113
2019,2,21900724,1/31/2020,1610612743,Denver Nuggets,0,1,1610612749,Milwaukee Bucks,1,0,26,28,54,22,24,46,48,52,100,9,0,9,9,43,29,7,13,108,127
2019,2,21900724,1/31/2020,1610612749,Milwaukee Bucks,1,0,1610612743,Denver Nuggets,0,1,31,24,55,12,28,40,43,52,95,17,9,26,12,46,29,8,13,108,115
2019,2,21900703,1/28/2020,1610612737,Atlanta Hawks,0,0,1610612761,Toronto Raptors,1,1,29,16,45,12,35,47,41,51,92,20,5,25,11,42,28,10,18,111,114
2019,2,21900703,1/28/2020,1610612761,Toronto Raptors,1,1,1610612737,Atlanta Hawks,0,0,35,19,54,13,30,43,48,49,97,21,6,27,14,38,26,10,13,110,130
2019,2,21900699,1/28/2020,1610612752,New York Knicks,0,0,1610612766,Charlotte Hornets,1,1,29,25,54,9,23,32,38,48,86,7,4,11,11,39,17,5,14,95,92
2019,2,21900699,1/28/2020,1610612766,Charlotte Hornets,1,1,1610612752,New York Knicks,0,0,26,30,56,8,24,32,34,54,88,21,6,27,21,37,22,5,14,94,97
2019,2,21900679,1/24/2020,1610612744,Golden State Warriors,1,0,1610612754,Indiana Pacers,0,1,21,22,43,19,20,39,40,42,82,19,4,23,11,33,31,15,20,101,118
2019,2,21900679,1/24/2020,1610612754,Indiana Pacers,0,1,1610612744,Golden State Warriors,1,0,33,26,59,17,11,28,50,37,87,12,1,13,6,31,35,6,12,100,129
2020,2,22000055,12/29/2020,1610612743,Denver Nuggets,0,0,1610612758,Sacramento Kings,1,1,33,20,53,11,17,28,44,37,81,16,4,20,10,27,27,9,20,100,115
2020,2,22000055,12/29/2020,1610612758,Sacramento Kings,1,1,1610612743,Denver Nuggets,0,0,30,31,61,16,17,33,46,48,94,17,5,22,14,37,33,7,11,101,125
2019,2,21900305,12/3/2019,1610612746,LA Clippers,1,1,1610612757,Portland Trail Blazers,0,0,26,34,60,17,17,34,43,51,94,14,11,25,17,39,25,5,11,99,117
2019,2,21900305,12/3/2019,1610612757,Portland Trail Blazers,0,0,1610612746,LA Clippers,1,1,32,32,64,7,20,27,39,52,91,12,3,15,13,40,20,7,13,98,97
2019,2,21900077,11/2/2019,1610612740,New Orleans Pelicans,0,0,1610612760,Oklahoma City Thunder,1,1,29,33,62,11,21,32,40,54,94,13,9,22,19,38,25,8,16,101,104
2019,2,21900077,11/2/2019,1610612760,Oklahoma City Thunder,1,1,1610612740,New Orleans Pelicans,0,0,26,27,53,15,22,37,41,49,90,18,5,23,11,40,20,7,12,102,115
2020,2,22000054,12/29/2020,1610612746,LA Clippers,1,1,1610612750,Minnesota Timberwolves,0,0,31,26,57,16,15,31,47,41,88,14,2,16,13,30,32,7,15,98,124
2020,2,22000054,12/29/2020,1610612750,Minnesota Timberwolves,0,0,1610612746,LA Clippers,1,1,24,27,51,13,25,38,37,52,89,14,3,17,14,40,22,6,14,97,101
2016,2,21600632,1/18/2017,1610612745,Houston Rockets,1,1,1610612749,Milwaukee Bucks,0,0,29,22,51,14,30,44,43,52,95,11,4,15,17,38,25,8,10,95,111
2016,2,21600632,1/18/2017,1610612749,Milwaukee Bucks,0,0,1610612745,Houston Rockets,1,1,30,35,65,7,21,28,37,56,93,11,3,14,21,36,26,9,18,95,92
2016,2,21600170,11/17/2016,1610612748,Miami Heat,1,1,1610612749,Milwaukee Bucks,0,0,32,35,67,7,23,30,39,58,97,11,10,21,25,38,19,4,8,89,96
2016,2,21600170,11/17/2016,1610612749,Milwaukee Bucks,0,0,1610612748,Miami Heat,1,1,21,41,62,7,16,23,28,57,85,10,3,13,16,44,20,5,15,88,73
2014,2,21400843,2/25/2015,1610612737,Atlanta Hawks,1,1,1610612742,Dallas Mavericks,0,0,26,24,50,13,22,35,39,46,85,13,3,16,16,32,28,0,11,90,104
2014,2,21400843,2/25/2015,1610612742,Dallas Mavericks,0,0,1610612737,Atlanta Hawks,1,1,29,20,49,5,26,31,34,46,80,14,4,18,16,31,20,7,16,89,87
2015,2,21501072,3/24/2016,1610612746,LA Clippers,1,1,1610612757,Portland Trail Blazers,0,0,33,30,63,4,15,19,37,45,82,18,10,28,14,36,21,10,16,99,96
2015,2,21501072,3/24/2016,1610612757,Portland Trail Blazers,0,0,1610612746,LA Clippers,1,1,26,30,56,6,18,24,32,48,80,24,8,32,13,39,18,9,16,98,94
2018,2,21801053,3/18/2019,1610612752,New York Knicks,0,0,1610612761,Toronto Raptors,1,1,20,30,50,8,27,35,28,57,85,28,4,32,11,47,16,5,14,103,92
2018,2,21801053,3/18/2019,1610612761,Toronto Raptors,1,1,1610612752,New York Knicks,0,0,32,16,48,17,23,40,49,39,88,13,9,22,9,32,36,8,15,102,128
2018,2,21800493,12/23/2018,1610612750,Minnesota Timberwolves,0,1,1610612760,Oklahoma City Thunder,1,0,27,29,56,14,13,27,41,42,83,18,9,27,9,38,25,4,17,102,114
2018,2,21800493,12/23/2018,1610612760,Oklahoma City Thunder,1,0,1610612750,Minnesota Timberwolves,0,1,34,31,65,9,16,25,43,47,90,17,5,22,13,36,17,9,14,102,112
2018,2,21800134,11/4/2018,1610612751,Brooklyn Nets,1,1,1610612755,Philadelphia 76ers,0,0,41,36,77,9,19,28,50,55,105,13,5,18,20,38,27,6,9,103,122
2018,2,21800134,11/4/2018,1610612755,Philadelphia 76ers,0,0,1610612751,Brooklyn Nets,1,1,27,18,45,4,16,20,31,34,65,31,10,41,10,26,16,11,28,102,97
2018,2,21800089,10/29/2018,1610612748,Miami Heat,1,0,1610612758,Sacramento Kings,0,1,25,28,53,13,26,39,38,54,92,24,10,34,18,40,20,8,18,108,113
2018,2,21800089,10/29/2018,1610612758,Sacramento Kings,0,1,1610612748,Miami Heat,1,0,36,35,71,12,14,26,48,49,97,15,10,25,14,40,28,10,14,108,123
2016,2,21601190,4/8/2017,1610612753,Orlando Magic,1,0,1610612754,Indiana Pacers,0,1,27,27,54,14,16,30,41,43,84,16,6,22,7,39,29,6,13,100,112
2016,2,21601190,4/8/2017,1610612754,Indiana Pacers,0,1,1610612753,Orlando Magic,1,0,40,24,64,11,11,22,51,35,86,14,5,19,8,30,35,10,15,100,127
2023,2,22300950,3/13/2024,1610612763,Memphis Grizzlies,1,0,1610612766,Charlotte Hornets,0,1,20,25,45,16,24,40,36,49,85,10,1,11,18,31,24,12,24,97,98
2019,2,21901315,8/14/2020,1610612745,Houston Rockets,1,0,1610612755,Philadelphia 76ers,0,1,23,9,32,12,36,48,35,45,80,14,2,16,2,44,25,8,17,103,96
2019,2,21901315,8/14/2020,1610612755,Philadelphia 76ers,0,1,1610612745,Houston Rockets,1,0,31,18,49,18,20,38,49,38,87,18,4,22,12,28,31,10,16,103,134
2019,2,21901298,8/11/2020,1610612745,Houston Rockets,0,0,1610612759,San Antonio Spurs,1,1,22,19,41,14,34,48,36,53,89,19,2,21,5,50,18,10,18,113,105
2019,2,21901298,8/11/2020,1610612759,San Antonio Spurs,1,1,1610612745,Houston Rockets,0,0,33,28,61,13,19,32,46,47,93,18,2,20,12,37,28,14,22,113,123
2019,2,21901272,8/6/2020,1610612743,Denver Nuggets,1,0,1610612757,Portland Trail Blazers,0,1,30,26,56,14,14,28,44,40,84,13,4,17,14,29,30,7,16,95,115
2019,2,21901272,8/6/2020,1610612757,Portland Trail Blazers,0,1,1610612743,Denver Nuggets,1,0,20,33,53,23,16,39,43,49,92,16,4,20,16,34,30,5,9,94,125
2019,2,21901257,8/4/2020,1610612742,Dallas Mavericks,0,1,1610612758,Sacramento Kings,1,0,24,25,49,9,32,41,33,57,90,39,11,50,22,41,22,8,17,106,114
2019,2,21901257,8/4/2020,1610612758,Sacramento Kings,1,0,1610612742,Dallas Mavericks,0,1,27,34,61,16,27,43,43,61,104,8,4,12,17,46,26,4,11,109,110
2019,2,21900971,3/11/2020,1610612755,Philadelphia 76ers,1,1,1610612765,Detroit Pistons,0,0,28,22,50,14,19,33,42,41,83,26,6,32,18,27,28,10,14,95,124
2019,2,21900971,3/11/2020,1610612765,Detroit Pistons,0,0,1610612755,Philadelphia 76ers,1,1,28,21,49,11,24,35,39,45,84,17,8,25,11,39,25,7,9,95,106
2019,2,21900902,3/2/2020,1610612739,Cleveland Cavaliers,1,0,1610612762,Utah Jazz,0,1,25,25,50,17,24,41,42,49,91,12,6,18,12,40,28,3,7,94,113
2019,2,21900902,3/2/2020,1610612762,Utah Jazz,0,1,1610612739,Cleveland Cavaliers,1,0,27,15,42,20,21,41,47,36,83,12,2,14,10,26,30,10,15,96,126
2019,2,21900864,2/26/2020,1610612752,New York Knicks,0,0,1610612766,Charlotte Hornets,1,1,39,31,70,4,11,15,43,42,85,11,6,17,16,28,22,7,15,94,101
2019,2,21900864,2/26/2020,1610612766,Charlotte Hornets,1,1,1610612752,New York Knicks,0,0,29,24,53,10,20,30,39,44,83,19,6,25,15,32,25,5,14,93,107
2020,2,22000053,12/29/2020,1610612740,New Orleans Pelicans,0,0,1610612756,Phoenix Suns,1,1,34,19,53,3,21,24,37,40,77,9,9,18,12,31,18,7,18,92,86
2020,2,22000053,12/29/2020,1610612756,Phoenix Suns,1,1,1610612740,New Orleans Pelicans,0,0,18,19,37,19,28,47,37,47,84,18,1,19,13,34,24,8,12,92,111
2018,2,21800916,2/27/2019,1610612741,Chicago Bulls,0,1,1610612763,Memphis Grizzlies,1,0,31,27,58,8,16,24,39,43,82,23,2,25,9,35,20,7,15,102,109
2018,2,21800916,2/27/2019,1610612763,Memphis Grizzlies,1,0,1610612741,Chicago Bulls,0,1,32,35,67,9,18,27,41,53,94,16,2,18,17,37,25,12,16,101,107
2018,2,21800811,2/7/2019,1610612746,LA Clippers,0,0,1610612754,Indiana Pacers,1,1,31,37,68,6,11,17,37,48,85,12,7,19,15,37,23,15,21,100,92
2018,2,21800811,2/7/2019,1610612754,Indiana Pacers,1,1,1610612746,LA Clippers,0,0,40,25,65,9,13,22,49,38,87,9,2,11,9,30,26,14,19,100,116
2019,2,21900076,11/1/2019,1610612744,Golden State Warriors,1,0,1610612759,San Antonio Spurs,0,1,26,30,56,13,15,28,39,45,84,19,2,21,8,38,25,4,11,98,110
2019,2,21900076,11/1/2019,1610612759,San Antonio Spurs,0,1,1610612744,Golden State Warriors,1,0,31,27,58,13,22,35,44,49,93,26,4,30,18,34,23,4,11,97,127
2018,2,21800568,1/4/2019,1610612748,Miami Heat,1,1,1610612764,Washington Wizards,0,0,35,27,62,9,20,29,44,47,91,18,7,25,18,33,28,8,17,101,115
2018,2,21800568,1/4/2019,1610612764,Washington Wizards,0,0,1610612748,Miami Heat,1,1,32,30,62,10,26,36,42,56,98,15,4,19,17,41,24,7,12,103,109
2016,2,21600631,1/18/2017,1610612740,New Orleans Pelicans,1,1,1610612753,Orlando Magic,0,0,31,26,57,15,21,36,46,47,93,11,4,15,9,44,28,6,9,102,118
2016,2,21600631,1/18/2017,1610612753,Orlando Magic,0,0,1610612740,New Orleans Pelicans,1,1,28,28,56,11,21,32,39,49,88,9,2,11,9,40,18,11,18,103,98
2016,2,21600169,11/17/2016,1610612752,New York Knicks,0,0,1610612764,Washington Wizards,1,1,29,28,57,12,17,29,41,45,86,18,2,20,15,32,23,7,16,97,112
2020,2,22000052,12/29/2020,1610612753,Orlando Magic,0,1,1610612760,Oklahoma City Thunder,1,0,42,32,74,7,15,22,49,47,96,13,3,16,12,37,26,3,11,101,118
2020,2,22000052,12/29/2020,1610612760,Oklahoma City Thunder,1,0,1610612753,Orlando Magic,0,1,32,21,53,11,23,34,43,44,87,10,9,19,13,35,20,12,20,102,107
2016,2,21600169,11/17/2016,1610612764,Washington Wizards,1,1,1610612752,New York Knicks,0,0,29,27,56,15,10,25,44,37,81,16,2,18,10,29,26,9,16,97,119
2014,2,21400842,2/25/2015,1610612748,Miami Heat,0,1,1610612753,Orlando Magic,1,0,26,27,53,6,25,31,32,52,84,23,9,32,16,40,17,4,14,98,93
2014,2,21400842,2/25/2015,1610612753,Orlando Magic,1,0,1610612748,Miami Heat,0,1,27,29,56,6,16,22,33,45,78,18,13,31,14,38,17,8,19,98,90
2018,2,21801199,4/7/2019,1610612751,Brooklyn Nets,0,1,1610612754,Indiana Pacers,1,0,29,23,52,11,25,36,40,48,88,17,5,22,18,34,23,6,16,95,108
2015,2,21500162,11/17/2015,1610612752,New York Knicks,1,1,1610612766,Charlotte Hornets,0,0,26,43,69,10,10,20,36,53,89,20,1,21,17,37,22,7,11,92,102
2015,2,21500162,11/17/2015,1610612766,Charlotte Hornets,0,0,1610612752,New York Knicks,1,1,31,31,62,5,15,20,36,46,82,17,8,25,10,39,13,4,7,92,94
2020,2,22000051,12/29/2020,1610612748,Miami Heat,1,0,1610612749,Milwaukee Bucks,0,1,26,16,42,11,26,37,37,42,79,12,6,18,8,37,23,14,22,101,97
2020,2,22000051,12/29/2020,1610612749,Milwaukee Bucks,0,1,1610612748,Miami Heat,1,0,22,19,41,29,22,51,51,41,92,13,2,15,14,28,32,9,17,101,144
2018,2,21801199,4/7/2019,1610612754,Indiana Pacers,1,0,1610612751,Brooklyn Nets,0,1,31,27,58,10,17,27,41,44,85,4,3,7,6,40,27,7,13,96,96
2020,2,22000941,4/28/2021,1610612746,LA Clippers,0,0,1610612756,Phoenix Suns,1,1,29,20,49,12,19,31,41,39,80,7,2,9,10,30,24,9,15,89,101
2020,2,22000941,4/28/2021,1610612756,Phoenix Suns,1,1,1610612746,LA Clippers,0,0,30,24,54,13,24,37,43,48,91,10,3,13,17,32,23,8,10,89,109
2016,2,21601189,4/8/2017,1610612738,Boston Celtics,0,1,1610612766,Charlotte Hornets,1,0,28,20,48,17,22,39,45,42,87,14,3,17,6,38,35,5,9,97,121
2016,2,21601189,4/8/2017,1610612766,Charlotte Hornets,1,0,1610612738,Boston Celtics,0,1,29,27,56,9,19,28,38,46,84,29,3,32,8,39,22,2,7,98,114
2016,2,21600630,1/18/2017,1610612738,Boston Celtics,1,0,1610612752,New York Knicks,0,1,26,32,58,9,24,33,35,56,91,27,2,29,15,42,25,2,3,96,106
2016,2,21600630,1/18/2017,1610612752,New York Knicks,0,1,1610612738,Boston Celtics,1,0,36,30,66,10,15,25,46,45,91,15,3,18,20,26,27,8,16,95,117
2016,2,21600168,11/16/2016,1610612758,Sacramento Kings,1,0,1610612759,San Antonio Spurs,0,1,27,29,56,9,11,20,36,40,76,24,7,31,11,30,21,11,17,97,105
2016,2,21600168,11/16/2016,1610612759,San Antonio Spurs,0,1,1610612758,Sacramento Kings,1,0,32,26,58,11,19,30,43,45,88,13,4,17,10,37,29,5,11,97,110
2020,2,22000050,12/29/2020,1610612741,Chicago Bulls,0,1,1610612764,Washington Wizards,1,0,23,28,51,15,21,36,38,49,87,24,8,32,9,43,26,6,14,107,115
2020,2,22000050,12/29/2020,1610612764,Washington Wizards,1,0,1610612741,Chicago Bulls,0,1,27,20,47,10,27,37,37,47,84,23,3,26,10,39,25,7,21,107,107
2019,2,21900304,12/3/2019,1610612743,Denver Nuggets,1,0,1610612747,Los Angeles Lakers,0,1,31,31,62,6,23,29,37,54,91,16,1,17,10,45,26,8,11,99,96
2019,2,21900304,12/3/2019,1610612747,Los Angeles Lakers,0,1,1610612743,Denver Nuggets,1,0,32,28,60,7,17,24,39,45,84,20,10,30,16,32,24,9,16,98,105
2018,2,21800915,2/27/2019,1610612744,Golden State Warriors,0,0,1610612748,Miami Heat,1,1,27,14,41,17,31,48,44,45,89,20,8,28,12,37,21,4,10,100,125
2018,2,21800915,2/27/2019,1610612748,Miami Heat,1,1,1610612744,Golden State Warriors,0,0,24,18,42,18,23,41,42,41,83,24,6,30,13,30,20,7,14,100,126
2018,2,21800810,2/6/2019,1610612744,Golden State Warriors,1,1,1610612759,San Antonio Spurs,0,0,39,22,61,16,18,34,55,40,95,15,6,21,15,27,42,6,12,102,141
2018,2,21800810,2/6/2019,1610612759,San Antonio Spurs,0,0,1610612744,Golden State Warriors,1,1,23,26,49,12,20,32,35,46,81,20,1,21,7,39,24,14,18,103,102
2018,2,21800719,1/24/2019,1610612747,Los Angeles Lakers,1,0,1610612750,Minnesota Timberwolves,0,1,36,23,59,8,20,28,44,43,87,9,5,14,12,34,28,8,19,102,105
2018,2,21800719,1/24/2019,1610612750,Minnesota Timberwolves,0,1,1610612747,Los Angeles Lakers,1,0,34,35,69,10,23,33,44,58,102,22,3,25,27,32,24,5,15,102,120
2016,2,21601188,4/8/2017,1610612741,Chicago Bulls,0,0,1610612751,Brooklyn Nets,1,1,29,37,66,11,13,24,40,50,90,15,2,17,12,38,14,15,17,103,106
2016,2,21601188,4/8/2017,1610612751,Brooklyn Nets,1,1,1610612741,Chicago Bulls,0,0,29,32,61,10,21,31,39,53,92,19,5,24,12,45,24,6,13,103,107
2020,2,22000049,12/29/2020,1610612755,Philadelphia 76ers,1,1,1610612761,Toronto Raptors,0,0,24,29,53,8,23,31,32,52,84,28,5,33,17,37,21,12,20,102,100
2020,2,22000049,12/29/2020,1610612761,Toronto Raptors,0,0,1610612755,Philadelphia 76ers,1,1,15,30,45,17,28,45,32,58,90,12,2,14,13,46,21,10,20,103,93
2019,2,21900931,3/6/2020,1610612751,Brooklyn Nets,1,1,1610612759,San Antonio Spurs,0,0,36,24,60,15,21,36,51,45,96,22,9,31,12,37,32,3,8,107,139
2019,2,21900931,3/6/2020,1610612759,San Antonio Spurs,0,0,1610612751,Brooklyn Nets,1,1,33,25,58,10,24,34,43,49,92,24,3,27,4,46,25,1,6,107,120
2019,2,21900917,3/4/2020,1610612738,Boston Celtics,0,1,1610612739,Cleveland Cavaliers,1,0,29,27,56,11,19,30,40,46,86,21,5,26,15,34,16,6,11,94,112
2019,2,21900917,3/4/2020,1610612739,Cleveland Cavaliers,1,0,1610612738,Boston Celtics,0,1,26,25,51,13,25,38,39,50,89,15,5,20,18,36,24,10,13,95,106
2019,2,21900863,2/25/2020,1610612744,Golden State Warriors,1,0,1610612758,Sacramento Kings,0,1,31,20,51,4,24,28,35,44,79,20,4,24,9,38,21,7,17,98,94
2019,2,21900863,2/25/2020,1610612758,Sacramento Kings,0,1,1610612744,Golden State Warriors,1,0,27,19,46,13,17,30,40,36,76,19,15,34,7,35,25,7,10,98,112
2019,2,21900840,2/22/2020,1610612749,Milwaukee Bucks,1,1,1610612755,Philadelphia 76ers,0,0,34,16,50,14,27,41,48,43,91,9,4,13,11,34,35,10,17,105,119
2019,2,21900840,2/22/2020,1610612755,Philadelphia 76ers,0,0,1610612749,Milwaukee Bucks,1,1,22,39,61,13,25,38,35,64,99,15,3,18,15,50,17,2,12,104,98
2019,2,21900797,2/10/2020,1610612749,Milwaukee Bucks,1,1,1610612758,Sacramento Kings,0,0,25,29,54,18,24,42,43,53,96,19,4,23,12,42,26,6,13,109,123
2019,2,21900797,2/10/2020,1610612758,Sacramento Kings,0,0,1610612749,Milwaukee Bucks,1,1,28,30,58,14,29,43,42,59,101,13,5,18,14,49,23,7,13,110,111
2019,2,21900743,2/3/2020,1610612742,Dallas Mavericks,0,1,1610612754,Indiana Pacers,1,0,18,23,41,18,27,45,36,50,86,22,1,23,15,36,20,7,12,95,112
2019,2,21900743,2/3/2020,1610612754,Indiana Pacers,1,0,1610612742,Dallas Mavericks,0,1,37,25,62,7,27,34,44,52,96,8,3,11,11,43,28,3,4,94,103
2019,2,21900723,1/31/2020,1610612740,New Orleans Pelicans,1,1,1610612763,Memphis Grizzlies,0,0,36,25,61,15,19,34,51,44,95,22,4,26,21,25,30,10,19,106,139
2019,2,21900723,1/31/2020,1610612763,Memphis Grizzlies,0,0,1610612740,New Orleans Pelicans,1,1,39,26,65,6,25,31,45,51,96,15,11,26,13,44,17,8,11,106,111
2019,2,21900712,1/29/2020,1610612745,Houston Rockets,0,0,1610612757,Portland Trail Blazers,1,1,23,24,47,17,30,47,40,54,94,15,3,18,13,43,21,8,15,107,112
2019,2,21900712,1/29/2020,1610612757,Portland Trail Blazers,1,1,1610612745,Houston Rockets,0,0,33,20,53,13,23,36,46,43,89,20,7,27,14,33,24,8,19,106,125
2019,2,21900694,1/27/2020,1610612748,Miami Heat,1,1,1610612753,Orlando Magic,0,0,28,23,51,14,14,28,42,37,79,15,1,16,6,32,31,7,12,90,113
2019,2,21900694,1/27/2020,1610612753,Orlando Magic,0,0,1610612748,Miami Heat,1,1,22,30,52,11,26,37,33,56,89,15,4,19,15,43,23,2,7,91,92
2019,2,21900688,1/26/2020,1610612751,Brooklyn Nets,0,0,1610612752,New York Knicks,1,1,21,21,42,13,26,39,34,47,81,16,7,23,13,38,21,7,16,97,97
2019,2,21900688,1/26/2020,1610612752,New York Knicks,1,1,1610612751,Brooklyn Nets,0,0,43,30,73,6,13,19,49,43,92,6,7,13,17,30,19,6,15,96,110
2018,2,21801052,3/18/2019,1610612738,Boston Celtics,1,0,1610612743,Denver Nuggets,0,1,27,27,54,12,27,39,39,54,93,15,4,19,16,40,24,6,13,99,105
2018,2,21801052,3/18/2019,1610612743,Denver Nuggets,0,1,1610612738,Boston Celtics,1,0,32,23,55,14,25,39,46,48,94,8,2,10,19,30,29,12,19,99,114
2019,2,21900075,11/1/2019,1610612758,Sacramento Kings,1,1,1610612762,Utah Jazz,0,0,33,22,55,8,21,29,41,43,84,12,5,17,13,33,15,12,17,94,102
2019,2,21900075,11/1/2019,1610612762,Utah Jazz,0,0,1610612758,Sacramento Kings,1,1,24,21,45,11,17,28,35,38,73,20,7,27,10,30,18,8,17,93,101
2018,2,21800567,1/4/2019,1610612739,Cleveland Cavaliers,1,0,1610612762,Utah Jazz,0,1,21,40,61,11,10,21,32,50,82,16,1,17,9,41,14,6,13,94,91
2018,2,21800567,1/4/2019,1610612762,Utah Jazz,0,1,1610612739,Cleveland Cavaliers,1,0,28,19,47,14,21,35,42,40,82,19,3,22,9,33,28,6,11,93,117
2018,2,21800422,12/14/2018,1610612751,Brooklyn Nets,1,1,1610612764,Washington Wizards,0,0,33,20,53,11,20,31,44,40,84,26,5,31,12,29,34,3,10,96,125
2018,2,21800422,12/14/2018,1610612764,Washington Wizards,0,0,1610612751,Brooklyn Nets,1,1,38,23,61,11,18,29,49,41,90,9,7,16,8,39,30,5,9,97,118
2016,2,21600629,1/18/2017,1610612757,Portland Trail Blazers,0,0,1610612766,Charlotte Hornets,1,1,25,38,63,8,23,31,33,61,94,11,0,11,17,44,18,11,16,99,85
2016,2,21600629,1/18/2017,1610612766,Charlotte Hornets,1,1,1610612757,Portland Trail Blazers,0,0,30,31,61,11,15,26,41,46,87,14,3,17,10,36,28,10,12,97,107
2016,2,21600167,11/16/2016,1610612746,LA Clippers,1,0,1610612763,Memphis Grizzlies,0,1,28,28,56,9,16,25,37,44,81,24,10,34,11,36,15,6,8,95,107
2016,2,21600167,11/16/2016,1610612763,Memphis Grizzlies,0,1,1610612746,LA Clippers,1,0,25,31,56,15,11,26,40,42,82,16,3,19,15,28,24,13,17,93,111
2014,2,21400841,2/24/2015,1610612742,Dallas Mavericks,1,1,1610612761,Toronto Raptors,0,0,30,30,60,8,11,19,38,41,79,15,3,18,11,32,17,10,20,97,99
2019,2,21901314,8/13/2020,1610612759,San Antonio Spurs,0,0,1610612762,Utah Jazz,1,1,29,30,59,10,10,20,39,40,79,24,12,36,11,36,24,7,15,100,112
2019,2,21901314,8/13/2020,1610612762,Utah Jazz,1,1,1610612759,San Antonio Spurs,0,0,32,23,55,15,31,46,47,54,101,9,1,10,16,38,25,4,9,101,118
2019,2,21901297,8/11/2020,1610612751,Brooklyn Nets,0,1,1610612753,Orlando Magic,1,0,25,21,46,13,30,43,38,51,89,19,5,24,13,40,26,9,15,101,108
2019,2,21901297,8/11/2020,1610612753,Orlando Magic,1,0,1610612751,Brooklyn Nets,0,1,25,35,60,7,16,23,32,51,83,25,4,29,14,39,13,9,17,101,96
2020,2,22000048,12/29/2020,1610612738,Boston Celtics,0,1,1610612754,Indiana Pacers,1,0,31,27,58,9,13,22,40,40,80,27,10,37,12,32,21,9,14,100,116
2020,2,22000048,12/29/2020,1610612754,Indiana Pacers,1,0,1610612738,Boston Celtics,0,1,31,20,51,12,21,33,43,41,84,13,3,16,8,34,27,10,15,101,111
2018,2,21801198,4/7/2019,1610612765,Detroit Pistons,1,0,1610612766,Charlotte Hornets,0,1,24,27,51,10,31,41,34,58,92,13,2,15,20,39,20,5,9,89,91
2018,2,21801198,4/7/2019,1610612766,Charlotte Hornets,0,1,1610612765,Detroit Pistons,1,0,28,29,57,10,21,31,38,50,88,18,5,23,16,38,23,3,7,89,104
2018,2,21801051,3/18/2019,1610612762,Utah Jazz,0,1,1610612764,Washington Wizards,1,0,35,19,54,14,23,37,49,42,91,4,2,6,11,32,35,9,17,99,116
2018,2,21801051,3/18/2019,1610612764,Washington Wizards,1,0,1610612762,Utah Jazz,0,1,26,28,54,8,19,27,34,47,81,19,3,22,9,40,20,10,16,99,95
2018,2,21800492,12/23/2018,1610612740,New Orleans Pelicans,0,0,1610612758,Sacramento Kings,1,1,38,30,68,6,20,26,44,50,94,23,5,28,13,40,26,9,13,107,117
2018,2,21800492,12/23/2018,1610612758,Sacramento Kings,1,1,1610612740,New Orleans Pelicans,0,0,28,41,69,14,17,31,42,58,100,24,9,33,17,48,26,6,9,108,122
2018,2,21800190,11/12/2018,1610612753,Orlando Magic,0,0,1610612764,Washington Wizards,1,1,28,31,59,15,15,30,43,46,89,8,3,11,13,35,28,8,13,94,109
2018,2,21800190,11/12/2018,1610612764,Washington Wizards,1,1,1610612753,Orlando Magic,0,0,27,19,46,13,20,33,40,39,79,24,9,33,13,28,24,5,12,95,117
2018,2,21800135,11/4/2018,1610612752,New York Knicks,0,0,1610612764,Washington Wizards,1,1,34,32,66,5,22,27,39,54,93,12,4,16,20,35,19,12,20,99,95
2018,2,21800135,11/4/2018,1610612764,Washington Wizards,1,1,1610612752,New York Knicks,0,0,30,27,57,6,20,26,36,47,83,30,9,39,17,38,21,5,13,97,108
2016,2,21601187,4/7/2017,1610612747,Los Angeles Lakers,1,1,1610612758,Sacramento Kings,0,0,34,28,62,4,20,24,38,48,86,18,7,25,19,33,20,5,14,93,98
2016,2,21601187,4/7/2017,1610612758,Sacramento Kings,0,0,1610612747,Los Angeles Lakers,1,1,30,25,55,8,12,20,38,37,75,10,3,13,12,26,27,12,23,93,94
2014,2,21400841,2/24/2015,1610612761,Toronto Raptors,0,0,1610612742,Dallas Mavericks,1,1,29,29,58,9,17,26,38,46,84,7,4,11,11,36,17,13,19,97,92
2018,2,21800914,2/27/2019,1610612751,Brooklyn Nets,1,0,1610612764,Washington Wizards,0,1,31,19,50,8,27,35,39,46,85,30,9,39,10,42,20,10,16,108,116
2018,2,21800914,2/27/2019,1610612764,Washington Wizards,0,1,1610612751,Brooklyn Nets,1,0,33,26,59,11,26,37,44,52,96,26,5,31,20,36,34,7,19,108,125
2018,2,21800718,1/24/2019,1610612756,Phoenix Suns,1,0,1610612757,Portland Trail Blazers,0,1,23,27,50,13,25,38,36,52,88,21,6,27,15,41,19,8,16,102,106
2018,2,21800718,1/24/2019,1610612757,Portland Trail Blazers,0,1,1610612756,Phoenix Suns,1,0,32,36,68,12,14,26,44,50,94,20,0,20,18,32,25,9,17,103,120
2018,2,21800644,1/13/2019,1610612739,Cleveland Cavaliers,0,1,1610612747,Los Angeles Lakers,1,0,30,38,68,8,13,21,38,51,89,17,6,23,16,39,18,4,13,99,101
2018,2,21800644,1/13/2019,1610612747,Los Angeles Lakers,1,0,1610612739,Cleveland Cavaliers,0,1,29,28,57,7,27,34,36,55,91,16,11,27,16,44,21,5,11,99,95
2018,2,21800298,11/26/2018,1610612738,Boston Celtics,0,1,1610612740,New Orleans Pelicans,1,0,29,29,58,19,20,39,48,49,97,9,1,10,18,32,27,8,15,99,124
2018,2,21800298,11/26/2018,1610612740,New Orleans Pelicans,1,0,1610612738,Boston Celtics,0,1,22,23,45,12,20,32,34,43,77,27,2,29,15,29,21,14,22,99,107
2018,2,21800243,11/19/2018,1610612737,Atlanta Hawks,1,0,1610612746,LA Clippers,0,1,33,30,63,12,26,38,45,56,101,17,2,19,17,39,29,9,16,108,119
2018,2,21800243,11/19/2018,1610612746,LA Clippers,0,1,1610612737,Atlanta Hawks,1,0,30,30,60,10,23,33,40,53,93,37,10,47,21,38,24,6,15,109,127
2016,2,21600628,1/18/2017,1610612763,Memphis Grizzlies,0,0,1610612764,Washington Wizards,1,1,25,33,58,8,17,25,33,50,83,27,7,34,20,33,20,7,12,91,101
2016,2,21600628,1/18/2017,1610612764,Washington Wizards,1,1,1610612763,Memphis Grizzlies,0,0,28,23,51,8,21,29,36,44,80,24,2,26,14,30,27,8,12,91,104
2019,2,21901242,8/1/2020,1610612754,Indiana Pacers,1,1,1610612755,Philadelphia 76ers,0,0,34,27,61,14,20,34,48,47,95,17,6,23,13,38,31,6,10,104,127
2019,2,21901242,8/1/2020,1610612755,Philadelphia 76ers,0,0,1610612754,Indiana Pacers,1,1,37,31,68,9,16,25,46,47,93,20,5,25,21,27,20,8,21,104,121
2019,2,21900956,3/8/2020,1610612758,Sacramento Kings,1,0,1610612761,Toronto Raptors,0,1,34,25,59,8,23,31,42,48,90,21,2,23,12,38,24,10,11,99,113
2019,2,21900956,3/8/2020,1610612761,Toronto Raptors,0,1,1610612758,Sacramento Kings,1,0,20,14,34,19,29,48,39,43,82,21,6,27,5,41,27,5,9,99,118
2019,2,21900943,3/7/2020,1610612737,Atlanta Hawks,0,0,1610612763,Memphis Grizzlies,1,1,19,27,46,13,36,49,32,63,95,24,4,28,16,48,23,9,14,106,101
2019,2,21900943,3/7/2020,1610612763,Memphis Grizzlies,1,1,1610612737,Atlanta Hawks,0,0,31,23,54,12,21,33,43,44,87,20,13,33,16,34,27,9,17,106,118
2019,2,21900901,3/1/2020,1610612744,Golden State Warriors,1,0,1610612764,Washington Wizards,0,1,33,28,61,9,19,28,42,47,89,17,7,24,18,32,25,10,22,103,110
2019,2,21900901,3/1/2020,1610612764,Washington Wizards,0,1,1610612744,Golden State Warriors,1,0,20,32,52,20,10,30,40,42,82,24,3,27,6,36,24,7,13,103,124
2019,2,21900883,2/28/2020,1610612739,Cleveland Cavaliers,0,0,1610612740,New Orleans Pelicans,1,1,32,32,64,11,20,31,43,52,95,7,5,12,15,40,27,12,14,99,104
2019,2,21900883,2/28/2020,1610612740,New Orleans Pelicans,1,1,1610612739,Cleveland Cavaliers,0,0,39,26,65,9,14,23,48,40,88,11,4,15,15,26,36,7,17,100,116
2019,2,21900862,2/25/2020,1610612738,Boston Celtics,0,1,1610612757,Portland Trail Blazers,1,0,24,27,51,19,20,39,43,47,90,13,1,14,10,37,19,8,14,103,118
2019,2,21900862,2/25/2020,1610612757,Portland Trail Blazers,1,0,1610612738,Boston Celtics,0,1,25,29,54,13,18,31,38,47,85,17,6,23,10,41,24,6,17,102,106
2019,2,21900817,2/12/2020,1610612743,Denver Nuggets,1,0,1610612747,Los Angeles Lakers,0,1,33,30,63,11,14,25,44,44,88,17,5,22,7,39,32,8,12,104,116
2019,2,21900817,2/12/2020,1610612747,Los Angeles Lakers,0,1,1610612743,Denver Nuggets,1,0,35,25,60,12,21,33,47,46,93,14,13,27,14,40,29,9,12,105,120
2020,2,22000047,12/29/2020,1610612744,Golden State Warriors,0,1,1610612765,Detroit Pistons,1,0,24,19,43,14,19,33,38,38,76,26,10,36,14,31,21,8,19,100,116
2020,2,22000047,12/29/2020,1610612765,Detroit Pistons,1,0,1610612744,Golden State Warriors,0,1,22,35,57,13,22,35,35,57,92,23,6,29,22,41,21,8,15,100,106
2019,2,21900303,12/3/2019,1610612745,Houston Rockets,0,0,1610612759,San Antonio Spurs,1,1,27,33,60,15,36,51,42,69,111,34,2,36,23,48,22,10,17,122,133
2019,2,21900303,12/3/2019,1610612759,San Antonio Spurs,1,1,1610612745,Houston Rockets,0,0,37,39,76,13,17,30,50,56,106,22,10,32,19,43,35,11,21,122,135
2019,2,21900074,11/1/2019,1610612742,Dallas Mavericks,1,0,1610612747,Los Angeles Lakers,0,1,26,40,66,14,22,36,40,62,102,16,7,23,26,40,23,11,23,110,110
2019,2,21900074,11/1/2019,1610612747,Los Angeles Lakers,0,1,1610612742,Dallas Mavericks,1,0,38,26,64,9,23,32,47,49,96,16,5,21,8,44,24,5,11,110,119
2016,2,21600166,11/16/2016,1610612743,Denver Nuggets,1,1,1610612756,Phoenix Suns,0,0,37,39,76,8,9,17,45,48,93,22,2,24,19,31,23,8,14,97,120
2016,2,21600166,11/16/2016,1610612756,Phoenix Suns,0,0,1610612743,Denver Nuggets,1,1,31,28,59,8,12,20,39,40,79,18,11,29,11,36,14,8,16,98,104
2014,2,21400840,2/24/2015,1610612754,Indiana Pacers,0,0,1610612760,Oklahoma City Thunder,1,1,29,33,62,9,17,26,38,50,88,7,4,11,10,43,26,10,14,97,92
2014,2,21400840,2/24/2015,1610612760,Oklahoma City Thunder,1,1,1610612754,Indiana Pacers,0,0,31,41,72,9,15,24,40,56,96,16,2,18,17,40,23,5,10,98,105
2020,2,22000046,12/29/2020,1610612739,Cleveland Cavaliers,1,0,1610612752,New York Knicks,0,1,25,31,56,7,25,32,32,56,88,15,7,22,15,43,22,9,13,98,86
2020,2,22000046,12/29/2020,1610612752,New York Knicks,0,1,1610612739,Cleveland Cavaliers,1,0,20,34,54,14,11,25,34,45,79,13,8,21,18,30,23,13,27,99,95
2019,2,21900302,12/3/2019,1610612740,New Orleans Pelicans,1,0,1610612742,Dallas Mavericks,0,1,27,26,53,11,30,41,38,56,94,10,5,15,14,45,20,5,11,100,97
2019,2,21900302,12/3/2019,1610612742,Dallas Mavericks,0,1,1610612740,New Orleans Pelicans,1,0,19,24,43,19,26,45,38,50,88,23,4,27,13,40,22,4,12,100,118
2018,2,21800809,2/6/2019,1610612745,Houston Rockets,0,1,1610612758,Sacramento Kings,1,0,25,24,49,20,31,51,45,55,100,17,1,18,20,35,17,5,12,102,127
2018,2,21800809,2/6/2019,1610612758,Sacramento Kings,1,0,1610612745,Houston Rockets,0,1,28,30,58,11,22,33,39,52,91,12,8,20,23,34,21,13,22,102,101
2018,2,21800421,12/14/2018,1610612752,New York Knicks,0,1,1610612766,Charlotte Hornets,1,0,35,29,64,12,22,34,47,51,98,20,11,31,15,42,27,7,10,110,126
2018,2,21800421,12/14/2018,1610612766,Charlotte Hornets,1,0,1610612752,New York Knicks,0,1,28,26,54,20,28,48,48,54,102,8,2,10,14,41,38,11,16,111,124
2018,2,21800356,12/5/2018,1610612743,Denver Nuggets,0,1,1610612753,Orlando Magic,1,0,34,29,63,11,8,19,45,37,82,23,14,37,7,36,34,4,10,103,124
2018,2,21800356,12/5/2018,1610612753,Orlando Magic,1,0,1610612743,Denver Nuggets,0,1,25,21,46,20,29,49,45,50,95,8,0,8,9,41,30,5,10,102,118
2018,2,21800242,11/19/2018,1610612755,Philadelphia 76ers,1,1,1610612756,Phoenix Suns,0,0,35,27,62,6,16,22,41,43,84,31,11,42,18,30,24,9,19,105,119
2018,2,21800242,11/19/2018,1610612756,Phoenix Suns,0,0,1610612755,Philadelphia 76ers,1,1,31,23,54,13,20,33,44,43,87,13,11,24,6,43,25,8,13,104,114
2018,2,21800189,11/11/2018,1610612737,Atlanta Hawks,0,0,1610612747,Los Angeles Lakers,1,1,28,30,58,13,24,37,41,54,95,11,2,13,15,40,25,12,19,107,106
2018,2,21800189,11/11/2018,1610612747,Los Angeles Lakers,1,1,1610612737,Atlanta Hawks,0,0,25,29,54,14,24,38,39,53,92,15,9,24,21,35,28,11,23,105,107
2019,2,21901313,8/13/2020,1610612742,Dallas Mavericks,0,0,1610612756,Phoenix Suns,1,1,31,32,63,8,18,26,39,50,89,16,3,19,13,39,17,6,11,95,102
2019,2,21901313,8/13/2020,1610612756,Phoenix Suns,1,1,1610612742,Dallas Mavericks,0,0,35,20,55,14,20,34,49,40,89,16,5,21,10,33,34,3,6,96,128
2019,2,21901296,8/10/2020,1610612743,Denver Nuggets,0,0,1610612747,Los Angeles Lakers,1,1,32,22,54,13,10,23,45,32,77,18,5,23,14,21,27,8,14,90,121
2019,2,21901296,8/10/2020,1610612747,Los Angeles Lakers,1,1,1610612743,Denver Nuggets,0,0,30,22,52,14,15,29,44,37,81,22,10,32,16,26,28,6,10,90,124
2019,2,21901271,8/6/2020,1610612742,Dallas Mavericks,1,0,1610612746,LA Clippers,0,1,22,17,39,17,31,48,39,48,87,16,5,21,10,41,24,3,8,95,111
2019,2,21901271,8/6/2020,1610612746,LA Clippers,0,1,1610612742,Dallas Mavericks,1,0,36,25,61,14,17,31,50,42,92,12,3,15,13,30,22,3,8,96,126
2019,2,21901256,8/4/2020,1610612749,Milwaukee Bucks,1,0,1610612751,Brooklyn Nets,0,1,25,12,37,17,34,51,42,46,88,15,8,23,13,38,28,5,19,109,116
2019,2,21901256,8/4/2020,1610612751,Brooklyn Nets,0,1,1610612749,Milwaukee Bucks,1,0,22,24,46,21,36,57,43,60,103,12,4,16,10,52,30,3,7,107,119
2019,2,21900970,3/11/2020,1610612748,Miami Heat,1,0,1610612766,Charlotte Hornets,0,1,24,16,40,15,29,44,39,45,84,5,1,6,10,36,32,7,14,91,98
2019,2,21900970,3/11/2020,1610612766,Charlotte Hornets,0,1,1610612748,Miami Heat,1,0,20,28,48,17,17,34,37,45,82,18,4,22,18,28,20,8,14,92,109
2019,2,21900916,3/3/2020,1610612758,Sacramento Kings,1,1,1610612764,Washington Wizards,0,0,37,23,60,13,16,29,50,39,89,20,4,24,10,31,23,10,15,109,133
2019,2,21900916,3/3/2020,1610612764,Washington Wizards,0,0,1610612758,Sacramento Kings,1,1,25,17,42,16,22,38,41,39,80,28,6,34,4,37,28,13,14,109,126
2019,2,21900861,2/25/2020,1610612740,New Orleans Pelicans,0,0,1610612747,Los Angeles Lakers,1,1,31,28,59,8,19,27,39,47,86,23,7,30,10,39,31,10,20,110,109
2019,2,21900861,2/25/2020,1610612747,Los Angeles Lakers,1,1,1610612740,New Orleans Pelicans,0,0,32,26,58,13,31,44,45,57,102,15,6,21,18,43,27,10,16,111,118
2019,2,21900850,2/24/2020,1610612737,Atlanta Hawks,0,0,1610612755,Philadelphia 76ers,1,1,32,27,59,8,30,38,40,57,97,24,3,27,19,40,19,9,13,102,112
2019,2,21900850,2/24/2020,1610612755,Philadelphia 76ers,1,1,1610612737,Atlanta Hawks,0,0,33,25,58,12,18,30,45,43,88,27,3,30,12,32,27,5,12,101,129
2019,2,21900839,2/22/2020,1610612741,Chicago Bulls,1,0,1610612756,Phoenix Suns,0,1,22,23,45,14,24,38,36,47,83,18,3,21,16,32,18,10,26,102,104
2019,2,21900839,2/22/2020,1610612756,Phoenix Suns,0,1,1610612741,Chicago Bulls,1,0,28,28,56,10,20,30,38,48,86,26,5,31,19,31,26,11,21,102,112
2020,2,22000045,12/28/2020,1610612747,Los Angeles Lakers,1,0,1610612757,Portland Trail Blazers,0,1,31,29,60,10,17,27,41,46,87,15,3,18,9,39,20,9,15,98,107
2020,2,22000045,12/28/2020,1610612757,Portland Trail Blazers,0,1,1610612747,Los Angeles Lakers,1,0,27,19,46,16,30,46,43,49,92,13,2,15,12,39,27,6,10,98,115
2016,2,21601186,4/7/2017,1610612756,Phoenix Suns,1,1,1610612760,Oklahoma City Thunder,0,0,35,30,65,8,10,18,43,40,83,26,5,31,14,29,16,1,8,90,120
2016,2,21601186,4/7/2017,1610612760,Oklahoma City Thunder,0,0,1610612756,Phoenix Suns,1,1,27,35,62,7,23,30,34,58,92,24,9,33,27,36,13,6,10,88,99
2016,2,21600627,1/18/2017,1610612755,Philadelphia 76ers,1,1,1610612761,Toronto Raptors,0,0,23,22,45,8,16,24,31,38,69,24,8,32,10,32,20,10,22,97,94
2018,2,21801197,4/7/2019,1610612750,Minnesota Timberwolves,1,0,1610612760,Oklahoma City Thunder,0,1,36,26,62,10,13,23,46,39,85,24,5,29,9,34,29,6,13,102,126
2018,2,21801197,4/7/2019,1610612760,Oklahoma City Thunder,0,1,1610612750,Minnesota Timberwolves,1,0,34,24,58,14,20,34,48,44,92,22,4,26,16,29,27,9,14,101,132
2018,2,21801050,3/18/2019,1610612739,Cleveland Cavaliers,1,1,1610612765,Detroit Pistons,0,0,35,22,57,11,11,22,46,33,79,23,4,27,6,30,22,6,8,93,126
2018,2,21801050,3/18/2019,1610612765,Detroit Pistons,0,0,1610612739,Cleveland Cavaliers,1,1,24,26,50,18,26,44,42,52,94,17,4,21,23,32,24,6,12,93,119
2016,2,21600627,1/18/2017,1610612761,Toronto Raptors,0,0,1610612755,Philadelphia 76ers,1,1,28,34,62,6,18,24,34,52,86,15,8,23,14,44,17,5,11,96,89
2016,2,21600165,11/16/2016,1610612744,Golden State Warriors,0,1,1610612761,Toronto Raptors,1,0,31,20,51,13,23,36,44,43,87,26,2,28,9,34,33,8,12,102,127
2015,2,21501127,3/31/2016,1610612738,Boston Celtics,0,0,1610612757,Portland Trail Blazers,1,1,28,36,64,9,15,24,37,51,88,26,8,34,18,37,20,9,15,102,109
2019,2,21900942,3/7/2020,1610612739,Cleveland Cavaliers,1,1,1610612743,Denver Nuggets,0,0,30,18,48,12,16,28,42,34,76,8,4,12,10,26,32,15,22,94,104
2019,2,21900942,3/7/2020,1610612743,Denver Nuggets,0,0,1610612739,Cleveland Cavaliers,1,1,30,23,53,13,19,32,43,42,85,3,5,8,12,32,28,8,18,96,102
2019,2,21900930,3/6/2020,1610612737,Atlanta Hawks,0,0,1610612764,Washington Wizards,1,1,34,20,54,12,20,32,46,40,86,8,4,12,10,32,25,9,18,100,112
2019,2,21900930,3/6/2020,1610612764,Washington Wizards,1,1,1610612737,Atlanta Hawks,0,0,21,24,45,15,16,31,36,40,76,31,4,35,11,32,24,9,18,101,118
2019,2,21900900,3/1/2020,1610612740,New Orleans Pelicans,1,0,1610612747,Los Angeles Lakers,0,1,33,30,63,7,25,32,40,55,95,27,6,33,21,35,24,9,16,107,114
2019,2,21900900,3/1/2020,1610612747,Los Angeles Lakers,0,1,1610612740,New Orleans Pelicans,1,0,37,25,62,13,22,35,50,47,97,9,1,10,9,39,23,7,13,106,122
2016,2,21600165,11/16/2016,1610612761,Toronto Raptors,1,0,1610612744,Golden State Warriors,0,1,27,30,57,10,15,25,37,45,82,37,4,41,16,29,16,9,15,103,121
2019,2,21900301,12/3/2019,1610612748,Miami Heat,0,1,1610612761,Toronto Raptors,1,0,30,31,61,15,23,38,45,54,99,16,5,21,14,42,29,5,14,110,121
2019,2,21900301,12/3/2019,1610612761,Toronto Raptors,1,0,1610612748,Miami Heat,0,1,24,24,48,11,32,43,35,56,91,29,7,36,13,46,25,4,12,109,110
2019,2,21900073,11/1/2019,1610612741,Chicago Bulls,1,1,1610612765,Detroit Pistons,0,0,23,26,49,16,24,40,39,50,89,18,5,23,16,38,29,11,17,100,112
2019,2,21900073,11/1/2019,1610612765,Detroit Pistons,0,0,1610612741,Chicago Bulls,1,1,35,21,56,6,23,29,41,44,85,18,6,24,13,33,21,6,16,100,106
2016,2,21601185,4/7/2017,1610612750,Minnesota Timberwolves,0,0,1610612762,Utah Jazz,1,1,32,31,63,7,9,16,39,40,79,28,0,28,12,28,22,8,12,93,113
2016,2,21601185,4/7/2017,1610612762,Utah Jazz,1,1,1610612750,Minnesota Timberwolves,0,0,31,19,50,14,11,25,45,30,75,16,6,22,7,26,29,11,14,93,120
2020,2,22000044,12/28/2020,1610612743,Denver Nuggets,1,1,1610612745,Houston Rockets,0,0,32,24,56,14,17,31,46,41,87,18,14,32,14,35,31,8,16,102,124
2020,2,22000044,12/28/2020,1610612745,Houston Rockets,0,0,1610612743,Denver Nuggets,1,1,23,24,47,16,23,39,39,47,86,17,6,23,10,42,25,8,16,102,111
2014,2,21400839,2/24/2015,1610612739,Cleveland Cavaliers,0,1,1610612765,Detroit Pistons,1,0,20,20,40,14,23,37,34,43,77,20,4,24,7,39,22,5,15,98,102
2014,2,21400839,2/24/2015,1610612765,Detroit Pistons,1,0,1610612739,Cleveland Cavaliers,0,1,24,34,58,9,15,24,33,49,82,18,12,30,13,41,16,9,15,97,93
2016,2,21600626,1/17/2017,1610612743,Denver Nuggets,0,1,1610612747,Los Angeles Lakers,1,0,39,23,62,11,15,26,50,38,88,16,10,26,17,25,29,11,17,102,127
2016,2,21600626,1/17/2017,1610612747,Los Angeles Lakers,1,0,1610612743,Denver Nuggets,0,1,36,42,78,11,19,30,47,61,108,16,2,18,28,35,28,5,12,101,121
2016,2,21600164,11/16/2016,1610612745,Houston Rockets,0,0,1610612760,Oklahoma City Thunder,1,1,26,26,52,14,26,40,40,52,92,9,5,14,14,40,25,7,16,101,103
2016,2,21600164,11/16/2016,1610612760,Oklahoma City Thunder,1,1,1610612745,Houston Rockets,0,0,28,31,59,12,13,25,40,44,84,13,1,14,7,37,25,10,16,100,105
2020,2,22000043,12/28/2020,1610612760,Oklahoma City Thunder,1,0,1610612762,Utah Jazz,0,1,25,23,48,15,23,38,40,46,86,14,5,19,14,36,21,9,17,98,109
2020,2,22000043,12/28/2020,1610612762,Utah Jazz,0,1,1610612760,Oklahoma City Thunder,1,0,30,20,50,13,23,36,43,43,86,11,3,14,11,34,24,9,17,99,110
2014,2,21400838,2/24/2015,1610612744,Golden State Warriors,0,1,1610612764,Washington Wizards,1,0,33,34,67,12,11,23,45,45,90,12,5,17,5,41,27,4,9,103,114
2014,2,21400838,2/24/2015,1610612764,Washington Wizards,1,0,1610612744,Golden State Warriors,0,1,37,24,61,5,13,18,42,37,79,18,3,21,11,27,23,12,26,104,107
2018,2,21801196,4/7/2019,1610612739,Cleveland Cavaliers,1,0,1610612759,San Antonio Spurs,0,1,23,27,50,8,21,29,31,48,79,20,7,27,13,38,16,10,18,98,90
2018,2,21801196,4/7/2019,1610612759,San Antonio Spurs,0,1,1610612739,Cleveland Cavaliers,1,0,34,26,60,9,13,22,43,39,82,17,5,22,13,28,27,14,18,97,112
2018,2,21800643,1/13/2019,1610612743,Denver Nuggets,1,1,1610612757,Portland Trail Blazers,0,0,36,23,59,9,13,22,45,36,81,17,3,20,6,32,21,5,12,95,116
2018,2,21800643,1/13/2019,1610612757,Portland Trail Blazers,0,0,1610612743,Denver Nuggets,1,1,28,26,54,12,22,34,40,48,88,21,1,22,13,36,25,5,9,97,113
2018,2,21800566,1/4/2019,1610612738,Boston Celtics,1,1,1610612742,Dallas Mavericks,0,0,21,30,51,21,24,45,42,54,96,9,2,11,16,39,35,9,13,99,114
2018,2,21800566,1/4/2019,1610612742,Dallas Mavericks,0,0,1610612738,Boston Celtics,1,1,23,21,44,11,33,44,34,54,88,14,5,19,13,41,16,12,14,99,93
2020,2,22000042,12/28/2020,1610612751,Brooklyn Nets,1,0,1610612763,Memphis Grizzlies,0,1,27,31,58,14,28,42,41,59,100,15,2,17,16,43,28,10,17,110,111
2020,2,22000042,12/28/2020,1610612763,Memphis Grizzlies,0,1,1610612751,Brooklyn Nets,1,0,32,37,69,10,19,29,42,56,98,22,7,29,21,39,20,13,19,109,116
2021,2,22100257,11/22/2021,1610612741,Chicago Bulls,1,0,1610612754,Indiana Pacers,0,1,25,32,57,6,22,28,31,54,85,9,6,15,8,49,13,7,9,93,77
2021,2,22100257,11/22/2021,1610612754,Indiana Pacers,0,1,1610612741,Chicago Bulls,1,0,27,32,59,13,18,31,40,50,90,16,2,18,17,34,27,6,13,95,109
2019,2,21900300,12/3/2019,1610612753,Orlando Magic,0,1,1610612764,Washington Wizards,1,0,31,28,59,15,16,31,46,44,90,20,7,27,12,34,26,9,13,101,127
2019,2,21900300,12/3/2019,1610612764,Washington Wizards,1,0,1610612753,Orlando Magic,0,1,33,21,54,12,23,35,45,44,89,18,5,23,6,41,22,3,10,102,120
2019,2,21900072,11/1/2019,1610612738,Boston Celtics,1,1,1610612752,New York Knicks,0,0,22,18,40,11,23,34,33,41,74,27,2,29,4,37,21,9,14,97,104
2019,2,21900072,11/1/2019,1610612752,New York Knicks,0,0,1610612738,Boston Celtics,1,1,23,32,55,14,24,38,37,56,93,14,7,21,18,42,22,7,13,96,102
2016,2,21601184,4/7/2017,1610612740,New Orleans Pelicans,0,0,1610612743,Denver Nuggets,1,1,44,32,76,3,20,23,47,52,99,9,4,13,12,43,19,9,11,102,106
2016,2,21601184,4/7/2017,1610612743,Denver Nuggets,1,1,1610612740,New Orleans Pelicans,0,0,30,16,46,13,19,32,43,35,78,23,9,32,13,27,31,11,21,101,122
2016,2,21600625,1/17/2017,1610612750,Minnesota Timberwolves,0,0,1610612759,San Antonio Spurs,1,1,30,30,60,6,7,13,36,37,73,36,5,41,8,30,26,9,18,102,114
2016,2,21600625,1/17/2017,1610612759,San Antonio Spurs,1,1,1610612750,Minnesota Timberwolves,0,0,35,31,66,8,10,18,43,41,84,28,7,35,7,36,27,5,7,101,122
2019,2,21901270,8/6/2020,1610612754,Indiana Pacers,0,0,1610612756,Phoenix Suns,1,1,27,29,56,10,19,29,37,48,85,15,4,19,6,44,20,6,15,103,99
2019,2,21901270,8/6/2020,1610612756,Phoenix Suns,1,1,1610612754,Indiana Pacers,0,0,34,24,58,9,25,34,43,49,92,19,1,20,16,34,27,6,16,102,114
2019,2,21901241,8/1/2020,1610612740,New Orleans Pelicans,0,0,1610612746,LA Clippers,1,1,29,26,55,9,21,30,38,47,85,18,10,28,12,40,24,10,18,104,103
2019,2,21901241,8/1/2020,1610612746,LA Clippers,1,1,1610612740,New Orleans Pelicans,0,0,12,28,40,25,22,47,37,50,87,27,8,35,11,42,23,4,10,104,126
2019,2,21900955,3/8/2020,1610612752,New York Knicks,1,1,1610612765,Detroit Pistons,0,0,30,33,63,6,13,19,36,46,82,18,7,25,17,31,15,8,12,90,96
2019,2,21900955,3/8/2020,1610612765,Detroit Pistons,0,0,1610612752,New York Knicks,1,1,18,24,42,11,27,38,29,51,80,15,7,22,12,39,21,10,13,89,84
2019,2,21900915,3/3/2020,1610612747,Los Angeles Lakers,1,1,1610612755,Philadelphia 76ers,0,0,33,20,53,13,20,33,46,40,86,15,3,18,10,31,25,10,13,96,120
2019,2,21900915,3/3/2020,1610612755,Philadelphia 76ers,0,0,1610612747,Los Angeles Lakers,1,1,22,23,45,16,24,40,38,47,85,15,5,20,14,36,24,9,15,98,107
2019,2,21900882,2/28/2020,1610612749,Milwaukee Bucks,1,1,1610612760,Oklahoma City Thunder,0,0,29,26,55,21,24,45,50,50,100,12,2,14,17,34,34,8,17,108,133
2019,2,21900882,2/28/2020,1610612760,Oklahoma City Thunder,0,0,1610612749,Milwaukee Bucks,1,1,27,29,56,6,29,35,33,58,91,14,6,20,7,55,14,6,14,107,86
2018,2,21801049,3/17/2019,1610612746,LA Clippers,1,1,1610612751,Brooklyn Nets,0,0,30,36,66,12,19,31,42,55,97,23,5,28,18,39,26,6,14,105,119
2018,2,21801049,3/17/2019,1610612751,Brooklyn Nets,0,0,1610612746,LA Clippers,1,1,28,34,62,14,24,38,42,58,100,18,7,25,20,43,26,8,14,105,116
2018,2,21800913,2/27/2019,1610612738,Boston Celtics,1,0,1610612757,Portland Trail Blazers,0,1,35,23,58,5,23,28,40,46,86,7,3,10,12,36,20,11,17,96,92
2018,2,21800913,2/27/2019,1610612757,Portland Trail Blazers,0,1,1610612738,Boston Celtics,1,0,32,25,57,6,27,33,38,52,90,15,5,20,16,37,14,5,12,96,97
2018,2,21800808,2/6/2019,1610612756,Phoenix Suns,0,0,1610612762,Utah Jazz,1,1,32,26,58,3,14,17,35,40,75,15,4,19,9,34,23,13,22,98,88
2018,2,21800808,2/6/2019,1610612762,Utah Jazz,1,1,1610612756,Phoenix Suns,0,0,31,25,56,11,17,28,42,42,84,21,11,32,16,30,29,8,16,98,116
2018,2,21800717,1/24/2019,1610612740,New Orleans Pelicans,0,0,1610612760,Oklahoma City Thunder,1,1,39,26,65,10,26,36,49,52,101,8,4,12,11,44,34,8,12,107,116
2018,2,21800717,1/24/2019,1610612760,Oklahoma City Thunder,1,1,1610612740,New Orleans Pelicans,0,0,36,33,69,14,18,32,50,51,101,8,8,16,17,39,33,7,14,107,122
2018,2,21800491,12/23/2018,1610612748,Miami Heat,0,1,1610612753,Orlando Magic,1,0,27,27,54,16,15,31,43,42,85,13,6,19,14,32,27,4,12,92,115
2018,2,21800491,12/23/2018,1610612753,Orlando Magic,1,0,1610612748,Miami Heat,0,1,19,23,42,10,18,28,29,41,70,23,9,32,13,33,15,11,19,91,91
2018,2,21800355,12/5/2018,1610612739,Cleveland Cavaliers,1,0,1610612744,Golden State Warriors,0,1,28,29,57,11,21,32,39,50,89,16,7,23,14,39,17,6,10,94,105
2018,2,21800355,12/5/2018,1610612744,Golden State Warriors,0,1,1610612739,Cleveland Cavaliers,1,0,27,24,51,18,16,34,45,40,85,21,3,24,10,30,29,7,9,94,129
2018,2,21800297,11/26/2018,1610612741,Chicago Bulls,1,0,1610612759,San Antonio Spurs,0,1,28,29,57,14,19,33,42,48,90,9,2,11,10,39,23,7,12,99,107
2018,2,21800297,11/26/2018,1610612759,San Antonio Spurs,0,1,1610612741,Chicago Bulls,1,0,35,28,63,10,20,30,45,48,93,8,1,9,9,39,29,6,10,99,108
2019,2,21900860,2/25/2020,1610612743,Denver Nuggets,1,1,1610612765,Detroit Pistons,0,0,35,22,57,9,10,19,44,32,76,18,4,22,12,22,33,8,18,93,115
2019,2,21900860,2/25/2020,1610612765,Detroit Pistons,0,0,1610612743,Denver Nuggets,1,1,18,22,40,15,26,41,33,48,81,17,4,21,16,35,24,12,16,93,98
2019,2,21900828,2/21/2020,1610612752,New York Knicks,1,0,1610612754,Indiana Pacers,0,1,24,32,56,11,14,25,35,46,81,17,8,25,10,41,21,7,15,99,98
2019,2,21900828,2/21/2020,1610612754,Indiana Pacers,0,1,1610612752,New York Knicks,1,0,28,32,60,8,20,28,36,52,88,26,7,33,16,39,20,7,11,99,106
2019,2,21900807,2/12/2020,1610612737,Atlanta Hawks,0,0,1610612739,Cleveland Cavaliers,1,1,23,27,50,13,21,34,36,48,84,20,5,25,10,40,24,8,17,103,105
2019,2,21900807,2/12/2020,1610612739,Cleveland Cavaliers,1,1,1610612737,Atlanta Hawks,0,0,38,28,66,10,18,28,48,46,94,21,4,25,19,30,25,11,17,103,127
2019,2,21900767,2/6/2020,1610612757,Portland Trail Blazers,1,1,1610612759,San Antonio Spurs,0,0,31,24,55,18,19,37,49,43,92,9,3,12,12,33,28,9,12,97,125
2019,2,21900767,2/6/2020,1610612759,San Antonio Spurs,0,0,1610612757,Portland Trail Blazers,1,1,31,33,64,10,18,28,41,51,92,25,3,28,10,43,25,2,4,98,117
2020,2,22000041,12/28/2020,1610612737,Atlanta Hawks,1,1,1610612765,Detroit Pistons,0,0,20,20,40,20,22,42,40,42,82,28,4,32,11,33,30,7,13,101,128
2020,2,22000041,12/28/2020,1610612765,Detroit Pistons,0,0,1610612737,Atlanta Hawks,1,1,30,27,57,13,28,41,43,55,98,21,3,24,17,40,24,5,8,100,120
2016,2,21601183,4/7/2017,1610612742,Dallas Mavericks,1,0,1610612759,San Antonio Spurs,0,1,30,32,62,8,18,26,38,50,88,5,3,8,7,44,26,6,9,96,89
2016,2,21601183,4/7/2017,1610612759,San Antonio Spurs,0,1,1610612742,Dallas Mavericks,1,0,31,37,68,9,19,28,40,56,96,13,9,22,19,42,26,1,7,94,102
2016,2,21600163,11/16/2016,1610612737,Atlanta Hawks,1,1,1610612749,Milwaukee Bucks,0,0,25,15,40,10,22,32,35,37,72,27,4,31,4,35,29,9,16,99,107
2016,2,21600163,11/16/2016,1610612749,Milwaukee Bucks,0,0,1610612737,Atlanta Hawks,1,1,31,35,66,8,24,32,39,59,98,14,4,18,23,39,25,6,15,99,100
2014,2,21400837,2/23/2015,1610612746,LA Clippers,1,0,1610612763,Memphis Grizzlies,0,1,26,26,52,9,18,27,35,44,79,8,4,12,8,37,21,10,14,90,87
2014,2,21400837,2/23/2015,1610612763,Memphis Grizzlies,0,1,1610612746,LA Clippers,1,0,28,38,66,5,10,15,33,48,81,19,7,26,13,37,22,6,10,92,90
2019,2,21901312,8/13/2020,1610612740,New Orleans Pelicans,0,0,1610612753,Orlando Magic,1,1,38,15,53,10,24,34,48,39,87,21,6,27,12,28,22,6,13,101,127
2019,2,21901312,8/13/2020,1610612753,Orlando Magic,1,1,1610612740,New Orleans Pelicans,0,0,33,23,56,15,13,28,48,36,84,22,8,30,10,31,25,6,12,102,133
2018,2,21801195,4/7/2019,1610612748,Miami Heat,0,0,1610612761,Toronto Raptors,1,1,28,38,66,13,21,34,41,59,100,14,5,19,16,46,27,7,12,106,109
2018,2,21801195,4/7/2019,1610612761,Toronto Raptors,1,1,1610612748,Miami Heat,0,0,23,23,46,16,25,41,39,48,87,23,4,27,6,43,26,5,11,106,117
2018,2,21800490,12/23/2018,1610612739,Cleveland Cavaliers,1,0,1610612741,Chicago Bulls,0,1,31,30,61,7,16,23,38,46,84,9,5,14,13,36,11,7,12,90,92
2018,2,21800490,12/23/2018,1610612741,Chicago Bulls,0,1,1610612739,Cleveland Cavaliers,1,0,32,24,56,11,11,22,43,35,78,15,2,17,9,26,26,5,15,90,112
2018,2,21800420,12/14/2018,1610612737,Atlanta Hawks,0,0,1610612738,Boston Celtics,1,1,20,28,48,16,22,38,36,50,86,20,12,32,18,35,27,15,24,108,108
2018,2,21800420,12/14/2018,1610612738,Boston Celtics,1,1,1610612737,Atlanta Hawks,0,0,27,29,56,19,20,39,46,49,95,18,2,20,19,30,28,10,22,110,129
2019,2,21901295,8/10/2020,1610612748,Miami Heat,1,1,1610612754,Indiana Pacers,0,0,31,27,58,13,27,40,44,54,98,13,6,19,19,39,29,5,14,103,114
2019,2,21901295,8/10/2020,1610612754,Indiana Pacers,0,0,1610612748,Miami Heat,1,1,23,26,49,10,25,35,33,51,84,16,9,25,10,46,20,11,17,103,92
2019,2,21901255,8/3/2020,1610612747,Los Angeles Lakers,0,1,1610612762,Utah Jazz,1,0,32,24,56,9,17,26,41,41,82,25,6,31,8,36,23,8,14,102,116
2019,2,21901255,8/3/2020,1610612762,Utah Jazz,1,0,1610612747,Los Angeles Lakers,0,1,25,15,40,12,31,43,37,46,83,22,3,25,11,36,25,12,21,103,108
2019,2,21900969,3/11/2020,1610612737,Atlanta Hawks,1,0,1610612752,New York Knicks,0,1,34,31,65,14,27,41,48,58,106,21,5,26,19,43,26,14,17,114,131
2019,2,21900969,3/11/2020,1610612752,New York Knicks,0,1,1610612737,Atlanta Hawks,1,0,39,27,66,11,17,28,50,44,94,25,9,34,8,40,32,6,12,116,136
2020,2,22000040,12/27/2020,1610612747,Los Angeles Lakers,1,1,1610612750,Minnesota Timberwolves,0,0,37,18,55,13,22,35,50,40,90,14,4,18,9,32,32,11,17,105,127
2020,2,22000040,12/27/2020,1610612750,Minnesota Timberwolves,0,0,1610612747,Los Angeles Lakers,1,1,32,36,68,6,29,35,38,65,103,9,5,14,23,44,24,6,18,106,91
2021,2,22100256,11/22/2021,1610612738,Boston Celtics,1,1,1610612745,Houston Rockets,0,0,27,30,57,12,23,35,39,53,92,18,1,19,14,40,19,5,15,102,108
2021,2,22100256,11/22/2021,1610612745,Houston Rockets,0,0,1610612738,Boston Celtics,1,1,20,21,41,11,31,42,31,52,83,17,7,24,6,50,19,10,15,103,90
2016,2,21600162,11/16/2016,1610612752,New York Knicks,1,1,1610612765,Detroit Pistons,0,0,33,35,68,9,16,25,42,51,93,12,7,19,21,33,24,6,9,91,105
2016,2,21600162,11/16/2016,1610612765,Detroit Pistons,0,0,1610612752,New York Knicks,1,1,34,28,62,8,15,23,42,43,85,10,2,12,12,33,19,8,11,90,102
2019,2,21900899,3/1/2020,1610612758,Sacramento Kings,1,1,1610612765,Detroit Pistons,0,0,28,28,56,9,26,35,37,54,91,23,3,26,19,35,18,6,11,95,106
2019,2,21900899,3/1/2020,1610612765,Detroit Pistons,0,0,1610612758,Sacramento Kings,1,1,15,23,38,18,24,42,33,47,80,16,8,24,13,37,23,8,16,96,100
2019,2,21900881,2/28/2020,1610612758,Sacramento Kings,0,1,1610612763,Memphis Grizzlies,1,0,27,26,53,11,27,38,38,53,91,17,4,21,9,47,24,7,9,101,104
2019,2,21900881,2/28/2020,1610612763,Memphis Grizzlies,1,0,1610612758,Sacramento Kings,0,1,31,30,61,8,22,30,39,52,91,15,5,20,15,40,27,11,14,102,101
2019,2,21900859,2/25/2020,1610612741,Chicago Bulls,1,0,1610612760,Oklahoma City Thunder,0,1,40,26,66,12,19,31,52,45,97,6,3,9,17,31,22,8,11,95,122
2019,2,21900859,2/25/2020,1610612760,Oklahoma City Thunder,0,1,1610612741,Chicago Bulls,1,0,28,18,46,14,16,30,42,34,76,26,9,35,11,26,25,6,12,95,124
2019,2,21900784,2/8/2020,1610612743,Denver Nuggets,0,1,1610612756,Phoenix Suns,1,0,34,20,54,11,17,28,45,37,82,16,5,21,10,30,23,7,14,98,117
2019,2,21900784,2/8/2020,1610612756,Phoenix Suns,1,0,1610612743,Denver Nuggets,0,1,29,26,55,9,23,32,38,49,87,23,0,23,15,34,25,7,14,97,108
2019,2,21900775,2/7/2020,1610612748,Miami Heat,0,0,1610612758,Sacramento Kings,1,1,22,15,37,12,28,40,34,43,77,17,8,25,15,31,21,8,20,94,97
2019,2,21900775,2/7/2020,1610612758,Sacramento Kings,1,1,1610612748,Miami Heat,0,0,21,17,38,19,25,44,40,42,82,6,6,12,8,36,29,7,14,95,105
2019,2,21900749,2/3/2020,1610612750,Minnesota Timberwolves,0,0,1610612758,Sacramento Kings,1,1,24,23,47,13,25,38,37,48,85,22,6,28,18,32,25,7,16,95,109
2019,2,21900749,2/3/2020,1610612758,Sacramento Kings,1,1,1610612750,Minnesota Timberwolves,0,0,24,24,48,14,13,27,38,37,75,23,8,31,11,32,26,12,17,96,113
2019,2,21900735,2/1/2020,1610612757,Portland Trail Blazers,1,1,1610612762,Utah Jazz,0,0,32,31,63,15,14,29,47,45,92,15,3,18,18,29,20,6,12,96,124
2019,2,21900735,2/1/2020,1610612762,Utah Jazz,0,0,1610612757,Portland Trail Blazers,1,1,22,31,53,18,23,41,40,54,94,9,0,9,13,41,19,4,10,96,107
2019,2,21900722,1/31/2020,1610612742,Dallas Mavericks,0,0,1610612745,Houston Rockets,1,1,29,25,54,14,22,36,43,47,90,21,6,27,18,32,29,11,17,100,121
2019,2,21900722,1/31/2020,1610612745,Houston Rockets,1,1,1610612742,Dallas Mavericks,0,0,24,29,53,21,24,45,45,53,98,17,3,20,13,41,25,2,7,101,128
2019,2,21900299,12/3/2019,1610612739,Cleveland Cavaliers,1,0,1610612765,Detroit Pistons,0,1,30,33,63,8,19,27,38,52,90,10,4,14,16,38,16,11,14,94,94
2019,2,21900299,12/3/2019,1610612765,Detroit Pistons,0,1,1610612739,Cleveland Cavaliers,1,0,33,26,59,18,17,35,51,43,94,7,4,11,15,30,33,6,11,95,127
2018,2,21801048,3/17/2019,1610612745,Houston Rockets,1,1,1610612750,Minnesota Timberwolves,0,0,22,22,44,21,29,50,43,51,94,10,4,14,14,39,29,5,10,97,117
2018,2,21801048,3/17/2019,1610612750,Minnesota Timberwolves,0,0,1610612745,Houston Rockets,1,1,28,32,60,10,22,32,38,54,92,16,7,23,20,35,22,9,14,97,102
2020,2,22000940,4/28/2021,1610612740,New Orleans Pelicans,0,0,1610612743,Denver Nuggets,1,1,31,26,57,12,18,30,43,44,87,14,5,19,9,37,27,14,21,109,112
2020,2,22000940,4/28/2021,1610612743,Denver Nuggets,1,1,1610612740,New Orleans Pelicans,0,0,33,20,53,10,22,32,43,42,85,18,5,23,5,38,26,13,18,109,114
2018,2,21800807,2/6/2019,1610612742,Dallas Mavericks,1,1,1610612766,Charlotte Hornets,0,0,27,31,58,11,25,36,38,56,94,12,5,17,17,40,25,9,13,98,99
2019,2,21900681,1/25/2020,1610612751,Brooklyn Nets,0,1,1610612765,Detroit Pistons,1,0,27,25,52,15,27,42,42,52,94,22,3,25,15,38,19,5,11,103,121
2019,2,21900681,1/25/2020,1610612765,Detroit Pistons,1,0,1610612751,Brooklyn Nets,0,1,30,39,69,13,22,35,43,61,104,12,6,18,18,46,20,3,8,104,111
2019,2,21900671,1/24/2020,1610612738,Boston Celtics,0,1,1610612753,Orlando Magic,1,0,26,25,51,14,21,35,40,46,86,15,3,18,12,35,27,5,14,96,109
2019,2,21900671,1/24/2020,1610612753,Orlando Magic,1,0,1610612738,Boston Celtics,0,1,24,29,53,12,25,37,36,54,90,14,5,19,17,41,18,10,14,98,98
2016,2,21601182,4/7/2017,1610612745,Houston Rockets,1,0,1610612765,Detroit Pistons,0,1,20,16,36,16,35,51,36,51,87,21,7,28,14,40,25,5,14,99,109
2016,2,21601182,4/7/2017,1610612765,Detroit Pistons,0,1,1610612745,Houston Rockets,1,0,37,45,82,9,17,26,46,62,108,13,3,16,22,41,27,3,6,99,114
2016,2,21600624,1/17/2017,1610612741,Chicago Bulls,1,0,1610612742,Dallas Mavericks,0,1,31,37,68,6,8,14,37,45,82,18,4,22,14,33,23,5,13,91,98
2016,2,21600624,1/17/2017,1610612742,Dallas Mavericks,0,1,1610612741,Chicago Bulls,1,0,26,24,50,11,17,28,37,41,78,14,4,18,7,35,27,6,12,92,99
2014,2,21400836,2/23/2015,1610612759,San Antonio Spurs,0,0,1610612762,Utah Jazz,1,1,27,33,60,5,14,19,32,47,79,12,9,21,14,39,17,14,22,96,81
2014,2,21400836,2/23/2015,1610612762,Utah Jazz,1,1,1610612759,San Antonio Spurs,0,0,30,38,68,4,11,15,34,49,83,18,5,23,13,37,14,7,13,96,90
2019,2,21901269,8/6/2020,1610612748,Miami Heat,0,0,1610612749,Milwaukee Bucks,1,1,14,23,37,21,25,46,35,48,83,25,2,27,9,40,28,7,19,106,116
2019,2,21901269,8/6/2020,1610612749,Milwaukee Bucks,1,1,1610612748,Miami Heat,0,0,26,15,41,15,22,37,41,37,78,33,5,38,6,33,27,6,14,106,130
2019,2,21901254,8/3/2020,1610612755,Philadelphia 76ers,1,1,1610612759,San Antonio Spurs,0,0,32,24,56,14,17,31,46,41,87,26,4,30,11,33,26,7,13,104,132
2019,2,21901254,8/3/2020,1610612759,San Antonio Spurs,0,0,1610612755,Philadelphia 76ers,1,1,34,33,67,12,14,26,46,47,93,26,3,29,17,30,21,6,14,103,130
2018,2,21800912,2/27/2019,1610612737,Atlanta Hawks,1,1,1610612750,Minnesota Timberwolves,0,0,34,45,79,12,17,29,46,62,108,27,5,32,22,42,32,8,12,112,131
2018,2,21800912,2/27/2019,1610612750,Minnesota Timberwolves,0,0,1610612737,Atlanta Hawks,1,1,32,32,64,12,26,38,44,58,102,23,10,33,11,51,29,1,7,112,123
2018,2,21800807,2/6/2019,1610612766,Charlotte Hornets,0,0,1610612742,Dallas Mavericks,1,1,27,25,52,9,28,37,36,53,89,12,5,17,13,43,17,8,14,97,93
2018,2,21800565,1/3/2019,1610612744,Golden State Warriors,1,0,1610612745,Houston Rockets,0,1,39,26,65,14,23,37,53,49,102,14,1,15,15,35,33,8,15,109,134
2018,2,21800565,1/3/2019,1610612745,Houston Rockets,0,1,1610612744,Golden State Warriors,1,0,24,21,45,21,33,54,45,54,99,24,4,28,15,40,30,8,11,107,135
2018,2,21800354,12/4/2018,1610612759,San Antonio Spurs,0,0,1610612762,Utah Jazz,1,1,37,31,68,7,15,22,44,46,90,10,1,11,8,39,25,12,16,103,105
2018,2,21800354,12/4/2018,1610612762,Utah Jazz,1,1,1610612759,San Antonio Spurs,0,0,31,20,51,20,13,33,51,33,84,17,3,20,9,27,38,7,18,103,139
2019,2,21901240,8/1/2020,1610612760,Oklahoma City Thunder,1,1,1610612762,Utah Jazz,0,0,31,20,51,10,16,26,41,36,77,18,6,24,13,24,19,11,23,97,110
2019,2,21901240,8/1/2020,1610612762,Utah Jazz,0,0,1610612760,Oklahoma City Thunder,1,1,26,30,56,8,23,31,34,53,87,18,4,22,16,38,17,9,15,98,94
2020,2,22000039,12/27/2020,1610612756,Phoenix Suns,0,1,1610612758,Sacramento Kings,1,0,32,27,59,14,21,35,46,48,94,10,1,11,10,39,34,5,9,95,116
2020,2,22000039,12/27/2020,1610612758,Sacramento Kings,1,0,1610612756,Phoenix Suns,0,1,26,27,53,10,13,23,36,40,76,18,7,25,6,37,21,6,15,97,100
2019,2,21901311,8/13/2020,1610612749,Milwaukee Bucks,0,0,1610612763,Memphis Grizzlies,1,1,26,31,57,13,28,41,39,59,98,15,8,23,13,50,27,4,15,111,106
2019,2,21901311,8/13/2020,1610612763,Memphis Grizzlies,1,1,1610612749,Milwaukee Bucks,0,0,32,25,57,13,20,33,45,45,90,16,7,23,11,38,36,8,18,110,119
2019,2,21901294,8/10/2020,1610612749,Milwaukee Bucks,1,0,1610612761,Toronto Raptors,0,1,19,22,41,14,29,43,33,51,84,26,9,35,15,41,25,11,19,106,106
2019,2,21901294,8/10/2020,1610612761,Toronto Raptors,0,1,1610612749,Milwaukee Bucks,1,0,30,27,57,12,28,40,42,55,97,18,8,26,18,41,24,4,14,105,114
2019,2,21900941,3/7/2020,1610612762,Utah Jazz,0,1,1610612765,Detroit Pistons,1,0,30,14,44,10,23,33,40,37,77,21,7,28,10,29,17,4,10,91,111
2019,2,21900941,3/7/2020,1610612765,Detroit Pistons,1,0,1610612762,Utah Jazz,0,1,31,25,56,9,21,30,40,46,86,16,6,22,16,32,24,10,11,92,105
2019,2,21900929,3/5/2020,1610612744,Golden State Warriors,1,0,1610612761,Toronto Raptors,0,1,26,20,46,14,38,52,40,58,98,19,6,25,22,38,34,10,16,105,113
2019,2,21900929,3/5/2020,1610612761,Toronto Raptors,0,1,1610612744,Golden State Warriors,1,0,27,16,43,13,28,41,40,44,84,28,3,31,6,40,28,4,12,105,121
2019,2,21900849,2/24/2020,1610612739,Cleveland Cavaliers,1,1,1610612748,Miami Heat,0,0,29,31,60,14,23,37,43,54,97,25,9,34,19,40,25,6,12,110,125
2019,2,21900849,2/24/2020,1610612748,Miami Heat,0,0,1610612739,Cleveland Cavaliers,1,1,28,26,54,16,26,42,44,52,96,15,5,20,11,42,33,8,15,108,119
2019,2,21900838,2/22/2020,1610612739,Cleveland Cavaliers,0,0,1610612748,Miami Heat,1,1,25,18,43,13,23,36,38,41,79,16,6,22,17,27,29,16,25,100,105
2019,2,21900838,2/22/2020,1610612748,Miami Heat,1,1,1610612739,Cleveland Cavaliers,0,0,26,13,39,19,21,40,45,34,79,15,5,20,5,32,34,8,16,99,124
2019,2,21900816,2/12/2020,1610612748,Miami Heat,0,0,1610612762,Utah Jazz,1,1,25,24,49,13,26,39,38,50,88,12,4,16,8,45,19,6,11,101,101
2019,2,21900816,2/12/2020,1610612762,Utah Jazz,1,1,1610612748,Miami Heat,0,0,27,22,49,14,22,36,41,44,85,20,3,23,12,34,23,11,15,101,116
2019,2,21900070,11/1/2019,1610612739,Cleveland Cavaliers,0,0,1610612754,Indiana Pacers,1,1,21,34,55,11,21,32,32,55,87,20,5,25,10,49,20,8,16,104,95
2019,2,21900070,11/1/2019,1610612754,Indiana Pacers,1,1,1610612739,Cleveland Cavaliers,0,0,34,35,69,5,22,27,39,57,96,19,2,21,16,42,20,9,14,105,102
2018,2,21801194,4/6/2019,1610612741,Chicago Bulls,1,0,1610612755,Philadelphia 76ers,0,1,30,34,64,8,17,25,38,51,89,12,3,15,8,44,22,5,8,96,96
2018,2,21801194,4/6/2019,1610612755,Philadelphia 76ers,0,1,1610612741,Chicago Bulls,1,0,37,24,61,9,18,27,46,42,88,15,11,26,14,33,25,4,10,96,116
2020,2,22000038,12/27/2020,1610612741,Chicago Bulls,1,0,1610612744,Golden State Warriors,0,1,27,18,45,17,24,41,44,42,86,23,8,31,12,31,27,17,24,115,128
2020,2,22000038,12/27/2020,1610612744,Golden State Warriors,0,1,1610612741,Chicago Bulls,1,0,24,33,57,18,29,47,42,62,104,27,3,30,16,48,25,4,12,114,129
2016,2,21601181,4/7/2017,1610612752,New York Knicks,0,0,1610612763,Memphis Grizzlies,1,1,32,28,60,6,22,28,38,50,88,6,7,13,19,35,20,3,11,87,88
2016,2,21601181,4/7/2017,1610612763,Memphis Grizzlies,1,1,1610612752,New York Knicks,0,0,23,25,48,15,12,27,38,37,75,10,2,12,9,28,20,8,14,86,101
2016,2,21600623,1/17/2017,1610612745,Houston Rockets,0,0,1610612748,Miami Heat,1,1,27,24,51,9,30,39,36,54,90,22,6,28,15,42,21,11,18,108,103
2016,2,21600623,1/17/2017,1610612748,Miami Heat,1,1,1610612745,Houston Rockets,0,0,33,28,61,9,20,29,42,48,90,16,8,24,11,40,21,8,16,106,109
2016,2,21600161,11/16/2016,1610612738,Boston Celtics,1,1,1610612742,Dallas Mavericks,0,0,26,29,55,7,14,21,33,43,76,17,6,23,17,28,18,9,19,88,90
2016,2,21600161,11/16/2016,1610612742,Dallas Mavericks,0,0,1610612738,Boston Celtics,1,1,26,34,60,8,15,23,34,49,83,7,3,10,8,42,16,6,9,89,83
2014,2,21400835,2/23/2015,1610612738,Boston Celtics,0,1,1610612756,Phoenix Suns,1,0,25,35,60,14,15,29,39,50,89,23,7,30,14,39,26,9,15,104,115
2014,2,21400835,2/23/2015,1610612756,Phoenix Suns,1,0,1610612738,Boston Celtics,0,1,35,30,65,9,23,32,44,53,97,13,3,16,18,36,25,13,17,104,110
2021,2,22100255,11/22/2021,1610612737,Atlanta Hawks,1,1,1610612760,Oklahoma City Thunder,0,0,28,25,53,14,20,34,42,45,87,15,1,16,9,36,25,5,8,93,113
2019,2,21901268,8/6/2020,1610612740,New Orleans Pelicans,0,0,1610612758,Sacramento Kings,1,1,33,15,48,14,20,34,47,35,82,17,6,23,8,29,31,11,17,101,125
2019,2,21901268,8/6/2020,1610612758,Sacramento Kings,1,1,1610612740,New Orleans Pelicans,0,0,34,26,60,16,17,33,50,43,93,24,9,33,17,29,26,4,8,103,140
2019,2,21900968,3/10/2020,1610612747,Los Angeles Lakers,1,0,1610612751,Brooklyn Nets,0,1,25,22,47,15,25,40,40,47,87,7,5,12,13,37,24,7,15,95,102
2019,2,21900968,3/10/2020,1610612751,Brooklyn Nets,0,1,1610612747,Los Angeles Lakers,1,0,24,26,50,13,27,40,37,53,90,17,6,23,16,40,24,7,11,96,104
2019,2,21900954,3/8/2020,1610612739,Cleveland Cavaliers,1,1,1610612759,San Antonio Spurs,0,0,30,30,60,13,21,34,43,51,94,33,12,45,16,40,26,14,17,117,132
2019,2,21900954,3/8/2020,1610612759,San Antonio Spurs,0,0,1610612739,Cleveland Cavaliers,1,1,33,39,72,10,16,26,43,55,98,33,3,36,8,49,20,5,10,115,129
2018,2,21801047,3/17/2019,1610612741,Chicago Bulls,0,0,1610612758,Sacramento Kings,1,1,29,33,62,10,16,26,39,49,88,14,7,21,17,38,20,12,20,99,102
2019,2,21900071,11/1/2019,1610612749,Milwaukee Bucks,0,1,1610612753,Orlando Magic,1,0,30,16,46,17,30,47,47,46,93,12,6,18,12,36,24,8,14,103,123
2019,2,21900071,11/1/2019,1610612753,Orlando Magic,1,0,1610612749,Milwaukee Bucks,0,1,22,32,54,12,25,37,34,57,91,11,6,17,13,48,21,11,16,104,91
2018,2,21801047,3/17/2019,1610612758,Sacramento Kings,1,1,1610612741,Chicago Bulls,0,0,46,34,80,8,15,23,54,49,103,13,3,16,20,29,28,6,12,101,129
2018,2,21800911,2/27/2019,1610612745,Houston Rockets,0,1,1610612766,Charlotte Hornets,1,0,29,23,52,13,26,39,42,49,91,21,3,24,10,41,23,9,10,102,118
2018,2,21800911,2/27/2019,1610612766,Charlotte Hornets,1,0,1610612745,Houston Rockets,0,1,27,23,50,12,21,33,39,44,83,23,4,27,11,35,25,11,18,103,113
2018,2,21800642,1/13/2019,1610612742,Dallas Mavericks,1,0,1610612744,Golden State Warriors,0,1,22,31,53,16,22,38,38,53,91,22,7,29,21,36,21,9,12,96,114
2018,2,21800642,1/13/2019,1610612744,Golden State Warriors,0,1,1610612742,Dallas Mavericks,1,0,26,28,54,19,26,45,45,54,99,10,2,12,21,34,26,5,10,96,119
2018,2,21800296,11/26/2018,1610612745,Houston Rockets,0,0,1610612764,Washington Wizards,1,1,28,21,49,18,30,48,46,51,97,21,6,27,23,31,22,7,21,106,131
2018,2,21800296,11/26/2018,1610612764,Washington Wizards,1,1,1610612745,Houston Rockets,0,0,39,21,60,11,18,29,50,39,89,24,8,32,10,33,29,8,13,107,135
2018,2,21800087,10/29/2018,1610612754,Indiana Pacers,1,0,1610612757,Portland Trail Blazers,0,1,31,40,71,6,13,19,37,53,90,13,7,20,16,41,19,3,9,95,93
2018,2,21800087,10/29/2018,1610612757,Portland Trail Blazers,0,1,1610612754,Indiana Pacers,1,0,28,24,52,10,16,26,38,40,78,17,1,18,11,30,19,8,18,93,103
2021,2,22100255,11/22/2021,1610612760,Oklahoma City Thunder,0,0,1610612737,Atlanta Hawks,1,1,29,30,59,10,28,38,39,58,97,13,1,14,22,36,24,6,10,92,101
2020,2,22000037,12/27/2020,1610612738,Boston Celtics,0,0,1610612754,Indiana Pacers,1,1,31,25,56,9,14,23,40,39,79,18,6,24,9,32,21,11,18,101,107
2020,2,22000037,12/27/2020,1610612754,Indiana Pacers,1,1,1610612738,Boston Celtics,0,0,38,24,62,7,19,26,45,43,88,11,4,15,9,37,23,13,16,101,108
2019,2,21900298,12/2/2019,1610612741,Chicago Bulls,0,1,1610612758,Sacramento Kings,1,0,20,18,38,16,21,37,36,39,75,25,4,29,8,34,20,7,18,99,113
2019,2,21900298,12/2/2019,1610612758,Sacramento Kings,1,0,1610612741,Chicago Bulls,0,1,31,19,50,9,24,33,40,43,83,17,3,20,13,32,22,9,18,98,106
2018,2,21800910,2/26/2019,1610612743,Denver Nuggets,1,1,1610612760,Oklahoma City Thunder,0,0,28,32,60,13,15,28,41,47,88,26,9,35,17,34,28,10,18,106,121
2018,2,21800910,2/26/2019,1610612760,Oklahoma City Thunder,0,0,1610612743,Denver Nuggets,1,1,33,24,57,10,28,38,43,52,95,16,9,25,17,40,31,9,17,108,112
2018,2,21800806,2/6/2019,1610612749,Milwaukee Bucks,1,1,1610612764,Washington Wizards,0,0,37,26,63,19,11,30,56,37,93,17,9,26,11,34,33,6,15,108,148
2018,2,21800806,2/6/2019,1610612764,Washington Wizards,0,0,1610612749,Milwaukee Bucks,1,1,31,24,55,17,20,37,48,44,92,16,3,19,15,29,34,15,24,109,129
2020,2,22000036,12/27/2020,1610612749,Milwaukee Bucks,0,0,1610612752,New York Knicks,1,1,34,23,57,7,31,38,41,54,95,21,8,29,21,39,24,5,11,99,110
2020,2,22000036,12/27/2020,1610612752,New York Knicks,1,1,1610612749,Milwaukee Bucks,0,0,30,28,58,16,11,27,46,39,85,22,5,27,14,27,27,7,16,98,130
2016,2,21600622,1/17/2017,1610612751,Brooklyn Nets,1,0,1610612761,Toronto Raptors,0,1,33,30,63,7,19,26,40,49,89,22,2,24,15,35,20,8,13,97,109
2016,2,21600622,1/17/2017,1610612761,Toronto Raptors,0,1,1610612751,Brooklyn Nets,1,0,38,35,73,10,9,19,48,44,92,13,3,16,13,33,18,7,10,97,119
2016,2,21600160,11/16/2016,1610612739,Cleveland Cavaliers,0,0,1610612754,Indiana Pacers,1,1,24,32,56,11,19,30,35,51,86,12,8,20,18,37,19,8,18,96,93
2016,2,21600160,11/16/2016,1610612754,Indiana Pacers,1,1,1610612739,Cleveland Cavaliers,0,0,33,25,58,10,18,28,43,43,86,7,4,11,5,40,22,3,10,96,103
2014,2,21400834,2/23/2015,1610612743,Denver Nuggets,1,0,1610612751,Brooklyn Nets,0,1,24,43,67,7,20,27,31,63,94,13,9,22,22,45,18,7,15,97,82
2014,2,21400834,2/23/2015,1610612751,Brooklyn Nets,0,1,1610612743,Denver Nuggets,1,0,39,32,71,4,17,21,43,49,92,20,3,23,17,33,21,6,10,96,110
2021,2,22100254,11/22/2021,1610612764,Washington Wizards,1,0,1610612766,Charlotte Hornets,0,1,27,30,57,9,28,37,36,58,94,22,5,27,25,33,23,11,18,104,103
2018,2,21801193,4/6/2019,1610612749,Milwaukee Bucks,1,0,1610612751,Brooklyn Nets,0,1,33,21,54,16,18,34,49,39,88,14,7,21,10,32,28,7,14,103,128
2018,2,21801193,4/6/2019,1610612751,Brooklyn Nets,0,1,1610612749,Milwaukee Bucks,1,0,29,23,52,19,26,45,48,49,97,18,5,23,15,39,25,7,10,103,133
2018,2,21801046,3/17/2019,1610612737,Atlanta Hawks,0,0,1610612753,Orlando Magic,1,1,30,26,56,8,27,35,38,53,91,7,3,10,9,46,20,12,18,106,91
2018,2,21801046,3/17/2019,1610612753,Orlando Magic,1,1,1610612737,Atlanta Hawks,0,0,24,24,48,9,28,37,33,52,85,26,7,33,11,43,21,8,15,106,101
2021,2,22100254,11/22/2021,1610612766,Charlotte Hornets,0,1,1610612764,Washington Wizards,1,0,25,35,60,15,16,31,40,51,91,14,10,24,9,48,21,6,10,103,109
2020,2,22000035,12/27/2020,1610612739,Cleveland Cavaliers,1,1,1610612755,Philadelphia 76ers,0,0,39,29,68,9,14,23,48,43,91,13,3,16,14,32,31,9,16,98,118
2020,2,22000035,12/27/2020,1610612755,Philadelphia 76ers,0,0,1610612739,Cleveland Cavaliers,1,1,21,21,42,12,25,37,33,46,79,16,6,22,13,35,24,13,22,99,94
2016,2,21601180,4/7/2017,1610612748,Miami Heat,0,0,1610612761,Toronto Raptors,1,1,25,35,60,8,15,23,33,50,83,20,9,29,16,39,16,10,19,99,94
2016,2,21601180,4/7/2017,1610612761,Toronto Raptors,1,1,1610612748,Miami Heat,0,0,26,39,65,9,11,20,35,50,85,17,7,24,17,36,14,10,18,99,96
2019,2,21901293,8/10/2020,1610612742,Dallas Mavericks,0,1,1610612762,Utah Jazz,1,0,36,25,61,12,12,24,48,37,85,14,2,16,9,29,29,5,8,93,122
2019,2,21901293,8/10/2020,1610612762,Utah Jazz,1,0,1610612742,Dallas Mavericks,0,1,18,18,36,21,25,46,39,43,82,15,5,20,12,32,28,6,12,92,114
2019,2,21901253,8/3/2020,1610612740,New Orleans Pelicans,1,1,1610612763,Memphis Grizzlies,0,0,26,27,53,11,18,29,37,45,82,24,15,39,11,41,25,3,15,104,109
2019,2,21901253,8/3/2020,1610612763,Memphis Grizzlies,0,0,1610612740,New Orleans Pelicans,1,1,25,25,50,12,31,43,37,56,93,13,2,15,11,46,25,7,14,105,99
2019,2,21901239,8/1/2020,1610612743,Denver Nuggets,1,0,1610612748,Miami Heat,0,1,31,23,54,8,27,35,39,50,89,19,5,24,18,34,28,7,19,99,105
2019,2,21901239,8/1/2020,1610612748,Miami Heat,0,1,1610612743,Denver Nuggets,1,0,27,16,43,13,16,29,40,32,72,32,5,37,7,26,29,7,16,99,125
2019,2,21900914,3/3/2020,1610612756,Phoenix Suns,1,0,1610612761,Toronto Raptors,0,1,24,22,46,15,24,39,39,46,85,21,4,25,9,40,30,9,18,106,114
2019,2,21900914,3/3/2020,1610612761,Toronto Raptors,0,1,1610612756,Phoenix Suns,1,0,26,26,52,14,20,34,40,46,86,29,6,35,12,36,17,6,15,107,123
2019,2,21900827,2/21/2020,1610612739,Cleveland Cavaliers,0,1,1610612764,Washington Wizards,1,0,32,22,54,11,16,27,43,38,81,16,9,25,10,32,19,12,22,103,113
2019,2,21900827,2/21/2020,1610612764,Washington Wizards,1,0,1610612739,Cleveland Cavaliers,0,1,32,37,69,9,28,37,41,65,106,17,6,23,25,42,24,3,12,103,108
2019,2,21900790,2/9/2020,1610612745,Houston Rockets,1,0,1610612762,Utah Jazz,0,1,29,24,53,15,27,42,44,51,95,10,4,14,13,41,20,2,8,98,113
2019,2,21900790,2/9/2020,1610612762,Utah Jazz,0,1,1610612745,Houston Rockets,1,0,27,21,48,15,23,38,42,44,86,15,3,18,14,32,25,10,16,98,114
2019,2,21900766,2/6/2020,1610612749,Milwaukee Bucks,1,1,1610612755,Philadelphia 76ers,0,0,32,25,57,12,25,37,44,50,94,12,6,18,13,42,19,7,14,105,112
2019,2,21900766,2/6/2020,1610612755,Philadelphia 76ers,0,0,1610612749,Milwaukee Bucks,1,1,18,36,54,19,26,45,37,62,99,8,6,14,13,52,24,3,11,104,101
2019,2,21900757,2/5/2020,1610612744,Golden State Warriors,0,0,1610612751,Brooklyn Nets,1,1,30,27,57,5,34,39,35,61,96,13,5,18,10,54,20,4,7,100,88
2019,2,21900757,2/5/2020,1610612751,Brooklyn Nets,1,1,1610612744,Golden State Warriors,0,0,37,29,66,14,20,34,51,49,100,13,2,15,20,30,29,6,15,100,129
2019,2,21900742,2/3/2020,1610612739,Cleveland Cavaliers,1,0,1610612752,New York Knicks,0,1,34,23,57,18,17,35,52,40,92,12,6,18,8,34,34,11,15,109,134
2019,2,21900742,2/3/2020,1610612752,New York Knicks,0,1,1610612739,Cleveland Cavaliers,1,0,47,29,76,10,16,26,57,45,102,15,6,21,17,32,33,6,12,109,139
2018,2,21800641,1/13/2019,1610612745,Houston Rockets,0,0,1610612753,Orlando Magic,1,1,28,16,44,10,32,42,38,48,86,23,4,27,13,37,20,6,10,95,109
2018,2,21800641,1/13/2019,1610612753,Orlando Magic,1,1,1610612745,Houston Rockets,0,0,32,29,61,9,15,24,41,44,85,25,3,28,13,32,25,7,11,95,116
2018,2,21800419,12/13/2018,1610612742,Dallas Mavericks,0,0,1610612756,Phoenix Suns,1,1,26,19,45,5,28,33,31,47,78,22,11,33,19,30,14,15,23,99,89
2018,2,21800419,12/13/2018,1610612756,Phoenix Suns,1,1,1610612742,Dallas Mavericks,0,0,27,38,65,10,17,27,37,55,92,15,3,18,13,43,20,7,13,98,99
2018,2,21800241,11/19/2018,1610612754,Indiana Pacers,1,1,1610612762,Utah Jazz,0,0,37,31,68,12,13,25,49,44,93,11,6,17,15,34,35,6,9,96,121
2016,2,21601179,4/7/2017,1610612737,Atlanta Hawks,0,1,1610612739,Cleveland Cavaliers,1,0,29,23,52,16,21,37,45,44,89,8,0,8,8,36,39,5,11,98,114
2016,2,21601179,4/7/2017,1610612739,Cleveland Cavaliers,1,0,1610612737,Atlanta Hawks,0,1,30,15,45,9,27,36,39,42,81,13,4,17,6,38,23,7,14,98,100
2016,2,21600621,1/16/2017,1610612746,LA Clippers,1,1,1610612760,Oklahoma City Thunder,0,0,33,21,54,12,16,28,45,37,82,18,4,22,11,28,27,10,16,98,120
2016,2,21600621,1/16/2017,1610612760,Oklahoma City Thunder,0,0,1610612746,LA Clippers,1,1,26,29,55,10,20,30,36,49,85,16,3,19,11,40,18,9,15,99,98
2021,2,22100253,11/22/2021,1610612739,Cleveland Cavaliers,1,0,1610612751,Brooklyn Nets,0,1,22,27,49,14,30,44,36,57,93,26,3,29,21,37,24,6,15,103,112
2021,2,22100253,11/22/2021,1610612751,Brooklyn Nets,0,1,1610612739,Cleveland Cavaliers,1,0,34,26,60,11,24,35,45,50,95,16,2,18,11,40,32,6,10,102,117
2016,2,21600159,11/16/2016,1610612740,New Orleans Pelicans,0,0,1610612753,Orlando Magic,1,1,23,38,61,7,14,21,30,52,82,15,4,19,13,40,19,7,18,96,82
2016,2,21600159,11/16/2016,1610612753,Orlando Magic,1,1,1610612740,New Orleans Pelicans,0,0,24,37,61,10,17,27,34,54,88,11,8,19,15,41,17,5,12,96,89
2019,2,21901310,8/13/2020,1610612747,Los Angeles Lakers,1,0,1610612758,Sacramento Kings,0,1,33,30,63,15,20,35,48,50,98,11,4,15,17,35,29,12,17,106,122
2019,2,21901310,8/13/2020,1610612758,Sacramento Kings,0,1,1610612747,Los Angeles Lakers,1,0,33,15,48,21,26,47,54,41,95,7,5,12,11,33,37,6,15,106,136
2019,2,21900297,12/2/2019,1610612749,Milwaukee Bucks,1,1,1610612752,New York Knicks,0,0,32,19,51,16,19,35,48,38,86,20,12,32,13,30,30,4,14,100,132
2019,2,21900297,12/2/2019,1610612752,New York Knicks,0,0,1610612749,Milwaukee Bucks,1,1,18,34,52,10,29,39,28,63,91,22,11,33,16,51,13,7,10,101,88
2018,2,21800909,2/26/2019,1610612738,Boston Celtics,0,0,1610612761,Toronto Raptors,1,1,27,29,56,6,24,30,33,53,86,23,5,28,14,41,24,7,14,99,95
2018,2,21800909,2/26/2019,1610612761,Toronto Raptors,1,1,1610612738,Boston Celtics,0,0,29,29,58,17,19,36,46,48,94,9,5,14,11,39,33,6,9,99,118
2018,2,21800805,2/6/2019,1610612740,New Orleans Pelicans,0,1,1610612741,Chicago Bulls,1,0,30,20,50,15,20,35,45,40,85,20,10,30,16,29,26,8,12,93,125
2020,2,22000939,4/28/2021,1610612757,Portland Trail Blazers,0,1,1610612763,Memphis Grizzlies,1,0,30,22,52,15,25,40,45,47,92,25,3,28,12,37,23,7,10,103,130
2020,2,22000939,4/28/2021,1610612763,Memphis Grizzlies,1,0,1610612757,Portland Trail Blazers,0,1,28,28,56,9,23,32,37,51,88,26,4,30,11,41,26,7,11,103,109
2018,2,21800805,2/6/2019,1610612741,Chicago Bulls,1,0,1610612740,New Orleans Pelicans,0,1,29,26,55,16,20,36,45,46,91,14,5,19,13,35,27,1,8,94,120
2018,2,21800716,1/24/2019,1610612744,Golden State Warriors,0,1,1610612764,Washington Wizards,1,0,43,25,68,7,13,20,50,38,88,19,2,21,8,31,34,7,15,104,126
2018,2,21800716,1/24/2019,1610612764,Washington Wizards,1,0,1610612744,Golden State Warriors,0,1,29,24,53,15,27,42,44,51,95,15,6,21,12,42,29,5,10,104,118
2018,2,21800564,1/3/2019,1610612743,Denver Nuggets,0,1,1610612758,Sacramento Kings,1,0,27,23,50,14,25,39,41,48,89,21,9,30,19,31,24,5,14,97,117
2018,2,21800564,1/3/2019,1610612758,Sacramento Kings,1,0,1610612743,Denver Nuggets,0,1,32,27,59,13,18,31,45,45,90,10,5,15,7,42,25,3,8,97,113
2018,2,21800489,12/23/2018,1610612751,Brooklyn Nets,1,1,1610612756,Phoenix Suns,0,0,30,28,58,10,17,27,40,45,85,21,12,33,19,33,25,10,17,99,111
2018,2,21800489,12/23/2018,1610612756,Phoenix Suns,0,0,1610612751,Brooklyn Nets,1,1,40,32,72,3,14,17,43,46,89,14,2,16,11,36,24,7,13,99,103
2014,2,21400833,2/23/2015,1610612740,New Orleans Pelicans,1,1,1610612761,Toronto Raptors,0,0,30,26,56,10,12,22,40,38,78,10,6,16,14,28,27,12,17,89,100
2014,2,21400833,2/23/2015,1610612761,Toronto Raptors,0,0,1610612740,New Orleans Pelicans,1,1,30,31,61,5,18,23,35,49,84,22,9,31,18,37,13,6,8,91,97
2016,2,21600158,11/16/2016,1610612755,Philadelphia 76ers,1,1,1610612764,Washington Wizards,0,0,32,17,49,10,18,28,42,35,77,15,7,22,7,31,30,8,17,95,109
2016,2,21600158,11/16/2016,1610612764,Washington Wizards,0,0,1610612755,Philadelphia 76ers,1,1,30,38,68,8,15,23,38,53,91,18,6,24,19,38,18,6,11,96,102
2019,2,21900928,3/5/2020,1610612755,Philadelphia 76ers,0,1,1610612758,Sacramento Kings,1,0,30,29,59,17,20,37,47,49,96,14,3,17,16,34,24,7,13,100,125
2019,2,21900928,3/5/2020,1610612758,Sacramento Kings,1,0,1610612755,Philadelphia 76ers,0,1,31,19,50,11,18,29,42,37,79,13,5,18,7,32,23,8,18,101,108
2019,2,21900898,3/1/2020,1610612743,Denver Nuggets,1,1,1610612761,Toronto Raptors,0,0,29,18,47,18,18,36,47,36,83,21,9,30,10,31,38,9,16,102,133
2019,2,21900898,3/1/2020,1610612761,Toronto Raptors,0,0,1610612743,Denver Nuggets,1,1,31,20,51,10,28,38,41,48,89,26,3,29,13,35,24,6,12,102,118
2019,2,21900880,2/28/2020,1610612742,Dallas Mavericks,0,0,1610612748,Miami Heat,1,1,19,15,34,21,29,50,40,44,84,17,2,19,6,40,25,6,11,96,118
2019,2,21900880,2/28/2020,1610612748,Miami Heat,1,1,1610612742,Dallas Mavericks,0,0,24,20,44,17,18,35,41,38,79,27,9,36,10,33,30,0,11,97,126
2019,2,21900837,2/22/2020,1610612737,Atlanta Hawks,1,1,1610612742,Dallas Mavericks,0,0,35,26,61,8,29,37,43,55,98,17,9,26,20,41,27,5,10,101,111
2019,2,21900837,2/22/2020,1610612742,Dallas Mavericks,0,0,1610612737,Atlanta Hawks,1,1,26,19,45,14,30,44,40,49,89,13,6,19,13,40,23,9,16,100,107
2019,2,21900815,2/12/2020,1610612744,Golden State Warriors,0,0,1610612756,Phoenix Suns,1,1,28,18,46,11,20,31,39,38,77,17,2,19,6,34,27,14,22,101,106
2019,2,21900815,2/12/2020,1610612756,Phoenix Suns,1,1,1610612744,Golden State Warriors,0,0,28,26,54,14,23,37,42,49,91,14,1,15,12,38,25,8,14,100,112
2020,2,22000034,12/27/2020,1610612740,New Orleans Pelicans,1,1,1610612759,San Antonio Spurs,0,0,31,39,70,5,19,24,36,58,94,21,8,29,16,48,15,5,8,99,98
2020,2,22000034,12/27/2020,1610612759,San Antonio Spurs,0,0,1610612740,New Orleans Pelicans,1,1,27,26,53,11,25,36,38,51,89,8,0,8,8,43,26,11,15,100,95
2018,2,21801045,3/17/2019,1610612748,Miami Heat,1,1,1610612766,Charlotte Hornets,0,0,21,32,53,13,20,33,34,52,86,12,7,19,17,39,25,6,12,88,93
2018,2,21801045,3/17/2019,1610612766,Charlotte Hornets,0,0,1610612748,Miami Heat,1,1,19,28,47,7,29,36,26,57,83,16,2,18,17,41,11,6,13,88,75
2016,2,21601178,4/6/2017,1610612750,Minnesota Timberwolves,0,0,1610612757,Portland Trail Blazers,1,1,34,35,69,4,14,18,38,49,87,18,2,20,12,39,16,8,13,98,98
2016,2,21601178,4/6/2017,1610612757,Portland Trail Blazers,1,1,1610612750,Minnesota Timberwolves,0,0,21,27,48,14,19,33,35,46,81,21,5,26,8,39,19,7,13,99,105
2016,2,21600620,1/16/2017,1610612756,Phoenix Suns,1,0,1610612762,Utah Jazz,0,1,35,24,59,5,17,22,40,41,81,16,1,17,8,34,13,4,10,91,101
2016,2,21600620,1/16/2017,1610612762,Utah Jazz,0,1,1610612756,Phoenix Suns,1,0,33,33,66,8,15,23,41,48,89,16,8,24,17,34,22,4,8,90,106
2021,2,22100252,11/21/2021,1610612744,Golden State Warriors,1,1,1610612761,Toronto Raptors,0,0,17,17,34,22,23,45,39,40,79,19,5,24,11,30,31,7,16,95,119
2021,2,22100252,11/21/2021,1610612761,Toronto Raptors,0,0,1610612744,Golden State Warriors,1,1,24,38,62,15,22,37,39,60,99,11,9,20,23,42,25,5,11,95,104
2018,2,21801192,4/5/2019,1610612746,LA Clippers,1,0,1610612747,Los Angeles Lakers,0,1,30,32,62,10,19,29,40,51,91,27,4,31,10,42,29,8,13,108,117
2018,2,21801192,4/5/2019,1610612747,Los Angeles Lakers,0,1,1610612746,LA Clippers,1,0,29,35,64,14,18,32,43,53,96,22,5,27,17,39,28,7,14,110,122
2018,2,21801044,3/17/2019,1610612761,Toronto Raptors,0,0,1610612765,Detroit Pistons,1,1,21,25,46,18,18,36,39,43,82,11,3,14,9,36,25,8,12,92,107
2018,2,21801044,3/17/2019,1610612765,Detroit Pistons,1,1,1610612761,Toronto Raptors,0,0,31,25,56,8,19,27,39,44,83,24,3,27,13,32,23,2,10,91,110
2019,2,21900069,11/1/2019,1610612745,Houston Rockets,0,0,1610612751,Brooklyn Nets,1,1,29,22,51,12,36,48,41,58,99,22,5,27,15,46,21,8,12,110,116
2019,2,21900069,11/1/2019,1610612751,Brooklyn Nets,1,1,1610612745,Houston Rockets,0,0,23,30,53,19,13,32,42,43,85,20,8,28,12,33,26,13,22,108,123
2018,2,21800640,1/13/2019,1610612737,Atlanta Hawks,1,0,1610612749,Milwaukee Bucks,0,1,27,31,58,12,26,38,39,57,96,24,6,30,24,36,19,13,24,111,114
2018,2,21800640,1/13/2019,1610612749,Milwaukee Bucks,0,1,1610612737,Atlanta Hawks,1,0,38,24,62,11,19,30,49,43,92,24,9,33,12,37,28,3,14,110,133
2018,2,21800241,11/19/2018,1610612762,Utah Jazz,0,0,1610612754,Indiana Pacers,1,1,25,24,49,11,14,25,36,38,74,11,5,16,6,36,26,13,19,96,94
2018,2,21800188,11/11/2018,1610612738,Boston Celtics,0,0,1610612757,Portland Trail Blazers,1,1,22,29,51,14,28,42,36,57,93,8,2,10,16,41,19,4,13,97,94
2018,2,21800188,11/11/2018,1610612757,Portland Trail Blazers,1,1,1610612738,Boston Celtics,0,0,25,25,50,14,22,36,39,47,86,8,2,10,16,32,22,11,21,96,100
2018,2,21800086,10/28/2018,1610612746,LA Clippers,1,1,1610612764,Washington Wizards,0,0,40,34,74,16,13,29,56,47,103,8,5,13,15,35,35,7,15,107,136
2018,2,21800086,10/28/2018,1610612764,Washington Wizards,0,0,1610612746,LA Clippers,1,1,33,37,70,5,22,27,38,59,97,23,5,28,17,45,18,7,14,107,104
2019,2,21901292,8/10/2020,1610612756,Phoenix Suns,1,1,1610612760,Oklahoma City Thunder,0,0,25,30,55,17,17,34,42,47,89,27,2,29,14,34,29,10,20,108,128
2019,2,21901292,8/10/2020,1610612760,Oklahoma City Thunder,0,0,1610612756,Phoenix Suns,1,1,22,29,51,13,26,39,35,55,90,18,3,21,12,46,24,11,19,109,101
2019,2,21901267,8/5/2020,1610612738,Boston Celtics,1,1,1610612751,Brooklyn Nets,0,0,30,19,49,20,19,39,50,38,88,29,6,35,10,31,29,9,14,109,149
2019,2,21901267,8/5/2020,1610612751,Brooklyn Nets,0,0,1610612738,Boston Celtics,1,1,37,26,63,8,24,32,45,50,95,17,4,21,13,40,23,10,18,108,115
2019,2,21901252,8/3/2020,1610612754,Indiana Pacers,0,1,1610612764,Washington Wizards,1,0,37,29,66,7,19,26,44,48,92,16,0,16,10,38,20,6,10,99,111
2019,2,21901252,8/3/2020,1610612764,Washington Wizards,1,0,1610612754,Indiana Pacers,0,1,30,34,64,11,19,30,41,53,94,7,6,13,14,42,30,6,13,99,100
2020,2,22000033,12/27/2020,1610612753,Orlando Magic,0,1,1610612764,Washington Wizards,1,0,28,32,60,9,16,25,37,48,85,37,1,38,12,36,19,6,10,100,120
2020,2,22000033,12/27/2020,1610612764,Washington Wizards,1,0,1610612753,Orlando Magic,0,1,39,26,65,8,24,32,47,50,97,11,2,13,16,35,27,6,13,101,113
2014,2,21400832,2/23/2015,1610612745,Houston Rockets,1,1,1610612750,Minnesota Timberwolves,0,0,27,29,56,12,26,38,39,55,94,23,11,34,22,39,23,9,16,103,113
2014,2,21400832,2/23/2015,1610612750,Minnesota Timberwolves,0,0,1610612745,Houston Rockets,1,1,26,49,75,5,13,18,31,62,93,35,4,39,28,35,17,11,20,104,102
2016,2,21600157,11/15/2016,1610612747,Los Angeles Lakers,1,1,1610612751,Brooklyn Nets,0,0,32,32,64,9,19,28,41,51,92,34,9,43,19,39,24,8,12,107,125
2016,2,21600157,11/15/2016,1610612751,Brooklyn Nets,0,0,1610612747,Los Angeles Lakers,1,1,33,25,58,12,29,41,45,54,99,16,4,20,15,41,23,9,14,108,118
2023,2,22300966,3/15/2024,1610612762,Utah Jazz,1,1,1610612737,Atlanta Hawks,0,0,32,22,54,14,22,36,46,44,90,18,2,20,12,34,24,7,13,99,124
2021,2,22100251,11/21/2021,1610612743,Denver Nuggets,0,0,1610612756,Phoenix Suns,1,1,22,30,52,11,27,38,33,57,90,20,8,28,16,44,20,7,10,99,97
2021,2,22100251,11/21/2021,1610612756,Phoenix Suns,1,1,1610612743,Denver Nuggets,0,0,35,16,51,11,25,36,46,41,87,23,3,26,11,32,34,5,13,98,126
2018,2,21801191,4/5/2019,1610612739,Cleveland Cavaliers,0,0,1610612744,Golden State Warriors,1,1,36,31,67,7,23,30,43,54,97,21,2,23,18,37,21,2,7,99,114
2018,2,21801191,4/5/2019,1610612744,Golden State Warriors,1,1,1610612739,Cleveland Cavaliers,0,0,26,24,50,20,17,37,46,41,87,8,0,8,4,37,29,9,13,98,120
2018,2,21800908,2/26/2019,1610612752,New York Knicks,1,1,1610612753,Orlando Magic,0,0,31,34,65,7,17,24,38,51,89,25,7,32,16,36,17,6,10,98,108
2018,2,21800908,2/26/2019,1610612753,Orlando Magic,0,0,1610612752,New York Knicks,1,1,28,29,57,11,21,32,39,50,89,14,6,20,16,38,26,11,16,98,103
2018,2,21800804,2/6/2019,1610612743,Denver Nuggets,0,0,1610612751,Brooklyn Nets,1,1,37,27,64,13,22,35,50,49,99,17,4,21,14,37,32,9,13,108,130
2018,2,21800804,2/6/2019,1610612751,Brooklyn Nets,1,1,1610612743,Denver Nuggets,0,0,27,29,56,19,15,34,46,44,90,24,9,33,12,36,36,7,14,106,135
2018,2,21800715,1/23/2019,1610612743,Denver Nuggets,0,0,1610612762,Utah Jazz,1,1,34,27,61,8,19,27,42,46,88,16,4,20,17,31,20,7,16,97,108
2018,2,21800715,1/23/2019,1610612762,Utah Jazz,1,1,1610612743,Denver Nuggets,0,0,19,23,42,19,27,46,38,50,88,19,8,27,17,38,28,7,13,97,114
2018,2,21800353,12/4/2018,1610612756,Phoenix Suns,1,0,1610612758,Sacramento Kings,0,1,26,18,44,12,31,43,38,49,87,17,4,21,17,34,27,13,21,104,105
2018,2,21800353,12/4/2018,1610612758,Sacramento Kings,0,1,1610612756,Phoenix Suns,1,0,34,26,60,11,13,24,45,39,84,21,11,32,11,31,27,9,13,102,122
2016,2,21601177,4/6/2017,1610612737,Atlanta Hawks,1,1,1610612738,Boston Celtics,0,0,33,33,66,11,12,23,44,45,89,24,10,34,21,29,26,9,17,102,123
2016,2,21601177,4/6/2017,1610612738,Boston Celtics,0,0,1610612737,Atlanta Hawks,1,1,22,25,47,15,28,43,37,53,90,27,7,34,15,42,28,7,12,103,116
2016,2,21600619,1/16/2017,1610612739,Cleveland Cavaliers,0,0,1610612744,Golden State Warriors,1,1,22,32,54,9,25,34,31,57,88,20,7,27,9,51,11,10,15,104,91
2016,2,21600619,1/16/2017,1610612744,Golden State Warriors,1,1,1610612739,Cleveland Cavaliers,0,0,31,26,57,15,19,34,46,45,91,19,5,24,16,32,37,7,17,104,126
2016,2,21600156,11/15/2016,1610612741,Chicago Bulls,0,1,1610612757,Portland Trail Blazers,1,0,34,44,78,7,13,20,41,57,98,24,4,28,23,36,16,8,10,99,113
2016,2,21600156,11/15/2016,1610612757,Portland Trail Blazers,1,0,1610612741,Chicago Bulls,0,1,25,36,61,9,25,34,34,61,95,11,7,18,16,50,17,7,11,98,88
2018,2,21800563,1/3/2019,1610612759,San Antonio Spurs,1,1,1610612761,Toronto Raptors,0,0,34,24,58,13,14,27,47,38,85,18,2,20,9,30,32,9,13,98,125
2018,2,21800563,1/3/2019,1610612761,Toronto Raptors,0,0,1610612759,San Antonio Spurs,1,1,33,24,57,6,24,30,39,48,87,23,6,29,13,39,21,7,10,100,107
2018,2,21800488,12/23/2018,1610612738,Boston Celtics,1,1,1610612766,Charlotte Hornets,0,0,30,17,47,13,26,39,43,43,86,20,5,25,15,31,30,9,14,96,119
2018,2,21800488,12/23/2018,1610612766,Charlotte Hornets,0,0,1610612738,Boston Celtics,1,1,30,26,56,8,24,32,38,50,88,19,7,26,15,39,24,8,11,96,103
2018,2,21800418,12/13/2018,1610612741,Chicago Bulls,0,0,1610612753,Orlando Magic,1,1,24,29,53,10,8,18,34,37,71,13,7,20,3,36,18,8,18,95,91
2018,2,21800418,12/13/2018,1610612753,Orlando Magic,1,1,1610612741,Chicago Bulls,0,0,23,26,49,11,22,33,34,48,82,18,5,23,15,35,23,10,16,96,97
2018,2,21800295,11/26/2018,1610612739,Cleveland Cavaliers,1,0,1610612750,Minnesota Timberwolves,0,1,26,29,55,10,21,31,36,50,86,13,1,14,15,35,24,8,17,93,95
2018,2,21800295,11/26/2018,1610612750,Minnesota Timberwolves,0,1,1610612739,Cleveland Cavaliers,1,0,32,28,60,8,18,26,40,46,86,14,5,19,12,34,18,4,9,92,102
2018,2,21800240,11/19/2018,1610612739,Cleveland Cavaliers,0,0,1610612765,Detroit Pistons,1,1,27,31,58,8,13,21,35,44,79,24,10,34,12,37,16,5,10,92,102
2018,2,21800240,11/19/2018,1610612765,Detroit Pistons,1,1,1610612739,Cleveland Cavaliers,0,0,28,23,51,13,25,38,41,48,89,18,1,19,17,31,26,8,12,92,113
2018,2,21800132,11/3/2018,1610612747,Los Angeles Lakers,0,1,1610612757,Portland Trail Blazers,1,0,37,28,65,8,13,21,45,41,86,16,9,25,10,34,20,10,20,107,114
2018,2,21800132,11/3/2018,1610612757,Portland Trail Blazers,1,0,1610612747,Los Angeles Lakers,0,1,38,31,69,6,29,35,44,60,104,16,6,22,20,44,20,9,14,108,110
2020,2,22000938,4/28/2021,1610612748,Miami Heat,1,1,1610612759,San Antonio Spurs,0,0,34,26,60,9,16,25,43,42,85,21,3,24,10,34,26,6,13,97,116
2020,2,22000938,4/28/2021,1610612759,San Antonio Spurs,0,0,1610612748,Miami Heat,1,1,31,25,56,10,22,32,41,47,88,19,5,24,10,40,26,4,9,98,111
2020,2,22000032,12/27/2020,1610612751,Brooklyn Nets,0,0,1610612766,Charlotte Hornets,1,1,18,17,35,17,30,47,35,47,82,17,8,25,11,40,23,8,19,104,104
2020,2,22000032,12/27/2020,1610612766,Charlotte Hornets,1,1,1610612751,Brooklyn Nets,0,0,33,29,62,10,24,34,43,53,96,10,7,17,16,42,35,4,15,103,106
2021,2,22100250,11/21/2021,1610612741,Chicago Bulls,1,1,1610612752,New York Knicks,0,0,26,33,59,11,18,29,37,51,88,24,3,27,18,35,21,4,10,94,109
2021,2,22100250,11/21/2021,1610612752,New York Knicks,0,0,1610612741,Chicago Bulls,1,1,28,29,57,7,20,27,35,49,84,26,5,31,16,35,16,5,14,96,103
2016,2,21600155,11/15/2016,1610612750,Minnesota Timberwolves,1,0,1610612766,Charlotte Hornets,0,1,23,31,54,15,20,35,38,51,89,17,4,21,19,35,25,10,18,98,108
2016,2,21600155,11/15/2016,1610612766,Charlotte Hornets,0,1,1610612750,Minnesota Timberwolves,1,0,32,24,56,11,13,24,43,37,80,18,4,22,7,30,25,4,13,98,115
2014,2,21400831,2/23/2015,1610612741,Chicago Bulls,1,1,1610612749,Milwaukee Bucks,0,0,19,31,50,8,18,26,27,49,76,25,7,32,21,31,20,9,19,91,87
2014,2,21400831,2/23/2015,1610612749,Milwaukee Bucks,0,0,1610612741,Chicago Bulls,1,1,26,45,71,4,14,18,30,59,89,7,6,13,14,48,16,4,10,92,71
2019,2,21901309,8/13/2020,1610612751,Brooklyn Nets,1,0,1610612757,Portland Trail Blazers,0,1,39,24,63,14,19,33,53,43,96,13,6,19,16,31,28,10,14,103,133
2019,2,21901309,8/13/2020,1610612757,Portland Trail Blazers,0,1,1610612751,Brooklyn Nets,1,0,37,28,65,13,26,39,50,54,104,21,3,24,21,35,25,5,9,103,134
2019,2,21900967,3/10/2020,1610612744,Golden State Warriors,1,0,1610612746,LA Clippers,0,1,26,15,41,11,27,38,37,42,79,22,5,27,5,39,25,5,10,98,107
2019,2,21900967,3/10/2020,1610612746,LA Clippers,0,1,1610612744,Golden State Warriors,1,0,26,22,48,20,24,44,46,46,92,19,0,19,13,33,28,3,11,99,131
2019,2,21900953,3/8/2020,1610612745,Houston Rockets,1,0,1610612753,Orlando Magic,0,1,30,26,56,9,23,32,39,49,88,19,6,25,14,37,21,11,18,102,106
2019,2,21900953,3/8/2020,1610612753,Orlando Magic,0,1,1610612745,Houston Rockets,1,0,31,31,62,13,16,29,44,47,91,25,6,31,17,32,21,10,15,104,126
2019,2,21900296,12/2/2019,1610612754,Indiana Pacers,0,1,1610612763,Memphis Grizzlies,1,0,28,22,50,16,22,38,44,44,88,13,2,15,11,33,31,5,15,98,117
2019,2,21900296,12/2/2019,1610612763,Memphis Grizzlies,1,0,1610612754,Indiana Pacers,0,1,28,23,51,10,28,38,38,51,89,18,1,19,11,40,23,4,12,99,104
2018,2,21801043,3/17/2019,1610612749,Milwaukee Bucks,1,0,1610612755,Philadelphia 76ers,0,1,27,18,45,16,34,50,43,52,95,23,5,28,11,43,25,8,10,105,125
2018,2,21801043,3/17/2019,1610612755,Philadelphia 76ers,0,1,1610612749,Milwaukee Bucks,1,0,32,36,68,15,17,32,47,53,100,21,9,30,21,36,26,9,13,106,130
2020,2,22000937,4/28/2021,1610612741,Chicago Bulls,0,0,1610612752,New York Knicks,1,1,29,27,56,10,19,29,39,46,85,6,4,10,10,37,29,10,14,93,94
2020,2,22000937,4/28/2021,1610612752,New York Knicks,1,1,1610612741,Chicago Bulls,0,0,30,34,64,12,15,27,42,49,91,17,2,19,12,39,27,2,4,91,113
2018,2,21800352,12/4/2018,1610612742,Dallas Mavericks,1,1,1610612757,Portland Trail Blazers,0,0,27,31,58,11,19,30,38,50,88,24,11,35,18,38,25,7,13,100,111
2018,2,21800352,12/4/2018,1610612757,Portland Trail Blazers,0,0,1610612742,Dallas Mavericks,1,1,31,29,60,7,17,24,38,46,84,19,4,23,12,37,20,11,19,101,102
2018,2,21800294,11/26/2018,1610612749,Milwaukee Bucks,0,0,1610612766,Charlotte Hornets,1,1,21,23,44,16,30,46,37,53,90,17,4,21,15,41,25,9,16,101,107
2018,2,21800294,11/26/2018,1610612766,Charlotte Hornets,1,1,1610612749,Milwaukee Bucks,0,0,25,27,52,13,16,29,38,43,81,21,9,30,7,39,21,7,11,101,110
2018,2,21800187,11/11/2018,1610612743,Denver Nuggets,1,0,1610612749,Milwaukee Bucks,0,1,23,28,51,18,20,38,41,48,89,14,6,20,12,38,27,10,10,97,114
2018,2,21800187,11/11/2018,1610612749,Milwaukee Bucks,0,1,1610612743,Denver Nuggets,1,0,31,19,50,17,17,34,48,36,84,8,5,13,6,33,27,8,13,96,121
2017,2,21701204,4/9/2018,1610612761,Toronto Raptors,0,1,1610612765,Detroit Pistons,1,0,34,14,48,12,27,39,46,41,87,4,0,4,11,30,27,7,10,90,108
2017,2,21701204,4/9/2018,1610612765,Detroit Pistons,1,0,1610612761,Toronto Raptors,0,1,26,22,48,9,21,30,35,43,78,19,6,25,6,41,22,3,6,89,98
2017,2,21701121,3/28/2018,1610612738,Boston Celtics,0,1,1610612762,Utah Jazz,1,0,23,35,58,12,9,21,35,44,79,15,5,20,14,34,20,7,18,93,97
2017,2,21701121,3/28/2018,1610612762,Utah Jazz,1,0,1610612738,Boston Celtics,0,1,25,24,49,9,24,33,34,48,82,17,4,21,16,33,25,11,16,94,94
2020,2,22000031,12/27/2020,1610612742,Dallas Mavericks,0,1,1610612746,LA Clippers,1,0,29,17,46,14,27,41,43,44,87,24,3,27,14,32,25,2,8,93,124
2016,2,21601176,4/6/2017,1610612752,New York Knicks,1,0,1610612764,Washington Wizards,0,1,33,42,75,7,13,20,40,55,95,16,5,21,26,31,20,5,13,90,103
2016,2,21601176,4/6/2017,1610612764,Washington Wizards,0,1,1610612752,New York Knicks,1,0,22,18,40,14,20,34,36,38,74,20,8,28,13,30,17,9,14,90,106
2016,2,21600618,1/16/2017,1610612738,Boston Celtics,1,1,1610612766,Charlotte Hornets,0,0,27,18,45,15,24,39,42,42,84,9,1,10,9,34,29,4,12,92,108
2020,2,22000031,12/27/2020,1610612746,LA Clippers,1,0,1610612742,Dallas Mavericks,0,1,22,21,43,4,29,33,26,50,76,17,3,20,7,43,13,10,14,93,73
2018,2,21801190,4/5/2019,1610612743,Denver Nuggets,1,1,1610612757,Portland Trail Blazers,0,0,36,21,57,7,20,27,43,41,84,26,3,29,14,30,27,6,10,94,119
2018,2,21801190,4/5/2019,1610612757,Portland Trail Blazers,0,0,1610612743,Denver Nuggets,1,1,32,25,57,10,19,29,42,44,86,16,4,20,17,30,24,10,15,94,110
2019,2,21900068,10/31/2019,1610612746,LA Clippers,1,1,1610612759,San Antonio Spurs,0,0,34,31,65,5,21,26,39,52,91,20,7,27,15,42,16,6,12,99,103
2019,2,21900068,10/31/2019,1610612759,San Antonio Spurs,0,0,1610612746,LA Clippers,1,1,29,30,59,7,14,21,36,44,80,18,9,27,12,36,15,9,19,101,97
2018,2,21800907,2/25/2019,1610612742,Dallas Mavericks,0,0,1610612746,LA Clippers,1,1,23,17,40,14,22,36,37,39,76,24,3,27,9,33,28,11,17,96,112
2018,2,21800907,2/25/2019,1610612746,LA Clippers,1,1,1610612742,Dallas Mavericks,0,0,28,27,55,17,28,45,45,55,100,14,4,18,17,40,33,3,6,97,121
2018,2,21800714,1/23/2019,1610612740,New Orleans Pelicans,1,0,1610612765,Detroit Pistons,0,1,36,33,69,6,16,22,42,49,91,4,5,9,10,42,20,5,12,96,94
2018,2,21800714,1/23/2019,1610612765,Detroit Pistons,0,1,1610612740,New Orleans Pelicans,1,0,23,27,50,13,26,39,36,53,89,13,6,19,13,44,24,3,9,95,98
2018,2,21800639,1/13/2019,1610612761,Toronto Raptors,0,1,1610612764,Washington Wizards,1,0,36,32,68,13,23,36,49,55,104,29,7,36,22,37,24,11,23,123,140
2018,2,21800639,1/13/2019,1610612764,Washington Wizards,1,0,1610612761,Toronto Raptors,0,1,35,39,74,19,25,44,54,64,118,11,7,18,24,44,36,16,20,121,138
2020,2,22000030,12/26/2020,1610612756,Phoenix Suns,0,0,1610612758,Sacramento Kings,1,1,30,24,54,11,33,44,41,57,98,10,3,13,13,45,25,4,11,101,103
2020,2,22000030,12/26/2020,1610612758,Sacramento Kings,1,1,1610612756,Phoenix Suns,0,0,34,29,63,5,18,23,39,47,86,23,10,33,17,35,20,8,18,101,106
2016,2,21600618,1/16/2017,1610612766,Charlotte Hornets,0,0,1610612738,Boston Celtics,1,1,30,31,61,8,17,25,38,48,86,14,3,17,13,37,25,6,11,92,98
2018,2,21800906,2/25/2019,1610612740,New Orleans Pelicans,1,0,1610612755,Philadelphia 76ers,0,1,39,37,76,5,23,28,44,60,104,17,7,24,18,44,29,9,14,112,110
2018,2,21800906,2/25/2019,1610612755,Philadelphia 76ers,0,1,1610612740,New Orleans Pelicans,1,0,34,36,70,10,21,31,44,57,101,13,6,19,18,42,23,15,20,112,111
2018,2,21800803,2/5/2019,1610612748,Miami Heat,0,1,1610612757,Portland Trail Blazers,1,0,38,23,61,7,15,22,45,38,83,21,4,25,10,29,18,6,12,97,118
2020,2,22000029,12/26/2020,1610612745,Houston Rockets,0,0,1610612757,Portland Trail Blazers,1,1,34,18,52,11,24,35,45,42,87,25,7,32,12,34,27,10,16,107,126
2020,2,22000029,12/26/2020,1610612757,Portland Trail Blazers,1,1,1610612745,Houston Rockets,0,0,28,29,57,19,26,45,47,55,102,15,8,23,22,37,27,5,14,107,128
2014,2,21400830,2/23/2015,1610612748,Miami Heat,1,1,1610612755,Philadelphia 76ers,0,0,35,27,62,11,10,21,46,37,83,16,6,22,13,26,27,10,17,98,119
2014,2,21400830,2/23/2015,1610612755,Philadelphia 76ers,0,0,1610612748,Miami Heat,1,1,27,26,53,13,18,31,40,44,84,15,13,28,11,41,27,6,12,98,108
2016,2,21600154,11/15/2016,1610612737,Atlanta Hawks,0,1,1610612748,Miami Heat,1,0,31,32,63,6,11,17,37,43,80,13,6,19,11,35,18,11,21,99,93
2016,2,21600154,11/15/2016,1610612748,Miami Heat,1,0,1610612737,Atlanta Hawks,0,1,29,37,66,7,16,23,36,53,89,11,3,14,22,32,13,14,23,99,90
2018,2,21801042,3/17/2019,1610612747,Los Angeles Lakers,0,0,1610612752,New York Knicks,1,1,40,30,70,7,20,27,47,50,97,22,6,28,16,36,26,4,10,101,123
2018,2,21801042,3/17/2019,1610612752,New York Knicks,1,1,1610612747,Los Angeles Lakers,0,0,32,18,50,12,14,26,44,32,76,24,5,29,12,22,24,12,24,101,124
2019,2,21900295,12/2/2019,1610612737,Atlanta Hawks,1,1,1610612744,Golden State Warriors,0,0,33,27,60,8,21,29,41,48,89,14,1,15,17,32,21,11,15,95,104
2019,2,21900295,12/2/2019,1610612744,Golden State Warriors,0,0,1610612737,Atlanta Hawks,1,1,30,36,66,3,14,17,33,50,83,10,2,12,20,30,17,13,25,93,79
2018,2,21800803,2/5/2019,1610612757,Portland Trail Blazers,1,0,1610612748,Miami Heat,0,1,27,27,54,15,24,39,42,51,93,9,3,12,12,41,30,11,13,98,108
2017,2,21701225,4/11/2018,1610612743,Denver Nuggets,0,0,1610612750,Minnesota Timberwolves,1,1,28,30,58,13,19,32,41,49,90,11,7,18,15,37,19,10,15,98,106
2017,2,21701225,4/11/2018,1610612750,Minnesota Timberwolves,1,1,1610612743,Denver Nuggets,0,0,33,33,66,9,14,23,42,47,89,19,6,25,12,38,24,4,8,99,112
2020,2,22000028,12/26/2020,1610612750,Minnesota Timberwolves,0,1,1610612762,Utah Jazz,1,0,32,40,72,13,16,29,45,56,101,13,5,18,17,42,21,5,10,103,116
2020,2,22000028,12/26/2020,1610612762,Utah Jazz,1,0,1610612750,Minnesota Timberwolves,0,1,26,34,60,10,24,34,36,58,94,29,8,37,27,33,15,9,19,104,111
2019,2,21900940,3/7/2020,1610612745,Houston Rockets,0,0,1610612766,Charlotte Hornets,1,1,20,11,31,15,30,45,35,41,76,14,6,20,15,28,22,7,21,91,99
2019,2,21900940,3/7/2020,1610612766,Charlotte Hornets,1,1,1610612745,Houston Rockets,0,0,22,16,38,15,17,32,37,33,70,19,6,25,7,29,29,9,17,92,108
2019,2,21900858,2/25/2020,1610612749,Milwaukee Bucks,0,1,1610612761,Toronto Raptors,1,0,18,24,42,14,28,42,32,52,84,30,6,36,13,40,23,4,14,104,108
2019,2,21900858,2/25/2020,1610612761,Toronto Raptors,1,0,1610612749,Milwaukee Bucks,0,1,14,25,39,18,34,52,32,59,91,15,6,21,14,47,21,10,17,104,97
2019,2,21900848,2/23/2020,1610612757,Portland Trail Blazers,1,1,1610612765,Detroit Pistons,0,0,28,26,54,13,17,30,41,43,84,12,7,19,10,36,20,7,10,93,107
2019,2,21900848,2/23/2020,1610612765,Detroit Pistons,0,0,1610612757,Portland Trail Blazers,1,1,26,25,51,11,24,35,37,49,86,19,1,20,12,37,18,6,11,94,104
2019,2,21900806,2/11/2020,1610612738,Boston Celtics,0,0,1610612745,Houston Rockets,1,1,26,27,53,11,21,32,37,48,85,20,5,25,11,40,24,9,18,104,105
2019,2,21900806,2/11/2020,1610612745,Houston Rockets,1,1,1610612738,Boston Celtics,0,0,20,12,32,13,32,45,33,44,77,37,5,42,6,41,17,11,14,104,116
2019,2,21900734,2/1/2020,1610612759,San Antonio Spurs,1,1,1610612766,Charlotte Hornets,0,0,35,24,59,10,18,28,45,42,87,14,7,21,11,34,27,5,12,97,114
2019,2,21900734,2/1/2020,1610612766,Charlotte Hornets,0,0,1610612759,San Antonio Spurs,1,1,25,22,47,10,26,36,35,48,83,10,2,12,11,38,29,13,17,97,90
2019,2,21900721,1/31/2020,1610612741,Chicago Bulls,0,0,1610612751,Brooklyn Nets,1,1,30,22,52,12,22,34,42,44,86,22,4,26,12,32,27,8,14,102,118
2019,2,21900721,1/31/2020,1610612751,Brooklyn Nets,1,1,1610612741,Chicago Bulls,0,0,35,14,49,15,16,31,50,30,80,18,7,25,7,27,31,7,20,102,133
2019,2,21900711,1/29/2020,1610612759,San Antonio Spurs,1,1,1610612762,Utah Jazz,0,0,38,13,51,8,23,31,46,36,82,27,3,30,5,32,23,4,9,100,127
2019,2,21900711,1/29/2020,1610612762,Utah Jazz,0,0,1610612759,San Antonio Spurs,1,1,23,23,46,14,24,38,37,47,84,32,14,46,20,33,18,5,13,102,120
2023,2,22300966,3/15/2024,1610612737,Atlanta Hawks,0,0,1610612762,Utah Jazz,1,1,21,32,53,20,19,39,41,51,92,20,7,27,13,41,32,6,9,100,122
2019,2,21900702,1/28/2020,1610612744,Golden State Warriors,0,0,1610612755,Philadelphia 76ers,1,1,22,25,47,15,25,40,37,50,87,15,6,21,7,48,29,5,14,104,104
2019,2,21900702,1/28/2020,1610612755,Philadelphia 76ers,1,1,1610612744,Golden State Warriors,0,0,31,19,50,11,21,32,42,40,82,20,6,26,6,38,28,6,16,104,115
2019,2,21900698,1/27/2020,1610612745,Houston Rockets,0,1,1610612762,Utah Jazz,1,0,23,18,41,15,25,40,38,43,81,35,14,49,11,39,14,7,17,108,126
2019,2,21900698,1/27/2020,1610612762,Utah Jazz,1,0,1610612745,Houston Rockets,0,1,31,12,43,12,30,42,43,42,85,19,7,26,8,36,24,11,18,109,117
2019,2,21900693,1/27/2020,1610612739,Cleveland Cavaliers,0,1,1610612765,Detroit Pistons,1,0,39,33,72,9,15,24,48,48,96,10,3,13,17,33,25,8,14,99,115
2019,2,21900693,1/27/2020,1610612765,Detroit Pistons,1,0,1610612739,Cleveland Cavaliers,0,1,26,23,49,12,23,35,38,46,84,12,5,17,12,36,18,9,18,98,100
2019,2,21900687,1/26/2020,1610612737,Atlanta Hawks,1,1,1610612764,Washington Wizards,0,0,39,19,58,15,20,35,54,39,93,29,5,34,13,29,30,5,16,109,152
2019,2,21900687,1/26/2020,1610612764,Washington Wizards,0,0,1610612737,Atlanta Hawks,1,1,31,24,55,11,22,33,42,46,88,38,4,42,8,39,20,7,11,109,133
2016,2,21601175,4/6/2017,1610612749,Milwaukee Bucks,0,0,1610612754,Indiana Pacers,1,1,22,25,47,11,13,24,33,38,71,12,2,14,7,32,21,15,21,92,89
2016,2,21601175,4/6/2017,1610612754,Indiana Pacers,1,1,1610612749,Milwaukee Bucks,0,0,30,25,55,8,17,25,38,42,80,20,6,26,18,26,20,8,17,93,104
2016,2,21600617,1/16/2017,1610612743,Denver Nuggets,1,1,1610612753,Orlando Magic,0,0,43,19,62,9,18,27,52,37,89,12,3,15,10,29,33,6,15,102,125
2016,2,21600617,1/16/2017,1610612753,Orlando Magic,0,0,1610612743,Denver Nuggets,1,1,37,26,63,8,17,25,45,43,88,14,4,18,10,35,28,11,14,101,112
2016,2,21601174,4/6/2017,1610612751,Brooklyn Nets,0,0,1610612753,Orlando Magic,1,1,29,28,57,11,19,30,40,47,87,16,6,22,9,41,21,9,14,101,107
2016,2,21601174,4/6/2017,1610612753,Orlando Magic,1,1,1610612751,Brooklyn Nets,0,0,33,32,65,9,16,25,42,48,90,22,4,26,16,33,24,7,14,102,115
2019,2,21900067,10/31/2019,1610612740,New Orleans Pelicans,1,1,1610612743,Denver Nuggets,0,0,26,18,44,15,18,33,41,36,77,25,7,32,7,33,30,5,16,103,122
2019,2,21900067,10/31/2019,1610612743,Denver Nuggets,0,0,1610612740,New Orleans Pelicans,1,1,36,27,63,7,19,26,43,46,89,14,2,16,9,38,24,7,15,102,107
2018,2,21801189,4/5/2019,1610612740,New Orleans Pelicans,0,0,1610612756,Phoenix Suns,1,1,41,37,78,8,15,23,49,52,101,20,7,27,22,35,28,12,15,105,126
2018,2,21801189,4/5/2019,1610612756,Phoenix Suns,1,1,1610612740,New Orleans Pelicans,0,0,37,31,68,14,22,36,51,53,104,17,4,21,17,38,27,4,7,105,133
2018,2,21800562,1/2/2019,1610612747,Los Angeles Lakers,1,0,1610612760,Oklahoma City Thunder,0,1,30,32,62,7,20,27,37,52,89,19,13,32,11,48,24,8,17,111,100
2018,2,21800562,1/2/2019,1610612760,Oklahoma City Thunder,0,1,1610612747,Los Angeles Lakers,1,0,33,41,74,7,24,31,40,65,105,20,11,31,21,48,22,8,11,111,107
2018,2,21800417,12/13/2018,1610612746,LA Clippers,0,0,1610612759,San Antonio Spurs,1,1,20,33,53,10,21,31,30,54,84,17,7,24,17,40,21,10,17,98,87
2018,2,21800417,12/13/2018,1610612759,San Antonio Spurs,1,1,1610612746,LA Clippers,0,0,38,23,61,10,12,22,48,35,83,19,5,24,9,29,25,4,11,97,125
2021,2,22100249,11/21/2021,1610612747,Los Angeles Lakers,0,1,1610612765,Detroit Pistons,1,0,35,26,61,10,21,31,45,47,92,21,6,27,15,33,29,7,13,104,121
2021,2,22100249,11/21/2021,1610612765,Detroit Pistons,1,0,1610612747,Los Angeles Lakers,0,1,29,28,57,14,26,40,43,54,97,16,5,21,14,40,27,7,11,104,116
2020,2,22000936,4/28/2021,1610612738,Boston Celtics,1,1,1610612766,Charlotte Hornets,0,0,29,23,52,15,25,40,44,48,92,17,5,22,22,27,26,7,14,96,120
2020,2,22000936,4/28/2021,1610612766,Charlotte Hornets,0,0,1610612738,Boston Celtics,1,1,24,28,52,13,22,35,37,50,87,24,8,32,16,39,29,9,11,96,111
2020,2,22000027,12/26/2020,1610612759,San Antonio Spurs,1,1,1610612761,Toronto Raptors,0,0,33,33,66,14,20,34,47,53,100,11,5,16,19,36,36,8,16,103,119
2020,2,22000027,12/26/2020,1610612761,Toronto Raptors,0,0,1610612759,San Antonio Spurs,1,1,29,26,55,15,26,41,44,52,96,11,4,15,13,40,32,4,12,104,114
2014,2,21400829,2/22/2015,1610612738,Boston Celtics,0,0,1610612747,Los Angeles Lakers,1,1,34,31,65,8,25,33,42,56,98,19,8,27,17,42,27,8,18,110,111
2014,2,21400829,2/22/2015,1610612747,Los Angeles Lakers,1,1,1610612738,Boston Celtics,0,0,36,30,66,7,11,18,43,41,84,25,13,38,11,36,22,9,18,108,118
2016,2,21600153,11/15/2016,1610612739,Cleveland Cavaliers,1,1,1610612761,Toronto Raptors,0,0,31,19,50,13,20,33,44,39,83,20,8,28,13,30,26,11,17,98,121
2016,2,21600153,11/15/2016,1610612761,Toronto Raptors,0,0,1610612739,Cleveland Cavaliers,1,1,33,34,67,13,16,29,46,50,96,12,6,18,15,37,24,4,8,99,117
2018,2,21800905,2/25/2019,1610612750,Minnesota Timberwolves,1,1,1610612758,Sacramento Kings,0,0,34,18,52,8,23,31,42,41,83,20,8,28,8,36,23,13,22,112,112
2018,2,21800905,2/25/2019,1610612758,Sacramento Kings,0,0,1610612750,Minnesota Timberwolves,1,1,28,41,69,9,17,26,37,58,95,22,7,29,18,44,20,10,20,112,105
2018,2,21800085,10/28/2018,1610612756,Phoenix Suns,0,0,1610612760,Oklahoma City Thunder,1,1,30,29,59,8,19,27,38,48,86,26,1,27,13,35,21,16,22,108,110
2018,2,21800085,10/28/2018,1610612760,Oklahoma City Thunder,1,1,1610612756,Phoenix Suns,0,0,36,25,61,7,17,24,43,42,85,24,11,35,10,35,22,10,15,108,117
2016,2,21601173,4/6/2017,1610612741,Chicago Bulls,0,1,1610612755,Philadelphia 76ers,1,0,31,35,66,8,17,25,39,52,91,16,1,17,13,40,27,10,17,103,102
2016,2,21601173,4/6/2017,1610612755,Philadelphia 76ers,1,0,1610612741,Chicago Bulls,0,1,26,32,58,7,26,33,33,58,91,17,5,22,11,49,19,7,13,101,90
2016,2,21600616,1/16/2017,1610612740,New Orleans Pelicans,0,0,1610612754,Indiana Pacers,1,1,26,32,58,10,15,25,36,47,83,13,5,18,10,41,18,11,14,96,95
2016,2,21600616,1/16/2017,1610612754,Indiana Pacers,1,1,1610612740,New Orleans Pelicans,0,0,36,26,62,5,14,19,41,40,81,11,5,16,9,32,26,7,16,96,98
2019,2,21900294,12/2/2019,1610612755,Philadelphia 76ers,1,1,1610612762,Utah Jazz,0,0,24,41,65,13,13,26,37,54,91,16,7,23,16,42,24,6,15,104,103
2019,2,21900294,12/2/2019,1610612762,Utah Jazz,0,0,1610612755,Philadelphia 76ers,1,1,33,26,59,5,17,22,38,43,81,13,7,20,7,40,23,12,20,103,94
2014,2,21400828,2/22/2015,1610612757,Portland Trail Blazers,1,0,1610612763,Memphis Grizzlies,0,1,20,29,49,13,20,33,33,49,82,13,3,16,11,39,24,13,15,93,92
2021,2,22100248,11/21/2021,1610612742,Dallas Mavericks,0,0,1610612746,LA Clippers,1,1,28,25,53,6,24,30,34,49,83,17,1,18,12,37,21,5,10,91,91
2021,2,22100248,11/21/2021,1610612746,LA Clippers,1,1,1610612742,Dallas Mavericks,0,0,24,22,46,12,17,29,36,39,75,13,5,18,10,32,18,6,15,89,97
2014,2,21400828,2/22/2015,1610612763,Memphis Grizzlies,0,1,1610612757,Portland Trail Blazers,1,0,39,41,80,3,6,9,42,47,89,11,2,13,10,38,20,4,7,92,98
2018,2,21801041,3/16/2019,1610612751,Brooklyn Nets,0,0,1610612762,Utah Jazz,1,1,21,38,59,12,24,36,33,62,95,20,2,22,11,52,20,3,7,104,98
2018,2,21801041,3/16/2019,1610612762,Utah Jazz,1,1,1610612751,Brooklyn Nets,0,0,26,29,55,13,23,36,39,52,91,23,8,31,19,36,24,9,15,103,114
2018,2,21800802,2/5/2019,1610612753,Orlando Magic,0,0,1610612760,Oklahoma City Thunder,1,1,31,22,53,11,26,37,42,48,90,27,7,34,9,44,27,11,18,114,122
2018,2,21800802,2/5/2019,1610612760,Oklahoma City Thunder,1,1,1610612753,Orlando Magic,0,0,33,29,62,13,17,30,46,46,92,27,10,37,14,36,25,13,17,114,132
2018,2,21800638,1/13/2019,1610612752,New York Knicks,1,0,1610612755,Philadelphia 76ers,0,1,27,28,55,10,21,31,37,49,86,21,9,30,8,46,24,4,10,101,105
2018,2,21800638,1/13/2019,1610612755,Philadelphia 76ers,0,1,1610612752,New York Knicks,1,0,34,33,67,6,14,20,40,47,87,22,8,30,18,31,22,8,17,101,108
2018,2,21800487,12/23/2018,1610612754,Indiana Pacers,1,1,1610612764,Washington Wizards,0,0,34,33,67,9,21,30,43,54,97,10,2,12,18,37,24,8,17,102,105
2018,2,21800487,12/23/2018,1610612764,Washington Wizards,0,0,1610612754,Indiana Pacers,1,1,19,22,41,9,26,35,28,48,76,24,2,26,8,41,21,12,22,102,89
2018,2,21800416,12/13/2018,1610612745,Houston Rockets,1,1,1610612747,Los Angeles Lakers,0,0,27,24,51,15,19,34,42,43,85,27,5,32,19,26,24,9,14,94,126
2018,2,21800416,12/13/2018,1610612747,Los Angeles Lakers,0,0,1610612745,Houston Rockets,1,1,33,15,48,10,22,32,43,37,80,15,12,27,10,31,23,8,13,95,111
2018,2,21800293,11/25/2018,1610612746,LA Clippers,0,1,1610612757,Portland Trail Blazers,1,0,33,32,65,5,20,25,38,52,90,23,11,34,14,43,15,2,4,95,104
2018,2,21800293,11/25/2018,1610612757,Portland Trail Blazers,1,0,1610612746,LA Clippers,0,1,34,25,59,8,30,38,42,55,97,8,2,10,17,39,18,9,12,96,100
2018,2,21800239,11/19/2018,1610612738,Boston Celtics,0,0,1610612766,Charlotte Hornets,1,1,36,21,57,9,23,32,45,44,89,13,5,18,9,37,31,5,12,100,112
2018,2,21800239,11/19/2018,1610612766,Charlotte Hornets,1,1,1610612738,Boston Celtics,0,0,28,20,48,15,26,41,43,46,89,16,6,22,13,37,18,9,14,101,117
2018,2,21800186,11/11/2018,1610612752,New York Knicks,1,0,1610612753,Orlando Magic,0,1,26,34,60,5,23,28,31,57,88,22,8,30,18,43,13,10,19,103,89
2020,2,22000935,4/28/2021,1610612747,Los Angeles Lakers,0,0,1610612764,Washington Wizards,1,1,32,30,62,10,24,34,42,54,96,13,8,21,14,44,31,6,10,100,107
2020,2,22000935,4/28/2021,1610612764,Washington Wizards,1,1,1610612747,Los Angeles Lakers,0,0,41,31,72,6,12,18,47,43,90,16,5,21,13,31,24,10,14,100,116
2018,2,21800186,11/11/2018,1610612753,Orlando Magic,0,1,1610612752,New York Knicks,1,0,27,29,56,17,25,42,44,54,98,10,1,11,11,43,31,4,11,102,115
2020,2,22000026,12/26/2020,1610612741,Chicago Bulls,1,0,1610612754,Indiana Pacers,0,1,18,34,52,16,23,39,34,57,91,22,3,25,17,41,23,15,20,107,106
2020,2,22000026,12/26/2020,1610612754,Indiana Pacers,0,1,1610612741,Chicago Bulls,1,0,43,24,67,9,17,26,52,41,93,12,7,19,11,33,34,7,16,107,125
2016,2,21601172,4/5/2017,1610612742,Dallas Mavericks,0,0,1610612746,LA Clippers,1,1,27,28,55,11,20,31,38,48,86,14,4,18,13,37,24,11,16,95,101
2016,2,21601172,4/5/2017,1610612746,LA Clippers,1,1,1610612742,Dallas Mavericks,0,0,26,18,44,12,19,31,38,37,75,24,7,31,9,33,22,5,15,96,112
2023,2,22300857,3/1/2024,1610612739,Cleveland Cavaliers,0,1,1610612765,Detroit Pistons,1,0,15,27,42,18,23,41,33,50,83,26,4,30,17,35,25,10,16,98,110
2018,2,21801188,4/5/2019,1610612758,Sacramento Kings,0,0,1610612762,Utah Jazz,1,1,33,38,71,5,16,21,38,54,92,17,8,25,17,39,17,9,18,105,98
2018,2,21801188,4/5/2019,1610612762,Utah Jazz,1,1,1610612758,Sacramento Kings,0,0,29,23,52,15,18,33,44,41,85,16,9,25,9,36,30,7,16,104,119
2016,2,21600152,11/14/2016,1610612746,LA Clippers,1,1,1610612751,Brooklyn Nets,0,0,34,31,65,14,11,25,48,42,90,17,4,21,12,30,32,6,12,100,127
2016,2,21600152,11/14/2016,1610612751,Brooklyn Nets,0,0,1610612746,LA Clippers,1,1,24,20,44,10,23,33,34,43,77,17,5,22,14,34,18,17,22,99,95
2018,2,21800561,1/2/2019,1610612755,Philadelphia 76ers,0,1,1610612756,Phoenix Suns,1,0,29,21,50,11,13,24,40,34,74,41,13,54,11,29,27,10,18,108,132
2018,2,21800561,1/2/2019,1610612756,Phoenix Suns,1,0,1610612755,Philadelphia 76ers,0,1,32,29,61,11,23,34,43,52,95,30,6,36,18,38,22,9,15,109,127
2018,2,21800351,12/4/2018,1610612748,Miami Heat,1,0,1610612753,Orlando Magic,0,1,26,30,56,12,23,35,38,53,91,2,3,5,19,35,19,5,16,91,90
2018,2,21800351,12/4/2018,1610612753,Orlando Magic,0,1,1610612748,Miami Heat,1,0,24,34,58,14,14,28,38,48,86,15,5,20,18,32,22,7,15,92,105
2018,2,21800238,11/18/2018,1610612744,Golden State Warriors,0,0,1610612759,San Antonio Spurs,1,1,30,30,60,5,21,26,35,51,86,17,4,21,14,38,20,3,12,96,92
2018,2,21800238,11/18/2018,1610612759,San Antonio Spurs,1,1,1610612744,Golden State Warriors,0,0,31,37,68,10,14,24,41,51,92,12,5,17,15,38,24,6,11,95,104
2020,2,22000025,12/26/2020,1610612752,New York Knicks,1,0,1610612755,Philadelphia 76ers,0,1,24,30,54,8,21,29,32,51,83,17,6,23,16,37,19,9,16,95,89
2020,2,22000025,12/26/2020,1610612755,Philadelphia 76ers,0,1,1610612752,New York Knicks,1,0,30,27,57,11,20,31,41,47,88,16,6,22,18,31,20,6,12,94,109
2016,2,21600615,1/16/2017,1610612749,Milwaukee Bucks,1,0,1610612755,Philadelphia 76ers,0,1,37,38,75,5,9,14,42,47,89,15,7,22,13,39,23,8,13,99,104
2016,2,21600615,1/16/2017,1610612755,Philadelphia 76ers,0,1,1610612749,Milwaukee Bucks,1,0,21,20,41,14,23,37,35,43,78,29,7,36,16,29,25,8,19,98,113
2019,2,21900066,10/31/2019,1610612737,Atlanta Hawks,1,0,1610612748,Miami Heat,0,1,29,25,54,7,27,34,36,52,88,18,8,26,22,35,20,12,16,97,97
2019,2,21900066,10/31/2019,1610612748,Miami Heat,0,1,1610612737,Atlanta Hawks,1,0,26,21,47,14,23,37,40,44,84,12,7,19,12,35,29,5,14,96,106
2018,2,21801187,4/5/2019,1610612742,Dallas Mavericks,1,0,1610612763,Memphis Grizzlies,0,1,24,25,49,17,30,47,41,55,96,13,8,21,15,43,28,7,9,99,112
2018,2,21801187,4/5/2019,1610612763,Memphis Grizzlies,0,1,1610612742,Dallas Mavericks,1,0,30,25,55,16,25,41,46,50,96,14,2,16,15,35,30,4,10,99,122
2018,2,21800904,2/25/2019,1610612747,Los Angeles Lakers,0,0,1610612763,Memphis Grizzlies,1,1,30,32,62,10,17,27,40,49,89,15,5,20,10,44,25,7,17,103,105
2018,2,21800904,2/25/2019,1610612763,Memphis Grizzlies,1,1,1610612747,Los Angeles Lakers,0,0,32,25,57,9,27,36,41,52,93,19,4,23,16,38,20,8,15,102,110
2018,2,21800713,1/23/2019,1610612763,Memphis Grizzlies,1,0,1610612766,Charlotte Hornets,0,1,29,21,50,9,22,31,38,43,81,22,2,24,11,34,25,8,11,94,107
2018,2,21800713,1/23/2019,1610612766,Charlotte Hornets,0,1,1610612763,Memphis Grizzlies,1,0,29,18,47,12,18,30,41,36,77,24,7,31,8,33,23,8,9,93,118
2018,2,21800292,11/25/2018,1610612758,Sacramento Kings,1,0,1610612762,Utah Jazz,0,1,31,31,62,9,14,23,40,45,85,23,8,31,8,38,20,11,17,109,112
2018,2,21800292,11/25/2018,1610612762,Utah Jazz,0,1,1610612758,Sacramento Kings,1,0,39,23,62,10,20,30,49,43,92,25,8,33,18,29,30,10,19,110,133
2018,2,21800130,11/3/2018,1610612740,New Orleans Pelicans,0,0,1610612759,San Antonio Spurs,1,1,30,26,56,6,15,21,36,41,77,17,13,30,9,36,22,8,16,101,95
2018,2,21800130,11/3/2018,1610612759,San Antonio Spurs,1,1,1610612740,New Orleans Pelicans,0,0,37,36,73,8,15,23,45,51,96,11,3,14,10,42,29,3,9,101,109
2018,2,21800084,10/28/2018,1610612742,Dallas Mavericks,1,0,1610612762,Utah Jazz,0,1,29,34,63,9,19,28,38,53,91,19,6,25,14,41,24,8,13,101,104
2018,2,21800084,10/28/2018,1610612762,Utah Jazz,0,1,1610612742,Dallas Mavericks,1,0,32,23,55,10,15,25,42,38,80,19,3,22,8,32,25,6,18,99,113
2016,2,21601171,4/5/2017,1610612744,Golden State Warriors,0,1,1610612756,Phoenix Suns,1,0,32,27,59,13,17,30,45,44,89,17,7,24,11,36,25,13,15,106,120
2016,2,21601171,4/5/2017,1610612756,Phoenix Suns,1,0,1610612744,Golden State Warriors,0,1,36,40,76,7,20,27,43,60,103,18,8,26,26,38,26,13,16,108,111
2020,2,22000024,12/26/2020,1610612753,Orlando Magic,0,1,1610612764,Washington Wizards,1,0,37,27,64,11,20,31,48,47,95,23,6,29,13,38,25,5,14,108,130
2020,2,22000024,12/26/2020,1610612764,Washington Wizards,1,0,1610612753,Orlando Magic,0,1,33,25,58,13,24,37,46,49,95,15,13,28,12,44,28,8,14,109,120
2019,2,21900293,12/2/2019,1610612756,Phoenix Suns,0,1,1610612766,Charlotte Hornets,1,0,30,16,46,9,33,42,39,49,88,22,8,30,10,42,30,4,8,100,109
2019,2,21900293,12/2/2019,1610612766,Charlotte Hornets,1,0,1610612756,Phoenix Suns,0,1,31,28,59,7,18,25,38,46,84,21,5,26,15,32,27,12,19,99,104
2016,2,21600151,11/14/2016,1610612762,Utah Jazz,1,0,1610612763,Memphis Grizzlies,0,1,27,18,45,8,20,28,35,38,73,18,4,22,9,31,17,4,9,85,96
2016,2,21600151,11/14/2016,1610612763,Memphis Grizzlies,0,1,1610612762,Utah Jazz,1,0,28,27,55,8,13,21,36,40,76,22,4,26,19,24,13,8,16,85,102
2014,2,21400827,2/22/2015,1610612742,Dallas Mavericks,1,1,1610612766,Charlotte Hornets,0,0,31,29,60,5,13,18,36,42,78,15,4,19,7,36,20,10,15,95,92
2014,2,21400827,2/22/2015,1610612766,Charlotte Hornets,0,0,1610612742,Dallas Mavericks,1,1,27,44,71,6,13,19,33,57,90,9,4,13,15,45,20,7,15,96,81
2018,2,21801040,3/16/2019,1610612743,Denver Nuggets,1,1,1610612754,Indiana Pacers,0,0,28,16,44,11,27,38,39,43,82,13,7,20,11,37,27,6,11,91,102
2018,2,21801040,3/16/2019,1610612754,Indiana Pacers,0,0,1610612743,Denver Nuggets,1,1,28,23,51,6,18,24,34,41,75,26,11,37,10,34,20,6,11,91,100
2018,2,21800801,2/5/2019,1610612750,Minnesota Timberwolves,0,0,1610612763,Memphis Grizzlies,1,1,30,28,58,9,20,29,39,48,87,19,1,20,20,29,26,11,17,94,106
2018,2,21800801,2/5/2019,1610612763,Memphis Grizzlies,1,1,1610612750,Minnesota Timberwolves,0,0,21,31,52,15,19,34,36,50,86,21,8,29,13,41,18,4,8,94,108
2018,2,21800637,1/12/2019,1610612741,Chicago Bulls,0,0,1610612762,Utah Jazz,1,1,33,39,72,7,18,25,40,57,97,15,2,17,15,44,24,6,11,100,102
2018,2,21800637,1/12/2019,1610612762,Utah Jazz,1,1,1610612741,Chicago Bulls,0,0,22,21,43,16,29,45,38,50,88,18,7,25,15,39,23,8,13,101,110
2018,2,21800486,12/23/2018,1610612737,Atlanta Hawks,0,1,1610612765,Detroit Pistons,1,0,30,38,68,6,17,23,36,55,91,20,5,25,21,36,24,6,16,99,98
2018,2,21800486,12/23/2018,1610612765,Detroit Pistons,1,0,1610612737,Atlanta Hawks,0,1,24,30,54,10,19,29,34,49,83,17,10,27,12,43,21,9,16,99,95
2018,2,21800350,12/4/2018,1610612741,Chicago Bulls,0,0,1610612754,Indiana Pacers,1,1,26,37,63,11,20,31,37,57,94,5,0,5,17,40,26,10,19,98,90
2018,2,21800350,12/4/2018,1610612754,Indiana Pacers,1,1,1610612741,Chicago Bulls,0,0,29,25,54,6,16,22,35,41,76,20,4,24,10,33,22,8,18,98,96
2020,2,22000023,12/26/2020,1610612739,Cleveland Cavaliers,0,1,1610612765,Detroit Pistons,1,0,35,34,69,13,17,30,48,51,99,19,11,30,10,49,29,9,19,124,128
2020,2,22000023,12/26/2020,1610612765,Detroit Pistons,1,0,1610612739,Cleveland Cavaliers,0,1,24,29,53,16,29,45,40,58,98,23,9,32,15,47,24,13,24,123,119
2016,2,21601170,4/5/2017,1610612747,Los Angeles Lakers,0,1,1610612759,San Antonio Spurs,1,0,35,37,72,7,7,14,42,44,86,11,3,14,11,34,23,8,16,97,102
2016,2,21601170,4/5/2017,1610612759,San Antonio Spurs,1,0,1610612747,Los Angeles Lakers,0,1,26,28,54,13,22,35,39,50,89,4,2,6,10,42,28,8,16,97,95
2016,2,21600614,1/16/2017,1610612757,Portland Trail Blazers,0,0,1610612764,Washington Wizards,1,1,29,33,62,8,18,26,37,51,88,19,6,25,16,40,22,10,15,99,101
2016,2,21600614,1/16/2017,1610612764,Washington Wizards,1,1,1610612757,Portland Trail Blazers,0,0,29,34,63,13,10,23,42,44,86,23,2,25,12,32,26,6,12,98,120
2014,2,21400826,2/22/2015,1610612743,Denver Nuggets,0,0,1610612760,Oklahoma City Thunder,1,1,28,42,70,7,20,27,35,62,97,17,3,20,17,48,19,8,13,102,94
2014,2,21400826,2/22/2015,1610612760,Oklahoma City Thunder,1,1,1610612743,Denver Nuggets,0,0,40,32,72,8,12,20,48,44,92,15,8,23,18,28,31,13,18,102,119
2018,2,21801039,3/16/2019,1610612757,Portland Trail Blazers,0,0,1610612759,San Antonio Spurs,1,1,35,38,73,7,21,28,42,59,101,12,2,14,18,42,23,4,9,98,103
2018,2,21801039,3/16/2019,1610612759,San Antonio Spurs,1,1,1610612757,Portland Trail Blazers,0,0,29,33,62,8,9,17,37,42,79,26,4,30,4,39,17,4,10,98,108
2018,2,21800903,2/25/2019,1610612737,Atlanta Hawks,0,0,1610612745,Houston Rockets,1,1,22,20,42,17,21,38,39,41,80,16,7,23,11,34,21,11,17,99,111
2018,2,21800903,2/25/2019,1610612745,Houston Rockets,1,1,1610612737,Atlanta Hawks,0,0,24,15,39,15,36,51,39,51,90,26,4,30,18,33,24,6,14,99,119
2018,2,21800415,12/12/2018,1610612744,Golden State Warriors,1,0,1610612761,Toronto Raptors,0,1,33,23,56,6,20,26,39,43,82,9,4,13,7,39,28,12,19,99,93
2018,2,21800415,12/12/2018,1610612761,Toronto Raptors,0,1,1610612744,Golden State Warriors,1,0,35,28,63,9,19,28,44,47,91,16,3,19,12,37,27,5,11,100,113
2020,2,22000022,12/26/2020,1610612760,Oklahoma City Thunder,0,1,1610612766,Charlotte Hornets,1,0,30,22,52,10,26,36,40,48,88,19,5,24,13,39,25,11,17,104,109
2020,2,22000022,12/26/2020,1610612766,Charlotte Hornets,1,0,1610612760,Oklahoma City Thunder,0,1,24,37,61,13,19,32,37,56,93,20,12,32,17,48,27,10,13,105,107
2019,2,21900065,10/30/2019,1610612744,Golden State Warriors,1,0,1610612756,Phoenix Suns,0,1,28,26,54,8,20,28,36,46,82,30,6,36,11,38,24,12,18,107,110
2019,2,21900065,10/30/2019,1610612756,Phoenix Suns,0,1,1610612744,Golden State Warriors,1,0,29,31,60,15,21,36,44,52,96,18,3,21,17,38,33,8,17,107,121
2018,2,21800712,1/23/2019,1610612737,Atlanta Hawks,0,1,1610612741,Chicago Bulls,1,0,30,20,50,15,25,40,45,45,90,16,5,21,17,31,31,7,17,99,121
2018,2,21800712,1/23/2019,1610612741,Chicago Bulls,1,0,1610612737,Atlanta Hawks,0,1,27,26,53,8,18,26,35,44,79,23,4,27,9,38,20,11,15,100,101
2018,2,21800560,1/2/2019,1610612763,Memphis Grizzlies,1,0,1610612765,Detroit Pistons,0,1,32,28,60,4,14,18,36,42,78,18,3,21,10,35,21,7,12,92,94
2018,2,21800560,1/2/2019,1610612765,Detroit Pistons,0,1,1610612763,Memphis Grizzlies,1,0,20,23,43,16,24,40,36,47,83,13,9,22,13,39,23,2,10,92,101
2018,2,21800485,12/22/2018,1610612760,Oklahoma City Thunder,0,1,1610612762,Utah Jazz,1,0,33,31,64,9,16,25,42,47,89,14,8,22,13,39,19,12,17,105,107
2018,2,21800485,12/22/2018,1610612762,Utah Jazz,1,0,1610612760,Oklahoma City Thunder,0,1,31,28,59,11,23,34,42,51,93,11,7,18,12,43,35,11,13,104,106
2018,2,21800185,11/11/2018,1610612745,Houston Rockets,1,1,1610612754,Indiana Pacers,0,0,16,11,27,20,27,47,36,38,74,23,9,32,11,33,18,10,17,93,115
2018,2,21800185,11/11/2018,1610612754,Indiana Pacers,0,0,1610612745,Houston Rockets,1,1,25,24,49,11,18,29,36,42,78,20,6,26,11,32,24,6,13,94,103
2016,2,21601169,4/5/2017,1610612738,Boston Celtics,1,0,1610612739,Cleveland Cavaliers,0,1,26,22,48,7,26,33,33,48,81,18,11,29,14,38,21,7,13,94,91
2016,2,21601169,4/5/2017,1610612739,Cleveland Cavaliers,0,1,1610612738,Boston Celtics,1,0,32,24,56,11,25,36,43,49,92,17,1,18,17,33,19,6,10,93,114
2020,2,22000021,12/26/2020,1610612737,Atlanta Hawks,0,1,1610612763,Memphis Grizzlies,1,0,25,28,53,13,23,36,38,51,89,33,5,38,17,38,23,5,16,103,122
2020,2,22000021,12/26/2020,1610612763,Memphis Grizzlies,1,0,1610612737,Atlanta Hawks,0,1,24,26,50,13,30,43,37,56,93,25,4,29,14,44,20,4,9,103,112
2016,2,21600613,1/16/2017,1610612737,Atlanta Hawks,0,1,1610612752,New York Knicks,1,0,28,27,55,12,20,32,40,47,87,16,7,23,12,39,26,8,10,95,108
2019,2,21900292,12/1/2019,1610612746,LA Clippers,1,1,1610612764,Washington Wizards,0,0,38,24,62,14,18,32,52,42,94,32,8,40,13,34,22,10,17,117,150
2019,2,21900292,12/1/2019,1610612764,Washington Wizards,0,0,1610612746,LA Clippers,1,1,36,36,72,11,19,30,47,55,102,20,7,27,13,43,32,8,14,116,125
2016,2,21600613,1/16/2017,1610612752,New York Knicks,1,0,1610612737,Atlanta Hawks,0,1,34,25,59,8,18,26,42,43,85,15,8,23,16,30,21,11,18,97,107
2016,2,21600150,11/14/2016,1610612748,Miami Heat,0,0,1610612759,San Antonio Spurs,1,1,33,36,69,4,11,15,37,47,84,12,9,21,13,39,22,4,13,95,90
2016,2,21600150,11/14/2016,1610612759,San Antonio Spurs,1,1,1610612748,Miami Heat,0,0,25,42,67,8,7,15,33,49,82,20,7,27,19,32,24,14,17,94,94
2018,2,21801186,4/5/2019,1610612760,Oklahoma City Thunder,1,1,1610612765,Detroit Pistons,0,0,36,36,72,12,17,29,48,53,101,15,7,22,26,30,30,10,17,102,123
2018,2,21801186,4/5/2019,1610612765,Detroit Pistons,0,0,1610612760,Oklahoma City Thunder,1,1,20,20,40,15,26,41,35,46,81,25,6,31,7,41,20,10,14,102,110
2018,2,21800902,2/25/2019,1610612741,Chicago Bulls,1,0,1610612749,Milwaukee Bucks,0,1,32,34,66,9,17,26,41,51,92,15,7,22,11,43,31,3,7,97,106
2018,2,21800902,2/25/2019,1610612749,Milwaukee Bucks,0,1,1610612741,Chicago Bulls,1,0,25,17,42,17,32,49,42,49,91,16,7,23,13,39,26,3,8,97,117
2018,2,21800800,2/5/2019,1610612755,Philadelphia 76ers,1,0,1610612761,Toronto Raptors,0,1,24,22,46,7,17,24,31,39,70,38,3,41,10,31,20,12,18,99,107
2018,2,21800800,2/5/2019,1610612761,Toronto Raptors,0,1,1610612755,Philadelphia 76ers,1,0,30,28,58,11,20,31,41,48,89,26,6,32,19,31,27,8,13,98,119
2014,2,21400825,2/22/2015,1610612753,Orlando Magic,1,1,1610612755,Philadelphia 76ers,0,0,33,26,59,6,17,23,39,43,82,19,7,26,16,31,19,8,15,93,103
2014,2,21400825,2/22/2015,1610612755,Philadelphia 76ers,0,0,1610612753,Orlando Magic,1,1,23,21,44,13,21,34,36,42,78,13,4,17,13,31,21,9,21,94,98
2016,2,21601168,4/5/2017,1610612743,Denver Nuggets,0,0,1610612745,Houston Rockets,1,1,34,32,66,7,31,38,41,63,104,15,3,18,17,48,26,7,12,108,104
2016,2,21601168,4/5/2017,1610612745,Houston Rockets,1,1,1610612743,Denver Nuggets,0,0,27,26,53,10,24,34,37,50,87,26,12,38,12,41,19,10,16,107,110
2021,2,22100247,11/20/2021,1610612758,Sacramento Kings,1,0,1610612762,Utah Jazz,0,1,31,29,60,10,21,31,41,50,91,13,8,21,11,42,20,5,8,96,105
2021,2,22100247,11/20/2021,1610612762,Utah Jazz,0,1,1610612758,Sacramento Kings,1,0,29,23,52,17,22,39,46,45,91,14,3,17,17,29,20,8,13,96,123
2018,2,21800711,1/23/2019,1610612755,Philadelphia 76ers,1,1,1610612759,San Antonio Spurs,0,0,30,27,57,17,19,36,47,46,93,11,3,14,14,32,35,8,12,98,122
2018,2,21800711,1/23/2019,1610612759,San Antonio Spurs,0,0,1610612755,Philadelphia 76ers,1,1,34,21,55,13,14,27,47,35,82,13,2,15,7,29,24,9,15,98,120
2018,2,21800636,1/12/2019,1610612758,Sacramento Kings,1,1,1610612766,Charlotte Hornets,0,0,27,35,62,14,23,37,41,58,99,8,4,12,17,44,27,6,11,97,104
2018,2,21800636,1/12/2019,1610612766,Charlotte Hornets,0,0,1610612758,Sacramento Kings,1,1,24,28,52,12,24,36,36,52,88,13,9,22,20,37,21,8,20,99,97
2018,2,21800559,1/2/2019,1610612741,Chicago Bulls,1,0,1610612753,Orlando Magic,0,1,29,37,66,7,13,20,36,50,86,5,3,8,10,41,18,5,11,91,84
2018,2,21800559,1/2/2019,1610612753,Orlando Magic,0,1,1610612741,Chicago Bulls,1,0,33,17,50,11,15,26,44,32,76,13,5,18,6,29,31,8,13,91,112
2018,2,21800414,12/12/2018,1610612750,Minnesota Timberwolves,0,0,1610612758,Sacramento Kings,1,1,41,30,71,9,13,22,50,43,93,21,6,27,17,30,30,3,11,100,130
2018,2,21800414,12/12/2018,1610612758,Sacramento Kings,1,1,1610612750,Minnesota Timberwolves,0,0,31,17,48,19,19,38,50,36,86,22,10,32,13,29,34,4,11,101,141
2018,2,21800349,12/3/2018,1610612740,New Orleans Pelicans,1,0,1610612746,LA Clippers,0,1,36,22,58,13,21,34,49,43,92,15,7,22,11,35,32,4,7,98,126
2018,2,21800349,12/3/2018,1610612746,LA Clippers,0,1,1610612740,New Orleans Pelicans,1,0,41,22,63,8,12,20,49,34,83,23,7,30,10,27,29,10,12,99,129
2020,2,22000934,4/28/2021,1610612737,Atlanta Hawks,0,0,1610612755,Philadelphia 76ers,1,1,21,41,62,6,13,19,27,54,81,23,6,29,21,35,17,12,15,92,83
2020,2,22000934,4/28/2021,1610612755,Philadelphia 76ers,1,1,1610612737,Atlanta Hawks,0,0,32,21,53,16,20,36,48,41,89,15,7,22,14,32,29,3,8,92,127
2018,2,21800131,11/3/2018,1610612743,Denver Nuggets,1,1,1610612762,Utah Jazz,0,0,32,23,55,9,19,28,41,42,83,12,7,19,13,33,32,12,17,98,103
2018,2,21800131,11/3/2018,1610612762,Utah Jazz,0,0,1610612743,Denver Nuggets,1,1,27,23,50,6,25,31,33,48,81,16,8,24,10,43,22,8,13,97,88
2018,2,21800083,10/28/2018,1610612744,Golden State Warriors,0,1,1610612751,Brooklyn Nets,1,0,33,23,56,11,22,33,44,45,89,21,3,24,13,33,28,5,12,101,120
2018,2,21800083,10/28/2018,1610612751,Brooklyn Nets,1,0,1610612744,Golden State Warriors,0,1,22,23,45,20,22,42,42,45,87,10,5,15,9,36,28,11,15,102,114
2020,2,22000020,12/23/2020,1610612757,Portland Trail Blazers,1,0,1610612762,Utah Jazz,0,1,25,34,59,12,21,33,37,55,92,14,3,17,8,47,23,3,6,98,100
2020,2,22000020,12/23/2020,1610612762,Utah Jazz,0,1,1610612757,Portland Trail Blazers,1,0,24,20,44,19,31,50,43,51,94,15,4,19,15,38,24,6,11,99,120
2016,2,21600612,1/15/2017,1610612747,Los Angeles Lakers,1,0,1610612765,Detroit Pistons,0,1,30,27,57,6,20,26,36,47,83,19,5,24,10,38,19,6,15,96,97
2016,2,21600612,1/15/2017,1610612765,Detroit Pistons,0,1,1610612747,Los Angeles Lakers,1,0,32,38,70,9,16,25,41,54,95,11,5,16,12,44,24,2,7,97,102
2014,2,21400824,2/22/2015,1610612744,Golden State Warriors,0,0,1610612754,Indiana Pacers,1,1,25,38,63,9,17,26,34,55,89,21,1,22,17,39,19,3,10,94,98
2014,2,21400824,2/22/2015,1610612754,Indiana Pacers,1,1,1610612744,Golden State Warriors,0,0,31,31,62,8,11,19,39,42,81,18,5,23,11,35,20,9,15,95,104
2018,2,21801185,4/5/2019,1610612748,Miami Heat,0,0,1610612750,Minnesota Timberwolves,1,1,35,19,54,10,24,34,45,43,88,9,3,12,10,34,24,10,17,101,109
2018,2,21801185,4/5/2019,1610612750,Minnesota Timberwolves,1,1,1610612748,Miami Heat,0,0,35,27,62,8,16,24,43,43,86,17,4,21,14,32,25,10,19,102,111
2017,2,21701226,4/11/2018,1610612740,New Orleans Pelicans,1,1,1610612759,San Antonio Spurs,0,0,47,22,69,5,14,19,52,36,88,13,6,19,11,28,30,9,19,103,122
2017,2,21701226,4/11/2018,1610612759,San Antonio Spurs,0,0,1610612740,New Orleans Pelicans,1,1,29,39,68,8,16,24,37,55,92,16,3,19,14,43,22,11,17,104,98
2022,2,22200476,12/21/2022,1610612746,LA Clippers,1,1,1610612766,Charlotte Hornets,0,0,18,14,32,23,26,49,41,40,81,21,2,23,10,30,29,15,27,111,126
2022,2,22200476,12/21/2022,1610612766,Charlotte Hornets,0,0,1610612746,LA Clippers,1,1,28,33,61,9,22,31,37,55,92,22,7,29,11,45,25,6,15,110,105
2017,2,21701089,3/24/2018,1610612741,Chicago Bulls,0,0,1610612765,Detroit Pistons,1,1,28,34,62,11,24,35,39,58,97,6,3,9,20,39,27,6,13,96,95
2017,2,21701089,3/24/2018,1610612765,Detroit Pistons,1,1,1610612741,Chicago Bulls,0,0,27,18,45,16,26,42,43,44,87,15,3,18,14,30,33,10,14,95,117
2017,2,21701044,3/17/2018,1610612744,Golden State Warriors,0,1,1610612756,Phoenix Suns,1,0,37,27,64,13,18,31,50,45,95,11,3,14,12,35,29,8,14,103,124
2016,2,21601167,4/5/2017,1610612760,Oklahoma City Thunder,0,1,1610612763,Memphis Grizzlies,1,0,23,31,54,14,17,31,37,48,85,15,9,24,13,37,19,7,12,93,103
2016,2,21601167,4/5/2017,1610612763,Memphis Grizzlies,1,0,1610612760,Oklahoma City Thunder,0,1,28,24,52,9,17,26,37,41,78,17,4,21,10,34,21,8,14,91,100
2016,2,21600149,11/14/2016,1610612745,Houston Rockets,1,1,1610612755,Philadelphia 76ers,0,0,27,24,51,17,23,40,44,47,91,10,7,17,20,32,20,10,18,96,115
2016,2,21600149,11/14/2016,1610612755,Philadelphia 76ers,0,0,1610612745,Houston Rockets,1,1,29,39,68,5,17,22,34,56,90,15,2,17,16,41,18,6,13,96,88
2018,2,21801038,3/16/2019,1610612744,Golden State Warriors,0,1,1610612760,Oklahoma City Thunder,1,0,24,24,48,15,20,35,39,44,83,17,5,22,8,37,25,4,17,101,110
2018,2,21801038,3/16/2019,1610612760,Oklahoma City Thunder,1,0,1610612744,Golden State Warriors,0,1,18,37,55,13,28,41,31,65,96,13,10,23,21,48,18,10,16,103,88
2018,2,21800901,2/25/2019,1610612748,Miami Heat,1,0,1610612756,Phoenix Suns,0,1,39,29,68,9,20,29,48,49,97,16,4,20,17,34,31,9,14,102,121
2018,2,21800901,2/25/2019,1610612756,Phoenix Suns,0,1,1610612748,Miami Heat,1,0,32,25,57,13,19,32,45,44,89,21,4,25,10,35,30,10,14,103,124
2021,2,22100246,11/20/2021,1610612755,Philadelphia 76ers,0,0,1610612757,Portland Trail Blazers,1,1,31,22,53,10,18,28,41,40,81,19,2,21,7,35,24,6,12,95,111
2021,2,22100246,11/20/2021,1610612757,Portland Trail Blazers,1,1,1610612755,Philadelphia 76ers,0,0,25,21,46,15,19,34,40,40,80,23,0,23,9,31,23,7,13,95,118
2020,2,22000933,4/28/2021,1610612739,Cleveland Cavaliers,1,0,1610612753,Orlando Magic,0,1,25,23,48,12,32,44,37,55,92,18,6,24,17,40,30,9,13,101,104
2020,2,22000933,4/28/2021,1610612753,Orlando Magic,0,1,1610612739,Cleveland Cavaliers,1,0,33,23,56,10,19,29,43,42,85,13,7,20,10,36,26,12,15,100,109
2020,2,22000019,12/23/2020,1610612743,Denver Nuggets,1,0,1610612758,Sacramento Kings,0,1,39,30,69,8,21,29,47,51,98,20,4,24,12,42,28,5,15,111,122
2020,2,22000019,12/23/2020,1610612758,Sacramento Kings,0,1,1610612743,Denver Nuggets,1,0,35,36,71,10,21,31,45,57,102,24,7,31,19,40,27,6,15,110,124
2019,2,21900291,12/1/2019,1610612761,Toronto Raptors,1,1,1610612762,Utah Jazz,0,0,28,26,54,19,17,36,47,43,90,17,4,21,9,36,36,5,14,104,130
2019,2,21900291,12/1/2019,1610612762,Utah Jazz,0,0,1610612761,Toronto Raptors,1,1,25,30,55,13,22,35,38,52,90,21,8,29,19,36,21,14,18,103,110
2019,2,21900064,10/30/2019,1610612758,Sacramento Kings,1,0,1610612766,Charlotte Hornets,0,1,30,20,50,14,32,46,44,52,96,9,3,12,15,38,26,8,15,100,111
2019,2,21900064,10/30/2019,1610612766,Charlotte Hornets,0,1,1610612758,Sacramento Kings,1,0,30,22,52,16,16,32,46,38,84,10,4,14,11,31,30,11,21,100,118
2016,2,21600611,1/15/2017,1610612741,Chicago Bulls,0,1,1610612763,Memphis Grizzlies,1,0,36,25,61,4,13,17,40,38,78,24,11,35,7,37,18,6,12,99,108
2016,2,21600611,1/15/2017,1610612763,Memphis Grizzlies,1,0,1610612741,Chicago Bulls,0,1,29,34,63,11,21,32,40,55,95,13,0,13,14,41,24,8,10,98,104
2021,2,22100245,11/20/2021,1610612750,Minnesota Timberwolves,1,1,1610612763,Memphis Grizzlies,0,0,29,21,50,20,21,41,49,42,91,20,8,28,20,27,28,7,13,97,138
2021,2,22100245,11/20/2021,1610612763,Memphis Grizzlies,0,0,1610612750,Minnesota Timberwolves,1,1,20,31,51,9,23,32,29,54,83,28,7,35,19,37,21,12,16,97,95
2014,2,21400823,2/22/2015,1610612764,Washington Wizards,0,0,1610612765,Detroit Pistons,1,1,31,37,68,6,11,17,37,48,85,9,5,14,14,36,28,8,12,91,89
2018,2,21801037,3/16/2019,1610612739,Cleveland Cavaliers,0,0,1610612742,Dallas Mavericks,1,1,25,23,48,15,23,38,40,46,86,21,1,22,12,34,20,3,6,91,116
2018,2,21801037,3/16/2019,1610612742,Dallas Mavericks,1,1,1610612739,Cleveland Cavaliers,0,0,30,25,55,16,18,34,46,43,89,13,3,16,11,34,32,1,5,90,121
2018,2,21800799,2/5/2019,1610612752,New York Knicks,1,0,1610612765,Detroit Pistons,0,1,27,30,57,9,24,33,36,54,90,11,4,15,16,39,17,4,11,92,92
2018,2,21800799,2/5/2019,1610612765,Detroit Pistons,0,1,1610612752,New York Knicks,1,0,25,20,45,12,22,34,37,42,79,19,5,24,9,36,22,5,11,91,105
2020,2,22000018,12/23/2020,1610612750,Minnesota Timberwolves,1,1,1610612765,Detroit Pistons,0,0,27,20,47,11,30,41,38,50,88,24,4,28,13,38,25,5,12,100,111
2020,2,22000018,12/23/2020,1610612765,Detroit Pistons,0,0,1610612750,Minnesota Timberwolves,1,1,37,21,58,8,27,35,45,48,93,3,5,8,12,39,29,6,15,99,101
2021,2,22100244,11/20/2021,1610612749,Milwaukee Bucks,1,1,1610612753,Orlando Magic,0,0,18,24,42,19,21,40,37,45,82,24,13,37,12,38,25,5,14,102,117
2021,2,22100244,11/20/2021,1610612753,Orlando Magic,0,0,1610612749,Milwaukee Bucks,1,1,20,27,47,19,32,51,39,59,98,11,3,14,11,50,26,6,10,103,108
2014,2,21400823,2/22/2015,1610612765,Detroit Pistons,1,1,1610612764,Washington Wizards,0,0,24,33,57,13,19,32,37,52,89,19,6,25,23,32,22,4,13,91,106
2018,2,21801184,4/5/2019,1610612745,Houston Rockets,1,1,1610612752,New York Knicks,0,0,21,21,42,22,37,59,43,58,101,12,5,17,11,49,26,3,6,104,120
2018,2,21801184,4/5/2019,1610612752,New York Knicks,0,0,1610612745,Houston Rockets,1,1,31,24,55,6,21,27,37,45,82,16,11,27,7,44,22,8,16,104,96
2018,2,21800635,1/12/2019,1610612743,Denver Nuggets,0,0,1610612756,Phoenix Suns,1,1,24,33,57,10,21,31,34,54,88,15,7,22,19,38,25,11,17,96,93
2018,2,21800635,1/12/2019,1610612756,Phoenix Suns,1,1,1610612743,Denver Nuggets,0,0,30,36,66,8,18,26,38,54,92,18,7,25,15,42,29,7,9,97,102
2018,2,21800558,1/2/2019,1610612738,Boston Celtics,1,1,1610612750,Minnesota Timberwolves,0,0,33,13,46,12,18,30,45,31,76,13,2,15,5,26,34,7,16,95,115
2018,2,21800558,1/2/2019,1610612750,Minnesota Timberwolves,0,0,1610612738,Boston Celtics,1,1,33,28,61,7,16,23,40,44,84,15,6,21,13,33,24,10,15,95,102
2020,2,22000017,12/23/2020,1610612759,San Antonio Spurs,0,1,1610612763,Memphis Grizzlies,1,0,38,32,70,10,15,25,48,47,95,25,4,29,11,38,28,6,11,109,131
2020,2,22000017,12/23/2020,1610612763,Memphis Grizzlies,1,0,1610612759,San Antonio Spurs,0,1,39,29,68,10,17,27,49,46,95,11,7,18,7,42,27,8,11,107,119
2019,2,21900290,12/1/2019,1610612744,Golden State Warriors,0,0,1610612753,Orlando Magic,1,1,30,38,68,6,17,23,36,55,91,18,5,23,19,39,21,7,12,95,96
2019,2,21900290,12/1/2019,1610612753,Orlando Magic,1,1,1610612744,Golden State Warriors,0,0,26,28,54,11,22,33,37,50,87,15,7,22,18,36,21,6,15,96,100
2016,2,21601166,4/5/2017,1610612761,Toronto Raptors,0,1,1610612765,Detroit Pistons,1,0,31,26,57,10,20,30,41,46,87,13,2,15,11,36,29,5,12,94,105
2021,2,22100243,11/20/2021,1610612738,Boston Celtics,1,1,1610612760,Oklahoma City Thunder,0,0,24,25,49,17,22,39,41,47,88,12,2,14,9,39,28,5,7,94,111
2021,2,22100243,11/20/2021,1610612760,Oklahoma City Thunder,0,0,1610612738,Boston Celtics,1,1,21,33,54,18,24,42,39,57,96,9,7,16,19,41,23,4,10,93,105
2016,2,21601166,4/5/2017,1610612765,Detroit Pistons,1,0,1610612761,Toronto Raptors,0,1,35,25,60,7,14,21,42,39,81,11,7,18,12,30,22,7,14,93,102
2016,2,21600148,11/14/2016,1610612738,Boston Celtics,0,0,1610612740,New Orleans Pelicans,1,1,26,28,54,12,29,41,38,57,95,17,3,20,15,42,19,9,12,103,105
2018,2,21801183,4/5/2019,1610612738,Boston Celtics,0,1,1610612754,Indiana Pacers,1,0,41,24,65,7,20,27,48,44,92,14,2,16,11,35,27,5,11,98,117
2018,2,21801183,4/5/2019,1610612754,Indiana Pacers,1,0,1610612738,Boston Celtics,0,1,28,41,69,10,13,23,38,54,92,11,8,19,13,45,24,7,11,98,97
2016,2,21600148,11/14/2016,1610612740,New Orleans Pelicans,1,1,1610612738,Boston Celtics,0,0,29,29,58,6,15,21,35,44,79,30,6,36,12,35,16,9,17,103,106
2018,2,21800900,2/25/2019,1610612751,Brooklyn Nets,1,1,1610612759,San Antonio Spurs,0,0,16,15,31,19,31,50,35,46,81,12,4,16,7,40,24,6,16,98,101
2018,2,21800900,2/25/2019,1610612759,San Antonio Spurs,0,0,1610612751,Brooklyn Nets,1,1,31,41,72,4,20,24,35,61,96,11,1,12,15,47,14,5,11,98,85
2018,2,21800798,2/5/2019,1610612747,Los Angeles Lakers,0,0,1610612754,Indiana Pacers,1,1,31,23,54,4,17,21,35,40,75,20,6,26,7,34,25,11,19,100,94
2018,2,21800798,2/5/2019,1610612754,Indiana Pacers,1,1,1610612747,Los Angeles Lakers,0,0,37,27,64,19,15,34,56,42,98,5,3,8,11,33,37,5,10,99,136
2018,2,21800710,1/23/2019,1610612745,Houston Rockets,0,1,1610612752,New York Knicks,1,0,26,20,46,11,33,44,37,53,90,29,9,38,19,38,10,5,13,101,114
2018,2,21800710,1/23/2019,1610612752,New York Knicks,1,0,1610612745,Houston Rockets,0,1,26,25,51,11,19,30,37,44,81,25,5,30,14,33,15,15,19,100,110
2018,2,21800484,12/22/2018,1610612742,Dallas Mavericks,0,0,1610612744,Golden State Warriors,1,1,28,25,53,14,25,39,42,50,92,18,10,28,16,39,28,7,14,103,116
2018,2,21800484,12/22/2018,1610612744,Golden State Warriors,1,1,1610612742,Dallas Mavericks,0,0,30,25,55,15,28,43,45,53,98,15,1,16,16,37,34,9,13,101,120
2018,2,21800348,12/3/2018,1610612745,Houston Rockets,0,0,1610612750,Minnesota Timberwolves,1,1,21,14,35,11,28,39,32,42,74,16,3,19,9,33,24,11,20,93,91
2020,2,22000932,4/27/2021,1610612742,Dallas Mavericks,0,1,1610612744,Golden State Warriors,1,0,30,27,57,18,17,35,48,44,92,19,3,22,11,33,21,11,13,103,133
2020,2,22000932,4/27/2021,1610612744,Golden State Warriors,1,0,1610612742,Dallas Mavericks,0,1,18,23,41,16,27,43,34,50,84,19,5,24,12,42,25,9,18,103,103
2020,2,22000016,3/21/2021,1610612745,Houston Rockets,1,0,1610612760,Oklahoma City Thunder,0,1,25,16,41,14,24,38,39,40,79,20,7,27,8,36,22,8,16,101,112
2020,2,22000016,3/21/2021,1610612760,Oklahoma City Thunder,0,1,1610612745,Houston Rockets,1,0,29,23,52,13,26,39,42,49,91,17,8,25,21,31,22,7,18,101,114
2016,2,21601165,4/5/2017,1610612748,Miami Heat,0,1,1610612766,Charlotte Hornets,1,0,19,25,44,21,19,40,40,44,84,11,1,12,10,34,23,2,8,88,112
2016,2,21601165,4/5/2017,1610612766,Charlotte Hornets,1,0,1610612748,Miami Heat,0,1,27,26,53,8,17,25,35,43,78,21,3,24,7,37,19,5,6,88,99
2016,2,21600610,1/15/2017,1610612758,Sacramento Kings,1,0,1610612760,Oklahoma City Thunder,0,1,28,28,56,9,16,25,37,44,81,35,5,40,18,29,24,14,22,105,118
2016,2,21600610,1/15/2017,1610612760,Oklahoma City Thunder,0,1,1610612758,Sacramento Kings,1,0,31,31,62,9,19,28,40,50,90,33,8,41,23,32,20,13,19,105,122
2014,2,21400822,2/22/2015,1610612737,Atlanta Hawks,0,1,1610612749,Milwaukee Bucks,1,0,26,31,57,9,21,30,35,52,87,18,3,21,21,31,23,10,20,96,97
2014,2,21400822,2/22/2015,1610612749,Milwaukee Bucks,1,0,1610612737,Atlanta Hawks,0,1,28,28,56,4,12,16,32,40,72,18,0,18,10,30,19,10,25,96,86
2018,2,21801036,3/16/2019,1610612740,New Orleans Pelicans,1,0,1610612756,Phoenix Suns,0,1,32,40,72,15,15,30,47,55,102,27,14,41,24,40,34,10,23,121,136
2018,2,21801036,3/16/2019,1610612756,Phoenix Suns,0,1,1610612740,New Orleans Pelicans,1,0,42,29,71,9,20,29,51,49,100,27,9,36,15,42,31,11,22,121,138
2018,2,21800557,1/2/2019,1610612740,New Orleans Pelicans,0,0,1610612751,Brooklyn Nets,1,1,36,28,64,10,13,23,46,41,87,19,8,27,13,33,19,7,12,97,121
2018,2,21800557,1/2/2019,1610612751,Brooklyn Nets,1,1,1610612740,New Orleans Pelicans,0,0,31,31,62,16,15,31,47,46,93,16,5,21,16,33,27,7,10,98,126
2018,2,21800413,12/12/2018,1610612748,Miami Heat,0,0,1610612762,Utah Jazz,1,1,17,27,44,12,21,33,29,48,77,14,10,24,6,46,16,6,13,96,84
2018,2,21800413,12/12/2018,1610612762,Utah Jazz,1,1,1610612748,Miami Heat,0,0,24,20,44,16,16,32,40,36,76,15,6,21,8,30,29,10,17,95,111
2018,2,21800348,12/3/2018,1610612750,Minnesota Timberwolves,1,1,1610612745,Houston Rockets,0,0,25,35,60,11,11,22,36,46,82,20,8,28,18,31,22,9,14,93,103
2018,2,21800291,11/25/2018,1610612752,New York Knicks,0,1,1610612763,Memphis Grizzlies,1,0,26,43,69,8,14,22,34,57,91,27,5,32,23,37,17,5,10,93,103
2018,2,21800291,11/25/2018,1610612763,Memphis Grizzlies,1,0,1610612752,New York Knicks,0,1,27,29,56,11,19,30,38,48,86,11,8,19,9,44,27,4,8,94,98
2018,2,21800184,11/11/2018,1610612765,Detroit Pistons,1,0,1610612766,Charlotte Hornets,0,1,26,34,60,12,32,44,38,66,104,15,4,19,27,42,21,6,10,95,103
2018,2,21800184,11/11/2018,1610612766,Charlotte Hornets,0,1,1610612765,Detroit Pistons,1,0,32,25,57,11,17,28,43,42,85,16,2,18,10,32,24,5,12,95,113
2020,2,22000015,12/23/2020,1610612737,Atlanta Hawks,0,1,1610612741,Chicago Bulls,1,0,29,16,45,14,21,35,43,37,80,24,5,29,9,30,24,10,23,106,124
2020,2,22000015,12/23/2020,1610612741,Chicago Bulls,1,0,1610612737,Atlanta Hawks,0,1,28,24,52,8,27,35,36,51,87,24,4,28,13,39,20,6,17,107,104
2016,2,21600147,11/14/2016,1610612760,Oklahoma City Thunder,0,0,1610612765,Detroit Pistons,1,1,28,33,61,5,22,27,33,55,88,17,5,22,15,44,16,4,15,99,88
2016,2,21600147,11/14/2016,1610612765,Detroit Pistons,1,1,1610612760,Oklahoma City Thunder,0,0,38,38,76,5,11,16,43,49,92,13,3,16,10,39,25,3,10,98,104
2019,2,21900063,10/30/2019,1610612746,LA Clippers,0,0,1610612762,Utah Jazz,1,1,31,28,59,8,15,23,39,43,82,10,2,12,10,34,19,12,20,97,96
2019,2,21900063,10/30/2019,1610612762,Utah Jazz,1,1,1610612746,LA Clippers,0,0,33,23,56,11,13,24,44,36,80,11,5,16,7,32,23,3,15,98,110
2014,2,21400821,2/22/2015,1610612739,Cleveland Cavaliers,0,1,1610612752,New York Knicks,1,0,28,18,46,12,21,33,40,39,79,9,6,15,10,34,22,8,15,92,101
2014,2,21400821,2/22/2015,1610612752,New York Knicks,1,0,1610612739,Cleveland Cavaliers,0,1,34,46,80,3,16,19,37,62,99,6,1,7,22,40,16,5,11,92,83
2021,2,22100242,11/20/2021,1610612737,Atlanta Hawks,1,1,1610612766,Charlotte Hornets,0,0,31,17,48,12,22,34,43,39,82,17,4,21,9,33,24,6,12,96,115
2021,2,22100242,11/20/2021,1610612766,Charlotte Hornets,0,0,1610612737,Atlanta Hawks,1,1,33,29,62,10,30,40,43,59,102,9,6,15,22,41,26,6,10,97,105
2018,2,21800483,12/22/2018,1610612745,Houston Rockets,1,1,1610612759,San Antonio Spurs,0,0,18,23,41,19,35,54,37,58,95,15,6,21,21,40,22,3,9,93,108
2018,2,21800483,12/22/2018,1610612759,San Antonio Spurs,0,0,1610612745,Houston Rockets,1,1,32,32,64,10,14,24,42,46,88,7,4,11,9,39,24,4,9,93,101
2016,2,21601164,4/4/2017,1610612757,Portland Trail Blazers,0,0,1610612762,Utah Jazz,1,1,27,30,57,6,20,26,33,50,83,15,2,17,12,40,10,4,9,87,87
2016,2,21601164,4/4/2017,1610612762,Utah Jazz,1,1,1610612757,Portland Trail Blazers,0,0,26,25,51,13,10,23,39,35,74,15,4,19,11,25,21,8,15,87,106
2016,2,21600609,1/15/2017,1610612745,Houston Rockets,0,1,1610612751,Brooklyn Nets,1,0,25,23,48,21,23,44,46,46,92,24,8,32,17,31,30,9,14,104,137
2016,2,21600609,1/15/2017,1610612751,Brooklyn Nets,1,0,1610612745,Houston Rockets,0,1,26,23,49,15,29,44,41,52,93,15,4,19,16,39,29,9,18,104,112
2019,2,21900289,12/1/2019,1610612740,New Orleans Pelicans,1,0,1610612760,Oklahoma City Thunder,0,1,22,27,49,17,21,38,39,48,87,9,1,10,7,42,22,5,11,96,104
2019,2,21900289,12/1/2019,1610612760,Oklahoma City Thunder,0,1,1610612740,New Orleans Pelicans,1,0,27,21,48,11,22,33,38,43,81,20,6,26,8,39,19,6,11,96,107
2018,2,21801182,4/5/2019,1610612759,San Antonio Spurs,0,1,1610612764,Washington Wizards,1,0,41,25,66,10,15,25,51,40,91,17,3,20,14,27,34,2,9,95,129
2018,2,21801182,4/5/2019,1610612764,Washington Wizards,1,0,1610612759,San Antonio Spurs,0,1,33,23,56,9,23,32,42,46,88,19,3,22,13,33,22,3,10,96,112
2018,2,21801035,3/16/2019,1610612763,Memphis Grizzlies,0,0,1610612764,Washington Wizards,1,1,36,21,57,12,21,33,48,42,90,20,6,26,9,36,35,6,10,103,128
2018,2,21801035,3/16/2019,1610612764,Washington Wizards,1,1,1610612763,Memphis Grizzlies,0,0,24,22,46,17,18,35,41,40,81,36,7,43,11,33,26,5,13,104,135
2018,2,21800899,2/25/2019,1610612754,Indiana Pacers,0,0,1610612765,Detroit Pistons,1,1,30,31,61,10,16,26,40,47,87,19,2,21,14,34,23,8,11,95,109
2018,2,21800899,2/25/2019,1610612765,Detroit Pistons,1,1,1610612754,Indiana Pacers,0,0,21,26,47,18,23,41,39,49,88,17,9,26,18,34,28,8,12,95,113
2018,2,21800797,2/5/2019,1610612738,Boston Celtics,0,1,1610612739,Cleveland Cavaliers,1,0,31,25,56,9,17,26,40,42,82,14,0,14,9,33,29,6,13,92,103
2018,2,21800797,2/5/2019,1610612739,Cleveland Cavaliers,1,0,1610612738,Boston Celtics,0,1,31,32,63,9,24,33,40,56,96,7,1,8,21,36,21,10,14,92,96
2018,2,21800634,1/12/2019,1610612759,San Antonio Spurs,0,0,1610612760,Oklahoma City Thunder,1,1,34,31,65,10,21,31,44,52,96,14,6,20,14,41,21,10,14,104,112
2018,2,21800634,1/12/2019,1610612760,Oklahoma City Thunder,1,1,1610612759,San Antonio Spurs,0,0,32,38,70,11,12,23,43,50,93,25,4,29,9,41,27,5,7,104,122
2020,2,22000931,4/27/2021,1610612745,Houston Rockets,1,0,1610612750,Minnesota Timberwolves,0,1,35,20,55,7,24,31,42,44,86,16,6,22,8,39,24,10,17,104,107
2020,2,22000931,4/27/2021,1610612750,Minnesota Timberwolves,0,1,1610612745,Houston Rockets,1,0,35,20,55,10,28,38,45,48,93,14,11,25,14,41,29,9,14,104,114
2018,2,21800237,11/18/2018,1610612757,Portland Trail Blazers,0,1,1610612764,Washington Wizards,1,0,28,28,56,11,19,30,39,47,86,30,5,35,11,38,26,4,15,105,119
2018,2,21800237,11/18/2018,1610612764,Washington Wizards,1,0,1610612757,Portland Trail Blazers,0,1,30,34,64,13,19,32,43,53,96,10,11,21,14,45,28,4,12,104,109
2020,2,22000014,12/23/2020,1610612740,New Orleans Pelicans,0,1,1610612761,Toronto Raptors,1,0,23,15,38,19,23,42,42,38,80,10,10,20,13,30,30,10,27,104,113
2020,2,22000014,12/23/2020,1610612761,Toronto Raptors,1,0,1610612740,New Orleans Pelicans,0,1,24,19,43,14,32,46,38,51,89,9,3,12,14,37,26,13,21,103,99
2014,2,21400820,2/21/2015,1610612746,LA Clippers,1,1,1610612758,Sacramento Kings,0,0,32,28,60,14,21,35,46,49,95,20,8,28,12,41,31,4,11,108,126
2016,2,21600608,1/15/2017,1610612742,Dallas Mavericks,1,1,1610612750,Minnesota Timberwolves,0,0,24,24,48,12,17,29,36,41,77,14,5,19,7,36,21,7,11,89,98
2016,2,21600608,1/15/2017,1610612750,Minnesota Timberwolves,0,0,1610612742,Dallas Mavericks,1,1,30,29,59,5,16,21,35,45,80,12,6,18,11,37,20,8,12,90,87
2021,2,22100241,11/20/2021,1610612748,Miami Heat,0,0,1610612764,Washington Wizards,1,1,31,23,54,7,20,27,38,43,81,17,3,20,15,29,21,6,14,92,100
2021,2,22100241,11/20/2021,1610612764,Washington Wizards,1,1,1610612748,Miami Heat,0,0,25,19,44,11,19,30,36,38,74,20,3,23,12,28,22,7,20,91,103
2014,2,21400820,2/21/2015,1610612758,Sacramento Kings,0,0,1610612746,LA Clippers,1,1,26,46,72,4,12,16,30,58,88,35,11,46,20,44,18,9,17,108,99
2018,2,21800898,2/25/2019,1610612739,Cleveland Cavaliers,1,0,1610612757,Portland Trail Blazers,0,1,24,31,55,13,21,34,37,52,89,23,3,26,14,40,22,5,8,95,110
2018,2,21800898,2/25/2019,1610612757,Portland Trail Blazers,0,1,1610612739,Cleveland Cavaliers,1,0,26,23,49,18,11,29,44,34,78,17,5,22,6,31,26,4,13,95,123
2018,2,21800633,1/12/2019,1610612740,New Orleans Pelicans,0,0,1610612750,Minnesota Timberwolves,1,1,35,28,63,5,19,24,40,47,87,21,3,24,13,36,22,7,17,102,106
2018,2,21800633,1/12/2019,1610612750,Minnesota Timberwolves,1,1,1610612740,New Orleans Pelicans,0,0,29,25,54,11,28,39,40,53,93,19,5,24,18,39,23,7,15,102,110
2018,2,21800556,1/2/2019,1610612737,Atlanta Hawks,0,0,1610612764,Washington Wizards,1,1,30,34,64,10,21,31,40,55,95,8,5,13,18,39,26,10,14,101,98
2018,2,21800556,1/2/2019,1610612764,Washington Wizards,1,1,1610612737,Atlanta Hawks,0,0,32,31,63,11,18,29,43,49,92,17,6,23,13,38,29,5,10,99,114
2020,2,22000930,4/27/2021,1610612751,Brooklyn Nets,0,1,1610612761,Toronto Raptors,1,0,22,16,38,18,27,45,40,43,83,18,0,18,8,35,30,5,11,94,116
2020,2,22000930,4/27/2021,1610612761,Toronto Raptors,1,0,1610612751,Brooklyn Nets,0,1,21,27,48,15,28,43,36,55,91,16,3,19,18,39,24,9,13,95,103
2018,2,21800412,12/12/2018,1610612737,Atlanta Hawks,0,0,1610612742,Dallas Mavericks,1,1,32,28,60,11,22,33,43,50,93,10,4,14,19,34,21,13,21,101,107
2018,2,21800412,12/12/2018,1610612742,Dallas Mavericks,1,1,1610612737,Atlanta Hawks,0,0,23,18,41,12,22,34,35,40,75,32,11,43,10,32,22,7,14,101,114
2020,2,22000013,12/23/2020,1610612755,Philadelphia 76ers,1,1,1610612764,Washington Wizards,0,0,33,26,59,8,20,28,41,46,87,23,7,30,14,36,22,7,18,105,113
2020,2,22000013,12/23/2020,1610612764,Washington Wizards,0,0,1610612755,Philadelphia 76ers,1,1,26,32,58,13,14,27,39,46,85,16,7,23,9,40,28,11,20,106,107
2016,2,21601163,4/4/2017,1610612742,Dallas Mavericks,0,0,1610612758,Sacramento Kings,1,1,20,17,37,12,31,43,32,48,80,11,3,14,10,40,21,11,16,95,87
2016,2,21601163,4/4/2017,1610612758,Sacramento Kings,1,1,1610612742,Dallas Mavericks,0,0,24,35,59,12,10,22,36,45,81,14,3,17,15,32,17,9,19,94,98
2016,2,21600607,1/15/2017,1610612737,Atlanta Hawks,1,1,1610612749,Milwaukee Bucks,0,0,29,25,54,13,13,26,42,38,80,14,4,18,17,24,29,11,19,90,111
2016,2,21600607,1/15/2017,1610612749,Milwaukee Bucks,0,0,1610612737,Atlanta Hawks,1,1,33,27,60,6,13,19,39,40,79,14,4,18,16,27,25,9,17,90,98
2016,2,21600146,11/14/2016,1610612742,Dallas Mavericks,0,0,1610612752,New York Knicks,1,1,27,30,57,5,22,27,32,52,84,8,3,11,15,40,15,5,13,88,77
2016,2,21600146,11/14/2016,1610612752,New York Knicks,1,1,1610612742,Dallas Mavericks,0,0,25,28,53,9,16,25,34,44,78,16,2,18,16,29,18,8,17,87,93
2014,2,21400819,2/21/2015,1610612745,Houston Rockets,1,1,1610612761,Toronto Raptors,0,0,29,26,55,6,23,29,35,49,84,22,9,31,18,36,22,17,25,106,98
2014,2,21400819,2/21/2015,1610612761,Toronto Raptors,0,0,1610612745,Houston Rockets,1,1,21,38,59,4,14,18,25,52,77,22,6,28,11,45,12,17,25,105,76
2018,2,21800709,1/23/2019,1610612746,LA Clippers,0,1,1610612748,Miami Heat,1,0,38,25,63,7,15,22,45,40,85,14,7,21,12,30,23,3,7,92,111
2018,2,21800709,1/23/2019,1610612748,Miami Heat,1,0,1610612746,LA Clippers,0,1,31,24,55,8,20,28,39,44,83,13,9,22,14,35,23,5,14,93,99
2018,2,21800482,12/22/2018,1610612748,Miami Heat,1,1,1610612749,Milwaukee Bucks,0,0,24,33,57,10,22,32,34,55,89,16,7,23,12,47,22,6,12,100,94
2018,2,21800482,12/22/2018,1610612749,Milwaukee Bucks,0,0,1610612748,Miami Heat,1,1,22,19,41,9,34,43,31,53,84,16,6,22,8,49,20,9,16,100,87
2020,2,22000929,4/27/2021,1610612754,Indiana Pacers,1,0,1610612757,Portland Trail Blazers,0,1,30,26,56,10,20,30,40,46,86,22,6,28,8,42,25,6,13,102,112
2020,2,22000929,4/27/2021,1610612757,Portland Trail Blazers,0,1,1610612754,Indiana Pacers,1,0,30,41,71,20,15,35,50,56,106,13,3,16,23,34,26,6,13,104,133
2021,2,22100240,11/20/2021,1610612740,New Orleans Pelicans,0,0,1610612754,Indiana Pacers,1,1,29,41,70,6,12,18,35,53,88,18,1,19,12,41,17,11,16,101,94
2021,2,22100240,11/20/2021,1610612754,Indiana Pacers,1,1,1610612740,New Orleans Pelicans,0,0,28,25,53,14,24,38,42,49,91,13,5,18,9,42,28,7,11,102,111
2019,2,21900288,12/1/2019,1610612759,San Antonio Spurs,0,0,1610612765,Detroit Pistons,1,1,29,33,62,7,19,26,36,52,88,19,3,22,9,43,20,5,8,99,98
2019,2,21900288,12/1/2019,1610612765,Detroit Pistons,1,1,1610612759,San Antonio Spurs,0,0,37,20,57,15,16,31,52,36,88,13,5,18,13,26,33,11,17,99,132
2022,2,22200465,12/20/2022,1610612743,Denver Nuggets,1,1,1610612763,Memphis Grizzlies,0,0,30,32,62,10,17,27,40,49,89,15,10,25,18,36,28,11,17,100,105
2022,2,22200465,12/20/2022,1610612763,Memphis Grizzlies,0,0,1610612743,Denver Nuggets,1,1,31,24,55,5,21,26,36,45,81,14,7,21,8,40,25,9,16,101,91
2018,2,21801181,4/5/2019,1610612737,Atlanta Hawks,0,0,1610612753,Orlando Magic,1,1,31,24,55,10,29,39,41,53,94,21,10,31,12,46,21,11,14,111,113
2018,2,21801181,4/5/2019,1610612753,Orlando Magic,1,1,1610612737,Atlanta Hawks,0,0,38,17,55,18,19,37,56,36,92,19,6,25,11,29,35,16,19,111,149
2018,2,21801034,3/16/2019,1610612737,Atlanta Hawks,0,0,1610612738,Boston Celtics,1,1,28,32,60,15,25,40,43,57,100,19,5,24,23,37,27,10,17,105,120
2018,2,21801034,3/16/2019,1610612738,Boston Celtics,1,1,1610612737,Atlanta Hawks,0,0,31,26,57,13,23,36,44,49,93,28,9,37,19,34,30,11,14,104,129
2018,2,21800290,11/25/2018,1610612748,Miami Heat,0,0,1610612761,Toronto Raptors,1,1,24,35,59,15,21,36,39,56,95,22,10,32,18,41,21,4,7,99,115
2018,2,21800290,11/25/2018,1610612761,Toronto Raptors,1,1,1610612748,Miami Heat,0,0,36,19,55,11,24,35,47,43,90,20,5,25,14,31,25,6,11,100,125
2017,2,21701180,4/5/2018,1610612743,Denver Nuggets,1,1,1610612750,Minnesota Timberwolves,0,0,24,29,53,11,25,36,35,54,89,19,3,22,19,37,21,4,11,90,100
2017,2,21701180,4/5/2018,1610612750,Minnesota Timberwolves,0,0,1610612743,Denver Nuggets,1,1,33,34,67,6,18,24,39,52,91,12,4,16,17,39,22,3,8,90,96
2017,2,21701120,3/28/2018,1610612737,Atlanta Hawks,0,0,1610612750,Minnesota Timberwolves,1,1,28,22,50,13,14,27,41,36,77,19,4,23,7,31,26,9,20,101,114
2017,2,21701120,3/28/2018,1610612750,Minnesota Timberwolves,1,1,1610612737,Atlanta Hawks,0,0,35,25,60,13,17,30,48,42,90,17,4,21,9,34,33,10,13,102,126
2020,2,22000012,12/23/2020,1610612748,Miami Heat,0,0,1610612753,Orlando Magic,1,1,35,28,63,7,13,20,42,41,83,16,3,19,8,34,25,15,22,105,107
2020,2,22000012,12/23/2020,1610612753,Orlando Magic,1,1,1610612748,Miami Heat,0,0,32,28,60,10,18,28,42,46,88,19,11,30,15,38,23,11,18,105,113
2016,2,21601162,4/4/2017,1610612744,Golden State Warriors,1,1,1610612750,Minnesota Timberwolves,0,0,30,22,52,14,18,32,44,40,84,19,5,24,11,32,33,9,13,98,121
2019,2,21900062,10/30/2019,1610612757,Portland Trail Blazers,0,1,1610612760,Oklahoma City Thunder,1,0,17,34,51,17,18,35,34,52,86,17,7,24,12,44,19,8,19,105,102
2019,2,21900062,10/30/2019,1610612760,Oklahoma City Thunder,1,0,1610612757,Portland Trail Blazers,0,1,29,28,57,4,23,27,33,51,84,29,8,37,16,40,15,9,19,106,99
2016,2,21601162,4/4/2017,1610612750,Minnesota Timberwolves,0,0,1610612744,Golden State Warriors,1,1,37,40,77,4,15,19,41,55,96,21,5,26,21,36,22,9,14,97,107
2014,2,21400818,2/21/2015,1610612741,Chicago Bulls,1,1,1610612756,Phoenix Suns,0,0,31,34,65,12,12,24,43,46,89,14,2,16,18,28,27,10,17,97,112
2014,2,21400818,2/21/2015,1610612756,Phoenix Suns,0,0,1610612741,Chicago Bulls,1,1,37,26,63,10,15,25,47,41,88,3,5,8,9,34,25,5,13,97,107
2021,2,22100239,11/20/2021,1610612745,Houston Rockets,0,0,1610612752,New York Knicks,1,1,28,17,45,10,29,39,38,46,84,13,9,22,15,33,21,12,22,101,99
2021,2,22100239,11/20/2021,1610612752,New York Knicks,1,1,1610612745,Houston Rockets,0,0,15,22,37,18,23,41,33,45,78,22,4,26,7,39,25,5,15,100,106
2018,2,21800897,2/25/2019,1610612744,Golden State Warriors,0,1,1610612766,Charlotte Hornets,1,0,34,20,54,14,27,41,48,47,95,11,2,13,15,32,35,13,15,101,121
2018,2,21800897,2/25/2019,1610612766,Charlotte Hornets,1,0,1610612744,Golden State Warriors,0,1,33,25,58,7,26,33,40,51,91,23,3,26,14,39,23,9,12,101,110
2018,2,21800796,2/5/2019,1610612746,LA Clippers,0,1,1610612766,Charlotte Hornets,1,0,24,39,63,18,6,24,42,45,87,15,2,17,10,36,25,8,11,96,117
2018,2,21800796,2/5/2019,1610612766,Charlotte Hornets,1,0,1610612746,LA Clippers,0,1,24,27,51,15,27,42,39,54,93,22,4,26,15,41,19,1,5,97,115
2020,2,22000928,4/27/2021,1610612749,Milwaukee Bucks,0,1,1610612766,Charlotte Hornets,1,0,38,20,58,9,26,35,47,46,93,11,3,14,12,36,28,6,15,104,114
2020,2,22000928,4/27/2021,1610612766,Charlotte Hornets,1,0,1610612749,Milwaukee Bucks,0,1,26,21,47,12,23,35,38,44,82,16,7,23,8,39,26,13,18,103,104
2020,2,22000011,12/23/2020,1610612752,New York Knicks,0,0,1610612754,Indiana Pacers,1,1,27,30,57,12,16,28,39,46,85,17,6,23,5,44,25,6,16,105,107
2020,2,22000011,12/23/2020,1610612754,Indiana Pacers,1,1,1610612752,New York Knicks,0,0,38,22,60,8,26,34,46,48,94,21,8,29,16,36,28,8,13,106,121
2021,2,22100238,11/19/2021,1610612758,Sacramento Kings,1,0,1610612761,Toronto Raptors,0,1,23,24,47,9,28,37,32,52,84,16,9,25,16,42,15,9,15,94,89
2021,2,22100238,11/19/2021,1610612761,Toronto Raptors,0,1,1610612758,Sacramento Kings,1,0,26,27,53,12,19,31,38,46,84,20,4,24,18,30,20,8,17,94,108
2016,2,21600606,1/15/2017,1610612752,New York Knicks,0,0,1610612761,Toronto Raptors,1,1,23,32,55,12,17,29,35,49,84,19,8,27,16,34,21,9,16,96,101
2016,2,21600606,1/15/2017,1610612761,Toronto Raptors,1,1,1610612752,New York Knicks,0,0,36,31,67,8,14,22,44,45,89,20,3,23,14,32,21,7,11,97,116
2016,2,21600145,11/14/2016,1610612753,Orlando Magic,0,0,1610612754,Indiana Pacers,1,1,22,37,59,5,20,25,27,57,84,10,3,13,13,44,12,9,16,93,69
2016,2,21600145,11/14/2016,1610612754,Indiana Pacers,1,1,1610612753,Orlando Magic,0,0,27,38,65,8,17,25,35,55,90,10,0,10,10,45,22,3,9,93,88
2020,2,22000927,4/27/2021,1610612738,Boston Celtics,1,0,1610612760,Oklahoma City Thunder,0,1,30,18,48,11,38,49,41,56,97,22,3,25,12,46,21,5,14,113,115
2020,2,22000927,4/27/2021,1610612760,Oklahoma City Thunder,0,1,1610612738,Boston Celtics,1,0,26,25,51,13,17,30,39,42,81,28,8,36,13,32,25,16,27,112,119
2018,2,21800347,12/3/2018,1610612743,Denver Nuggets,0,1,1610612761,Toronto Raptors,1,0,29,32,61,11,17,28,40,49,89,15,9,24,18,37,32,10,20,102,106
2018,2,21800347,12/3/2018,1610612761,Toronto Raptors,1,0,1610612743,Denver Nuggets,0,1,29,17,46,11,30,41,40,47,87,12,0,12,9,38,28,9,17,104,103
2018,2,21800183,11/10/2018,1610612747,Los Angeles Lakers,0,1,1610612758,Sacramento Kings,1,0,29,32,61,12,26,38,41,58,99,7,10,17,22,41,23,7,16,102,101
2018,2,21800183,11/10/2018,1610612758,Sacramento Kings,1,0,1610612747,Los Angeles Lakers,0,1,26,41,67,6,19,25,32,60,92,16,4,20,18,45,11,11,19,103,86
2020,2,22000010,12/23/2020,1610612739,Cleveland Cavaliers,1,1,1610612766,Charlotte Hornets,0,0,32,25,57,14,16,30,46,41,87,15,5,20,15,29,34,10,21,100,121
2020,2,22000010,12/23/2020,1610612766,Charlotte Hornets,0,0,1610612739,Cleveland Cavaliers,1,1,29,17,46,16,28,44,45,45,90,8,7,15,10,40,29,12,15,102,114
2019,2,21900061,10/30/2019,1610612745,Houston Rockets,0,1,1610612764,Washington Wizards,1,0,32,17,49,23,31,54,55,48,103,26,7,33,19,34,34,6,13,111,159
2019,2,21900061,10/30/2019,1610612764,Washington Wizards,1,0,1610612745,Houston Rockets,0,1,37,18,55,20,16,36,57,34,91,24,5,29,11,27,31,10,19,111,158
2014,2,21400817,2/21/2015,1610612740,New Orleans Pelicans,0,1,1610612748,Miami Heat,1,0,27,35,62,8,13,21,35,48,83,27,4,31,19,32,22,5,13,91,105
2014,2,21400817,2/21/2015,1610612748,Miami Heat,1,0,1610612740,New Orleans Pelicans,0,1,28,34,62,5,12,17,33,46,79,20,7,27,18,31,15,8,17,92,91
2021,2,22100237,11/19/2021,1610612742,Dallas Mavericks,0,0,1610612756,Phoenix Suns,1,1,25,25,50,12,28,40,37,53,90,18,5,23,11,44,25,7,10,99,104
2021,2,22100237,11/19/2021,1610612756,Phoenix Suns,1,1,1610612742,Dallas Mavericks,0,0,30,26,56,14,15,29,44,41,85,10,4,14,12,31,28,15,18,100,112
2018,2,21801180,4/5/2019,1610612761,Toronto Raptors,0,0,1610612766,Charlotte Hornets,1,1,34,20,54,9,17,26,43,37,80,16,4,20,8,32,27,6,14,95,111
2018,2,21801180,4/5/2019,1610612766,Charlotte Hornets,1,1,1610612761,Toronto Raptors,0,0,31,24,55,13,26,39,44,50,94,12,2,14,10,41,28,2,7,95,113
2018,2,21801033,3/15/2019,1610612741,Chicago Bulls,0,0,1610612746,LA Clippers,1,1,31,28,59,11,10,21,42,38,80,26,7,33,11,29,24,9,17,103,121
2018,2,21801033,3/15/2019,1610612746,LA Clippers,1,1,1610612741,Chicago Bulls,0,0,34,45,79,10,10,20,44,55,99,30,5,35,21,38,28,3,8,101,128
2018,2,21800795,2/4/2019,1610612758,Sacramento Kings,1,1,1610612759,San Antonio Spurs,0,0,37,21,58,13,19,32,50,40,90,14,9,23,11,32,26,6,8,99,127
2018,2,21800795,2/4/2019,1610612759,San Antonio Spurs,0,0,1610612758,Sacramento Kings,1,1,33,33,66,9,23,32,42,56,98,19,2,21,17,40,18,5,9,99,112
2018,2,21800708,1/23/2019,1610612751,Brooklyn Nets,1,1,1610612753,Orlando Magic,0,0,33,25,58,10,22,32,43,47,90,18,5,23,15,34,20,7,17,103,114
2018,2,21800708,1/23/2019,1610612753,Orlando Magic,0,0,1610612751,Brooklyn Nets,1,1,27,28,55,11,23,34,38,51,89,23,5,28,14,38,22,7,13,102,110
2018,2,21800555,1/2/2019,1610612739,Cleveland Cavaliers,1,0,1610612748,Miami Heat,0,1,21,23,44,13,18,31,34,41,75,11,2,13,5,37,23,8,13,90,92
2018,2,21800555,1/2/2019,1610612748,Miami Heat,0,1,1610612739,Cleveland Cavaliers,1,0,28,27,55,16,15,31,44,42,86,13,4,17,18,26,29,8,13,91,117
2018,2,21800289,11/25/2018,1610612751,Brooklyn Nets,1,0,1610612755,Philadelphia 76ers,0,1,40,23,63,10,15,25,50,38,88,15,5,20,12,29,19,9,16,100,125
2018,2,21800289,11/25/2018,1610612755,Philadelphia 76ers,0,1,1610612751,Brooklyn Nets,1,0,32,30,62,12,17,29,44,47,91,27,6,33,16,34,28,2,9,99,127
2018,2,21800236,11/18/2018,1610612752,New York Knicks,0,0,1610612753,Orlando Magic,1,1,32,31,63,8,16,24,40,47,87,29,6,35,19,30,12,5,14,96,117
2018,2,21800236,11/18/2018,1610612753,Orlando Magic,1,1,1610612752,New York Knicks,0,0,35,17,52,13,19,32,48,36,84,22,4,26,13,26,35,7,17,98,131
2018,2,21800081,10/27/2018,1610612749,Milwaukee Bucks,1,1,1610612753,Orlando Magic,0,0,31,21,52,10,20,30,41,41,82,21,2,23,8,34,24,9,21,105,113
2020,2,22000009,12/25/2020,1610612743,Denver Nuggets,1,0,1610612746,LA Clippers,0,1,26,19,45,11,25,36,37,44,81,23,8,31,14,33,25,9,13,95,108
2020,2,22000009,12/25/2020,1610612746,LA Clippers,0,1,1610612743,Denver Nuggets,1,0,22,14,36,19,19,38,41,33,74,20,4,24,11,23,32,7,21,94,121
2021,2,22100236,11/19/2021,1610612741,Chicago Bulls,0,1,1610612743,Denver Nuggets,1,0,33,29,62,8,23,31,41,52,93,24,0,24,19,33,19,5,11,96,114
2021,2,22100236,11/19/2021,1610612743,Denver Nuggets,1,0,1610612741,Chicago Bulls,0,1,25,20,45,14,23,37,39,43,82,16,4,20,10,34,24,7,14,95,108
2019,2,21900287,12/1/2019,1610612742,Dallas Mavericks,0,1,1610612747,Los Angeles Lakers,1,0,25,23,48,17,32,49,42,55,97,13,5,18,20,37,24,9,13,99,114
2019,2,21900287,12/1/2019,1610612747,Los Angeles Lakers,1,0,1610612742,Dallas Mavericks,0,1,33,27,60,7,20,27,40,47,87,13,3,16,11,37,25,11,17,99,100
2016,2,21601161,4/4/2017,1610612759,San Antonio Spurs,1,1,1610612763,Memphis Grizzlies,0,0,24,35,59,11,10,21,35,45,80,14,4,18,9,40,22,9,15,95,95
2016,2,21601161,4/4/2017,1610612763,Memphis Grizzlies,0,0,1610612759,San Antonio Spurs,1,1,27,37,64,8,17,25,35,54,89,11,7,18,19,38,26,8,15,96,89
2016,2,21600605,1/14/2017,1610612756,Phoenix Suns,1,1,1610612759,San Antonio Spurs,0,0,31,33,64,8,13,21,39,46,85,22,2,24,19,28,18,8,15,95,108
2016,2,21600605,1/14/2017,1610612759,San Antonio Spurs,0,0,1610612756,Phoenix Suns,1,1,27,24,51,9,11,20,36,35,71,24,10,34,7,31,15,10,16,94,105
2018,2,21800896,2/24/2019,1610612752,New York Knicks,1,1,1610612759,San Antonio Spurs,0,0,34,27,61,16,21,37,50,48,98,14,5,19,15,37,25,3,7,98,130
2018,2,21800896,2/24/2019,1610612759,San Antonio Spurs,0,0,1610612752,New York Knicks,1,1,36,34,70,6,18,24,42,52,94,28,3,31,16,38,18,3,7,97,118
2018,2,21800481,12/22/2018,1610612755,Philadelphia 76ers,1,1,1610612761,Toronto Raptors,0,0,38,23,61,8,16,24,46,39,85,26,9,35,5,36,33,5,13,110,126
2018,2,21800481,12/22/2018,1610612761,Toronto Raptors,0,0,1610612755,Philadelphia 76ers,1,1,27,28,55,10,30,40,37,58,95,17,2,19,9,50,17,10,15,111,101
2018,2,21800411,12/12/2018,1610612740,New Orleans Pelicans,1,1,1610612760,Oklahoma City Thunder,0,0,41,38,79,4,14,18,45,52,97,24,6,30,21,34,29,10,18,108,118
2018,2,21800411,12/12/2018,1610612760,Oklahoma City Thunder,0,0,1610612740,New Orleans Pelicans,1,1,29,15,44,13,30,43,42,45,87,17,10,27,11,39,23,14,18,107,114
2014,2,21400816,2/21/2015,1610612760,Oklahoma City Thunder,0,1,1610612766,Charlotte Hornets,1,0,37,40,77,5,13,18,42,53,95,21,5,26,24,33,21,9,14,101,110
2014,2,21400816,2/21/2015,1610612766,Charlotte Hornets,1,0,1610612760,Oklahoma City Thunder,0,1,33,36,69,7,17,24,40,53,93,16,4,20,14,42,28,7,9,100,103
2018,2,21801179,4/4/2019,1610612744,Golden State Warriors,0,1,1610612747,Los Angeles Lakers,1,0,25,27,52,18,28,46,43,55,98,4,1,5,12,44,30,10,15,103,108
2018,2,21801179,4/4/2019,1610612747,Los Angeles Lakers,1,0,1610612744,Golden State Warriors,0,1,29,38,67,8,29,37,37,67,104,8,6,14,26,44,25,11,18,105,90
2018,2,21801032,3/15/2019,1610612752,New York Knicks,0,0,1610612759,San Antonio Spurs,1,1,27,39,66,8,12,20,35,51,86,5,4,9,12,41,21,8,16,95,83
2018,2,21801032,3/15/2019,1610612759,San Antonio Spurs,1,1,1610612752,New York Knicks,0,0,40,27,67,7,14,21,47,41,88,8,2,10,9,33,31,6,10,94,109
2018,2,21800632,1/12/2019,1610612738,Boston Celtics,0,0,1610612753,Orlando Magic,1,1,30,28,58,8,24,32,38,52,90,19,9,28,14,42,19,2,8,97,103
2020,2,22000926,4/26/2021,1610612742,Dallas Mavericks,0,0,1610612758,Sacramento Kings,1,1,31,19,50,12,30,42,43,49,92,8,6,14,15,37,24,6,10,94,106
2018,2,21800632,1/12/2019,1610612753,Orlando Magic,1,1,1610612738,Boston Celtics,0,0,25,21,46,11,27,38,36,48,84,22,2,24,12,37,21,7,15,98,105
2020,2,22000926,4/26/2021,1610612758,Sacramento Kings,1,1,1610612742,Dallas Mavericks,0,0,29,23,52,13,16,29,42,39,81,16,2,18,13,28,23,9,18,95,113
2023,2,22300511,1/8/2024,1610612756,Phoenix Suns,0,0,1610612746,LA Clippers,1,1,28,19,47,10,20,30,38,39,77,25,4,29,8,33,17,11,14,97,111
2018,2,21800081,10/27/2018,1610612753,Orlando Magic,0,0,1610612749,Milwaukee Bucks,1,1,23,35,58,10,33,43,33,68,101,15,2,17,16,52,21,6,11,105,91
2021,2,22100235,11/19/2021,1610612740,New Orleans Pelicans,1,1,1610612746,LA Clippers,0,0,25,32,57,13,17,30,38,49,87,5,3,8,13,37,19,7,13,93,94
2021,2,22100235,11/19/2021,1610612746,LA Clippers,0,0,1610612740,New Orleans Pelicans,1,1,25,28,53,9,28,37,34,56,90,4,1,5,11,46,22,9,12,93,81
2020,2,22000008,12/25/2020,1610612742,Dallas Mavericks,0,0,1610612747,Los Angeles Lakers,1,1,28,23,51,13,19,32,41,42,83,20,6,26,3,40,20,9,9,101,115
2020,2,22000008,12/25/2020,1610612747,Los Angeles Lakers,1,1,1610612742,Dallas Mavericks,0,0,32,20,52,19,20,39,51,40,91,17,7,24,18,26,33,13,17,101,138
2016,2,21600604,1/14/2017,1610612753,Orlando Magic,0,0,1610612762,Utah Jazz,1,1,26,22,48,12,22,34,38,44,82,19,8,27,10,38,23,6,15,101,107
2016,2,21600604,1/14/2017,1610612762,Utah Jazz,1,1,1610612753,Orlando Magic,0,0,34,23,57,7,19,26,41,42,83,25,11,36,11,35,28,10,13,100,114
2016,2,21600144,11/13/2016,1610612743,Denver Nuggets,0,0,1610612757,Portland Trail Blazers,1,1,25,37,62,11,18,29,36,55,91,22,7,29,21,35,11,8,18,103,105
2018,2,21800895,2/24/2019,1610612743,Denver Nuggets,1,1,1610612746,LA Clippers,0,0,32,19,51,12,22,34,44,41,85,23,12,35,13,34,30,9,23,110,123
2018,2,21800895,2/24/2019,1610612746,LA Clippers,0,0,1610612743,Denver Nuggets,1,1,27,39,66,3,18,21,30,57,87,33,4,37,11,46,20,11,17,109,96
2018,2,21800794,2/4/2019,1610612745,Houston Rockets,0,1,1610612756,Phoenix Suns,1,0,30,16,46,13,28,41,43,44,87,19,6,25,15,32,19,9,14,96,118
2018,2,21800794,2/4/2019,1610612756,Phoenix Suns,1,0,1610612745,Houston Rockets,0,1,38,21,59,7,18,25,45,39,84,13,5,18,11,32,29,13,17,98,110
2018,2,21800707,1/23/2019,1610612738,Boston Celtics,1,1,1610612739,Cleveland Cavaliers,0,0,33,28,61,12,13,25,45,41,86,21,2,23,10,32,25,4,14,100,123
2018,2,21800707,1/23/2019,1610612739,Cleveland Cavaliers,0,0,1610612738,Boston Celtics,1,1,25,32,57,13,17,30,38,49,87,14,6,20,18,34,20,12,21,100,103
2018,2,21800554,1/2/2019,1610612742,Dallas Mavericks,0,1,1610612766,Charlotte Hornets,1,0,26,24,50,18,27,45,44,51,95,16,2,18,16,36,31,4,12,100,122
2018,2,21800554,1/2/2019,1610612766,Charlotte Hornets,1,0,1610612742,Dallas Mavericks,0,1,26,32,58,6,26,32,32,58,90,14,5,19,14,48,23,9,14,98,84
2018,2,21800410,12/12/2018,1610612757,Portland Trail Blazers,0,0,1610612763,Memphis Grizzlies,1,1,26,39,65,6,16,22,32,55,87,13,3,16,13,43,15,9,14,97,83
2018,2,21800410,12/12/2018,1610612763,Memphis Grizzlies,1,1,1610612757,Portland Trail Blazers,0,0,26,32,58,8,16,24,34,48,82,16,8,24,12,41,19,11,13,95,92
2018,2,21800346,12/3/2018,1610612752,New York Knicks,1,0,1610612764,Washington Wizards,0,1,25,31,56,12,22,34,37,53,90,21,7,28,23,33,20,7,16,97,107
2018,2,21800346,12/3/2018,1610612764,Washington Wizards,0,1,1610612752,New York Knicks,1,0,31,29,60,13,19,32,44,48,92,9,3,12,12,38,30,4,10,96,110
2018,2,21800182,11/10/2018,1610612744,Golden State Warriors,1,1,1610612751,Brooklyn Nets,0,0,39,28,67,7,9,16,46,37,83,17,4,21,11,29,27,7,10,92,116
2018,2,21800182,11/10/2018,1610612751,Brooklyn Nets,0,0,1610612744,Golden State Warriors,1,1,29,24,53,7,17,24,36,41,77,21,8,29,13,32,20,9,15,93,100
2018,2,21800127,11/3/2018,1610612738,Boston Celtics,0,0,1610612754,Indiana Pacers,1,1,19,23,42,19,27,46,38,50,88,6,3,9,11,40,23,10,14,96,101
2018,2,21800127,11/3/2018,1610612754,Indiana Pacers,1,1,1610612738,Boston Celtics,0,0,25,29,54,11,21,32,36,50,86,19,6,25,16,38,23,6,13,96,102
2018,2,21800082,10/27/2018,1610612747,Los Angeles Lakers,0,0,1610612759,San Antonio Spurs,1,1,28,25,53,13,20,33,41,45,86,11,7,18,9,39,19,7,17,102,106
2018,2,21800082,10/27/2018,1610612759,San Antonio Spurs,1,1,1610612747,Los Angeles Lakers,0,0,41,34,75,3,13,16,44,47,91,19,5,24,13,36,20,5,13,102,110
2016,2,21601160,4/4/2017,1610612741,Chicago Bulls,0,0,1610612752,New York Knicks,1,1,26,32,58,6,21,27,32,53,85,21,2,23,16,39,22,4,14,94,91
2016,2,21601160,4/4/2017,1610612752,New York Knicks,1,1,1610612741,Chicago Bulls,0,0,36,30,66,6,17,23,42,47,89,10,6,16,18,31,26,7,15,92,100
2016,2,21600144,11/13/2016,1610612757,Portland Trail Blazers,1,1,1610612743,Denver Nuggets,0,0,31,39,70,8,21,29,39,60,99,26,6,32,18,46,21,4,8,102,112
2020,2,22000925,4/26/2021,1610612743,Denver Nuggets,1,1,1610612763,Memphis Grizzlies,0,0,34,27,61,11,22,33,45,49,94,19,3,22,11,40,25,8,11,103,120
2020,2,22000925,4/26/2021,1610612763,Memphis Grizzlies,0,0,1610612743,Denver Nuggets,1,1,30,19,49,4,28,32,34,47,81,24,7,31,8,41,20,8,16,103,96
2018,2,21800235,11/18/2018,1610612747,Los Angeles Lakers,0,1,1610612748,Miami Heat,1,0,31,37,68,11,16,27,42,53,95,18,3,21,18,38,16,3,10,95,113
2018,2,21800235,11/18/2018,1610612748,Miami Heat,1,0,1610612747,Los Angeles Lakers,0,1,22,33,55,13,19,32,35,52,87,14,5,19,16,37,20,7,14,94,97
2018,2,21800181,11/10/2018,1610612742,Dallas Mavericks,1,1,1610612760,Oklahoma City Thunder,0,0,29,19,48,14,15,29,43,34,77,11,6,17,9,27,31,9,16,94,111
2018,2,21800181,11/10/2018,1610612760,Oklahoma City Thunder,0,0,1610612742,Dallas Mavericks,1,1,29,34,63,9,25,34,38,59,97,11,7,18,28,36,17,9,16,94,96
2018,2,21800128,11/3/2018,1610612737,Atlanta Hawks,1,1,1610612748,Miami Heat,0,0,33,23,56,13,19,32,46,42,88,18,5,23,15,31,33,6,18,101,123
2018,2,21800128,11/3/2018,1610612748,Miami Heat,0,0,1610612737,Atlanta Hawks,1,1,25,20,45,16,24,40,41,44,85,20,6,26,15,32,27,11,18,100,118
2020,2,22000007,12/25/2020,1610612738,Boston Celtics,1,0,1610612751,Brooklyn Nets,0,1,29,42,71,8,19,27,37,61,98,13,6,19,26,37,23,5,15,98,95
2020,2,22000007,12/25/2020,1610612751,Brooklyn Nets,0,1,1610612738,Boston Celtics,1,0,26,21,47,15,14,29,41,35,76,26,5,31,11,28,21,6,16,97,123
2016,2,21601159,4/4/2017,1610612749,Milwaukee Bucks,0,0,1610612760,Oklahoma City Thunder,1,1,26,37,63,3,15,18,29,52,81,18,8,26,12,44,16,9,12,93,79
2016,2,21601159,4/4/2017,1610612760,Oklahoma City Thunder,1,1,1610612749,Milwaukee Bucks,0,0,31,25,56,9,19,28,40,44,84,21,4,25,16,31,29,9,14,95,110
2016,2,21600603,1/14/2017,1610612755,Philadelphia 76ers,0,0,1610612764,Washington Wizards,1,1,26,30,56,10,21,31,36,51,87,11,10,21,15,41,20,9,16,98,93
2016,2,21600603,1/14/2017,1610612764,Washington Wizards,1,1,1610612755,Philadelphia 76ers,0,0,36,38,74,8,9,17,44,47,91,13,5,18,13,36,18,6,11,97,109
2021,2,22100234,11/19/2021,1610612749,Milwaukee Bucks,1,1,1610612760,Oklahoma City Thunder,0,0,19,23,42,12,29,41,31,52,83,22,4,26,11,43,21,6,13,98,96
2021,2,22100234,11/19/2021,1610612760,Oklahoma City Thunder,0,0,1610612749,Milwaukee Bucks,1,1,20,23,43,12,36,48,32,59,91,13,8,21,15,48,17,9,12,98,89
2019,2,21900060,10/30/2019,1610612761,Toronto Raptors,1,1,1610612765,Detroit Pistons,0,0,38,21,59,13,14,27,51,35,86,10,2,12,3,33,30,5,15,104,125
2019,2,21900060,10/30/2019,1610612765,Detroit Pistons,0,0,1610612761,Toronto Raptors,1,1,27,31,58,14,16,30,41,47,88,17,6,23,16,34,30,12,20,106,113
2018,2,21801178,4/4/2019,1610612739,Cleveland Cavaliers,0,0,1610612758,Sacramento Kings,1,1,33,23,56,11,14,25,44,37,81,5,4,9,10,30,20,12,22,97,104
2018,2,21801178,4/4/2019,1610612758,Sacramento Kings,1,1,1610612739,Cleveland Cavaliers,0,0,34,25,59,14,24,38,48,49,97,7,3,10,10,42,28,3,7,99,117
2018,2,21801031,3/15/2019,1610612740,New Orleans Pelicans,1,0,1610612757,Portland Trail Blazers,0,1,37,27,64,8,22,30,45,49,94,12,13,25,15,39,31,7,11,103,110
2018,2,21801031,3/15/2019,1610612757,Portland Trail Blazers,0,1,1610612740,New Orleans Pelicans,1,0,33,36,69,10,17,27,43,53,96,26,6,32,24,32,26,7,15,102,122
2018,2,21800894,2/24/2019,1610612753,Orlando Magic,0,1,1610612761,Toronto Raptors,1,0,28,27,55,14,22,36,42,49,91,15,5,20,15,36,29,6,13,99,113
2018,2,21800894,2/24/2019,1610612761,Toronto Raptors,1,0,1610612753,Orlando Magic,0,1,27,36,63,11,17,28,38,53,91,11,3,14,13,42,30,6,13,98,98
2014,2,21400815,2/20/2015,1610612747,Los Angeles Lakers,1,0,1610612751,Brooklyn Nets,0,1,37,29,66,4,19,23,41,48,89,19,10,29,17,37,22,7,10,96,105
2014,2,21400815,2/20/2015,1610612751,Brooklyn Nets,0,1,1610612747,Los Angeles Lakers,1,0,32,36,68,10,11,21,42,47,89,20,4,24,14,35,29,10,11,96,114
2018,2,21800480,12/22/2018,1610612756,Phoenix Suns,0,0,1610612764,Washington Wizards,1,1,44,36,80,11,24,35,55,60,115,25,8,33,25,39,30,6,15,122,146
2018,2,21800480,12/22/2018,1610612764,Washington Wizards,1,1,1610612756,Phoenix Suns,0,0,43,32,75,13,23,36,56,55,111,24,3,27,23,33,40,14,22,123,149
2018,2,21800288,11/25/2018,1610612737,Atlanta Hawks,1,1,1610612766,Charlotte Hornets,0,0,34,21,55,16,23,39,50,44,94,8,3,11,12,34,34,8,15,103,124
2018,2,21800288,11/25/2018,1610612766,Charlotte Hornets,0,0,1610612737,Atlanta Hawks,1,1,23,24,47,18,27,45,41,51,92,23,5,28,15,37,30,5,12,104,123
2020,2,22000006,12/25/2020,1610612744,Golden State Warriors,0,0,1610612749,Milwaukee Bucks,1,1,24,30,54,10,35,45,34,65,99,21,4,25,13,53,14,6,11,109,99
2020,2,22000006,12/25/2020,1610612749,Milwaukee Bucks,1,1,1610612744,Golden State Warriors,0,0,30,24,54,20,16,36,50,40,90,18,8,26,13,33,25,5,18,108,138
2019,2,21900286,12/1/2019,1610612750,Minnesota Timberwolves,1,0,1610612763,Memphis Grizzlies,0,1,22,27,49,11,25,36,33,52,85,30,5,35,12,42,22,8,16,105,107
2019,2,21900286,12/1/2019,1610612763,Memphis Grizzlies,0,1,1610612750,Minnesota Timberwolves,1,0,25,35,60,16,24,40,41,59,100,17,4,21,15,44,27,7,11,105,115
2016,2,21600602,1/14/2017,1610612740,New Orleans Pelicans,0,0,1610612741,Chicago Bulls,1,1,32,29,61,7,16,23,39,45,84,14,7,21,7,42,27,10,11,95,99
2016,2,21600602,1/14/2017,1610612741,Chicago Bulls,1,1,1610612740,New Orleans Pelicans,0,0,35,46,81,8,12,20,43,58,101,13,10,23,29,38,22,3,10,96,107
2016,2,21600143,11/13/2016,1610612744,Golden State Warriors,1,1,1610612756,Phoenix Suns,0,0,29,25,54,16,17,33,45,42,87,27,4,31,11,33,32,10,16,105,133
2016,2,21600143,11/13/2016,1610612756,Phoenix Suns,0,0,1610612744,Golden State Warriors,1,1,38,28,66,8,16,24,46,44,90,20,6,26,9,37,27,8,13,107,120
2014,2,21400814,2/20/2015,1610612744,Golden State Warriors,1,1,1610612759,San Antonio Spurs,0,0,24,27,51,17,16,33,41,43,84,11,6,17,10,37,29,6,12,94,110
2014,2,21400814,2/20/2015,1610612759,San Antonio Spurs,0,0,1610612744,Golden State Warriors,1,1,33,29,62,6,13,19,39,42,81,15,5,20,11,33,25,10,16,96,99
2018,2,21800793,2/4/2019,1610612740,New Orleans Pelicans,1,0,1610612754,Indiana Pacers,0,1,30,22,52,9,29,38,39,51,90,20,4,24,14,40,26,5,17,104,107
2018,2,21800793,2/4/2019,1610612754,Indiana Pacers,0,1,1610612740,New Orleans Pelicans,1,0,31,32,63,10,18,28,41,50,91,17,7,24,10,43,25,6,9,105,109
2018,2,21800631,1/12/2019,1610612748,Miami Heat,1,1,1610612763,Memphis Grizzlies,0,0,25,24,49,15,16,31,40,40,80,17,7,24,13,31,25,9,14,93,112
2018,2,21800631,1/12/2019,1610612763,Memphis Grizzlies,0,0,1610612748,Miami Heat,1,1,30,22,52,9,20,29,39,42,81,21,6,27,14,32,18,7,13,92,108
2018,2,21800553,1/1/2019,1610612746,LA Clippers,1,0,1610612755,Philadelphia 76ers,0,1,37,29,66,5,20,25,42,49,91,24,10,34,12,41,18,7,13,107,113
2018,2,21800553,1/1/2019,1610612755,Philadelphia 76ers,0,1,1610612746,LA Clippers,1,0,30,31,61,12,14,26,42,45,87,23,10,33,18,31,25,12,21,106,119
2018,2,21800409,12/12/2018,1610612738,Boston Celtics,0,1,1610612764,Washington Wizards,1,0,36,30,66,11,27,38,47,57,104,25,0,25,21,36,20,7,14,110,130
2018,2,21800409,12/12/2018,1610612764,Washington Wizards,1,0,1610612738,Boston Celtics,0,1,34,24,58,12,21,33,46,45,91,21,8,29,10,39,25,6,15,111,125
2020,2,22000005,12/25/2020,1610612740,New Orleans Pelicans,0,0,1610612748,Miami Heat,1,1,21,22,43,10,25,35,31,47,78,26,7,33,16,33,18,11,19,96,98
2020,2,22000005,12/25/2020,1610612748,Miami Heat,1,1,1610612740,New Orleans Pelicans,0,0,22,16,38,16,21,37,38,37,75,19,4,23,7,31,29,8,17,94,111
2016,2,21601158,4/4/2017,1610612740,New Orleans Pelicans,1,0,1610612743,Denver Nuggets,0,1,37,31,68,14,18,32,51,49,100,15,2,17,16,35,30,3,7,99,131
2016,2,21601158,4/4/2017,1610612743,Denver Nuggets,0,1,1610612740,New Orleans Pelicans,1,0,40,29,69,13,17,30,53,46,99,15,6,21,22,26,31,5,11,99,134
2018,2,21801030,3/15/2019,1610612745,Houston Rockets,1,1,1610612756,Phoenix Suns,0,0,25,18,43,11,29,40,36,47,83,25,8,33,10,40,18,9,14,104,108
2018,2,21801030,3/15/2019,1610612756,Phoenix Suns,0,0,1610612745,Houston Rockets,1,1,31,32,63,7,19,26,38,51,89,19,6,25,17,36,22,13,21,104,102
2021,2,22100233,11/19/2021,1610612751,Brooklyn Nets,1,1,1610612753,Orlando Magic,0,0,31,27,58,10,23,33,41,50,91,23,2,25,17,34,19,7,11,96,115
2021,2,22100233,11/19/2021,1610612753,Orlando Magic,0,0,1610612751,Brooklyn Nets,1,1,26,25,51,14,24,38,40,49,89,19,6,25,17,33,26,6,13,97,113
2018,2,21800129,11/3/2018,1610612741,Chicago Bulls,1,0,1610612745,Houston Rockets,0,1,22,26,48,6,17,23,28,43,71,26,1,27,6,37,15,13,19,97,88
2018,2,21800129,11/3/2018,1610612745,Houston Rockets,0,1,1610612741,Chicago Bulls,1,0,22,19,41,13,29,42,35,48,83,13,7,20,14,36,21,13,19,97,96
2017,2,21701181,4/6/2018,1610612742,Dallas Mavericks,0,0,1610612765,Detroit Pistons,1,1,27,26,53,13,26,39,40,52,92,13,5,18,11,44,26,6,12,102,106
2017,2,21701181,4/6/2018,1610612765,Detroit Pistons,1,1,1610612742,Dallas Mavericks,0,0,34,28,62,12,18,30,46,46,92,9,8,17,11,39,24,7,11,102,113
2017,2,21701139,3/31/2018,1610612752,New York Knicks,1,0,1610612765,Detroit Pistons,0,1,30,32,62,13,16,29,43,48,91,10,2,12,15,34,31,8,14,96,109
2017,2,21701139,3/31/2018,1610612765,Detroit Pistons,0,1,1610612752,New York Knicks,1,0,34,27,61,10,14,24,44,41,85,17,5,22,11,33,24,4,9,94,115
2017,2,21701053,3/19/2018,1610612751,Brooklyn Nets,1,1,1610612763,Memphis Grizzlies,0,0,20,12,32,16,24,40,36,36,72,30,10,40,11,31,27,11,22,99,118
2017,2,21701053,3/19/2018,1610612763,Memphis Grizzlies,0,0,1610612751,Brooklyn Nets,1,1,36,29,65,10,13,23,46,42,88,13,7,20,14,33,21,5,17,99,115
2017,2,21701044,3/17/2018,1610612756,Phoenix Suns,1,0,1610612744,Golden State Warriors,0,1,28,30,58,11,13,24,39,43,82,20,9,29,10,39,22,8,19,103,109
2020,2,22000004,12/23/2020,1610612742,Dallas Mavericks,0,0,1610612756,Phoenix Suns,1,1,27,21,48,9,28,37,36,49,85,21,5,26,8,43,17,7,12,101,102
2020,2,22000004,12/23/2020,1610612756,Phoenix Suns,1,1,1610612742,Dallas Mavericks,0,0,27,22,49,11,19,30,38,41,79,19,8,27,9,35,21,6,19,102,106
2016,2,21600601,1/14/2017,1610612746,LA Clippers,1,1,1610612747,Los Angeles Lakers,0,0,38,26,64,10,18,28,48,44,92,7,1,8,9,36,28,3,8,96,113
2016,2,21600601,1/14/2017,1610612747,Los Angeles Lakers,0,0,1610612746,LA Clippers,1,1,26,33,59,10,11,21,36,44,80,15,12,27,13,37,21,6,15,97,97
2018,2,21801177,4/4/2019,1610612749,Milwaukee Bucks,0,1,1610612755,Philadelphia 76ers,1,0,30,29,59,12,22,34,42,51,93,32,11,43,12,42,26,4,11,112,128
2018,2,21801177,4/4/2019,1610612755,Philadelphia 76ers,1,0,1610612749,Milwaukee Bucks,0,1,27,32,59,18,18,36,45,50,95,14,4,18,6,45,36,5,13,111,122
2018,2,21800893,2/23/2019,1610612742,Dallas Mavericks,0,0,1610612762,Utah Jazz,1,1,28,33,61,13,23,36,41,56,97,14,4,18,9,48,25,2,3,100,109
2018,2,21800893,2/23/2019,1610612762,Utah Jazz,1,1,1610612742,Dallas Mavericks,0,0,27,20,47,14,24,38,41,44,85,29,4,33,10,35,28,2,7,98,125
2021,2,22100232,11/19/2021,1610612738,Boston Celtics,1,1,1610612747,Los Angeles Lakers,0,0,33,25,58,11,19,30,44,44,88,31,7,38,22,27,22,5,14,99,130
2021,2,22100232,11/19/2021,1610612747,Los Angeles Lakers,0,0,1610612738,Boston Celtics,1,1,27,27,54,12,18,30,39,45,84,18,6,24,8,40,20,7,12,99,108
2018,2,21800345,12/3/2018,1610612739,Cleveland Cavaliers,0,1,1610612751,Brooklyn Nets,1,0,34,39,73,4,11,15,38,50,88,19,1,20,16,34,15,5,10,91,99
2018,2,21800345,12/3/2018,1610612751,Brooklyn Nets,1,0,1610612739,Cleveland Cavaliers,0,1,29,30,59,10,30,40,39,60,99,9,7,16,21,43,17,5,8,92,97
2018,2,21800287,11/25/2018,1610612756,Phoenix Suns,0,0,1610612765,Detroit Pistons,1,1,34,23,57,8,17,25,42,40,82,15,6,21,11,32,22,9,17,97,107
2018,2,21800287,11/25/2018,1610612765,Detroit Pistons,1,1,1610612756,Phoenix Suns,0,0,27,25,52,16,25,41,43,50,93,16,9,25,20,35,30,6,13,98,118
2020,2,22000924,4/26/2021,1610612740,New Orleans Pelicans,1,1,1610612746,LA Clippers,0,0,29,24,53,15,14,29,44,38,82,17,9,26,10,32,28,5,16,100,120
2020,2,22000924,4/26/2021,1610612746,LA Clippers,0,0,1610612740,New Orleans Pelicans,1,1,22,23,45,14,31,45,36,54,90,17,0,17,17,37,20,13,19,101,103
2016,2,21601157,4/4/2017,1610612754,Indiana Pacers,1,1,1610612761,Toronto Raptors,0,0,27,37,64,12,13,25,39,50,89,18,0,18,14,36,16,7,11,94,108
2016,2,21601157,4/4/2017,1610612761,Toronto Raptors,0,0,1610612754,Indiana Pacers,1,1,29,24,53,5,18,23,34,42,76,17,2,19,7,36,11,7,14,93,90
2016,2,21600600,1/13/2017,1610612762,Utah Jazz,1,1,1610612765,Detroit Pistons,0,0,27,22,49,16,15,31,43,37,80,8,5,13,8,32,22,5,13,89,110
2016,2,21600600,1/13/2017,1610612765,Detroit Pistons,0,0,1610612762,Utah Jazz,1,1,24,35,59,6,11,17,30,46,76,11,5,16,6,43,15,10,13,90,77
2019,2,21900285,12/1/2019,1610612738,Boston Celtics,0,1,1610612752,New York Knicks,1,0,26,26,52,15,26,41,41,52,93,16,6,22,21,35,25,7,14,98,113
2019,2,21900285,12/1/2019,1610612752,New York Knicks,1,0,1610612738,Boston Celtics,0,1,27,23,50,8,18,26,35,41,76,26,11,37,12,32,15,5,16,98,104
2014,2,21400813,2/20/2015,1610612738,Boston Celtics,0,0,1610612758,Sacramento Kings,1,1,34,44,78,6,16,22,40,60,100,15,11,26,24,41,24,6,11,99,101
2014,2,21400813,2/20/2015,1610612758,Sacramento Kings,1,1,1610612738,Boston Celtics,0,0,32,29,61,8,14,22,40,43,83,21,5,26,22,23,26,14,24,98,109
2018,2,21800706,1/23/2019,1610612754,Indiana Pacers,1,1,1610612761,Toronto Raptors,0,0,31,35,66,9,17,26,40,52,92,21,4,25,17,37,27,2,7,94,110
2018,2,21800706,1/23/2019,1610612761,Toronto Raptors,0,0,1610612754,Indiana Pacers,1,1,26,27,53,12,27,39,38,54,92,18,5,23,18,38,28,6,9,95,106
2018,2,21800233,11/17/2018,1610612756,Phoenix Suns,1,0,1610612760,Oklahoma City Thunder,0,1,25,28,53,12,17,29,37,45,82,14,7,21,7,41,25,9,15,101,100
2018,2,21800233,11/17/2018,1610612760,Oklahoma City Thunder,0,1,1610612756,Phoenix Suns,1,0,31,30,61,7,17,24,38,47,85,27,5,32,17,31,17,14,18,101,110
2016,2,21600599,1/13/2017,1610612739,Cleveland Cavaliers,0,1,1610612758,Sacramento Kings,1,0,29,21,50,15,22,37,44,43,87,17,5,22,12,33,27,7,12,98,120
2016,2,21600599,1/13/2017,1610612758,Sacramento Kings,1,0,1610612739,Cleveland Cavaliers,0,1,33,22,55,9,16,25,42,38,80,15,4,19,13,29,23,11,21,98,108
2019,2,21900059,10/30/2019,1610612751,Brooklyn Nets,1,0,1610612754,Indiana Pacers,0,1,31,31,62,10,21,31,41,52,93,16,10,26,24,34,21,8,19,99,108
2019,2,21900059,10/30/2019,1610612754,Indiana Pacers,0,1,1610612751,Brooklyn Nets,1,0,34,36,70,11,15,26,45,51,96,17,3,20,14,38,25,7,10,99,118
2021,2,22100231,11/19/2021,1610612744,Golden State Warriors,0,1,1610612765,Detroit Pistons,1,0,26,24,50,12,18,30,38,42,80,17,4,21,18,25,22,11,19,91,105
2021,2,22100231,11/19/2021,1610612765,Detroit Pistons,1,0,1610612744,Golden State Warriors,0,1,18,20,38,14,28,42,32,48,80,24,6,30,17,34,21,8,13,93,102
2018,2,21801176,4/3/2019,1610612745,Houston Rockets,0,1,1610612746,LA Clippers,1,0,29,21,50,18,20,38,47,41,88,23,6,29,14,30,22,11,16,104,135
2018,2,21801176,4/3/2019,1610612746,LA Clippers,1,0,1610612745,Houston Rockets,0,1,30,26,56,8,18,26,38,44,82,19,12,31,12,39,27,6,19,103,103
2018,2,21801029,3/15/2019,1610612748,Miami Heat,1,0,1610612749,Milwaukee Bucks,0,1,30,41,71,8,14,22,38,55,93,14,11,25,16,45,21,7,11,101,98
2018,2,21801029,3/15/2019,1610612749,Milwaukee Bucks,0,1,1610612748,Miami Heat,1,0,30,25,55,12,21,33,42,46,88,17,7,24,10,37,29,8,16,101,113
2018,2,21800792,2/4/2019,1610612749,Milwaukee Bucks,0,1,1610612751,Brooklyn Nets,1,0,33,29,62,10,29,39,43,58,101,17,8,25,18,44,29,5,11,105,113
2018,2,21800792,2/4/2019,1610612751,Brooklyn Nets,1,0,1610612749,Milwaukee Bucks,0,1,28,32,60,5,37,42,33,69,102,23,5,28,22,48,23,9,13,107,94
2018,2,21800630,1/12/2019,1610612746,LA Clippers,1,0,1610612765,Detroit Pistons,0,1,27,29,56,9,9,18,36,38,74,23,6,29,7,34,25,11,17,97,104
2018,2,21800630,1/12/2019,1610612765,Detroit Pistons,0,1,1610612746,LA Clippers,1,0,21,27,48,16,21,37,37,48,85,19,3,22,17,32,20,7,18,96,109
2018,2,21800479,12/22/2018,1610612743,Denver Nuggets,0,0,1610612746,LA Clippers,1,1,32,34,66,9,22,31,41,56,97,20,5,25,15,44,21,7,9,101,111
2018,2,21800479,12/22/2018,1610612746,LA Clippers,1,1,1610612743,Denver Nuggets,0,0,43,29,72,10,10,20,53,39,92,16,1,17,15,24,28,10,18,101,132
2018,2,21800408,12/12/2018,1610612751,Brooklyn Nets,0,1,1610612755,Philadelphia 76ers,1,0,24,22,46,14,14,28,38,36,74,37,6,43,9,30,20,11,17,103,127
2018,2,21800408,12/12/2018,1610612755,Philadelphia 76ers,1,0,1610612751,Brooklyn Nets,0,1,38,25,63,12,16,28,50,41,91,12,4,16,11,32,31,10,17,103,124
2018,2,21800344,12/3/2018,1610612737,Atlanta Hawks,1,0,1610612744,Golden State Warriors,0,1,39,25,64,5,21,26,44,46,90,18,6,24,13,35,23,10,19,106,111
2018,2,21800344,12/3/2018,1610612744,Golden State Warriors,0,1,1610612737,Atlanta Hawks,1,0,35,23,58,13,11,24,48,34,82,19,3,22,8,28,33,10,20,106,128
2018,2,21800234,11/18/2018,1610612750,Minnesota Timberwolves,1,0,1610612763,Memphis Grizzlies,0,1,19,32,51,12,17,29,31,49,80,13,3,16,15,35,20,11,20,95,87
2018,2,21800234,11/18/2018,1610612763,Memphis Grizzlies,0,1,1610612750,Minnesota Timberwolves,1,0,23,31,54,12,16,28,35,47,82,18,7,25,11,40,26,8,12,95,100
2018,2,21800180,11/10/2018,1610612745,Houston Rockets,0,0,1610612759,San Antonio Spurs,1,1,21,28,49,9,32,41,30,60,90,20,9,29,18,46,11,3,8,96,89
2018,2,21800180,11/10/2018,1610612759,San Antonio Spurs,1,1,1610612745,Houston Rockets,0,0,23,31,54,10,10,20,33,41,74,20,7,27,9,36,17,10,16,94,96
2020,2,22000002,12/22/2020,1610612746,LA Clippers,0,1,1610612747,Los Angeles Lakers,1,0,30,23,53,14,26,40,44,49,93,14,5,19,14,38,22,4,16,103,116
2020,2,22000002,12/22/2020,1610612747,Los Angeles Lakers,1,0,1610612746,LA Clippers,0,1,29,23,52,9,20,29,38,43,81,24,7,31,11,33,22,10,19,103,109
2016,2,21600142,11/13/2016,1610612747,Los Angeles Lakers,0,0,1610612750,Minnesota Timberwolves,1,1,25,22,47,8,16,24,33,38,71,25,5,30,5,36,16,10,17,96,99
2021,2,22100230,11/19/2021,1610612754,Indiana Pacers,0,0,1610612766,Charlotte Hornets,1,1,30,22,52,11,25,36,41,47,88,25,7,32,9,42,19,8,10,104,118
2021,2,22100230,11/19/2021,1610612766,Charlotte Hornets,1,1,1610612754,Indiana Pacers,0,0,32,18,50,12,19,31,44,37,81,21,7,28,6,34,28,10,17,104,121
2016,2,21600142,11/13/2016,1610612750,Minnesota Timberwolves,1,1,1610612747,Los Angeles Lakers,0,0,29,24,53,13,14,27,42,38,80,28,14,42,11,36,28,6,10,97,125
2014,2,21400812,2/20/2015,1610612757,Portland Trail Blazers,0,0,1610612762,Utah Jazz,1,1,22,28,50,4,18,22,26,46,72,20,2,22,8,38,12,11,13,88,76
2018,2,21800892,2/23/2019,1610612744,Golden State Warriors,1,0,1610612745,Houston Rockets,0,1,28,26,54,14,22,36,42,48,90,14,6,20,11,42,26,13,18,106,112
2018,2,21800892,2/23/2019,1610612745,Houston Rockets,0,1,1610612744,Golden State Warriors,1,0,24,25,49,16,27,43,40,52,92,22,2,24,14,40,26,9,15,105,118
2014,2,21400812,2/20/2015,1610612762,Utah Jazz,1,1,1610612757,Portland Trail Blazers,0,0,27,31,58,10,15,25,37,46,83,8,9,17,15,36,18,5,11,88,92
2018,2,21800705,1/22/2019,1610612750,Minnesota Timberwolves,0,1,1610612756,Phoenix Suns,1,0,30,31,61,15,27,42,45,58,103,13,6,19,24,36,30,6,15,103,118
2018,2,21800705,1/22/2019,1610612756,Phoenix Suns,1,0,1610612750,Minnesota Timberwolves,0,1,30,23,53,7,27,34,37,50,87,10,8,18,8,47,23,7,14,102,91
2018,2,21800552,1/1/2019,1610612757,Portland Trail Blazers,0,1,1610612758,Sacramento Kings,1,0,30,28,58,9,23,32,39,51,90,26,4,30,12,42,22,13,19,111,113
2018,2,21800552,1/1/2019,1610612758,Sacramento Kings,1,0,1610612757,Portland Trail Blazers,0,1,33,49,82,11,22,33,44,71,115,9,3,12,23,50,24,11,13,112,108
2022,2,22200520,12/28/2022,1610612740,New Orleans Pelicans,1,1,1610612750,Minnesota Timberwolves,0,0,28,30,58,11,12,23,39,42,81,30,13,43,13,34,22,6,15,101,119
2022,2,22200520,12/28/2022,1610612750,Minnesota Timberwolves,0,0,1610612740,New Orleans Pelicans,1,1,32,22,54,10,19,29,42,41,83,24,8,32,8,37,18,6,11,102,118
2018,2,21800286,11/25/2018,1610612747,Los Angeles Lakers,1,0,1610612753,Orlando Magic,0,1,27,26,53,10,16,26,37,42,79,20,11,31,8,38,22,8,18,103,104
2018,2,21800286,11/25/2018,1610612753,Orlando Magic,0,1,1610612747,Los Angeles Lakers,1,0,31,31,62,11,20,31,42,51,93,13,1,14,12,39,31,9,14,101,108
2018,2,21800179,11/10/2018,1610612755,Philadelphia 76ers,0,0,1610612763,Memphis Grizzlies,1,1,36,18,54,8,23,31,44,41,85,10,6,16,11,32,27,9,23,105,106
2018,2,21800179,11/10/2018,1610612763,Memphis Grizzlies,1,1,1610612755,Philadelphia 76ers,0,0,34,39,73,11,19,30,45,58,103,11,4,15,18,43,16,10,11,104,112
2016,2,21601156,4/4/2017,1610612739,Cleveland Cavaliers,1,1,1610612753,Orlando Magic,0,0,26,20,46,18,18,36,44,38,82,16,5,21,6,34,30,8,12,98,122
2016,2,21601156,4/4/2017,1610612753,Orlando Magic,0,0,1610612739,Cleveland Cavaliers,1,1,22,31,53,11,22,33,33,53,86,25,1,26,15,39,23,9,14,98,102
2016,2,21600598,1/13/2017,1610612753,Orlando Magic,0,1,1610612757,Portland Trail Blazers,1,0,31,34,65,10,8,18,41,42,83,23,3,26,11,32,21,6,15,101,115
2016,2,21600598,1/13/2017,1610612757,Portland Trail Blazers,1,0,1610612753,Orlando Magic,0,1,29,34,63,10,24,34,39,58,97,21,4,25,18,41,19,5,10,102,109
2021,2,22100229,11/18/2021,1610612761,Toronto Raptors,0,0,1610612762,Utah Jazz,1,1,29,27,56,10,28,38,39,55,94,15,2,17,18,38,24,8,13,97,103
2021,2,22100229,11/18/2021,1610612762,Utah Jazz,1,1,1610612761,Toronto Raptors,0,0,25,9,34,19,27,46,44,36,80,12,1,13,14,22,34,10,24,97,119
2019,2,21900284,12/1/2019,1610612748,Miami Heat,0,1,1610612751,Brooklyn Nets,1,0,25,33,58,12,25,37,37,58,95,23,5,28,19,41,16,3,9,97,109
2019,2,21900284,12/1/2019,1610612751,Brooklyn Nets,1,0,1610612748,Miami Heat,0,1,26,23,49,14,28,42,40,51,91,12,4,16,12,40,24,3,12,99,106
2018,2,21801175,4/3/2019,1610612757,Portland Trail Blazers,1,1,1610612763,Memphis Grizzlies,0,0,38,25,63,10,21,31,48,46,94,10,6,16,19,31,28,10,14,95,116
2018,2,21801175,4/3/2019,1610612763,Memphis Grizzlies,0,0,1610612757,Portland Trail Blazers,1,1,20,27,47,11,22,33,31,49,80,16,3,19,8,42,20,9,13,95,89
2018,2,21800478,12/21/2018,1610612740,New Orleans Pelicans,0,0,1610612747,Los Angeles Lakers,1,1,36,39,75,8,19,27,44,58,102,8,8,16,17,45,27,7,13,106,104
2018,2,21800478,12/21/2018,1610612747,Los Angeles Lakers,1,1,1610612740,New Orleans Pelicans,0,0,35,25,60,8,24,32,43,49,92,18,7,25,11,40,28,8,13,106,112
2020,2,22000923,4/26/2021,1610612750,Minnesota Timberwolves,1,1,1610612762,Utah Jazz,0,0,21,18,39,16,28,44,37,46,83,15,6,21,12,37,29,9,16,96,105
2020,2,22000923,4/26/2021,1610612762,Utah Jazz,0,0,1610612750,Minnesota Timberwolves,1,1,21,17,38,16,41,57,37,58,95,14,5,19,19,43,24,7,11,97,104
2020,2,22000001,12/22/2020,1610612744,Golden State Warriors,0,0,1610612751,Brooklyn Nets,1,1,27,39,66,10,23,33,37,62,99,15,8,23,18,46,26,11,18,112,99
2020,2,22000001,12/22/2020,1610612751,Brooklyn Nets,1,1,1610612744,Golden State Warriors,0,0,27,30,57,15,20,35,42,50,92,26,6,32,17,37,24,6,20,110,125
2021,2,22100228,11/18/2021,1610612743,Denver Nuggets,1,0,1610612755,Philadelphia 76ers,0,1,20,33,53,12,24,36,32,57,89,13,3,16,16,42,22,5,11,92,89
2021,2,22100228,11/18/2021,1610612755,Philadelphia 76ers,0,1,1610612743,Denver Nuggets,1,0,32,24,56,11,18,29,43,42,85,6,6,12,8,37,22,6,10,93,103
2019,2,21900058,10/30/2019,1610612738,Boston Celtics,1,1,1610612749,Milwaukee Bucks,0,0,24,27,51,17,24,41,41,51,92,17,4,21,11,43,25,3,10,101,116
2019,2,21900058,10/30/2019,1610612749,Milwaukee Bucks,0,0,1610612738,Boston Celtics,1,1,24,13,37,14,31,45,38,44,82,15,9,24,7,42,21,4,15,100,105
2014,2,21400811,2/20/2015,1610612743,Denver Nuggets,0,0,1610612749,Milwaukee Bucks,1,1,23,35,58,7,19,26,30,54,84,14,7,21,16,40,18,6,15,93,81
2014,2,21400811,2/20/2015,1610612749,Milwaukee Bucks,1,1,1610612743,Denver Nuggets,0,0,28,35,63,5,10,15,33,45,78,18,4,22,14,31,22,11,17,92,89
2018,2,21801028,3/15/2019,1610612764,Washington Wizards,1,0,1610612766,Charlotte Hornets,0,1,28,22,50,13,21,34,41,43,84,15,4,19,11,34,25,11,17,100,110
2018,2,21801028,3/15/2019,1610612766,Charlotte Hornets,0,1,1610612764,Washington Wizards,1,0,32,38,70,14,17,31,46,55,101,10,2,12,17,40,18,8,12,99,116
2018,2,21800551,1/1/2019,1610612743,Denver Nuggets,1,1,1610612752,New York Knicks,0,0,32,29,61,12,22,34,44,51,95,15,8,23,25,29,36,4,9,93,115
2018,2,21800551,1/1/2019,1610612752,New York Knicks,0,0,1610612743,Denver Nuggets,1,1,31,35,66,11,16,27,42,51,93,13,5,18,16,38,28,7,9,92,108
2018,2,21800407,12/12/2018,1610612749,Milwaukee Bucks,0,0,1610612754,Indiana Pacers,1,1,27,21,48,11,32,43,38,53,91,10,5,15,12,43,22,7,13,100,97
2018,2,21800407,12/12/2018,1610612754,Indiana Pacers,1,1,1610612749,Milwaukee Bucks,0,0,31,30,61,12,18,30,43,48,91,15,5,20,17,34,31,6,16,99,113
2018,2,21800343,12/3/2018,1610612760,Oklahoma City Thunder,0,1,1610612765,Detroit Pistons,1,0,36,24,60,7,18,25,43,42,85,17,3,20,10,34,23,10,17,103,110
2018,2,21800343,12/3/2018,1610612765,Detroit Pistons,1,0,1610612760,Oklahoma City Thunder,0,1,25,37,62,6,26,32,31,63,94,15,4,19,17,48,16,10,17,101,83
2018,2,21800232,11/17/2018,1610612742,Dallas Mavericks,1,1,1610612744,Golden State Warriors,0,0,30,22,52,10,24,34,40,46,86,22,12,34,12,38,18,7,11,97,112
2018,2,21800232,11/17/2018,1610612744,Golden State Warriors,0,0,1610612742,Dallas Mavericks,1,1,33,28,61,9,24,33,42,52,94,16,1,17,15,38,24,5,11,97,109
2020,2,22000922,4/26/2021,1610612741,Chicago Bulls,0,1,1610612748,Miami Heat,1,0,30,18,48,11,18,29,41,36,77,17,5,22,10,29,33,13,18,95,110
2020,2,22000922,4/26/2021,1610612748,Miami Heat,1,0,1610612741,Chicago Bulls,0,1,29,19,48,7,29,36,36,48,84,23,2,25,6,43,18,3,6,95,102
2016,2,21600597,1/13/2017,1610612737,Atlanta Hawks,1,0,1610612738,Boston Celtics,0,1,25,29,54,11,19,30,36,48,84,18,3,21,16,36,22,7,12,94,101
2016,2,21600597,1/13/2017,1610612738,Boston Celtics,0,1,1610612737,Atlanta Hawks,1,0,19,20,39,17,27,44,36,47,83,14,5,19,13,35,22,5,12,93,103
2016,2,21600141,11/13/2016,1610612753,Orlando Magic,0,1,1610612760,Oklahoma City Thunder,1,0,35,27,62,11,13,24,46,40,86,16,4,20,11,30,24,4,10,95,119
2016,2,21600141,11/13/2016,1610612760,Oklahoma City Thunder,1,0,1610612753,Orlando Magic,0,1,40,27,67,7,18,25,47,45,92,16,10,26,20,32,22,4,11,95,117
2018,2,21801027,3/15/2019,1610612755,Philadelphia 76ers,1,1,1610612758,Sacramento Kings,0,0,39,28,67,7,17,24,46,45,91,24,3,27,13,33,28,4,11,101,123
2018,2,21801027,3/15/2019,1610612758,Sacramento Kings,0,0,1610612755,Philadelphia 76ers,1,1,34,33,67,9,18,27,43,51,94,19,5,24,15,39,23,7,9,101,114
2018,2,21800891,2/23/2019,1610612749,Milwaukee Bucks,1,1,1610612750,Minnesota Timberwolves,0,0,31,21,52,19,24,43,50,45,95,21,1,22,14,31,28,7,11,104,140
2018,2,21800891,2/23/2019,1610612750,Minnesota Timberwolves,0,0,1610612749,Milwaukee Bucks,1,1,38,38,76,12,14,26,50,52,102,16,4,20,16,39,29,6,10,103,128
2018,2,21800704,1/22/2019,1610612742,Dallas Mavericks,1,1,1610612746,LA Clippers,0,0,28,19,47,10,24,34,38,43,81,20,9,29,16,32,21,4,13,94,106
2018,2,21800704,1/22/2019,1610612746,LA Clippers,0,0,1610612742,Dallas Mavericks,1,1,23,32,55,10,26,36,33,58,91,22,7,29,19,42,19,5,8,93,98
2018,2,21800285,11/24/2018,1610612744,Golden State Warriors,1,1,1610612758,Sacramento Kings,0,0,31,23,54,10,24,34,41,47,88,25,4,29,12,37,28,6,15,103,117
2018,2,21800285,11/24/2018,1610612758,Sacramento Kings,0,0,1610612744,Golden State Warriors,1,1,31,38,69,11,17,28,42,55,97,21,8,29,16,44,28,5,8,104,116
2018,2,21800124,11/2/2018,1610612744,Golden State Warriors,1,1,1610612750,Minnesota Timberwolves,0,0,30,24,54,13,21,34,43,45,88,17,5,22,14,33,31,8,16,100,116
2018,2,21800124,11/2/2018,1610612750,Minnesota Timberwolves,0,0,1610612744,Golden State Warriors,1,1,25,31,56,13,32,45,38,63,101,10,4,14,12,53,25,3,5,101,99
2016,2,21601155,4/4/2017,1610612764,Washington Wizards,1,1,1610612766,Charlotte Hornets,0,0,26,25,51,17,17,34,43,42,85,15,3,18,12,30,31,5,14,97,118
2016,2,21601155,4/4/2017,1610612766,Charlotte Hornets,0,0,1610612764,Washington Wizards,1,1,28,17,45,12,22,34,40,39,79,19,3,22,9,31,21,10,16,96,111
2021,2,22100227,11/18/2021,1610612750,Minnesota Timberwolves,1,1,1610612759,San Antonio Spurs,0,0,20,17,37,21,28,49,41,45,86,12,3,15,13,34,30,7,13,94,115
2021,2,22100227,11/18/2021,1610612759,San Antonio Spurs,0,0,1610612750,Minnesota Timberwolves,1,1,29,23,52,6,26,32,35,49,84,14,5,19,12,40,26,5,12,93,90
2014,2,21400810,2/20/2015,1610612742,Dallas Mavericks,1,1,1610612745,Houston Rockets,0,0,35,34,69,9,15,24,44,49,93,14,4,18,16,36,26,8,17,104,111
2014,2,21400810,2/20/2015,1610612745,Houston Rockets,0,0,1610612742,Dallas Mavericks,1,1,24,26,50,12,25,37,36,51,87,16,10,26,18,39,20,10,21,104,100
2018,2,21801174,4/3/2019,1610612756,Phoenix Suns,1,0,1610612762,Utah Jazz,0,1,37,33,70,5,16,21,42,49,91,8,5,13,11,39,21,2,10,95,97
2018,2,21801174,4/3/2019,1610612762,Utah Jazz,0,1,1610612756,Phoenix Suns,1,0,28,17,45,16,16,32,44,33,77,14,4,18,9,26,30,7,20,97,118
2018,2,21800791,2/4/2019,1610612737,Atlanta Hawks,0,1,1610612764,Washington Wizards,1,0,26,25,51,20,20,40,46,45,91,25,4,29,17,29,29,5,14,102,137
2018,2,21800791,2/4/2019,1610612764,Washington Wizards,1,0,1610612737,Atlanta Hawks,0,1,36,23,59,12,26,38,48,49,97,21,8,29,16,36,34,7,9,101,129
2018,2,21800477,12/21/2018,1610612758,Sacramento Kings,1,1,1610612763,Memphis Grizzlies,0,0,18,29,47,15,26,41,33,55,88,21,8,29,18,40,25,7,10,94,102
2018,2,21800477,12/21/2018,1610612763,Memphis Grizzlies,0,0,1610612758,Sacramento Kings,1,1,21,27,48,16,16,32,37,43,80,9,1,10,8,35,24,10,18,94,99
2018,2,21800125,11/3/2018,1610612755,Philadelphia 76ers,1,1,1610612765,Detroit Pistons,0,0,19,21,40,9,20,29,28,41,69,44,7,51,5,40,21,8,18,105,109
2018,2,21800125,11/3/2018,1610612765,Detroit Pistons,0,0,1610612755,Philadelphia 76ers,1,1,28,25,53,5,25,30,33,50,83,28,13,41,12,44,16,11,17,107,99
2020,2,22000921,4/26/2021,1610612739,Cleveland Cavaliers,0,0,1610612761,Toronto Raptors,1,1,26,19,45,10,28,38,36,47,83,14,2,16,11,37,25,7,14,93,96
2020,2,22000921,4/26/2021,1610612761,Toronto Raptors,1,1,1610612739,Cleveland Cavaliers,0,0,35,15,50,8,21,29,43,36,79,18,2,20,7,30,32,6,13,94,112
2017,2,21701201,4/8/2018,1610612747,Los Angeles Lakers,1,0,1610612762,Utah Jazz,0,1,32,36,68,5,20,25,37,56,93,18,4,22,17,41,20,8,14,99,97
2017,2,21701201,4/8/2018,1610612762,Utah Jazz,0,1,1610612747,Los Angeles Lakers,1,0,29,18,47,13,23,36,42,41,83,15,7,22,11,34,35,8,18,99,112
2019,2,21900283,11/30/2019,1610612749,Milwaukee Bucks,1,1,1610612766,Charlotte Hornets,0,0,34,18,52,20,24,44,54,42,96,9,6,15,8,39,41,4,7,101,137
2019,2,21900283,11/30/2019,1610612766,Charlotte Hornets,0,0,1610612749,Milwaukee Bucks,1,1,22,34,56,15,30,45,37,64,101,7,1,8,17,47,21,7,12,99,96
2016,2,21601154,4/4/2017,1610612751,Brooklyn Nets,0,1,1610612755,Philadelphia 76ers,1,0,32,12,44,16,15,31,48,27,75,29,4,33,2,25,36,7,18,103,141
2016,2,21601154,4/4/2017,1610612755,Philadelphia 76ers,1,0,1610612751,Brooklyn Nets,0,1,31,28,59,12,26,38,43,54,97,20,7,27,17,42,32,9,11,104,118
2016,2,21600596,1/13/2017,1610612750,Minnesota Timberwolves,1,1,1610612760,Oklahoma City Thunder,0,0,34,34,68,5,13,18,39,47,86,13,1,14,14,34,21,10,16,94,96
2016,2,21600596,1/13/2017,1610612760,Oklahoma City Thunder,0,0,1610612750,Minnesota Timberwolves,1,1,30,35,65,3,17,20,33,52,85,17,4,21,20,35,19,11,19,94,86
2018,2,21800890,2/23/2019,1610612758,Sacramento Kings,0,1,1610612760,Oklahoma City Thunder,1,0,37,41,78,7,12,19,44,53,97,24,10,34,11,45,24,2,9,111,119
2018,2,21800890,2/23/2019,1610612760,Oklahoma City Thunder,1,0,1610612758,Sacramento Kings,0,1,26,33,59,14,32,46,40,65,105,22,6,28,23,44,17,7,14,110,116
2018,2,21800406,12/12/2018,1610612739,Cleveland Cavaliers,1,1,1610612752,New York Knicks,0,0,33,24,57,10,24,34,43,48,91,17,4,21,14,36,19,7,13,100,113
2018,2,21800406,12/12/2018,1610612752,New York Knicks,0,0,1610612739,Cleveland Cavaliers,1,1,30,37,67,11,16,27,41,53,94,13,1,14,14,40,21,7,12,99,106
2018,2,21800342,12/2/2018,1610612757,Portland Trail Blazers,0,0,1610612759,San Antonio Spurs,1,1,33,24,57,12,17,29,45,41,86,16,0,16,12,29,25,5,17,99,118
2018,2,21800342,12/2/2018,1610612759,San Antonio Spurs,1,1,1610612757,Portland Trail Blazers,0,0,39,29,68,11,4,15,50,33,83,20,2,22,6,29,29,6,12,99,131
2018,2,21800231,11/17/2018,1610612745,Houston Rockets,1,1,1610612758,Sacramento Kings,0,0,26,8,34,20,27,47,46,35,81,20,4,24,10,27,27,10,22,105,132
2018,2,21800231,11/17/2018,1610612758,Sacramento Kings,0,0,1610612745,Houston Rockets,1,1,35,32,67,11,24,35,46,56,102,9,3,12,18,38,23,9,14,104,112
2018,2,21800178,11/10/2018,1610612739,Cleveland Cavaliers,0,0,1610612741,Chicago Bulls,1,1,31,39,70,8,13,21,39,52,91,12,6,18,18,37,15,7,12,97,98
2018,2,21800178,11/10/2018,1610612741,Chicago Bulls,1,1,1610612739,Cleveland Cavaliers,0,0,32,32,64,7,11,18,39,43,82,14,7,21,7,40,20,5,11,95,99
2018,2,21800126,11/3/2018,1610612739,Cleveland Cavaliers,0,0,1610612766,Charlotte Hornets,1,1,25,30,55,10,16,26,35,46,81,14,1,15,6,40,22,3,15,96,94
2018,2,21800126,11/3/2018,1610612766,Charlotte Hornets,1,1,1610612739,Cleveland Cavaliers,0,0,42,19,61,10,20,30,52,39,91,12,1,13,14,25,29,10,15,97,126
2021,2,22100226,11/18/2021,1610612746,LA Clippers,0,0,1610612763,Memphis Grizzlies,1,1,26,25,51,16,23,39,42,48,90,8,0,8,12,36,24,8,14,95,108
2021,2,22100226,11/18/2021,1610612763,Memphis Grizzlies,1,1,1610612746,LA Clippers,0,0,41,29,70,11,15,26,52,44,96,5,1,6,16,29,28,6,12,95,120
2019,2,21900057,10/30/2019,1610612750,Minnesota Timberwolves,0,0,1610612755,Philadelphia 76ers,1,1,22,24,46,10,25,35,32,49,81,21,7,28,8,43,12,14,22,109,95
2019,2,21900057,10/30/2019,1610612755,Philadelphia 76ers,1,1,1610612750,Minnesota Timberwolves,0,0,34,33,67,9,16,25,43,49,92,22,6,28,19,32,24,13,22,109,117
2014,2,21400809,2/20/2015,1610612739,Cleveland Cavaliers,0,1,1610612764,Washington Wizards,1,0,32,25,57,14,19,33,46,44,90,21,7,28,16,31,28,7,11,98,127
2014,2,21400809,2/20/2015,1610612764,Washington Wizards,1,0,1610612739,Cleveland Cavaliers,0,1,37,33,70,1,15,16,38,48,86,12,4,16,14,36,22,12,18,98,89
2018,2,21801173,4/3/2019,1610612743,Denver Nuggets,1,1,1610612759,San Antonio Spurs,0,0,35,19,54,12,21,33,47,40,87,7,5,12,15,28,41,9,15,92,113
2018,2,21801173,4/3/2019,1610612759,San Antonio Spurs,0,0,1610612743,Denver Nuggets,1,1,26,28,54,5,22,27,31,50,81,18,7,25,12,41,15,6,11,92,85
2018,2,21801026,3/15/2019,1610612747,Los Angeles Lakers,0,0,1610612765,Detroit Pistons,1,1,30,31,61,6,19,25,36,50,86,19,7,26,14,40,24,5,14,96,97
2018,2,21801026,3/15/2019,1610612765,Detroit Pistons,1,1,1610612747,Los Angeles Lakers,0,0,20,27,47,17,22,39,37,49,86,20,12,32,18,37,26,9,15,98,111
2018,2,21800790,2/4/2019,1610612743,Denver Nuggets,0,0,1610612765,Detroit Pistons,1,1,32,32,64,9,19,28,41,51,92,12,10,22,15,40,28,8,14,101,103
2018,2,21800790,2/4/2019,1610612765,Detroit Pistons,1,1,1610612743,Denver Nuggets,0,0,32,19,51,16,21,37,48,40,88,17,3,20,16,26,32,10,20,100,129
2018,2,21800628,1/11/2019,1610612757,Portland Trail Blazers,1,1,1610612766,Charlotte Hornets,0,0,37,16,53,15,25,40,52,41,93,8,1,9,9,33,31,3,9,98,127
2018,2,21800628,1/11/2019,1610612766,Charlotte Hornets,0,0,1610612757,Portland Trail Blazers,1,1,23,37,60,13,17,30,36,54,90,11,5,16,14,42,23,10,14,98,96
2018,2,21800550,1/1/2019,1610612749,Milwaukee Bucks,1,1,1610612765,Detroit Pistons,0,0,37,15,52,10,17,27,47,32,79,17,9,26,7,30,28,7,13,95,121
2018,2,21800550,1/1/2019,1610612765,Detroit Pistons,0,0,1610612749,Milwaukee Bucks,1,1,23,36,59,12,21,33,35,57,92,16,5,21,19,40,23,7,14,96,98
2020,2,22000920,4/26/2021,1610612752,New York Knicks,1,0,1610612756,Phoenix Suns,0,1,33,25,58,12,17,29,45,42,87,8,2,10,10,32,24,5,11,94,110
2020,2,22000920,4/26/2021,1610612756,Phoenix Suns,0,1,1610612752,New York Knicks,1,0,31,18,49,14,20,34,45,38,83,14,3,17,8,30,23,6,12,92,118
2016,2,21601153,4/2/2017,1610612745,Houston Rockets,0,1,1610612756,Phoenix Suns,1,0,33,29,62,14,24,38,47,53,100,15,8,23,15,41,23,8,15,110,123
2016,2,21601153,4/2/2017,1610612756,Phoenix Suns,1,0,1610612745,Houston Rockets,0,1,34,32,66,8,26,34,42,58,100,24,5,29,27,34,24,8,23,111,116
2016,2,21600595,1/13/2017,1610612745,Houston Rockets,1,0,1610612763,Memphis Grizzlies,0,1,23,18,41,10,31,41,33,49,82,29,7,36,12,42,19,8,12,99,105
2016,2,21600595,1/13/2017,1610612763,Memphis Grizzlies,0,1,1610612745,Houston Rockets,1,0,31,18,49,10,17,27,41,35,76,18,9,27,12,24,25,9,22,99,110
2014,2,21400808,2/20/2015,1610612750,Minnesota Timberwolves,1,1,1610612756,Phoenix Suns,0,0,36,35,71,4,11,15,40,46,86,27,11,38,19,33,24,8,14,98,111
2014,2,21400808,2/20/2015,1610612756,Phoenix Suns,0,0,1610612750,Minnesota Timberwolves,1,1,33,39,72,7,10,17,40,49,89,22,9,31,19,36,23,7,13,98,109
2018,2,21800703,1/22/2019,1610612757,Portland Trail Blazers,0,0,1610612760,Oklahoma City Thunder,1,1,33,26,59,10,26,36,43,52,95,18,4,22,22,31,21,16,20,104,114
2018,2,21800703,1/22/2019,1610612760,Oklahoma City Thunder,1,1,1610612757,Portland Trail Blazers,0,0,32,30,62,11,12,23,43,42,85,26,7,33,10,35,26,7,11,103,123
2018,2,21800629,1/11/2019,1610612741,Chicago Bulls,0,0,1610612744,Golden State Warriors,1,1,26,32,58,9,11,20,35,43,78,30,4,34,6,38,16,6,13,101,109
2018,2,21800629,1/11/2019,1610612744,Golden State Warriors,1,1,1610612741,Chicago Bulls,0,0,35,18,53,18,21,39,53,39,92,22,4,26,15,26,38,9,12,101,146
2017,2,21701062,3/20/2018,1610612737,Atlanta Hawks,0,1,1610612762,Utah Jazz,1,0,29,32,61,9,24,33,38,56,94,14,5,19,16,42,21,8,13,102,99
2017,2,21701062,3/20/2018,1610612762,Utah Jazz,1,0,1610612737,Atlanta Hawks,0,1,27,28,55,6,28,34,33,56,89,22,3,25,15,43,16,7,16,102,94
2021,2,22100225,11/18/2021,1610612748,Miami Heat,1,1,1610612764,Washington Wizards,0,0,31,25,56,10,16,26,41,41,82,20,4,24,9,33,27,4,6,92,112
2021,2,22100225,11/18/2021,1610612764,Washington Wizards,0,0,1610612748,Miami Heat,1,1,23,18,41,15,21,36,38,39,77,6,4,10,7,35,25,10,17,92,97
2019,2,21900282,11/30/2019,1610612737,Atlanta Hawks,0,0,1610612745,Houston Rockets,1,1,23,20,43,15,31,46,38,51,89,20,5,25,9,45,26,9,14,105,111
2019,2,21900282,11/30/2019,1610612745,Houston Rockets,1,1,1610612737,Atlanta Hawks,0,0,27,11,38,25,26,51,52,37,89,29,5,34,16,23,30,5,15,105,158
2019,2,21900056,10/30/2019,1610612752,New York Knicks,0,0,1610612753,Orlando Magic,1,1,24,27,51,7,24,31,31,51,82,14,6,20,13,39,19,5,11,89,83
2019,2,21900056,10/30/2019,1610612753,Orlando Magic,1,1,1610612752,New York Knicks,0,0,25,31,56,12,20,32,37,51,88,9,3,12,16,37,24,1,9,88,95
2016,2,21600140,11/13/2016,1610612739,Cleveland Cavaliers,1,1,1610612766,Charlotte Hornets,0,0,25,29,54,14,24,38,39,53,92,8,7,15,18,40,25,7,9,91,100
2016,2,21600140,11/13/2016,1610612766,Charlotte Hornets,0,0,1610612739,Cleveland Cavaliers,1,1,25,41,66,11,18,29,36,59,95,10,2,12,15,45,23,3,5,90,93
2014,2,21400807,2/20/2015,1610612748,Miami Heat,0,1,1610612752,New York Knicks,1,0,29,30,59,9,11,20,38,41,79,26,9,35,18,26,28,10,22,103,111
2014,2,21400807,2/20/2015,1610612752,New York Knicks,1,0,1610612748,Miami Heat,0,1,29,35,64,6,12,18,35,47,82,11,5,16,8,41,28,12,20,102,87
2018,2,21800789,2/3/2019,1610612746,LA Clippers,0,0,1610612761,Toronto Raptors,1,1,36,41,77,2,10,12,38,51,89,25,4,29,11,42,15,10,13,102,103
2018,2,21800789,2/3/2019,1610612761,Toronto Raptors,1,1,1610612746,LA Clippers,0,0,34,27,61,9,24,33,43,51,94,26,5,31,21,32,21,7,16,104,121
2018,2,21800476,12/21/2018,1610612757,Portland Trail Blazers,1,0,1610612762,Utah Jazz,0,1,25,30,55,10,22,32,35,52,87,10,8,18,16,40,17,7,14,95,90
2018,2,21800476,12/21/2018,1610612762,Utah Jazz,0,1,1610612757,Portland Trail Blazers,1,0,31,23,54,16,15,31,47,38,85,10,7,17,11,31,35,8,15,95,120
2018,2,21800405,12/12/2018,1610612765,Detroit Pistons,0,0,1610612766,Charlotte Hornets,1,1,27,25,52,13,21,34,40,46,86,14,7,21,11,38,23,7,14,97,107
2018,2,21800405,12/12/2018,1610612766,Charlotte Hornets,1,1,1610612765,Detroit Pistons,0,0,26,31,57,9,19,28,35,50,85,29,8,37,13,42,21,4,7,98,108
2018,2,21800341,12/2/2018,1610612742,Dallas Mavericks,1,1,1610612746,LA Clippers,0,0,34,38,72,8,15,23,42,53,95,22,4,26,18,37,20,9,16,104,114
2018,2,21800341,12/2/2018,1610612746,LA Clippers,0,0,1610612742,Dallas Mavericks,1,1,33,38,71,9,15,24,42,53,95,17,5,22,10,47,23,6,11,105,110
2018,2,21800284,11/24/2018,1610612749,Milwaukee Bucks,1,1,1610612759,San Antonio Spurs,0,0,34,12,46,15,25,40,49,37,86,22,7,29,9,33,30,8,13,104,135
2018,2,21800284,11/24/2018,1610612759,San Antonio Spurs,0,0,1610612749,Milwaukee Bucks,1,1,39,32,71,10,11,21,49,43,92,21,7,28,11,36,27,7,10,102,129
2020,2,22000919,4/26/2021,1610612759,San Antonio Spurs,0,1,1610612764,Washington Wizards,1,0,49,37,86,6,11,17,55,48,103,30,5,35,16,33,27,4,6,111,146
2020,2,22000919,4/26/2021,1610612764,Washington Wizards,1,0,1610612759,San Antonio Spurs,0,1,52,37,89,6,14,20,58,51,109,21,4,25,21,33,26,6,8,109,143
2016,2,21601152,4/2/2017,1610612744,Golden State Warriors,1,1,1610612764,Washington Wizards,0,0,34,18,52,16,20,36,50,38,88,23,3,26,11,29,34,9,16,105,139
2016,2,21601152,4/2/2017,1610612764,Washington Wizards,0,0,1610612744,Golden State Warriors,1,1,33,32,65,10,17,27,43,49,92,19,6,25,14,37,28,7,15,105,115
2021,2,22100224,11/18/2021,1610612739,Cleveland Cavaliers,1,0,1610612744,Golden State Warriors,0,1,22,19,41,12,27,39,34,46,80,9,7,16,18,30,22,12,20,90,89
2021,2,22100224,11/18/2021,1610612744,Golden State Warriors,0,1,1610612739,Cleveland Cavaliers,1,0,26,14,40,15,28,43,41,42,83,7,1,8,8,35,36,6,11,90,104
2016,2,21600594,1/13/2017,1610612748,Miami Heat,0,0,1610612749,Milwaukee Bucks,1,1,29,22,51,12,20,32,41,42,83,14,4,18,8,35,33,8,8,92,108
2016,2,21600594,1/13/2017,1610612749,Milwaukee Bucks,1,1,1610612748,Miami Heat,0,0,31,34,65,9,6,15,40,40,80,27,4,31,18,24,28,6,13,92,116
2018,2,21801172,4/3/2019,1610612742,Dallas Mavericks,1,0,1610612750,Minnesota Timberwolves,0,1,36,19,55,7,32,39,43,51,94,15,4,19,17,36,26,6,13,99,108
2018,2,21801172,4/3/2019,1610612750,Minnesota Timberwolves,0,1,1610612742,Dallas Mavericks,1,0,32,27,59,10,17,27,42,44,86,16,4,20,6,40,26,2,10,98,110
2018,2,21801025,3/14/2019,1610612742,Dallas Mavericks,0,0,1610612743,Denver Nuggets,1,1,25,25,50,12,25,37,37,50,87,13,4,17,14,38,22,6,9,91,99
2018,2,21801025,3/14/2019,1610612743,Denver Nuggets,1,1,1610612742,Dallas Mavericks,0,0,31,21,52,8,21,29,39,42,81,14,3,17,10,33,27,8,11,91,100
2018,2,21800889,2/23/2019,1610612738,Boston Celtics,0,0,1610612741,Chicago Bulls,1,1,35,28,63,10,19,29,45,47,92,16,5,21,10,38,26,4,7,100,116
2018,2,21800889,2/23/2019,1610612741,Chicago Bulls,1,1,1610612738,Boston Celtics,0,0,35,23,58,12,18,30,47,41,88,20,1,21,12,29,26,6,13,98,126
2018,2,21800702,1/22/2019,1610612758,Sacramento Kings,0,0,1610612761,Toronto Raptors,1,1,34,36,70,7,14,21,41,50,91,16,6,22,13,38,29,7,14,102,105
2018,2,21800702,1/22/2019,1610612761,Toronto Raptors,1,1,1610612758,Sacramento Kings,0,0,24,27,51,16,24,40,40,51,91,24,11,35,22,36,25,8,16,103,120
2018,2,21800549,1/1/2019,1610612761,Toronto Raptors,1,1,1610612762,Utah Jazz,0,0,38,24,62,7,13,20,45,37,82,25,10,35,8,34,18,6,10,100,122
2018,2,21800549,1/1/2019,1610612762,Utah Jazz,0,0,1610612761,Toronto Raptors,1,1,33,32,65,9,23,32,42,55,97,23,6,29,14,42,23,4,4,99,116
2018,2,21800475,12/21/2018,1610612750,Minnesota Timberwolves,0,0,1610612759,San Antonio Spurs,1,1,27,35,62,6,15,21,33,50,83,26,5,31,11,40,19,7,12,98,98
2018,2,21800475,12/21/2018,1610612759,San Antonio Spurs,1,1,1610612750,Minnesota Timberwolves,0,0,27,27,54,19,14,33,46,41,87,13,5,18,13,31,36,11,16,98,124
2017,2,21701223,4/11/2018,1610612749,Milwaukee Bucks,0,0,1610612755,Philadelphia 76ers,1,1,30,35,65,7,18,25,37,53,90,14,2,16,12,41,22,15,20,105,95
2017,2,21701223,4/11/2018,1610612755,Philadelphia 76ers,1,1,1610612749,Milwaukee Bucks,0,0,37,32,69,15,21,36,52,53,105,11,4,15,19,37,35,6,12,105,130
2017,2,21701202,4/8/2018,1610612737,Atlanta Hawks,0,1,1610612738,Boston Celtics,1,0,28,23,51,15,20,35,43,43,86,11,3,14,13,32,23,9,13,93,112
2017,2,21701202,4/8/2018,1610612738,Boston Celtics,1,0,1610612737,Atlanta Hawks,0,1,33,26,59,9,14,23,42,40,82,13,7,20,11,33,33,7,12,92,106
2017,2,21701158,4/3/2018,1610612737,Atlanta Hawks,0,0,1610612748,Miami Heat,1,1,24,31,55,13,20,33,37,51,88,11,4,15,15,38,24,10,18,99,98
2017,2,21701158,4/3/2018,1610612748,Miami Heat,1,1,1610612737,Atlanta Hawks,0,0,33,25,58,8,25,33,41,50,91,11,2,13,13,38,22,10,14,99,101
2017,2,21701119,3/28/2018,1610612757,Portland Trail Blazers,0,0,1610612763,Memphis Grizzlies,1,1,30,19,49,8,22,30,38,41,79,19,11,30,9,36,15,7,12,96,103
2017,2,21701119,3/28/2018,1610612763,Memphis Grizzlies,1,1,1610612757,Portland Trail Blazers,0,0,28,31,59,13,12,25,41,43,84,13,10,23,16,32,23,7,15,95,108
2021,2,22100223,11/17/2021,1610612741,Chicago Bulls,0,0,1610612757,Portland Trail Blazers,1,1,26,28,54,13,16,29,39,44,83,16,4,20,11,34,23,10,15,96,107
2021,2,22100223,11/17/2021,1610612757,Portland Trail Blazers,1,1,1610612741,Chicago Bulls,0,0,26,27,53,11,20,31,37,47,84,27,1,28,18,29,26,7,17,97,112
2014,2,21400806,2/20/2015,1610612741,Chicago Bulls,0,0,1610612765,Detroit Pistons,1,1,28,34,62,5,11,16,33,45,78,20,2,22,13,33,16,12,20,95,91
2014,2,21400806,2/20/2015,1610612765,Detroit Pistons,1,1,1610612741,Chicago Bulls,0,0,32,30,62,6,16,22,38,46,84,18,15,33,18,35,19,2,12,96,100
2016,2,21600139,11/12/2016,1610612751,Brooklyn Nets,0,1,1610612756,Phoenix Suns,1,0,24,23,47,16,21,37,40,44,84,26,4,30,8,39,22,9,17,105,122
2016,2,21600139,11/12/2016,1610612756,Phoenix Suns,1,0,1610612751,Brooklyn Nets,0,1,32,42,74,8,25,33,40,67,107,16,5,21,21,50,23,6,12,107,104
2018,2,21801024,3/14/2019,1610612750,Minnesota Timberwolves,0,0,1610612762,Utah Jazz,1,1,37,30,67,5,19,24,42,49,91,11,4,15,12,39,27,7,11,96,100
2018,2,21801024,3/14/2019,1610612762,Utah Jazz,1,1,1610612750,Minnesota Timberwolves,0,0,31,20,51,13,25,38,44,45,89,19,8,27,18,31,30,6,12,95,120
2018,2,21800230,11/17/2018,1610612741,Chicago Bulls,1,0,1610612761,Toronto Raptors,0,1,22,37,59,8,19,27,30,56,86,15,6,21,11,47,21,14,22,106,83
2018,2,21800230,11/17/2018,1610612761,Toronto Raptors,0,1,1610612741,Chicago Bulls,1,0,34,20,54,14,21,35,48,41,89,12,1,13,13,29,31,13,23,107,122
2020,2,22000918,4/26/2021,1610612755,Philadelphia 76ers,1,1,1610612760,Oklahoma City Thunder,0,0,33,22,55,14,17,31,47,39,86,13,5,18,12,29,27,11,21,103,121
2020,2,22000918,4/26/2021,1610612760,Oklahoma City Thunder,0,0,1610612755,Philadelphia 76ers,1,1,28,20,48,7,23,30,35,43,78,13,10,23,18,32,21,22,30,102,90
2018,2,21800176,11/10/2018,1610612740,New Orleans Pelicans,1,1,1610612756,Phoenix Suns,0,0,31,30,61,11,14,25,42,44,86,24,5,29,19,29,28,10,18,100,119
2018,2,21800176,11/10/2018,1610612756,Phoenix Suns,0,0,1610612740,New Orleans Pelicans,1,1,25,25,50,10,26,36,35,51,86,19,1,20,12,40,16,7,17,100,99
2021,2,22100222,11/17/2021,1610612742,Dallas Mavericks,0,0,1610612756,Phoenix Suns,1,1,22,37,59,16,16,32,38,53,91,6,0,6,9,44,28,6,10,95,98
2021,2,22100222,11/17/2021,1610612756,Phoenix Suns,1,1,1610612742,Dallas Mavericks,0,0,28,26,54,13,26,39,41,52,93,10,4,14,14,41,27,5,8,94,105
2016,2,21601151,4/2/2017,1610612759,San Antonio Spurs,1,1,1610612762,Utah Jazz,0,0,30,28,58,10,9,19,40,37,77,19,3,22,11,27,26,6,13,90,109
2016,2,21601151,4/2/2017,1610612762,Utah Jazz,0,0,1610612759,San Antonio Spurs,1,1,34,31,65,9,15,24,43,46,89,8,5,13,15,35,24,7,10,90,103
2016,2,21600593,1/13/2017,1610612755,Philadelphia 76ers,1,1,1610612766,Charlotte Hornets,0,0,22,16,38,14,24,38,36,40,76,16,4,20,12,29,26,12,23,97,102
2016,2,21600593,1/13/2017,1610612766,Charlotte Hornets,0,0,1610612755,Philadelphia 76ers,1,1,22,40,62,6,17,23,28,57,85,31,1,32,24,33,11,12,19,97,93
2019,2,21900055,10/30/2019,1610612739,Cleveland Cavaliers,1,1,1610612741,Chicago Bulls,0,0,31,23,54,10,14,24,41,37,78,25,6,31,15,26,25,6,19,97,117
2019,2,21900055,10/30/2019,1610612741,Chicago Bulls,0,0,1610612739,Cleveland Cavaliers,1,1,25,26,51,14,25,39,39,51,90,19,4,23,14,40,25,3,7,97,111
2018,2,21801171,4/3/2019,1610612740,New Orleans Pelicans,1,0,1610612766,Charlotte Hornets,0,1,25,19,44,15,26,41,40,45,85,14,3,17,10,37,25,13,19,102,109
2018,2,21801171,4/3/2019,1610612766,Charlotte Hornets,0,1,1610612740,New Orleans Pelicans,1,0,26,30,56,12,22,34,38,52,90,27,5,32,14,41,19,7,11,101,115
2014,2,21400805,2/20/2015,1610612737,Atlanta Hawks,1,0,1610612761,Toronto Raptors,0,1,21,29,50,8,30,38,29,59,88,14,7,21,22,40,19,15,23,99,80
2014,2,21400805,2/20/2015,1610612761,Toronto Raptors,0,1,1610612737,Atlanta Hawks,1,0,30,36,66,13,17,30,43,53,96,6,2,8,16,37,27,6,14,97,105
2018,2,21800283,11/24/2018,1610612738,Boston Celtics,0,0,1610612742,Dallas Mavericks,1,1,31,27,58,10,18,28,41,45,86,12,1,13,14,32,19,12,18,95,104
2018,2,21800283,11/24/2018,1610612742,Dallas Mavericks,1,1,1610612738,Boston Celtics,0,0,26,20,46,16,25,41,42,45,87,13,8,21,16,34,27,8,16,97,113
2018,2,21800177,11/10/2018,1610612748,Miami Heat,1,0,1610612764,Washington Wizards,0,1,27,28,55,12,21,33,39,49,88,20,6,26,18,36,25,8,19,99,110
2018,2,21800177,11/10/2018,1610612764,Washington Wizards,0,1,1610612748,Miami Heat,1,0,32,29,61,8,14,22,40,43,83,28,10,38,17,30,14,5,16,100,116
2017,2,21701224,4/11/2018,1610612741,Chicago Bulls,1,0,1610612765,Detroit Pistons,0,1,21,31,52,11,23,34,32,54,86,12,6,18,18,40,21,12,19,96,87
2017,2,21701224,4/11/2018,1610612765,Detroit Pistons,0,1,1610612741,Chicago Bulls,1,0,32,22,54,15,20,35,47,42,89,10,0,10,10,32,27,8,12,96,119
2017,2,21701178,4/5/2018,1610612749,Milwaukee Bucks,1,0,1610612751,Brooklyn Nets,0,1,36,37,73,5,15,20,41,52,93,24,6,30,16,39,21,3,8,98,111
2017,2,21701178,4/5/2018,1610612751,Brooklyn Nets,0,1,1610612749,Milwaukee Bucks,1,0,22,14,36,19,20,39,41,34,75,18,3,21,7,29,30,12,20,97,119
2017,2,21701159,4/3/2018,1610612752,New York Knicks,1,0,1610612753,Orlando Magic,0,1,26,33,59,4,23,27,30,56,86,9,3,12,12,44,17,7,12,93,73
2017,2,21701159,4/3/2018,1610612753,Orlando Magic,0,1,1610612752,New York Knicks,1,0,26,26,52,11,25,36,37,51,88,12,6,18,16,37,28,5,11,91,97
2019,2,21900281,11/30/2019,1610612754,Indiana Pacers,0,0,1610612755,Philadelphia 76ers,1,1,31,23,54,11,11,22,42,34,76,21,4,25,7,30,22,12,20,98,116
2019,2,21900281,11/30/2019,1610612755,Philadelphia 76ers,1,1,1610612754,Indiana Pacers,0,0,27,27,54,11,12,23,38,39,77,32,4,36,9,31,27,7,14,99,119
2021,2,22100221,11/17/2021,1610612745,Houston Rockets,0,0,1610612760,Oklahoma City Thunder,1,1,20,28,48,12,30,42,32,58,90,13,6,19,13,47,16,11,15,99,89
2021,2,22100221,11/17/2021,1610612760,Oklahoma City Thunder,1,1,1610612745,Houston Rockets,0,0,31,22,53,10,29,39,41,51,92,9,7,16,15,40,18,5,13,100,101
2018,2,21800888,2/23/2019,1610612748,Miami Heat,1,0,1610612765,Detroit Pistons,0,1,28,26,54,7,21,28,35,47,82,19,8,27,15,36,18,6,13,94,96
2018,2,21800888,2/23/2019,1610612765,Detroit Pistons,0,1,1610612748,Miami Heat,1,0,28,19,47,14,19,33,42,38,80,21,5,26,11,28,21,6,14,94,119
2018,2,21800788,2/3/2019,1610612738,Boston Celtics,1,1,1610612760,Oklahoma City Thunder,0,0,41,16,57,13,21,34,54,37,91,13,4,17,8,31,36,12,14,105,134
2018,2,21800788,2/3/2019,1610612760,Oklahoma City Thunder,0,0,1610612738,Boston Celtics,1,1,31,26,57,14,21,35,45,47,92,25,9,34,13,39,25,8,11,106,129
2018,2,21800340,12/2/2018,1610612755,Philadelphia 76ers,1,1,1610612763,Memphis Grizzlies,0,0,28,24,52,8,14,22,36,38,74,23,7,30,5,35,22,7,16,99,103
2018,2,21800340,12/2/2018,1610612763,Memphis Grizzlies,0,0,1610612755,Philadelphia 76ers,1,1,22,29,51,11,17,28,33,46,79,18,5,23,4,46,19,5,15,101,95
2020,2,22000917,4/26/2021,1610612747,Los Angeles Lakers,0,1,1610612753,Orlando Magic,1,0,36,20,56,11,20,31,47,40,87,9,5,14,14,28,23,5,12,92,114
2020,2,22000917,4/26/2021,1610612753,Orlando Magic,1,0,1610612747,Los Angeles Lakers,0,1,25,26,51,11,14,25,36,40,76,20,4,24,6,36,16,8,11,92,103
2016,2,21600592,1/13/2017,1610612751,Brooklyn Nets,0,0,1610612761,Toronto Raptors,1,1,23,27,50,17,19,36,40,46,86,16,4,20,8,39,26,7,12,101,113
2016,2,21600592,1/13/2017,1610612761,Toronto Raptors,1,1,1610612751,Brooklyn Nets,0,0,41,28,69,11,17,28,52,45,97,17,4,21,14,34,21,5,8,100,132
2014,2,21400804,2/20/2015,1610612754,Indiana Pacers,0,1,1610612755,Philadelphia 76ers,1,0,32,29,61,8,14,22,40,43,83,18,4,22,11,34,24,11,15,95,106
2014,2,21400804,2/20/2015,1610612755,Philadelphia 76ers,1,0,1610612754,Indiana Pacers,0,1,26,33,59,8,17,25,34,50,84,19,10,29,19,37,18,13,18,97,95
2021,2,22100220,11/17/2021,1610612750,Minnesota Timberwolves,1,1,1610612758,Sacramento Kings,0,0,31,15,46,10,26,36,41,41,82,15,3,18,14,29,20,7,17,94,107
2021,2,22100220,11/17/2021,1610612758,Sacramento Kings,0,0,1610612750,Minnesota Timberwolves,1,1,24,31,55,10,28,38,34,59,93,19,6,25,31,31,19,8,20,94,97
2018,2,21800701,1/21/2019,1610612744,Golden State Warriors,0,1,1610612747,Los Angeles Lakers,1,0,34,27,61,16,21,37,50,48,98,14,5,19,15,36,41,1,12,104,130
2018,2,21800701,1/21/2019,1610612747,Los Angeles Lakers,1,0,1610612744,Golden State Warriors,0,1,37,27,64,5,15,20,42,42,84,22,16,38,13,39,20,8,15,104,111
2018,2,21800548,12/31/2018,1610612744,Golden State Warriors,0,1,1610612756,Phoenix Suns,1,0,32,24,56,14,14,28,46,38,84,26,6,32,9,33,31,7,15,104,132
2018,2,21800548,12/31/2018,1610612756,Phoenix Suns,1,0,1610612744,Golden State Warriors,0,1,28,31,59,9,17,26,37,48,85,26,4,30,11,39,20,7,14,104,109
2018,2,21800474,12/21/2018,1610612741,Chicago Bulls,1,1,1610612753,Orlando Magic,0,0,28,30,58,5,12,17,33,42,75,19,7,26,11,35,23,4,10,86,90
2018,2,21800474,12/21/2018,1610612753,Orlando Magic,0,0,1610612741,Chicago Bulls,1,1,20,33,53,8,25,33,28,58,86,16,8,24,20,42,20,5,9,88,80
2018,2,21800404,12/11/2018,1610612746,LA Clippers,1,0,1610612761,Toronto Raptors,0,1,31,30,61,7,18,25,38,48,86,16,3,19,14,35,25,8,16,97,99
2018,2,21800404,12/11/2018,1610612761,Toronto Raptors,0,1,1610612746,LA Clippers,1,0,36,31,67,14,15,29,50,46,96,9,3,12,14,35,34,2,9,98,123
2018,2,21800282,11/24/2018,1610612743,Denver Nuggets,0,1,1610612760,Oklahoma City Thunder,1,0,29,36,65,10,20,30,39,56,95,17,7,24,22,39,26,9,18,100,105
2018,2,21800282,11/24/2018,1610612760,Oklahoma City Thunder,1,0,1610612743,Denver Nuggets,0,1,28,36,64,9,30,39,37,66,103,15,8,23,24,45,22,6,10,99,98
2018,2,21800122,11/2/2018,1610612762,Utah Jazz,1,0,1610612763,Memphis Grizzlies,0,1,22,19,41,14,22,36,36,41,77,14,11,25,13,32,21,9,14,90,100
2018,2,21800122,11/2/2018,1610612763,Memphis Grizzlies,0,1,1610612762,Utah Jazz,1,0,25,24,49,13,13,26,38,37,75,21,13,34,10,34,23,3,11,90,110
2017,2,21701179,4/5/2018,1610612746,LA Clippers,0,0,1610612762,Utah Jazz,1,1,32,31,63,3,14,17,35,45,80,22,6,28,18,29,18,7,16,93,95
2017,2,21701179,4/5/2018,1610612762,Utah Jazz,1,1,1610612746,LA Clippers,0,0,34,22,56,10,17,27,44,39,83,19,9,28,14,29,27,7,11,94,117
2017,2,21701088,3/24/2018,1610612750,Minnesota Timberwolves,0,0,1610612755,Philadelphia 76ers,1,1,31,42,73,6,17,23,37,59,96,28,10,38,17,47,19,9,14,112,108
2017,2,21701088,3/24/2018,1610612755,Philadelphia 76ers,1,1,1610612750,Minnesota Timberwolves,0,0,29,22,51,13,24,37,42,46,88,23,13,36,11,43,33,7,16,111,120
2016,2,21601150,4/2/2017,1610612739,Cleveland Cavaliers,1,1,1610612754,Indiana Pacers,0,0,29,23,52,18,25,43,47,48,95,23,10,33,18,36,29,6,16,111,135
2016,2,21601150,4/2/2017,1610612754,Indiana Pacers,0,0,1610612739,Cleveland Cavaliers,1,1,32,32,64,16,25,41,48,57,105,18,2,20,14,44,32,7,11,111,130
2016,2,21600138,11/12/2016,1610612743,Denver Nuggets,1,0,1610612765,Detroit Pistons,0,1,27,32,59,9,16,25,36,48,84,14,5,19,20,30,15,11,16,91,95
2016,2,21600138,11/12/2016,1610612765,Detroit Pistons,0,1,1610612743,Denver Nuggets,1,0,42,30,72,4,14,18,46,44,90,10,4,14,17,29,23,6,9,91,106
2018,2,21801170,4/3/2019,1610612738,Boston Celtics,0,1,1610612748,Miami Heat,1,0,29,27,56,9,15,24,38,42,80,27,4,31,11,31,25,6,12,97,112
2018,2,21801170,4/3/2019,1610612748,Miami Heat,1,0,1610612738,Boston Celtics,0,1,27,32,59,12,24,36,39,56,95,12,8,20,22,38,25,8,15,97,102
2014,2,21400803,2/20/2015,1610612740,New Orleans Pelicans,0,0,1610612753,Orlando Magic,1,1,24,26,50,5,14,19,29,40,69,21,7,28,7,36,21,4,12,88,84
2014,2,21400803,2/20/2015,1610612753,Orlando Magic,1,1,1610612740,New Orleans Pelicans,0,0,40,30,70,4,14,18,44,44,88,3,3,6,13,33,22,6,9,88,95
2018,2,21800626,1/11/2019,1610612742,Dallas Mavericks,0,1,1610612750,Minnesota Timberwolves,1,0,31,28,59,13,25,38,44,53,97,18,6,24,17,40,25,5,7,100,119
2018,2,21800626,1/11/2019,1610612750,Minnesota Timberwolves,1,0,1610612742,Dallas Mavericks,0,1,37,41,78,10,14,24,47,55,102,11,2,13,23,34,27,7,13,99,115
2018,2,21800228,11/17/2018,1610612740,New Orleans Pelicans,1,1,1610612743,Denver Nuggets,0,0,32,30,62,10,15,25,42,45,87,31,3,34,13,34,29,5,11,99,125
2018,2,21800228,11/17/2018,1610612743,Denver Nuggets,0,0,1610612740,New Orleans Pelicans,1,1,31,25,56,15,24,39,46,49,95,8,5,13,14,37,30,6,13,101,115
2017,2,21701137,3/30/2018,1610612746,LA Clippers,0,0,1610612757,Portland Trail Blazers,1,1,32,44,76,4,9,13,36,53,89,20,15,35,19,40,13,9,10,96,96
2017,2,21701137,3/30/2018,1610612757,Portland Trail Blazers,1,1,1610612746,LA Clippers,0,0,33,32,65,8,22,30,41,54,95,15,1,16,17,37,30,5,11,97,105
2017,2,21701102,3/25/2018,1610612744,Golden State Warriors,1,0,1610612762,Utah Jazz,0,1,32,44,76,6,9,15,38,53,91,9,1,10,15,39,24,6,11,93,91
2017,2,21701102,3/25/2018,1610612762,Utah Jazz,0,1,1610612744,Golden State Warriors,1,0,30,29,59,12,16,28,42,45,87,14,4,18,17,30,27,9,14,93,110
2017,2,21701087,3/23/2018,1610612737,Atlanta Hawks,0,0,1610612744,Golden State Warriors,1,1,26,26,52,11,21,32,37,47,84,9,11,20,11,39,24,8,11,95,94
2017,2,21701087,3/23/2018,1610612744,Golden State Warriors,1,1,1610612737,Atlanta Hawks,0,0,30,33,63,12,18,30,42,51,93,10,1,11,10,42,28,5,7,94,106
2017,2,21701074,3/22/2018,1610612745,Houston Rockets,1,1,1610612765,Detroit Pistons,0,0,23,25,48,12,39,51,35,64,99,18,10,28,20,50,19,9,13,105,100
2017,2,21701074,3/22/2018,1610612765,Detroit Pistons,0,0,1610612745,Houston Rockets,1,1,34,23,57,6,32,38,40,55,95,10,9,19,16,42,22,9,17,103,96
2017,2,21701052,3/19/2018,1610612755,Philadelphia 76ers,1,1,1610612766,Charlotte Hornets,0,0,24,25,49,18,26,44,42,51,93,6,2,8,17,35,30,8,16,97,108
2019,2,21900280,11/30/2019,1610612743,Denver Nuggets,0,0,1610612758,Sacramento Kings,1,1,25,30,55,11,21,32,36,51,87,14,7,21,14,42,23,12,17,101,97
2019,2,21900280,11/30/2019,1610612758,Sacramento Kings,1,1,1610612743,Denver Nuggets,0,0,29,34,63,8,25,33,37,59,96,18,3,21,19,41,22,11,16,101,100
2014,2,21401230,4/15/2015,1610612747,Los Angeles Lakers,1,0,1610612758,Sacramento Kings,0,1,29,41,70,7,17,24,36,58,94,20,5,25,23,37,22,10,15,100,99
2014,2,21401230,4/15/2015,1610612758,Sacramento Kings,0,1,1610612747,Los Angeles Lakers,1,0,38,29,67,8,9,17,46,38,84,22,19,41,13,34,30,6,10,98,122
2019,2,21900054,10/29/2019,1610612747,Los Angeles Lakers,1,1,1610612763,Memphis Grizzlies,0,0,33,27,60,7,19,26,40,46,86,33,6,39,14,35,25,10,19,108,120
2019,2,21900054,10/29/2019,1610612763,Memphis Grizzlies,0,0,1610612747,Los Angeles Lakers,1,1,24,37,61,7,27,34,31,64,95,22,1,23,18,46,20,9,20,108,91
2021,2,22100219,11/17/2021,1610612747,Los Angeles Lakers,0,0,1610612749,Milwaukee Bucks,1,1,28,25,53,12,31,43,40,56,96,10,2,12,13,44,24,9,13,102,102
2021,2,22100219,11/17/2021,1610612749,Milwaukee Bucks,1,1,1610612747,Los Angeles Lakers,0,0,28,22,50,12,25,37,40,47,87,17,7,24,10,41,22,8,15,102,109
2018,2,21800787,2/3/2019,1610612752,New York Knicks,1,0,1610612763,Memphis Grizzlies,0,1,16,18,34,12,28,40,28,46,74,16,6,22,8,41,20,8,15,92,84
2018,2,21800787,2/3/2019,1610612763,Memphis Grizzlies,0,1,1610612752,New York Knicks,1,0,28,37,65,9,17,26,37,54,91,13,5,18,16,42,25,4,8,92,96
2018,2,21800627,1/11/2019,1610612747,Los Angeles Lakers,0,0,1610612762,Utah Jazz,1,1,32,44,76,5,22,27,37,66,103,16,8,24,20,50,14,9,13,107,95
2018,2,21800627,1/11/2019,1610612762,Utah Jazz,1,1,1610612747,Los Angeles Lakers,0,0,23,31,54,15,27,42,38,58,96,22,10,32,20,41,24,9,16,106,113
2018,2,21800403,12/11/2018,1610612756,Phoenix Suns,0,0,1610612759,San Antonio Spurs,1,1,25,29,54,8,20,28,33,49,82,12,2,14,12,38,19,7,17,95,86
2018,2,21800403,12/11/2018,1610612759,San Antonio Spurs,1,1,1610612756,Phoenix Suns,0,0,28,34,62,13,8,21,41,42,83,16,3,19,12,33,28,7,15,94,111
2018,2,21800339,12/2/2018,1610612748,Miami Heat,1,1,1610612762,Utah Jazz,0,0,23,37,60,13,18,31,36,55,91,17,7,24,18,43,20,8,13,94,102
2020,2,22000916,4/26/2021,1610612737,Atlanta Hawks,0,0,1610612765,Detroit Pistons,1,1,29,29,58,4,23,27,33,52,85,16,1,17,12,40,19,9,16,97,86
2020,2,22000916,4/26/2021,1610612765,Detroit Pistons,1,1,1610612737,Atlanta Hawks,0,0,31,27,58,9,17,26,40,44,84,11,4,15,8,38,22,10,14,96,100
2018,2,21800339,12/2/2018,1610612762,Utah Jazz,0,0,1610612748,Miami Heat,1,1,28,28,56,11,22,33,39,50,89,11,4,15,15,36,21,8,14,95,100
2018,2,21800229,11/17/2018,1610612738,Boston Celtics,1,0,1610612762,Utah Jazz,0,1,30,28,58,5,28,33,35,56,91,11,9,20,21,40,16,11,14,93,86
2018,2,21800229,11/17/2018,1610612762,Utah Jazz,0,1,1610612738,Boston Celtics,1,0,24,16,40,11,27,38,35,43,78,17,10,27,10,38,23,11,15,94,98
2018,2,21800174,11/10/2018,1610612752,New York Knicks,0,0,1610612761,Toronto Raptors,1,1,38,36,74,6,16,22,44,52,96,18,4,22,20,35,18,8,14,100,112
2018,2,21800174,11/10/2018,1610612761,Toronto Raptors,1,1,1610612752,New York Knicks,0,0,28,16,44,14,21,35,42,37,79,30,10,40,12,32,24,12,15,100,128
2016,2,21600591,1/12/2017,1610612742,Dallas Mavericks,0,1,1610612756,Phoenix Suns,1,0,28,27,55,15,19,34,43,46,89,12,5,17,11,36,29,2,10,96,113
2016,2,21600591,1/12/2017,1610612756,Phoenix Suns,1,0,1610612742,Dallas Mavericks,0,1,28,32,60,10,8,18,38,40,78,22,5,27,16,25,15,11,20,96,108
2016,2,21600137,11/12/2016,1610612749,Milwaukee Bucks,1,1,1610612763,Memphis Grizzlies,0,0,29,21,50,7,11,18,36,32,68,27,9,36,6,31,20,8,14,93,106
2016,2,21600137,11/12/2016,1610612763,Memphis Grizzlies,0,0,1610612749,Milwaukee Bucks,1,1,29,19,48,6,24,30,35,43,78,20,1,21,8,36,20,9,13,95,96
2014,2,21401229,4/15/2015,1610612743,Denver Nuggets,0,0,1610612744,Golden State Warriors,1,1,39,26,65,6,12,18,45,38,83,30,6,36,13,30,28,11,21,105,126
2014,2,21401229,4/15/2015,1610612744,Golden State Warriors,1,1,1610612743,Denver Nuggets,0,0,34,28,62,13,15,28,47,43,90,26,8,34,15,32,30,10,13,105,133
2018,2,21800887,2/23/2019,1610612740,New Orleans Pelicans,1,1,1610612747,Los Angeles Lakers,0,0,35,21,56,15,25,40,50,46,96,13,3,16,13,34,31,10,18,109,128
2018,2,21800887,2/23/2019,1610612747,Los Angeles Lakers,0,0,1610612740,New Orleans Pelicans,1,1,34,18,52,10,19,29,44,37,81,17,9,26,7,35,33,14,23,108,115
2018,2,21800700,1/21/2019,1610612757,Portland Trail Blazers,0,1,1610612762,Utah Jazz,1,0,37,35,72,8,10,18,45,45,90,11,4,15,10,37,30,5,11,99,109
2018,2,21800700,1/21/2019,1610612762,Utah Jazz,1,0,1610612757,Portland Trail Blazers,0,1,29,29,58,7,26,33,36,55,91,25,6,31,22,38,21,6,15,99,104
2018,2,21800547,12/31/2018,1610612742,Dallas Mavericks,0,0,1610612760,Oklahoma City Thunder,1,1,17,19,36,14,24,38,31,43,74,26,8,34,8,37,21,13,29,111,102
2018,2,21800547,12/31/2018,1610612760,Oklahoma City Thunder,1,1,1610612742,Dallas Mavericks,0,0,40,39,79,6,18,24,46,57,103,24,11,35,18,46,22,7,10,111,122
2018,2,21800281,11/24/2018,1610612741,Chicago Bulls,0,0,1610612750,Minnesota Timberwolves,1,1,22,26,48,10,23,33,32,49,81,22,9,31,11,42,22,7,15,101,96
2018,2,21800281,11/24/2018,1610612750,Minnesota Timberwolves,1,1,1610612741,Chicago Bulls,0,0,35,34,69,7,27,34,42,61,103,20,3,23,27,35,22,7,14,100,111
2017,2,21701138,3/31/2018,1610612764,Washington Wizards,1,1,1610612766,Charlotte Hornets,0,0,22,27,49,18,21,39,40,48,88,9,3,12,11,38,30,6,12,94,107
2017,2,21701138,3/31/2018,1610612766,Charlotte Hornets,0,0,1610612764,Washington Wizards,1,1,29,25,54,6,17,23,35,42,77,17,10,27,14,33,22,11,17,96,93
2017,2,21701118,3/28/2018,1610612752,New York Knicks,0,0,1610612755,Philadelphia 76ers,1,1,27,36,63,9,22,31,36,58,94,20,6,26,14,48,20,9,17,109,101
2017,2,21701118,3/28/2018,1610612755,Philadelphia 76ers,1,1,1610612752,New York Knicks,0,0,36,31,67,9,22,31,45,53,98,19,8,27,16,42,34,4,12,107,118
2016,2,21601149,4/2/2017,1610612743,Denver Nuggets,0,1,1610612748,Miami Heat,1,0,39,28,67,5,15,20,44,43,87,23,4,27,9,36,25,3,8,99,116
2016,2,21601149,4/2/2017,1610612748,Miami Heat,1,0,1610612743,Denver Nuggets,0,1,29,31,60,13,14,27,42,45,87,16,5,21,10,36,26,9,11,99,113
2014,2,21400802,2/19/2015,1610612746,LA Clippers,1,1,1610612759,San Antonio Spurs,0,0,34,24,58,8,11,19,42,35,77,27,25,52,11,36,26,6,13,103,119
2014,2,21400802,2/19/2015,1610612759,San Antonio Spurs,0,0,1610612746,LA Clippers,1,1,33,23,56,10,18,28,43,41,84,19,4,23,9,35,34,10,17,104,115
2018,2,21801169,4/3/2019,1610612751,Brooklyn Nets,1,0,1610612761,Toronto Raptors,0,1,31,23,54,10,22,32,41,45,86,13,8,21,11,38,23,9,16,101,105
2018,2,21801169,4/3/2019,1610612761,Toronto Raptors,0,1,1610612751,Brooklyn Nets,1,0,29,38,67,15,23,38,44,61,105,12,2,14,18,44,29,3,7,101,115
2021,2,22100218,11/17/2021,1610612752,New York Knicks,1,0,1610612753,Orlando Magic,0,1,21,18,39,16,33,49,37,51,88,8,4,12,14,38,25,7,18,98,98
2021,2,22100218,11/17/2021,1610612753,Orlando Magic,0,1,1610612752,New York Knicks,1,0,28,30,58,11,27,38,39,57,96,15,3,18,22,36,20,5,15,98,104
2018,2,21800473,12/21/2018,1610612738,Boston Celtics,1,0,1610612749,Milwaukee Bucks,0,1,25,32,57,10,24,34,35,56,91,27,9,36,14,47,22,3,5,101,107
2018,2,21800473,12/21/2018,1610612749,Milwaukee Bucks,0,1,1610612738,Boston Celtics,1,0,25,15,40,16,24,40,41,39,80,22,6,28,13,28,26,13,21,101,120
2018,2,21800175,11/10/2018,1610612746,LA Clippers,1,1,1610612749,Milwaukee Bucks,0,0,32,33,65,14,20,34,46,53,99,22,5,27,14,42,26,11,18,114,128
2018,2,21800175,11/10/2018,1610612749,Milwaukee Bucks,0,0,1610612746,LA Clippers,1,1,31,28,59,16,30,46,47,58,105,16,7,23,17,44,31,6,17,115,126
2018,2,21800123,11/2/2018,1610612756,Phoenix Suns,1,0,1610612761,Toronto Raptors,0,1,32,33,65,8,18,26,40,51,91,10,8,18,17,36,20,11,16,98,98
2018,2,21800123,11/2/2018,1610612761,Toronto Raptors,0,1,1610612756,Phoenix Suns,1,0,29,19,48,12,21,33,41,40,81,13,8,21,7,38,29,3,14,97,107
2017,2,21701101,3/25/2018,1610612737,Atlanta Hawks,0,0,1610612745,Houston Rockets,1,1,28,20,48,11,29,40,39,49,88,10,1,11,8,41,18,7,13,98,99
2017,2,21701101,3/25/2018,1610612745,Houston Rockets,1,1,1610612737,Atlanta Hawks,0,0,24,14,38,20,32,52,44,46,90,10,1,11,8,39,28,5,12,99,118
2016,2,21601148,4/2/2017,1610612737,Atlanta Hawks,0,0,1610612751,Brooklyn Nets,1,1,23,33,56,7,17,24,30,50,80,15,8,23,8,45,19,11,20,101,82
2016,2,21601148,4/2/2017,1610612751,Brooklyn Nets,1,1,1610612737,Atlanta Hawks,0,0,22,27,49,10,23,33,32,50,82,17,3,20,11,41,21,9,21,101,91
2016,2,21600590,1/12/2017,1610612744,Golden State Warriors,1,1,1610612765,Detroit Pistons,0,0,35,25,60,15,14,29,50,39,89,12,6,18,10,32,39,10,18,106,127
2016,2,21600590,1/12/2017,1610612765,Detroit Pistons,0,0,1610612744,Golden State Warriors,1,1,37,23,60,6,22,28,43,45,88,15,5,20,13,35,20,14,20,107,107
2016,2,21600136,11/12/2016,1610612748,Miami Heat,1,0,1610612762,Utah Jazz,0,1,33,31,64,5,12,17,38,43,81,10,9,19,7,41,21,5,9,92,91
2016,2,21600136,11/12/2016,1610612762,Utah Jazz,0,1,1610612748,Miami Heat,1,0,34,27,61,6,14,20,40,41,81,16,3,19,6,36,12,5,9,91,102
2019,2,21900279,11/29/2019,1610612747,Los Angeles Lakers,1,1,1610612764,Washington Wizards,0,0,31,24,55,14,18,32,45,42,87,21,7,28,11,34,29,10,19,107,125
2019,2,21900279,11/29/2019,1610612764,Washington Wizards,0,0,1610612747,Los Angeles Lakers,1,1,28,31,59,10,27,37,38,58,96,17,2,19,18,41,25,9,19,108,103
2019,2,21900053,10/29/2019,1610612742,Dallas Mavericks,0,1,1610612743,Denver Nuggets,1,0,28,19,47,13,24,37,41,43,84,14,10,24,11,40,29,6,9,91,109
2019,2,21900053,10/29/2019,1610612743,Denver Nuggets,1,0,1610612742,Dallas Mavericks,0,1,32,27,59,11,21,32,43,48,91,9,4,13,17,34,24,6,11,92,106
2018,2,21801021,3/14/2019,1610612739,Cleveland Cavaliers,0,0,1610612753,Orlando Magic,1,1,28,27,55,7,24,31,35,51,86,14,1,15,12,40,13,11,16,97,91
2018,2,21801021,3/14/2019,1610612753,Orlando Magic,1,1,1610612739,Cleveland Cavaliers,0,0,31,31,62,14,17,31,45,48,93,16,5,21,14,35,31,4,9,96,120
2018,2,21800886,2/23/2019,1610612754,Indiana Pacers,0,1,1610612764,Washington Wizards,1,0,36,22,58,11,14,25,47,36,83,14,8,22,15,27,29,15,23,101,119
2018,2,21800886,2/23/2019,1610612764,Washington Wizards,1,0,1610612754,Indiana Pacers,0,1,29,15,44,13,22,35,42,37,79,15,6,21,9,31,27,13,22,101,112
2018,2,21800786,2/2/2019,1610612745,Houston Rockets,0,1,1610612762,Utah Jazz,1,0,25,23,48,15,24,39,40,47,87,30,7,37,9,41,17,8,14,110,125
2018,2,21800786,2/2/2019,1610612762,Utah Jazz,1,0,1610612745,Houston Rockets,0,1,20,25,45,11,30,41,31,55,86,25,11,36,19,42,19,15,23,109,98
2018,2,21800546,12/31/2018,1610612740,New Orleans Pelicans,1,1,1610612750,Minnesota Timberwolves,0,0,31,31,62,14,11,25,45,42,87,19,2,21,14,29,28,10,15,97,123
2018,2,21800546,12/31/2018,1610612750,Minnesota Timberwolves,0,0,1610612740,New Orleans Pelicans,1,1,34,31,65,9,19,28,43,50,93,19,4,23,15,38,29,3,7,97,114
2018,2,21800402,12/11/2018,1610612745,Houston Rockets,1,1,1610612757,Portland Trail Blazers,0,0,33,23,56,9,20,29,42,43,85,18,9,27,17,31,22,1,7,91,111
2018,2,21800402,12/11/2018,1610612757,Portland Trail Blazers,0,0,1610612745,Houston Rockets,1,1,28,34,62,10,15,25,38,49,87,18,3,21,20,30,20,9,14,92,104
2020,2,22000915,4/25/2021,1610612744,Golden State Warriors,1,1,1610612758,Sacramento Kings,0,0,32,27,59,14,22,36,46,49,95,11,4,15,19,32,30,8,17,99,117
2020,2,22000915,4/25/2021,1610612758,Sacramento Kings,0,0,1610612744,Golden State Warriors,1,1,27,22,49,14,23,37,41,45,86,17,5,22,8,38,22,5,11,99,113
2016,2,21601147,4/2/2017,1610612755,Philadelphia 76ers,0,0,1610612761,Toronto Raptors,1,1,25,19,44,11,25,36,36,44,80,22,3,25,18,28,25,12,21,96,105
2016,2,21601147,4/2/2017,1610612761,Toronto Raptors,1,1,1610612755,Philadelphia 76ers,0,0,40,26,66,6,13,19,46,39,85,15,4,19,14,27,25,8,15,95,113
2014,2,21400801,2/19/2015,1610612742,Dallas Mavericks,0,0,1610612760,Oklahoma City Thunder,1,1,24,40,64,9,18,27,33,58,91,14,3,17,17,43,16,8,18,100,89
2021,2,22100217,11/17/2021,1610612740,New Orleans Pelicans,0,0,1610612748,Miami Heat,1,1,23,17,40,10,25,35,33,42,75,22,6,28,12,32,18,6,17,94,98
2021,2,22100217,11/17/2021,1610612748,Miami Heat,1,1,1610612740,New Orleans Pelicans,0,0,27,20,47,15,25,40,42,45,87,14,3,17,14,31,29,6,11,95,113
2014,2,21400801,2/19/2015,1610612760,Oklahoma City Thunder,1,1,1610612742,Dallas Mavericks,0,0,31,38,69,7,15,22,38,53,91,21,5,26,28,27,20,14,25,101,104
2018,2,21801168,4/3/2019,1610612737,Atlanta Hawks,1,1,1610612755,Philadelphia 76ers,0,0,36,20,56,12,24,36,48,44,92,22,6,28,13,34,29,8,11,103,130
2018,2,21801168,4/3/2019,1610612755,Philadelphia 76ers,0,0,1610612737,Atlanta Hawks,1,1,35,32,67,10,21,31,45,53,98,22,16,38,27,33,27,7,13,101,122
2018,2,21801023,3/14/2019,1610612747,Los Angeles Lakers,0,0,1610612761,Toronto Raptors,1,1,31,23,54,7,24,31,38,47,85,15,9,24,11,41,24,15,21,106,98
2018,2,21801023,3/14/2019,1610612761,Toronto Raptors,1,1,1610612747,Los Angeles Lakers,0,0,20,30,50,16,25,41,36,55,91,23,6,29,17,42,21,11,17,107,111
2018,2,21800699,1/21/2019,1610612745,Houston Rockets,0,0,1610612755,Philadelphia 76ers,1,1,20,24,44,11,31,42,31,55,86,20,6,26,9,48,14,9,12,101,93
2018,2,21800699,1/21/2019,1610612755,Philadelphia 76ers,1,1,1610612745,Houston Rockets,0,0,35,30,65,8,15,23,43,45,88,27,6,33,16,33,21,9,13,101,121
2018,2,21800472,12/21/2018,1610612737,Atlanta Hawks,0,1,1610612752,New York Knicks,1,0,33,29,62,10,19,29,43,48,91,18,6,24,17,32,29,8,16,102,114
2018,2,21800472,12/21/2018,1610612752,New York Knicks,1,0,1610612737,Atlanta Hawks,0,1,33,24,57,8,19,27,41,43,84,17,7,24,6,41,20,4,13,102,107
2018,2,21800338,12/2/2018,1610612740,New Orleans Pelicans,0,1,1610612766,Charlotte Hornets,1,0,33,21,54,11,21,32,44,42,86,20,4,24,11,33,30,9,18,104,119
2018,2,21800338,12/2/2018,1610612766,Charlotte Hornets,1,0,1610612740,New Orleans Pelicans,0,1,29,26,55,10,26,36,39,52,91,21,7,28,13,42,25,6,11,104,109
2018,2,21800280,11/24/2018,1610612740,New Orleans Pelicans,0,0,1610612764,Washington Wizards,1,1,32,27,59,11,20,31,43,47,90,17,4,21,8,42,23,12,16,109,114
2018,2,21800280,11/24/2018,1610612764,Washington Wizards,1,1,1610612740,New Orleans Pelicans,0,0,41,20,61,10,19,29,51,39,90,12,11,23,7,38,30,10,15,108,124
2018,2,21800227,11/17/2018,1610612747,Los Angeles Lakers,0,0,1610612753,Orlando Magic,1,1,33,27,60,10,20,30,43,47,90,21,4,25,14,34,22,5,14,104,117
2018,2,21800227,11/17/2018,1610612753,Orlando Magic,1,1,1610612747,Los Angeles Lakers,0,0,39,22,61,11,21,32,50,43,93,19,4,23,12,34,28,5,13,103,130
2018,2,21800173,11/9/2018,1610612750,Minnesota Timberwolves,0,0,1610612758,Sacramento Kings,1,1,32,37,69,7,18,25,39,55,94,25,6,31,19,40,20,7,17,107,110
2018,2,21800173,11/9/2018,1610612758,Sacramento Kings,1,1,1610612750,Minnesota Timberwolves,0,0,31,32,63,12,20,32,43,52,95,23,6,29,15,41,25,6,13,107,121
2016,2,21600589,1/12/2017,1610612743,Denver Nuggets,1,1,1610612754,Indiana Pacers,0,0,37,21,58,15,17,32,52,38,90,21,2,23,14,24,37,9,15,101,140
2016,2,21600589,1/12/2017,1610612754,Indiana Pacers,0,0,1610612743,Denver Nuggets,1,1,32,33,65,12,17,29,44,50,94,12,1,13,15,36,26,10,16,103,112
2021,2,22100216,11/17/2021,1610612739,Cleveland Cavaliers,0,0,1610612751,Brooklyn Nets,1,1,24,21,45,11,33,44,35,54,89,18,3,21,15,40,20,7,14,100,99
2021,2,22100216,11/17/2021,1610612751,Brooklyn Nets,1,1,1610612739,Cleveland Cavaliers,0,0,26,25,51,12,20,32,38,45,83,21,4,25,8,39,29,9,12,98,109
2018,2,21801022,3/14/2019,1610612738,Boston Celtics,1,1,1610612758,Sacramento Kings,0,0,40,29,69,9,19,28,49,48,97,19,7,26,12,41,32,9,13,110,126
2018,2,21801022,3/14/2019,1610612758,Sacramento Kings,0,0,1610612738,Boston Celtics,1,1,37,24,61,11,23,34,48,47,95,13,10,23,8,45,31,7,10,109,120
2018,2,21800785,2/2/2019,1610612755,Philadelphia 76ers,0,0,1610612758,Sacramento Kings,1,1,34,26,60,7,26,33,41,52,93,19,6,25,16,38,19,9,14,102,108
2018,2,21800785,2/2/2019,1610612758,Sacramento Kings,1,1,1610612755,Philadelphia 76ers,0,0,31,31,62,11,19,30,42,50,92,20,4,24,18,34,22,9,16,101,115
2017,2,21701221,4/11/2018,1610612748,Miami Heat,1,1,1610612761,Toronto Raptors,0,0,35,45,80,11,15,26,46,60,106,13,7,20,22,41,26,5,9,103,116
2017,2,21701221,4/11/2018,1610612761,Toronto Raptors,0,0,1610612748,Miami Heat,1,1,33,29,62,9,21,30,42,50,92,16,5,21,13,41,24,8,14,104,109
2017,2,21701155,4/1/2018,1610612747,Los Angeles Lakers,1,0,1610612758,Sacramento Kings,0,1,23,20,43,7,25,32,30,45,75,16,9,25,13,35,18,9,15,90,83
2017,2,21701155,4/1/2018,1610612758,Sacramento Kings,0,1,1610612747,Los Angeles Lakers,1,0,28,40,68,7,17,24,35,57,92,7,7,14,19,42,17,5,10,89,84
2017,2,21701086,3/23/2018,1610612738,Boston Celtics,0,1,1610612757,Portland Trail Blazers,1,0,24,35,59,11,7,18,35,42,77,24,2,26,10,32,22,8,13,92,105
2017,2,21701086,3/23/2018,1610612757,Portland Trail Blazers,1,0,1610612738,Boston Celtics,0,1,32,26,58,8,25,33,40,51,91,12,3,15,14,37,16,5,8,93,100
2017,2,21701073,3/22/2018,1610612753,Orlando Magic,1,0,1610612755,Philadelphia 76ers,0,1,27,31,58,10,23,33,37,54,91,14,8,22,10,48,26,7,12,104,98
2016,2,21600588,1/12/2017,1610612747,Los Angeles Lakers,0,0,1610612759,San Antonio Spurs,1,1,29,36,65,6,14,20,35,50,85,18,7,25,12,41,23,5,9,94,94
2021,2,22100215,11/17/2021,1610612737,Atlanta Hawks,1,1,1610612738,Boston Celtics,0,0,28,16,44,13,24,37,41,40,81,15,3,18,9,33,28,9,14,94,110
2021,2,22100215,11/17/2021,1610612738,Boston Celtics,0,0,1610612737,Atlanta Hawks,1,1,26,17,43,11,30,41,37,47,84,14,3,17,13,35,24,9,14,94,99
2016,2,21600588,1/12/2017,1610612759,San Antonio Spurs,1,1,1610612747,Los Angeles Lakers,0,0,39,21,60,10,11,21,49,32,81,26,3,29,11,22,32,6,12,95,134
2016,2,21600135,11/12/2016,1610612746,LA Clippers,0,1,1610612750,Minnesota Timberwolves,1,0,29,23,52,11,13,24,40,36,76,28,9,37,14,25,25,11,14,95,119
2016,2,21600135,11/12/2016,1610612750,Minnesota Timberwolves,1,0,1610612746,LA Clippers,0,1,32,35,67,8,14,22,40,49,89,17,4,21,17,34,26,7,13,95,105
2020,2,22000914,4/25/2021,1610612753,Orlando Magic,1,0,1610612754,Indiana Pacers,0,1,30,39,69,10,22,32,40,61,101,22,6,28,19,45,22,3,7,103,112
2020,2,22000914,4/25/2021,1610612754,Indiana Pacers,0,1,1610612753,Orlando Magic,1,0,35,24,59,15,17,32,50,41,91,16,2,18,7,36,28,9,13,103,131
2014,2,21400800,2/12/2015,1610612739,Cleveland Cavaliers,0,0,1610612741,Chicago Bulls,1,1,29,25,54,8,23,31,37,48,85,16,6,22,15,35,20,10,16,97,98
2014,2,21400800,2/12/2015,1610612741,Chicago Bulls,1,1,1610612739,Cleveland Cavaliers,0,0,33,36,69,9,14,23,42,50,92,20,6,26,15,36,29,5,8,96,113
2018,2,21800545,12/31/2018,1610612738,Boston Celtics,0,0,1610612759,San Antonio Spurs,1,1,32,22,54,11,23,34,43,45,88,14,6,20,12,35,30,6,12,97,111
2018,2,21800545,12/31/2018,1610612759,San Antonio Spurs,1,1,1610612738,Boston Celtics,0,0,31,34,65,14,12,26,45,46,91,16,2,18,13,34,27,5,11,98,120
2018,2,21800401,12/10/2018,1610612747,Los Angeles Lakers,1,1,1610612748,Miami Heat,0,0,27,31,58,14,18,32,41,49,90,12,8,20,13,40,24,9,12,99,108
2018,2,21800401,12/10/2018,1610612748,Miami Heat,0,0,1610612747,Los Angeles Lakers,1,1,31,29,60,11,23,34,42,52,94,10,3,13,18,35,29,9,17,100,105
2018,2,21800337,12/2/2018,1610612747,Los Angeles Lakers,1,1,1610612756,Phoenix Suns,0,0,35,30,65,11,16,27,46,46,92,17,6,23,15,34,26,12,19,104,120
2018,2,21800337,12/2/2018,1610612756,Phoenix Suns,0,0,1610612747,Los Angeles Lakers,1,1,24,36,60,13,20,33,37,56,93,9,2,11,10,47,24,9,16,105,96
2018,2,21800279,11/24/2018,1610612739,Cleveland Cavaliers,1,1,1610612745,Houston Rockets,0,0,37,31,68,7,15,22,44,46,90,22,7,29,26,25,15,5,14,91,117
2018,2,21800279,11/24/2018,1610612745,Houston Rockets,0,0,1610612739,Cleveland Cavaliers,1,1,22,13,35,15,24,39,37,37,74,19,9,28,11,32,18,11,16,92,108
2018,2,21800226,11/17/2018,1610612737,Atlanta Hawks,0,0,1610612754,Indiana Pacers,1,1,23,35,58,8,21,29,31,56,87,19,8,27,12,47,20,11,18,105,89
2018,2,21800226,11/17/2018,1610612754,Indiana Pacers,1,1,1610612737,Atlanta Hawks,0,0,23,34,57,12,18,30,35,52,87,15,6,21,16,38,25,15,24,105,97
2017,2,21701222,4/11/2018,1610612753,Orlando Magic,1,1,1610612764,Washington Wizards,0,0,20,25,45,13,19,32,33,44,77,22,5,27,9,36,20,5,16,96,101
2017,2,21701222,4/11/2018,1610612764,Washington Wizards,0,0,1610612753,Orlando Magic,1,1,23,38,61,10,24,34,33,62,95,16,11,27,24,43,17,6,12,98,92
2017,2,21701199,4/8/2018,1610612763,Memphis Grizzlies,1,1,1610612765,Detroit Pistons,0,0,32,18,50,16,17,33,48,35,83,18,6,24,12,28,36,10,14,97,130
2017,2,21701199,4/8/2018,1610612765,Detroit Pistons,0,0,1610612763,Memphis Grizzlies,1,1,15,31,46,23,24,47,38,55,93,18,5,23,19,38,30,11,13,97,117
2016,2,21601146,4/2/2017,1610612740,New Orleans Pelicans,1,0,1610612741,Chicago Bulls,0,1,23,28,51,10,20,30,33,48,81,34,1,35,7,42,24,7,12,101,110
2016,2,21601146,4/2/2017,1610612741,Chicago Bulls,0,1,1610612740,New Orleans Pelicans,1,0,32,34,66,13,13,26,45,47,92,14,4,18,11,36,26,7,11,101,117
2019,2,21900278,11/29/2019,1610612741,Chicago Bulls,0,0,1610612757,Portland Trail Blazers,1,1,22,34,56,14,24,38,36,58,94,17,8,25,19,44,24,6,11,99,103
2019,2,21900278,11/29/2019,1610612757,Portland Trail Blazers,1,1,1610612741,Chicago Bulls,0,0,28,26,54,10,20,30,38,46,84,21,7,28,11,38,20,8,13,99,107
2021,2,22100214,11/17/2021,1610612754,Indiana Pacers,0,0,1610612765,Detroit Pistons,1,1,24,18,42,9,28,37,33,46,79,14,5,19,11,37,14,13,18,96,89
2021,2,22100214,11/17/2021,1610612765,Detroit Pistons,1,1,1610612754,Indiana Pacers,0,0,26,26,52,8,20,28,34,46,80,21,7,28,11,38,16,5,13,96,97
2014,2,21400799,2/11/2015,1610612745,Houston Rockets,0,0,1610612746,LA Clippers,1,1,25,17,42,9,36,45,34,53,87,18,4,22,15,40,26,13,17,99,95
2014,2,21400799,2/11/2015,1610612746,LA Clippers,1,1,1610612745,Houston Rockets,0,0,35,24,59,4,18,22,39,42,81,28,17,45,18,29,25,6,15,99,110
2018,2,21801167,4/3/2019,1610612741,Chicago Bulls,0,1,1610612764,Washington Wizards,1,0,43,28,71,5,14,19,48,42,90,14,3,17,13,31,22,8,20,104,115
2018,2,21801167,4/3/2019,1610612764,Washington Wizards,1,0,1610612741,Chicago Bulls,0,1,40,30,70,5,22,27,45,52,97,19,7,26,15,41,24,7,12,105,114
2018,2,21801018,3/13/2019,1610612744,Golden State Warriors,0,1,1610612745,Houston Rockets,1,0,30,23,53,12,20,32,42,43,85,10,0,10,14,29,28,7,15,90,106
2018,2,21801018,3/13/2019,1610612745,Houston Rockets,1,0,1610612744,Golden State Warriors,0,1,26,11,37,11,30,41,37,41,78,19,4,23,9,34,18,7,11,92,104
2018,2,21800885,2/23/2019,1610612739,Cleveland Cavaliers,1,1,1610612763,Memphis Grizzlies,0,0,23,23,46,16,26,42,39,49,88,18,5,23,18,32,25,7,19,102,112
2018,2,21800885,2/23/2019,1610612763,Memphis Grizzlies,0,0,1610612739,Cleveland Cavaliers,1,1,35,30,65,5,20,25,40,50,90,22,6,28,16,39,18,6,12,100,107
2018,2,21800698,1/21/2019,1610612738,Boston Celtics,1,1,1610612748,Miami Heat,0,0,31,26,57,12,18,30,43,44,87,9,1,10,12,33,26,11,19,98,107
2018,2,21800698,1/21/2019,1610612748,Miami Heat,0,0,1610612738,Boston Celtics,1,1,25,26,51,11,24,35,36,50,86,16,2,18,17,35,25,13,20,99,99
2018,2,21800624,1/11/2019,1610612751,Brooklyn Nets,0,0,1610612761,Toronto Raptors,1,1,26,32,58,11,19,30,37,51,88,20,10,30,11,44,20,10,17,108,105
2018,2,21800624,1/11/2019,1610612761,Toronto Raptors,1,1,1610612751,Brooklyn Nets,0,0,37,33,70,11,24,35,48,57,105,15,9,24,15,47,32,4,10,110,122
2018,2,21800471,12/21/2018,1610612751,Brooklyn Nets,1,0,1610612754,Indiana Pacers,0,1,17,24,41,16,15,31,33,39,72,24,10,34,15,30,28,10,22,96,106
2018,2,21800471,12/21/2018,1610612754,Indiana Pacers,0,1,1610612751,Brooklyn Nets,1,0,33,23,56,11,15,26,44,38,82,15,3,18,7,32,24,5,12,95,114
2020,2,22000913,4/25/2021,1610612737,Atlanta Hawks,1,1,1610612749,Milwaukee Bucks,0,0,27,26,53,13,22,35,40,48,88,18,5,23,11,39,23,6,10,100,111
2020,2,22000913,4/25/2021,1610612749,Milwaukee Bucks,0,0,1610612737,Atlanta Hawks,1,1,31,22,53,8,20,28,39,42,81,18,5,23,4,41,20,6,12,99,104
2016,2,21601145,4/2/2017,1610612738,Boston Celtics,0,1,1610612752,New York Knicks,1,0,28,7,35,12,25,37,40,32,72,18,8,26,7,28,22,12,17,94,110
2016,2,21601145,4/2/2017,1610612752,New York Knicks,1,0,1610612738,Boston Celtics,0,1,26,34,60,7,18,25,33,52,85,21,4,25,13,41,20,8,11,95,94
2021,2,22100213,11/17/2021,1610612764,Washington Wizards,0,0,1610612766,Charlotte Hornets,1,1,25,23,48,8,34,42,33,57,90,13,3,16,15,44,23,6,11,94,87
2021,2,22100213,11/17/2021,1610612766,Charlotte Hornets,1,1,1610612764,Washington Wizards,0,0,32,32,64,10,22,32,42,54,96,3,3,6,18,38,30,7,11,93,97
2019,2,21900052,10/29/2019,1610612737,Atlanta Hawks,0,0,1610612748,Miami Heat,1,1,24,20,44,11,28,39,35,48,83,16,8,24,12,39,28,11,20,104,97
2019,2,21900052,10/29/2019,1610612748,Miami Heat,1,1,1610612737,Atlanta Hawks,0,0,20,22,42,13,18,31,33,40,73,33,12,45,18,27,19,14,28,103,112
2014,2,21401228,4/15/2015,1610612761,Toronto Raptors,1,1,1610612766,Charlotte Hornets,0,0,26,18,44,12,21,33,38,39,77,4,0,4,8,31,27,8,11,83,92
2014,2,21401228,4/15/2015,1610612766,Charlotte Hornets,0,0,1610612761,Toronto Raptors,1,1,18,20,38,12,21,33,30,41,71,15,1,16,11,30,15,8,14,82,87
2018,2,21800625,1/11/2019,1610612739,Cleveland Cavaliers,0,0,1610612745,Houston Rockets,1,1,31,25,56,9,24,33,40,49,89,24,2,26,8,41,24,8,13,105,113
2018,2,21800625,1/11/2019,1610612745,Houston Rockets,1,1,1610612739,Cleveland Cavaliers,0,0,26,11,37,20,32,52,46,43,89,29,3,32,10,36,28,12,15,106,141
2018,2,21800400,12/10/2018,1610612744,Golden State Warriors,1,1,1610612750,Minnesota Timberwolves,0,0,20,30,50,19,24,43,39,54,93,19,2,21,21,33,25,5,17,104,116
2018,2,21800400,12/10/2018,1610612750,Minnesota Timberwolves,0,0,1610612744,Golden State Warriors,1,1,31,27,58,7,18,25,38,45,83,25,6,31,13,35,28,6,16,103,108
2018,2,21800120,11/2/2018,1610612741,Chicago Bulls,1,0,1610612754,Indiana Pacers,0,1,29,29,58,13,18,31,42,47,89,8,1,9,14,34,33,8,14,94,105
2018,2,21800120,11/2/2018,1610612754,Indiana Pacers,0,1,1610612741,Chicago Bulls,1,0,33,26,59,7,19,26,40,45,85,20,2,22,13,34,21,2,11,92,107
2017,2,21701200,4/8/2018,1610612753,Orlando Magic,0,0,1610612761,Toronto Raptors,1,1,35,31,66,7,16,23,42,47,89,10,7,17,10,41,25,8,11,98,101
2017,2,21701200,4/8/2018,1610612761,Toronto Raptors,1,1,1610612753,Orlando Magic,0,0,22,16,38,17,23,40,39,39,78,17,7,24,8,36,28,12,17,96,112
2017,2,21701156,4/3/2018,1610612739,Cleveland Cavaliers,1,1,1610612761,Toronto Raptors,0,0,25,22,47,13,17,30,38,39,77,23,3,26,3,38,18,7,12,97,112
2017,2,21701156,4/3/2018,1610612761,Toronto Raptors,0,0,1610612739,Cleveland Cavaliers,1,1,31,29,60,11,23,34,42,52,94,11,3,14,13,42,28,8,11,97,106
2017,2,21701117,3/28/2018,1610612751,Brooklyn Nets,0,1,1610612753,Orlando Magic,1,0,28,25,53,12,22,34,40,47,87,19,3,22,13,35,28,4,9,93,111
2017,2,21701117,3/28/2018,1610612753,Orlando Magic,1,0,1610612751,Brooklyn Nets,0,1,29,32,61,11,20,31,40,52,92,13,3,16,16,38,25,6,10,93,104
2019,2,21900051,10/28/2019,1610612746,LA Clippers,1,1,1610612766,Charlotte Hornets,0,0,28,22,50,12,21,33,40,43,83,19,2,21,13,31,23,5,22,100,111
2019,2,21900051,10/28/2019,1610612766,Charlotte Hornets,0,0,1610612746,LA Clippers,1,1,22,22,44,14,25,39,36,47,83,10,4,14,12,36,24,11,22,100,96
2021,2,22100212,11/16/2021,1610612746,LA Clippers,1,1,1610612759,San Antonio Spurs,0,0,25,22,47,12,26,38,37,48,85,20,2,22,11,38,16,10,21,106,106
2021,2,22100212,11/16/2021,1610612759,San Antonio Spurs,0,0,1610612746,LA Clippers,1,1,36,37,73,5,17,22,41,54,95,5,2,7,8,47,26,9,16,107,92
2016,2,21600587,1/12/2017,1610612741,Chicago Bulls,0,0,1610612752,New York Knicks,1,1,32,39,71,3,15,18,35,54,89,16,5,21,21,35,20,3,13,90,89
2016,2,21600587,1/12/2017,1610612752,New York Knicks,1,1,1610612741,Chicago Bulls,0,0,37,32,69,7,16,23,44,48,92,9,2,11,19,30,21,5,12,89,104
2014,2,21401227,4/15/2015,1610612748,Miami Heat,0,1,1610612755,Philadelphia 76ers,1,0,27,31,58,12,19,31,39,50,89,15,5,20,15,37,22,7,16,99,105
2014,2,21401227,4/15/2015,1610612755,Philadelphia 76ers,1,0,1610612748,Miami Heat,0,1,33,21,54,5,24,29,38,45,83,20,5,25,15,33,26,10,18,98,101
2018,2,21801019,3/13/2019,1610612756,Phoenix Suns,1,0,1610612762,Utah Jazz,0,1,29,34,63,7,12,19,36,46,82,18,5,23,6,43,21,8,12,99,97
2018,2,21801019,3/13/2019,1610612762,Utah Jazz,0,1,1610612756,Phoenix Suns,1,0,30,27,57,12,21,33,42,48,90,18,7,25,17,34,30,8,12,98,114
2018,2,21800544,12/31/2018,1610612745,Houston Rockets,1,1,1610612763,Memphis Grizzlies,0,0,13,16,29,18,23,41,31,39,70,33,12,45,10,34,19,11,14,96,113
2018,2,21800544,12/31/2018,1610612763,Memphis Grizzlies,0,0,1610612745,Houston Rockets,1,1,32,25,57,6,19,25,38,44,82,19,11,30,9,42,24,5,10,95,101
2018,2,21800336,12/1/2018,1610612754,Indiana Pacers,0,0,1610612758,Sacramento Kings,1,1,33,25,58,10,14,24,43,39,82,14,4,18,9,33,32,10,25,106,110
2018,2,21800336,12/1/2018,1610612758,Sacramento Kings,1,1,1610612754,Indiana Pacers,0,0,28,34,62,13,16,29,41,50,91,16,8,24,17,36,25,11,20,106,111
2018,2,21800278,11/23/2018,1610612747,Los Angeles Lakers,1,1,1610612762,Utah Jazz,0,0,29,27,56,7,16,23,36,43,79,11,7,18,9,37,10,12,24,102,90
2018,2,21800278,11/23/2018,1610612762,Utah Jazz,0,0,1610612747,Los Angeles Lakers,1,1,29,33,62,4,19,23,33,52,85,13,4,17,10,44,22,11,19,102,83
2018,2,21800172,11/9/2018,1610612738,Boston Celtics,0,0,1610612762,Utah Jazz,1,1,22,23,45,17,26,43,39,49,88,20,2,22,10,40,31,4,8,97,115
2018,2,21800172,11/9/2018,1610612762,Utah Jazz,1,1,1610612738,Boston Celtics,0,0,30,13,43,13,21,34,43,34,77,24,6,30,12,24,29,11,17,97,123
2018,2,21800119,11/2/2018,1610612760,Oklahoma City Thunder,0,1,1610612764,Washington Wizards,1,0,34,20,54,15,17,32,49,37,86,21,5,26,8,29,34,6,13,103,134
2018,2,21800119,11/2/2018,1610612764,Washington Wizards,1,0,1610612760,Oklahoma City Thunder,0,1,35,21,56,9,21,30,44,42,86,14,4,18,10,33,27,13,19,103,111
2020,2,22000912,4/25/2021,1610612751,Brooklyn Nets,1,1,1610612756,Phoenix Suns,0,0,33,26,59,13,15,28,46,41,87,23,4,27,14,28,30,5,11,96,128
2020,2,22000912,4/25/2021,1610612756,Phoenix Suns,0,0,1610612751,Brooklyn Nets,1,1,31,25,56,12,22,34,43,47,90,21,4,25,17,33,22,6,12,96,119
2022,2,22200473,12/21/2022,1610612742,Dallas Mavericks,0,1,1610612750,Minnesota Timberwolves,1,0,21,15,36,13,26,39,34,41,75,23,4,27,10,32,17,7,13,91,104
2022,2,22200473,12/21/2022,1610612750,Minnesota Timberwolves,1,0,1610612742,Dallas Mavericks,0,1,34,21,55,8,22,30,42,43,85,7,3,10,11,35,23,6,13,91,99
2017,2,21701176,4/5/2018,1610612739,Cleveland Cavaliers,1,1,1610612764,Washington Wizards,0,0,29,21,50,13,14,27,42,35,77,22,6,28,6,30,26,8,16,100,119
2017,2,21701176,4/5/2018,1610612764,Washington Wizards,0,0,1610612739,Cleveland Cavaliers,1,1,38,35,73,9,12,21,47,47,94,12,2,14,16,32,34,10,15,102,115
2017,2,21701157,4/3/2018,1610612751,Brooklyn Nets,0,0,1610612755,Philadelphia 76ers,1,1,17,22,39,17,25,42,34,47,81,10,13,23,8,48,20,10,18,101,95
2017,2,21701157,4/3/2018,1610612755,Philadelphia 76ers,1,1,1610612751,Brooklyn Nets,0,0,41,29,70,9,12,21,50,41,91,12,6,18,8,35,28,5,10,100,121
2016,2,21600134,11/12/2016,1610612745,Houston Rockets,1,0,1610612759,San Antonio Spurs,0,1,19,23,42,15,32,47,34,55,89,17,4,21,20,37,22,6,14,93,100
2016,2,21600134,11/12/2016,1610612759,San Antonio Spurs,0,1,1610612745,Houston Rockets,1,0,36,22,58,5,13,18,41,35,76,19,5,24,8,30,21,6,12,92,106
2019,2,21900277,11/29/2019,1610612742,Dallas Mavericks,0,1,1610612756,Phoenix Suns,1,0,18,20,38,17,30,47,35,50,85,33,5,38,13,38,20,3,8,100,120
2019,2,21900277,11/29/2019,1610612756,Phoenix Suns,1,0,1610612742,Dallas Mavericks,0,1,28,27,55,13,25,38,41,52,93,18,7,25,14,42,29,7,10,101,113
2018,2,21801166,4/3/2019,1610612752,New York Knicks,0,0,1610612753,Orlando Magic,1,1,32,26,58,6,21,27,38,47,85,18,3,21,8,41,21,5,12,98,100
2018,2,21801166,4/3/2019,1610612753,Orlando Magic,1,1,1610612752,New York Knicks,0,0,34,33,67,11,21,32,45,54,99,13,7,20,24,32,29,10,14,98,114
2018,2,21801020,3/14/2019,1610612754,Indiana Pacers,1,1,1610612760,Oklahoma City Thunder,0,0,30,30,60,7,15,22,37,45,82,27,5,32,10,37,24,11,16,102,108
2018,2,21801020,3/14/2019,1610612760,Oklahoma City Thunder,0,0,1610612754,Indiana Pacers,1,1,24,32,56,14,16,30,38,48,86,16,4,20,13,36,24,11,18,103,106
2018,2,21800884,2/23/2019,1610612751,Brooklyn Nets,0,1,1610612766,Charlotte Hornets,1,0,23,21,44,17,26,43,40,47,87,20,6,26,14,35,23,4,13,99,117
2018,2,21800884,2/23/2019,1610612766,Charlotte Hornets,1,0,1610612751,Brooklyn Nets,0,1,27,24,51,12,23,35,39,47,86,25,5,30,15,33,15,5,12,99,115
2018,2,21800121,11/2/2018,1610612742,Dallas Mavericks,1,0,1610612752,New York Knicks,0,1,29,23,52,11,18,29,40,41,81,15,9,24,16,31,22,13,19,94,106
2018,2,21800121,11/2/2018,1610612752,New York Knicks,0,1,1610612742,Dallas Mavericks,1,0,39,16,55,7,22,29,46,38,84,19,7,26,13,30,26,6,12,94,118
2017,2,21701177,4/5/2018,1610612745,Houston Rockets,1,1,1610612757,Portland Trail Blazers,0,0,21,15,36,13,24,37,34,39,73,15,9,24,7,36,16,10,17,93,96
2017,2,21701177,4/5/2018,1610612757,Portland Trail Blazers,0,0,1610612745,Houston Rockets,1,1,32,31,63,7,15,22,39,46,85,9,5,14,15,33,16,10,18,94,94
2017,2,21701134,3/30/2018,1610612742,Dallas Mavericks,1,0,1610612750,Minnesota Timberwolves,0,1,27,31,58,11,17,28,38,48,86,5,2,7,8,41,22,10,14,95,92
2017,2,21701134,3/30/2018,1610612750,Minnesota Timberwolves,0,1,1610612742,Dallas Mavericks,1,0,27,31,58,8,17,25,35,48,83,15,2,17,6,44,14,5,10,96,93
2017,2,21701100,3/25/2018,1610612757,Portland Trail Blazers,0,1,1610612760,Oklahoma City Thunder,1,0,33,23,56,9,25,34,42,48,90,15,4,19,19,31,20,9,14,94,108
2016,2,21601144,4/2/2017,1610612742,Dallas Mavericks,0,1,1610612749,Milwaukee Bucks,1,0,24,13,37,14,22,36,38,35,73,19,1,20,6,30,25,9,14,92,109
2016,2,21601144,4/2/2017,1610612749,Milwaukee Bucks,1,0,1610612742,Dallas Mavericks,0,1,27,16,43,12,22,34,39,38,77,15,3,18,10,29,25,7,15,93,105
2016,2,21600586,1/12/2017,1610612740,New Orleans Pelicans,0,1,1610612751,Brooklyn Nets,1,0,27,31,58,11,21,32,38,52,90,17,8,25,13,44,16,10,17,105,104
2016,2,21600586,1/12/2017,1610612751,Brooklyn Nets,1,0,1610612740,New Orleans Pelicans,0,1,31,24,55,9,33,42,40,57,97,6,5,11,13,45,22,12,16,106,95
2015,2,21501127,3/31/2016,1610612757,Portland Trail Blazers,1,1,1610612738,Boston Celtics,0,0,27,29,56,14,20,34,41,49,90,20,7,27,18,34,26,12,16,102,116
2021,2,22100211,11/16/2021,1610612755,Philadelphia 76ers,0,0,1610612762,Utah Jazz,1,1,27,34,61,6,23,29,33,57,90,13,4,17,8,51,19,5,9,99,85
2021,2,22100211,11/16/2021,1610612762,Utah Jazz,1,1,1610612755,Philadelphia 76ers,0,0,30,21,51,16,22,38,46,43,89,12,7,19,10,38,27,5,11,99,120
2014,2,21400798,2/11/2015,1610612747,Los Angeles Lakers,0,0,1610612757,Portland Trail Blazers,1,1,27,50,77,7,9,16,34,59,93,11,0,11,18,40,17,5,10,91,86
2014,2,21400798,2/11/2015,1610612757,Portland Trail Blazers,1,1,1610612747,Los Angeles Lakers,0,0,25,31,56,10,20,30,35,51,86,22,1,23,17,35,27,4,10,92,102
2019,2,21901291,8/9/2020,1610612746,LA Clippers,1,0,1610612751,Brooklyn Nets,0,1,32,25,57,13,23,36,45,48,93,17,3,20,11,39,23,5,10,98,120
2019,2,21901291,8/9/2020,1610612751,Brooklyn Nets,0,1,1610612746,LA Clippers,1,0,27,15,42,20,23,43,47,38,85,15,4,19,11,30,32,8,16,98,129
2019,2,21901266,8/5/2020,1610612753,Orlando Magic,1,0,1610612761,Toronto Raptors,0,1,24,22,46,11,30,41,35,52,87,18,8,26,9,45,26,6,13,102,99
2018,2,21800784,2/2/2019,1610612737,Atlanta Hawks,0,1,1610612756,Phoenix Suns,1,0,29,23,52,14,18,32,43,41,84,18,8,26,21,27,21,15,24,99,118
2018,2,21800784,2/2/2019,1610612756,Phoenix Suns,1,0,1610612737,Atlanta Hawks,0,1,33,31,64,12,20,32,45,51,96,10,8,18,15,40,31,6,10,99,112
2018,2,21800470,12/21/2018,1610612739,Cleveland Cavaliers,0,0,1610612761,Toronto Raptors,1,1,30,28,58,9,15,24,39,43,82,23,7,30,13,35,20,9,11,95,110
2018,2,21800470,12/21/2018,1610612761,Toronto Raptors,1,1,1610612739,Cleveland Cavaliers,0,0,39,21,60,9,22,31,48,43,91,21,5,26,17,29,21,5,9,94,126
2018,2,21800399,12/10/2018,1610612746,LA Clippers,0,1,1610612756,Phoenix Suns,1,0,38,26,64,7,14,21,45,40,85,26,7,33,13,30,27,14,18,105,123
2018,2,21800399,12/10/2018,1610612756,Phoenix Suns,1,0,1610612746,LA Clippers,0,1,38,31,69,9,16,25,47,47,94,16,4,20,12,36,31,8,15,105,119
2020,2,22000911,4/25/2021,1610612738,Boston Celtics,0,0,1610612766,Charlotte Hornets,1,1,20,27,47,14,27,41,34,54,88,22,4,26,16,40,18,7,13,98,104
2020,2,22000911,4/25/2021,1610612766,Charlotte Hornets,1,1,1610612738,Boston Celtics,0,0,26,24,50,21,22,43,47,46,93,10,1,11,12,35,39,6,11,98,125
2022,2,22200470,12/21/2022,1610612744,Golden State Warriors,0,0,1610612751,Brooklyn Nets,1,1,29,21,50,12,21,33,41,42,83,19,6,25,12,33,32,10,21,103,113
2022,2,22200470,12/21/2022,1610612751,Brooklyn Nets,1,1,1610612744,Golden State Warriors,0,0,33,18,51,21,12,33,54,30,84,14,2,16,4,27,42,6,15,102,143
2017,2,21701135,3/30/2018,1610612762,Utah Jazz,1,1,1610612763,Memphis Grizzlies,0,0,28,15,43,12,19,31,40,34,74,15,11,26,11,28,24,8,17,92,107
2017,2,21701135,3/30/2018,1610612763,Memphis Grizzlies,0,0,1610612762,Utah Jazz,1,1,30,28,58,9,14,23,39,42,81,10,5,15,12,32,24,7,15,93,97
2017,2,21701116,3/28/2018,1610612739,Cleveland Cavaliers,0,1,1610612766,Charlotte Hornets,1,0,34,31,65,11,17,28,45,48,93,17,3,20,14,36,22,2,6,93,118
2017,2,21701116,3/28/2018,1610612766,Charlotte Hornets,1,0,1610612739,Cleveland Cavaliers,0,1,34,21,55,5,16,21,39,37,76,22,2,24,8,30,20,9,13,92,105
2017,2,21701100,3/25/2018,1610612760,Oklahoma City Thunder,1,0,1610612757,Portland Trail Blazers,0,1,29,28,57,8,19,27,37,47,84,23,5,28,17,34,16,8,11,94,105
2017,2,21701073,3/22/2018,1610612755,Philadelphia 76ers,0,1,1610612753,Orlando Magic,1,0,27,25,52,15,22,37,42,47,89,19,5,24,15,36,30,10,18,104,118
2017,2,21701052,3/19/2018,1610612766,Charlotte Hornets,0,0,1610612755,Philadelphia 76ers,1,1,26,36,62,6,16,22,32,52,84,24,6,30,10,44,16,5,9,97,94
2014,2,21401226,4/15/2015,1610612752,New York Knicks,1,0,1610612765,Detroit Pistons,0,1,26,32,58,7,12,19,33,44,77,17,10,27,15,34,19,14,21,95,90
2014,2,21401226,4/15/2015,1610612765,Detroit Pistons,0,1,1610612752,New York Knicks,1,0,31,24,55,10,16,26,41,40,81,20,7,27,13,32,20,6,13,95,112
2019,2,21900050,10/28/2019,1610612743,Denver Nuggets,0,1,1610612758,Sacramento Kings,1,0,26,36,62,10,26,36,36,62,98,19,2,21,29,34,19,6,12,93,101
2019,2,21900050,10/28/2019,1610612758,Sacramento Kings,1,0,1610612743,Denver Nuggets,0,1,24,30,54,12,25,37,36,55,91,10,6,16,20,40,25,8,13,92,94
2018,2,21800697,1/21/2019,1610612740,New Orleans Pelicans,0,1,1610612763,Memphis Grizzlies,1,0,30,18,48,9,17,26,39,35,74,18,8,26,12,26,19,10,19,93,105
2018,2,21800697,1/21/2019,1610612763,Memphis Grizzlies,1,0,1610612740,New Orleans Pelicans,0,1,24,29,53,9,26,35,33,55,88,10,7,17,12,44,21,8,12,95,85
2018,2,21800622,1/11/2019,1610612749,Milwaukee Bucks,0,0,1610612764,Washington Wizards,1,1,27,22,49,13,27,40,40,49,89,13,4,17,13,38,26,10,15,99,106
2018,2,21800622,1/11/2019,1610612764,Washington Wizards,1,1,1610612749,Milwaukee Bucks,0,0,22,27,49,18,15,33,40,42,82,15,5,20,10,35,28,8,17,99,113
2018,2,21800398,12/10/2018,1610612743,Denver Nuggets,1,1,1610612763,Memphis Grizzlies,0,0,30,19,49,9,19,28,39,38,77,18,5,23,13,28,22,7,14,89,105
2018,2,21800398,12/10/2018,1610612763,Memphis Grizzlies,0,0,1610612743,Denver Nuggets,1,1,28,19,47,9,18,27,37,37,74,16,1,17,8,30,22,11,14,88,99
2018,2,21800335,12/1/2018,1610612738,Boston Celtics,0,1,1610612750,Minnesota Timberwolves,1,0,23,18,41,17,27,44,40,45,85,21,0,21,11,34,30,6,14,99,118
2018,2,21800335,12/1/2018,1610612750,Minnesota Timberwolves,1,0,1610612738,Boston Celtics,0,1,28,26,54,9,19,28,37,45,82,26,6,32,13,37,19,9,16,100,109
2018,2,21800171,11/9/2018,1610612743,Denver Nuggets,1,0,1610612751,Brooklyn Nets,0,1,35,34,69,5,13,18,40,47,87,25,9,34,19,33,20,7,13,101,110
2018,2,21800171,11/9/2018,1610612751,Brooklyn Nets,0,1,1610612743,Denver Nuggets,1,0,24,31,55,12,21,33,36,52,88,28,14,42,15,42,21,3,8,100,112
2017,2,21701220,4/11/2018,1610612739,Cleveland Cavaliers,1,0,1610612752,New York Knicks,0,1,31,39,70,6,18,24,37,57,94,18,10,28,26,36,15,10,16,96,98
2017,2,21701220,4/11/2018,1610612752,New York Knicks,0,1,1610612739,Cleveland Cavaliers,1,0,31,27,58,12,15,27,43,42,85,12,1,13,11,31,30,9,15,96,110
2016,2,21601143,4/2/2017,1610612747,Los Angeles Lakers,1,1,1610612763,Memphis Grizzlies,0,0,33,33,66,7,12,19,40,45,85,21,6,27,19,29,14,8,14,93,108
2016,2,21601143,4/2/2017,1610612763,Memphis Grizzlies,0,0,1610612747,Los Angeles Lakers,1,1,27,23,50,13,17,30,40,40,80,10,4,14,8,35,29,11,14,94,103
2016,2,21600585,1/11/2017,1610612739,Cleveland Cavaliers,0,0,1610612757,Portland Trail Blazers,1,1,19,33,52,9,21,30,28,54,82,21,7,28,17,41,14,6,16,94,86
2016,2,21600585,1/11/2017,1610612757,Portland Trail Blazers,1,1,1610612739,Cleveland Cavaliers,0,0,30,33,63,10,20,30,40,53,93,12,4,16,18,37,29,5,12,95,102
2015,2,21501205,4/11/2016,1610612738,Boston Celtics,1,0,1610612766,Charlotte Hornets,0,1,26,39,65,8,16,24,34,55,89,24,5,29,17,42,17,10,12,98,100
2015,2,21501205,4/11/2016,1610612766,Charlotte Hornets,0,1,1610612738,Boston Celtics,1,0,27,22,49,14,18,32,41,40,81,18,4,22,8,34,23,6,14,97,114
2021,2,22100210,11/16/2021,1610612744,Golden State Warriors,0,1,1610612751,Brooklyn Nets,1,0,28,11,39,13,27,40,41,38,79,22,6,28,10,30,25,12,22,104,117
2021,2,22100210,11/16/2021,1610612751,Brooklyn Nets,1,0,1610612744,Golden State Warriors,0,1,24,28,52,10,26,36,34,54,88,21,6,27,10,47,21,4,12,102,99
2019,2,21900276,11/29/2019,1610612746,LA Clippers,0,0,1610612759,San Antonio Spurs,1,1,24,35,59,12,21,33,36,56,92,13,0,13,13,43,23,8,15,101,97
2019,2,21900276,11/29/2019,1610612759,San Antonio Spurs,1,1,1610612746,LA Clippers,0,0,26,31,57,14,22,36,40,53,93,13,1,14,10,43,28,6,11,101,107
2014,2,21400797,2/11/2015,1610612742,Dallas Mavericks,1,1,1610612762,Utah Jazz,0,0,18,29,47,10,18,28,28,47,75,21,5,26,11,39,18,9,11,87,87
2014,2,21400797,2/11/2015,1610612762,Utah Jazz,0,0,1610612742,Dallas Mavericks,1,1,19,32,51,11,18,29,30,50,80,11,10,21,23,32,19,11,19,87,82
2018,2,21801165,4/3/2019,1610612754,Indiana Pacers,0,1,1610612765,Detroit Pistons,1,0,37,34,71,6,15,21,43,49,92,16,6,22,16,36,31,6,11,96,108
2018,2,21801165,4/3/2019,1610612765,Detroit Pistons,1,0,1610612754,Indiana Pacers,0,1,20,19,39,11,30,41,31,49,80,16,8,24,16,37,21,9,20,96,89
2018,2,21801017,3/13/2019,1610612751,Brooklyn Nets,0,0,1610612760,Oklahoma City Thunder,1,1,22,27,49,13,22,35,35,49,84,13,6,19,12,39,19,9,17,99,96
2018,2,21801017,3/13/2019,1610612760,Oklahoma City Thunder,1,1,1610612751,Brooklyn Nets,0,0,30,38,68,11,17,28,41,55,96,15,4,19,18,38,21,7,12,99,108
2020,2,22000910,4/24/2021,1610612743,Denver Nuggets,1,1,1610612745,Houston Rockets,0,0,34,13,47,16,21,37,50,34,84,13,3,16,4,31,36,10,15,104,129
2020,2,22000910,4/24/2021,1610612745,Houston Rockets,0,0,1610612743,Denver Nuggets,1,1,26,16,42,15,25,40,41,41,82,19,9,28,8,38,27,8,16,103,116
2018,2,21800277,11/23/2018,1610612744,Golden State Warriors,1,1,1610612757,Portland Trail Blazers,0,0,31,22,53,17,15,32,48,37,85,12,4,16,10,30,29,9,15,98,125
2018,2,21800277,11/23/2018,1610612757,Portland Trail Blazers,0,0,1610612744,Golden State Warriors,1,1,29,40,69,9,15,24,38,55,93,12,10,22,17,43,22,11,13,98,97
2018,2,21800225,11/17/2018,1610612755,Philadelphia 76ers,0,1,1610612766,Charlotte Hornets,1,0,28,30,58,11,24,35,39,54,93,33,5,38,12,43,23,10,19,118,122
2018,2,21800225,11/17/2018,1610612766,Charlotte Hornets,1,0,1610612755,Philadelphia 76ers,0,1,32,36,68,10,21,31,42,57,99,25,2,27,12,46,23,9,17,118,119
2016,2,21600133,11/12/2016,1610612741,Chicago Bulls,1,1,1610612764,Washington Wizards,0,0,34,48,82,5,10,15,39,58,97,23,2,25,21,39,21,3,10,95,106
2016,2,21600133,11/12/2016,1610612764,Washington Wizards,0,0,1610612741,Chicago Bulls,1,1,34,44,78,4,9,13,38,53,91,15,3,18,16,39,19,7,12,95,95
2018,2,21801164,4/2/2019,1610612743,Denver Nuggets,0,0,1610612744,Golden State Warriors,1,1,29,37,66,7,23,30,36,60,96,23,6,29,19,45,23,11,16,105,102
2018,2,21801164,4/2/2019,1610612744,Golden State Warriors,1,1,1610612743,Denver Nuggets,0,0,37,21,58,13,21,34,50,42,92,3,5,8,15,30,36,19,24,104,116
2018,2,21801016,3/13/2019,1610612737,Atlanta Hawks,1,1,1610612763,Memphis Grizzlies,0,0,35,23,58,17,28,45,52,51,103,11,3,14,22,31,35,8,12,101,132
2018,2,21801016,3/13/2019,1610612763,Memphis Grizzlies,0,0,1610612737,Atlanta Hawks,1,1,24,25,49,14,26,40,38,51,89,21,5,26,14,38,28,9,14,100,111
2018,2,21800883,2/23/2019,1610612737,Atlanta Hawks,1,1,1610612756,Phoenix Suns,0,0,26,33,59,12,21,33,38,54,92,32,6,38,19,38,22,9,14,103,120
2018,2,21800883,2/23/2019,1610612756,Phoenix Suns,0,0,1610612737,Atlanta Hawks,1,1,28,28,56,13,24,37,41,52,93,17,3,20,11,42,25,8,12,103,112
2018,2,21800783,2/2/2019,1610612743,Denver Nuggets,0,1,1610612750,Minnesota Timberwolves,1,0,29,27,56,13,20,33,42,47,89,10,4,14,16,33,29,6,10,91,107
2018,2,21800783,2/2/2019,1610612750,Minnesota Timberwolves,1,0,1610612743,Denver Nuggets,0,1,31,24,55,11,23,34,42,47,89,11,5,16,16,33,27,3,10,92,106
2018,2,21800621,1/11/2019,1610612737,Atlanta Hawks,0,1,1610612755,Philadelphia 76ers,1,0,33,23,56,12,13,25,45,36,81,21,6,27,17,20,27,13,21,97,123
2018,2,21800621,1/11/2019,1610612755,Philadelphia 76ers,1,0,1610612737,Atlanta Hawks,0,1,34,20,54,11,22,33,45,42,87,20,7,27,17,30,31,7,15,97,121
2018,2,21800542,12/31/2018,1610612737,Atlanta Hawks,0,0,1610612754,Indiana Pacers,1,1,28,35,63,13,19,32,41,54,95,13,6,19,24,34,24,13,17,96,108
2018,2,21800542,12/31/2018,1610612754,Indiana Pacers,1,1,1610612737,Atlanta Hawks,0,0,31,29,60,11,13,24,42,42,84,21,8,29,11,35,29,8,11,97,116
2018,2,21800469,12/21/2018,1610612765,Detroit Pistons,0,0,1610612766,Charlotte Hornets,1,1,24,24,48,8,26,34,32,50,82,14,8,22,15,39,21,7,16,92,86
2018,2,21800469,12/21/2018,1610612766,Charlotte Hornets,1,1,1610612765,Detroit Pistons,0,0,21,30,51,12,12,24,33,42,75,20,8,28,14,29,19,8,18,91,98
2016,2,21600584,1/11/2017,1610612746,LA Clippers,1,1,1610612753,Orlando Magic,0,0,30,20,50,9,17,26,39,37,76,18,8,26,11,31,23,8,21,98,105
2016,2,21600584,1/11/2017,1610612753,Orlando Magic,0,0,1610612746,LA Clippers,1,1,33,32,65,6,21,27,39,53,92,12,6,18,14,41,21,11,13,100,96
2014,2,21401224,4/15/2015,1610612751,Brooklyn Nets,1,1,1610612753,Orlando Magic,0,0,30,26,56,9,15,24,39,41,80,14,9,23,13,34,25,6,13,92,101
2014,2,21401224,4/15/2015,1610612753,Orlando Magic,0,0,1610612751,Brooklyn Nets,1,1,31,28,59,7,13,20,38,41,79,5,8,13,11,34,18,8,17,91,88
2019,2,21900275,11/29/2019,1610612740,New Orleans Pelicans,0,0,1610612760,Oklahoma City Thunder,1,1,28,21,49,11,27,38,39,48,87,15,6,21,9,40,19,6,14,103,104
2019,2,21900275,11/29/2019,1610612760,Oklahoma City Thunder,1,1,1610612740,New Orleans Pelicans,0,0,30,26,56,13,21,34,43,47,90,10,6,16,7,42,27,8,11,103,109
2019,2,21900049,10/28/2019,1610612756,Phoenix Suns,1,0,1610612762,Utah Jazz,0,1,20,26,46,13,21,34,33,47,80,16,7,23,4,47,23,8,16,102,95
2019,2,21900049,10/28/2019,1610612762,Utah Jazz,0,1,1610612756,Phoenix Suns,1,0,17,23,40,10,21,31,27,44,71,32,7,39,11,37,19,7,23,102,96
2018,2,21800696,1/21/2019,1610612751,Brooklyn Nets,1,1,1610612758,Sacramento Kings,0,0,32,23,55,13,22,35,45,45,90,20,4,24,17,29,25,8,17,101,123
2018,2,21800696,1/21/2019,1610612758,Sacramento Kings,0,0,1610612751,Brooklyn Nets,1,1,29,39,68,10,15,25,39,54,93,6,5,11,12,45,26,9,14,100,94
2018,2,21800543,12/31/2018,1610612753,Orlando Magic,0,0,1610612766,Charlotte Hornets,1,1,28,29,57,10,25,35,38,54,92,14,5,19,14,41,22,8,12,99,100
2018,2,21800543,12/31/2018,1610612766,Charlotte Hornets,1,1,1610612753,Orlando Magic,0,0,31,30,61,11,13,24,42,43,85,30,3,33,8,37,29,6,8,99,125
2018,2,21800224,11/17/2018,1610612746,LA Clippers,0,1,1610612751,Brooklyn Nets,1,0,37,35,72,11,12,23,48,47,95,20,4,24,16,35,23,4,8,98,127
2018,2,21800224,11/17/2018,1610612751,Brooklyn Nets,1,0,1610612746,LA Clippers,0,1,27,33,60,13,15,28,40,48,88,26,8,34,18,33,25,4,11,98,119
2017,2,21701219,4/11/2018,1610612738,Boston Celtics,1,1,1610612751,Brooklyn Nets,0,0,40,38,78,6,18,24,46,56,102,12,3,15,23,35,22,10,14,100,110
2017,2,21701219,4/11/2018,1610612751,Brooklyn Nets,0,0,1610612738,Boston Celtics,1,1,26,25,51,11,29,40,37,54,91,12,4,16,13,44,27,6,16,101,97
2017,2,21701136,3/30/2018,1610612747,Los Angeles Lakers,1,0,1610612749,Milwaukee Bucks,0,1,40,27,67,8,19,27,48,46,94,18,7,25,16,35,33,14,19,108,122
2021,2,22100209,11/15/2021,1610612741,Chicago Bulls,0,1,1610612747,Los Angeles Lakers,1,0,34,21,55,15,19,34,49,40,89,8,3,11,5,37,31,10,17,103,121
2021,2,22100209,11/15/2021,1610612747,Los Angeles Lakers,1,0,1610612741,Chicago Bulls,0,1,30,17,47,6,26,32,36,43,79,25,6,31,10,34,19,9,19,103,103
2016,2,21601142,4/2/2017,1610612760,Oklahoma City Thunder,1,0,1610612766,Charlotte Hornets,0,1,27,26,53,12,19,31,39,45,84,11,1,12,11,35,19,18,24,102,101
2016,2,21601142,4/2/2017,1610612766,Charlotte Hornets,0,1,1610612760,Oklahoma City Thunder,1,0,26,21,47,11,19,30,37,40,77,28,4,32,6,36,20,10,18,103,113
2014,2,21401225,4/15/2015,1610612739,Cleveland Cavaliers,1,1,1610612764,Washington Wizards,0,0,27,34,61,16,14,30,43,48,91,11,6,17,13,39,29,8,16,103,113
2014,2,21401225,4/15/2015,1610612764,Washington Wizards,0,0,1610612739,Cleveland Cavaliers,1,1,34,41,75,8,14,22,42,55,97,16,5,21,20,37,26,7,14,102,108
2014,2,21400796,2/11/2015,1610612739,Cleveland Cavaliers,1,1,1610612748,Miami Heat,0,0,34,19,53,10,15,25,44,34,78,15,4,19,12,24,32,10,16,89,113
2014,2,21400796,2/11/2015,1610612748,Miami Heat,0,0,1610612739,Cleveland Cavaliers,1,1,25,35,60,9,15,24,34,50,84,16,4,20,17,36,21,9,15,91,93
2018,2,21800882,2/23/2019,1610612755,Philadelphia 76ers,1,0,1610612757,Portland Trail Blazers,0,1,33,30,63,9,15,24,42,45,87,22,6,28,9,37,28,8,11,102,115
2018,2,21800882,2/23/2019,1610612757,Portland Trail Blazers,0,1,1610612755,Philadelphia 76ers,1,0,44,32,76,5,18,23,49,50,99,27,2,29,23,28,29,5,11,101,130
2018,2,21800782,2/2/2019,1610612744,Golden State Warriors,1,1,1610612747,Los Angeles Lakers,0,0,32,25,57,11,23,34,43,48,91,18,1,19,11,37,31,5,10,100,115
2018,2,21800782,2/2/2019,1610612747,Los Angeles Lakers,0,0,1610612744,Golden State Warriors,1,1,35,34,69,7,20,27,42,54,96,10,7,17,19,40,23,4,15,100,101
2018,2,21800623,1/11/2019,1610612752,New York Knicks,1,0,1610612754,Indiana Pacers,0,1,25,24,49,14,25,39,39,49,88,14,2,16,12,37,22,8,17,100,106
2018,2,21800623,1/11/2019,1610612754,Indiana Pacers,0,1,1610612752,New York Knicks,1,0,37,31,68,12,14,26,49,45,94,11,0,11,13,32,30,8,14,101,121
2018,2,21800468,12/20/2018,1610612742,Dallas Mavericks,0,0,1610612746,LA Clippers,1,1,33,31,64,10,18,28,43,49,92,25,8,33,21,32,24,5,12,98,121
2018,2,21800468,12/20/2018,1610612746,LA Clippers,1,1,1610612742,Dallas Mavericks,0,0,41,22,63,6,14,20,47,36,83,25,6,31,12,29,26,8,12,96,125
2016,2,21601141,4/1/2017,1610612756,Phoenix Suns,0,0,1610612757,Portland Trail Blazers,1,1,41,26,67,3,7,10,44,33,77,26,6,32,14,30,17,12,17,100,117
2016,2,21601141,4/1/2017,1610612757,Portland Trail Blazers,1,1,1610612756,Phoenix Suns,0,0,28,25,53,15,22,37,43,47,90,29,2,31,17,33,21,8,12,101,130
2019,2,21900274,11/29/2019,1610612762,Utah Jazz,0,1,1610612763,Memphis Grizzlies,1,0,26,34,60,12,23,35,38,57,95,15,4,19,14,43,18,1,7,96,103
2019,2,21900274,11/29/2019,1610612763,Memphis Grizzlies,1,0,1610612762,Utah Jazz,0,1,27,33,60,10,24,34,37,57,94,10,7,17,18,43,22,8,12,98,94
2016,2,21600583,1/11/2017,1610612738,Boston Celtics,1,1,1610612764,Washington Wizards,0,0,26,18,44,17,24,41,43,42,85,14,4,18,13,30,20,10,14,95,117
2016,2,21600583,1/11/2017,1610612764,Washington Wizards,0,0,1610612738,Boston Celtics,1,1,35,44,79,10,16,26,45,60,105,8,4,12,25,37,28,5,8,96,108
2018,2,21801163,4/2/2019,1610612745,Houston Rockets,0,1,1610612758,Sacramento Kings,1,0,20,13,33,26,35,61,46,48,94,12,5,17,10,40,30,3,7,98,130
2018,2,21801163,4/2/2019,1610612758,Sacramento Kings,1,0,1610612745,Houston Rockets,0,1,35,37,72,7,16,23,42,53,95,14,6,20,18,38,19,8,11,98,105
2018,2,21801015,3/13/2019,1610612753,Orlando Magic,0,0,1610612764,Washington Wizards,1,1,23,34,57,12,21,33,35,55,90,8,1,9,15,41,26,5,11,90,90
2018,2,21801015,3/13/2019,1610612764,Washington Wizards,1,1,1610612753,Orlando Magic,0,0,34,29,63,8,19,27,42,48,90,8,4,12,14,37,20,3,9,92,100
2014,2,21400795,2/11/2015,1610612760,Oklahoma City Thunder,1,1,1610612763,Memphis Grizzlies,0,0,30,33,63,7,13,20,37,46,83,24,1,25,13,33,24,7,14,97,105
2014,2,21400795,2/11/2015,1610612763,Memphis Grizzlies,0,0,1610612760,Oklahoma City Thunder,1,1,30,44,74,2,10,12,32,54,86,23,7,30,15,41,13,7,13,99,89
2018,2,21800397,12/10/2018,1610612742,Dallas Mavericks,1,1,1610612753,Orlando Magic,0,0,25,22,47,10,25,35,35,47,82,21,4,25,14,35,28,8,14,96,101
2018,2,21800397,12/10/2018,1610612753,Orlando Magic,0,0,1610612742,Dallas Mavericks,1,1,24,37,61,8,20,28,32,57,89,4,1,5,15,43,18,7,16,95,76
2018,2,21800334,12/1/2018,1610612741,Chicago Bulls,0,0,1610612745,Houston Rockets,1,1,31,25,56,8,24,32,39,49,88,19,5,24,10,41,15,8,14,104,105
2018,2,21800334,12/1/2018,1610612745,Houston Rockets,1,1,1610612741,Chicago Bulls,0,0,26,17,43,16,25,41,42,42,84,21,9,30,9,36,23,11,14,102,121
2018,2,21800170,11/9/2018,1610612748,Miami Heat,1,0,1610612754,Indiana Pacers,0,1,22,31,53,14,13,27,36,44,80,16,11,27,14,36,27,10,24,101,102
2018,2,21800170,11/9/2018,1610612754,Indiana Pacers,0,1,1610612748,Miami Heat,1,0,36,23,59,7,13,20,43,36,79,17,12,29,10,30,20,6,18,100,110
2020,2,22000909,4/24/2021,1610612750,Minnesota Timberwolves,0,1,1610612762,Utah Jazz,1,0,31,23,54,9,29,38,40,52,92,12,8,20,16,40,15,9,14,98,101
2020,2,22000909,4/24/2021,1610612762,Utah Jazz,1,0,1610612750,Minnesota Timberwolves,0,1,14,21,35,19,28,47,33,49,82,11,4,15,10,40,24,13,20,98,96
2021,2,22100208,11/15/2021,1610612757,Portland Trail Blazers,1,1,1610612761,Toronto Raptors,0,0,30,16,46,16,20,36,46,36,82,10,4,14,10,28,25,7,14,92,118
2021,2,22100208,11/15/2021,1610612761,Toronto Raptors,0,0,1610612757,Portland Trail Blazers,1,1,26,30,56,15,18,33,41,48,89,16,2,18,15,34,20,6,11,93,113
2015,2,21501126,3/31/2016,1610612746,LA Clippers,0,0,1610612760,Oklahoma City Thunder,1,1,26,21,47,16,13,29,42,34,76,17,5,22,6,29,22,10,14,94,117
2015,2,21501126,3/31/2016,1610612760,Oklahoma City Thunder,1,1,1610612746,LA Clippers,0,0,35,20,55,10,22,32,45,42,87,19,5,24,19,25,25,9,14,93,119
2016,2,21600132,11/12/2016,1610612737,Atlanta Hawks,1,1,1610612755,Philadelphia 76ers,0,0,35,28,63,13,19,32,48,47,95,8,6,14,18,34,31,14,16,99,117
2016,2,21600132,11/12/2016,1610612755,Philadelphia 76ers,0,0,1610612737,Atlanta Hawks,1,1,25,29,54,11,18,29,36,47,83,13,7,20,14,37,21,10,19,99,96
2018,2,21801014,3/13/2019,1610612748,Miami Heat,1,1,1610612765,Detroit Pistons,0,0,28,28,56,11,17,28,39,45,84,19,5,24,15,31,22,7,11,89,108
2018,2,21801014,3/13/2019,1610612765,Detroit Pistons,0,0,1610612748,Miami Heat,1,1,19,21,40,8,29,37,27,50,77,12,6,18,15,38,20,10,18,89,74
2018,2,21800333,12/1/2018,1610612751,Brooklyn Nets,0,0,1610612764,Washington Wizards,1,1,22,26,48,8,25,33,30,51,81,20,5,25,15,39,19,8,19,96,88
2018,2,21800333,12/1/2018,1610612764,Washington Wizards,1,1,1610612751,Brooklyn Nets,0,0,33,20,53,8,18,26,41,38,79,12,6,18,5,35,19,8,13,96,102
2018,2,21800275,11/23/2018,1610612749,Milwaukee Bucks,1,0,1610612756,Phoenix Suns,0,1,32,11,43,10,34,44,42,45,87,20,10,30,11,39,30,8,14,105,114
2018,2,21800275,11/23/2018,1610612756,Phoenix Suns,0,1,1610612749,Milwaukee Bucks,1,0,36,28,64,9,17,26,45,45,90,17,5,22,7,39,21,6,11,104,116
2018,2,21800223,11/16/2018,1610612741,Chicago Bulls,0,0,1610612749,Milwaukee Bucks,1,1,28,33,61,13,20,33,41,53,94,9,4,13,9,45,22,8,12,105,104
2018,2,21800223,11/16/2018,1610612749,Milwaukee Bucks,1,1,1610612741,Chicago Bulls,0,0,29,21,50,18,25,43,47,46,93,11,6,17,13,35,28,8,17,104,123
2021,2,22100207,11/15/2021,1610612748,Miami Heat,0,1,1610612760,Oklahoma City Thunder,1,0,19,23,42,18,22,40,37,45,82,11,2,13,11,34,22,6,19,96,103
2021,2,22100207,11/15/2021,1610612760,Oklahoma City Thunder,1,0,1610612748,Miami Heat,0,1,19,23,42,15,26,41,34,49,83,7,3,10,10,39,26,11,20,97,90
2019,2,21900048,10/28/2019,1610612757,Portland Trail Blazers,0,0,1610612759,San Antonio Spurs,1,1,29,38,67,10,23,33,39,61,100,22,5,27,16,46,19,5,10,108,110
2019,2,21900048,10/28/2019,1610612759,San Antonio Spurs,1,1,1610612757,Portland Trail Blazers,0,0,34,29,63,7,15,22,41,44,85,24,8,32,9,41,25,4,18,108,113
2016,2,21601140,4/1/2017,1610612750,Minnesota Timberwolves,1,0,1610612758,Sacramento Kings,0,1,30,30,60,9,18,27,39,48,87,30,8,38,15,37,27,5,11,102,117
2016,2,21601140,4/1/2017,1610612758,Sacramento Kings,0,1,1610612750,Minnesota Timberwolves,1,0,33,26,59,11,8,19,44,34,78,24,9,33,7,32,27,8,17,102,123
2016,2,21600582,1/11/2017,1610612745,Houston Rockets,0,0,1610612750,Minnesota Timberwolves,1,1,21,24,45,15,27,42,36,51,87,18,4,22,11,42,23,8,16,100,105
2016,2,21600582,1/11/2017,1610612750,Minnesota Timberwolves,1,1,1610612745,Houston Rockets,0,0,36,22,58,8,15,23,44,37,81,23,2,25,12,26,31,7,18,99,119
2014,2,21400794,2/11/2015,1610612740,New Orleans Pelicans,1,0,1610612754,Indiana Pacers,0,1,27,32,59,7,8,15,34,40,74,18,7,25,12,32,22,7,15,89,93
2014,2,21400794,2/11/2015,1610612754,Indiana Pacers,0,1,1610612740,New Orleans Pelicans,1,0,31,24,55,9,11,20,40,35,75,17,1,18,8,27,28,5,15,89,106
2018,2,21800695,1/21/2019,1610612737,Atlanta Hawks,1,0,1610612753,Orlando Magic,0,1,30,26,56,9,21,30,39,47,86,16,7,23,13,37,23,8,14,97,103
2018,2,21800695,1/21/2019,1610612753,Orlando Magic,0,1,1610612737,Atlanta Hawks,1,0,35,27,62,11,18,29,46,45,91,19,2,21,12,35,29,5,11,96,122
2018,2,21800467,12/20/2018,1610612745,Houston Rockets,0,0,1610612748,Miami Heat,1,1,11,17,28,18,36,54,29,53,82,23,7,30,13,44,20,6,8,92,99
2018,2,21800467,12/20/2018,1610612748,Miami Heat,1,1,1610612745,Houston Rockets,0,0,27,27,54,9,30,39,36,57,93,20,14,34,27,36,22,6,9,91,101
2018,2,21800276,11/23/2018,1610612743,Denver Nuggets,1,1,1610612753,Orlando Magic,0,0,35,30,65,9,19,28,44,49,93,15,2,17,16,34,33,7,11,95,112
2018,2,21800276,11/23/2018,1610612753,Orlando Magic,0,0,1610612743,Denver Nuggets,1,1,24,23,47,8,24,32,32,47,79,15,4,19,9,40,24,10,15,95,87
2018,2,21800117,11/2/2018,1610612746,LA Clippers,0,1,1610612753,Orlando Magic,1,0,28,32,60,13,13,26,41,45,86,25,8,33,17,32,22,7,14,98,120
2018,2,21800117,11/2/2018,1610612753,Orlando Magic,1,0,1610612746,LA Clippers,0,1,36,37,73,4,13,17,40,50,90,11,8,19,12,43,20,5,10,97,95
2020,2,22000908,4/24/2021,1610612742,Dallas Mavericks,1,1,1610612747,Los Angeles Lakers,0,0,25,23,48,13,17,30,38,40,78,19,6,25,12,32,26,11,18,95,108
2020,2,22000908,4/24/2021,1610612747,Los Angeles Lakers,0,0,1610612742,Dallas Mavericks,1,1,21,20,41,12,33,45,33,53,86,15,4,19,11,42,22,3,9,95,93
2021,2,22100206,11/15/2021,1610612750,Minnesota Timberwolves,1,0,1610612756,Phoenix Suns,0,1,18,23,41,13,31,44,31,54,85,21,6,27,18,41,18,8,21,103,96
2019,2,21900273,11/29/2019,1610612744,Golden State Warriors,0,0,1610612748,Miami Heat,1,1,20,29,49,10,18,28,30,47,77,35,5,40,8,42,19,7,9,99,105
2019,2,21900273,11/29/2019,1610612748,Miami Heat,1,1,1610612744,Golden State Warriors,0,0,31,26,57,13,12,25,44,38,82,21,7,28,12,29,23,4,16,100,122
2014,2,21400793,2/11/2015,1610612744,Golden State Warriors,0,1,1610612750,Minnesota Timberwolves,1,0,33,30,63,7,20,27,40,50,90,7,2,9,12,40,26,7,15,98,94
2014,2,21400793,2/11/2015,1610612750,Minnesota Timberwolves,1,0,1610612744,Golden State Warriors,0,1,28,44,72,5,9,14,33,53,86,20,7,27,17,41,18,7,14,96,91
2018,2,21801162,4/2/2019,1610612737,Atlanta Hawks,0,0,1610612759,San Antonio Spurs,1,1,31,29,60,12,22,34,43,51,94,13,7,20,13,44,26,6,11,101,111
2018,2,21801162,4/2/2019,1610612759,San Antonio Spurs,1,1,1610612737,Atlanta Hawks,0,0,28,22,50,14,16,30,42,38,80,19,3,22,7,34,23,13,17,102,117
2018,2,21800781,2/2/2019,1610612748,Miami Heat,1,0,1610612754,Indiana Pacers,0,1,21,20,41,9,21,30,30,41,71,19,7,26,12,33,21,15,24,94,88
2018,2,21800781,2/2/2019,1610612754,Indiana Pacers,0,1,1610612748,Miami Heat,1,0,31,34,65,7,17,24,38,51,89,12,5,17,19,35,26,8,14,95,95
2018,2,21800396,12/10/2018,1610612760,Oklahoma City Thunder,1,1,1610612762,Utah Jazz,0,0,35,29,64,8,13,21,43,42,85,28,11,39,14,34,25,11,18,106,122
2018,2,21800396,12/10/2018,1610612762,Utah Jazz,0,0,1610612760,Oklahoma City Thunder,1,1,35,20,55,8,21,29,43,41,84,19,11,30,14,31,30,12,20,107,113
2021,2,22100206,11/15/2021,1610612756,Phoenix Suns,0,1,1610612750,Minnesota Timberwolves,1,0,25,29,54,7,24,31,32,53,85,28,8,36,14,42,21,8,15,102,99
2021,2,22100205,11/15/2021,1610612745,Houston Rockets,0,0,1610612763,Memphis Grizzlies,1,1,25,32,57,11,27,38,36,59,95,19,7,26,19,44,24,14,18,106,102
2021,2,22100205,11/15/2021,1610612763,Memphis Grizzlies,1,1,1610612745,Houston Rockets,0,0,36,19,55,16,25,41,52,44,96,16,4,20,10,36,33,6,10,104,136
2016,2,21600581,1/11/2017,1610612760,Oklahoma City Thunder,1,1,1610612763,Memphis Grizzlies,0,0,28,27,55,8,18,26,36,45,81,23,6,29,15,32,21,11,16,94,103
2016,2,21600581,1/11/2017,1610612763,Memphis Grizzlies,0,0,1610612760,Oklahoma City Thunder,1,1,31,37,68,7,17,24,38,54,92,12,9,21,18,42,18,5,10,95,95
2016,2,21600131,11/12/2016,1610612752,New York Knicks,0,0,1610612761,Toronto Raptors,1,1,37,37,74,7,16,23,44,53,97,12,4,16,21,35,19,10,16,101,107
2016,2,21600131,11/12/2016,1610612761,Toronto Raptors,1,1,1610612752,New York Knicks,0,0,32,29,61,7,15,22,39,44,83,33,5,38,11,34,18,3,11,100,118
2018,2,21801013,3/12/2019,1610612746,LA Clippers,1,0,1610612757,Portland Trail Blazers,0,1,29,51,80,9,6,15,38,57,95,19,8,27,26,34,21,8,12,95,104
2018,2,21801013,3/12/2019,1610612757,Portland Trail Blazers,0,1,1610612746,LA Clippers,1,0,35,30,65,12,19,31,47,49,96,19,7,26,23,31,27,7,12,95,125
2018,2,21800541,12/30/2018,1610612747,Los Angeles Lakers,1,1,1610612758,Sacramento Kings,0,0,32,22,54,15,29,44,47,51,98,12,8,20,19,37,30,8,14,104,121
2018,2,21800541,12/30/2018,1610612758,Sacramento Kings,0,0,1610612747,Los Angeles Lakers,1,1,33,28,61,13,21,34,46,49,95,9,3,12,9,41,24,7,14,103,114
2018,2,21800169,11/9/2018,1610612737,Atlanta Hawks,1,0,1610612765,Detroit Pistons,0,1,29,22,51,7,21,28,36,43,79,30,10,40,11,36,17,10,16,104,109
2018,2,21800169,11/9/2018,1610612765,Detroit Pistons,0,1,1610612737,Atlanta Hawks,1,0,26,24,50,20,27,47,46,51,97,12,7,19,12,44,30,6,11,105,124
2020,2,22000907,4/24/2021,1610612741,Chicago Bulls,0,0,1610612748,Miami Heat,1,1,25,16,41,13,25,38,38,41,79,12,1,13,8,33,28,11,18,95,101
2020,2,22000907,4/24/2021,1610612748,Miami Heat,1,1,1610612741,Chicago Bulls,0,0,22,21,43,14,23,37,36,44,80,20,4,24,10,38,22,7,13,96,106
2017,2,21701196,4/7/2018,1610612757,Portland Trail Blazers,0,0,1610612759,San Antonio Spurs,1,1,31,29,60,11,17,28,42,46,88,10,1,11,12,34,18,12,13,92,105
2017,2,21701196,4/7/2018,1610612759,San Antonio Spurs,1,1,1610612757,Portland Trail Blazers,0,0,40,23,63,7,14,21,47,37,84,15,6,21,8,32,21,4,8,92,116
2017,2,21701175,4/5/2018,1610612744,Golden State Warriors,0,0,1610612754,Indiana Pacers,1,1,28,26,54,9,20,29,37,46,83,23,1,24,13,34,29,11,16,97,106
2017,2,21701175,4/5/2018,1610612754,Indiana Pacers,1,1,1610612744,Golden State Warriors,0,0,35,29,64,15,14,29,50,43,93,11,4,15,16,28,32,6,13,98,126
2017,2,21701136,3/30/2018,1610612749,Milwaukee Bucks,0,1,1610612747,Los Angeles Lakers,1,0,34,31,65,11,18,29,45,49,94,23,5,28,11,42,24,5,13,108,124
2016,2,21601139,4/1/2017,1610612751,Brooklyn Nets,1,1,1610612753,Orlando Magic,0,0,42,21,63,8,23,31,50,44,94,13,3,16,14,32,26,9,11,100,121
2016,2,21601139,4/1/2017,1610612753,Orlando Magic,0,0,1610612751,Brooklyn Nets,1,1,35,31,66,10,15,25,45,46,91,11,4,15,12,36,26,8,14,99,111
2019,2,21900047,10/28/2019,1610612740,New Orleans Pelicans,1,0,1610612744,Golden State Warriors,0,1,33,23,56,15,32,47,48,55,103,12,10,22,17,45,36,8,15,110,123
2019,2,21900047,10/28/2019,1610612744,Golden State Warriors,0,1,1610612740,New Orleans Pelicans,1,0,37,32,69,14,21,35,51,53,104,18,6,24,25,32,37,13,18,109,134
2018,2,21800620,1/10/2019,1610612758,Sacramento Kings,1,1,1610612765,Detroit Pistons,0,0,35,29,64,9,13,22,44,42,86,15,5,20,15,29,29,13,20,99,112
2018,2,21800620,1/10/2019,1610612765,Detroit Pistons,0,0,1610612758,Sacramento Kings,1,1,24,20,44,11,27,38,35,47,82,21,3,24,11,39,22,7,20,100,102
2018,2,21800466,12/19/2018,1610612758,Sacramento Kings,1,0,1610612760,Oklahoma City Thunder,0,1,26,33,59,13,21,34,39,54,93,22,11,33,11,50,28,8,13,111,113
2018,2,21800466,12/19/2018,1610612760,Oklahoma City Thunder,0,1,1610612758,Sacramento Kings,1,0,38,32,70,13,19,32,51,51,102,17,10,27,22,35,27,7,18,112,132
2018,2,21800332,12/1/2018,1610612739,Cleveland Cavaliers,1,0,1610612761,Toronto Raptors,0,1,29,37,66,5,17,22,34,54,88,22,3,25,18,38,14,5,12,94,95
2021,2,22100204,11/15/2021,1610612742,Dallas Mavericks,1,1,1610612743,Denver Nuggets,0,0,31,23,54,14,22,36,45,45,90,7,3,10,10,38,30,4,9,92,111
2021,2,22100204,11/15/2021,1610612743,Denver Nuggets,0,0,1610612742,Dallas Mavericks,1,1,31,21,52,9,23,32,40,44,84,12,5,17,12,34,20,7,12,92,101
2018,2,21800332,12/1/2018,1610612761,Toronto Raptors,0,1,1610612739,Cleveland Cavaliers,1,0,32,22,54,7,19,26,39,41,80,21,4,25,9,34,15,6,12,93,106
2018,2,21800274,11/23/2018,1610612760,Oklahoma City Thunder,1,1,1610612766,Charlotte Hornets,0,0,30,30,60,11,22,33,41,52,93,16,8,24,16,40,24,8,14,102,109
2018,2,21800274,11/23/2018,1610612766,Charlotte Hornets,0,0,1610612760,Oklahoma City Thunder,1,1,37,26,63,6,25,31,43,51,94,12,2,14,14,37,24,6,14,101,104
2018,2,21800222,11/16/2018,1610612740,New Orleans Pelicans,1,1,1610612752,New York Knicks,0,0,38,27,65,10,24,34,48,51,99,23,9,32,19,36,27,10,15,109,129
2018,2,21800222,11/16/2018,1610612752,New York Knicks,0,0,1610612740,New Orleans Pelicans,1,1,37,27,64,11,23,34,48,50,98,17,7,24,12,44,15,5,13,109,124
2018,2,21800118,11/2/2018,1610612745,Houston Rockets,0,1,1610612751,Brooklyn Nets,1,0,26,18,44,15,24,39,41,42,83,22,10,32,15,32,22,5,9,91,119
2018,2,21800118,11/2/2018,1610612751,Brooklyn Nets,1,0,1610612745,Houston Rockets,0,1,27,24,51,15,19,34,42,43,85,12,8,20,16,32,22,4,12,90,111
2017,2,21700895,2/25/2018,1610612755,Philadelphia 76ers,0,0,1610612764,Washington Wizards,1,1,22,31,53,9,24,33,31,55,86,23,8,31,21,40,24,9,16,94,94
2017,2,21700895,2/25/2018,1610612764,Washington Wizards,1,1,1610612755,Philadelphia 76ers,0,0,31,23,54,12,13,25,43,36,79,11,1,12,10,27,35,13,19,94,109
2017,2,21701197,4/8/2018,1610612754,Indiana Pacers,0,1,1610612766,Charlotte Hornets,1,0,41,27,68,9,16,25,50,43,93,14,4,18,8,37,27,6,15,108,123
2017,2,21701197,4/8/2018,1610612766,Charlotte Hornets,1,0,1610612754,Indiana Pacers,0,1,29,21,50,11,19,30,40,40,80,26,4,30,6,36,27,11,21,109,117
2017,2,21701174,4/4/2018,1610612747,Los Angeles Lakers,1,1,1610612759,San Antonio Spurs,0,0,34,28,62,13,11,24,47,39,86,15,3,18,8,33,32,7,14,101,122
2017,2,21701174,4/4/2018,1610612759,San Antonio Spurs,0,0,1610612747,Los Angeles Lakers,1,1,33,41,74,9,14,23,42,55,97,19,8,27,17,43,25,4,10,102,112
2017,2,21701153,4/1/2018,1610612744,Golden State Warriors,1,1,1610612756,Phoenix Suns,0,0,35,26,61,13,15,28,48,41,89,8,1,9,8,34,31,8,15,100,117
2017,2,21701153,4/1/2018,1610612756,Phoenix Suns,0,0,1610612744,Golden State Warriors,1,1,30,29,59,11,20,31,41,49,90,14,2,16,11,40,26,10,15,100,107
2014,2,21401223,4/15/2015,1610612740,New Orleans Pelicans,1,1,1610612759,San Antonio Spurs,0,0,38,35,73,5,5,10,43,40,83,17,8,25,10,33,23,2,9,93,108
2014,2,21401223,4/15/2015,1610612759,San Antonio Spurs,0,0,1610612740,New Orleans Pelicans,1,1,42,27,69,3,7,10,45,34,79,10,3,13,6,29,33,11,15,94,103
2019,2,21900272,11/29/2019,1610612737,Atlanta Hawks,0,0,1610612754,Indiana Pacers,1,1,30,28,58,9,23,32,39,51,90,17,1,18,14,38,14,12,24,109,104
2019,2,21900272,11/29/2019,1610612754,Indiana Pacers,1,1,1610612737,Atlanta Hawks,0,0,33,33,66,6,20,26,39,53,92,21,7,28,14,43,19,10,16,109,105
2016,2,21600580,1/11/2017,1610612752,New York Knicks,0,0,1610612755,Philadelphia 76ers,1,1,38,26,64,4,18,22,42,44,86,9,1,10,11,33,20,7,15,94,97
2016,2,21600580,1/11/2017,1610612755,Philadelphia 76ers,1,1,1610612752,New York Knicks,0,0,30,37,67,7,21,28,37,58,95,17,4,21,25,34,27,7,14,95,98
2014,2,21400792,2/11/2015,1610612749,Milwaukee Bucks,1,1,1610612758,Sacramento Kings,0,0,32,33,65,7,8,15,39,41,80,26,6,32,13,32,23,7,15,97,111
2014,2,21400792,2/11/2015,1610612758,Sacramento Kings,0,0,1610612749,Milwaukee Bucks,1,1,28,34,62,8,14,22,36,48,84,23,7,30,18,35,24,11,18,98,103
2018,2,21801161,4/2/2019,1610612747,Los Angeles Lakers,0,0,1610612760,Oklahoma City Thunder,1,1,24,21,45,16,23,39,40,44,84,7,3,10,11,35,26,15,23,101,103
2018,2,21801161,4/2/2019,1610612760,Oklahoma City Thunder,1,1,1610612747,Los Angeles Lakers,0,0,34,24,58,13,31,44,47,55,102,12,8,20,22,38,33,7,12,100,119
2018,2,21800879,2/22/2019,1610612746,LA Clippers,0,1,1610612763,Memphis Grizzlies,1,0,29,21,50,6,19,25,35,40,75,36,6,42,14,29,21,10,24,107,112
2018,2,21800879,2/22/2019,1610612763,Memphis Grizzlies,1,0,1610612746,LA Clippers,0,1,24,34,58,9,23,32,33,57,90,31,5,36,14,45,20,8,11,108,106
2018,2,21800694,1/21/2019,1610612742,Dallas Mavericks,0,0,1610612749,Milwaukee Bucks,1,1,27,32,59,14,26,40,41,58,99,10,7,17,16,45,24,9,11,104,106
2018,2,21800694,1/21/2019,1610612749,Milwaukee Bucks,1,1,1610612742,Dallas Mavericks,0,0,30,29,59,12,20,32,42,49,91,20,2,22,13,37,21,7,15,103,116
2018,2,21800331,12/1/2018,1610612744,Golden State Warriors,0,0,1610612765,Detroit Pistons,1,1,33,26,59,6,20,26,39,46,85,18,3,21,11,37,23,8,15,99,102
2018,2,21800331,12/1/2018,1610612765,Detroit Pistons,1,1,1610612744,Golden State Warriors,0,0,31,32,63,12,23,35,43,55,98,13,7,20,20,39,22,6,12,100,111
2018,2,21800168,11/9/2018,1610612755,Philadelphia 76ers,1,1,1610612766,Charlotte Hornets,0,0,33,24,57,12,25,37,45,49,94,31,10,41,18,37,33,10,17,114,133
2018,2,21800168,11/9/2018,1610612766,Charlotte Hornets,0,0,1610612755,Philadelphia 76ers,1,1,27,43,70,16,24,40,43,67,110,30,10,40,23,50,25,3,7,115,132
2020,2,22000906,4/24/2021,1610612754,Indiana Pacers,1,1,1610612765,Detroit Pistons,0,0,30,34,64,10,22,32,40,56,96,25,10,35,14,49,28,3,5,105,115
2020,2,22000906,4/24/2021,1610612765,Detroit Pistons,0,0,1610612754,Indiana Pacers,1,1,29,33,62,10,24,34,39,57,96,21,5,26,23,35,26,10,18,104,109
2022,2,22200472,12/21/2022,1610612745,Houston Rockets,1,0,1610612753,Orlando Magic,0,1,24,21,45,17,26,43,41,47,88,11,6,17,12,37,22,11,17,101,110
2022,2,22200472,12/21/2022,1610612753,Orlando Magic,0,1,1610612745,Houston Rockets,1,0,30,24,54,11,26,37,41,50,91,23,10,33,15,43,19,6,11,99,116
2017,2,21701198,4/8/2018,1610612742,Dallas Mavericks,0,0,1610612755,Philadelphia 76ers,1,1,29,25,54,11,29,40,40,54,94,6,7,13,12,45,24,9,12,99,97
2017,2,21701198,4/8/2018,1610612755,Philadelphia 76ers,1,1,1610612742,Dallas Mavericks,0,0,38,26,64,8,19,27,46,45,91,9,5,14,11,36,32,6,11,98,109
2017,2,21701154,4/1/2018,1610612757,Portland Trail Blazers,1,1,1610612763,Memphis Grizzlies,0,0,27,19,46,12,26,38,39,45,84,23,2,25,11,34,28,7,14,98,113
2017,2,21701154,4/1/2018,1610612763,Memphis Grizzlies,0,0,1610612757,Portland Trail Blazers,1,1,31,36,67,9,12,21,40,48,88,9,3,12,12,37,20,9,17,100,98
2021,2,22100203,11/15/2021,1610612752,New York Knicks,1,1,1610612754,Indiana Pacers,0,0,26,26,52,11,23,34,37,49,86,7,3,10,14,37,22,6,12,89,92
2021,2,22100203,11/15/2021,1610612754,Indiana Pacers,0,0,1610612752,New York Knicks,1,1,24,25,49,8,29,37,32,54,86,12,4,16,14,42,16,1,9,90,84
2016,2,21601138,4/1/2017,1610612737,Atlanta Hawks,0,0,1610612741,Chicago Bulls,1,1,29,33,62,11,17,28,40,50,90,13,4,17,15,37,25,6,13,97,104
2016,2,21601138,4/1/2017,1610612741,Chicago Bulls,1,1,1610612737,Atlanta Hawks,0,0,28,27,55,12,18,30,40,45,85,14,0,14,9,36,25,4,12,95,106
2015,2,21501204,4/11/2016,1610612749,Milwaukee Bucks,0,0,1610612753,Orlando Magic,1,1,38,25,63,3,12,15,41,37,78,13,6,19,15,26,18,19,23,95,98
2015,2,21501204,4/11/2016,1610612753,Orlando Magic,1,1,1610612749,Milwaukee Bucks,0,0,34,27,61,7,16,23,41,43,84,18,10,28,15,33,28,6,10,97,107
2018,2,21801160,4/1/2019,1610612739,Cleveland Cavaliers,0,0,1610612756,Phoenix Suns,1,1,37,40,77,8,14,22,45,54,99,15,7,22,21,37,17,1,9,96,113
2018,2,21801160,4/1/2019,1610612756,Phoenix Suns,1,1,1610612739,Cleveland Cavaliers,0,0,33,14,47,13,24,37,46,38,84,17,3,20,8,32,28,5,14,96,122
2018,2,21801012,3/12/2019,1610612743,Denver Nuggets,1,1,1610612750,Minnesota Timberwolves,0,0,33,22,55,18,12,30,51,34,85,13,2,15,12,23,40,10,14,95,133
2014,2,21401222,4/15/2015,1610612750,Minnesota Timberwolves,1,0,1610612760,Oklahoma City Thunder,0,1,33,32,65,6,13,19,39,45,84,29,6,35,16,31,22,10,16,100,113
2014,2,21401222,4/15/2015,1610612760,Oklahoma City Thunder,0,1,1610612750,Minnesota Timberwolves,1,0,40,27,67,12,16,28,52,43,95,22,9,31,22,26,22,12,13,100,138
2018,2,21801012,3/12/2019,1610612750,Minnesota Timberwolves,0,0,1610612743,Denver Nuggets,1,1,30,29,59,11,19,30,41,48,89,14,0,14,16,32,24,6,15,94,107
2014,2,21400791,2/11/2015,1610612761,Toronto Raptors,1,1,1610612764,Washington Wizards,0,0,20,30,50,11,15,26,31,45,76,22,4,26,10,37,17,7,13,91,95
2014,2,21400791,2/11/2015,1610612764,Washington Wizards,0,0,1610612761,Toronto Raptors,1,1,34,30,64,5,16,21,39,46,85,10,6,16,18,29,25,9,16,92,93
2018,2,21800780,2/2/2019,1610612739,Cleveland Cavaliers,1,0,1610612742,Dallas Mavericks,0,1,30,32,62,4,19,23,34,51,85,26,7,33,13,43,20,2,6,94,98
2018,2,21800780,2/2/2019,1610612742,Dallas Mavericks,0,1,1610612739,Cleveland Cavaliers,1,0,24,21,45,16,23,39,40,44,84,15,4,19,11,33,20,7,13,95,111
2023,2,22300472,1/3/2024,1610612742,Dallas Mavericks,1,1,1610612757,Portland Trail Blazers,0,0,29,25,54,13,17,30,42,42,84,29,12,41,11,39,25,4,12,104,126
2018,2,21800540,12/30/2018,1610612755,Philadelphia 76ers,0,0,1610612757,Portland Trail Blazers,1,1,26,27,53,8,35,43,34,62,96,19,8,27,13,53,18,2,11,107,95
2018,2,21800540,12/30/2018,1610612757,Portland Trail Blazers,1,1,1610612755,Philadelphia 76ers,0,0,37,24,61,12,10,22,49,34,83,19,6,25,10,29,28,15,21,107,129
2018,2,21800395,12/10/2018,1610612739,Cleveland Cavaliers,0,0,1610612749,Milwaukee Bucks,1,1,26,40,66,10,20,30,36,60,96,10,5,15,17,46,24,4,9,99,92
2018,2,21800395,12/10/2018,1610612749,Milwaukee Bucks,1,1,1610612739,Cleveland Cavaliers,0,0,27,33,60,15,21,36,42,54,96,9,2,11,18,38,22,5,14,99,108
2018,2,21800221,11/16/2018,1610612750,Minnesota Timberwolves,1,1,1610612757,Portland Trail Blazers,0,0,34,30,64,12,16,28,46,46,92,8,3,11,11,38,28,6,12,99,112
2018,2,21800221,11/16/2018,1610612757,Portland Trail Blazers,0,0,1610612750,Minnesota Timberwolves,1,1,29,30,59,8,21,29,37,51,88,14,6,20,16,37,16,11,18,99,96
2022,2,22200469,12/21/2022,1610612738,Boston Celtics,1,0,1610612754,Indiana Pacers,0,1,26,34,60,13,28,41,39,62,101,21,4,25,29,35,26,10,17,102,112
2022,2,22200469,12/21/2022,1610612754,Indiana Pacers,0,1,1610612738,Boston Celtics,1,0,28,31,59,18,21,39,46,52,98,7,2,9,13,41,27,11,14,102,117
2016,2,21600579,1/10/2017,1610612758,Sacramento Kings,1,1,1610612765,Detroit Pistons,0,0,19,31,50,13,10,23,32,41,73,23,6,29,15,28,21,12,17,89,100
2016,2,21600579,1/10/2017,1610612765,Detroit Pistons,0,0,1610612758,Sacramento Kings,1,1,24,31,55,12,15,27,36,46,82,10,6,16,12,37,14,6,12,91,94
2019,2,21900046,10/28/2019,1610612739,Cleveland Cavaliers,0,0,1610612749,Milwaukee Bucks,1,1,33,28,61,12,27,39,45,55,100,10,2,12,12,44,19,9,12,106,112
2019,2,21900046,10/28/2019,1610612749,Milwaukee Bucks,1,1,1610612739,Cleveland Cavaliers,0,0,31,23,54,17,21,38,48,44,92,16,8,24,10,38,29,2,12,105,129
2016,2,21600130,11/12/2016,1610612738,Boston Celtics,0,1,1610612754,Indiana Pacers,1,0,27,28,55,8,17,25,35,45,80,27,6,33,17,30,22,9,14,94,105
2016,2,21600130,11/12/2016,1610612754,Indiana Pacers,1,0,1610612738,Boston Celtics,0,1,30,29,59,6,21,27,36,50,86,21,7,28,20,33,17,7,14,95,99
2018,2,21800881,2/22/2019,1610612760,Oklahoma City Thunder,1,1,1610612762,Utah Jazz,0,0,37,37,74,18,26,44,55,63,118,20,5,25,18,48,29,8,11,124,148
2018,2,21800881,2/22/2019,1610612762,Utah Jazz,0,0,1610612760,Oklahoma City Thunder,1,1,34,31,65,18,22,40,52,53,105,25,6,31,20,34,33,16,25,124,147
2018,2,21800779,2/2/2019,1610612740,New Orleans Pelicans,0,0,1610612759,San Antonio Spurs,1,1,33,28,61,10,25,35,43,53,96,12,0,12,10,43,26,5,9,103,108
2018,2,21800779,2/2/2019,1610612759,San Antonio Spurs,1,1,1610612740,New Orleans Pelicans,0,0,35,34,69,9,14,23,44,48,92,16,2,18,10,39,29,6,11,101,113
2018,2,21800619,1/10/2019,1610612759,San Antonio Spurs,1,1,1610612760,Oklahoma City Thunder,0,0,40,40,80,16,3,19,56,43,99,26,3,29,8,36,38,8,17,120,154
2018,2,21800619,1/10/2019,1610612760,Oklahoma City Thunder,0,0,1610612759,San Antonio Spurs,1,1,43,36,79,15,20,35,58,56,114,16,8,24,20,41,33,8,13,119,147
2018,2,21800167,11/9/2018,1610612753,Orlando Magic,1,1,1610612764,Washington Wizards,0,0,31,24,55,13,18,31,44,42,86,16,3,19,12,30,26,8,16,99,117
2018,2,21800167,11/9/2018,1610612764,Washington Wizards,0,0,1610612753,Orlando Magic,1,1,31,24,55,11,16,27,42,40,82,13,6,19,10,33,24,8,19,101,108
2017,2,21701061,3/20/2018,1610612740,New Orleans Pelicans,1,1,1610612742,Dallas Mavericks,0,0,38,28,66,10,15,25,48,43,91,9,6,15,13,33,33,4,9,94,115
2017,2,21701061,3/20/2018,1610612742,Dallas Mavericks,0,0,1610612740,New Orleans Pelicans,1,1,33,22,55,10,25,35,43,47,90,9,2,11,10,38,25,5,8,94,105
2019,2,21900271,11/29/2019,1610612752,New York Knicks,1,0,1610612755,Philadelphia 76ers,0,1,26,32,58,8,12,20,34,44,78,19,14,33,12,39,14,5,14,95,95
2019,2,21900271,11/29/2019,1610612755,Philadelphia 76ers,0,1,1610612752,New York Knicks,1,0,24,22,46,7,19,26,31,41,72,32,8,40,13,30,22,5,16,96,101
2014,2,21400790,2/11/2015,1610612759,San Antonio Spurs,0,1,1610612765,Detroit Pistons,1,0,32,29,61,10,17,27,42,46,88,10,1,11,17,29,26,4,10,86,104
2014,2,21400790,2/11/2015,1610612765,Detroit Pistons,1,0,1610612759,San Antonio Spurs,0,1,24,36,60,9,12,21,33,48,81,12,5,17,13,37,17,8,10,87,87
2018,2,21801011,3/12/2019,1610612742,Dallas Mavericks,1,0,1610612759,San Antonio Spurs,0,1,24,19,43,14,25,39,38,44,82,15,11,26,13,35,22,11,14,94,105
2018,2,21801011,3/12/2019,1610612759,San Antonio Spurs,0,1,1610612742,Dallas Mavericks,1,0,35,25,60,8,14,22,43,39,82,18,0,18,9,30,26,1,12,95,112
2018,2,21800880,2/22/2019,1610612742,Dallas Mavericks,1,0,1610612743,Denver Nuggets,0,1,24,19,43,10,31,41,34,50,84,26,7,33,12,42,19,11,15,103,104
2018,2,21800880,2/22/2019,1610612743,Denver Nuggets,0,1,1610612742,Dallas Mavericks,1,0,28,38,66,14,23,37,42,61,103,16,9,25,26,39,32,7,13,103,114
2018,2,21800693,1/21/2019,1610612764,Washington Wizards,1,1,1610612765,Detroit Pistons,0,0,28,28,56,8,15,23,36,43,79,21,6,27,7,40,24,5,16,98,101
2018,2,21800693,1/21/2019,1610612765,Detroit Pistons,0,0,1610612764,Washington Wizards,1,1,20,23,43,11,23,34,31,46,77,14,4,18,5,44,22,7,18,98,87
2021,2,22100202,11/15/2021,1610612737,Atlanta Hawks,1,1,1610612753,Orlando Magic,0,0,33,22,55,14,16,30,47,38,85,21,11,32,11,31,32,8,11,99,129
2021,2,22100202,11/15/2021,1610612753,Orlando Magic,0,0,1610612737,Atlanta Hawks,1,1,27,25,52,16,27,43,43,52,95,9,5,14,17,39,30,10,16,100,111
2018,2,21800394,12/10/2018,1610612741,Chicago Bulls,1,0,1610612758,Sacramento Kings,0,1,26,22,48,8,20,28,34,42,76,13,0,13,10,32,16,16,27,99,89
2018,2,21800394,12/10/2018,1610612758,Sacramento Kings,0,1,1610612741,Chicago Bulls,1,0,24,27,51,16,21,37,40,48,88,12,3,15,16,33,28,10,18,100,108
2018,2,21800273,11/23/2018,1610612741,Chicago Bulls,1,0,1610612748,Miami Heat,0,1,28,38,66,7,21,28,35,59,94,19,1,20,17,42,23,10,17,105,96
2018,2,21800273,11/23/2018,1610612748,Miami Heat,0,1,1610612741,Chicago Bulls,1,0,27,26,53,10,24,34,37,50,87,19,12,31,11,44,20,8,14,104,103
2018,2,21800220,11/16/2018,1610612758,Sacramento Kings,0,0,1610612763,Memphis Grizzlies,1,1,25,22,47,12,21,33,37,43,80,18,6,24,14,32,23,11,21,99,104
2018,2,21800220,11/16/2018,1610612763,Memphis Grizzlies,1,1,1610612758,Sacramento Kings,0,0,32,28,60,11,14,25,43,42,85,15,9,24,12,35,24,9,16,98,112
2018,2,21800166,11/8/2018,1610612744,Golden State Warriors,1,0,1610612749,Milwaukee Bucks,0,1,32,27,59,10,18,28,42,45,87,17,5,22,12,36,31,11,18,103,111
2020,2,22000904,4/24/2021,1610612752,New York Knicks,1,1,1610612761,Toronto Raptors,0,0,26,18,44,16,15,31,42,33,75,20,4,24,7,29,20,6,15,92,120
2020,2,22000904,4/24/2021,1610612761,Toronto Raptors,0,0,1610612752,New York Knicks,1,1,19,20,39,17,27,44,36,47,83,14,5,19,5,43,31,4,7,94,103
2018,2,21800166,11/8/2018,1610612749,Milwaukee Bucks,0,1,1610612744,Golden State Warriors,1,0,43,23,66,9,26,35,52,49,101,21,6,27,20,32,33,5,12,104,134
2016,2,21601137,4/1/2017,1610612746,LA Clippers,1,1,1610612747,Los Angeles Lakers,0,0,27,17,44,11,14,25,38,31,69,28,6,34,7,26,24,12,18,98,115
2016,2,21601137,4/1/2017,1610612747,Los Angeles Lakers,0,0,1610612746,LA Clippers,1,1,33,34,67,6,17,23,39,51,90,20,10,30,17,40,26,8,12,97,104
2018,2,21801159,4/1/2019,1610612762,Utah Jazz,1,1,1610612766,Charlotte Hornets,0,0,23,21,44,15,20,35,38,41,79,20,6,26,10,34,30,12,18,101,111
2018,2,21801159,4/1/2019,1610612766,Charlotte Hornets,0,0,1610612762,Utah Jazz,1,1,29,31,60,7,23,30,36,54,90,23,6,29,14,43,15,7,11,101,102
2018,2,21800878,2/22/2019,1610612750,Minnesota Timberwolves,0,1,1610612752,New York Knicks,1,0,30,33,63,11,13,24,41,46,87,22,10,32,12,40,22,9,13,103,115
2018,2,21800878,2/22/2019,1610612752,New York Knicks,1,0,1610612750,Minnesota Timberwolves,0,1,26,31,57,11,18,29,37,49,86,19,5,24,15,37,15,13,23,104,104
2021,2,22100201,11/15/2021,1610612740,New Orleans Pelicans,0,0,1610612764,Washington Wizards,1,1,19,34,53,11,10,21,30,44,74,29,5,34,10,37,20,9,12,94,100
2021,2,22100201,11/15/2021,1610612764,Washington Wizards,1,1,1610612740,New Orleans Pelicans,0,0,29,27,56,10,18,28,39,45,84,17,8,25,8,40,23,2,6,93,105
2018,2,21800539,12/30/2018,1610612742,Dallas Mavericks,1,1,1610612760,Oklahoma City Thunder,0,0,23,19,42,14,25,39,37,44,81,17,5,22,14,33,21,15,24,102,105
2018,2,21800539,12/30/2018,1610612760,Oklahoma City Thunder,0,0,1610612742,Dallas Mavericks,1,1,31,24,55,9,29,38,40,53,93,14,7,21,11,46,17,8,11,103,103
2018,2,21800114,11/1/2018,1610612737,Atlanta Hawks,1,0,1610612758,Sacramento Kings,0,1,34,22,56,8,23,31,42,45,87,23,11,34,14,36,26,14,22,112,115
2018,2,21800114,11/1/2018,1610612758,Sacramento Kings,0,1,1610612737,Atlanta Hawks,1,0,39,24,63,14,21,35,53,45,98,26,6,32,13,35,38,6,14,111,146
2017,2,21701217,4/10/2018,1610612744,Golden State Warriors,0,0,1610612762,Utah Jazz,1,1,25,42,67,5,14,19,30,56,86,14,2,16,11,46,14,10,16,97,79
2017,2,21701217,4/10/2018,1610612762,Utah Jazz,1,1,1610612744,Golden State Warriors,0,0,35,20,55,13,22,35,48,42,90,10,3,13,16,30,25,7,15,98,119
2017,2,21701085,3/23/2018,1610612759,San Antonio Spurs,1,1,1610612762,Utah Jazz,0,0,40,35,75,7,10,17,47,45,92,23,4,27,12,33,21,10,14,106,124
2017,2,21701085,3/23/2018,1610612762,Utah Jazz,0,0,1610612759,San Antonio Spurs,1,1,32,28,60,11,17,28,43,45,88,23,6,29,8,42,24,9,15,108,120
2017,2,21701072,3/22/2018,1610612763,Memphis Grizzlies,0,0,1610612766,Charlotte Hornets,1,1,26,34,60,4,14,18,30,48,78,15,6,21,11,42,13,10,19,98,79
2017,2,21701072,3/22/2018,1610612766,Charlotte Hornets,1,1,1610612763,Memphis Grizzlies,0,0,30,22,52,19,21,40,49,43,92,23,4,27,15,30,25,4,9,97,140
2017,2,21701051,3/19/2018,1610612747,Los Angeles Lakers,0,0,1610612754,Indiana Pacers,1,1,30,23,53,8,25,33,38,48,86,16,7,23,16,36,20,9,13,93,100
2017,2,21701051,3/19/2018,1610612754,Indiana Pacers,1,1,1610612747,Los Angeles Lakers,0,0,37,29,66,6,15,21,43,44,87,18,1,19,11,34,24,4,7,92,110
2017,2,21701043,3/17/2018,1610612758,Sacramento Kings,0,0,1610612762,Utah Jazz,1,1,23,42,65,14,7,21,37,49,86,9,5,14,9,42,23,8,14,101,97
2019,2,21900270,11/29/2019,1610612739,Cleveland Cavaliers,1,0,1610612749,Milwaukee Bucks,0,1,27,27,54,17,17,34,44,44,88,5,5,10,9,37,32,7,15,98,110
2019,2,21900270,11/29/2019,1610612749,Milwaukee Bucks,0,1,1610612739,Cleveland Cavaliers,1,0,33,21,54,12,22,34,45,43,88,17,6,23,11,37,28,7,13,100,119
2016,2,21601136,3/31/2017,1610612744,Golden State Warriors,1,1,1610612745,Houston Rockets,0,0,32,31,63,11,21,32,43,52,95,10,4,14,19,35,27,6,12,94,107
2016,2,21601136,3/31/2017,1610612745,Houston Rockets,0,0,1610612744,Golden State Warriors,1,1,22,32,54,12,25,37,34,57,91,18,5,23,22,38,20,10,15,93,98
2016,2,21600578,1/10/2017,1610612744,Golden State Warriors,1,1,1610612748,Miami Heat,0,0,28,31,59,11,16,27,39,47,86,18,4,22,7,40,28,6,11,100,107
2016,2,21600578,1/10/2017,1610612748,Miami Heat,0,0,1610612744,Golden State Warriors,1,1,32,28,60,6,24,30,38,52,90,13,4,17,8,46,25,6,11,100,95
2014,2,21400789,2/11/2015,1610612737,Atlanta Hawks,0,0,1610612738,Boston Celtics,1,1,26,23,49,7,22,29,33,45,78,15,8,23,9,41,23,7,12,93,88
2014,2,21400789,2/11/2015,1610612738,Boston Celtics,1,1,1610612737,Atlanta Hawks,0,0,20,42,62,10,21,31,30,63,93,19,1,20,21,43,21,6,10,93,89
2021,2,22100200,11/15/2021,1610612758,Sacramento Kings,0,1,1610612765,Detroit Pistons,1,0,36,29,65,16,17,33,52,46,98,9,2,11,15,32,32,7,14,101,129
2021,2,22100200,11/15/2021,1610612765,Detroit Pistons,1,0,1610612758,Sacramento Kings,0,1,26,23,49,13,34,47,39,57,96,16,1,17,21,36,23,11,18,103,107
2018,2,21800465,12/19/2018,1610612757,Portland Trail Blazers,1,1,1610612763,Memphis Grizzlies,0,0,24,25,49,11,15,26,35,40,75,18,2,20,16,25,16,12,21,90,99
2018,2,21800465,12/19/2018,1610612763,Memphis Grizzlies,0,0,1610612757,Portland Trail Blazers,1,1,24,27,51,9,18,27,33,45,78,17,2,19,11,35,22,9,14,90,92
2018,2,21800330,12/1/2018,1610612749,Milwaukee Bucks,0,0,1610612752,New York Knicks,1,1,28,24,52,18,24,42,46,48,94,24,7,31,14,37,28,5,17,112,134
2018,2,21800330,12/1/2018,1610612752,New York Knicks,1,1,1610612749,Milwaukee Bucks,0,0,31,31,62,20,14,34,51,45,96,14,7,21,9,41,30,11,17,113,136
2018,2,21800272,11/23/2018,1610612754,Indiana Pacers,1,0,1610612759,San Antonio Spurs,0,1,43,32,75,3,21,24,46,53,99,5,4,9,15,40,31,3,12,100,100
2015,2,21500788,2/9/2016,1610612744,Golden State Warriors,1,1,1610612745,Houston Rockets,0,0,32,28,60,12,22,34,44,50,94,23,3,26,20,32,28,8,12,98,123
2015,2,21500788,2/9/2016,1610612745,Houston Rockets,0,0,1610612744,Golden State Warriors,1,1,24,30,54,13,20,33,37,50,87,23,12,35,16,39,24,5,12,99,110
2018,2,21800272,11/23/2018,1610612759,San Antonio Spurs,0,1,1610612754,Indiana Pacers,1,0,32,30,62,10,11,21,42,41,83,17,7,24,11,34,28,9,15,99,111
2020,2,22000903,4/23/2021,1610612743,Denver Nuggets,0,0,1610612744,Golden State Warriors,1,1,21,21,42,13,33,46,34,54,88,16,4,20,10,45,26,8,9,98,97
2020,2,22000903,4/23/2021,1610612744,Golden State Warriors,1,1,1610612743,Denver Nuggets,0,0,30,15,45,15,24,39,45,39,84,13,5,18,9,31,40,9,15,98,118
2018,2,21800115,11/1/2018,1610612738,Boston Celtics,1,1,1610612749,Milwaukee Bucks,0,0,17,20,37,24,31,55,41,51,92,11,2,13,13,38,30,8,13,100,117
2018,2,21800115,11/1/2018,1610612749,Milwaukee Bucks,0,0,1610612738,Boston Celtics,1,1,32,24,56,9,20,29,41,44,85,22,8,30,12,37,20,5,14,100,113
2017,2,21701218,4/10/2018,1610612745,Houston Rockets,0,1,1610612747,Los Angeles Lakers,1,0,21,20,41,16,31,47,37,51,88,15,1,16,11,40,19,14,19,103,105
2017,2,21701218,4/10/2018,1610612747,Los Angeles Lakers,1,0,1610612745,Houston Rockets,0,1,28,26,54,10,26,36,38,52,90,13,2,15,11,42,22,9,17,104,99
2016,2,21600129,11/12/2016,1610612740,New Orleans Pelicans,1,0,1610612747,Los Angeles Lakers,0,1,33,37,70,6,14,20,39,51,90,15,4,19,14,41,20,8,10,96,99
2016,2,21600129,11/12/2016,1610612747,Los Angeles Lakers,0,1,1610612740,New Orleans Pelicans,1,0,36,28,64,16,14,30,52,42,94,6,1,7,11,31,36,4,10,95,126
2014,2,21400788,2/11/2015,1610612752,New York Knicks,0,0,1610612753,Orlando Magic,1,1,20,38,58,5,10,15,25,48,73,28,8,36,12,38,19,6,12,91,83
2014,2,21400788,2/11/2015,1610612753,Orlando Magic,1,1,1610612752,New York Knicks,0,0,27,29,56,4,7,11,31,36,67,23,5,28,8,31,13,7,18,90,89
2018,2,21801010,3/12/2019,1610612740,New Orleans Pelicans,1,0,1610612749,Milwaukee Bucks,0,1,36,24,60,10,37,47,46,61,107,11,5,16,16,48,27,5,15,114,113
2018,2,21801010,3/12/2019,1610612749,Milwaukee Bucks,0,1,1610612740,New Orleans Pelicans,1,0,38,23,61,10,26,36,48,49,97,24,4,28,9,41,27,3,13,114,130
2018,2,21800877,2/22/2019,1610612737,Atlanta Hawks,1,0,1610612765,Detroit Pistons,0,1,23,23,46,20,22,42,43,45,88,16,3,19,13,35,21,11,18,102,122
2018,2,21800877,2/22/2019,1610612765,Detroit Pistons,0,1,1610612737,Atlanta Hawks,1,0,31,24,55,15,25,40,46,49,95,18,10,28,15,38,20,6,8,102,125
2018,2,21800778,2/2/2019,1610612749,Milwaukee Bucks,0,1,1610612764,Washington Wizards,1,0,28,24,52,17,22,39,45,46,91,24,0,24,10,36,30,6,12,105,131
2018,2,21800778,2/2/2019,1610612764,Washington Wizards,1,0,1610612749,Milwaukee Bucks,0,1,33,27,60,10,23,33,43,50,93,19,7,26,12,40,28,10,12,105,115
2018,2,21800692,1/21/2019,1610612739,Cleveland Cavaliers,1,0,1610612741,Chicago Bulls,0,1,25,35,60,6,21,27,31,56,87,20,9,29,18,43,16,8,14,96,88
2018,2,21800692,1/21/2019,1610612741,Chicago Bulls,0,1,1610612739,Cleveland Cavaliers,1,0,21,25,46,15,15,30,36,40,76,17,5,22,11,30,24,8,18,95,104
2021,2,22100199,11/15/2021,1610612738,Boston Celtics,0,1,1610612739,Cleveland Cavaliers,1,0,26,23,49,10,19,29,36,42,78,16,4,20,7,36,23,6,14,95,98
2021,2,22100199,11/15/2021,1610612739,Cleveland Cavaliers,1,0,1610612738,Boston Celtics,0,1,16,27,43,16,24,40,32,51,83,12,4,16,9,42,18,7,14,96,92
2018,2,21800618,1/10/2019,1610612743,Denver Nuggets,1,1,1610612746,LA Clippers,0,0,39,32,71,11,17,28,50,49,99,10,3,13,17,33,29,4,9,97,121
2018,2,21800618,1/10/2019,1610612746,LA Clippers,0,0,1610612743,Denver Nuggets,1,1,32,31,63,6,18,24,38,49,87,18,8,26,13,40,21,7,12,99,100
2018,2,21800538,12/30/2018,1610612741,Chicago Bulls,0,0,1610612761,Toronto Raptors,1,1,26,34,60,7,13,20,33,47,80,16,2,18,12,37,16,5,18,95,89
2018,2,21800538,12/30/2018,1610612761,Toronto Raptors,1,1,1610612741,Chicago Bulls,0,0,25,34,59,9,24,33,34,58,92,18,2,20,20,38,17,7,12,95,95
2018,2,21800464,12/19/2018,1610612744,Golden State Warriors,0,0,1610612762,Utah Jazz,1,1,28,36,64,10,21,31,38,57,95,17,1,18,12,45,18,7,12,103,103
2018,2,21800464,12/19/2018,1610612762,Utah Jazz,1,1,1610612744,Golden State Warriors,0,0,21,30,51,16,26,42,37,56,93,18,4,22,17,41,30,10,16,105,108
2020,2,22000902,4/23/2021,1610612760,Oklahoma City Thunder,1,0,1610612764,Washington Wizards,0,1,29,31,60,10,23,33,39,54,93,21,4,25,16,40,18,7,17,105,109
2020,2,22000902,4/23/2021,1610612764,Washington Wizards,0,1,1610612760,Oklahoma City Thunder,1,0,30,31,61,18,14,32,48,45,93,15,1,16,16,29,25,12,20,105,129
2018,2,21800116,11/1/2018,1610612740,New Orleans Pelicans,0,0,1610612757,Portland Trail Blazers,1,1,32,33,65,8,21,29,40,54,94,31,6,37,18,41,23,4,13,104,119
2018,2,21800116,11/1/2018,1610612757,Portland Trail Blazers,1,1,1610612740,New Orleans Pelicans,0,0,26,26,52,18,17,35,44,43,87,26,5,31,13,33,26,7,14,104,132
2016,2,21601135,3/31/2017,1610612759,San Antonio Spurs,0,1,1610612760,Oklahoma City Thunder,1,0,28,30,58,9,18,27,37,48,85,17,10,27,16,36,23,7,14,96,100
2016,2,21601135,3/31/2017,1610612760,Oklahoma City Thunder,1,0,1610612759,San Antonio Spurs,0,1,27,33,60,6,15,21,33,48,81,23,4,27,18,31,21,8,18,96,95
2019,2,21900045,10/28/2019,1610612745,Houston Rockets,1,1,1610612760,Oklahoma City Thunder,0,0,29,17,46,10,34,44,39,51,90,28,5,33,14,40,21,7,14,103,116
2019,2,21900045,10/28/2019,1610612760,Oklahoma City Thunder,0,0,1610612745,Houston Rockets,1,1,28,31,59,13,22,35,41,53,94,17,7,24,19,36,22,6,15,102,112
2016,2,21600577,1/10/2017,1610612747,Los Angeles Lakers,1,0,1610612757,Portland Trail Blazers,0,1,23,36,59,9,15,24,32,51,83,14,12,26,10,45,18,6,10,96,87
2016,2,21600577,1/10/2017,1610612757,Portland Trail Blazers,0,1,1610612747,Los Angeles Lakers,1,0,36,28,64,7,14,21,43,42,85,15,5,20,11,33,25,7,12,96,108
2018,2,21801158,4/1/2019,1610612742,Dallas Mavericks,1,1,1610612755,Philadelphia 76ers,0,0,34,31,65,12,20,32,46,51,97,18,9,27,12,44,29,2,9,105,122
2018,2,21801158,4/1/2019,1610612755,Philadelphia 76ers,0,0,1610612742,Dallas Mavericks,1,1,30,30,60,6,27,33,36,57,93,24,8,32,15,48,20,5,12,106,102
2014,2,21401221,4/15/2015,1610612738,Boston Celtics,0,1,1610612749,Milwaukee Bucks,1,0,29,26,55,13,17,30,42,43,85,8,6,14,11,35,37,7,17,96,105
2014,2,21401221,4/15/2015,1610612749,Milwaukee Bucks,1,0,1610612738,Boston Celtics,0,1,34,34,68,7,14,21,41,48,89,11,5,16,18,32,35,9,17,98,100
2018,2,21800876,2/22/2019,1610612759,San Antonio Spurs,0,0,1610612761,Toronto Raptors,1,1,31,21,52,12,25,37,43,46,89,19,3,22,11,35,27,8,14,101,117
2018,2,21800876,2/22/2019,1610612761,Toronto Raptors,1,1,1610612759,San Antonio Spurs,0,0,26,38,64,14,16,30,40,54,94,26,6,32,16,40,24,7,9,102,120
2021,2,22100198,11/14/2021,1610612741,Chicago Bulls,0,1,1610612746,LA Clippers,1,0,27,30,57,11,18,29,38,48,86,13,1,14,8,40,19,7,15,98,100
2021,2,22100198,11/14/2021,1610612746,LA Clippers,1,0,1610612741,Chicago Bulls,0,1,18,29,47,11,23,34,29,52,81,21,0,21,12,40,16,9,20,99,90
2015,2,21501203,4/11/2016,1610612737,Atlanta Hawks,0,0,1610612739,Cleveland Cavaliers,1,1,31,26,57,8,22,30,39,48,87,8,7,15,11,42,23,9,15,96,94
2015,2,21501203,4/11/2016,1610612739,Cleveland Cavaliers,1,1,1610612737,Atlanta Hawks,0,0,29,25,54,11,18,29,40,43,83,18,2,20,11,34,17,8,15,97,109
2018,2,21800393,12/10/2018,1610612738,Boston Celtics,1,1,1610612740,New Orleans Pelicans,0,0,32,19,51,12,27,39,44,46,90,13,6,19,18,33,23,11,15,98,113
2018,2,21800393,12/10/2018,1610612740,New Orleans Pelicans,0,0,1610612738,Boston Celtics,1,1,31,30,61,8,18,26,39,48,87,14,5,19,12,37,28,8,13,99,100
2017,2,21701173,4/4/2018,1610612740,New Orleans Pelicans,1,1,1610612763,Memphis Grizzlies,0,0,29,21,50,16,20,36,45,41,86,17,2,19,14,27,32,9,18,99,123
2017,2,21701173,4/4/2018,1610612763,Memphis Grizzlies,0,0,1610612740,New Orleans Pelicans,1,1,27,34,61,10,22,32,37,56,93,11,4,15,23,37,19,14,21,100,95
2016,2,21601134,3/31/2017,1610612762,Utah Jazz,1,1,1610612764,Washington Wizards,0,0,23,24,47,10,15,25,33,39,72,19,12,31,10,33,20,8,12,88,95
2016,2,21601134,3/31/2017,1610612764,Washington Wizards,0,0,1610612762,Utah Jazz,1,1,30,40,70,5,12,17,35,52,87,13,3,16,19,35,12,9,15,90,88
2019,2,21900269,11/29/2019,1610612753,Orlando Magic,1,0,1610612761,Toronto Raptors,0,1,20,29,49,7,22,29,27,51,78,22,5,27,17,37,17,16,24,96,83
2019,2,21900269,11/29/2019,1610612761,Toronto Raptors,0,1,1610612753,Orlando Magic,1,0,20,26,46,11,27,38,31,53,84,17,11,28,14,43,21,10,14,96,90
2014,2,21401220,4/15/2015,1610612754,Indiana Pacers,0,0,1610612763,Memphis Grizzlies,1,1,24,30,54,8,16,24,32,46,78,11,4,15,15,32,15,10,13,84,83
2014,2,21401220,4/15/2015,1610612763,Memphis Grizzlies,1,1,1610612754,Indiana Pacers,0,0,34,33,67,2,7,9,36,40,76,21,5,26,18,24,12,7,13,83,95
2021,2,22100197,11/14/2021,1610612743,Denver Nuggets,1,1,1610612757,Portland Trail Blazers,0,0,28,22,50,19,21,40,47,43,90,11,3,14,17,28,29,8,11,91,124
2021,2,22100197,11/14/2021,1610612757,Portland Trail Blazers,0,0,1610612743,Denver Nuggets,1,1,22,19,41,13,26,39,35,45,80,12,1,13,10,35,22,9,13,90,95
2018,2,21800329,11/30/2018,1610612743,Denver Nuggets,0,1,1610612757,Portland Trail Blazers,1,0,26,31,57,14,16,30,40,47,87,19,7,26,16,36,28,7,12,95,113
2018,2,21800329,11/30/2018,1610612757,Portland Trail Blazers,1,0,1610612743,Denver Nuggets,0,1,39,24,63,6,16,22,45,40,85,16,5,21,14,30,19,11,14,94,112
2017,2,21701172,4/4/2018,1610612737,Atlanta Hawks,1,0,1610612748,Miami Heat,0,1,24,36,60,9,21,30,33,57,90,11,6,17,14,47,20,9,16,99,86
2017,2,21701172,4/4/2018,1610612748,Miami Heat,0,1,1610612737,Atlanta Hawks,1,0,25,31,56,17,21,38,42,52,94,14,3,17,14,40,23,5,12,99,115
2017,2,21701115,3/27/2018,1610612746,LA Clippers,1,1,1610612749,Milwaukee Bucks,0,0,25,33,58,15,13,28,40,46,86,10,8,18,14,36,23,12,15,97,105
2017,2,21701115,3/27/2018,1610612749,Milwaukee Bucks,0,0,1610612746,LA Clippers,1,1,32,28,60,6,17,23,38,45,83,16,7,23,12,35,24,8,17,97,98
2016,2,21600576,1/10/2017,1610612739,Cleveland Cavaliers,0,0,1610612762,Utah Jazz,1,1,22,32,54,9,22,31,31,54,85,21,4,25,19,38,15,8,18,96,92
2016,2,21600576,1/10/2017,1610612762,Utah Jazz,1,1,1610612739,Cleveland Cavaliers,0,0,25,20,45,13,21,34,38,41,79,11,8,19,13,32,22,6,20,95,100
2018,2,21801157,4/1/2019,1610612750,Minnesota Timberwolves,1,0,1610612757,Portland Trail Blazers,0,1,36,31,67,11,18,29,47,49,96,17,2,19,15,35,29,6,9,100,122
2018,2,21801157,4/1/2019,1610612757,Portland Trail Blazers,0,1,1610612750,Minnesota Timberwolves,1,0,35,26,61,15,15,30,50,41,91,17,7,24,16,28,31,8,14,100,132
2018,2,21801009,3/12/2019,1610612741,Chicago Bulls,1,0,1610612747,Los Angeles Lakers,0,1,31,33,64,11,16,27,42,49,91,12,0,12,13,36,23,11,16,102,107
2018,2,21801009,3/12/2019,1610612747,Los Angeles Lakers,0,1,1610612741,Chicago Bulls,1,0,34,19,53,13,20,33,47,39,86,16,4,20,7,34,23,6,14,103,123
2014,2,21401219,4/15/2015,1610612745,Houston Rockets,1,1,1610612762,Utah Jazz,0,0,29,19,48,12,16,28,41,35,76,23,11,34,10,31,28,12,19,105,117
2014,2,21401219,4/15/2015,1610612762,Utah Jazz,0,0,1610612745,Houston Rockets,1,1,33,41,74,5,22,27,38,63,101,10,8,18,20,47,23,9,15,103,91
2015,2,21500837,2/22/2016,1610612747,Los Angeles Lakers,0,0,1610612749,Milwaukee Bucks,1,1,16,31,47,12,17,29,28,48,76,33,10,43,13,40,18,10,17,100,101
2015,2,21500837,2/22/2016,1610612749,Milwaukee Bucks,1,1,1610612747,Los Angeles Lakers,0,0,39,31,70,5,11,16,44,42,86,15,10,25,8,38,32,7,9,99,108
2020,2,22000901,4/23/2021,1610612745,Houston Rockets,1,0,1610612746,LA Clippers,0,1,23,24,47,13,29,42,36,53,89,19,3,22,10,45,24,8,14,104,104
2020,2,22000901,4/23/2021,1610612746,LA Clippers,0,1,1610612745,Houston Rockets,1,0,27,36,63,12,22,34,39,58,97,19,4,23,18,43,22,7,14,105,109
2016,2,21601133,3/31/2017,1610612748,Miami Heat,1,0,1610612752,New York Knicks,0,1,26,24,50,8,25,33,34,49,83,18,7,25,17,36,17,9,14,92,94
2016,2,21601133,3/31/2017,1610612752,New York Knicks,0,1,1610612748,Miami Heat,1,0,32,32,64,6,10,16,38,42,80,16,1,17,9,33,25,5,14,92,98
2019,2,21900268,11/29/2019,1610612765,Detroit Pistons,1,0,1610612766,Charlotte Hornets,0,1,26,22,48,15,20,35,41,42,83,10,10,20,19,27,27,8,14,88,107
2019,2,21900268,11/29/2019,1610612766,Charlotte Hornets,0,1,1610612765,Detroit Pistons,1,0,21,24,45,19,19,38,40,43,83,11,4,15,13,32,26,5,10,88,110
2016,2,21600575,1/10/2017,1610612749,Milwaukee Bucks,0,1,1610612759,San Antonio Spurs,1,0,34,31,65,10,9,19,44,40,84,11,2,13,12,29,32,5,12,90,109
2016,2,21600575,1/10/2017,1610612759,San Antonio Spurs,1,0,1610612749,Milwaukee Bucks,0,1,30,28,58,12,18,30,42,46,88,11,3,14,18,29,22,8,15,91,107
2014,2,21400787,2/10/2015,1610612743,Denver Nuggets,0,1,1610612747,Los Angeles Lakers,1,0,39,24,63,4,12,16,43,36,79,16,7,23,8,31,25,3,7,90,106
2014,2,21400787,2/10/2015,1610612747,Los Angeles Lakers,1,0,1610612743,Denver Nuggets,0,1,31,36,67,6,12,18,37,48,85,16,11,27,18,35,23,9,12,90,96
2021,2,22100196,11/14/2021,1610612751,Brooklyn Nets,0,1,1610612760,Oklahoma City Thunder,1,0,23,16,39,18,25,43,41,41,82,20,1,21,7,35,31,9,15,98,120
2021,2,22100196,11/14/2021,1610612760,Oklahoma City Thunder,1,0,1610612751,Brooklyn Nets,0,1,22,23,45,14,31,45,36,54,90,10,1,11,13,41,20,8,14,98,96
2018,2,21800777,2/2/2019,1610612751,Brooklyn Nets,0,0,1610612753,Orlando Magic,1,1,23,30,53,10,28,38,33,58,91,13,3,16,14,44,23,11,19,105,89
2018,2,21800777,2/2/2019,1610612753,Orlando Magic,1,1,1610612751,Brooklyn Nets,0,0,31,36,67,10,17,27,41,53,94,10,2,12,9,46,25,6,14,104,102
2018,2,21800537,12/30/2018,1610612748,Miami Heat,1,0,1610612750,Minnesota Timberwolves,0,1,29,37,66,8,16,24,37,53,90,22,6,28,25,32,19,11,20,98,104
2018,2,21800537,12/30/2018,1610612750,Minnesota Timberwolves,0,1,1610612748,Miami Heat,1,0,30,40,70,8,16,24,38,56,94,29,7,36,22,39,24,8,11,99,113
2018,2,21800392,12/10/2018,1610612755,Philadelphia 76ers,1,1,1610612765,Detroit Pistons,0,0,24,27,51,15,22,37,39,49,88,23,12,35,22,36,27,5,14,96,116
2018,2,21800392,12/10/2018,1610612765,Detroit Pistons,0,0,1610612755,Philadelphia 76ers,1,1,32,31,63,9,12,21,41,43,84,11,10,21,15,32,23,9,15,96,102
2018,2,21800219,11/16/2018,1610612751,Brooklyn Nets,0,1,1610612764,Washington Wizards,1,0,29,28,57,9,24,33,38,52,90,30,8,38,18,36,19,5,12,102,115
2018,2,21800219,11/16/2018,1610612764,Washington Wizards,1,0,1610612751,Brooklyn Nets,0,1,34,35,69,3,15,18,37,50,87,27,7,34,15,38,18,8,13,102,104
2018,2,21800165,11/8/2018,1610612746,LA Clippers,0,0,1610612757,Portland Trail Blazers,1,1,33,33,66,8,15,23,41,48,89,15,5,20,10,40,19,4,7,96,105
2018,2,21800165,11/8/2018,1610612757,Portland Trail Blazers,1,1,1610612746,LA Clippers,0,0,30,41,71,10,16,26,40,57,97,26,2,28,21,37,18,2,7,97,116
2016,2,21601132,3/31/2017,1610612740,New Orleans Pelicans,1,1,1610612758,Sacramento Kings,0,0,36,26,62,10,23,33,46,49,95,15,4,19,13,39,28,7,12,101,117
2016,2,21601132,3/31/2017,1610612758,Sacramento Kings,0,0,1610612740,New Orleans Pelicans,1,1,29,41,70,6,14,20,35,55,90,13,4,17,18,38,18,16,21,102,89
2019,2,21900044,10/28/2019,1610612753,Orlando Magic,0,0,1610612761,Toronto Raptors,1,1,22,28,50,12,27,39,34,55,89,15,3,18,9,47,22,9,16,104,95
2019,2,21900044,10/28/2019,1610612761,Toronto Raptors,1,1,1610612753,Orlando Magic,0,0,23,23,46,10,29,39,33,52,85,28,2,30,11,41,19,9,17,104,104
2018,2,21801156,4/1/2019,1610612753,Orlando Magic,0,0,1610612761,Toronto Raptors,1,1,31,29,60,12,21,33,43,50,93,11,4,15,15,37,32,9,13,99,109
2016,2,21600128,11/11/2016,1610612757,Portland Trail Blazers,1,1,1610612758,Sacramento Kings,0,0,32,21,53,13,20,33,45,41,86,19,8,27,9,36,29,7,13,103,122
2016,2,21600128,11/11/2016,1610612758,Sacramento Kings,0,0,1610612757,Portland Trail Blazers,1,1,37,30,67,6,15,21,43,45,88,28,7,35,18,30,18,8,15,103,120
2018,2,21801156,4/1/2019,1610612761,Toronto Raptors,1,1,1610612753,Orlando Magic,0,0,23,24,47,19,18,37,42,42,84,18,4,22,8,36,31,7,14,99,121
2018,2,21801008,3/12/2019,1610612739,Cleveland Cavaliers,0,0,1610612755,Philadelphia 76ers,1,1,27,36,63,13,25,38,40,61,101,6,2,8,13,49,14,4,8,101,99
2018,2,21801008,3/12/2019,1610612755,Philadelphia 76ers,1,1,1610612739,Cleveland Cavaliers,0,0,34,28,62,8,15,23,42,43,85,14,3,17,16,28,25,8,22,100,106
2018,2,21800462,12/19/2018,1610612740,New Orleans Pelicans,0,0,1610612749,Milwaukee Bucks,1,1,24,26,50,19,23,42,43,49,92,10,5,15,11,39,28,11,15,104,115
2018,2,21800462,12/19/2018,1610612749,Milwaukee Bucks,1,1,1610612740,New Orleans Pelicans,0,0,30,22,52,13,20,33,43,42,85,24,6,30,10,34,26,6,14,103,123
2018,2,21800271,11/23/2018,1610612761,Toronto Raptors,1,1,1610612764,Washington Wizards,0,0,29,25,54,17,22,39,46,47,93,16,3,19,17,32,32,8,15,101,125
2018,2,21800271,11/23/2018,1610612764,Washington Wizards,0,0,1610612761,Toronto Raptors,1,1,31,23,54,9,37,46,40,60,100,18,1,19,20,40,28,5,13,100,107
2018,2,21800164,11/8/2018,1610612738,Boston Celtics,0,1,1610612756,Phoenix Suns,1,0,25,35,60,14,23,37,39,58,97,24,7,31,20,41,21,10,16,108,116
2018,2,21800164,11/8/2018,1610612756,Phoenix Suns,1,0,1610612738,Boston Celtics,0,1,30,28,58,11,24,35,41,52,93,16,3,19,8,46,25,6,15,110,109
2016,2,21600574,1/10/2017,1610612745,Houston Rockets,1,1,1610612766,Charlotte Hornets,0,0,23,20,43,17,22,39,40,42,82,24,9,33,8,38,25,3,10,98,121
2016,2,21600574,1/10/2017,1610612766,Charlotte Hornets,0,0,1610612745,Houston Rockets,1,1,25,24,49,19,24,43,44,48,92,7,2,9,10,39,30,8,11,100,114
2016,2,21600127,11/11/2016,1610612759,San Antonio Spurs,1,1,1610612765,Detroit Pistons,0,0,27,34,61,9,11,20,36,45,81,15,4,19,13,35,24,2,8,85,96
2016,2,21600127,11/11/2016,1610612765,Detroit Pistons,0,0,1610612759,San Antonio Spurs,1,1,27,24,51,5,20,25,32,44,76,17,4,21,11,35,14,8,13,86,86
2014,2,21400786,2/10/2015,1610612751,Brooklyn Nets,0,0,1610612763,Memphis Grizzlies,1,1,32,37,69,3,9,12,35,46,81,13,4,17,16,34,14,14,20,91,86
2014,2,21400786,2/10/2015,1610612763,Memphis Grizzlies,1,1,1610612751,Brooklyn Nets,0,0,30,32,62,6,13,19,36,45,81,17,8,25,15,34,24,7,12,90,95
2019,2,21900267,11/29/2019,1610612738,Boston Celtics,0,0,1610612751,Brooklyn Nets,1,1,32,33,65,9,19,28,41,52,93,16,5,21,18,38,16,9,19,102,107
2019,2,21900267,11/29/2019,1610612751,Brooklyn Nets,1,1,1610612738,Boston Celtics,0,0,26,26,52,17,24,41,43,50,93,9,4,13,17,34,30,11,20,103,112
2018,2,21800776,2/2/2019,1610612741,Chicago Bulls,0,0,1610612766,Charlotte Hornets,1,1,33,24,57,9,15,24,42,39,81,25,0,25,10,29,20,6,10,92,118
2018,2,21800776,2/2/2019,1610612766,Charlotte Hornets,1,1,1610612741,Chicago Bulls,0,0,29,21,50,14,18,32,43,39,82,25,4,29,10,32,25,4,7,92,125
2015,2,21501202,4/10/2016,1610612752,New York Knicks,1,0,1610612761,Toronto Raptors,0,1,25,44,69,7,13,20,32,57,89,18,3,21,26,33,14,4,9,84,89
2015,2,21501202,4/10/2016,1610612761,Toronto Raptors,0,1,1610612752,New York Knicks,1,0,30,28,58,7,13,20,37,41,78,12,7,19,10,34,19,4,7,83,93
2018,2,21800691,1/21/2019,1610612752,New York Knicks,1,0,1610612760,Oklahoma City Thunder,0,1,32,32,64,7,16,23,39,48,87,24,8,32,13,39,25,7,12,101,109
2018,2,21800691,1/21/2019,1610612760,Oklahoma City Thunder,0,1,1610612752,New York Knicks,1,0,30,24,54,15,14,29,45,38,83,22,5,27,13,29,26,8,19,102,127
2018,2,21800463,12/19/2018,1610612750,Minnesota Timberwolves,1,0,1610612765,Detroit Pistons,0,1,36,34,70,9,24,33,45,58,103,24,5,29,17,43,22,3,7,107,123
2018,2,21800463,12/19/2018,1610612765,Detroit Pistons,0,1,1610612750,Minnesota Timberwolves,1,0,26,20,46,20,28,48,46,48,94,17,11,28,12,41,26,8,13,107,129
2018,2,21800328,11/30/2018,1610612742,Dallas Mavericks,0,0,1610612747,Los Angeles Lakers,1,1,24,23,47,10,29,39,34,52,86,25,9,34,12,43,20,8,16,107,103
2018,2,21800328,11/30/2018,1610612747,Los Angeles Lakers,1,1,1610612742,Dallas Mavericks,0,0,33,23,56,9,21,30,42,44,86,21,11,32,11,37,23,9,18,107,114
2017,2,21701194,4/7/2018,1610612745,Houston Rockets,1,0,1610612760,Oklahoma City Thunder,0,1,22,17,39,14,23,37,36,40,76,16,7,23,11,31,23,11,18,96,102
2017,2,21701194,4/7/2018,1610612760,Oklahoma City Thunder,0,1,1610612745,Houston Rockets,1,0,26,32,58,10,23,33,36,55,91,26,7,33,19,36,21,7,11,96,108
2017,2,21701151,4/1/2018,1610612750,Minnesota Timberwolves,1,0,1610612762,Utah Jazz,0,1,30,36,66,8,16,24,38,52,90,13,1,14,12,41,19,8,14,98,97
2017,2,21701151,4/1/2018,1610612762,Utah Jazz,0,1,1610612750,Minnesota Timberwolves,1,0,35,13,48,11,17,28,46,30,76,18,7,25,7,27,29,10,17,98,121
2016,2,21601131,3/31/2017,1610612742,Dallas Mavericks,0,0,1610612763,Memphis Grizzlies,1,1,17,25,42,12,22,34,29,47,76,20,5,25,8,41,15,4,9,90,90
2016,2,21601131,3/31/2017,1610612763,Memphis Grizzlies,1,1,1610612742,Dallas Mavericks,0,0,24,24,48,11,16,27,35,40,75,18,2,20,10,32,23,7,14,89,99
2018,2,21800875,2/22/2019,1610612741,Chicago Bulls,0,1,1610612753,Orlando Magic,1,0,28,33,61,12,17,29,40,50,90,18,1,19,9,41,18,4,8,97,110
2018,2,21800875,2/22/2019,1610612753,Orlando Magic,1,0,1610612741,Chicago Bulls,0,1,27,20,47,14,20,34,41,40,81,13,11,24,10,34,25,8,14,97,109
2018,2,21800616,1/9/2019,1610612747,Los Angeles Lakers,1,1,1610612765,Detroit Pistons,0,0,38,21,59,8,15,23,46,36,82,13,5,18,11,27,30,8,15,93,113
2018,2,21800616,1/9/2019,1610612765,Detroit Pistons,0,0,1610612747,Los Angeles Lakers,1,1,25,17,42,14,30,44,39,47,86,8,6,14,10,39,23,5,11,93,100
2018,2,21800391,12/10/2018,1610612754,Indiana Pacers,1,1,1610612764,Washington Wizards,0,0,31,25,56,10,10,20,41,35,76,17,5,22,10,28,29,13,24,102,109
2018,2,21800391,12/10/2018,1610612764,Washington Wizards,0,0,1610612754,Indiana Pacers,1,1,27,31,58,10,20,30,37,51,88,17,7,24,12,43,22,7,12,102,101
2018,2,21800327,11/30/2018,1610612753,Orlando Magic,0,1,1610612756,Phoenix Suns,1,0,31,24,55,8,19,27,39,43,82,13,5,18,11,33,23,5,12,91,99
2018,2,21800327,11/30/2018,1610612756,Phoenix Suns,1,0,1610612753,Orlando Magic,0,1,27,29,56,7,21,28,34,50,84,10,4,14,12,40,22,7,13,92,85
2018,2,21800270,11/23/2018,1610612739,Cleveland Cavaliers,0,1,1610612755,Philadelphia 76ers,1,0,38,33,71,11,11,22,49,44,93,12,4,16,18,28,16,5,9,92,121
2018,2,21800270,11/23/2018,1610612755,Philadelphia 76ers,1,0,1610612739,Cleveland Cavaliers,0,1,28,14,42,12,21,33,40,35,75,20,6,26,6,31,27,7,10,92,112
2020,2,22000900,4/23/2021,1610612739,Cleveland Cavaliers,0,0,1610612766,Charlotte Hornets,1,1,31,19,50,10,20,30,41,39,80,10,4,14,16,25,27,7,17,90,102
2020,2,22000900,4/23/2021,1610612766,Charlotte Hornets,1,1,1610612739,Cleveland Cavaliers,0,0,26,28,54,14,26,40,40,54,94,14,4,18,17,40,26,4,5,90,108
2017,2,21701195,4/7/2018,1610612740,New Orleans Pelicans,0,1,1610612744,Golden State Warriors,1,0,38,22,60,11,16,27,49,38,87,17,5,22,5,36,39,3,8,100,126
2017,2,21701195,4/7/2018,1610612744,Golden State Warriors,1,0,1610612740,New Orleans Pelicans,0,1,34,23,57,15,18,33,49,41,90,7,4,11,10,33,31,15,17,101,120
2017,2,21701152,4/1/2018,1610612743,Denver Nuggets,1,1,1610612749,Milwaukee Bucks,0,0,29,25,54,11,25,36,40,50,90,37,9,46,19,36,27,9,17,108,128
2017,2,21701152,4/1/2018,1610612749,Milwaukee Bucks,0,0,1610612743,Denver Nuggets,1,1,33,34,67,12,21,33,45,55,100,23,4,27,14,42,27,2,9,108,125
2017,2,21701132,3/30/2018,1610612745,Houston Rockets,1,1,1610612756,Phoenix Suns,0,0,21,22,43,14,24,38,35,46,81,20,9,29,9,41,22,8,10,95,104
2017,2,21701132,3/30/2018,1610612756,Phoenix Suns,0,0,1610612745,Houston Rockets,1,1,29,23,52,12,20,32,41,43,84,9,4,13,13,32,23,9,18,96,103
2017,2,21701071,3/21/2018,1610612759,San Antonio Spurs,1,1,1610612764,Washington Wizards,0,0,32,24,56,7,16,23,39,40,79,13,5,18,14,28,21,11,15,89,98
2017,2,21701071,3/21/2018,1610612764,Washington Wizards,0,0,1610612759,San Antonio Spurs,1,1,27,31,58,8,17,25,35,48,83,12,4,16,16,32,27,7,14,89,90
2016,2,21600126,11/11/2016,1610612746,LA Clippers,0,1,1610612760,Oklahoma City Thunder,1,0,28,31,59,11,16,27,39,47,86,21,14,35,15,40,18,3,10,100,110
2016,2,21600126,11/11/2016,1610612760,Oklahoma City Thunder,1,0,1610612746,LA Clippers,0,1,22,38,60,16,12,28,38,50,88,16,3,19,15,36,21,9,17,99,108
2014,2,21400785,2/10/2015,1610612741,Chicago Bulls,1,1,1610612758,Sacramento Kings,0,0,35,25,60,7,13,20,42,38,80,13,2,15,7,32,26,3,7,88,104
2014,2,21400785,2/10/2015,1610612758,Sacramento Kings,0,0,1610612741,Chicago Bulls,1,1,33,30,63,2,10,12,35,40,75,14,13,27,15,32,23,8,13,86,86
2019,2,21900266,11/27/2019,1610612741,Chicago Bulls,0,0,1610612744,Golden State Warriors,1,1,24,36,60,10,19,29,34,55,89,12,6,18,17,42,20,12,18,100,90
2019,2,21900266,11/27/2019,1610612744,Golden State Warriors,1,1,1610612741,Chicago Bulls,0,0,26,26,52,11,18,29,37,44,81,19,7,26,15,31,31,14,21,99,104
2021,2,22100195,11/14/2021,1610612745,Houston Rockets,1,0,1610612756,Phoenix Suns,0,1,28,25,53,7,25,32,35,50,85,12,6,18,12,42,19,16,23,102,89
2021,2,22100195,11/14/2021,1610612756,Phoenix Suns,0,1,1610612745,Houston Rockets,1,0,28,29,57,14,26,40,42,55,97,17,3,20,16,42,19,7,10,101,115
2018,2,21801155,4/1/2019,1610612741,Chicago Bulls,0,0,1610612752,New York Knicks,1,1,38,39,77,4,13,17,42,52,94,17,6,23,17,39,20,2,7,96,105
2018,2,21801155,4/1/2019,1610612752,New York Knicks,1,1,1610612741,Chicago Bulls,0,0,19,17,36,18,20,38,37,37,74,21,4,25,9,32,24,9,17,95,113
2018,2,21800617,1/10/2019,1610612738,Boston Celtics,0,0,1610612748,Miami Heat,1,1,24,31,55,12,22,34,36,53,89,15,2,17,13,41,20,7,11,95,99
2018,2,21800617,1/10/2019,1610612748,Miami Heat,1,1,1610612738,Boston Celtics,0,0,28,29,57,18,21,39,46,50,96,5,3,8,15,35,33,5,9,96,115
2018,2,21800536,12/30/2018,1610612753,Orlando Magic,1,1,1610612765,Detroit Pistons,0,0,33,28,61,7,17,24,40,45,85,22,2,24,11,35,21,6,13,97,109
2018,2,21800536,12/30/2018,1610612765,Detroit Pistons,0,0,1610612753,Orlando Magic,1,1,31,30,61,8,23,31,39,53,92,21,2,23,19,36,21,7,13,96,107
2018,2,21800112,11/1/2018,1610612739,Cleveland Cavaliers,1,0,1610612743,Denver Nuggets,0,1,29,36,65,5,13,18,34,49,83,18,1,19,17,32,18,8,14,88,91
2018,2,21800112,11/1/2018,1610612743,Denver Nuggets,0,1,1610612739,Cleveland Cavaliers,1,0,31,28,59,10,16,26,41,44,85,18,3,21,19,26,22,11,12,88,110
2016,2,21601130,3/31/2017,1610612749,Milwaukee Bucks,1,1,1610612765,Detroit Pistons,0,0,21,27,48,14,22,36,35,49,84,24,10,34,13,42,25,8,12,100,108
2016,2,21601130,3/31/2017,1610612765,Detroit Pistons,0,0,1610612749,Milwaukee Bucks,1,1,37,30,67,7,23,30,44,53,97,10,6,16,17,40,25,6,12,101,105
2016,2,21600573,1/10/2017,1610612737,Atlanta Hawks,0,1,1610612751,Brooklyn Nets,1,0,37,32,69,7,16,23,44,48,92,22,16,38,21,34,25,5,12,101,117
2016,2,21600573,1/10/2017,1610612751,Brooklyn Nets,1,0,1610612737,Atlanta Hawks,0,1,25,33,58,10,19,29,35,52,87,17,6,23,17,38,22,11,18,99,97
2018,2,21801007,3/12/2019,1610612752,New York Knicks,0,0,1610612754,Indiana Pacers,1,1,22,30,52,13,15,28,35,45,80,15,3,18,12,35,22,11,19,96,98
2018,2,21801007,3/12/2019,1610612754,Indiana Pacers,1,1,1610612752,New York Knicks,0,0,29,28,57,8,20,28,37,48,85,21,8,29,13,41,26,4,10,95,103
2018,2,21800217,11/16/2018,1610612748,Miami Heat,0,0,1610612754,Indiana Pacers,1,1,21,36,57,14,22,36,35,58,93,7,3,10,15,45,21,10,18,100,91
2018,2,21800217,11/16/2018,1610612754,Indiana Pacers,1,1,1610612748,Miami Heat,0,0,22,32,54,14,13,27,36,45,81,13,2,15,6,40,22,10,19,101,99
2020,2,22000899,4/23/2021,1610612738,Boston Celtics,0,0,1610612751,Brooklyn Nets,1,1,21,31,52,17,25,42,38,56,94,11,5,16,18,42,21,12,19,102,104
2020,2,22000899,4/23/2021,1610612751,Brooklyn Nets,1,1,1610612738,Boston Celtics,0,0,26,28,54,11,21,32,37,49,86,24,4,28,8,42,26,6,11,102,109
2017,2,21701099,3/25/2018,1610612738,Boston Celtics,0,1,1610612758,Sacramento Kings,1,0,28,22,50,12,10,22,40,32,72,12,5,17,6,27,23,7,16,90,104
2017,2,21701099,3/25/2018,1610612758,Sacramento Kings,1,0,1610612738,Boston Celtics,0,1,31,25,56,7,19,26,38,44,82,10,0,10,12,32,18,9,14,92,93
2016,2,21600125,11/11/2016,1610612738,Boston Celtics,1,1,1610612752,New York Knicks,0,0,24,39,63,11,16,27,35,55,90,34,9,43,22,38,23,7,16,101,115
2016,2,21600125,11/11/2016,1610612752,New York Knicks,0,0,1610612738,Boston Celtics,1,1,27,44,71,6,17,23,33,61,94,15,2,17,26,37,19,16,25,101,87
2019,2,21900043,10/28/2019,1610612737,Atlanta Hawks,1,0,1610612755,Philadelphia 76ers,0,1,27,30,57,9,18,27,36,48,84,22,10,32,15,38,23,12,21,104,103
2019,2,21900043,10/28/2019,1610612755,Philadelphia 76ers,0,1,1610612737,Atlanta Hawks,1,0,26,21,47,11,30,41,37,51,88,20,5,25,16,38,22,12,22,105,105
2021,2,22100194,11/14/2021,1610612744,Golden State Warriors,0,0,1610612766,Charlotte Hornets,1,1,29,22,51,9,30,39,38,52,90,17,8,25,15,41,31,10,15,100,102
2021,2,22100194,11/14/2021,1610612766,Charlotte Hornets,1,1,1610612744,Golden State Warriors,0,0,28,24,52,14,22,36,42,46,88,8,4,12,7,41,23,8,13,99,106
2018,2,21801154,4/1/2019,1610612749,Milwaukee Bucks,0,1,1610612751,Brooklyn Nets,1,0,36,24,60,11,23,34,47,47,94,26,4,30,8,42,28,6,15,112,131
2018,2,21801154,4/1/2019,1610612751,Brooklyn Nets,1,0,1610612749,Milwaukee Bucks,0,1,23,27,50,16,28,44,39,55,94,27,7,34,21,36,19,15,23,111,121
2018,2,21801006,3/11/2019,1610612738,Boston Celtics,0,0,1610612746,LA Clippers,1,1,30,25,55,14,22,36,44,47,91,13,6,19,10,39,26,4,13,105,115
2018,2,21801006,3/11/2019,1610612746,LA Clippers,1,1,1610612738,Boston Celtics,0,0,40,18,58,13,15,28,53,33,86,21,4,25,11,24,29,11,20,104,140
2018,2,21800874,2/22/2019,1610612740,New Orleans Pelicans,0,0,1610612754,Indiana Pacers,1,1,35,31,66,8,19,27,43,50,93,17,13,30,18,39,25,10,17,104,111
2018,2,21800874,2/22/2019,1610612754,Indiana Pacers,1,1,1610612740,New Orleans Pelicans,0,0,30,31,61,14,18,32,44,49,93,24,11,35,15,39,28,5,11,103,126
2018,2,21800775,2/2/2019,1610612746,LA Clippers,0,1,1610612765,Detroit Pistons,1,0,30,32,62,10,10,20,40,42,82,21,13,34,13,34,22,6,12,98,111
2018,2,21800775,2/2/2019,1610612765,Detroit Pistons,1,0,1610612746,LA Clippers,0,1,18,23,41,17,25,42,35,48,83,14,6,20,11,41,21,5,15,98,101
2018,2,21800690,1/20/2019,1610612746,LA Clippers,0,1,1610612759,San Antonio Spurs,1,0,28,36,64,11,10,21,39,46,85,14,10,24,8,42,23,6,12,99,103
2018,2,21800690,1/20/2019,1610612759,San Antonio Spurs,1,0,1610612746,LA Clippers,0,1,31,34,65,8,11,19,39,45,84,9,8,17,11,38,21,11,18,100,95
2018,2,21800461,12/19/2018,1610612745,Houston Rockets,1,1,1610612764,Washington Wizards,0,0,21,9,30,26,29,55,47,38,85,16,5,21,9,32,30,8,17,102,136
2018,2,21800461,12/19/2018,1610612764,Washington Wizards,0,0,1610612745,Houston Rockets,1,1,35,19,54,10,20,30,45,39,84,18,5,23,4,37,28,8,11,103,118
2018,2,21800390,12/9/2018,1610612759,San Antonio Spurs,1,1,1610612762,Utah Jazz,0,0,42,33,75,5,9,14,47,42,89,11,1,12,11,32,26,8,11,95,110
2018,2,21800390,12/9/2018,1610612762,Utah Jazz,0,0,1610612759,San Antonio Spurs,1,1,28,28,56,9,20,29,37,48,85,14,5,19,14,38,23,7,16,95,97
2018,2,21800269,11/23/2018,1610612740,New Orleans Pelicans,0,0,1610612752,New York Knicks,1,1,33,40,73,7,21,28,40,61,101,22,7,29,29,36,26,9,14,102,109
2018,2,21800269,11/23/2018,1610612752,New York Knicks,1,1,1610612740,New Orleans Pelicans,0,0,29,29,58,12,21,33,41,50,91,20,7,27,14,37,22,5,9,101,114
2018,2,21800218,11/16/2018,1610612755,Philadelphia 76ers,1,1,1610612762,Utah Jazz,0,0,30,28,58,11,12,23,41,40,81,20,12,32,14,33,25,10,18,99,113
2018,2,21800218,11/16/2018,1610612762,Utah Jazz,0,0,1610612755,Philadelphia 76ers,1,1,37,29,66,4,18,22,41,47,88,21,16,37,17,34,15,7,13,101,107
2018,2,21800113,11/1/2018,1610612746,LA Clippers,0,0,1610612755,Philadelphia 76ers,1,1,29,34,63,9,14,23,38,48,86,28,5,33,14,35,19,7,18,105,113
2018,2,21800113,11/1/2018,1610612755,Philadelphia 76ers,1,1,1610612746,LA Clippers,0,0,31,35,66,13,14,27,44,49,93,21,7,28,14,39,29,6,16,105,122
2016,2,21600571,1/10/2017,1610612741,Chicago Bulls,0,0,1610612764,Washington Wizards,1,1,25,36,61,10,17,27,35,53,88,19,2,21,16,38,19,8,18,100,99
2016,2,21600571,1/10/2017,1610612764,Washington Wizards,1,1,1610612741,Chicago Bulls,0,0,31,30,61,11,11,22,42,41,83,6,3,9,8,35,24,10,21,100,101
2014,2,21400784,2/10/2015,1610612745,Houston Rockets,0,1,1610612756,Phoenix Suns,1,0,33,25,58,15,22,37,48,47,95,16,7,23,19,30,28,9,14,101,127
2014,2,21400784,2/10/2015,1610612756,Phoenix Suns,1,0,1610612745,Houston Rockets,0,1,29,32,61,12,14,26,41,46,87,24,6,30,14,36,18,9,14,101,118
2019,2,21900265,11/27/2019,1610612757,Portland Trail Blazers,1,1,1610612760,Oklahoma City Thunder,0,0,35,29,64,14,16,30,49,45,94,24,0,24,11,34,23,4,9,101,136
2019,2,21900265,11/27/2019,1610612760,Oklahoma City Thunder,0,0,1610612757,Portland Trail Blazers,1,1,28,25,53,11,24,35,39,49,88,30,8,38,9,46,19,3,6,102,119
2018,2,21801005,3/11/2019,1610612760,Oklahoma City Thunder,0,1,1610612762,Utah Jazz,1,0,29,28,57,7,15,22,36,43,79,19,8,27,11,38,18,12,16,97,98
2018,2,21801005,3/11/2019,1610612762,Utah Jazz,1,0,1610612760,Oklahoma City Thunder,0,1,19,26,45,13,30,43,32,56,88,12,5,17,13,45,22,8,14,97,89
2018,2,21800535,12/29/2018,1610612746,LA Clippers,1,0,1610612759,San Antonio Spurs,0,1,27,35,62,9,11,20,36,46,82,30,8,38,9,41,22,10,18,108,111
2018,2,21800535,12/29/2018,1610612759,San Antonio Spurs,0,1,1610612746,LA Clippers,1,0,38,26,64,6,17,23,44,43,87,28,3,31,9,35,27,9,16,108,122
2018,2,21800460,12/19/2018,1610612741,Chicago Bulls,1,0,1610612751,Brooklyn Nets,0,1,34,38,72,6,13,19,40,51,91,7,3,10,13,38,21,3,9,91,93
2018,2,21800460,12/19/2018,1610612751,Brooklyn Nets,0,1,1610612741,Chicago Bulls,1,0,26,23,49,8,17,25,34,40,74,20,5,25,9,32,23,7,14,93,96
2020,2,22000898,4/23/2021,1610612737,Atlanta Hawks,1,1,1610612748,Miami Heat,0,0,28,17,45,15,20,35,43,37,80,17,2,19,11,27,24,10,14,91,118
2020,2,22000898,4/23/2021,1610612748,Miami Heat,0,0,1610612737,Atlanta Hawks,1,1,25,17,42,13,24,37,38,41,79,14,2,16,9,32,24,12,13,92,103
2017,2,21701133,3/30/2018,1610612743,Denver Nuggets,0,1,1610612760,Oklahoma City Thunder,1,0,39,25,64,10,20,30,49,45,94,18,3,21,14,33,27,13,15,105,126
2017,2,21701133,3/30/2018,1610612760,Oklahoma City Thunder,1,0,1610612743,Denver Nuggets,0,1,25,39,64,20,24,44,45,63,108,15,12,27,22,49,25,4,8,107,125
2017,2,21701114,3/27/2018,1610612744,Golden State Warriors,1,0,1610612754,Indiana Pacers,0,1,30,39,69,5,12,17,35,51,86,6,3,9,19,34,21,10,17,89,81
2017,2,21701114,3/27/2018,1610612754,Indiana Pacers,0,1,1610612744,Golden State Warriors,1,0,33,27,60,6,15,21,39,42,81,8,4,12,10,35,22,4,12,88,92
2017,2,21701084,3/23/2018,1610612748,Miami Heat,0,0,1610612760,Oklahoma City Thunder,1,1,21,36,57,13,17,30,34,53,87,18,2,20,14,40,22,7,12,96,99
2016,2,21601129,3/31/2017,1610612738,Boston Celtics,1,1,1610612753,Orlando Magic,0,0,26,25,51,12,21,33,38,46,84,29,5,34,9,40,27,9,11,103,117
2016,2,21601129,3/31/2017,1610612753,Orlando Magic,0,0,1610612738,Boston Celtics,1,1,28,40,68,12,18,30,40,58,98,24,1,25,16,43,28,6,9,102,116
2016,2,21600572,1/10/2017,1610612738,Boston Celtics,0,0,1610612761,Toronto Raptors,1,1,31,27,58,9,18,27,40,45,85,17,3,20,12,35,21,9,15,97,106
2016,2,21600572,1/10/2017,1610612761,Toronto Raptors,1,1,1610612738,Boston Celtics,0,0,31,34,65,10,12,22,41,46,87,22,5,27,21,29,17,7,18,97,114
2014,2,21400782,2/9/2015,1610612743,Denver Nuggets,1,0,1610612760,Oklahoma City Thunder,0,1,33,26,59,9,19,28,42,45,87,21,8,29,14,34,20,4,11,99,114
2014,2,21400782,2/9/2015,1610612760,Oklahoma City Thunder,0,1,1610612743,Denver Nuggets,1,0,31,25,56,12,12,24,43,37,80,26,9,35,12,27,24,7,13,98,124
2021,2,22100193,11/14/2021,1610612737,Atlanta Hawks,1,1,1610612749,Milwaukee Bucks,0,0,32,30,62,15,20,35,47,50,97,11,2,13,21,29,21,8,13,96,120
2021,2,22100193,11/14/2021,1610612749,Milwaukee Bucks,0,0,1610612737,Atlanta Hawks,1,1,24,19,43,14,27,41,38,46,84,10,6,16,8,40,24,6,11,96,100
2018,2,21800873,2/22/2019,1610612764,Washington Wizards,0,0,1610612766,Charlotte Hornets,1,1,32,26,58,10,29,39,42,55,97,16,2,18,13,43,24,7,13,104,110
2018,2,21800873,2/22/2019,1610612766,Charlotte Hornets,1,1,1610612764,Washington Wizards,0,0,33,30,63,13,20,33,46,50,96,18,4,22,15,35,26,6,14,105,123
2018,2,21800689,1/20/2019,1610612750,Minnesota Timberwolves,1,1,1610612756,Phoenix Suns,0,0,33,34,67,6,18,24,39,52,91,32,8,40,20,36,22,9,17,106,116
2018,2,21800689,1/20/2019,1610612756,Phoenix Suns,0,0,1610612750,Minnesota Timberwolves,1,1,28,19,47,12,27,39,40,46,86,22,10,32,13,35,22,8,16,107,114
2015,2,21501201,4/10/2016,1610612744,Golden State Warriors,0,1,1610612759,San Antonio Spurs,1,0,24,26,50,10,17,27,34,43,77,14,4,18,10,37,19,10,13,90,92
2015,2,21501201,4/10/2016,1610612759,San Antonio Spurs,1,0,1610612744,Golden State Warriors,0,1,31,42,73,3,14,17,34,56,90,15,4,19,19,41,21,7,12,90,86
2018,2,21800326,11/30/2018,1610612745,Houston Rockets,0,1,1610612759,San Antonio Spurs,1,0,27,17,44,22,32,54,49,49,98,16,4,20,15,37,32,4,6,99,136
2018,2,21800326,11/30/2018,1610612759,San Antonio Spurs,1,0,1610612745,Houston Rockets,0,1,29,29,58,10,18,28,39,47,86,17,3,20,12,37,24,9,13,97,105
2017,2,21701215,4/10/2018,1610612738,Boston Celtics,0,0,1610612764,Washington Wizards,1,1,20,34,54,13,20,33,33,54,87,22,5,27,16,42,22,8,17,101,101
2017,2,21701215,4/10/2018,1610612764,Washington Wizards,1,1,1610612738,Boston Celtics,0,0,26,27,53,15,15,30,41,42,83,16,4,20,11,33,32,14,20,100,113
2014,2,21401218,4/15/2015,1610612742,Dallas Mavericks,1,1,1610612757,Portland Trail Blazers,0,0,30,31,61,9,16,25,39,47,86,27,7,34,14,34,18,7,16,104,114
2014,2,21401218,4/15/2015,1610612757,Portland Trail Blazers,0,0,1610612742,Dallas Mavericks,1,1,31,35,66,7,18,25,38,53,91,15,3,18,14,42,20,9,19,103,98
2014,2,21400783,2/10/2015,1610612765,Detroit Pistons,0,1,1610612766,Charlotte Hornets,1,0,32,32,64,5,14,19,37,46,83,27,3,30,17,30,21,1,9,90,106
2014,2,21400783,2/10/2015,1610612766,Charlotte Hornets,1,0,1610612765,Detroit Pistons,0,1,20,37,57,9,15,24,29,52,81,11,3,14,12,41,21,8,12,88,78
2019,2,21900042,10/28/2019,1610612741,Chicago Bulls,0,0,1610612752,New York Knicks,1,1,27,23,50,9,26,35,36,49,85,17,4,21,11,41,19,3,10,93,98
2019,2,21900042,10/28/2019,1610612752,New York Knicks,1,1,1610612741,Chicago Bulls,0,0,29,33,62,9,20,29,38,53,91,20,12,32,29,32,19,6,17,95,105
2021,2,22100192,11/14/2021,1610612747,Los Angeles Lakers,1,1,1610612759,San Antonio Spurs,0,0,28,24,52,15,16,31,43,40,83,13,4,17,11,32,28,9,16,97,114
2021,2,22100192,11/14/2021,1610612759,San Antonio Spurs,0,0,1610612747,Los Angeles Lakers,1,1,24,30,54,16,20,36,40,50,90,10,5,15,16,37,28,6,15,97,106
2018,2,21801153,4/1/2019,1610612738,Boston Celtics,1,1,1610612748,Miami Heat,0,0,19,32,51,17,23,40,36,55,91,21,3,24,16,41,25,9,13,98,110
2018,2,21801153,4/1/2019,1610612748,Miami Heat,0,0,1610612738,Boston Celtics,1,1,30,21,51,10,27,37,40,48,88,15,3,18,13,37,27,8,15,99,105
2018,2,21800774,2/1/2019,1610612743,Denver Nuggets,1,1,1610612745,Houston Rockets,0,0,37,14,51,14,17,31,51,31,82,20,3,23,12,19,37,6,8,90,136
2018,2,21800774,2/1/2019,1610612745,Houston Rockets,0,0,1610612743,Denver Nuggets,1,1,29,12,41,16,28,44,45,40,85,16,5,21,13,28,23,7,10,91,122
2018,2,21800163,11/8/2018,1610612745,Houston Rockets,0,0,1610612760,Oklahoma City Thunder,1,1,20,20,40,11,31,42,31,51,82,7,3,10,15,39,16,10,17,89,80
2020,2,22000897,4/22/2021,1610612742,Dallas Mavericks,1,1,1610612747,Los Angeles Lakers,0,0,31,27,58,9,15,24,40,42,82,26,10,36,14,33,23,7,12,99,115
2020,2,22000897,4/22/2021,1610612747,Los Angeles Lakers,0,0,1610612742,Dallas Mavericks,1,1,33,27,60,10,20,30,43,47,90,14,3,17,17,32,26,11,16,100,110
2018,2,21800163,11/8/2018,1610612760,Oklahoma City Thunder,1,1,1610612745,Houston Rockets,0,0,27,17,44,9,28,37,36,45,81,17,7,24,18,30,18,9,15,89,98
2016,2,21601128,3/31/2017,1610612739,Cleveland Cavaliers,1,1,1610612755,Philadelphia 76ers,0,0,37,29,66,13,16,29,50,45,95,9,7,16,13,37,30,7,9,97,122
2016,2,21601128,3/31/2017,1610612755,Philadelphia 76ers,0,0,1610612739,Cleveland Cavaliers,1,1,29,20,49,11,22,33,40,42,82,14,5,19,9,38,26,8,18,98,105
2016,2,21600570,1/9/2017,1610612742,Dallas Mavericks,0,0,1610612750,Minnesota Timberwolves,1,1,23,27,50,13,15,28,36,42,78,7,2,9,8,35,24,11,14,89,92
2016,2,21600570,1/9/2017,1610612750,Minnesota Timberwolves,1,1,1610612742,Dallas Mavericks,0,0,34,21,55,6,10,16,40,31,71,15,6,21,11,23,30,3,19,88,101
2016,2,21600124,11/11/2016,1610612753,Orlando Magic,1,0,1610612762,Utah Jazz,0,1,18,40,58,8,12,20,26,52,78,14,5,19,10,43,13,9,12,90,74
2016,2,21600124,11/11/2016,1610612762,Utah Jazz,0,1,1610612753,Orlando Magic,1,0,26,27,53,7,21,28,33,48,81,14,2,16,15,35,19,11,15,91,87
2021,2,22100191,11/13/2021,1610612746,LA Clippers,1,1,1610612750,Minnesota Timberwolves,0,0,37,22,59,16,24,40,53,46,99,7,2,9,15,31,35,8,14,102,129
2021,2,22100191,11/13/2021,1610612750,Minnesota Timberwolves,0,0,1610612746,LA Clippers,1,1,29,37,66,11,25,36,40,62,102,11,5,16,17,50,25,6,11,104,102
2018,2,21800614,1/9/2019,1610612753,Orlando Magic,0,0,1610612762,Utah Jazz,1,1,20,30,50,13,20,33,33,50,83,14,6,20,11,42,17,5,12,94,93
2018,2,21800614,1/9/2019,1610612762,Utah Jazz,1,1,1610612753,Orlando Magic,0,0,29,22,51,12,21,33,41,43,84,12,2,14,10,34,24,6,13,93,106
2018,2,21800534,12/29/2018,1610612744,Golden State Warriors,0,1,1610612757,Portland Trail Blazers,1,0,28,27,55,12,13,25,40,40,80,23,5,28,6,38,27,6,12,100,115
2018,2,21800534,12/29/2018,1610612757,Portland Trail Blazers,1,0,1610612744,Golden State Warriors,0,1,30,30,60,9,22,31,39,52,91,18,4,22,15,39,18,9,13,101,105
2018,2,21800459,12/19/2018,1610612754,Indiana Pacers,0,0,1610612761,Toronto Raptors,1,1,29,31,60,9,11,20,38,42,80,11,5,16,13,33,19,15,23,97,96
2018,2,21800459,12/19/2018,1610612761,Toronto Raptors,1,1,1610612754,Indiana Pacers,0,0,31,32,63,7,23,30,38,55,93,16,5,21,16,41,20,6,9,96,99
2018,2,21800268,11/23/2018,1610612737,Atlanta Hawks,1,0,1610612738,Boston Celtics,0,1,29,17,46,6,29,35,35,46,81,20,9,29,9,41,22,11,21,105,96
2018,2,21800268,11/23/2018,1610612738,Boston Celtics,0,1,1610612737,Atlanta Hawks,1,0,29,22,51,13,27,40,42,49,91,17,4,21,13,38,31,9,16,105,114
2017,2,21701216,4/10/2018,1610612742,Dallas Mavericks,1,0,1610612756,Phoenix Suns,0,1,29,35,64,8,25,33,37,60,97,15,7,22,24,42,20,5,8,92,97
2017,2,21701216,4/10/2018,1610612756,Phoenix Suns,0,1,1610612742,Dallas Mavericks,1,0,35,15,50,13,13,26,48,28,76,15,6,21,8,23,35,8,15,91,124
2017,2,21701098,3/25/2018,1610612752,New York Knicks,0,1,1610612764,Washington Wizards,1,0,35,31,66,6,16,22,41,47,88,13,2,15,13,34,26,10,15,96,101
2017,2,21701098,3/25/2018,1610612764,Washington Wizards,1,0,1610612752,New York Knicks,0,1,31,37,68,6,13,19,37,50,87,17,6,23,16,37,25,10,14,96,97
2017,2,21701084,3/23/2018,1610612760,Oklahoma City Thunder,1,1,1610612748,Miami Heat,0,0,28,30,58,8,18,26,36,48,84,25,8,33,16,36,17,4,11,94,105
2016,2,21601127,3/31/2017,1610612743,Denver Nuggets,0,0,1610612766,Charlotte Hornets,1,1,29,28,57,16,17,33,45,45,90,8,3,11,11,36,32,10,13,96,114
2016,2,21601127,3/31/2017,1610612766,Charlotte Hornets,1,1,1610612743,Denver Nuggets,0,0,23,27,50,17,19,36,40,46,86,25,5,30,10,40,26,4,7,95,122
2019,2,21900264,11/27/2019,1610612740,New Orleans Pelicans,1,0,1610612747,Los Angeles Lakers,0,1,17,27,44,17,23,40,34,50,84,25,5,30,18,33,20,9,20,103,110
2019,2,21900264,11/27/2019,1610612747,Los Angeles Lakers,0,1,1610612740,New Orleans Pelicans,1,0,36,25,61,8,16,24,44,41,85,18,7,25,11,33,25,7,16,101,114
2014,2,21401217,4/15/2015,1610612737,Atlanta Hawks,0,0,1610612741,Chicago Bulls,1,1,28,35,63,8,21,29,36,56,92,5,2,7,12,44,15,11,15,99,85
2014,2,21401217,4/15/2015,1610612741,Chicago Bulls,1,1,1610612737,Atlanta Hawks,0,0,24,29,53,7,17,24,31,46,77,22,4,26,12,35,14,10,22,99,91
2018,2,21801152,4/1/2019,1610612754,Indiana Pacers,1,1,1610612765,Detroit Pistons,0,0,32,23,55,10,12,22,42,35,77,17,5,22,10,27,27,7,17,96,111
2021,2,22100190,11/13/2021,1610612738,Boston Celtics,0,0,1610612739,Cleveland Cavaliers,1,1,27,28,55,6,17,23,33,45,78,17,1,18,13,32,20,10,20,94,89
2021,2,22100190,11/13/2021,1610612739,Cleveland Cavaliers,1,1,1610612738,Boston Celtics,0,0,21,22,43,10,28,38,31,50,81,19,3,22,10,41,17,7,11,94,91
2018,2,21801152,4/1/2019,1610612765,Detroit Pistons,0,0,1610612754,Indiana Pacers,1,1,26,29,55,12,21,33,38,50,88,14,5,19,16,37,21,9,15,95,102
2018,2,21801004,3/11/2019,1610612745,Houston Rockets,1,1,1610612766,Charlotte Hornets,0,0,21,27,48,17,26,43,38,53,91,25,2,27,19,35,25,4,14,98,118
2018,2,21801004,3/11/2019,1610612766,Charlotte Hornets,0,0,1610612745,Houston Rockets,1,1,22,26,48,16,25,41,38,51,89,14,1,15,8,44,23,7,12,98,106
2018,2,21800872,2/21/2019,1610612745,Houston Rockets,0,0,1610612747,Los Angeles Lakers,1,1,28,19,47,12,29,41,40,48,88,14,1,15,8,40,18,4,15,103,106
2018,2,21800872,2/21/2019,1610612747,Los Angeles Lakers,1,1,1610612745,Houston Rockets,0,0,30,26,56,8,22,30,38,48,86,27,6,33,17,35,22,8,18,102,111
2018,2,21800389,12/9/2018,1610612752,New York Knicks,1,0,1610612766,Charlotte Hornets,0,1,31,36,67,13,13,26,44,49,93,6,1,7,11,39,28,11,17,103,107
2018,2,21800389,12/9/2018,1610612766,Charlotte Hornets,0,1,1610612752,New York Knicks,1,0,30,23,53,12,22,34,42,45,87,23,4,27,11,35,19,5,12,104,119
2018,2,21800325,11/30/2018,1610612737,Atlanta Hawks,0,0,1610612760,Oklahoma City Thunder,1,1,32,28,60,11,25,36,43,53,96,12,8,20,16,41,26,12,21,109,109
2018,2,21800325,11/30/2018,1610612760,Oklahoma City Thunder,1,1,1610612737,Atlanta Hawks,0,0,28,19,47,18,23,41,46,42,88,14,1,15,9,33,30,15,22,108,124
2018,2,21800215,11/15/2018,1610612746,LA Clippers,1,1,1610612759,San Antonio Spurs,0,0,32,30,62,8,15,23,40,45,85,28,7,35,14,35,23,7,12,100,116
2018,2,21800215,11/15/2018,1610612759,San Antonio Spurs,0,0,1610612746,LA Clippers,1,1,32,41,73,9,20,29,41,61,102,20,5,25,20,43,19,2,5,102,111
2018,2,21800162,11/7/2018,1610612747,Los Angeles Lakers,1,1,1610612750,Minnesota Timberwolves,0,0,29,28,57,15,19,34,44,47,91,11,3,14,15,33,32,10,16,99,114
2018,2,21800162,11/7/2018,1610612750,Minnesota Timberwolves,0,0,1610612747,Los Angeles Lakers,1,1,21,30,51,20,20,40,41,50,91,8,1,9,13,37,22,6,16,99,110
2020,2,22000896,4/22/2021,1610612741,Chicago Bulls,1,1,1610612766,Charlotte Hornets,0,0,29,15,44,14,29,43,43,44,87,8,3,11,14,32,30,5,18,95,108
2020,2,22000896,4/22/2021,1610612766,Charlotte Hornets,0,0,1610612741,Chicago Bulls,1,1,27,24,51,8,23,31,35,47,82,13,4,17,8,41,30,8,14,96,91
2014,2,21401216,4/14/2015,1610612746,LA Clippers,0,1,1610612756,Phoenix Suns,1,0,27,22,49,15,23,38,42,45,87,13,5,18,16,31,26,8,13,92,112
2014,2,21401216,4/14/2015,1610612756,Phoenix Suns,1,0,1610612746,LA Clippers,0,1,28,26,54,11,15,26,39,41,80,12,8,20,12,36,25,10,15,91,101
2016,2,21600569,1/9/2017,1610612741,Chicago Bulls,1,0,1610612760,Oklahoma City Thunder,0,1,27,37,64,7,12,19,34,49,83,19,3,22,12,38,18,5,11,91,94
2016,2,21600569,1/9/2017,1610612760,Oklahoma City Thunder,0,1,1610612741,Chicago Bulls,1,0,40,19,59,7,17,24,47,36,83,8,3,11,8,31,30,7,12,91,109
2016,2,21600123,11/11/2016,1610612761,Toronto Raptors,0,1,1610612766,Charlotte Hornets,1,0,37,31,68,6,16,22,43,47,90,21,1,22,9,39,18,1,5,95,113
2016,2,21600123,11/11/2016,1610612766,Charlotte Hornets,1,0,1610612761,Toronto Raptors,0,1,21,31,52,17,24,41,38,55,93,18,6,24,21,37,22,8,12,95,111
2014,2,21400781,2/9/2015,1610612742,Dallas Mavericks,1,0,1610612746,LA Clippers,0,1,23,24,47,10,24,34,33,48,81,22,8,30,14,37,19,8,12,93,98
2014,2,21400781,2/9/2015,1610612746,LA Clippers,0,1,1610612742,Dallas Mavericks,1,0,32,33,65,9,18,27,41,51,92,24,5,29,19,34,21,2,6,93,115
2021,2,22100189,11/13/2021,1610612761,Toronto Raptors,1,0,1610612765,Detroit Pistons,0,1,31,22,53,13,21,34,44,43,87,20,11,31,20,28,21,5,13,98,121
2021,2,22100189,11/13/2021,1610612765,Detroit Pistons,0,1,1610612761,Toronto Raptors,1,0,28,16,44,15,20,35,43,36,79,26,4,30,11,26,34,9,14,96,127
2018,2,21800615,1/9/2019,1610612741,Chicago Bulls,0,0,1610612757,Portland Trail Blazers,1,1,34,37,71,9,13,22,43,50,93,17,2,19,13,38,22,6,12,100,112
2018,2,21800615,1/9/2019,1610612757,Portland Trail Blazers,1,1,1610612741,Chicago Bulls,0,0,36,21,57,11,15,26,47,36,83,19,2,21,9,28,28,5,16,99,124
2018,2,21800458,12/19/2018,1610612738,Boston Celtics,1,0,1610612756,Phoenix Suns,0,1,23,23,46,15,24,39,38,47,85,12,2,14,10,38,26,8,16,97,103
2018,2,21800458,12/19/2018,1610612756,Phoenix Suns,0,1,1610612738,Boston Celtics,1,0,30,39,69,11,16,27,41,55,96,18,4,22,28,29,23,13,17,97,111
2018,2,21800110,10/31/2018,1610612756,Phoenix Suns,1,0,1610612759,San Antonio Spurs,0,1,29,37,66,6,18,24,35,55,90,14,4,18,12,45,21,7,15,101,90
2018,2,21800110,10/31/2018,1610612759,San Antonio Spurs,0,1,1610612756,Phoenix Suns,1,0,42,23,65,4,14,18,46,37,83,24,2,26,8,30,24,10,14,102,120
2017,2,21701170,4/4/2018,1610612742,Dallas Mavericks,0,0,1610612753,Orlando Magic,1,1,29,30,59,10,20,30,39,50,89,12,5,17,16,36,24,4,12,94,100
2017,2,21701170,4/4/2018,1610612753,Orlando Magic,1,1,1610612742,Dallas Mavericks,0,0,31,26,57,8,21,29,39,47,86,19,8,27,17,33,27,3,13,94,105
2017,2,21701083,3/23/2018,1610612741,Chicago Bulls,1,0,1610612749,Milwaukee Bucks,0,1,24,37,61,12,14,26,36,51,87,21,2,23,23,30,21,8,15,90,105
2017,2,21701083,3/23/2018,1610612749,Milwaukee Bucks,0,1,1610612741,Chicago Bulls,1,0,28,29,57,15,15,30,43,44,87,17,2,19,10,36,27,3,5,89,118
2017,2,21701043,3/17/2018,1610612762,Utah Jazz,1,1,1610612758,Sacramento Kings,0,0,27,23,50,6,18,24,33,41,74,31,7,38,10,33,21,11,16,99,103
2016,2,21601126,3/31/2017,1610612754,Indiana Pacers,0,0,1610612761,Toronto Raptors,1,1,25,36,61,11,15,26,36,51,87,17,4,21,16,37,19,7,14,95,100
2016,2,21601126,3/31/2017,1610612761,Toronto Raptors,1,1,1610612754,Indiana Pacers,0,0,23,32,55,14,13,27,37,45,82,23,12,35,20,32,23,7,14,94,111
2014,2,21400780,2/9/2015,1610612740,New Orleans Pelicans,1,0,1610612762,Utah Jazz,0,1,20,37,57,13,9,22,33,46,79,17,3,20,20,27,20,11,15,84,96
2014,2,21400780,2/9/2015,1610612762,Utah Jazz,0,1,1610612740,New Orleans Pelicans,1,0,30,42,72,9,12,21,39,54,93,13,6,19,30,27,23,5,11,83,100
2019,2,21900041,10/28/2019,1610612754,Indiana Pacers,0,0,1610612765,Detroit Pistons,1,1,33,40,73,6,15,21,39,55,94,10,3,13,15,41,24,2,8,95,94
2019,2,21900041,10/28/2019,1610612765,Detroit Pistons,1,1,1610612754,Indiana Pacers,0,0,24,33,57,13,11,24,37,44,81,9,1,10,11,34,21,11,20,95,96
2018,2,21801003,3/11/2019,1610612751,Brooklyn Nets,1,1,1610612765,Detroit Pistons,0,0,28,20,48,11,20,31,39,40,79,14,8,22,10,32,21,7,17,97,103
2015,2,21500962,3/10/2016,1610612739,Cleveland Cavaliers,0,1,1610612747,Los Angeles Lakers,1,0,29,21,50,16,19,35,45,40,85,14,6,20,12,30,22,8,8,92,120
2015,2,21500962,3/10/2016,1610612747,Los Angeles Lakers,1,0,1610612739,Cleveland Cavaliers,0,1,35,23,58,7,15,22,42,38,80,17,4,21,9,32,18,4,11,93,108
2018,2,21801003,3/11/2019,1610612765,Detroit Pistons,0,0,1610612751,Brooklyn Nets,1,1,19,44,63,8,26,34,27,70,97,13,3,16,21,49,16,9,13,98,75
2018,2,21800773,2/1/2019,1610612737,Atlanta Hawks,0,0,1610612762,Utah Jazz,1,1,25,27,52,14,32,46,39,59,98,20,4,24,19,42,23,4,11,103,112
2018,2,21800773,2/1/2019,1610612762,Utah Jazz,1,1,1610612737,Atlanta Hawks,0,0,34,18,52,12,23,35,46,41,87,24,6,30,13,34,31,11,15,101,128
2018,2,21800533,12/29/2018,1610612743,Denver Nuggets,0,1,1610612756,Phoenix Suns,1,0,24,17,41,18,17,35,42,34,76,20,6,26,11,25,31,15,21,99,122
2018,2,21800533,12/29/2018,1610612756,Phoenix Suns,1,0,1610612743,Denver Nuggets,0,1,38,24,62,11,18,29,49,42,91,9,5,14,12,33,29,10,13,97,118
2018,2,21800267,11/23/2018,1610612745,Houston Rockets,0,0,1610612765,Detroit Pistons,1,1,31,31,62,10,26,36,41,57,98,19,2,21,20,38,22,11,14,102,111
2018,2,21800267,11/23/2018,1610612765,Detroit Pistons,1,1,1610612745,Houston Rockets,0,0,33,28,61,7,20,27,40,48,88,29,11,40,21,32,18,6,14,101,116
2018,2,21800216,11/16/2018,1610612738,Boston Celtics,1,1,1610612761,Toronto Raptors,0,0,38,25,63,9,17,26,47,42,89,20,4,24,10,34,25,12,18,108,123
2018,2,21800216,11/16/2018,1610612761,Toronto Raptors,0,0,1610612738,Boston Celtics,1,1,34,34,68,8,21,29,42,55,97,24,5,29,17,42,20,9,14,110,116
2018,2,21800109,10/31/2018,1610612742,Dallas Mavericks,0,0,1610612747,Los Angeles Lakers,1,1,30,27,57,13,16,29,43,43,86,14,5,19,13,31,24,12,23,106,113
2018,2,21800109,10/31/2018,1610612747,Los Angeles Lakers,1,1,1610612742,Dallas Mavericks,0,0,33,34,67,10,7,17,43,41,84,18,6,24,11,32,23,5,20,107,114
2017,2,21701171,4/4/2018,1610612738,Boston Celtics,0,0,1610612761,Toronto Raptors,1,1,22,31,53,3,19,22,25,50,75,25,3,28,13,39,10,10,17,92,78
2017,2,21701171,4/4/2018,1610612761,Toronto Raptors,1,1,1610612738,Boston Celtics,0,0,30,29,59,10,23,33,40,52,92,6,2,8,15,37,23,7,11,92,96
2017,2,21701150,4/1/2018,1610612740,New Orleans Pelicans,1,0,1610612760,Oklahoma City Thunder,0,1,27,24,51,11,21,32,38,45,83,17,6,23,8,39,28,13,21,107,104
2017,2,21701150,4/1/2018,1610612760,Oklahoma City Thunder,0,1,1610612740,New Orleans Pelicans,1,0,32,32,64,9,22,31,41,54,95,18,7,25,19,39,24,13,18,106,109
2022,2,22200455,12/19/2022,1610612745,Houston Rockets,1,0,1610612759,San Antonio Spurs,0,1,35,35,70,5,19,24,40,54,94,20,11,31,21,40,23,6,11,100,105
2022,2,22200455,12/19/2022,1610612759,San Antonio Spurs,0,1,1610612745,Houston Rockets,1,0,29,20,49,17,17,34,46,37,83,15,4,19,12,26,30,13,19,100,124
2019,2,21900263,11/27/2019,1610612756,Phoenix Suns,1,0,1610612764,Washington Wizards,0,1,33,22,55,15,23,38,48,45,93,21,3,24,14,33,29,9,15,106,132
2019,2,21900263,11/27/2019,1610612764,Washington Wizards,0,1,1610612756,Phoenix Suns,1,0,32,22,54,19,16,35,51,38,89,19,1,20,9,30,32,7,16,106,140
2016,2,21600568,1/9/2017,1610612740,New Orleans Pelicans,0,1,1610612752,New York Knicks,1,0,29,28,57,12,15,27,41,43,84,16,3,19,11,33,24,5,11,93,110
2016,2,21600568,1/9/2017,1610612752,New York Knicks,1,0,1610612740,New Orleans Pelicans,0,1,25,31,56,11,18,29,36,49,85,13,3,16,15,35,17,11,15,92,96
2021,2,22100188,11/13/2021,1610612740,New Orleans Pelicans,1,1,1610612763,Memphis Grizzlies,0,0,24,26,50,14,15,29,38,41,79,22,3,25,15,27,29,6,14,92,112
2021,2,22100188,11/13/2021,1610612763,Memphis Grizzlies,0,0,1610612740,New Orleans Pelicans,1,1,30,34,64,8,16,24,38,50,88,17,4,21,17,35,21,5,9,92,101
2018,2,21801151,3/31/2019,1610612746,LA Clippers,1,1,1610612763,Memphis Grizzlies,0,0,29,19,48,7,20,27,36,39,75,34,4,38,10,31,23,13,19,103,113
2018,2,21801151,3/31/2019,1610612763,Memphis Grizzlies,0,0,1610612746,LA Clippers,1,1,24,28,52,8,25,33,32,53,85,24,5,29,10,45,22,9,14,104,96
2018,2,21800688,1/20/2019,1610612754,Indiana Pacers,1,1,1610612766,Charlotte Hornets,0,0,33,40,73,14,13,27,47,53,100,12,0,12,15,38,34,5,9,100,120
2018,2,21800688,1/20/2019,1610612766,Charlotte Hornets,0,0,1610612754,Indiana Pacers,1,1,21,26,47,12,23,35,33,49,82,17,8,25,10,42,20,10,16,99,95
2018,2,21800388,12/9/2018,1610612749,Milwaukee Bucks,0,1,1610612761,Toronto Raptors,1,0,21,27,48,15,24,39,36,51,87,17,3,20,16,37,22,7,14,93,104
2018,2,21800388,12/9/2018,1610612761,Toronto Raptors,1,0,1610612749,Milwaukee Bucks,0,1,24,26,50,15,29,44,39,55,94,6,1,7,17,38,24,5,10,93,99
2020,2,22000895,4/22/2021,1610612759,San Antonio Spurs,1,1,1610612765,Detroit Pistons,0,0,26,30,56,11,13,24,37,43,80,21,6,27,12,34,28,2,10,91,106
2020,2,22000895,4/22/2021,1610612765,Detroit Pistons,0,0,1610612759,San Antonio Spurs,1,1,27,28,55,8,14,22,35,42,77,13,9,22,13,34,15,12,18,92,91
2018,2,21800111,11/1/2018,1610612760,Oklahoma City Thunder,0,1,1610612766,Charlotte Hornets,1,0,33,26,59,8,29,37,41,55,96,21,8,29,18,44,20,7,10,102,111
2018,2,21800111,11/1/2018,1610612766,Charlotte Hornets,1,0,1610612760,Oklahoma City Thunder,0,1,27,25,52,11,30,41,38,55,93,20,2,22,19,37,26,12,18,102,107
2022,2,22200457,12/19/2022,1610612740,New Orleans Pelicans,1,0,1610612749,Milwaukee Bucks,0,1,24,30,54,18,27,45,42,57,99,17,7,24,21,39,30,8,15,105,119
2022,2,22200457,12/19/2022,1610612749,Milwaukee Bucks,0,1,1610612740,New Orleans Pelicans,1,0,32,9,41,13,27,40,45,36,81,25,6,31,9,29,26,9,18,105,128
2016,2,21601125,3/30/2017,1610612745,Houston Rockets,0,0,1610612757,Portland Trail Blazers,1,1,32,21,53,8,26,34,40,47,87,19,4,23,19,34,18,12,18,100,107
2016,2,21601125,3/30/2017,1610612757,Portland Trail Blazers,1,1,1610612745,Houston Rockets,0,0,30,19,49,13,20,33,43,39,82,18,4,22,13,37,24,9,12,98,117
2016,2,21600122,11/11/2016,1610612739,Cleveland Cavaliers,0,1,1610612764,Washington Wizards,1,0,22,31,53,14,19,33,36,50,86,19,7,26,17,37,16,7,15,95,105
2016,2,21600122,11/11/2016,1610612764,Washington Wizards,1,0,1610612739,Cleveland Cavaliers,0,1,35,37,72,3,12,15,38,49,87,15,4,19,14,37,16,9,15,95,94
2014,2,21400779,2/9/2015,1610612737,Atlanta Hawks,0,1,1610612750,Minnesota Timberwolves,1,0,34,31,65,10,11,21,44,42,86,19,1,20,13,29,26,6,12,94,117
2014,2,21400779,2/9/2015,1610612750,Minnesota Timberwolves,1,0,1610612737,Atlanta Hawks,0,1,37,40,77,5,11,16,42,51,93,16,6,22,24,30,24,14,16,95,105
2018,2,21800871,2/21/2019,1610612744,Golden State Warriors,1,1,1610612758,Sacramento Kings,0,0,24,24,48,19,27,46,43,51,94,20,4,24,11,42,32,10,15,109,125
2018,2,21800871,2/21/2019,1610612758,Sacramento Kings,0,0,1610612744,Golden State Warriors,1,1,33,33,66,10,23,33,43,56,99,27,7,34,17,43,23,5,13,110,123
2018,2,21800772,2/1/2019,1610612748,Miami Heat,1,0,1610612760,Oklahoma City Thunder,0,1,30,26,56,11,25,36,41,51,92,9,5,14,16,38,28,10,18,99,102
2018,2,21800772,2/1/2019,1610612760,Oklahoma City Thunder,0,1,1610612748,Miami Heat,1,0,28,33,61,16,14,30,44,47,91,14,5,19,14,37,23,7,15,100,118
2018,2,21800457,12/19/2018,1610612752,New York Knicks,0,0,1610612755,Philadelphia 76ers,1,1,27,28,55,10,21,31,37,49,86,25,6,31,9,43,22,6,8,100,109
2018,2,21800457,12/19/2018,1610612755,Philadelphia 76ers,1,1,1610612752,New York Knicks,0,0,32,26,58,15,15,30,47,41,88,22,3,25,10,33,31,2,10,99,131
2018,2,21800324,11/30/2018,1610612740,New Orleans Pelicans,0,0,1610612748,Miami Heat,1,1,29,25,54,6,22,28,35,47,82,25,4,29,14,34,25,10,16,98,101
2018,2,21800324,11/30/2018,1610612748,Miami Heat,1,1,1610612740,New Orleans Pelicans,0,0,29,31,60,11,22,33,40,53,93,15,9,24,19,38,22,4,13,97,106
2018,2,21800161,11/7/2018,1610612758,Sacramento Kings,1,0,1610612761,Toronto Raptors,0,1,34,31,65,8,15,23,42,46,88,13,5,18,7,41,27,10,15,103,105
2018,2,21800161,11/7/2018,1610612761,Toronto Raptors,0,1,1610612758,Sacramento Kings,1,0,30,23,53,11,25,36,41,48,89,21,2,23,18,31,17,10,22,105,114
2016,2,21601124,3/30/2017,1610612746,LA Clippers,0,1,1610612756,Phoenix Suns,1,0,32,26,58,12,10,22,44,36,80,24,10,34,11,32,20,6,15,101,124
2016,2,21601124,3/30/2017,1610612756,Phoenix Suns,1,0,1610612746,LA Clippers,0,1,42,27,69,7,16,23,49,43,92,13,11,24,17,32,24,4,14,102,118
2022,2,22200460,12/19/2022,1610612758,Sacramento Kings,1,0,1610612766,Charlotte Hornets,0,1,33,29,62,12,21,33,45,50,95,17,14,31,12,46,23,4,8,105,119
2022,2,22200460,12/19/2022,1610612766,Charlotte Hornets,0,1,1610612758,Sacramento Kings,1,0,39,25,64,10,21,31,49,46,95,17,6,23,15,34,26,8,14,105,125
2021,2,22100187,11/13/2021,1610612753,Orlando Magic,1,0,1610612764,Washington Wizards,0,1,18,34,52,13,27,40,31,61,92,17,3,20,19,43,21,6,13,96,92
2021,2,22100187,11/13/2021,1610612764,Washington Wizards,0,1,1610612753,Orlando Magic,1,0,30,19,49,12,23,35,42,42,84,8,2,10,10,33,29,7,16,94,104
2016,2,21600567,1/8/2017,1610612747,Los Angeles Lakers,1,1,1610612753,Orlando Magic,0,0,34,21,55,8,24,32,42,45,87,19,5,24,8,38,23,5,13,102,111
2016,2,21600567,1/8/2017,1610612753,Orlando Magic,0,0,1610612747,Los Angeles Lakers,1,1,27,37,64,7,19,26,34,56,90,20,9,29,19,42,24,8,18,102,95
2018,2,21801002,3/11/2019,1610612758,Sacramento Kings,0,0,1610612764,Washington Wizards,1,1,32,32,64,9,18,27,41,50,91,24,8,32,12,41,28,12,16,111,115
2018,2,21801002,3/11/2019,1610612764,Washington Wizards,1,1,1610612758,Sacramento Kings,0,0,26,23,49,14,23,37,40,46,86,27,6,33,8,41,29,8,17,110,121
2018,2,21800687,1/19/2019,1610612739,Cleveland Cavaliers,0,0,1610612743,Denver Nuggets,1,1,25,18,43,10,19,29,35,37,72,22,4,26,7,32,20,7,14,91,102
2018,2,21800687,1/19/2019,1610612743,Denver Nuggets,1,1,1610612739,Cleveland Cavaliers,0,0,35,17,52,15,22,37,50,39,89,9,2,11,16,25,33,5,12,90,124
2018,2,21800387,12/9/2018,1610612740,New Orleans Pelicans,0,1,1610612765,Detroit Pistons,1,0,30,19,49,12,18,30,42,37,79,20,3,23,9,31,27,8,18,99,116
2018,2,21800387,12/9/2018,1610612765,Detroit Pistons,1,0,1610612740,New Orleans Pelicans,0,1,34,35,69,9,20,29,43,55,98,13,11,24,19,39,28,5,10,99,108
2018,2,21800160,11/7/2018,1610612742,Dallas Mavericks,0,0,1610612762,Utah Jazz,1,1,21,28,49,8,16,24,29,44,73,36,4,40,14,31,14,12,25,101,102
2018,2,21800160,11/7/2018,1610612762,Utah Jazz,1,1,1610612742,Dallas Mavericks,0,0,30,22,52,13,24,37,43,46,89,18,8,26,11,39,31,3,12,103,117
2020,2,22000894,4/22/2021,1610612749,Milwaukee Bucks,1,1,1610612755,Philadelphia 76ers,0,0,25,16,41,20,20,40,45,36,81,14,9,23,9,31,32,7,16,100,124
2020,2,22000894,4/22/2021,1610612755,Philadelphia 76ers,0,0,1610612749,Milwaukee Bucks,1,1,34,30,64,12,15,27,46,45,91,13,5,18,7,41,27,6,9,100,117
2014,2,21400778,2/9/2015,1610612749,Milwaukee Bucks,1,1,1610612751,Brooklyn Nets,0,0,30,41,71,7,11,18,37,52,89,22,3,25,20,33,25,3,10,90,103
2014,2,21400778,2/9/2015,1610612751,Brooklyn Nets,0,0,1610612749,Milwaukee Bucks,1,1,29,22,51,9,16,25,38,38,76,12,7,19,10,31,25,14,16,90,97
2019,2,21900040,10/27/2019,1610612747,Los Angeles Lakers,1,1,1610612766,Charlotte Hornets,0,0,38,24,62,11,20,31,49,44,93,11,3,14,13,34,30,7,14,100,120
2019,2,21900040,10/27/2019,1610612766,Charlotte Hornets,0,0,1610612747,Los Angeles Lakers,1,1,25,31,56,10,25,35,35,56,91,21,2,23,17,40,19,7,16,100,101
2018,2,21801150,3/31/2019,1610612744,Golden State Warriors,1,1,1610612766,Charlotte Hornets,0,0,32,23,55,21,12,33,53,35,88,10,2,12,13,23,41,8,15,96,137
2018,2,21801150,3/31/2019,1610612766,Charlotte Hornets,0,0,1610612744,Golden State Warriors,1,1,22,31,53,8,24,32,30,55,85,22,3,25,12,43,24,7,11,97,90
2018,2,21800532,12/29/2018,1610612752,New York Knicks,0,0,1610612762,Utah Jazz,1,1,17,37,54,15,17,32,32,54,86,18,4,22,10,47,17,8,15,100,97
2018,2,21800532,12/29/2018,1610612762,Utah Jazz,1,1,1610612752,New York Knicks,0,0,35,22,57,16,20,36,51,42,93,11,3,14,16,28,30,10,17,99,129
2018,2,21800214,11/15/2018,1610612737,Atlanta Hawks,0,0,1610612743,Denver Nuggets,1,1,23,27,50,9,33,42,32,60,92,20,7,27,16,47,20,12,19,106,93
2018,2,21800214,11/15/2018,1610612743,Denver Nuggets,1,1,1610612737,Atlanta Hawks,0,0,40,23,63,13,18,31,53,41,94,19,6,25,14,28,34,7,15,106,138
2017,2,21701192,4/7/2018,1610612749,Milwaukee Bucks,0,1,1610612752,New York Knicks,1,0,35,33,68,10,15,25,45,48,93,15,2,17,16,34,30,3,10,96,115
2017,2,21701192,4/7/2018,1610612752,New York Knicks,1,0,1610612749,Milwaukee Bucks,0,1,32,42,74,9,12,21,41,54,95,11,0,11,16,38,30,6,11,95,102
2017,2,21701149,4/1/2018,1610612739,Cleveland Cavaliers,1,1,1610612742,Dallas Mavericks,0,0,24,35,59,11,15,26,35,50,85,17,6,23,13,39,21,5,11,94,98
2017,2,21701149,4/1/2018,1610612742,Dallas Mavericks,0,0,1610612739,Cleveland Cavaliers,1,1,19,23,42,13,24,37,32,47,79,10,1,11,6,41,15,7,15,94,87
2017,2,21701131,3/30/2018,1610612739,Cleveland Cavaliers,1,1,1610612740,New Orleans Pelicans,0,0,33,33,66,10,14,24,43,47,90,11,4,15,12,36,22,4,10,95,107
2017,2,21701131,3/30/2018,1610612740,New Orleans Pelicans,0,0,1610612739,Cleveland Cavaliers,1,1,32,31,63,11,15,26,43,46,89,5,1,6,8,39,25,6,11,95,102
2017,2,21701060,3/20/2018,1610612746,LA Clippers,0,0,1610612750,Minnesota Timberwolves,1,1,32,37,69,8,16,24,40,53,93,21,5,26,18,37,21,5,12,99,109
2017,2,21701060,3/20/2018,1610612750,Minnesota Timberwolves,1,1,1610612746,LA Clippers,0,0,35,26,61,10,15,25,45,41,86,23,1,24,9,32,23,4,11,98,123
2017,2,21701034,3/16/2018,1610612747,Los Angeles Lakers,1,0,1610612748,Miami Heat,0,1,23,34,57,9,10,19,32,44,76,18,4,22,13,33,22,14,20,96,91
2017,2,21701034,3/16/2018,1610612748,Miami Heat,0,1,1610612747,Los Angeles Lakers,1,0,26,32,58,10,26,36,36,58,94,10,4,14,16,43,23,5,11,95,92
2017,2,21701029,3/16/2018,1610612738,Boston Celtics,0,1,1610612753,Orlando Magic,1,0,22,34,56,9,17,26,31,51,82,21,7,28,21,34,16,12,19,95,92
2016,2,21601123,3/30/2017,1610612747,Los Angeles Lakers,0,0,1610612750,Minnesota Timberwolves,1,1,31,26,57,9,18,27,40,44,84,15,1,16,16,28,20,9,17,92,104
2016,2,21601123,3/30/2017,1610612750,Minnesota Timberwolves,1,1,1610612747,Los Angeles Lakers,0,0,33,35,68,10,11,21,43,46,89,23,7,30,19,31,30,4,11,92,119
2016,2,21600566,1/8/2017,1610612744,Golden State Warriors,0,1,1610612758,Sacramento Kings,1,0,35,25,60,10,19,29,45,44,89,17,3,20,14,32,33,13,17,101,117
2016,2,21600566,1/8/2017,1610612758,Sacramento Kings,1,0,1610612744,Golden State Warriors,0,1,25,21,46,11,17,28,36,38,74,23,6,29,5,35,21,11,19,102,106
2021,2,22100186,11/13/2021,1610612754,Indiana Pacers,1,1,1610612755,Philadelphia 76ers,0,0,33,21,54,14,14,28,47,35,82,10,5,15,10,29,33,11,15,97,118
2021,2,22100186,11/13/2021,1610612755,Philadelphia 76ers,0,0,1610612754,Indiana Pacers,1,1,26,40,66,12,11,23,38,51,89,25,4,29,22,31,16,7,14,96,113
2014,2,21400777,2/9/2015,1610612748,Miami Heat,1,1,1610612752,New York Knicks,0,0,24,28,52,12,10,22,36,38,74,25,4,29,10,28,28,8,12,90,109
2014,2,21400777,2/9/2015,1610612752,New York Knicks,0,0,1610612748,Miami Heat,1,1,29,35,64,7,13,20,36,48,84,16,3,19,18,32,22,9,15,91,95
2019,2,21900262,11/27/2019,1610612750,Minnesota Timberwolves,0,1,1610612759,San Antonio Spurs,1,0,19,26,45,18,22,40,37,48,85,21,6,27,10,40,28,4,11,98,113
2019,2,21900262,11/27/2019,1610612759,San Antonio Spurs,1,0,1610612750,Minnesota Timberwolves,0,1,36,32,68,5,24,29,41,56,97,14,3,17,9,49,25,4,6,100,101
2018,2,21801001,3/11/2019,1610612739,Cleveland Cavaliers,1,1,1610612761,Toronto Raptors,0,0,26,27,53,18,23,41,44,50,94,20,1,21,14,37,27,8,15,104,126
2018,2,21801001,3/11/2019,1610612761,Toronto Raptors,0,0,1610612739,Cleveland Cavaliers,1,1,29,16,45,11,28,39,40,44,84,10,7,17,6,42,20,8,20,104,101
2018,2,21800870,2/21/2019,1610612738,Boston Celtics,0,0,1610612749,Milwaukee Bucks,1,1,25,37,62,14,26,40,39,63,102,5,1,6,14,49,19,5,7,100,97
2018,2,21800870,2/21/2019,1610612749,Milwaukee Bucks,1,1,1610612738,Boston Celtics,0,0,23,26,49,14,25,39,37,51,88,10,4,14,12,40,21,11,16,99,98
2018,2,21800771,2/1/2019,1610612738,Boston Celtics,0,1,1610612752,New York Knicks,1,0,33,30,63,13,24,37,46,54,100,8,2,10,12,42,25,2,7,99,113
2018,2,21800771,2/1/2019,1610612752,New York Knicks,1,0,1610612738,Boston Celtics,0,1,30,25,55,9,22,31,39,47,86,12,0,12,11,36,21,11,18,100,99
2018,2,21800611,1/9/2019,1610612759,San Antonio Spurs,0,0,1610612763,Memphis Grizzlies,1,1,19,37,56,11,16,27,30,53,83,15,8,23,13,44,14,6,15,98,86
2018,2,21800611,1/9/2019,1610612763,Memphis Grizzlies,1,1,1610612759,San Antonio Spurs,0,0,29,28,57,8,25,33,37,53,90,14,6,20,11,46,22,4,9,97,96
2018,2,21800531,12/29/2018,1610612738,Boston Celtics,0,1,1610612763,Memphis Grizzlies,1,0,24,20,44,16,20,36,40,40,80,16,2,18,11,31,29,11,17,94,112
2018,2,21800531,12/29/2018,1610612763,Memphis Grizzlies,1,0,1610612738,Boston Celtics,0,1,29,21,50,7,19,26,36,40,76,24,5,29,12,31,24,10,17,94,103
2018,2,21800456,12/19/2018,1610612753,Orlando Magic,1,0,1610612759,San Antonio Spurs,0,1,22,36,58,12,19,31,34,55,89,10,7,17,18,42,19,5,13,94,90
2018,2,21800456,12/19/2018,1610612759,San Antonio Spurs,0,1,1610612753,Orlando Magic,1,0,38,20,58,12,7,19,50,27,77,17,4,21,5,23,29,5,11,92,129
2016,2,21601122,3/30/2017,1610612739,Cleveland Cavaliers,0,0,1610612741,Chicago Bulls,1,1,27,29,56,10,17,27,37,46,83,9,7,16,11,39,23,11,15,93,93
2016,2,21601122,3/30/2017,1610612741,Chicago Bulls,1,1,1610612739,Cleveland Cavaliers,0,0,26,39,65,12,13,25,38,52,90,11,7,18,20,35,26,6,14,92,99
2016,2,21600121,11/11/2016,1610612754,Indiana Pacers,0,0,1610612755,Philadelphia 76ers,1,1,34,35,69,5,14,19,39,49,88,22,1,23,5,45,23,7,13,106,105
2016,2,21600121,11/11/2016,1610612755,Philadelphia 76ers,1,1,1610612754,Indiana Pacers,0,0,25,29,54,11,21,32,36,50,86,26,5,31,16,37,24,14,20,106,109
2014,2,21401215,4/14/2015,1610612754,Indiana Pacers,1,1,1610612764,Washington Wizards,0,0,31,44,75,9,21,30,40,65,105,10,7,17,22,47,22,8,15,106,99
2014,2,21401215,4/14/2015,1610612764,Washington Wizards,0,0,1610612754,Indiana Pacers,1,1,30,50,80,7,17,24,37,67,104,14,3,17,22,47,22,5,13,105,95
2018,2,21800612,1/9/2019,1610612739,Cleveland Cavaliers,0,0,1610612740,New Orleans Pelicans,1,1,28,30,58,14,16,30,42,46,88,26,4,30,12,34,27,7,13,105,124
2018,2,21800612,1/9/2019,1610612740,New Orleans Pelicans,1,1,1610612739,Cleveland Cavaliers,0,0,34,21,55,12,17,29,46,38,84,36,3,39,14,26,33,7,17,105,140
2018,2,21800386,12/8/2018,1610612746,LA Clippers,1,0,1610612748,Miami Heat,0,1,26,34,60,7,22,29,33,56,89,25,6,31,15,43,16,9,16,105,98
2018,2,21800386,12/8/2018,1610612748,Miami Heat,0,1,1610612746,LA Clippers,1,0,27,26,53,13,26,39,40,52,92,28,11,39,16,40,27,5,11,105,121
2018,2,21800213,11/15/2018,1610612744,Golden State Warriors,0,0,1610612745,Houston Rockets,1,1,28,30,58,4,14,18,32,44,76,18,4,22,17,29,18,8,17,85,86
2018,2,21800213,11/15/2018,1610612745,Houston Rockets,1,1,1610612744,Golden State Warriors,0,0,19,21,40,16,31,47,35,52,87,21,5,26,22,34,20,2,8,86,107
2020,2,22000893,4/22/2021,1610612740,New Orleans Pelicans,0,1,1610612753,Orlando Magic,1,0,38,24,62,12,16,28,50,40,90,23,3,26,15,28,34,6,15,100,135
2020,2,22000893,4/22/2021,1610612753,Orlando Magic,1,0,1610612740,New Orleans Pelicans,0,1,23,39,62,13,23,36,36,62,98,15,4,19,15,48,13,2,6,99,100
2017,2,21701193,4/7/2018,1610612741,Chicago Bulls,1,0,1610612751,Brooklyn Nets,0,1,30,29,59,6,23,29,36,52,88,18,3,21,8,44,16,11,13,104,96
2017,2,21701193,4/7/2018,1610612751,Brooklyn Nets,0,1,1610612741,Chicago Bulls,1,0,22,15,37,24,31,55,46,46,92,8,3,11,9,39,36,8,15,103,124
2017,2,21701113,3/27/2018,1610612742,Dallas Mavericks,0,1,1610612758,Sacramento Kings,1,0,22,18,40,14,26,40,36,44,80,17,8,25,9,38,25,6,13,97,103
2017,2,21701113,3/27/2018,1610612758,Sacramento Kings,1,0,1610612742,Dallas Mavericks,0,1,32,38,70,6,17,23,38,55,93,15,4,19,15,42,25,7,10,98,97
2017,2,21701070,3/21/2018,1610612746,LA Clippers,0,1,1610612749,Milwaukee Bucks,1,0,30,26,56,15,15,30,45,41,86,22,7,29,19,26,26,10,21,101,127
2017,2,21701070,3/21/2018,1610612749,Milwaukee Bucks,1,0,1610612746,LA Clippers,0,1,42,23,65,8,18,26,50,41,91,12,5,17,12,31,33,12,15,102,120
2017,2,21701059,3/20/2018,1610612738,Boston Celtics,1,1,1610612760,Oklahoma City Thunder,0,0,23,28,51,13,23,36,36,51,87,15,1,16,14,37,22,6,19,100,100
2017,2,21701059,3/20/2018,1610612760,Oklahoma City Thunder,0,0,1610612738,Boston Celtics,1,1,25,33,58,10,17,27,35,50,85,19,10,29,12,44,19,6,13,100,99
2017,2,21701050,3/19/2018,1610612739,Cleveland Cavaliers,1,1,1610612749,Milwaukee Bucks,0,0,28,21,49,15,23,38,43,44,87,23,4,27,18,27,24,11,15,96,124
2015,2,21501200,4/10/2016,1610612748,Miami Heat,1,1,1610612753,Orlando Magic,0,0,37,20,57,6,14,20,43,34,77,26,4,30,6,30,28,6,12,98,118
2015,2,21501200,4/10/2016,1610612753,Orlando Magic,0,0,1610612748,Miami Heat,1,1,30,35,65,7,11,18,37,46,83,15,4,19,10,39,18,10,16,98,96
2021,2,22100185,11/13/2021,1610612748,Miami Heat,0,1,1610612762,Utah Jazz,1,0,29,23,52,13,20,33,42,43,85,14,2,16,16,28,23,13,21,97,111
2021,2,22100185,11/13/2021,1610612762,Utah Jazz,1,0,1610612748,Miami Heat,0,1,18,14,32,17,36,53,35,50,85,18,7,25,16,37,23,6,17,97,105
2019,2,21900261,11/27/2019,1610612737,Atlanta Hawks,0,0,1610612749,Milwaukee Bucks,1,1,27,33,60,11,23,34,38,56,94,15,7,22,22,38,22,6,19,101,102
2019,2,21900261,11/27/2019,1610612749,Milwaukee Bucks,1,1,1610612737,Atlanta Hawks,0,0,32,22,54,10,24,34,42,46,88,17,10,27,13,39,25,4,14,99,111
2018,2,21801149,3/31/2019,1610612758,Sacramento Kings,0,1,1610612759,San Antonio Spurs,1,0,28,28,56,11,14,25,39,42,81,24,4,28,12,32,20,7,12,95,113
2018,2,21801149,3/31/2019,1610612759,San Antonio Spurs,1,0,1610612758,Sacramento Kings,0,1,36,31,67,8,19,27,44,50,94,10,4,14,17,36,24,9,11,95,106
2018,2,21800686,1/19/2019,1610612745,Houston Rockets,1,1,1610612747,Los Angeles Lakers,0,0,17,15,32,25,43,68,42,58,100,29,7,36,17,45,23,6,12,112,138
2018,2,21800686,1/19/2019,1610612747,Los Angeles Lakers,0,0,1610612745,Houston Rockets,1,1,40,19,59,10,27,37,50,46,96,24,6,30,17,32,27,9,16,112,134
2018,2,21800613,1/9/2019,1610612742,Dallas Mavericks,1,1,1610612756,Phoenix Suns,0,0,18,18,36,12,22,34,30,40,70,32,13,45,14,33,21,10,20,97,104
2018,2,21800613,1/9/2019,1610612756,Phoenix Suns,0,0,1610612742,Dallas Mavericks,1,1,29,30,59,7,18,25,36,48,84,15,6,21,12,37,22,7,15,98,94
2020,2,22000892,4/22/2021,1610612738,Boston Celtics,1,1,1610612756,Phoenix Suns,0,0,21,16,37,12,28,40,33,44,77,21,3,24,15,30,20,10,23,97,99
2020,2,22000892,4/22/2021,1610612756,Phoenix Suns,0,0,1610612738,Boston Celtics,1,1,30,23,53,6,29,35,36,52,88,8,1,9,13,40,18,7,17,97,86
2018,2,21800323,11/30/2018,1610612751,Brooklyn Nets,1,0,1610612763,Memphis Grizzlies,0,1,26,24,50,16,28,44,42,52,94,25,5,30,15,39,26,8,19,114,125
2018,2,21800323,11/30/2018,1610612763,Memphis Grizzlies,0,1,1610612751,Brooklyn Nets,1,0,38,33,71,12,18,30,50,51,101,19,3,22,14,40,27,7,17,114,131
2018,2,21800266,11/23/2018,1610612746,LA Clippers,1,1,1610612763,Memphis Grizzlies,0,0,32,39,71,8,15,23,40,54,94,24,3,27,11,45,26,6,11,106,112
2018,2,21800266,11/23/2018,1610612763,Memphis Grizzlies,0,0,1610612746,LA Clippers,1,1,33,32,65,9,18,27,42,50,92,14,4,18,11,43,29,6,17,105,107
2018,2,21800107,10/31/2018,1610612750,Minnesota Timberwolves,1,1,1610612762,Utah Jazz,0,0,38,23,61,12,13,25,50,36,86,16,8,24,10,29,19,9,16,102,128
2018,2,21800107,10/31/2018,1610612762,Utah Jazz,0,0,1610612750,Minnesota Timberwolves,1,1,34,33,67,13,17,30,47,50,97,18,12,30,22,34,25,10,14,103,125
2017,2,21701213,4/10/2018,1610612754,Indiana Pacers,1,0,1610612766,Charlotte Hornets,0,1,32,36,68,8,23,31,40,59,99,5,3,8,17,45,22,5,8,96,93
2016,2,21601121,3/30/2017,1610612751,Brooklyn Nets,0,0,1610612765,Detroit Pistons,1,1,25,36,61,10,21,31,35,57,92,9,3,12,13,44,17,6,13,98,89
2016,2,21601121,3/30/2017,1610612765,Detroit Pistons,1,1,1610612751,Brooklyn Nets,0,0,29,39,68,7,11,18,36,50,86,11,6,17,13,40,20,4,16,96,90
2016,2,21600565,1/8/2017,1610612739,Cleveland Cavaliers,0,1,1610612756,Phoenix Suns,1,0,29,19,48,15,19,34,44,38,82,17,2,19,16,25,15,12,20,94,120
2016,2,21600565,1/8/2017,1610612756,Phoenix Suns,1,0,1610612739,Cleveland Cavaliers,0,1,37,23,60,9,18,27,46,41,87,15,4,19,15,27,23,8,14,95,116
2014,2,21401214,4/14/2015,1610612738,Boston Celtics,1,1,1610612761,Toronto Raptors,0,0,32,40,72,6,21,27,38,61,99,13,2,15,23,39,24,9,14,97,95
2014,2,21401214,4/14/2015,1610612761,Toronto Raptors,0,0,1610612738,Boston Celtics,1,1,26,30,56,9,15,24,35,45,80,14,6,20,13,35,17,7,20,97,93
2021,2,22100184,11/12/2021,1610612747,Los Angeles Lakers,1,0,1610612750,Minnesota Timberwolves,0,1,20,21,41,9,32,41,29,53,82,16,4,20,15,41,17,10,20,96,83
2021,2,22100184,11/12/2021,1610612750,Minnesota Timberwolves,0,1,1610612747,Los Angeles Lakers,1,0,31,26,57,12,25,37,43,51,94,9,3,12,21,33,24,12,16,97,107
2014,2,21400776,2/9/2015,1610612753,Orlando Magic,0,0,1610612764,Washington Wizards,1,1,29,32,61,4,18,22,33,50,83,10,5,15,9,44,18,7,11,92,80
2014,2,21400776,2/9/2015,1610612764,Washington Wizards,1,1,1610612753,Orlando Magic,0,0,26,26,52,7,18,25,33,44,77,23,4,27,20,27,25,13,22,91,96
2015,2,21501125,3/31/2016,1610612740,New Orleans Pelicans,1,1,1610612743,Denver Nuggets,0,0,27,34,61,13,16,29,40,50,90,8,1,9,18,33,29,10,18,96,101
2015,2,21501125,3/31/2016,1610612743,Denver Nuggets,0,0,1610612740,New Orleans Pelicans,1,1,26,30,56,10,17,27,36,47,83,13,4,17,10,40,28,7,13,95,95
2018,2,21801000,3/10/2019,1610612744,Golden State Warriors,1,0,1610612756,Phoenix Suns,0,1,32,20,52,10,33,43,42,53,95,17,5,22,18,39,34,10,17,104,111
2018,2,21801000,3/10/2019,1610612756,Phoenix Suns,0,1,1610612744,Golden State Warriors,1,0,32,29,61,10,15,25,42,44,86,21,6,27,12,36,26,10,17,103,115
2018,2,21800869,2/21/2019,1610612751,Brooklyn Nets,1,0,1610612757,Portland Trail Blazers,0,1,29,27,56,7,29,36,36,56,92,20,6,26,14,44,26,7,12,103,99
2018,2,21800869,2/21/2019,1610612757,Portland Trail Blazers,0,1,1610612751,Brooklyn Nets,1,0,39,34,73,7,25,32,46,59,105,14,2,16,22,38,19,4,14,103,113
2018,2,21800455,12/19/2018,1610612739,Cleveland Cavaliers,0,0,1610612766,Charlotte Hornets,1,1,31,31,62,10,13,23,41,44,85,7,5,12,8,40,24,4,9,95,99
2018,2,21800455,12/19/2018,1610612766,Charlotte Hornets,1,1,1610612739,Cleveland Cavaliers,0,0,37,30,67,10,15,25,47,45,92,6,3,9,15,31,24,8,13,94,110
2018,2,21800265,11/23/2018,1610612750,Minnesota Timberwolves,0,1,1610612751,Brooklyn Nets,1,0,35,32,67,9,16,25,44,48,92,15,2,17,10,39,25,2,7,97,112
2018,2,21800265,11/23/2018,1610612751,Brooklyn Nets,1,0,1610612750,Minnesota Timberwolves,0,1,19,15,34,14,31,45,33,46,79,22,4,26,15,33,26,15,19,98,102
2018,2,21800157,11/7/2018,1610612754,Indiana Pacers,1,0,1610612755,Philadelphia 76ers,0,1,29,34,63,8,23,31,37,57,94,12,5,17,14,44,19,7,12,100,94
2018,2,21800157,11/7/2018,1610612755,Philadelphia 76ers,0,1,1610612754,Indiana Pacers,1,0,26,21,47,10,22,32,36,43,79,18,4,22,6,38,24,9,17,100,100
2018,2,21800108,10/31/2018,1610612740,New Orleans Pelicans,0,0,1610612744,Golden State Warriors,1,1,32,25,57,12,23,35,44,48,92,21,6,27,15,35,24,10,16,105,121
2018,2,21800108,10/31/2018,1610612744,Golden State Warriors,1,1,1610612740,New Orleans Pelicans,0,0,31,26,57,16,16,32,47,42,89,21,9,30,15,32,39,8,17,105,131
2017,2,21701213,4/10/2018,1610612766,Charlotte Hornets,0,1,1610612754,Indiana Pacers,1,0,28,29,57,18,24,42,46,53,99,9,3,12,14,40,27,3,7,96,119
2017,2,21701097,3/25/2018,1610612746,LA Clippers,0,1,1610612761,Toronto Raptors,1,0,36,41,77,8,10,18,44,51,95,21,6,27,18,37,17,3,9,99,117
2017,2,21701097,3/25/2018,1610612761,Toronto Raptors,1,0,1610612746,LA Clippers,0,1,25,31,56,16,20,36,41,51,92,8,6,14,16,38,24,7,16,101,106
2017,2,21701082,3/23/2018,1610612751,Brooklyn Nets,0,0,1610612761,Toronto Raptors,1,1,30,27,57,11,16,27,41,43,84,19,12,31,8,39,21,5,11,101,112
2015,2,21501199,4/10/2016,1610612751,Brooklyn Nets,0,0,1610612754,Indiana Pacers,1,1,21,33,54,14,23,37,35,56,91,21,5,26,14,44,24,10,15,104,105
2015,2,21501199,4/10/2016,1610612754,Indiana Pacers,1,1,1610612751,Brooklyn Nets,0,0,37,22,59,11,16,27,48,38,86,22,5,27,15,26,34,12,20,104,129
2014,2,21401213,4/13/2015,1610612743,Denver Nuggets,0,0,1610612746,LA Clippers,1,1,26,42,68,12,21,33,38,63,101,15,7,22,27,37,18,7,14,99,103
2014,2,21401213,4/13/2015,1610612746,LA Clippers,1,1,1610612743,Denver Nuggets,0,0,30,31,61,7,14,21,37,45,82,29,8,37,16,34,25,7,15,100,110
2021,2,22100183,11/12/2021,1610612741,Chicago Bulls,0,0,1610612744,Golden State Warriors,1,1,26,25,51,8,19,27,34,44,78,17,5,22,10,36,18,15,20,100,93
2021,2,22100183,11/12/2021,1610612744,Golden State Warriors,1,1,1610612741,Chicago Bulls,0,0,30,17,47,15,31,46,45,48,93,14,2,16,18,31,27,9,16,100,119
2016,2,21600564,1/8/2017,1610612762,Utah Jazz,0,0,1610612763,Memphis Grizzlies,1,1,19,30,49,9,14,23,28,44,72,14,9,23,11,36,14,11,17,87,79
2016,2,21600564,1/8/2017,1610612763,Memphis Grizzlies,1,1,1610612762,Utah Jazz,0,0,25,29,54,9,15,24,34,44,78,11,3,14,10,34,19,8,14,88,88
2018,2,21800770,2/1/2019,1610612763,Memphis Grizzlies,0,0,1610612766,Charlotte Hornets,1,1,26,25,51,9,20,29,35,45,80,13,4,17,13,35,23,6,14,88,92
2018,2,21800770,2/1/2019,1610612766,Charlotte Hornets,1,1,1610612763,Memphis Grizzlies,0,0,20,24,44,12,17,29,32,41,73,24,4,28,11,32,15,8,12,89,100
2018,2,21800385,12/8/2018,1610612750,Minnesota Timberwolves,0,0,1610612757,Portland Trail Blazers,1,1,33,42,75,7,9,16,40,51,91,18,4,22,13,40,25,10,12,101,105
2018,2,21800385,12/8/2018,1610612757,Portland Trail Blazers,1,1,1610612750,Minnesota Timberwolves,0,0,29,21,50,10,23,33,39,44,83,25,5,30,17,31,23,12,20,101,113
2020,2,22000891,4/21/2021,1610612750,Minnesota Timberwolves,0,0,1610612758,Sacramento Kings,1,1,31,22,53,15,19,34,46,41,87,18,4,22,12,30,30,7,12,97,125
2020,2,22000891,4/21/2021,1610612758,Sacramento Kings,1,1,1610612750,Minnesota Timberwolves,0,0,26,15,41,17,16,33,43,31,74,25,6,31,5,28,29,7,14,98,128
2016,2,21601120,3/29/2017,1610612758,Sacramento Kings,1,0,1610612762,Utah Jazz,0,1,32,28,60,2,13,15,34,41,75,12,6,18,6,39,14,10,13,90,82
2016,2,21601120,3/29/2017,1610612762,Utah Jazz,0,1,1610612758,Sacramento Kings,1,0,29,19,48,13,18,31,42,37,79,15,4,19,9,31,22,7,11,89,112
2019,2,21900039,10/27/2019,1610612748,Miami Heat,0,0,1610612750,Minnesota Timberwolves,1,1,27,22,49,15,21,36,42,43,85,10,5,15,13,32,25,12,23,103,109
2019,2,21900039,10/27/2019,1610612750,Minnesota Timberwolves,1,1,1610612748,Miami Heat,0,0,26,20,46,13,32,45,39,52,91,25,8,33,18,37,24,7,16,102,116
2016,2,21600120,11/10/2016,1610612747,Los Angeles Lakers,0,1,1610612758,Sacramento Kings,1,0,29,18,47,9,18,27,38,36,74,16,6,22,6,32,18,13,21,98,101
2016,2,21600120,11/10/2016,1610612758,Sacramento Kings,1,0,1610612747,Los Angeles Lakers,0,1,26,38,64,8,13,21,34,51,85,15,5,20,13,40,18,8,15,97,91
2018,2,21801148,3/31/2019,1610612743,Denver Nuggets,1,0,1610612764,Washington Wizards,0,1,28,29,57,7,29,36,35,58,93,13,7,20,15,47,18,9,11,99,90
2018,2,21801148,3/31/2019,1610612764,Washington Wizards,0,1,1610612743,Denver Nuggets,1,0,31,37,68,6,18,24,37,55,92,15,5,20,13,47,24,6,12,100,95
2018,2,21800999,3/10/2019,1610612749,Milwaukee Bucks,0,0,1610612759,San Antonio Spurs,1,1,27,24,51,14,22,36,41,46,87,18,7,25,9,39,22,6,10,99,114
2018,2,21800999,3/10/2019,1610612759,San Antonio Spurs,1,1,1610612749,Milwaukee Bucks,0,0,37,34,71,12,17,29,49,51,100,11,4,15,13,40,24,3,5,100,121
2014,2,21400775,2/9/2015,1610612744,Golden State Warriors,0,1,1610612755,Philadelphia 76ers,1,0,27,29,56,7,22,29,34,51,85,14,5,19,10,43,26,9,14,101,89
2014,2,21400775,2/9/2015,1610612755,Philadelphia 76ers,1,0,1610612744,Golden State Warriors,0,1,26,29,55,7,17,24,33,46,79,11,3,14,12,36,21,15,27,101,84
2018,2,21800322,11/30/2018,1610612755,Philadelphia 76ers,1,1,1610612764,Washington Wizards,0,0,31,29,60,12,26,38,43,55,98,25,8,33,20,38,28,10,12,106,123
2018,2,21800322,11/30/2018,1610612764,Washington Wizards,0,0,1610612755,Philadelphia 76ers,1,1,29,35,64,8,20,28,37,55,92,16,3,19,11,45,22,11,16,107,98
2018,2,21800158,11/7/2018,1610612743,Denver Nuggets,0,0,1610612763,Memphis Grizzlies,1,1,24,26,50,8,24,32,32,50,82,15,4,19,20,31,19,7,19,89,87
2018,2,21800158,11/7/2018,1610612763,Memphis Grizzlies,1,1,1610612743,Denver Nuggets,0,0,22,27,49,8,13,21,30,40,70,21,4,25,12,28,19,9,18,89,89
2015,2,21501071,3/24/2016,1610612760,Oklahoma City Thunder,1,1,1610612762,Utah Jazz,0,0,36,25,61,9,13,22,45,38,83,14,8,22,15,28,27,8,15,92,113
2015,2,21501071,3/24/2016,1610612762,Utah Jazz,0,0,1610612760,Oklahoma City Thunder,1,1,30,21,51,5,17,22,35,38,73,16,7,23,11,30,18,13,18,93,91
2019,2,21900260,11/27/2019,1610612746,LA Clippers,0,1,1610612763,Memphis Grizzlies,1,0,30,24,54,14,27,41,44,51,95,19,6,25,16,38,30,9,16,106,121
2019,2,21900260,11/27/2019,1610612763,Memphis Grizzlies,1,0,1610612746,LA Clippers,0,1,32,32,64,11,17,28,43,49,92,22,4,26,17,32,26,11,20,107,119
2018,2,21801147,3/31/2019,1610612740,New Orleans Pelicans,1,0,1610612747,Los Angeles Lakers,0,1,30,22,52,8,23,31,38,45,83,18,3,21,9,39,19,16,24,109,102
2018,2,21801147,3/31/2019,1610612747,Los Angeles Lakers,0,1,1610612740,New Orleans Pelicans,1,0,33,30,63,15,23,38,48,53,101,19,3,22,12,43,30,5,11,109,130
2018,2,21800868,2/21/2019,1610612748,Miami Heat,0,0,1610612755,Philadelphia 76ers,1,1,39,33,72,6,16,22,45,49,94,6,6,12,11,42,27,5,9,99,102
2018,2,21800868,2/21/2019,1610612755,Philadelphia 76ers,1,1,1610612748,Miami Heat,0,0,30,26,56,7,19,26,37,45,82,25,10,35,14,35,23,11,15,100,106
2018,2,21800685,1/19/2019,1610612741,Chicago Bulls,1,0,1610612748,Miami Heat,0,1,23,39,62,12,15,27,35,54,89,21,5,26,17,41,19,5,14,97,103
2018,2,21800685,1/19/2019,1610612748,Miami Heat,0,1,1610612741,Chicago Bulls,1,0,32,15,47,13,19,32,45,34,79,14,9,23,8,31,27,9,17,98,117
2018,2,21800530,12/29/2018,1610612764,Washington Wizards,1,1,1610612766,Charlotte Hornets,0,0,35,21,56,13,24,37,48,45,93,21,3,24,14,33,35,9,12,101,130
2021,2,22100182,11/12/2021,1610612737,Atlanta Hawks,0,0,1610612743,Denver Nuggets,1,1,33,32,65,5,23,28,38,55,93,15,6,21,16,42,20,6,8,93,96
2021,2,22100182,11/12/2021,1610612743,Denver Nuggets,1,1,1610612737,Atlanta Hawks,0,0,30,25,55,10,25,35,40,50,90,15,5,20,15,39,26,2,8,92,105
2018,2,21800530,12/29/2018,1610612766,Charlotte Hornets,0,0,1610612764,Washington Wizards,1,1,34,25,59,13,18,31,47,43,90,19,5,24,13,34,22,8,16,103,126
2018,2,21800159,11/7/2018,1610612740,New Orleans Pelicans,1,1,1610612741,Chicago Bulls,0,0,31,33,64,11,19,30,42,52,94,12,5,17,15,41,32,9,15,102,107
2018,2,21800159,11/7/2018,1610612741,Chicago Bulls,0,0,1610612740,New Orleans Pelicans,1,1,29,36,65,9,22,31,38,58,96,13,4,17,15,45,18,5,12,103,98
2017,2,21701212,4/9/2018,1610612740,New Orleans Pelicans,0,1,1610612746,LA Clippers,1,0,33,32,65,11,19,30,44,51,95,14,6,20,10,45,34,6,8,101,113
2017,2,21701212,4/9/2018,1610612746,LA Clippers,1,0,1610612740,New Orleans Pelicans,0,1,43,38,81,2,15,17,45,53,98,8,11,19,21,41,29,13,16,101,100
2021,2,22100181,11/12/2021,1610612742,Dallas Mavericks,0,1,1610612759,San Antonio Spurs,1,0,28,27,55,18,27,45,46,54,100,13,6,19,17,40,30,3,6,100,123
2021,2,22100181,11/12/2021,1610612759,San Antonio Spurs,1,0,1610612742,Dallas Mavericks,0,1,28,26,54,13,17,30,41,43,84,14,6,20,7,40,30,9,13,99,109
2016,2,21601119,3/29/2017,1610612746,LA Clippers,1,1,1610612764,Washington Wizards,0,0,35,18,53,12,18,30,47,36,83,27,10,37,11,30,27,7,10,100,133
2016,2,21601119,3/29/2017,1610612764,Washington Wizards,0,0,1610612746,LA Clippers,1,1,33,26,59,13,21,34,46,47,93,19,10,29,19,35,22,6,11,99,124
2016,2,21600563,1/8/2017,1610612745,Houston Rockets,0,1,1610612761,Toronto Raptors,1,0,35,16,51,11,27,38,46,43,89,26,5,31,11,36,27,7,15,104,129
2016,2,21600563,1/8/2017,1610612761,Toronto Raptors,1,0,1610612745,Houston Rockets,0,1,31,22,53,11,14,25,42,36,78,27,3,30,7,31,19,9,19,103,122
2022,2,22200489,12/23/2022,1610612743,Denver Nuggets,1,1,1610612757,Portland Trail Blazers,0,0,37,23,60,10,11,21,47,34,81,16,10,26,8,31,31,5,12,96,120
2022,2,22200489,12/23/2022,1610612757,Portland Trail Blazers,0,0,1610612743,Denver Nuggets,1,1,30,22,52,9,26,35,39,48,87,20,6,26,16,37,24,9,13,96,107
2015,2,21501198,4/10/2016,1610612743,Denver Nuggets,1,0,1610612762,Utah Jazz,0,1,26,27,53,6,21,27,32,48,80,14,5,19,12,39,18,7,12,91,84
2015,2,21501198,4/10/2016,1610612762,Utah Jazz,0,1,1610612743,Denver Nuggets,1,0,24,24,48,12,19,31,36,43,79,16,5,21,11,35,19,6,12,90,100
2020,2,22000890,4/21/2021,1610612743,Denver Nuggets,0,1,1610612757,Portland Trail Blazers,1,0,26,23,49,13,26,39,39,49,88,15,2,17,18,32,24,7,14,91,106
2020,2,22000890,4/21/2021,1610612757,Portland Trail Blazers,1,0,1610612743,Denver Nuggets,0,1,28,23,51,12,24,36,40,47,87,13,2,15,14,34,21,7,11,91,105
2018,2,21800454,12/18/2018,1610612742,Dallas Mavericks,0,0,1610612743,Denver Nuggets,1,1,25,24,49,15,22,37,40,46,86,23,7,30,9,39,26,7,8,101,118
2018,2,21800454,12/18/2018,1610612743,Denver Nuggets,1,1,1610612742,Dallas Mavericks,0,0,38,23,61,12,17,29,50,40,90,14,4,18,13,27,33,8,16,101,126
2018,2,21800212,11/14/2018,1610612747,Los Angeles Lakers,1,1,1610612757,Portland Trail Blazers,0,0,29,32,61,15,17,32,44,49,93,23,3,26,14,37,25,8,13,103,126
2018,2,21800212,11/14/2018,1610612757,Portland Trail Blazers,0,0,1610612747,Los Angeles Lakers,1,1,27,33,60,14,19,33,41,52,93,21,2,23,15,39,24,11,15,103,117
2017,2,21701214,4/10/2018,1610612737,Atlanta Hawks,1,0,1610612755,Philadelphia 76ers,0,1,28,33,61,13,24,37,41,57,98,18,8,26,13,46,27,7,10,105,113
2017,2,21701214,4/10/2018,1610612755,Philadelphia 76ers,0,1,1610612737,Atlanta Hawks,1,0,26,24,50,17,20,37,43,44,87,18,12,30,15,34,29,10,18,104,121
2017,2,21701169,4/4/2018,1610612755,Philadelphia 76ers,0,1,1610612765,Detroit Pistons,1,0,31,28,59,13,17,30,44,45,89,14,5,19,12,35,32,4,13,100,115
2017,2,21701169,4/4/2018,1610612765,Detroit Pistons,1,0,1610612755,Philadelphia 76ers,0,1,23,29,52,16,20,36,39,49,88,14,9,23,15,39,30,11,18,101,108
2017,2,21701148,4/1/2018,1610612751,Brooklyn Nets,1,0,1610612765,Detroit Pistons,0,1,25,19,44,12,31,43,37,50,87,10,5,15,9,45,23,9,12,96,96
2017,2,21701148,4/1/2018,1610612765,Detroit Pistons,0,1,1610612751,Brooklyn Nets,1,0,31,34,65,7,12,19,38,46,84,25,7,32,12,38,17,5,11,96,108
2019,2,21900038,10/27/2019,1610612742,Dallas Mavericks,1,0,1610612757,Portland Trail Blazers,0,1,24,20,44,13,37,50,37,57,94,32,9,41,19,44,27,6,12,107,119
2019,2,21900038,10/27/2019,1610612757,Portland Trail Blazers,0,1,1610612742,Dallas Mavericks,1,0,36,29,65,9,13,22,45,42,87,22,4,26,10,35,13,7,16,105,121
2014,2,21400774,2/9/2015,1610612754,Indiana Pacers,1,0,1610612759,San Antonio Spurs,0,1,28,39,67,8,13,21,36,52,88,13,0,13,16,36,24,8,12,93,93
2014,2,21400774,2/9/2015,1610612759,San Antonio Spurs,0,1,1610612754,Indiana Pacers,1,0,31,33,64,6,19,25,37,52,89,15,2,17,12,41,18,4,7,92,95
2018,2,21800998,3/10/2019,1610612750,Minnesota Timberwolves,1,1,1610612752,New York Knicks,0,0,33,31,64,9,21,30,42,52,94,10,3,13,16,37,22,5,11,95,103
2018,2,21800998,3/10/2019,1610612752,New York Knicks,0,0,1610612750,Minnesota Timberwolves,1,1,27,34,61,10,15,25,37,49,86,8,6,14,17,35,20,13,19,94,92
2021,2,22100180,11/12/2021,1610612758,Sacramento Kings,0,0,1610612760,Oklahoma City Thunder,1,1,24,30,54,14,27,41,38,57,95,13,4,17,19,40,20,8,14,98,103
2021,2,22100180,11/12/2021,1610612760,Oklahoma City Thunder,1,1,1610612758,Sacramento Kings,0,0,32,37,69,10,20,30,42,57,99,11,4,15,18,40,13,5,10,98,105
2018,2,21800769,1/31/2019,1610612746,LA Clippers,1,0,1610612747,Los Angeles Lakers,0,1,32,29,61,14,29,43,46,58,104,14,12,26,15,50,26,7,10,112,120
2018,2,21800769,1/31/2019,1610612747,Los Angeles Lakers,0,1,1610612746,LA Clippers,1,0,31,35,66,11,15,26,42,50,92,28,7,35,14,40,28,11,16,111,123
2018,2,21800609,1/9/2019,1610612737,Atlanta Hawks,0,0,1610612751,Brooklyn Nets,1,1,30,34,64,6,29,35,36,63,99,22,3,25,25,39,17,10,22,107,100
2018,2,21800609,1/9/2019,1610612751,Brooklyn Nets,1,1,1610612737,Atlanta Hawks,0,0,33,32,65,10,20,30,43,52,95,20,6,26,21,36,21,8,20,107,116
2018,2,21800529,12/29/2018,1610612737,Atlanta Hawks,1,1,1610612739,Cleveland Cavaliers,0,0,33,28,61,10,27,37,43,55,98,15,10,25,24,37,27,9,13,99,111
2018,2,21800529,12/29/2018,1610612739,Cleveland Cavaliers,0,0,1610612737,Atlanta Hawks,1,1,35,27,62,5,18,23,40,45,85,23,6,29,11,38,27,7,12,99,108
2018,2,21800384,12/8/2018,1610612747,Los Angeles Lakers,0,1,1610612763,Memphis Grizzlies,1,0,27,30,57,16,24,40,43,54,97,9,3,12,25,30,27,13,18,98,111
2018,2,21800384,12/8/2018,1610612763,Memphis Grizzlies,1,0,1610612747,Los Angeles Lakers,0,1,28,26,54,6,24,30,34,50,84,14,4,18,10,41,17,11,15,98,88
2022,2,22200474,12/21/2022,1610612757,Portland Trail Blazers,0,0,1610612760,Oklahoma City Thunder,1,1,25,18,43,14,22,36,39,40,79,6,3,9,11,31,29,9,20,93,98
2022,2,22200474,12/21/2022,1610612760,Oklahoma City Thunder,1,1,1610612757,Portland Trail Blazers,0,0,28,25,53,8,16,24,36,41,77,21,4,25,15,28,19,9,18,94,101
2016,2,21600562,1/8/2017,1610612749,Milwaukee Bucks,1,0,1610612764,Washington Wizards,0,1,28,29,57,9,14,23,37,43,80,18,2,20,7,38,25,10,16,98,101
2016,2,21600562,1/8/2017,1610612764,Washington Wizards,0,1,1610612749,Milwaukee Bucks,1,0,31,21,52,10,22,32,41,43,84,15,3,18,17,28,23,14,21,98,107
2019,2,21900037,10/27/2019,1610612751,Brooklyn Nets,0,0,1610612763,Memphis Grizzlies,1,1,29,27,56,15,30,45,44,57,101,30,7,37,19,43,28,9,17,116,133
2019,2,21900037,10/27/2019,1610612763,Memphis Grizzlies,1,1,1610612751,Brooklyn Nets,0,0,36,34,70,14,19,33,50,53,103,20,5,25,12,44,33,6,12,115,134
2016,2,21600119,11/10/2016,1610612743,Denver Nuggets,1,0,1610612744,Golden State Warriors,0,1,25,33,58,13,23,36,38,56,94,12,5,17,23,36,26,15,19,99,101
2016,2,21600119,11/10/2016,1610612744,Golden State Warriors,0,1,1610612743,Denver Nuggets,1,0,32,23,55,14,16,30,46,39,85,19,1,20,11,29,33,7,15,98,125
2014,2,21400773,2/8/2015,1610612756,Phoenix Suns,0,0,1610612758,Sacramento Kings,1,1,28,35,63,5,23,28,33,58,91,12,5,17,15,43,17,1,10,98,83
2014,2,21400773,2/8/2015,1610612758,Sacramento Kings,1,1,1610612756,Phoenix Suns,0,0,30,33,63,4,8,12,34,41,75,13,8,21,6,39,20,9,17,97,85
2018,2,21801146,3/31/2019,1610612742,Dallas Mavericks,0,1,1610612760,Oklahoma City Thunder,1,0,21,22,43,16,28,44,37,50,87,16,7,23,14,37,18,6,13,98,106
2018,2,21801146,3/31/2019,1610612760,Oklahoma City Thunder,1,0,1610612742,Dallas Mavericks,0,1,27,28,55,11,32,43,38,60,98,16,6,22,20,43,19,3,8,100,103
2021,2,22100179,11/12/2021,1610612740,New Orleans Pelicans,1,0,1610612751,Brooklyn Nets,0,1,30,26,56,13,19,32,43,45,88,13,3,16,16,31,26,9,16,95,112
2021,2,22100179,11/12/2021,1610612751,Brooklyn Nets,0,1,1610612740,New Orleans Pelicans,1,0,23,25,48,18,16,34,41,41,82,20,7,27,11,32,27,6,12,95,120
2018,2,21800684,1/19/2019,1610612761,Toronto Raptors,1,1,1610612763,Memphis Grizzlies,0,0,27,27,54,17,19,36,44,46,90,14,2,16,12,35,31,7,12,96,119
2018,2,21800684,1/19/2019,1610612763,Memphis Grizzlies,0,0,1610612761,Toronto Raptors,1,1,24,27,51,10,19,29,34,46,80,12,3,15,17,31,21,19,26,96,90
2015,2,21501197,4/10/2016,1610612749,Milwaukee Bucks,0,1,1610612755,Philadelphia 76ers,1,0,33,31,64,7,16,23,40,47,87,22,2,24,13,35,26,12,20,108,109
2015,2,21501197,4/10/2016,1610612755,Philadelphia 76ers,1,0,1610612749,Milwaukee Bucks,0,1,26,24,50,13,33,46,39,57,96,17,8,25,17,45,24,10,15,107,108
2018,2,21800610,1/9/2019,1610612745,Houston Rockets,1,0,1610612749,Milwaukee Bucks,0,1,14,23,37,18,30,48,32,53,85,27,5,32,15,40,19,11,19,103,109
2018,2,21800610,1/9/2019,1610612749,Milwaukee Bucks,0,1,1610612745,Houston Rockets,1,0,36,28,64,8,19,27,44,47,91,20,4,24,13,34,26,4,13,103,116
2018,2,21800453,12/18/2018,1610612747,Los Angeles Lakers,0,0,1610612751,Brooklyn Nets,1,1,29,21,50,13,27,40,42,48,90,13,10,23,12,39,21,5,14,104,110
2018,2,21800453,12/18/2018,1610612751,Brooklyn Nets,1,1,1610612747,Los Angeles Lakers,0,0,30,27,57,14,20,34,44,47,91,13,6,19,7,43,27,6,12,104,115
2020,2,22000889,4/21/2021,1610612746,LA Clippers,1,1,1610612763,Memphis Grizzlies,0,0,24,33,57,14,13,27,38,46,84,27,9,36,20,31,28,6,13,95,117
2020,2,22000889,4/21/2021,1610612763,Memphis Grizzlies,0,0,1610612746,LA Clippers,1,1,25,29,54,13,17,30,38,46,84,16,7,23,15,34,19,4,13,94,105
2018,2,21800264,11/21/2018,1610612744,Golden State Warriors,1,0,1610612760,Oklahoma City Thunder,0,1,29,25,54,7,22,29,36,47,83,16,8,24,9,43,24,10,17,103,95
2018,2,21800264,11/21/2018,1610612760,Oklahoma City Thunder,0,1,1610612744,Golden State Warriors,1,0,38,33,71,13,22,35,51,55,106,8,7,15,22,38,29,7,10,102,123
2018,2,21800106,10/31/2018,1610612741,Chicago Bulls,1,0,1610612743,Denver Nuggets,0,1,23,35,58,16,18,34,39,53,92,13,5,18,14,40,27,7,14,100,107
2018,2,21800106,10/31/2018,1610612743,Denver Nuggets,0,1,1610612741,Chicago Bulls,1,0,38,35,73,7,19,26,45,54,99,11,7,18,23,36,24,7,16,101,108
2016,2,21601118,3/29/2017,1610612744,Golden State Warriors,0,1,1610612759,San Antonio Spurs,1,0,30,29,59,13,13,26,43,42,85,11,0,11,15,27,31,9,15,90,110
2016,2,21601118,3/29/2017,1610612759,San Antonio Spurs,1,0,1610612744,Golden State Warriors,0,1,25,34,59,9,15,24,34,49,83,21,5,26,23,28,20,7,17,90,98
2021,2,22100178,11/12/2021,1610612756,Phoenix Suns,0,1,1610612763,Memphis Grizzlies,1,0,28,29,57,18,19,37,46,48,94,9,0,9,6,42,28,6,12,104,119
2021,2,22100178,11/12/2021,1610612763,Memphis Grizzlies,1,0,1610612756,Phoenix Suns,0,1,30,35,65,7,26,33,37,61,98,13,10,23,20,47,19,12,15,104,94
2019,2,21900259,11/27/2019,1610612745,Houston Rockets,1,1,1610612748,Miami Heat,0,0,23,16,39,15,29,44,38,45,83,26,7,33,12,36,19,8,15,102,117
2019,2,21900259,11/27/2019,1610612748,Miami Heat,0,0,1610612745,Houston Rockets,1,1,23,20,43,14,23,37,37,43,80,20,7,27,10,37,22,11,19,103,108
2015,2,21501013,3/17/2016,1610612755,Philadelphia 76ers,1,0,1610612764,Washington Wizards,0,1,29,29,58,6,27,33,35,56,91,18,8,26,10,50,17,8,11,103,94
2015,2,21501013,3/17/2016,1610612764,Washington Wizards,0,1,1610612755,Philadelphia 76ers,1,0,34,29,63,6,21,27,40,50,90,13,6,19,19,35,25,16,23,105,99
2018,2,21800997,3/10/2019,1610612742,Dallas Mavericks,1,0,1610612745,Houston Rockets,0,1,22,21,43,9,23,32,31,44,75,22,5,27,11,35,24,6,17,95,93
2018,2,21800997,3/10/2019,1610612745,Houston Rockets,0,1,1610612742,Dallas Mavericks,1,0,16,20,36,16,36,52,32,56,88,14,8,22,16,45,18,6,13,95,94
2018,2,21800867,2/21/2019,1610612739,Cleveland Cavaliers,1,1,1610612756,Phoenix Suns,0,0,29,20,49,13,23,36,42,43,85,14,6,20,15,29,34,12,18,99,111
2018,2,21800867,2/21/2019,1610612756,Phoenix Suns,0,0,1610612739,Cleveland Cavaliers,1,1,25,27,52,10,22,32,35,49,84,18,7,25,14,42,26,11,17,100,98
2018,2,21800768,1/31/2019,1610612744,Golden State Warriors,1,0,1610612755,Philadelphia 76ers,0,1,30,20,50,11,27,38,41,47,88,11,5,16,13,37,30,11,15,99,104
2018,2,21800768,1/31/2019,1610612755,Philadelphia 76ers,0,1,1610612744,Golden State Warriors,1,0,29,22,51,12,25,37,41,47,88,19,5,24,20,30,30,13,19,97,113
2018,2,21800383,12/8/2018,1610612738,Boston Celtics,0,1,1610612741,Chicago Bulls,1,0,28,22,50,22,21,43,50,43,93,11,4,15,15,31,34,3,7,92,133
2018,2,21800383,12/8/2018,1610612741,Chicago Bulls,1,0,1610612738,Boston Celtics,0,1,25,32,57,6,18,24,31,50,81,9,5,14,12,41,16,10,17,94,77
2018,2,21800321,11/30/2018,1610612741,Chicago Bulls,0,0,1610612765,Detroit Pistons,1,1,34,31,65,3,18,21,37,49,86,11,3,14,10,41,25,5,15,97,88
2018,2,21800321,11/30/2018,1610612765,Detroit Pistons,1,1,1610612741,Chicago Bulls,0,0,28,30,58,13,21,34,41,51,92,12,4,16,17,36,24,5,13,97,107
2016,2,21601117,3/29/2017,1610612740,New Orleans Pelicans,1,1,1610612742,Dallas Mavericks,0,0,30,24,54,12,18,30,42,42,84,25,8,33,12,33,26,3,6,91,121
2016,2,21601117,3/29/2017,1610612742,Dallas Mavericks,0,0,1610612740,New Orleans Pelicans,1,1,30,34,64,14,13,27,44,47,91,16,1,17,12,36,25,5,5,92,118
2016,2,21600561,1/8/2017,1610612746,LA Clippers,1,1,1610612748,Miami Heat,0,0,27,29,56,9,21,30,36,50,86,17,8,25,11,42,27,6,11,98,98
2016,2,21600561,1/8/2017,1610612748,Miami Heat,0,0,1610612746,LA Clippers,1,1,24,33,57,7,20,27,31,53,84,17,4,21,13,42,14,8,15,98,86
2016,2,21600118,11/10/2016,1610612741,Chicago Bulls,0,1,1610612748,Miami Heat,1,0,31,42,73,6,10,16,37,52,89,18,2,20,19,33,18,8,12,90,98
2016,2,21600118,11/10/2016,1610612748,Miami Heat,1,0,1610612741,Chicago Bulls,0,1,23,36,59,13,16,29,36,52,88,10,5,15,18,37,22,7,13,91,95
2014,2,21400772,2/8/2015,1610612759,San Antonio Spurs,0,0,1610612761,Toronto Raptors,1,1,24,41,65,7,21,28,31,62,93,13,3,16,22,43,23,11,15,94,82
2014,2,21400772,2/8/2015,1610612761,Toronto Raptors,1,1,1610612759,San Antonio Spurs,0,0,28,33,61,4,9,13,32,42,74,19,5,24,11,33,18,10,18,94,87
2018,2,21800263,11/21/2018,1610612758,Sacramento Kings,0,1,1610612762,Utah Jazz,1,0,36,28,64,11,14,25,47,42,89,14,5,19,11,36,27,7,11,96,119
2018,2,21800263,11/21/2018,1610612762,Utah Jazz,1,0,1610612758,Sacramento Kings,0,1,26,23,49,12,27,39,38,50,88,22,9,31,16,41,21,5,10,96,110
2018,2,21800155,11/7/2018,1610612737,Atlanta Hawks,1,0,1610612752,New York Knicks,0,1,26,28,54,11,27,38,37,55,92,22,7,29,17,40,26,8,17,103,107
2018,2,21800155,11/7/2018,1610612752,New York Knicks,0,1,1610612737,Atlanta Hawks,1,0,23,24,47,11,19,30,34,43,77,33,14,47,16,32,15,5,18,102,112
2020,2,22000888,4/21/2021,1610612748,Miami Heat,0,1,1610612759,San Antonio Spurs,1,0,26,26,52,13,18,31,39,44,83,16,4,20,12,32,28,1,7,87,107
2020,2,22000888,4/21/2021,1610612759,San Antonio Spurs,1,0,1610612748,Miami Heat,0,1,21,21,42,10,25,35,31,46,77,15,5,20,10,38,21,8,12,87,87
2017,2,21701168,4/3/2018,1610612746,LA Clippers,1,1,1610612759,San Antonio Spurs,0,0,32,34,66,5,11,16,37,45,82,34,9,43,19,31,21,13,15,100,113
2017,2,21701168,4/3/2018,1610612759,San Antonio Spurs,0,0,1610612746,LA Clippers,1,1,31,33,64,8,16,24,39,49,88,24,4,28,14,37,24,8,12,99,110
2017,2,21701130,3/30/2018,1610612737,Atlanta Hawks,1,0,1610612755,Philadelphia 76ers,0,1,27,35,62,9,30,39,36,65,101,10,5,15,20,48,24,10,17,107,91
2017,2,21701130,3/30/2018,1610612755,Philadelphia 76ers,0,1,1610612737,Atlanta Hawks,1,0,34,23,57,8,30,38,42,53,95,9,4,13,10,46,34,9,15,105,101
2017,2,21701112,3/27/2018,1610612740,New Orleans Pelicans,1,0,1610612757,Portland Trail Blazers,0,1,39,31,70,4,20,24,43,51,94,13,1,14,17,34,28,11,16,102,103
2017,2,21701112,3/27/2018,1610612757,Portland Trail Blazers,0,1,1610612740,New Orleans Pelicans,1,0,34,39,73,10,22,32,44,61,105,9,1,10,18,44,20,3,10,101,107
2017,2,21701082,3/23/2018,1610612761,Toronto Raptors,1,1,1610612751,Brooklyn Nets,0,0,27,31,58,14,14,28,41,45,86,20,9,29,12,39,26,5,11,101,116
2017,2,21701050,3/19/2018,1610612749,Milwaukee Bucks,0,0,1610612739,Cleveland Cavaliers,1,1,37,20,57,8,23,31,45,43,88,19,1,20,14,30,26,4,15,97,117
2021,2,22100177,11/12/2021,1610612745,Houston Rockets,1,0,1610612757,Portland Trail Blazers,0,1,27,26,53,7,25,32,34,51,85,17,10,27,11,45,13,10,13,99,92
2021,2,22100177,11/12/2021,1610612757,Portland Trail Blazers,0,1,1610612745,Houston Rockets,1,0,23,28,51,11,25,36,34,53,87,25,6,31,15,43,21,6,14,100,104
2014,2,21401211,4/13/2015,1610612747,Los Angeles Lakers,0,0,1610612758,Sacramento Kings,1,1,36,45,81,4,11,15,40,56,96,8,5,13,20,38,19,4,11,93,92
2014,2,21401211,4/13/2015,1610612758,Sacramento Kings,1,1,1610612747,Los Angeles Lakers,0,0,31,25,56,4,12,16,35,37,72,28,8,36,6,35,22,8,10,93,102
2015,2,21500961,3/10/2016,1610612743,Denver Nuggets,1,1,1610612756,Phoenix Suns,0,0,31,32,63,13,15,28,44,47,91,15,4,19,13,37,27,4,12,101,116
2015,2,21500961,3/10/2016,1610612756,Phoenix Suns,0,0,1610612743,Denver Nuggets,1,1,27,34,61,6,22,28,33,56,89,26,7,33,18,40,19,9,14,101,98
2018,2,21801145,3/31/2019,1610612737,Atlanta Hawks,1,1,1610612749,Milwaukee Bucks,0,0,30,27,57,22,39,61,52,66,118,10,7,17,20,51,36,6,9,118,136
2018,2,21801145,3/31/2019,1610612749,Milwaukee Bucks,0,0,1610612737,Atlanta Hawks,1,1,31,30,61,17,38,55,48,68,116,22,1,23,25,44,30,10,16,118,135
2018,2,21800683,1/19/2019,1610612737,Atlanta Hawks,1,0,1610612738,Boston Celtics,0,1,28,23,51,12,29,41,40,52,92,13,1,14,16,36,28,10,20,103,105
2018,2,21800683,1/19/2019,1610612738,Boston Celtics,0,1,1610612737,Atlanta Hawks,1,0,27,29,56,12,20,32,39,49,88,23,2,25,13,37,19,8,15,103,113
2018,2,21800528,12/29/2018,1610612740,New Orleans Pelicans,1,0,1610612745,Houston Rockets,0,1,32,32,64,9,19,28,41,51,92,13,4,17,18,36,25,9,15,98,104
2018,2,21800528,12/29/2018,1610612745,Houston Rockets,0,1,1610612740,New Orleans Pelicans,1,0,19,16,35,16,30,46,35,46,81,22,6,28,10,38,21,7,12,96,108
2018,2,21800209,11/14/2018,1610612752,New York Knicks,0,0,1610612760,Oklahoma City Thunder,1,1,32,30,62,7,19,26,39,49,88,18,5,23,13,39,18,11,18,102,103
2018,2,21800209,11/14/2018,1610612760,Oklahoma City Thunder,1,1,1610612752,New York Knicks,0,0,35,27,62,16,17,33,51,44,95,10,2,12,16,30,32,8,16,102,128
2018,2,21800156,11/7/2018,1610612748,Miami Heat,1,1,1610612759,San Antonio Spurs,0,0,26,35,61,10,22,32,36,57,93,13,5,18,20,40,21,8,13,95,95
2018,2,21800156,11/7/2018,1610612759,San Antonio Spurs,0,0,1610612748,Miami Heat,1,1,18,44,62,13,19,32,31,63,94,13,1,14,17,47,19,8,12,96,88
2018,2,21800105,10/31/2018,1610612752,New York Knicks,1,0,1610612754,Indiana Pacers,0,1,22,32,54,12,13,25,34,45,79,21,3,24,14,33,18,10,17,95,101
2018,2,21800105,10/31/2018,1610612754,Indiana Pacers,0,1,1610612752,New York Knicks,1,0,39,24,63,6,14,20,45,38,83,11,6,17,10,30,24,6,15,95,107
2017,2,21701190,4/6/2018,1610612747,Los Angeles Lakers,1,0,1610612750,Minnesota Timberwolves,0,1,23,32,55,8,16,24,31,48,79,26,6,32,19,31,16,14,21,97,96
2017,2,21701190,4/6/2018,1610612750,Minnesota Timberwolves,0,1,1610612747,Los Angeles Lakers,1,0,35,39,74,8,18,26,43,57,100,19,7,26,20,40,25,3,5,97,113
2017,2,21701129,3/30/2018,1610612741,Chicago Bulls,0,1,1610612753,Orlando Magic,1,0,16,27,43,14,27,41,30,54,84,16,7,23,14,44,16,11,17,97,90
2017,2,21701129,3/30/2018,1610612753,Orlando Magic,1,0,1610612741,Chicago Bulls,0,1,24,31,55,7,32,39,31,63,94,13,1,14,16,48,16,11,13,97,82
2016,2,21601116,3/29/2017,1610612754,Indiana Pacers,0,0,1610612763,Memphis Grizzlies,1,1,27,33,60,10,15,25,37,48,85,13,2,15,13,36,19,8,12,91,97
2016,2,21601116,3/29/2017,1610612763,Memphis Grizzlies,1,1,1610612754,Indiana Pacers,0,0,29,27,56,12,20,32,41,47,88,16,2,18,14,33,22,5,8,92,110
2016,2,21600560,1/8/2017,1610612751,Brooklyn Nets,1,0,1610612755,Philadelphia 76ers,0,1,26,25,51,10,17,27,36,42,78,13,4,17,4,40,21,11,22,102,95
2016,2,21600560,1/8/2017,1610612755,Philadelphia 76ers,0,1,1610612751,Brooklyn Nets,1,0,29,38,67,8,19,27,37,57,94,23,4,27,18,41,19,6,13,102,105
2014,2,21401210,4/13/2015,1610612742,Dallas Mavericks,0,0,1610612762,Utah Jazz,1,1,25,37,62,9,11,20,34,48,82,15,8,23,14,38,18,10,17,95,92
2014,2,21401210,4/13/2015,1610612762,Utah Jazz,1,1,1610612742,Dallas Mavericks,0,0,30,24,54,11,17,28,41,41,82,16,10,26,15,31,24,4,15,95,109
2014,2,21400771,2/8/2015,1610612745,Houston Rockets,1,0,1610612757,Portland Trail Blazers,0,1,18,29,47,13,22,35,31,51,82,23,11,34,17,38,24,8,11,90,98
2014,2,21400771,2/8/2015,1610612757,Portland Trail Blazers,0,1,1610612745,Houston Rockets,1,0,31,16,47,9,20,29,40,36,76,20,3,23,8,30,20,7,11,91,109
2018,2,21800996,3/10/2019,1610612753,Orlando Magic,0,0,1610612763,Memphis Grizzlies,1,1,19,30,49,12,26,38,31,56,87,23,4,27,17,41,23,6,14,98,97
2018,2,21800996,3/10/2019,1610612763,Memphis Grizzlies,1,1,1610612753,Orlando Magic,0,0,25,26,51,9,22,31,34,48,82,28,3,31,10,39,23,6,12,98,105
2018,2,21800452,12/18/2018,1610612737,Atlanta Hawks,1,1,1610612764,Washington Wizards,0,0,25,22,47,12,20,32,37,42,79,32,7,39,16,30,23,14,24,104,118
2018,2,21800452,12/18/2018,1610612764,Washington Wizards,0,0,1610612737,Atlanta Hawks,1,1,23,20,43,13,27,40,36,47,83,25,11,36,13,40,26,4,15,104,110
2018,2,21800382,12/8/2018,1610612751,Brooklyn Nets,0,1,1610612752,New York Knicks,1,0,32,34,66,11,11,22,43,45,88,15,10,25,17,32,27,8,16,100,112
2018,2,21800382,12/8/2018,1610612752,New York Knicks,1,0,1610612751,Brooklyn Nets,0,1,31,26,57,8,18,26,39,44,83,18,12,30,11,39,22,5,13,99,104
2018,2,21800320,11/30/2018,1610612762,Utah Jazz,0,1,1610612766,Charlotte Hornets,1,0,26,15,41,18,22,40,44,37,81,13,5,18,8,32,32,8,14,97,119
2018,2,21800320,11/30/2018,1610612766,Charlotte Hornets,1,0,1610612762,Utah Jazz,0,1,38,29,67,9,19,28,47,48,95,8,5,13,12,38,19,5,8,97,111
2018,2,21800210,11/14/2018,1610612742,Dallas Mavericks,1,1,1610612762,Utah Jazz,0,0,33,16,49,12,16,28,45,32,77,16,8,24,8,28,24,11,20,100,118
2018,2,21800210,11/14/2018,1610612762,Utah Jazz,0,0,1610612742,Dallas Mavericks,1,1,19,27,46,6,29,35,25,56,81,12,7,19,13,47,16,12,22,99,68
2020,2,22000887,4/21/2021,1610612745,Houston Rockets,1,0,1610612762,Utah Jazz,0,1,25,25,50,10,39,49,35,64,99,9,8,17,15,53,17,7,11,102,89
2020,2,22000887,4/21/2021,1610612762,Utah Jazz,0,1,1610612745,Houston Rockets,1,0,24,20,44,17,29,46,41,49,90,13,3,16,9,40,27,7,12,101,112
2017,2,21701147,4/1/2018,1610612737,Atlanta Hawks,1,1,1610612753,Orlando Magic,0,0,30,19,49,11,25,36,41,44,85,1,0,1,9,35,33,8,16,93,94
2017,2,21701147,4/1/2018,1610612753,Orlando Magic,0,0,1610612737,Atlanta Hawks,1,1,23,37,60,10,26,36,33,63,96,12,1,13,15,49,19,0,5,93,88
2014,2,21401212,4/13/2015,1610612744,Golden State Warriors,1,1,1610612763,Memphis Grizzlies,0,0,26,24,50,13,11,24,39,35,74,20,7,27,10,28,30,11,21,99,111
2014,2,21401212,4/13/2015,1610612763,Memphis Grizzlies,0,0,1610612744,Golden State Warriors,1,1,36,47,83,5,10,15,41,57,98,20,5,25,25,36,24,9,15,100,107
2014,2,21400770,2/8/2015,1610612741,Chicago Bulls,0,1,1610612753,Orlando Magic,1,0,29,26,55,8,14,22,37,40,77,16,2,18,9,33,27,9,15,91,98
2014,2,21400770,2/8/2015,1610612753,Orlando Magic,1,0,1610612741,Chicago Bulls,0,1,30,28,58,9,16,25,39,44,83,10,3,13,16,30,21,11,18,91,97
2019,2,21900258,11/27/2019,1610612752,New York Knicks,0,0,1610612761,Toronto Raptors,1,1,21,26,47,12,29,41,33,55,88,20,4,24,21,36,19,6,18,97,98
2019,2,21900258,11/27/2019,1610612761,Toronto Raptors,1,1,1610612752,New York Knicks,0,0,25,28,53,21,20,41,46,48,94,13,4,17,19,30,26,6,12,97,126
2015,2,21501196,4/10/2016,1610612742,Dallas Mavericks,0,0,1610612746,LA Clippers,1,1,22,22,44,8,22,30,30,44,74,23,10,33,11,38,18,11,16,95,91
2015,2,21501196,4/10/2016,1610612746,LA Clippers,1,1,1610612742,Dallas Mavericks,0,0,28,30,58,9,9,18,37,39,76,15,22,37,8,44,25,6,11,96,98
2022,2,22200512,12/27/2022,1610612742,Dallas Mavericks,1,1,1610612752,New York Knicks,0,0,31,13,44,13,33,46,44,46,90,25,8,33,10,40,20,5,9,103,126
2022,2,22200512,12/27/2022,1610612752,New York Knicks,0,0,1610612742,Dallas Mavericks,1,1,29,24,53,16,34,50,45,58,103,15,9,24,21,42,27,4,10,104,121
2018,2,21800866,2/14/2019,1610612740,New Orleans Pelicans,1,1,1610612760,Oklahoma City Thunder,0,0,38,28,66,12,14,26,50,42,92,19,5,24,14,31,35,8,15,104,131
2018,2,21800866,2/14/2019,1610612760,Oklahoma City Thunder,0,0,1610612740,New Orleans Pelicans,1,1,40,22,62,10,34,44,50,56,106,12,1,13,17,40,27,7,13,106,122
2018,2,21800767,1/31/2019,1610612751,Brooklyn Nets,0,0,1610612759,San Antonio Spurs,1,1,31,24,55,11,23,34,42,47,89,19,10,29,10,42,30,6,14,106,114
2018,2,21800767,1/31/2019,1610612759,San Antonio Spurs,1,1,1610612751,Brooklyn Nets,0,0,28,39,67,12,21,33,40,60,100,25,4,29,18,43,23,5,9,107,117
2018,2,21800527,12/29/2018,1610612749,Milwaukee Bucks,1,1,1610612751,Brooklyn Nets,0,0,26,19,45,21,30,51,47,49,96,14,2,16,11,38,30,6,11,103,129
2018,2,21800527,12/29/2018,1610612751,Brooklyn Nets,0,0,1610612749,Milwaukee Bucks,1,1,23,21,44,15,20,35,38,41,79,24,11,35,8,37,28,6,15,102,115
2021,2,22100176,11/12/2021,1610612739,Cleveland Cavaliers,1,1,1610612765,Detroit Pistons,0,0,25,16,41,14,27,41,39,43,82,6,3,9,10,34,27,12,21,96,98
2021,2,22100176,11/12/2021,1610612765,Detroit Pistons,0,0,1610612739,Cleveland Cavaliers,1,1,20,29,49,9,21,30,29,50,79,11,2,13,13,37,18,12,23,94,78
2018,2,21800211,11/14/2018,1610612756,Phoenix Suns,1,1,1610612759,San Antonio Spurs,0,0,32,21,53,15,16,31,47,37,84,7,1,8,6,32,27,7,16,97,116
2018,2,21800211,11/14/2018,1610612759,San Antonio Spurs,0,0,1610612756,Phoenix Suns,1,1,28,32,60,7,16,23,35,48,83,19,5,24,16,34,16,9,18,97,96
2016,2,21601115,3/29/2017,1610612748,Miami Heat,0,1,1610612752,New York Knicks,1,0,28,31,59,12,13,25,40,44,84,13,4,17,11,36,18,2,11,90,105
2016,2,21601115,3/29/2017,1610612752,New York Knicks,1,0,1610612748,Miami Heat,0,1,28,36,64,5,20,25,33,56,89,17,4,21,23,35,19,11,16,91,88
2016,2,21600559,1/8/2017,1610612757,Portland Trail Blazers,1,0,1610612765,Detroit Pistons,0,1,36,27,63,15,20,35,51,47,98,7,5,12,13,37,36,14,19,110,124
2016,2,21600559,1/8/2017,1610612765,Detroit Pistons,0,1,1610612757,Portland Trail Blazers,1,0,46,34,80,8,17,25,54,51,105,9,3,12,12,39,19,5,10,111,125
2018,2,21801144,3/30/2019,1610612756,Phoenix Suns,1,0,1610612763,Memphis Grizzlies,0,1,31,22,53,12,16,28,43,38,81,17,6,23,11,31,27,15,20,102,115
2018,2,21801144,3/30/2019,1610612763,Memphis Grizzlies,0,1,1610612756,Phoenix Suns,1,0,33,31,64,8,17,25,41,48,89,30,10,40,19,36,24,8,11,101,120
2018,2,21800995,3/10/2019,1610612737,Atlanta Hawks,1,1,1610612740,New Orleans Pelicans,0,0,31,30,61,17,20,37,48,50,98,15,3,18,13,39,30,6,10,102,128
2018,2,21800995,3/10/2019,1610612740,New Orleans Pelicans,0,0,1610612737,Atlanta Hawks,1,1,27,33,60,18,23,41,45,56,101,8,0,8,9,47,29,4,8,104,116
2018,2,21800682,1/19/2019,1610612749,Milwaukee Bucks,0,1,1610612753,Orlando Magic,1,0,35,20,55,12,18,30,47,38,85,12,3,15,7,32,22,5,13,100,118
2018,2,21800682,1/19/2019,1610612753,Orlando Magic,1,0,1610612749,Milwaukee Bucks,0,1,30,31,61,14,18,32,44,49,93,6,3,9,7,43,31,7,9,99,108
2018,2,21800608,1/9/2019,1610612755,Philadelphia 76ers,0,0,1610612764,Washington Wizards,1,1,29,30,59,8,19,27,37,49,86,24,7,31,21,31,23,16,24,103,106
2018,2,21800608,1/9/2019,1610612764,Washington Wizards,1,1,1610612755,Philadelphia 76ers,0,0,34,26,60,13,14,27,47,40,87,16,5,21,12,30,26,12,19,103,123
2018,2,21800526,12/28/2018,1610612746,LA Clippers,0,1,1610612747,Los Angeles Lakers,1,0,34,38,72,6,13,19,40,51,91,32,2,34,10,43,21,5,14,112,118
2018,2,21800526,12/28/2018,1610612747,Los Angeles Lakers,1,0,1610612746,LA Clippers,0,1,25,32,57,11,19,30,36,51,87,24,11,35,11,47,23,10,17,111,107
2018,2,21800451,12/18/2018,1610612739,Cleveland Cavaliers,0,1,1610612754,Indiana Pacers,1,0,32,28,60,6,25,31,38,53,91,10,3,13,13,40,19,7,12,94,92
2018,2,21800451,12/18/2018,1610612754,Indiana Pacers,1,0,1610612739,Cleveland Cavaliers,0,1,33,38,71,4,18,22,37,56,93,13,8,21,19,41,21,7,9,95,91
2018,2,21800381,12/8/2018,1610612739,Cleveland Cavaliers,1,1,1610612764,Washington Wizards,0,0,32,26,58,15,16,31,47,42,89,7,3,10,16,27,26,3,9,89,116
2018,2,21800381,12/8/2018,1610612764,Washington Wizards,0,0,1610612739,Cleveland Cavaliers,1,1,24,24,48,14,24,38,38,48,86,11,5,16,12,38,26,5,8,89,101
2018,2,21800262,11/21/2018,1610612759,San Antonio Spurs,1,0,1610612763,Memphis Grizzlies,0,1,28,32,60,7,15,22,35,47,82,26,4,30,11,37,21,4,9,93,103
2018,2,21800262,11/21/2018,1610612763,Memphis Grizzlies,0,1,1610612759,San Antonio Spurs,1,0,31,25,56,8,17,25,39,42,81,18,3,21,9,34,21,4,9,92,104
2020,2,22000886,4/21/2021,1610612737,Atlanta Hawks,0,0,1610612752,New York Knicks,1,1,37,31,68,12,22,34,49,53,102,17,7,24,15,41,28,8,10,107,127
2020,2,22000886,4/21/2021,1610612752,New York Knicks,1,1,1610612737,Atlanta Hawks,0,0,30,26,56,19,16,35,49,42,91,20,5,25,13,31,29,10,17,108,137
2018,2,21800104,10/31/2018,1610612751,Brooklyn Nets,1,1,1610612765,Detroit Pistons,0,0,31,32,63,12,26,38,43,58,101,22,8,30,21,43,26,8,16,109,120
2018,2,21800104,10/31/2018,1610612765,Detroit Pistons,0,0,1610612751,Brooklyn Nets,1,1,28,31,59,11,23,34,39,54,93,30,9,39,18,40,16,5,17,110,119
2018,2,21801143,3/30/2019,1610612750,Minnesota Timberwolves,1,0,1610612755,Philadelphia 76ers,0,1,28,32,60,11,15,26,39,47,86,20,5,25,8,41,23,5,9,99,109
2018,2,21801143,3/30/2019,1610612755,Philadelphia 76ers,0,1,1610612750,Minnesota Timberwolves,1,0,29,34,63,15,16,31,44,50,94,15,6,21,19,33,32,6,13,100,118
2019,2,21900668,1/23/2020,1610612742,Dallas Mavericks,0,1,1610612757,Portland Trail Blazers,1,0,26,20,46,22,25,47,48,45,93,15,9,24,13,37,27,4,9,101,133
2019,2,21900668,1/23/2020,1610612757,Portland Trail Blazers,1,0,1610612742,Dallas Mavericks,0,1,25,27,52,21,18,39,46,45,91,12,3,15,14,32,20,5,15,100,125
2019,2,21900667,1/23/2020,1610612747,Los Angeles Lakers,0,1,1610612751,Brooklyn Nets,1,0,28,28,56,19,19,38,47,47,94,15,5,20,14,36,28,12,16,105,128
2019,2,21900667,1/23/2020,1610612751,Brooklyn Nets,1,0,1610612747,Los Angeles Lakers,0,1,19,26,45,21,25,46,40,51,91,12,3,15,10,42,30,9,16,105,113
2019,2,21900666,1/23/2020,1610612739,Cleveland Cavaliers,1,0,1610612764,Washington Wizards,0,1,33,30,63,11,22,33,44,52,96,13,4,17,14,40,24,3,9,97,112
2019,2,21900666,1/23/2020,1610612764,Washington Wizards,0,1,1610612739,Cleveland Cavaliers,1,0,31,18,49,16,20,36,47,38,85,14,4,18,8,31,28,7,10,98,124
2019,2,21900665,1/22/2020,1610612744,Golden State Warriors,1,0,1610612762,Utah Jazz,0,1,29,36,65,6,17,23,35,53,88,20,4,24,12,42,20,5,8,98,96
2019,2,21900665,1/22/2020,1610612762,Utah Jazz,0,1,1610612744,Golden State Warriors,1,0,33,20,53,17,23,40,50,43,93,12,11,23,19,30,31,5,11,99,129
2019,2,21900664,1/22/2020,1610612754,Indiana Pacers,0,1,1610612756,Phoenix Suns,1,0,36,28,64,9,11,20,45,39,84,13,7,20,6,38,26,7,9,96,112
2019,2,21900664,1/22/2020,1610612756,Phoenix Suns,1,0,1610612754,Indiana Pacers,0,1,26,38,64,4,16,20,30,54,84,23,3,26,15,42,13,8,13,96,87
2019,2,21900663,1/22/2020,1610612740,New Orleans Pelicans,1,0,1610612759,San Antonio Spurs,0,1,25,23,48,14,22,36,39,45,84,25,7,32,9,38,26,7,14,103,117
2019,2,21900663,1/22/2020,1610612759,San Antonio Spurs,0,1,1610612740,New Orleans Pelicans,1,0,34,28,62,11,16,27,45,44,89,20,5,25,11,36,17,6,11,104,121
2019,2,21900662,1/22/2020,1610612743,Denver Nuggets,0,0,1610612745,Houston Rockets,1,1,32,32,64,10,18,28,42,50,92,11,4,15,14,38,25,10,15,99,105
2019,2,21900662,1/22/2020,1610612745,Houston Rockets,1,1,1610612743,Denver Nuggets,0,0,29,31,60,13,16,29,42,47,89,24,4,28,21,29,26,12,19,100,121
2019,2,21900661,1/22/2020,1610612741,Chicago Bulls,1,1,1610612750,Minnesota Timberwolves,0,0,30,24,54,9,21,30,39,45,84,30,7,37,15,33,21,7,13,101,117
2019,2,21900661,1/22/2020,1610612750,Minnesota Timberwolves,0,0,1610612741,Chicago Bulls,1,1,26,16,42,15,29,44,41,45,86,13,11,24,12,39,27,9,18,101,110
2019,2,21900660,1/22/2020,1610612755,Philadelphia 76ers,0,0,1610612761,Toronto Raptors,1,1,14,24,38,18,28,46,32,52,84,13,5,18,9,46,25,6,13,97,95
2019,2,21900660,1/22/2020,1610612761,Toronto Raptors,1,1,1610612755,Philadelphia 76ers,0,0,27,26,53,13,20,33,40,46,86,14,7,21,11,38,27,8,12,98,107
2019,2,21900659,1/22/2020,1610612747,Los Angeles Lakers,0,1,1610612752,New York Knicks,1,0,27,28,55,9,18,27,36,46,82,19,9,28,16,35,18,4,10,90,100
2019,2,21900659,1/22/2020,1610612752,New York Knicks,1,0,1610612747,Los Angeles Lakers,0,1,25,29,54,11,23,34,36,52,88,9,4,13,21,34,24,13,17,90,92
2019,2,21900658,1/22/2020,1610612748,Miami Heat,1,1,1610612764,Washington Wizards,0,0,26,26,52,17,16,33,43,42,85,31,5,36,8,36,29,10,16,109,134
2019,2,21900658,1/22/2020,1610612764,Washington Wizards,0,0,1610612748,Miami Heat,1,1,37,20,57,13,29,42,50,49,99,16,4,20,11,39,30,3,11,111,129
2019,2,21900657,1/22/2020,1610612738,Boston Celtics,1,1,1610612763,Memphis Grizzlies,0,0,31,26,57,14,18,32,45,44,89,15,5,20,10,37,32,7,11,99,119
2019,2,21900657,1/22/2020,1610612763,Memphis Grizzlies,0,0,1610612738,Boston Celtics,1,1,25,28,53,11,21,32,36,49,85,12,3,15,12,39,24,11,19,100,95
2019,2,21900656,1/22/2020,1610612737,Atlanta Hawks,1,1,1610612746,LA Clippers,0,0,25,42,67,11,24,35,36,66,102,19,4,23,29,40,21,5,15,100,102
2019,2,21900656,1/22/2020,1610612746,LA Clippers,0,0,1610612737,Atlanta Hawks,1,1,29,28,57,4,17,21,33,45,78,25,14,39,10,41,19,8,14,99,95
2019,2,21900655,1/22/2020,1610612753,Orlando Magic,1,0,1610612760,Oklahoma City Thunder,0,1,30,27,57,14,21,35,44,48,92,12,4,16,15,36,26,10,15,100,114
2018,2,21800865,2/14/2019,1610612737,Atlanta Hawks,1,0,1610612752,New York Knicks,0,1,23,30,53,10,28,38,33,58,91,15,4,19,15,45,19,9,12,96,91
2018,2,21800865,2/14/2019,1610612752,New York Knicks,0,1,1610612737,Atlanta Hawks,1,0,26,27,53,12,19,31,38,46,84,18,8,26,16,33,21,8,14,96,106
2018,2,21800607,1/9/2019,1610612738,Boston Celtics,1,1,1610612754,Indiana Pacers,0,0,36,20,56,14,18,32,50,38,88,21,3,24,9,29,32,6,14,102,135
2018,2,21800607,1/9/2019,1610612754,Indiana Pacers,0,0,1610612738,Boston Celtics,1,1,30,33,63,9,19,28,39,52,91,21,12,33,16,40,26,7,11,101,108
2019,2,21900655,1/22/2020,1610612760,Oklahoma City Thunder,0,1,1610612753,Orlando Magic,1,0,37,20,57,9,10,19,46,30,76,19,4,23,2,30,22,9,15,100,120
2019,2,21900654,1/22/2020,1610612758,Sacramento Kings,0,0,1610612765,Detroit Pistons,1,1,32,31,63,10,25,35,42,56,98,12,11,23,15,45,23,9,11,105,106
2019,2,21900654,1/22/2020,1610612765,Detroit Pistons,1,1,1610612758,Sacramento Kings,0,0,27,17,44,12,17,29,39,34,73,37,7,44,4,33,19,10,17,106,127
2019,2,21900653,1/21/2020,1610612742,Dallas Mavericks,1,0,1610612746,LA Clippers,0,1,27,21,48,12,31,43,39,52,91,17,7,24,17,38,23,9,13,98,107
2019,2,21900653,1/21/2020,1610612746,LA Clippers,0,1,1610612742,Dallas Mavericks,1,0,24,35,59,12,26,38,36,61,97,26,7,33,26,40,19,7,11,98,110
2019,2,21900652,1/20/2020,1610612744,Golden State Warriors,0,0,1610612757,Portland Trail Blazers,1,1,39,41,80,9,27,36,48,68,116,19,3,22,24,46,30,4,9,116,124
2019,2,21900652,1/20/2020,1610612757,Portland Trail Blazers,1,1,1610612744,Golden State Warriors,0,0,30,26,56,14,30,44,44,56,100,27,3,30,13,45,21,7,12,113,129
2019,2,21900651,1/20/2020,1610612754,Indiana Pacers,0,0,1610612762,Utah Jazz,1,1,32,35,67,7,19,26,39,54,93,3,4,7,12,44,23,5,14,98,88
2019,2,21900651,1/20/2020,1610612762,Utah Jazz,1,1,1610612754,Indiana Pacers,0,0,35,21,56,12,19,31,47,40,87,12,0,12,16,24,22,15,21,98,118
2019,2,21900650,1/20/2020,1610612756,Phoenix Suns,1,0,1610612759,San Antonio Spurs,0,1,34,24,58,8,14,22,42,38,80,26,4,30,11,28,26,12,14,97,118
2019,2,21900650,1/20/2020,1610612759,San Antonio Spurs,0,1,1610612756,Phoenix Suns,1,0,26,30,56,17,14,31,43,44,87,17,5,22,10,35,30,3,9,96,120
2016,2,21600558,1/7/2017,1610612759,San Antonio Spurs,1,1,1610612766,Charlotte Hornets,0,0,23,32,55,13,21,34,36,53,89,17,3,20,12,43,29,5,7,93,102
2016,2,21600558,1/7/2017,1610612766,Charlotte Hornets,0,0,1610612759,San Antonio Spurs,1,1,26,28,54,4,17,21,30,45,75,21,4,25,10,37,18,9,16,93,85
2016,2,21600117,11/10/2016,1610612740,New Orleans Pelicans,0,1,1610612749,Milwaukee Bucks,1,0,30,34,64,9,16,25,39,50,89,25,2,27,12,39,22,4,10,98,112
2016,2,21600117,11/10/2016,1610612749,Milwaukee Bucks,1,0,1610612740,New Orleans Pelicans,0,1,34,39,73,6,12,18,40,51,91,20,5,25,16,37,23,9,11,100,106
2019,2,21900649,1/20/2020,1610612743,Denver Nuggets,0,1,1610612750,Minnesota Timberwolves,1,0,32,27,59,11,20,31,43,47,90,10,2,12,17,32,26,7,13,95,107
2019,2,21900649,1/20/2020,1610612750,Minnesota Timberwolves,1,0,1610612743,Denver Nuggets,0,1,25,24,49,13,29,42,38,53,91,11,3,14,12,42,26,9,9,94,100
2014,2,21400769,2/8/2015,1610612750,Minnesota Timberwolves,0,1,1610612765,Detroit Pistons,1,0,34,30,64,5,7,12,39,37,76,29,5,34,15,24,26,8,15,92,112
2014,2,21400769,2/8/2015,1610612765,Detroit Pistons,1,0,1610612750,Minnesota Timberwolves,0,1,27,21,48,10,21,31,37,42,79,17,4,21,13,32,18,6,15,92,101
2019,2,21900648,1/20/2020,1610612738,Boston Celtics,1,1,1610612747,Los Angeles Lakers,0,0,36,23,59,16,18,34,52,41,93,19,10,29,19,27,31,5,12,101,139
2019,2,21900648,1/20/2020,1610612747,Los Angeles Lakers,0,0,1610612738,Boston Celtics,1,1,32,31,63,7,19,26,39,50,89,22,7,29,16,36,22,10,15,100,107
2019,2,21900647,1/20/2020,1610612741,Chicago Bulls,0,0,1610612749,Milwaukee Bucks,1,1,20,24,44,14,34,48,34,58,92,16,2,18,11,49,18,7,17,107,98
2019,2,21900647,1/20/2020,1610612749,Milwaukee Bucks,1,1,1610612741,Chicago Bulls,0,0,34,17,51,11,15,26,45,32,77,10,13,23,5,33,34,11,23,107,111
2019,2,21900646,1/20/2020,1610612740,New Orleans Pelicans,0,1,1610612763,Memphis Grizzlies,1,0,21,19,40,21,27,48,42,46,88,21,3,24,10,38,24,8,17,107,126
2019,2,21900646,1/20/2020,1610612763,Memphis Grizzlies,1,0,1610612740,New Orleans Pelicans,0,1,37,33,70,9,24,33,46,57,103,15,6,21,21,39,26,7,14,106,116
2019,2,21900645,1/20/2020,1610612745,Houston Rockets,1,0,1610612760,Oklahoma City Thunder,0,1,34,18,52,9,36,45,43,54,97,12,5,17,12,45,21,8,11,102,107
2019,2,21900645,1/20/2020,1610612760,Oklahoma City Thunder,0,1,1610612745,Houston Rockets,1,0,28,32,60,12,20,32,40,52,92,20,6,26,14,40,14,6,13,102,112
2019,2,21900644,1/20/2020,1610612748,Miami Heat,1,1,1610612758,Sacramento Kings,0,0,26,15,41,16,26,42,42,41,83,18,4,22,8,35,26,11,21,107,118
2019,2,21900644,1/20/2020,1610612758,Sacramento Kings,0,0,1610612748,Miami Heat,1,1,31,24,55,13,38,51,44,62,106,12,3,15,22,42,27,9,15,106,113
2019,2,21900643,1/20/2020,1610612739,Cleveland Cavaliers,1,0,1610612752,New York Knicks,0,1,21,40,61,11,22,33,32,62,94,11,6,17,19,47,15,6,10,94,86
2019,2,21900643,1/20/2020,1610612752,New York Knicks,0,1,1610612739,Cleveland Cavaliers,1,0,32,30,62,9,14,23,41,44,85,15,2,17,8,38,17,5,10,94,106
2019,2,21900642,1/20/2020,1610612753,Orlando Magic,0,1,1610612766,Charlotte Hornets,1,0,30,34,64,14,14,28,44,48,92,4,5,9,19,33,25,4,11,90,106
2019,2,21900642,1/20/2020,1610612766,Charlotte Hornets,1,0,1610612753,Orlando Magic,0,1,19,24,43,10,23,33,29,47,76,15,5,20,12,37,21,9,18,89,83
2019,2,21900641,1/20/2020,1610612751,Brooklyn Nets,1,0,1610612755,Philadelphia 76ers,0,1,28,24,52,11,18,29,39,42,81,22,12,34,15,34,22,12,22,104,111
2019,2,21900641,1/20/2020,1610612755,Philadelphia 76ers,0,1,1610612751,Brooklyn Nets,1,0,29,26,55,13,26,39,42,52,94,20,7,27,17,38,30,7,13,104,117
2019,2,21900640,1/20/2020,1610612737,Atlanta Hawks,1,0,1610612761,Toronto Raptors,0,1,29,21,50,12,21,33,41,42,83,23,10,33,13,34,26,13,24,111,117
2019,2,21900640,1/20/2020,1610612761,Toronto Raptors,0,1,1610612737,Atlanta Hawks,1,0,25,25,50,13,29,42,38,54,92,33,10,43,16,44,25,9,14,110,122
2019,2,21900639,1/20/2020,1610612764,Washington Wizards,1,1,1610612765,Detroit Pistons,0,0,33,25,58,9,15,24,42,40,82,13,3,16,9,32,22,10,20,102,106
2019,2,21900639,1/20/2020,1610612765,Detroit Pistons,0,0,1610612764,Washington Wizards,1,1,28,29,57,10,22,32,38,51,89,14,6,20,15,40,19,9,17,100,100
2019,2,21900638,1/19/2020,1610612743,Denver Nuggets,1,0,1610612754,Indiana Pacers,0,1,38,27,65,3,20,23,41,47,88,22,10,32,19,31,22,1,9,97,107
2019,2,21900638,1/19/2020,1610612754,Indiana Pacers,0,1,1610612743,Denver Nuggets,1,0,30,27,57,13,16,29,43,43,86,16,3,19,14,32,31,10,15,95,115
2019,2,21900637,1/19/2020,1610612748,Miami Heat,0,0,1610612759,San Antonio Spurs,1,1,27,25,52,10,24,34,37,49,86,18,2,20,13,36,23,5,10,94,102
2019,2,21900637,1/19/2020,1610612759,San Antonio Spurs,1,1,1610612748,Miami Heat,0,0,24,28,52,12,21,33,36,49,85,23,1,24,12,38,27,8,11,93,107
2019,2,21900636,1/18/2020,1610612758,Sacramento Kings,0,0,1610612762,Utah Jazz,1,1,32,28,60,10,16,26,42,44,86,7,5,12,7,38,20,7,10,94,101
2019,2,21900636,1/18/2020,1610612762,Utah Jazz,1,1,1610612758,Sacramento Kings,0,0,29,14,43,14,28,42,43,42,85,23,1,24,12,31,24,3,10,96,123
2019,2,21900635,1/18/2020,1610612757,Portland Trail Blazers,0,0,1610612760,Oklahoma City Thunder,1,1,27,32,59,12,20,32,39,52,91,16,5,21,13,41,11,5,12,98,106
2019,2,21900635,1/18/2020,1610612760,Oklahoma City Thunder,1,1,1610612757,Portland Trail Blazers,0,0,36,25,61,7,15,22,43,40,83,26,10,36,16,32,25,7,13,99,119
2019,2,21900634,1/18/2020,1610612744,Golden State Warriors,1,1,1610612753,Orlando Magic,0,0,31,23,54,12,28,40,43,51,94,11,0,11,11,40,25,7,11,99,109
2019,2,21900634,1/18/2020,1610612753,Orlando Magic,0,0,1610612744,Golden State Warriors,1,1,30,25,55,9,22,31,39,47,86,8,5,13,10,40,21,9,15,98,95
2019,2,21900633,1/18/2020,1610612745,Houston Rockets,1,0,1610612747,Los Angeles Lakers,0,1,28,25,53,12,25,37,40,50,90,23,6,29,14,39,20,13,20,109,115
2019,2,21900633,1/18/2020,1610612747,Los Angeles Lakers,0,1,1610612745,Houston Rockets,1,0,34,26,60,11,22,33,45,48,93,23,9,32,17,38,25,8,17,108,124
2019,2,21900632,1/18/2020,1610612750,Minnesota Timberwolves,1,0,1610612761,Toronto Raptors,0,1,24,20,44,14,36,50,38,56,94,22,5,27,19,39,34,13,17,107,112
2019,2,21900632,1/18/2020,1610612761,Toronto Raptors,0,1,1610612750,Minnesota Timberwolves,1,0,34,22,56,13,22,35,47,44,91,15,2,17,7,38,25,8,14,106,122
2016,2,21601114,3/29/2017,1610612761,Toronto Raptors,1,0,1610612766,Charlotte Hornets,0,1,27,25,52,11,20,31,38,45,83,19,5,24,17,29,23,6,14,91,106
2016,2,21601114,3/29/2017,1610612766,Charlotte Hornets,0,1,1610612761,Toronto Raptors,1,0,23,31,54,16,16,32,39,47,86,16,5,21,14,33,23,4,9,90,110
2019,2,21900631,1/18/2020,1610612739,Cleveland Cavaliers,0,0,1610612741,Chicago Bulls,1,1,25,19,44,15,14,29,40,33,73,21,2,23,11,23,27,18,27,99,116
2019,2,21900631,1/18/2020,1610612741,Chicago Bulls,1,1,1610612739,Cleveland Cavaliers,0,0,39,23,62,9,16,25,48,39,87,13,4,17,7,33,25,5,12,100,118
2019,2,21900630,1/18/2020,1610612752,New York Knicks,1,0,1610612755,Philadelphia 76ers,0,1,29,34,63,6,19,25,35,53,88,11,7,18,19,37,20,8,14,95,87
2019,2,21900630,1/18/2020,1610612755,Philadelphia 76ers,0,1,1610612752,New York Knicks,1,0,24,22,46,10,22,32,34,44,78,12,7,19,7,39,26,4,14,94,90
2014,2,21400768,2/8/2015,1610612754,Indiana Pacers,0,1,1610612766,Charlotte Hornets,1,0,30,35,65,7,12,19,37,47,84,22,3,25,16,31,19,5,12,93,103
2014,2,21400768,2/8/2015,1610612766,Charlotte Hornets,1,0,1610612754,Indiana Pacers,0,1,28,35,63,8,6,14,36,41,77,22,6,28,9,34,24,4,10,93,102
2019,2,21900629,1/18/2020,1610612737,Atlanta Hawks,1,0,1610612765,Detroit Pistons,0,1,30,29,59,10,24,34,40,53,93,13,2,15,18,36,18,12,20,103,103
2019,2,21900629,1/18/2020,1610612765,Detroit Pistons,0,1,1610612737,Atlanta Hawks,1,0,36,18,54,15,17,32,51,35,86,19,6,25,14,23,31,9,18,105,136
2019,2,21900628,1/18/2020,1610612738,Boston Celtics,1,0,1610612756,Phoenix Suns,0,1,27,27,54,15,27,42,42,54,96,20,2,22,11,44,26,6,11,106,119
2019,2,21900628,1/18/2020,1610612756,Phoenix Suns,0,1,1610612738,Boston Celtics,1,0,29,29,58,13,18,31,42,47,89,26,4,30,13,36,27,11,15,106,123
2019,2,21900627,1/18/2020,1610612749,Milwaukee Bucks,0,1,1610612751,Brooklyn Nets,1,0,28,24,52,17,20,37,45,44,89,10,6,16,7,39,30,11,20,112,117
2019,2,21900627,1/18/2020,1610612751,Brooklyn Nets,1,0,1610612749,Milwaukee Bucks,0,1,18,32,50,15,34,49,33,66,99,16,1,17,14,52,23,8,17,111,97
2019,2,21900626,1/18/2020,1610612740,New Orleans Pelicans,1,0,1610612746,LA Clippers,0,1,31,14,45,15,26,41,46,40,86,23,13,36,17,29,32,12,21,110,130
2019,2,21900626,1/18/2020,1610612746,LA Clippers,0,1,1610612740,New Orleans Pelicans,1,0,36,26,62,10,21,31,46,47,93,31,8,39,12,39,22,7,12,109,133
2019,2,21900625,1/17/2020,1610612742,Dallas Mavericks,1,1,1610612757,Portland Trail Blazers,0,0,19,23,42,20,27,47,39,50,89,22,6,28,17,34,19,6,13,97,120
2019,2,21900625,1/17/2020,1610612757,Portland Trail Blazers,0,0,1610612742,Dallas Mavericks,1,1,35,20,55,9,21,30,44,41,85,15,7,22,10,34,25,6,12,98,112
2019,2,21900624,1/17/2020,1610612737,Atlanta Hawks,0,1,1610612759,San Antonio Spurs,1,0,22,20,42,19,21,40,41,41,82,20,7,27,9,34,21,12,19,105,121
2019,2,21900624,1/17/2020,1610612759,San Antonio Spurs,1,0,1610612737,Atlanta Hawks,0,1,37,32,69,8,21,29,45,53,98,22,1,23,17,37,28,10,15,107,120
2019,2,21900623,1/17/2020,1610612748,Miami Heat,0,1,1610612760,Oklahoma City Thunder,1,0,27,21,48,14,22,36,41,43,84,19,5,24,13,31,26,4,11,94,115
2019,2,21900623,1/17/2020,1610612760,Oklahoma City Thunder,1,0,1610612748,Miami Heat,0,1,19,19,38,18,28,46,37,47,84,16,2,18,6,42,29,4,10,94,108
2019,2,21900622,1/17/2020,1610612739,Cleveland Cavaliers,0,0,1610612763,Memphis Grizzlies,1,1,32,24,56,9,27,36,41,51,92,18,8,26,18,37,18,11,15,103,109
2019,2,21900622,1/17/2020,1610612763,Memphis Grizzlies,1,1,1610612739,Cleveland Cavaliers,0,0,36,25,61,9,19,28,45,44,89,14,6,20,9,38,32,6,12,103,113
2019,2,21900621,1/17/2020,1610612761,Toronto Raptors,1,1,1610612764,Washington Wizards,0,0,30,18,48,22,21,43,52,39,91,14,2,16,10,30,35,9,19,108,140
2019,2,21900621,1/17/2020,1610612764,Washington Wizards,0,0,1610612761,Toronto Raptors,1,1,25,29,54,15,20,35,40,49,89,16,7,23,17,37,19,16,28,108,111
2019,2,21900620,1/17/2020,1610612741,Chicago Bulls,0,0,1610612755,Philadelphia 76ers,1,1,27,19,46,8,27,35,35,46,81,11,4,15,11,37,21,9,17,93,89
2019,2,21900620,1/17/2020,1610612755,Philadelphia 76ers,1,1,1610612741,Chicago Bulls,0,0,31,22,53,9,20,29,40,42,82,11,0,11,9,33,30,8,13,91,100
2019,2,21900619,1/17/2020,1610612750,Minnesota Timberwolves,0,0,1610612754,Indiana Pacers,1,1,23,26,49,17,22,39,40,48,88,17,4,21,10,41,22,4,13,99,114
2019,2,21900619,1/17/2020,1610612754,Indiana Pacers,1,1,1610612750,Minnesota Timberwolves,0,0,38,20,58,8,16,24,46,36,82,16,4,20,6,31,24,4,13,100,116
2019,2,21900618,1/16/2020,1610612746,LA Clippers,1,1,1610612753,Orlando Magic,0,0,33,30,63,14,18,32,47,48,95,14,6,20,15,36,29,4,10,99,122
2019,2,21900618,1/16/2020,1610612753,Orlando Magic,0,0,1610612746,LA Clippers,1,1,22,28,50,14,28,42,36,56,92,9,7,16,9,51,24,4,9,100,95
2019,2,21900617,1/16/2020,1610612743,Denver Nuggets,0,1,1610612744,Golden State Warriors,1,0,30,35,65,17,18,35,47,53,100,23,3,26,20,34,31,12,21,113,134
2019,2,21900617,1/16/2020,1610612744,Golden State Warriors,1,0,1610612743,Denver Nuggets,0,1,22,28,50,20,25,45,42,53,95,27,4,31,13,42,36,11,19,115,131
2019,2,21900616,1/16/2020,1610612740,New Orleans Pelicans,1,1,1610612762,Utah Jazz,0,0,40,27,67,11,15,26,51,42,93,25,10,35,11,35,29,9,13,111,138
2019,2,21900616,1/16/2020,1610612762,Utah Jazz,0,0,1610612740,New Orleans Pelicans,1,1,31,30,61,15,24,39,46,54,100,25,7,32,17,41,23,8,13,111,132
2019,2,21900615,1/16/2020,1610612738,Boston Celtics,0,0,1610612749,Milwaukee Bucks,1,1,28,21,49,15,34,49,43,55,98,22,5,27,12,46,16,6,8,106,123
2019,2,21900615,1/16/2020,1610612749,Milwaukee Bucks,1,1,1610612738,Boston Celtics,0,0,27,29,56,16,15,31,43,44,87,26,11,37,9,41,21,4,10,104,128
2019,2,21900614,1/16/2020,1610612752,New York Knicks,1,0,1610612756,Phoenix Suns,0,1,29,35,64,8,18,26,37,53,90,16,8,24,14,43,21,11,18,103,98
2019,2,21900614,1/16/2020,1610612756,Phoenix Suns,0,1,1610612752,New York Knicks,1,0,35,27,62,12,18,30,47,45,92,15,3,18,16,31,31,12,19,104,121
2016,2,21601113,3/29/2017,1610612738,Boston Celtics,1,0,1610612749,Milwaukee Bucks,0,1,23,28,51,12,25,37,35,53,88,18,5,23,24,30,24,9,16,95,100
2016,2,21601113,3/29/2017,1610612749,Milwaukee Bucks,0,1,1610612738,Boston Celtics,1,0,33,23,56,8,14,22,41,37,78,13,4,17,9,29,27,8,16,94,103
2019,2,21900613,1/15/2020,1610612747,Los Angeles Lakers,1,0,1610612753,Orlando Magic,0,1,33,26,59,15,23,38,48,49,97,7,4,11,15,37,34,10,16,104,118
2019,2,21900613,1/15/2020,1610612753,Orlando Magic,0,1,1610612747,Los Angeles Lakers,1,0,33,35,68,10,16,26,43,51,94,23,6,29,16,37,22,7,13,104,119
2016,2,21600557,1/7/2017,1610612737,Atlanta Hawks,0,1,1610612742,Dallas Mavericks,1,0,19,33,52,11,11,22,30,44,74,26,6,32,7,40,19,7,10,94,97
2016,2,21600557,1/7/2017,1610612742,Dallas Mavericks,1,0,1610612737,Atlanta Hawks,0,1,23,23,46,9,27,36,32,50,82,9,1,10,8,42,18,8,14,94,82
2019,2,21900612,1/15/2020,1610612742,Dallas Mavericks,0,1,1610612758,Sacramento Kings,1,0,34,18,52,13,27,40,47,45,92,20,4,24,14,33,24,5,11,100,127
2019,2,21900612,1/15/2020,1610612758,Sacramento Kings,1,0,1610612742,Dallas Mavericks,0,1,38,25,63,12,21,33,50,46,96,11,9,20,13,37,28,4,8,100,123
2019,2,21900611,1/15/2020,1610612745,Houston Rockets,1,0,1610612757,Portland Trail Blazers,0,1,22,25,47,16,33,49,38,58,96,15,8,23,15,47,24,6,11,101,107
2019,2,21900611,1/15/2020,1610612757,Portland Trail Blazers,0,1,1610612745,Houston Rockets,1,0,30,29,59,11,25,36,41,54,95,24,5,29,17,40,22,4,9,101,117
2019,2,21900610,1/15/2020,1610612743,Denver Nuggets,1,1,1610612766,Charlotte Hornets,0,0,29,22,51,9,19,28,38,41,79,15,10,25,11,37,28,4,13,91,100
2019,2,21900610,1/15/2020,1610612766,Charlotte Hornets,0,0,1610612743,Denver Nuggets,1,1,21,25,46,12,23,35,33,48,81,8,6,14,14,38,28,8,15,91,86
2019,2,21900609,1/15/2020,1610612760,Oklahoma City Thunder,1,0,1610612761,Toronto Raptors,0,1,27,16,43,16,26,42,43,42,85,19,1,20,10,32,32,13,20,105,121
2019,2,21900609,1/15/2020,1610612761,Toronto Raptors,0,1,1610612760,Oklahoma City Thunder,1,0,37,21,58,15,12,27,52,33,85,11,4,15,7,28,33,14,19,103,130
2019,2,21900608,1/15/2020,1610612750,Minnesota Timberwolves,1,0,1610612754,Indiana Pacers,0,1,27,33,60,11,17,28,38,50,88,12,4,16,13,40,26,7,15,97,99
2019,2,21900608,1/15/2020,1610612754,Indiana Pacers,0,1,1610612750,Minnesota Timberwolves,1,0,37,25,62,7,16,23,44,41,85,9,3,12,8,35,27,6,15,99,104
2019,2,21900607,1/15/2020,1610612741,Chicago Bulls,1,1,1610612764,Washington Wizards,0,0,29,18,47,14,24,38,43,42,85,15,7,22,10,33,26,8,15,101,115
2019,2,21900607,1/15/2020,1610612764,Washington Wizards,0,0,1610612741,Chicago Bulls,1,1,26,26,52,11,16,27,37,42,79,21,5,26,9,35,25,11,17,101,106
2019,2,21900606,1/15/2020,1610612748,Miami Heat,1,1,1610612759,San Antonio Spurs,0,0,24,24,48,17,23,40,41,47,88,7,6,13,12,37,26,8,10,97,106
2019,2,21900606,1/15/2020,1610612759,San Antonio Spurs,0,0,1610612748,Miami Heat,1,1,29,27,56,10,23,33,39,50,89,12,3,15,8,44,22,4,8,95,100
2019,2,21900605,1/15/2020,1610612751,Brooklyn Nets,0,0,1610612755,Philadelphia 76ers,1,1,26,36,62,12,13,25,38,49,87,18,12,30,17,38,20,7,15,99,106
2019,2,21900605,1/15/2020,1610612755,Philadelphia 76ers,1,1,1610612751,Brooklyn Nets,0,0,34,24,58,11,19,30,45,43,88,16,9,25,14,33,25,9,12,99,117
2019,2,21900604,1/15/2020,1610612738,Boston Celtics,1,0,1610612765,Detroit Pistons,0,1,32,23,55,9,19,28,41,42,83,12,8,20,13,34,21,8,15,96,103
2019,2,21900604,1/15/2020,1610612765,Detroit Pistons,0,1,1610612738,Boston Celtics,1,0,35,11,46,12,20,32,47,31,78,10,9,19,4,34,30,7,13,95,116
2019,2,21900603,1/14/2020,1610612739,Cleveland Cavaliers,0,0,1610612746,LA Clippers,1,1,24,30,54,14,23,37,38,53,91,13,2,15,14,39,25,7,13,99,103
2019,2,21900603,1/14/2020,1610612746,LA Clippers,1,1,1610612739,Cleveland Cavaliers,0,0,34,22,56,15,23,38,49,45,94,15,6,21,17,32,29,5,11,99,128
2019,2,21900602,1/14/2020,1610612742,Dallas Mavericks,0,1,1610612744,Golden State Warriors,1,0,36,23,59,13,24,37,49,47,96,13,8,21,18,32,23,4,8,96,124
2019,2,21900602,1/14/2020,1610612744,Golden State Warriors,1,0,1610612742,Dallas Mavericks,0,1,30,25,55,9,23,32,39,48,87,10,3,13,10,39,27,5,14,97,97
2019,2,21900601,1/14/2020,1610612749,Milwaukee Bucks,1,1,1610612752,New York Knicks,0,0,30,26,56,15,21,36,45,47,92,23,5,28,9,40,27,7,14,110,128
2019,2,21900601,1/14/2020,1610612752,New York Knicks,0,0,1610612749,Milwaukee Bucks,1,1,25,40,65,11,26,37,36,66,102,19,7,26,17,52,26,4,11,110,102
2019,2,21900600,1/14/2020,1610612745,Houston Rockets,0,0,1610612763,Memphis Grizzlies,1,1,23,18,41,14,31,45,37,49,86,22,2,24,16,35,18,6,16,98,110
2019,2,21900600,1/14/2020,1610612763,Memphis Grizzlies,1,1,1610612745,Houston Rockets,0,0,33,20,53,13,24,37,46,44,90,16,3,19,11,34,29,4,9,98,121
2019,2,21900599,1/14/2020,1610612751,Brooklyn Nets,1,0,1610612762,Utah Jazz,0,1,37,27,64,8,18,26,45,45,90,9,6,15,14,35,22,8,12,98,107
2019,2,21900599,1/14/2020,1610612762,Utah Jazz,0,1,1610612751,Brooklyn Nets,1,0,33,23,56,13,23,36,46,46,92,13,2,15,11,35,19,4,9,98,118
2019,2,21900598,1/14/2020,1610612737,Atlanta Hawks,1,1,1610612756,Phoenix Suns,0,0,32,30,62,14,17,31,46,47,93,17,3,20,16,32,25,9,17,104,123
2019,2,21900598,1/14/2020,1610612756,Phoenix Suns,0,0,1610612737,Atlanta Hawks,1,1,36,31,67,4,16,20,40,47,87,26,6,32,12,37,20,3,12,104,110
2019,2,21900597,1/13/2020,1610612739,Cleveland Cavaliers,0,0,1610612747,Los Angeles Lakers,1,1,31,29,60,7,18,25,38,47,85,16,8,24,17,35,21,8,20,99,99
2019,2,21900597,1/13/2020,1610612747,Los Angeles Lakers,1,1,1610612739,Cleveland Cavaliers,0,0,37,21,58,11,19,30,48,40,88,21,7,28,11,32,33,4,9,99,128
2019,2,21900596,1/13/2020,1610612753,Orlando Magic,0,1,1610612758,Sacramento Kings,1,0,31,32,63,9,20,29,40,52,92,25,5,30,14,41,17,6,8,98,114
2019,2,21900596,1/13/2020,1610612758,Sacramento Kings,1,0,1610612753,Orlando Magic,0,1,33,23,56,12,19,31,45,42,87,10,1,11,7,36,25,6,12,97,112
2019,2,21900595,1/13/2020,1610612757,Portland Trail Blazers,1,1,1610612766,Charlotte Hornets,0,0,26,20,46,16,21,37,42,41,83,15,4,19,11,33,26,7,13,94,115
2019,2,21900595,1/13/2020,1610612766,Charlotte Hornets,0,0,1610612757,Portland Trail Blazers,1,1,22,30,52,18,20,38,40,50,90,14,4,18,13,39,24,4,8,94,112
2019,2,21900594,1/13/2020,1610612750,Minnesota Timberwolves,1,0,1610612760,Oklahoma City Thunder,0,1,26,30,56,12,23,35,38,53,91,16,5,21,11,44,23,4,10,100,104
2019,2,21900594,1/13/2020,1610612760,Oklahoma City Thunder,0,1,1610612750,Minnesota Timberwolves,1,0,29,23,52,12,18,30,41,41,82,23,3,26,12,30,25,10,15,101,117
2019,2,21900593,1/13/2020,1610612738,Boston Celtics,1,1,1610612741,Chicago Bulls,0,0,30,30,60,9,14,23,39,44,83,26,3,29,12,33,28,5,12,97,113
2019,2,21900593,1/13/2020,1610612741,Chicago Bulls,0,0,1610612738,Boston Celtics,1,1,31,25,56,6,19,25,37,44,81,21,5,26,9,36,16,7,14,98,101
2019,2,21900592,1/13/2020,1610612754,Indiana Pacers,1,1,1610612755,Philadelphia 76ers,0,0,23,37,60,10,16,26,33,53,86,25,6,31,15,40,24,6,9,97,101
2019,2,21900592,1/13/2020,1610612755,Philadelphia 76ers,0,0,1610612754,Indiana Pacers,1,1,31,25,56,6,27,33,37,52,89,15,4,19,16,37,17,6,13,97,95
2019,2,21900591,1/13/2020,1610612740,New Orleans Pelicans,0,1,1610612765,Detroit Pistons,1,0,34,43,77,9,17,26,43,60,103,22,5,27,23,40,23,11,19,110,117
2019,2,21900591,1/13/2020,1610612765,Detroit Pistons,1,0,1610612740,New Orleans Pelicans,0,1,29,38,67,11,21,32,40,59,99,19,5,24,12,48,27,6,9,110,110
2019,2,21900590,1/12/2020,1610612756,Phoenix Suns,1,1,1610612766,Charlotte Hornets,0,0,34,27,61,7,14,21,41,41,82,11,7,18,15,30,22,10,18,97,100
2019,2,21900590,1/12/2020,1610612766,Charlotte Hornets,0,0,1610612756,Phoenix Suns,1,1,28,23,51,8,27,35,36,50,86,12,6,18,13,40,25,8,16,95,92
2019,2,21900589,1/12/2020,1610612743,Denver Nuggets,1,1,1610612746,LA Clippers,0,0,26,26,52,11,14,25,37,40,77,29,8,37,11,33,24,8,14,99,114
2019,2,21900589,1/12/2020,1610612746,LA Clippers,0,0,1610612743,Denver Nuggets,1,1,30,21,51,8,25,33,38,46,84,20,6,26,13,38,21,7,14,99,104
2019,2,21900588,1/12/2020,1610612744,Golden State Warriors,0,0,1610612763,Memphis Grizzlies,1,1,18,40,58,17,17,34,35,57,92,15,6,21,16,43,23,17,22,108,102
2019,2,21900588,1/12/2020,1610612763,Memphis Grizzlies,1,1,1610612744,Golden State Warriors,0,0,34,31,65,11,24,35,45,55,100,21,4,25,21,37,33,11,17,108,122
2019,2,21900587,1/12/2020,1610612759,San Antonio Spurs,0,1,1610612761,Toronto Raptors,1,0,31,24,55,7,25,32,38,49,87,22,8,30,11,41,24,7,11,102,105
2019,2,21900587,1/12/2020,1610612761,Toronto Raptors,1,0,1610612759,San Antonio Spurs,0,1,22,26,48,17,31,48,39,57,96,9,2,11,13,44,30,6,12,102,104
2019,2,21900586,1/12/2020,1610612737,Atlanta Hawks,0,0,1610612751,Brooklyn Nets,1,1,20,29,49,12,36,48,32,65,97,10,1,11,8,58,23,8,12,106,86
2019,2,21900586,1/12/2020,1610612751,Brooklyn Nets,1,1,1610612737,Atlanta Hawks,0,0,31,20,51,10,16,26,41,36,77,16,13,29,10,33,25,16,26,107,108
2019,2,21900585,1/12/2020,1610612762,Utah Jazz,0,1,1610612764,Washington Wizards,1,0,38,22,60,10,20,30,48,42,90,21,4,25,14,31,24,5,11,100,127
2019,2,21900585,1/12/2020,1610612764,Washington Wizards,1,0,1610612762,Utah Jazz,0,1,40,31,71,7,15,22,47,46,93,15,2,17,12,34,28,6,10,100,116
2019,2,21900584,1/12/2020,1610612748,Miami Heat,0,0,1610612752,New York Knicks,1,1,28,15,43,14,21,35,42,36,78,23,5,28,10,30,24,11,15,94,121
2019,2,21900584,1/12/2020,1610612752,New York Knicks,1,1,1610612748,Miami Heat,0,0,37,22,59,9,22,31,46,44,90,23,5,28,13,34,24,1,6,94,124
2019,2,21900583,1/11/2020,1610612749,Milwaukee Bucks,0,1,1610612757,Portland Trail Blazers,1,0,33,32,65,14,24,38,47,56,103,14,6,20,14,46,21,6,10,108,122
2019,2,21900583,1/11/2020,1610612757,Portland Trail Blazers,1,0,1610612749,Milwaukee Bucks,0,1,27,32,59,10,26,36,37,58,95,17,4,21,9,52,17,6,13,107,101
2019,2,21900582,1/11/2020,1610612739,Cleveland Cavaliers,0,1,1610612743,Denver Nuggets,1,0,32,20,52,12,25,37,44,45,89,11,2,13,14,32,22,9,15,97,111
2019,2,21900582,1/11/2020,1610612743,Denver Nuggets,1,0,1610612739,Cleveland Cavaliers,0,1,33,23,56,8,31,39,41,54,95,13,5,18,13,43,23,5,5,95,103
2019,2,21900581,1/11/2020,1610612742,Dallas Mavericks,1,1,1610612755,Philadelphia 76ers,0,0,29,23,52,11,16,27,40,39,79,18,9,27,15,30,22,11,16,93,109
2019,2,21900581,1/11/2020,1610612755,Philadelphia 76ers,0,0,1610612742,Dallas Mavericks,1,1,28,33,61,9,28,37,37,61,98,8,4,12,15,48,22,4,4,95,91
2019,2,21900580,1/11/2020,1610612747,Los Angeles Lakers,0,1,1610612760,Oklahoma City Thunder,1,0,36,31,67,15,17,32,51,48,99,8,2,10,15,35,21,6,12,101,125
2019,2,21900580,1/11/2020,1610612760,Oklahoma City Thunder,1,0,1610612747,Los Angeles Lakers,0,1,34,27,61,9,22,31,43,49,92,15,2,17,7,44,23,3,7,99,110
2019,2,21900578,1/11/2020,1610612738,Boston Celtics,1,1,1610612740,New Orleans Pelicans,0,0,41,30,71,14,15,29,55,45,100,16,2,18,15,31,29,4,11,105,140
2016,2,21600116,11/9/2016,1610612742,Dallas Mavericks,0,0,1610612744,Golden State Warriors,1,1,28,30,58,6,22,28,34,52,86,21,7,28,17,39,20,3,7,89,95
2016,2,21600116,11/9/2016,1610612744,Golden State Warriors,1,1,1610612742,Dallas Mavericks,0,0,26,15,41,17,16,33,43,31,74,13,9,22,9,29,33,10,15,89,116
2019,2,21900578,1/11/2020,1610612740,New Orleans Pelicans,0,0,1610612738,Boston Celtics,1,1,26,29,55,14,31,45,40,60,100,11,7,18,19,44,29,14,16,106,105
2019,2,21900577,1/11/2020,1610612745,Houston Rockets,1,1,1610612750,Minnesota Timberwolves,0,0,31,19,50,18,27,45,49,46,95,23,6,29,15,34,29,12,22,114,139
2019,2,21900577,1/11/2020,1610612750,Minnesota Timberwolves,0,0,1610612745,Houston Rockets,1,1,23,24,47,13,35,48,36,59,95,24,12,36,18,47,28,9,18,114,109
2019,2,21900576,1/10/2020,1610612744,Golden State Warriors,0,0,1610612746,LA Clippers,1,1,29,28,57,8,31,39,37,59,96,18,7,25,16,47,28,5,10,102,100
2019,2,21900576,1/10/2020,1610612746,LA Clippers,1,1,1610612744,Golden State Warriors,0,0,30,15,45,11,28,39,41,43,84,16,6,22,11,36,27,9,19,101,109
2019,2,21900575,1/10/2020,1610612749,Milwaukee Bucks,0,1,1610612758,Sacramento Kings,1,0,37,19,56,10,29,39,47,48,95,23,7,30,9,41,29,8,11,111,127
2019,2,21900575,1/10/2020,1610612758,Sacramento Kings,1,0,1610612749,Milwaukee Bucks,0,1,34,27,61,10,25,35,44,52,96,8,2,10,7,45,26,11,16,110,106
2019,2,21900574,1/10/2020,1610612762,Utah Jazz,1,1,1610612766,Charlotte Hornets,0,0,22,15,37,18,24,42,40,39,79,11,3,14,10,31,28,6,16,92,109
2019,2,21900574,1/10/2020,1610612766,Charlotte Hornets,0,0,1610612762,Utah Jazz,1,1,27,22,49,8,18,26,35,40,75,14,5,19,12,32,20,9,21,93,92
2019,2,21900573,1/10/2020,1610612753,Orlando Magic,0,0,1610612756,Phoenix Suns,1,1,24,32,56,9,24,33,33,56,89,19,5,24,21,39,15,10,16,95,94
2019,2,21900573,1/10/2020,1610612756,Phoenix Suns,1,1,1610612753,Orlando Magic,0,0,24,27,51,9,19,28,33,46,79,23,3,26,12,36,19,9,15,96,98
2016,2,21601112,3/29/2017,1610612753,Orlando Magic,1,0,1610612760,Oklahoma City Thunder,0,1,30,37,67,9,21,30,39,58,97,19,8,27,14,47,24,11,14,112,106
2016,2,21601112,3/29/2017,1610612760,Oklahoma City Thunder,0,1,1610612753,Orlando Magic,1,0,33,36,69,10,23,33,43,59,102,18,10,28,15,48,18,9,12,112,114
2019,2,21900572,1/10/2020,1610612742,Dallas Mavericks,1,0,1610612747,Los Angeles Lakers,0,1,28,30,58,11,27,38,39,57,96,25,12,37,22,40,19,6,9,102,114
2019,2,21900572,1/10/2020,1610612747,Los Angeles Lakers,0,1,1610612742,Dallas Mavericks,1,0,37,28,65,10,14,24,47,42,89,25,7,32,12,32,18,4,7,100,129
2016,2,21600556,1/7/2017,1610612750,Minnesota Timberwolves,1,0,1610612762,Utah Jazz,0,1,28,32,60,7,13,20,35,45,80,15,6,21,19,29,23,12,16,87,92
2016,2,21600556,1/7/2017,1610612762,Utah Jazz,0,1,1610612750,Minnesota Timberwolves,1,0,24,30,54,8,15,23,32,45,77,22,6,28,13,36,23,3,10,87,94
2019,2,21900571,1/10/2020,1610612759,San Antonio Spurs,0,0,1610612763,Memphis Grizzlies,1,1,25,22,47,17,23,40,42,45,87,20,3,23,8,39,29,5,11,100,121
2019,2,21900571,1/10/2020,1610612763,Memphis Grizzlies,1,1,1610612759,San Antonio Spurs,0,0,36,26,62,16,22,38,52,48,100,14,2,16,14,34,39,3,8,100,134
2019,2,21900570,1/10/2020,1610612741,Chicago Bulls,1,0,1610612754,Indiana Pacers,0,1,19,20,39,18,23,41,37,43,80,13,3,16,7,38,16,9,16,96,105
2019,2,21900570,1/10/2020,1610612754,Indiana Pacers,0,1,1610612741,Chicago Bulls,1,0,37,17,54,11,19,30,48,36,84,9,5,14,8,32,31,6,14,96,116
2016,2,21600115,11/9/2016,1610612746,LA Clippers,1,1,1610612757,Portland Trail Blazers,0,0,27,28,55,11,21,32,38,49,87,24,9,33,16,38,24,4,7,93,111
2016,2,21600115,11/9/2016,1610612757,Portland Trail Blazers,0,0,1610612746,LA Clippers,1,1,25,33,58,6,24,30,31,57,88,12,2,14,14,44,16,9,14,94,80
2019,2,21900569,1/10/2020,1610612740,New Orleans Pelicans,0,1,1610612752,New York Knicks,1,0,30,18,48,18,20,38,48,38,86,9,8,17,9,33,35,13,20,106,123
2019,2,21900569,1/10/2020,1610612752,New York Knicks,1,0,1610612740,New Orleans Pelicans,0,1,41,32,73,5,22,27,46,54,100,14,6,20,18,39,26,8,13,105,111
2019,2,21900568,1/10/2020,1610612748,Miami Heat,0,0,1610612751,Brooklyn Nets,1,1,37,19,56,7,22,29,44,41,85,18,3,21,6,38,26,5,8,98,113
2019,2,21900568,1/10/2020,1610612751,Brooklyn Nets,1,1,1610612748,Miami Heat,0,0,30,19,49,15,29,44,45,48,93,12,7,19,15,37,31,6,10,98,117
2019,2,21900567,1/10/2020,1610612737,Atlanta Hawks,0,0,1610612764,Washington Wizards,1,1,34,26,60,7,22,29,41,48,89,12,12,24,12,41,19,11,18,106,101
2019,2,21900567,1/10/2020,1610612764,Washington Wizards,1,1,1610612737,Atlanta Hawks,0,0,32,51,83,10,19,29,42,70,112,17,11,28,27,50,26,5,9,107,111
2019,2,21900566,1/9/2020,1610612745,Houston Rockets,0,0,1610612760,Oklahoma City Thunder,1,1,23,26,49,11,29,40,34,55,89,13,1,14,10,45,16,8,14,100,92
2019,2,21900566,1/9/2020,1610612760,Oklahoma City Thunder,1,1,1610612745,Houston Rockets,0,0,32,23,55,11,21,32,43,44,87,16,4,20,11,35,22,4,13,101,113
2019,2,21900565,1/9/2020,1610612750,Minnesota Timberwolves,1,1,1610612757,Portland Trail Blazers,0,0,31,26,57,13,19,32,44,45,89,15,6,21,17,30,25,9,15,98,116
2019,2,21900565,1/9/2020,1610612757,Portland Trail Blazers,0,0,1610612750,Minnesota Timberwolves,1,1,24,35,59,11,26,37,35,61,96,21,10,31,24,43,14,7,12,98,102
2019,2,21900564,1/9/2020,1610612738,Boston Celtics,0,0,1610612755,Philadelphia 76ers,1,1,24,28,52,14,22,36,38,50,88,8,0,8,12,38,17,6,15,95,98
2019,2,21900564,1/9/2020,1610612755,Philadelphia 76ers,1,1,1610612738,Boston Celtics,0,0,32,29,61,11,16,27,43,45,88,12,5,17,16,31,24,8,13,96,109
2019,2,21900563,1/9/2020,1610612739,Cleveland Cavaliers,0,1,1610612765,Detroit Pistons,1,0,43,28,71,5,15,20,48,43,91,14,6,20,16,29,24,8,15,100,115
2019,2,21900563,1/9/2020,1610612765,Detroit Pistons,1,0,1610612739,Cleveland Cavaliers,0,1,42,36,78,6,14,20,48,50,98,10,6,16,21,31,20,9,16,101,112
2019,2,21900562,1/8/2020,1610612744,Golden State Warriors,1,0,1610612749,Milwaukee Bucks,0,1,18,31,49,15,23,38,33,54,87,17,3,20,12,44,29,11,19,103,98
2019,2,21900562,1/8/2020,1610612749,Milwaukee Bucks,0,1,1610612744,Golden State Warriors,1,0,26,20,46,9,32,41,35,52,87,28,4,32,8,45,22,7,10,105,107
2019,2,21900561,1/8/2020,1610612752,New York Knicks,0,0,1610612762,Utah Jazz,1,1,33,39,72,9,16,25,42,55,97,11,0,11,17,38,18,6,9,96,104
2019,2,21900561,1/8/2020,1610612762,Utah Jazz,1,1,1610612752,New York Knicks,0,0,33,14,47,16,27,43,49,41,90,14,9,23,13,30,29,3,7,96,128
2019,2,21900560,1/8/2020,1610612740,New Orleans Pelicans,1,1,1610612741,Chicago Bulls,0,0,26,17,43,15,29,44,41,46,87,26,6,32,17,30,31,12,15,102,123
2019,2,21900560,1/8/2020,1610612741,Chicago Bulls,0,0,1610612740,New Orleans Pelicans,1,1,27,30,57,14,21,35,41,51,92,12,9,21,14,41,22,7,12,101,108
2019,2,21900559,1/8/2020,1610612742,Dallas Mavericks,1,0,1610612743,Denver Nuggets,0,1,27,15,42,12,23,35,39,38,77,16,8,24,8,34,27,7,13,95,106
2019,2,21900559,1/8/2020,1610612743,Denver Nuggets,0,1,1610612742,Dallas Mavericks,1,0,32,29,61,9,15,24,41,44,85,16,4,20,13,32,27,8,13,95,107
2019,2,21900558,1/8/2020,1610612737,Atlanta Hawks,1,0,1610612745,Houston Rockets,0,1,26,36,62,13,31,44,39,67,106,24,3,27,22,45,20,7,11,109,115
2019,2,21900558,1/8/2020,1610612745,Houston Rockets,0,1,1610612737,Atlanta Hawks,1,0,26,21,47,13,32,45,39,53,92,31,10,41,18,40,22,6,13,109,122
2019,2,21900557,1/8/2020,1610612753,Orlando Magic,1,1,1610612764,Washington Wizards,0,0,33,27,60,10,17,27,43,44,87,27,7,34,16,30,24,8,17,101,123
2019,2,21900557,1/8/2020,1610612764,Washington Wizards,0,0,1610612753,Orlando Magic,1,1,30,31,61,6,17,23,36,48,84,11,8,19,13,39,24,18,23,103,89
2019,2,21900556,1/8/2020,1610612748,Miami Heat,0,1,1610612754,Indiana Pacers,1,0,27,16,43,16,22,38,43,38,81,20,5,25,7,34,28,5,11,97,122
2019,2,21900556,1/8/2020,1610612754,Indiana Pacers,1,0,1610612748,Miami Heat,0,1,31,26,57,9,18,27,40,44,84,19,6,25,9,39,25,8,12,97,108
2019,2,21900555,1/8/2020,1610612761,Toronto Raptors,0,1,1610612766,Charlotte Hornets,1,0,28,30,58,14,22,36,42,52,94,14,6,20,17,39,34,6,13,98,112
2019,2,21900555,1/8/2020,1610612766,Charlotte Hornets,1,0,1610612761,Toronto Raptors,0,1,23,26,49,15,22,37,38,48,86,19,7,26,21,32,30,7,20,99,110
2019,2,21900554,1/8/2020,1610612738,Boston Celtics,1,0,1610612759,San Antonio Spurs,0,1,24,27,51,13,25,38,37,52,89,27,3,30,14,41,26,9,15,104,114
2019,2,21900554,1/8/2020,1610612759,San Antonio Spurs,0,1,1610612738,Boston Celtics,1,0,39,19,58,9,20,29,48,39,87,24,2,26,8,32,28,7,15,103,129
2016,2,21600555,1/7/2017,1610612743,Denver Nuggets,0,0,1610612760,Oklahoma City Thunder,1,1,31,44,75,9,15,24,40,59,99,17,7,24,17,45,18,8,12,104,106
2016,2,21600555,1/7/2017,1610612760,Oklahoma City Thunder,1,1,1610612743,Denver Nuggets,0,0,31,22,53,12,24,36,43,46,89,23,6,29,8,42,23,7,12,105,121
2015,2,21501124,3/31/2016,1610612741,Chicago Bulls,0,1,1610612745,Houston Rockets,1,0,26,27,53,11,13,24,37,40,77,18,4,22,10,34,28,5,17,94,103
2015,2,21501124,3/31/2016,1610612745,Houston Rockets,1,0,1610612741,Chicago Bulls,0,1,27,38,65,9,16,25,36,54,90,19,3,22,16,39,19,5,10,95,100
2019,2,21900553,1/7/2020,1610612747,Los Angeles Lakers,1,1,1610612752,New York Knicks,0,0,24,22,46,17,19,36,41,41,82,18,3,21,8,34,27,10,19,102,117
2019,2,21900553,1/7/2020,1610612752,New York Knicks,0,0,1610612747,Los Angeles Lakers,1,1,33,42,75,4,16,20,37,58,95,9,7,16,18,43,15,11,16,103,87
2019,2,21900552,1/7/2020,1610612756,Phoenix Suns,1,0,1610612758,Sacramento Kings,0,1,26,16,42,11,24,35,37,40,77,18,4,22,7,35,24,8,19,100,103
2019,2,21900552,1/7/2020,1610612758,Sacramento Kings,0,1,1610612756,Phoenix Suns,1,0,22,26,48,15,21,36,37,47,84,25,3,28,15,35,18,4,16,101,114
2019,2,21900551,1/7/2020,1610612750,Minnesota Timberwolves,0,0,1610612763,Memphis Grizzlies,1,1,25,18,43,15,32,47,40,50,90,17,4,21,14,37,23,12,20,104,112
2019,2,21900551,1/7/2020,1610612763,Memphis Grizzlies,1,1,1610612750,Minnesota Timberwolves,0,0,38,23,61,8,20,28,46,43,89,19,2,21,11,34,22,10,15,105,119
2019,2,21900550,1/7/2020,1610612751,Brooklyn Nets,1,0,1610612760,Oklahoma City Thunder,0,1,29,32,61,11,26,37,40,58,98,12,4,16,14,47,19,11,17,110,103
2019,2,21900550,1/7/2020,1610612760,Oklahoma City Thunder,0,1,1610612751,Brooklyn Nets,1,0,27,28,55,11,26,37,38,54,92,24,5,29,12,44,19,5,17,112,111
2019,2,21900549,1/7/2020,1610612757,Portland Trail Blazers,0,1,1610612761,Toronto Raptors,1,0,25,28,53,13,22,35,38,50,88,12,2,14,11,41,23,5,11,96,101
2019,2,21900549,1/7/2020,1610612761,Toronto Raptors,1,0,1610612757,Portland Trail Blazers,0,1,20,34,54,15,27,42,35,61,96,14,5,19,23,41,21,6,13,96,99
2019,2,21900548,1/7/2020,1610612739,Cleveland Cavaliers,1,0,1610612765,Detroit Pistons,0,1,28,26,54,14,17,31,42,43,85,15,1,16,13,31,29,8,17,96,113
2019,2,21900548,1/7/2020,1610612765,Detroit Pistons,0,1,1610612739,Cleveland Cavaliers,1,0,29,29,58,13,20,33,42,49,91,18,3,21,11,40,26,7,9,96,115
2019,2,21900547,1/6/2020,1610612744,Golden State Warriors,0,0,1610612758,Sacramento Kings,1,1,29,31,60,5,21,26,34,52,86,25,7,32,15,39,19,10,19,106,98
2019,2,21900547,1/6/2020,1610612758,Sacramento Kings,1,1,1610612744,Golden State Warriors,0,0,24,27,51,15,15,30,39,42,81,18,5,23,6,37,27,13,23,106,111
2019,2,21900546,1/6/2020,1610612749,Milwaukee Bucks,0,0,1610612759,San Antonio Spurs,1,1,23,27,50,15,30,45,38,57,95,13,1,14,12,45,24,4,8,97,104
2019,2,21900546,1/6/2020,1610612759,San Antonio Spurs,1,1,1610612749,Milwaukee Bucks,0,0,26,27,53,19,16,35,45,43,88,17,2,19,12,31,23,5,13,96,126
2019,2,21900545,1/6/2020,1610612741,Chicago Bulls,0,0,1610612742,Dallas Mavericks,1,1,37,30,67,9,22,31,46,52,98,9,2,11,19,34,25,5,9,94,110
2019,2,21900545,1/6/2020,1610612742,Dallas Mavericks,1,1,1610612741,Chicago Bulls,0,0,28,15,43,16,25,41,44,40,84,14,5,19,13,29,25,10,15,95,118
2019,2,21900544,1/6/2020,1610612740,New Orleans Pelicans,1,0,1610612762,Utah Jazz,0,1,33,30,63,12,19,31,45,49,94,24,6,30,15,36,23,3,6,98,126
2019,2,21900544,1/6/2020,1610612762,Utah Jazz,0,1,1610612740,New Orleans Pelicans,1,0,30,27,57,16,17,33,46,44,90,20,4,24,10,36,19,4,8,98,128
2019,2,21900543,1/6/2020,1610612737,Atlanta Hawks,1,0,1610612743,Denver Nuggets,0,1,17,21,38,18,21,39,35,42,77,27,5,32,7,36,24,4,10,93,115
2019,2,21900543,1/6/2020,1610612743,Denver Nuggets,0,1,1610612737,Atlanta Hawks,1,0,38,27,65,9,18,27,47,45,92,20,7,27,13,35,27,3,4,95,123
2019,2,21900542,1/6/2020,1610612738,Boston Celtics,0,0,1610612764,Washington Wizards,1,1,25,33,58,8,29,37,33,62,95,20,6,26,24,42,17,8,17,101,94
2019,2,21900542,1/6/2020,1610612764,Washington Wizards,1,1,1610612738,Boston Celtics,0,0,32,31,63,7,14,21,39,45,84,14,9,23,10,39,18,7,14,101,99
2019,2,21900541,1/6/2020,1610612755,Philadelphia 76ers,1,1,1610612760,Oklahoma City Thunder,0,0,33,31,64,13,13,26,46,44,90,15,3,18,12,35,31,3,10,98,120
2019,2,21900541,1/6/2020,1610612760,Oklahoma City Thunder,0,0,1610612755,Philadelphia 76ers,1,1,28,32,60,12,17,29,40,49,89,21,10,31,20,34,17,4,13,98,113
2019,2,21900540,1/6/2020,1610612751,Brooklyn Nets,0,0,1610612753,Orlando Magic,1,1,22,27,49,10,37,47,32,64,96,15,4,19,17,51,20,8,13,103,89
2019,2,21900540,1/6/2020,1610612753,Orlando Magic,1,1,1610612751,Brooklyn Nets,0,0,27,28,55,8,18,26,35,46,81,23,8,31,13,38,21,11,20,102,101
2019,2,21900539,1/6/2020,1610612754,Indiana Pacers,0,1,1610612766,Charlotte Hornets,1,0,37,26,63,10,16,26,47,42,89,11,3,14,15,30,31,3,11,90,115
2014,2,21400767,2/8/2015,1610612737,Atlanta Hawks,0,0,1610612763,Memphis Grizzlies,1,1,21,29,50,12,18,30,33,47,80,10,1,11,6,42,17,8,14,95,88
2014,2,21400767,2/8/2015,1610612763,Memphis Grizzlies,1,1,1610612737,Atlanta Hawks,0,0,33,46,79,3,10,13,36,56,92,19,2,21,19,37,18,6,11,94,94
2019,2,21900539,1/6/2020,1610612766,Charlotte Hornets,1,0,1610612754,Indiana Pacers,0,1,27,24,51,10,20,30,37,44,81,20,2,22,13,32,21,8,12,91,104
2019,2,21900538,1/5/2020,1610612747,Los Angeles Lakers,1,1,1610612765,Detroit Pistons,0,0,36,36,72,6,14,20,42,50,92,16,7,23,13,40,23,8,13,102,106
2019,2,21900538,1/5/2020,1610612765,Detroit Pistons,0,0,1610612747,Los Angeles Lakers,1,1,18,34,52,11,15,26,29,49,78,30,5,35,10,41,21,8,16,103,99
2019,2,21900537,1/5/2020,1610612756,Phoenix Suns,1,0,1610612763,Memphis Grizzlies,0,1,37,32,69,6,20,26,43,52,95,22,4,26,14,41,25,4,10,103,114
2019,2,21900537,1/5/2020,1610612763,Memphis Grizzlies,0,1,1610612756,Phoenix Suns,1,0,27,14,41,18,24,42,45,38,83,13,4,17,6,36,31,7,17,104,121
2016,2,21601111,3/29/2017,1610612737,Atlanta Hawks,0,1,1610612755,Philadelphia 76ers,1,0,25,37,62,9,9,18,34,46,80,22,4,26,18,30,19,7,17,93,99
2016,2,21601111,3/29/2017,1610612755,Philadelphia 76ers,1,0,1610612737,Atlanta Hawks,0,1,25,23,48,11,28,39,36,51,87,9,2,11,16,35,30,7,15,93,92
2019,2,21900536,1/5/2020,1610612739,Cleveland Cavaliers,1,0,1610612750,Minnesota Timberwolves,0,1,32,27,59,8,17,25,40,44,84,15,4,19,14,32,15,16,20,99,103
2019,2,21900536,1/5/2020,1610612750,Minnesota Timberwolves,0,1,1610612739,Cleveland Cavaliers,1,0,33,24,57,14,24,38,47,48,95,10,3,13,18,33,32,6,17,100,118
2019,2,21900535,1/5/2020,1610612748,Miami Heat,1,1,1610612757,Portland Trail Blazers,0,0,29,17,46,18,26,44,47,43,90,10,6,16,13,33,34,5,11,97,122
2019,2,21900535,1/5/2020,1610612757,Portland Trail Blazers,0,0,1610612748,Miami Heat,1,1,27,23,50,13,24,37,40,47,87,18,2,20,10,37,21,4,10,95,111
2014,2,21400766,2/8/2015,1610612739,Cleveland Cavaliers,1,1,1610612747,Los Angeles Lakers,0,0,27,22,49,18,15,33,45,37,82,12,8,20,10,30,31,11,14,96,120
2014,2,21400766,2/8/2015,1610612747,Los Angeles Lakers,0,0,1610612739,Cleveland Cavaliers,1,1,34,43,77,7,16,23,41,59,100,16,3,19,19,42,22,6,7,97,105
2019,2,21900534,1/5/2020,1610612746,LA Clippers,1,1,1610612752,New York Knicks,0,0,27,24,51,18,14,32,45,38,83,27,6,33,11,29,25,11,19,104,135
2019,2,21900534,1/5/2020,1610612752,New York Knicks,0,0,1610612746,LA Clippers,1,1,36,25,61,12,11,23,48,36,84,24,13,37,10,32,22,4,16,104,132
2019,2,21900533,1/4/2020,1610612740,New Orleans Pelicans,0,1,1610612758,Sacramento Kings,1,0,22,20,42,16,29,45,38,49,87,25,8,33,13,39,28,9,15,105,117
2019,2,21900533,1/4/2020,1610612758,Sacramento Kings,1,0,1610612740,New Orleans Pelicans,0,1,26,38,64,12,9,21,38,47,85,27,9,36,16,36,20,11,21,105,115
2019,2,21900532,1/4/2020,1610612744,Golden State Warriors,1,0,1610612765,Detroit Pistons,0,1,22,39,61,11,10,21,33,49,82,27,5,32,13,38,26,13,14,99,104
2019,2,21900532,1/4/2020,1610612765,Detroit Pistons,0,1,1610612744,Golden State Warriors,1,0,32,24,56,11,16,27,43,40,83,14,2,16,10,31,24,13,21,101,111
2019,2,21900531,1/4/2020,1610612749,Milwaukee Bucks,1,1,1610612759,San Antonio Spurs,0,0,26,16,42,17,28,45,43,44,87,24,9,33,8,43,23,7,9,104,127
2019,2,21900531,1/4/2020,1610612759,San Antonio Spurs,0,0,1610612749,Milwaukee Bucks,1,1,27,33,60,11,21,32,38,54,92,31,3,34,12,43,20,4,8,104,118
2019,2,21900530,1/4/2020,1610612742,Dallas Mavericks,1,0,1610612766,Charlotte Hornets,0,1,32,18,50,15,35,50,47,53,100,11,2,13,17,38,28,5,10,101,120
2019,2,21900530,1/4/2020,1610612766,Charlotte Hornets,0,1,1610612742,Dallas Mavericks,1,0,31,29,60,11,14,25,42,43,85,28,3,31,17,28,27,7,18,100,123
2019,2,21900529,1/4/2020,1610612738,Boston Celtics,0,1,1610612741,Chicago Bulls,1,0,35,28,63,8,11,19,43,39,82,17,4,21,14,27,22,15,20,96,111
2019,2,21900529,1/4/2020,1610612741,Chicago Bulls,1,0,1610612738,Boston Celtics,0,1,21,25,46,13,21,34,34,46,80,23,8,31,14,36,23,10,16,96,104
2019,2,21900528,1/4/2020,1610612743,Denver Nuggets,0,0,1610612764,Washington Wizards,1,1,34,24,58,6,23,29,40,47,87,28,6,34,14,36,18,5,12,99,114
2019,2,21900528,1/4/2020,1610612764,Washington Wizards,1,1,1610612743,Denver Nuggets,0,0,44,31,75,6,10,16,50,41,91,22,5,27,17,26,20,6,11,99,128
2019,2,21900527,1/4/2020,1610612739,Cleveland Cavaliers,1,0,1610612760,Oklahoma City Thunder,0,1,25,30,55,14,16,30,39,46,85,14,3,17,10,36,19,6,15,97,106
2019,2,21900527,1/4/2020,1610612760,Oklahoma City Thunder,0,1,1610612739,Cleveland Cavaliers,1,0,29,30,59,14,23,37,43,53,96,21,5,26,22,34,24,4,12,99,121
2019,2,21900526,1/4/2020,1610612737,Atlanta Hawks,1,1,1610612754,Indiana Pacers,0,0,32,18,50,10,22,32,42,40,82,22,2,24,11,29,22,8,14,99,116
2019,2,21900526,1/4/2020,1610612754,Indiana Pacers,0,0,1610612737,Atlanta Hawks,1,1,26,34,60,10,17,27,36,51,87,29,6,35,17,37,24,8,11,99,111
2019,2,21900525,1/4/2020,1610612753,Orlando Magic,1,0,1610612762,Utah Jazz,0,1,27,21,48,11,26,37,38,47,85,9,3,12,10,38,21,3,10,91,96
2019,2,21900525,1/4/2020,1610612762,Utah Jazz,0,1,1610612753,Orlando Magic,1,0,26,27,53,16,24,40,42,51,93,9,5,14,17,39,22,6,8,92,109
2019,2,21900524,1/4/2020,1610612751,Brooklyn Nets,1,0,1610612761,Toronto Raptors,0,1,19,13,32,13,22,35,32,35,67,25,9,34,6,32,24,10,24,99,102
2019,2,21900524,1/4/2020,1610612761,Toronto Raptors,0,1,1610612751,Brooklyn Nets,1,0,31,34,65,13,19,32,44,53,97,20,8,28,19,38,21,4,8,101,121
2019,2,21900523,1/4/2020,1610612746,LA Clippers,1,0,1610612763,Memphis Grizzlies,0,1,38,33,71,7,23,30,45,56,101,17,5,22,17,44,20,8,13,106,114
2019,2,21900523,1/4/2020,1610612763,Memphis Grizzlies,0,1,1610612746,LA Clippers,1,0,31,26,57,18,21,39,49,47,96,24,4,28,13,37,36,3,9,107,140
2019,2,21900522,1/3/2020,1610612740,New Orleans Pelicans,0,0,1610612747,Los Angeles Lakers,1,1,37,28,65,11,26,37,48,54,102,6,1,7,16,39,24,9,12,103,113
2019,2,21900522,1/3/2020,1610612747,Los Angeles Lakers,1,1,1610612740,New Orleans Pelicans,0,0,29,28,57,14,15,29,43,43,86,23,5,28,12,35,29,4,14,103,123
2019,2,21900521,1/3/2020,1610612752,New York Knicks,0,0,1610612756,Phoenix Suns,1,1,31,24,55,10,27,37,41,51,92,20,10,30,16,40,19,7,15,103,112
2019,2,21900521,1/3/2020,1610612756,Phoenix Suns,1,1,1610612752,New York Knicks,0,0,32,30,62,10,18,28,42,48,90,26,7,33,13,40,28,7,10,102,120
2019,2,21900520,1/3/2020,1610612745,Houston Rockets,1,1,1610612755,Philadelphia 76ers,0,0,29,25,54,12,20,32,41,45,86,24,8,32,13,37,22,7,14,100,118
2019,2,21900520,1/3/2020,1610612755,Philadelphia 76ers,0,0,1610612745,Houston Rockets,1,1,36,29,65,6,21,27,42,50,92,18,7,25,14,40,32,6,11,101,108
2019,2,21900519,1/3/2020,1610612757,Portland Trail Blazers,0,1,1610612764,Washington Wizards,1,0,39,24,63,6,19,25,45,43,88,26,7,33,17,29,16,5,7,95,122
2019,2,21900519,1/3/2020,1610612764,Washington Wizards,1,0,1610612757,Portland Trail Blazers,0,1,27,30,57,11,22,33,38,52,90,16,9,25,22,33,19,6,13,95,103
2019,2,21900518,1/3/2020,1610612748,Miami Heat,0,0,1610612753,Orlando Magic,1,1,23,20,43,7,30,37,30,50,80,18,5,23,11,40,16,11,18,96,85
2019,2,21900518,1/3/2020,1610612753,Orlando Magic,1,1,1610612748,Miami Heat,0,0,20,26,46,13,22,35,33,48,81,26,3,29,10,39,25,7,11,96,105
2019,2,21900517,1/3/2020,1610612737,Atlanta Hawks,0,0,1610612738,Boston Celtics,1,1,23,25,48,16,29,45,39,54,93,12,3,15,12,43,26,9,14,102,106
2019,2,21900517,1/3/2020,1610612738,Boston Celtics,1,1,1610612737,Atlanta Hawks,0,0,35,33,68,6,19,25,41,52,93,21,8,29,19,37,23,6,13,102,109
2016,2,21600554,1/7/2017,1610612741,Chicago Bulls,1,1,1610612761,Toronto Raptors,0,0,27,42,69,11,17,28,38,59,97,36,3,39,21,38,25,11,14,107,123
2016,2,21600554,1/7/2017,1610612761,Toronto Raptors,0,0,1610612741,Chicago Bulls,1,1,29,25,54,8,23,31,37,48,85,36,7,43,8,45,20,5,11,107,118
2019,2,21900516,1/2/2020,1610612746,LA Clippers,1,1,1610612765,Detroit Pistons,0,0,39,25,64,11,17,28,50,42,92,15,6,21,13,34,29,10,15,103,126
2019,2,21900516,1/2/2020,1610612765,Detroit Pistons,0,0,1610612746,LA Clippers,1,1,33,28,61,7,26,33,40,54,94,25,10,35,18,41,20,6,11,103,112
2019,2,21900515,1/2/2020,1610612758,Sacramento Kings,1,1,1610612763,Memphis Grizzlies,0,0,30,26,56,14,20,34,44,46,90,26,5,31,12,36,26,4,13,108,128
2019,2,21900515,1/2/2020,1610612763,Memphis Grizzlies,0,0,1610612758,Sacramento Kings,1,1,32,27,59,13,21,34,45,48,93,20,1,21,13,35,31,9,17,108,123
2019,2,21900514,1/2/2020,1610612759,San Antonio Spurs,1,0,1610612760,Oklahoma City Thunder,0,1,27,34,61,13,18,31,40,52,92,10,2,12,16,37,22,7,9,91,103
2019,2,21900514,1/2/2020,1610612760,Oklahoma City Thunder,0,1,1610612759,San Antonio Spurs,1,0,34,30,64,9,16,25,43,46,89,14,6,20,14,35,19,1,4,93,109
2019,2,21900513,1/2/2020,1610612742,Dallas Mavericks,1,1,1610612751,Brooklyn Nets,0,0,27,24,51,18,21,39,45,45,90,15,2,17,14,32,22,5,14,99,123
2019,2,21900513,1/2/2020,1610612751,Brooklyn Nets,0,0,1610612742,Dallas Mavericks,1,1,30,24,54,12,25,37,42,49,91,15,2,17,14,37,29,4,12,97,111
2019,2,21900512,1/2/2020,1610612744,Golden State Warriors,0,0,1610612750,Minnesota Timberwolves,1,1,30,27,57,3,17,20,33,44,77,15,6,21,9,37,20,7,17,95,84
2019,2,21900512,1/2/2020,1610612750,Minnesota Timberwolves,1,1,1610612744,Golden State Warriors,0,0,25,27,52,13,30,43,38,57,95,10,7,17,22,39,22,9,15,97,99
2019,2,21900511,1/2/2020,1610612741,Chicago Bulls,1,0,1610612762,Utah Jazz,0,1,26,32,58,11,25,36,37,57,94,13,4,17,20,38,22,5,11,93,98
2019,2,21900511,1/2/2020,1610612762,Utah Jazz,0,1,1610612741,Chicago Bulls,1,0,26,20,46,11,19,30,37,39,76,17,5,22,10,32,24,8,17,93,102
2019,2,21900510,1/2/2020,1610612748,Miami Heat,1,1,1610612761,Toronto Raptors,0,0,21,23,44,12,25,37,33,48,81,6,5,11,15,37,23,4,16,90,84
2019,2,21900510,1/2/2020,1610612761,Toronto Raptors,0,0,1610612748,Miami Heat,1,1,22,25,47,6,36,42,28,61,89,14,3,17,18,43,20,6,11,90,76
2019,2,21900509,1/2/2020,1610612743,Denver Nuggets,0,1,1610612754,Indiana Pacers,1,0,38,22,60,8,19,27,46,41,87,24,3,27,17,25,27,7,10,93,124
2019,2,21900509,1/2/2020,1610612754,Indiana Pacers,1,0,1610612743,Denver Nuggets,0,1,31,25,56,12,14,26,43,39,82,18,7,25,9,33,32,7,9,92,116
2019,2,21900508,1/2/2020,1610612739,Cleveland Cavaliers,1,0,1610612766,Charlotte Hornets,0,1,28,18,46,13,22,35,41,40,81,11,3,14,10,30,26,5,15,95,106
2019,2,21900508,1/2/2020,1610612766,Charlotte Hornets,0,1,1610612739,Cleveland Cavaliers,1,0,22,23,45,15,23,38,37,46,83,20,4,24,12,35,25,6,11,95,109
2019,2,21900507,1/1/2020,1610612747,Los Angeles Lakers,1,1,1610612756,Phoenix Suns,0,0,36,26,62,7,21,28,43,47,90,24,10,34,16,38,25,7,13,101,117
2019,2,21900507,1/1/2020,1610612756,Phoenix Suns,0,0,1610612747,Los Angeles Lakers,1,1,36,27,63,6,17,23,42,44,86,17,6,23,12,35,32,9,15,100,107
2019,2,21900506,1/1/2020,1610612749,Milwaukee Bucks,1,1,1610612750,Minnesota Timberwolves,0,0,31,27,58,9,27,36,40,54,94,17,9,26,17,44,24,7,17,103,106
2019,2,21900506,1/1/2020,1610612750,Minnesota Timberwolves,0,0,1610612749,Milwaukee Bucks,1,1,19,26,45,15,31,46,34,57,91,21,7,28,14,48,18,4,12,104,104
2019,2,21900505,1/1/2020,1610612752,New York Knicks,1,1,1610612757,Portland Trail Blazers,0,0,33,29,62,14,22,36,47,51,98,9,5,14,14,39,29,4,7,99,117
2019,2,21900505,1/1/2020,1610612757,Portland Trail Blazers,0,0,1610612752,New York Knicks,1,1,27,35,62,10,22,32,37,57,94,9,6,15,12,49,17,3,9,99,93
2019,2,21900504,1/1/2020,1610612753,Orlando Magic,0,1,1610612764,Washington Wizards,1,0,33,30,63,12,20,32,45,50,95,20,7,27,15,38,25,5,9,101,122
2019,2,21900504,1/1/2020,1610612764,Washington Wizards,1,0,1610612753,Orlando Magic,0,1,24,32,56,9,22,31,33,54,87,26,5,31,12,44,18,11,13,102,101
2019,2,21900503,12/31/2019,1610612742,Dallas Mavericks,0,0,1610612760,Oklahoma City Thunder,1,1,18,24,42,15,36,51,33,60,93,20,7,27,21,42,19,7,11,97,101
2019,2,21900503,12/31/2019,1610612760,Oklahoma City Thunder,1,1,1610612742,Dallas Mavericks,0,0,33,31,64,6,21,27,39,52,91,22,6,28,20,34,18,5,12,96,106
2019,2,21900502,12/31/2019,1610612744,Golden State Warriors,0,0,1610612759,San Antonio Spurs,1,1,32,37,69,12,15,27,44,52,96,13,5,18,12,44,31,6,9,100,113
2019,2,21900502,12/31/2019,1610612759,San Antonio Spurs,1,1,1610612744,Golden State Warriors,0,0,31,34,65,14,17,31,45,51,96,13,4,17,15,38,30,5,10,101,117
2019,2,21900501,12/31/2019,1610612743,Denver Nuggets,0,0,1610612745,Houston Rockets,1,1,37,35,72,8,17,25,45,52,97,6,3,9,18,36,25,6,16,98,104
2016,2,21600114,11/9/2016,1610612745,Houston Rockets,0,1,1610612759,San Antonio Spurs,1,0,27,21,48,10,20,30,37,41,78,17,5,22,14,31,25,14,20,95,101
2016,2,21600114,11/9/2016,1610612759,San Antonio Spurs,1,0,1610612745,Houston Rockets,0,1,26,35,61,7,16,23,33,51,84,26,4,30,14,38,22,7,10,94,99
2019,2,21900501,12/31/2019,1610612745,Houston Rockets,1,1,1610612743,Denver Nuggets,0,0,30,23,53,16,18,34,46,41,87,22,9,31,17,28,20,7,15,100,130
2016,2,21601110,3/28/2017,1610612747,Los Angeles Lakers,1,0,1610612764,Washington Wizards,0,1,35,28,63,8,14,22,43,42,85,14,2,16,13,30,21,12,18,99,108
2016,2,21601110,3/28/2017,1610612764,Washington Wizards,0,1,1610612747,Los Angeles Lakers,1,0,42,29,71,6,17,23,48,46,94,17,8,25,18,33,24,6,13,98,119
2019,2,21900500,12/31/2019,1610612739,Cleveland Cavaliers,0,0,1610612761,Toronto Raptors,1,1,27,22,49,10,28,38,37,50,87,13,3,16,15,36,21,5,15,97,97
2019,2,21900500,12/31/2019,1610612761,Toronto Raptors,1,1,1610612739,Cleveland Cavaliers,0,0,23,22,45,17,22,39,40,44,84,20,5,25,12,35,29,5,12,96,117
2019,2,21900499,12/31/2019,1610612746,LA Clippers,0,1,1610612758,Sacramento Kings,1,0,24,28,52,12,24,36,36,52,88,21,1,22,18,34,21,8,12,93,105
2019,2,21900499,12/31/2019,1610612758,Sacramento Kings,1,0,1610612746,LA Clippers,0,1,25,27,52,8,20,28,33,47,80,13,6,19,13,38,20,9,16,92,87
2019,2,21900498,12/31/2019,1610612754,Indiana Pacers,1,1,1610612755,Philadelphia 76ers,0,0,31,30,61,11,14,25,42,44,86,20,6,26,11,35,35,4,6,94,115
2019,2,21900498,12/31/2019,1610612755,Philadelphia 76ers,0,0,1610612754,Indiana Pacers,1,1,31,31,62,6,23,29,37,54,91,17,3,20,20,34,24,3,15,95,97
2019,2,21900497,12/31/2019,1610612738,Boston Celtics,0,1,1610612766,Charlotte Hornets,1,0,30,29,59,14,24,38,44,53,97,7,3,10,19,35,25,7,13,97,109
2019,2,21900497,12/31/2019,1610612766,Charlotte Hornets,1,0,1610612738,Boston Celtics,0,1,22,30,52,12,22,34,34,52,86,12,4,16,14,41,25,12,17,97,92
2019,2,21900496,12/30/2019,1610612756,Phoenix Suns,0,1,1610612757,Portland Trail Blazers,1,0,31,38,69,13,10,23,44,48,92,21,1,22,15,34,29,5,11,98,122
2019,2,21900496,12/30/2019,1610612757,Portland Trail Blazers,1,0,1610612756,Phoenix Suns,0,1,30,32,62,14,20,34,44,52,96,14,4,18,16,39,24,6,9,97,116
2019,2,21900495,12/30/2019,1610612762,Utah Jazz,1,1,1610612765,Detroit Pistons,0,0,29,28,57,10,16,26,39,44,83,16,4,20,13,33,20,10,15,95,104
2019,2,21900495,12/30/2019,1610612765,Detroit Pistons,0,0,1610612762,Utah Jazz,1,1,26,39,65,4,10,14,30,49,79,17,6,23,13,39,14,7,17,96,81
2019,2,21900494,12/30/2019,1610612750,Minnesota Timberwolves,1,1,1610612751,Brooklyn Nets,0,0,25,35,60,17,27,44,42,62,104,21,8,29,15,52,20,4,14,118,122
2019,2,21900494,12/30/2019,1610612751,Brooklyn Nets,0,0,1610612750,Minnesota Timberwolves,1,1,25,33,58,15,26,41,40,59,99,20,7,27,10,52,22,12,17,117,115
2019,2,21900493,12/30/2019,1610612741,Chicago Bulls,1,0,1610612749,Milwaukee Bucks,0,1,23,40,63,17,27,44,40,67,107,5,3,8,19,50,26,6,10,103,102
2019,2,21900493,12/30/2019,1610612749,Milwaukee Bucks,0,1,1610612741,Chicago Bulls,1,0,35,17,52,11,21,32,46,38,84,20,4,24,10,29,29,10,18,102,123
2019,2,21900492,12/30/2019,1610612748,Miami Heat,0,0,1610612764,Washington Wizards,1,1,23,22,45,10,18,28,33,40,73,29,10,39,12,33,18,13,19,98,105
2019,2,21900492,12/30/2019,1610612764,Washington Wizards,1,1,1610612748,Miami Heat,0,0,26,21,47,17,20,37,43,41,84,20,10,30,10,36,26,5,10,97,123
2019,2,21900491,12/30/2019,1610612737,Atlanta Hawks,0,1,1610612753,Orlando Magic,1,0,30,22,52,9,20,29,39,42,81,14,3,17,13,30,21,9,21,97,101
2019,2,21900491,12/30/2019,1610612753,Orlando Magic,1,0,1610612737,Atlanta Hawks,0,1,32,32,64,5,20,25,37,52,89,14,10,24,14,42,22,8,9,97,93
2019,2,21900490,12/29/2019,1610612742,Dallas Mavericks,0,0,1610612747,Los Angeles Lakers,1,1,19,27,46,13,30,43,32,57,89,18,2,20,18,39,17,12,19,101,95
2019,2,21900490,12/29/2019,1610612747,Los Angeles Lakers,1,1,1610612742,Dallas Mavericks,0,0,29,26,55,9,14,23,38,40,78,23,5,28,8,32,28,11,16,101,108
2019,2,21900489,12/29/2019,1610612743,Denver Nuggets,1,1,1610612758,Sacramento Kings,0,0,34,18,52,8,21,29,42,39,81,28,3,31,14,27,23,5,12,95,120
2019,2,21900489,12/29/2019,1610612758,Sacramento Kings,0,0,1610612743,Denver Nuggets,1,1,32,19,51,13,21,34,45,40,85,12,5,17,13,28,32,6,14,95,115
2019,2,21900488,12/29/2019,1610612740,New Orleans Pelicans,1,1,1610612745,Houston Rockets,0,0,32,26,58,18,26,44,50,52,102,9,4,13,19,35,32,5,9,98,127
2019,2,21900488,12/29/2019,1610612745,Houston Rockets,0,0,1610612740,New Orleans Pelicans,1,1,27,15,42,15,24,39,42,39,81,13,7,20,9,34,29,9,17,97,112
2018,2,21800319,11/30/2018,1610612738,Boston Celtics,1,1,1610612739,Cleveland Cavaliers,0,0,32,29,61,17,14,31,49,43,92,13,3,16,14,29,30,5,10,96,128
2018,2,21800319,11/30/2018,1610612739,Cleveland Cavaliers,0,0,1610612738,Boston Celtics,1,1,23,32,55,7,15,22,30,47,77,28,7,35,10,38,18,4,13,95,95
2018,2,21800152,11/6/2018,1610612749,Milwaukee Bucks,0,0,1610612757,Portland Trail Blazers,1,1,24,26,50,16,26,42,40,52,92,7,1,8,13,40,26,7,12,95,103
2018,2,21800152,11/6/2018,1610612757,Portland Trail Blazers,1,1,1610612749,Milwaukee Bucks,0,0,31,17,48,17,26,43,48,43,91,5,3,8,12,34,23,2,12,94,118
2014,2,21401209,4/13/2015,1610612757,Portland Trail Blazers,0,0,1610612760,Oklahoma City Thunder,1,1,30,30,60,8,15,23,38,45,83,6,3,9,6,41,22,8,13,94,90
2014,2,21401209,4/13/2015,1610612760,Oklahoma City Thunder,1,1,1610612757,Portland Trail Blazers,0,0,35,40,75,4,17,21,39,57,96,19,8,27,24,37,14,1,8,94,101
2016,2,21600553,1/7/2017,1610612738,Boston Celtics,1,1,1610612740,New Orleans Pelicans,0,0,22,35,57,18,18,36,40,53,93,19,2,21,19,35,26,7,10,92,117
2016,2,21600553,1/7/2017,1610612740,New Orleans Pelicans,0,0,1610612738,Boston Celtics,1,1,30,24,54,10,21,31,40,45,85,18,5,23,13,34,22,6,12,94,108
2014,2,21400765,2/8/2015,1610612746,LA Clippers,0,0,1610612760,Oklahoma City Thunder,1,1,30,28,58,12,20,32,42,48,90,12,5,17,12,39,28,8,13,98,108
2014,2,21400765,2/8/2015,1610612760,Oklahoma City Thunder,1,1,1610612746,LA Clippers,0,0,38,30,68,8,12,20,46,42,88,31,7,38,19,27,26,9,11,96,131
2018,2,21800766,1/31/2019,1610612749,Milwaukee Bucks,0,1,1610612761,Toronto Raptors,1,0,25,16,41,14,24,38,39,40,79,13,4,17,9,34,21,9,20,98,105
2018,2,21800766,1/31/2019,1610612761,Toronto Raptors,1,0,1610612749,Milwaukee Bucks,0,1,30,36,66,7,20,27,37,56,93,11,2,13,15,43,16,13,16,99,92
2018,2,21800153,11/7/2018,1610612739,Cleveland Cavaliers,1,0,1610612760,Oklahoma City Thunder,0,1,24,34,58,9,22,31,33,56,89,11,2,13,16,42,17,13,20,98,86
2018,2,21800153,11/7/2018,1610612760,Oklahoma City Thunder,0,1,1610612739,Cleveland Cavaliers,1,0,28,29,57,7,20,27,35,49,84,18,8,26,11,41,10,3,12,98,95
2017,2,21701191,4/7/2018,1610612743,Denver Nuggets,0,1,1610612746,LA Clippers,1,0,41,15,56,12,17,29,53,32,85,16,7,23,9,26,36,6,8,95,134
2017,2,21701191,4/7/2018,1610612746,LA Clippers,1,0,1610612743,Denver Nuggets,0,1,37,33,70,6,11,17,43,44,87,23,11,34,21,30,25,4,11,95,115
2017,2,21701096,3/25/2018,1610612748,Miami Heat,0,0,1610612754,Indiana Pacers,1,1,27,24,51,14,21,35,41,45,86,11,3,14,7,41,32,12,17,104,107
2017,2,21701096,3/25/2018,1610612754,Indiana Pacers,1,1,1610612748,Miami Heat,0,0,36,31,67,8,15,23,44,46,90,17,4,21,15,33,26,10,17,103,113
2017,2,21701081,3/23/2018,1610612750,Minnesota Timberwolves,0,1,1610612752,New York Knicks,1,0,25,24,49,10,16,26,35,40,75,28,4,32,10,33,23,9,15,96,108
2017,2,21701081,3/23/2018,1610612752,New York Knicks,1,0,1610612750,Minnesota Timberwolves,0,1,28,36,64,12,16,28,40,52,92,12,5,17,15,40,25,6,11,96,104
2017,2,21701069,3/21/2018,1610612741,Chicago Bulls,1,0,1610612743,Denver Nuggets,0,1,26,25,51,13,25,38,39,50,89,11,3,14,13,39,29,9,15,99,102
2017,2,21701069,3/21/2018,1610612743,Denver Nuggets,0,1,1610612741,Chicago Bulls,1,0,31,17,48,20,15,35,51,32,83,13,3,16,9,26,34,12,19,99,135
2017,2,21701058,3/20/2018,1610612753,Orlando Magic,1,0,1610612761,Toronto Raptors,0,1,28,37,65,9,16,25,37,53,90,3,2,5,14,40,22,7,15,93,86
2017,2,21701058,3/20/2018,1610612761,Toronto Raptors,0,1,1610612753,Orlando Magic,1,0,21,20,41,14,22,36,35,42,77,9,8,17,11,36,19,13,17,94,93
2017,2,21701038,3/17/2018,1610612752,New York Knicks,1,1,1610612766,Charlotte Hornets,0,0,37,37,74,12,14,26,49,51,100,14,4,18,15,39,24,7,8,100,124
2017,2,21701038,3/17/2018,1610612766,Charlotte Hornets,0,0,1610612752,New York Knicks,1,1,24,33,57,9,24,33,33,57,90,26,6,32,15,46,11,7,10,101,101
2014,2,21401208,4/13/2015,1610612740,New Orleans Pelicans,0,1,1610612750,Minnesota Timberwolves,1,0,31,32,63,6,15,21,37,47,84,20,4,24,14,36,15,1,9,90,100
2014,2,21401208,4/13/2015,1610612750,Minnesota Timberwolves,1,0,1610612740,New Orleans Pelicans,0,1,27,37,64,4,10,14,31,47,78,22,6,28,15,33,19,6,11,89,88
2016,2,21600113,11/9/2016,1610612756,Phoenix Suns,1,1,1610612765,Detroit Pistons,0,0,30,32,62,8,14,22,38,46,84,23,7,30,16,34,20,11,18,100,107
2016,2,21600113,11/9/2016,1610612765,Detroit Pistons,0,0,1610612756,Phoenix Suns,1,1,23,44,67,9,13,22,32,57,89,27,5,32,16,42,20,7,12,101,100
2014,2,21400764,2/7/2015,1610612758,Sacramento Kings,0,0,1610612762,Utah Jazz,1,1,29,40,69,3,10,13,32,50,82,23,10,33,23,33,15,6,12,86,90
2014,2,21400764,2/7/2015,1610612762,Utah Jazz,1,1,1610612758,Sacramento Kings,0,0,38,29,67,5,14,19,43,43,86,11,6,17,18,28,21,3,10,86,102
2018,2,21801142,3/30/2019,1610612741,Chicago Bulls,1,0,1610612761,Toronto Raptors,0,1,32,35,67,9,21,30,41,56,97,10,6,16,18,42,21,10,13,98,101
2018,2,21801142,3/30/2019,1610612761,Toronto Raptors,0,1,1610612741,Chicago Bulls,1,0,28,23,51,18,20,38,46,43,89,14,4,18,9,37,35,7,12,99,124
2018,2,21800994,3/10/2019,1610612754,Indiana Pacers,0,0,1610612755,Philadelphia 76ers,1,1,26,41,67,5,11,16,31,52,83,22,15,37,17,43,18,10,14,98,89
2018,2,21800994,3/10/2019,1610612755,Philadelphia 76ers,1,1,1610612754,Indiana Pacers,0,0,31,33,64,7,16,23,38,49,87,23,7,30,18,36,24,8,13,98,106
2018,2,21800525,12/28/2018,1610612756,Phoenix Suns,1,0,1610612760,Oklahoma City Thunder,0,1,30,31,61,9,20,29,39,51,90,15,1,16,12,39,22,12,17,103,102
2018,2,21800525,12/28/2018,1610612760,Oklahoma City Thunder,0,1,1610612756,Phoenix Suns,1,0,44,31,75,7,13,20,51,44,95,9,4,13,14,31,22,12,17,104,118
2018,2,21800380,12/8/2018,1610612737,Atlanta Hawks,1,1,1610612743,Denver Nuggets,0,0,25,26,51,15,27,42,40,53,93,11,5,16,16,40,33,11,18,103,106
2018,2,21800380,12/8/2018,1610612743,Denver Nuggets,0,0,1610612737,Atlanta Hawks,1,1,27,34,61,9,27,36,36,61,97,17,4,21,19,44,28,9,15,103,98
2018,2,21800318,11/29/2018,1610612746,LA Clippers,0,1,1610612758,Sacramento Kings,1,0,38,24,62,12,16,28,50,40,90,21,7,28,10,34,25,4,10,101,133
2018,2,21800318,11/29/2018,1610612758,Sacramento Kings,1,0,1610612746,LA Clippers,0,1,39,33,72,7,17,24,46,50,96,22,4,26,20,31,26,7,11,101,121
2018,2,21800207,11/14/2018,1610612749,Milwaukee Bucks,1,0,1610612763,Memphis Grizzlies,0,1,32,14,46,9,26,35,41,40,81,22,5,27,11,32,22,8,16,101,113
2018,2,21800207,11/14/2018,1610612763,Memphis Grizzlies,0,1,1610612749,Milwaukee Bucks,1,0,28,19,47,14,22,36,42,41,83,18,6,24,9,35,24,5,14,102,116
2018,2,21800154,11/7/2018,1610612753,Orlando Magic,1,0,1610612765,Detroit Pistons,0,1,31,29,60,9,18,27,40,47,87,7,2,9,9,39,28,13,21,103,96
2018,2,21800154,11/7/2018,1610612765,Detroit Pistons,0,1,1610612753,Orlando Magic,1,0,26,27,53,11,26,37,37,53,90,18,2,20,16,37,21,10,20,104,103
2017,2,21701128,3/29/2018,1610612744,Golden State Warriors,1,0,1610612749,Milwaukee Bucks,0,1,31,24,55,10,10,20,41,34,75,15,0,15,2,32,26,16,19,98,107
2017,2,21701128,3/29/2018,1610612749,Milwaukee Bucks,0,1,1610612744,Golden State Warriors,1,0,37,30,67,11,9,20,48,39,87,9,1,10,9,30,30,10,16,98,116
2017,2,21701111,3/27/2018,1610612741,Chicago Bulls,0,0,1610612745,Houston Rockets,1,1,26,26,52,8,29,37,34,55,89,10,7,17,17,41,17,15,19,99,86
2017,2,21701111,3/27/2018,1610612745,Houston Rockets,1,1,1610612741,Chicago Bulls,0,0,23,13,36,18,39,57,41,52,93,18,3,21,13,41,28,8,10,98,118
2016,2,21601109,3/28/2017,1610612743,Denver Nuggets,0,0,1610612757,Portland Trail Blazers,1,1,35,29,64,9,21,30,44,50,94,16,4,20,16,35,23,8,13,101,113
2016,2,21601109,3/28/2017,1610612757,Portland Trail Blazers,1,1,1610612743,Denver Nuggets,0,0,37,27,64,8,19,27,45,46,91,24,9,33,15,36,15,3,9,100,122
2016,2,21600552,1/7/2017,1610612752,New York Knicks,0,0,1610612754,Indiana Pacers,1,1,28,28,56,12,19,31,40,47,87,17,7,24,9,41,25,11,17,105,109
2016,2,21600552,1/7/2017,1610612754,Indiana Pacers,1,1,1610612752,New York Knicks,0,0,32,30,62,11,13,24,43,43,86,26,2,28,16,28,25,9,20,105,123
2014,2,21401207,4/13/2015,1610612748,Miami Heat,1,1,1610612753,Orlando Magic,0,0,36,37,73,3,7,10,39,44,83,19,4,23,15,32,21,10,14,91,100
2014,2,21401207,4/13/2015,1610612753,Orlando Magic,0,0,1610612748,Miami Heat,1,1,29,35,64,6,15,21,35,50,85,17,11,28,14,41,14,2,8,93,93
2014,2,21400763,2/7/2015,1610612738,Boston Celtics,0,0,1610612749,Milwaukee Bucks,1,1,29,28,57,7,22,29,36,50,86,14,6,20,18,34,20,6,11,92,93
2014,2,21400763,2/7/2015,1610612749,Milwaukee Bucks,1,1,1610612738,Boston Celtics,0,0,29,26,55,8,12,20,37,38,75,14,5,19,6,35,21,7,12,90,96
2018,2,21800864,2/14/2019,1610612753,Orlando Magic,1,1,1610612766,Charlotte Hornets,0,0,31,22,53,17,22,39,48,44,92,14,4,18,9,35,32,6,7,97,127
2018,2,21800864,2/14/2019,1610612766,Charlotte Hornets,0,0,1610612753,Orlando Magic,1,1,29,34,63,4,27,31,33,61,94,19,7,26,17,44,18,6,8,98,89
2018,2,21800681,1/19/2019,1610612742,Dallas Mavericks,0,0,1610612754,Indiana Pacers,1,1,28,23,51,9,28,37,37,51,88,16,4,20,17,35,21,6,13,96,99
2018,2,21800681,1/19/2019,1610612754,Indiana Pacers,1,1,1610612742,Dallas Mavericks,0,0,34,27,61,8,16,24,42,43,85,19,5,24,14,32,23,5,11,94,111
2018,2,21800606,1/8/2019,1610612746,LA Clippers,1,1,1610612766,Charlotte Hornets,0,0,34,29,63,14,16,30,48,45,93,18,3,21,12,34,28,5,10,101,128
2018,2,21800606,1/8/2019,1610612766,Charlotte Hornets,0,0,1610612746,LA Clippers,1,1,24,33,57,12,21,33,36,54,90,25,4,29,14,41,20,6,11,101,109
2018,2,21800261,11/21/2018,1610612742,Dallas Mavericks,1,1,1610612751,Brooklyn Nets,0,0,27,24,51,11,16,27,38,40,78,32,9,41,14,29,21,8,13,99,119
2018,2,21800261,11/21/2018,1610612751,Brooklyn Nets,0,0,1610612742,Dallas Mavericks,1,1,28,24,52,14,28,42,42,52,94,15,6,21,17,38,23,10,14,99,113
2018,2,21800208,11/14/2018,1610612740,New Orleans Pelicans,0,0,1610612750,Minnesota Timberwolves,1,1,31,35,66,9,19,28,40,54,94,11,7,18,16,40,25,14,18,105,100
2018,2,21800208,11/14/2018,1610612750,Minnesota Timberwolves,1,1,1610612740,New Orleans Pelicans,0,0,23,35,58,14,18,32,37,53,90,19,5,24,14,41,29,7,16,105,107
2015,2,21501195,4/10/2016,1610612745,Houston Rockets,1,1,1610612747,Los Angeles Lakers,0,0,33,24,57,17,24,41,50,48,98,13,5,18,19,33,30,10,14,103,130
2015,2,21501195,4/10/2016,1610612747,Los Angeles Lakers,0,0,1610612745,Houston Rockets,1,1,29,26,55,12,16,28,41,42,83,16,3,19,9,34,25,11,21,102,110
2017,2,21701210,4/9/2018,1610612758,Sacramento Kings,0,0,1610612759,San Antonio Spurs,1,1,25,38,63,8,10,18,33,48,81,11,6,17,16,35,16,6,12,87,85
2017,2,21701210,4/9/2018,1610612759,San Antonio Spurs,1,1,1610612758,Sacramento Kings,0,0,28,27,55,6,21,27,34,48,82,24,5,29,15,36,18,4,8,87,98
2017,2,21701166,4/3/2018,1610612747,Los Angeles Lakers,0,0,1610612762,Utah Jazz,1,1,22,24,46,14,14,28,36,38,74,24,12,36,8,35,23,10,16,99,110
2017,2,21701166,4/3/2018,1610612762,Utah Jazz,1,1,1610612747,Los Angeles Lakers,0,0,29,27,56,14,19,33,43,46,89,17,10,27,18,34,29,7,14,98,117
2017,2,21701049,3/18/2018,1610612746,LA Clippers,1,0,1610612757,Portland Trail Blazers,0,1,31,35,66,9,14,23,40,49,89,20,7,27,12,40,21,7,8,98,109
2017,2,21701049,3/18/2018,1610612757,Portland Trail Blazers,0,1,1610612746,LA Clippers,1,0,32,31,63,14,15,29,46,46,92,16,4,20,16,33,24,8,13,98,122
2017,2,21701042,3/17/2018,1610612750,Minnesota Timberwolves,0,0,1610612759,San Antonio Spurs,1,1,32,37,69,7,5,12,39,42,81,16,4,20,17,28,22,11,16,92,101
2017,2,21701042,3/17/2018,1610612759,San Antonio Spurs,1,1,1610612750,Minnesota Timberwolves,0,0,43,27,70,6,20,26,49,47,96,13,1,14,16,31,32,3,5,91,117
2016,2,21601108,3/28/2017,1610612744,Golden State Warriors,0,1,1610612745,Houston Rockets,1,0,34,13,47,11,30,41,45,43,88,12,4,16,11,32,33,9,17,102,113
2016,2,21601108,3/28/2017,1610612745,Houston Rockets,1,0,1610612744,Golden State Warriors,0,1,28,26,54,5,26,31,33,52,85,35,4,39,15,37,20,9,14,103,106
2018,2,21801141,3/30/2019,1610612748,Miami Heat,0,1,1610612752,New York Knicks,1,0,30,28,58,9,23,32,39,51,90,13,4,17,19,36,26,11,20,99,100
2018,2,21801141,3/30/2019,1610612752,New York Knicks,1,0,1610612748,Miami Heat,0,1,22,17,39,9,29,38,31,46,77,21,4,25,11,38,20,10,19,98,92
2018,2,21800993,3/10/2019,1610612748,Miami Heat,1,0,1610612761,Toronto Raptors,0,1,34,31,65,8,19,27,42,50,92,12,9,21,14,40,27,8,14,101,104
2018,2,21800993,3/10/2019,1610612761,Toronto Raptors,0,1,1610612748,Miami Heat,1,0,21,13,34,21,19,40,42,32,74,20,6,26,7,27,32,13,21,100,125
2018,2,21800260,11/21/2018,1610612743,Denver Nuggets,0,1,1610612750,Minnesota Timberwolves,1,0,28,26,54,14,21,35,42,47,89,5,1,6,11,36,29,8,14,96,103
2018,2,21800260,11/21/2018,1610612750,Minnesota Timberwolves,1,0,1610612743,Denver Nuggets,0,1,26,21,47,9,23,32,35,44,79,22,4,26,12,34,24,12,18,97,101
2016,2,21600551,1/6/2017,1610612746,LA Clippers,0,1,1610612758,Sacramento Kings,1,0,26,27,53,13,18,31,39,45,84,15,6,21,9,39,28,4,8,91,106
2015,2,21501070,3/24/2016,1610612741,Chicago Bulls,0,0,1610612752,New York Knicks,1,1,31,33,64,6,19,25,37,52,89,14,4,18,11,43,15,4,8,94,94
2016,2,21600551,1/6/2017,1610612758,Sacramento Kings,1,0,1610612746,LA Clippers,0,1,27,30,57,9,21,30,36,51,87,17,5,22,13,40,23,6,7,91,98
2015,2,21501070,3/24/2016,1610612752,New York Knicks,1,1,1610612741,Chicago Bulls,0,0,26,20,46,13,17,30,39,37,76,15,1,16,6,31,19,9,18,95,106
2014,2,21400762,2/7/2015,1610612742,Dallas Mavericks,1,1,1610612757,Portland Trail Blazers,0,0,29,40,69,14,22,36,43,62,105,11,5,16,22,41,21,11,17,107,111
2014,2,21400762,2/7/2015,1610612757,Portland Trail Blazers,0,0,1610612742,Dallas Mavericks,1,1,27,30,57,10,22,32,37,52,89,17,7,24,18,35,24,11,23,106,101
2018,2,21800765,1/31/2019,1610612753,Orlando Magic,1,1,1610612754,Indiana Pacers,0,0,27,30,57,11,14,25,38,44,82,20,2,22,9,36,25,8,15,97,107
2018,2,21800765,1/31/2019,1610612754,Indiana Pacers,0,0,1610612753,Orlando Magic,1,1,37,35,72,4,15,19,41,50,91,14,2,16,9,43,26,4,10,99,100
2018,2,21800379,12/8/2018,1610612754,Indiana Pacers,1,1,1610612758,Sacramento Kings,0,0,32,30,62,8,22,30,40,52,92,19,3,22,21,32,26,9,17,97,107
2018,2,21800379,12/8/2018,1610612758,Sacramento Kings,0,0,1610612754,Indiana Pacers,1,1,29,29,58,9,23,32,38,52,90,12,3,15,16,37,24,7,14,96,97
2018,2,21800317,11/29/2018,1610612747,Los Angeles Lakers,1,1,1610612754,Indiana Pacers,0,0,35,27,62,7,17,24,42,44,86,13,10,23,14,34,25,14,18,100,104
2018,2,21800317,11/29/2018,1610612754,Indiana Pacers,0,0,1610612747,Los Angeles Lakers,1,1,22,41,63,10,13,23,32,54,86,22,5,27,16,39,23,8,17,100,96
2018,2,21800103,10/30/2018,1610612746,LA Clippers,0,0,1610612760,Oklahoma City Thunder,1,1,28,26,54,7,13,20,35,39,74,33,10,43,9,34,18,16,25,110,110
2018,2,21800103,10/30/2018,1610612760,Oklahoma City Thunder,1,1,1610612746,LA Clippers,0,0,39,38,77,9,8,17,48,46,94,23,9,32,15,34,19,6,17,111,128
2017,2,21701211,4/9/2018,1610612743,Denver Nuggets,1,1,1610612757,Portland Trail Blazers,0,0,25,32,57,6,20,26,31,52,83,20,6,26,15,41,22,8,12,95,88
2017,2,21701211,4/9/2018,1610612757,Portland Trail Blazers,0,0,1610612743,Denver Nuggets,1,1,24,37,61,7,26,33,31,63,94,13,5,18,23,44,10,7,17,95,82
2017,2,21701188,4/6/2018,1610612758,Sacramento Kings,0,1,1610612763,Memphis Grizzlies,1,0,34,27,61,6,18,24,40,45,85,8,4,12,17,29,23,7,16,91,94
2017,2,21701188,4/6/2018,1610612763,Memphis Grizzlies,1,0,1610612758,Sacramento Kings,0,1,31,29,60,6,18,24,37,47,84,13,5,18,16,34,20,8,15,90,93
2017,2,21701167,4/3/2018,1610612756,Phoenix Suns,1,1,1610612758,Sacramento Kings,0,0,29,31,60,6,11,17,35,42,77,21,12,33,11,35,18,5,15,97,97
2017,2,21701167,4/3/2018,1610612758,Sacramento Kings,0,0,1610612756,Phoenix Suns,1,1,22,40,62,11,16,27,33,56,89,17,6,23,13,47,20,6,10,98,94
2017,2,21701110,3/27/2018,1610612739,Cleveland Cavaliers,0,0,1610612748,Miami Heat,1,1,27,32,59,4,22,26,31,54,85,13,6,19,19,39,15,10,15,92,79
2017,2,21701110,3/27/2018,1610612748,Miami Heat,1,1,1610612739,Cleveland Cavaliers,0,0,28,21,49,9,20,29,37,41,78,15,5,20,12,32,24,8,16,91,98
2017,2,21701080,3/23/2018,1610612739,Cleveland Cavaliers,1,1,1610612756,Phoenix Suns,0,0,39,27,66,8,21,29,47,48,95,18,6,24,17,33,23,9,14,105,120
2017,2,21701080,3/23/2018,1610612756,Phoenix Suns,0,0,1610612739,Cleveland Cavaliers,1,1,31,28,59,7,21,28,38,49,87,12,8,20,10,44,24,9,17,104,95
2017,2,21701068,3/21/2018,1610612748,Miami Heat,1,1,1610612752,New York Knicks,0,0,30,17,47,15,19,34,45,36,81,14,5,19,9,29,31,6,8,90,119
2017,2,21701068,3/21/2018,1610612752,New York Knicks,0,0,1610612748,Miami Heat,1,1,29,29,58,10,21,31,39,50,89,10,2,12,21,30,21,9,15,90,98
2016,2,21601107,3/28/2017,1610612748,Miami Heat,0,1,1610612765,Detroit Pistons,1,0,31,27,58,5,16,21,36,43,79,20,8,28,12,35,18,7,13,91,97
2016,2,21601107,3/28/2017,1610612765,Detroit Pistons,1,0,1610612748,Miami Heat,0,1,28,30,58,8,19,27,36,49,85,16,5,21,18,34,20,5,13,91,96
2016,2,21600112,11/9/2016,1610612760,Oklahoma City Thunder,1,0,1610612761,Toronto Raptors,0,1,19,21,40,12,22,34,31,43,74,28,3,31,16,29,18,10,21,96,102
2016,2,21600112,11/9/2016,1610612761,Toronto Raptors,0,1,1610612760,Oklahoma City Thunder,1,0,32,25,57,11,15,26,43,40,83,15,7,22,11,31,25,6,13,96,112
2014,2,21400761,2/7/2015,1610612755,Philadelphia 76ers,1,1,1610612766,Charlotte Hornets,0,0,20,31,51,9,14,23,29,45,74,22,8,30,8,41,19,9,15,95,89
2014,2,21400761,2/7/2015,1610612766,Charlotte Hornets,0,0,1610612755,Philadelphia 76ers,1,1,23,38,61,6,17,23,29,55,84,17,3,20,10,46,24,6,12,95,81
2018,2,21800992,3/10/2019,1610612741,Chicago Bulls,0,0,1610612765,Detroit Pistons,1,1,32,32,64,9,9,18,41,41,82,17,9,26,9,36,18,5,10,99,108
2018,2,21800992,3/10/2019,1610612765,Detroit Pistons,1,1,1610612741,Chicago Bulls,0,0,30,26,56,19,16,35,49,42,91,14,8,22,13,33,34,4,8,97,131
2018,2,21800863,2/13/2019,1610612746,LA Clippers,1,1,1610612756,Phoenix Suns,0,0,39,23,62,11,11,22,50,34,84,23,7,30,9,29,33,6,11,102,134
2018,2,21800863,2/13/2019,1610612756,Phoenix Suns,0,0,1610612746,LA Clippers,1,1,32,24,56,8,22,30,40,46,86,19,6,25,12,37,24,12,17,102,107
2018,2,21800680,1/19/2019,1610612758,Sacramento Kings,0,1,1610612765,Detroit Pistons,1,0,30,34,64,10,15,25,40,49,89,13,5,18,16,35,30,6,13,94,103
2018,2,21800680,1/19/2019,1610612765,Detroit Pistons,1,0,1610612758,Sacramento Kings,0,1,26,27,53,10,19,29,36,46,82,19,6,25,16,31,21,5,17,95,101
2018,2,21800449,12/17/2018,1610612744,Golden State Warriors,1,1,1610612763,Memphis Grizzlies,0,0,25,29,54,12,19,31,37,48,85,24,3,27,9,41,23,6,10,99,110
2018,2,21800449,12/17/2018,1610612763,Memphis Grizzlies,0,0,1610612744,Golden State Warriors,1,1,29,25,54,7,18,25,36,43,79,14,4,18,6,39,24,10,16,100,93
2017,2,21701095,3/25/2018,1610612749,Milwaukee Bucks,1,1,1610612759,San Antonio Spurs,0,0,33,26,59,9,18,27,42,44,86,13,5,18,12,36,27,4,10,93,106
2017,2,21701095,3/25/2018,1610612759,San Antonio Spurs,0,0,1610612749,Milwaukee Bucks,1,1,37,38,75,4,13,17,41,51,92,17,4,21,22,30,16,6,12,92,103
2017,2,21701057,3/19/2018,1610612758,Sacramento Kings,1,0,1610612765,Detroit Pistons,0,1,34,31,65,6,17,23,40,48,88,4,5,9,12,39,23,6,13,93,90
2017,2,21701057,3/19/2018,1610612765,Detroit Pistons,0,1,1610612758,Sacramento Kings,1,0,23,27,50,14,15,29,37,42,79,18,4,22,8,35,17,7,10,92,106
2017,2,21701048,3/18/2018,1610612745,Houston Rockets,0,1,1610612750,Minnesota Timberwolves,1,0,27,16,43,16,19,35,43,35,78,27,9,36,8,30,28,7,11,96,129
2017,2,21701048,3/18/2018,1610612750,Minnesota Timberwolves,1,0,1610612745,Houston Rockets,0,1,35,31,66,10,10,20,45,41,86,20,6,26,17,26,24,7,14,96,120
2016,2,21600550,1/6/2017,1610612744,Golden State Warriors,1,0,1610612763,Memphis Grizzlies,0,1,33,20,53,8,22,30,41,42,83,29,10,39,8,38,23,13,16,108,119
2016,2,21600550,1/6/2017,1610612763,Memphis Grizzlies,0,1,1610612744,Golden State Warriors,1,0,37,33,70,13,20,33,50,53,103,15,4,19,17,38,29,7,12,106,128
2014,2,21400760,2/7/2015,1610612744,Golden State Warriors,0,1,1610612752,New York Knicks,1,0,25,31,56,12,13,25,37,44,81,20,4,24,15,32,21,7,14,91,106
2014,2,21400760,2/7/2015,1610612752,New York Knicks,1,0,1610612744,Golden State Warriors,0,1,27,42,69,8,10,18,35,52,87,14,3,17,17,36,23,8,15,91,92
2018,2,21801140,3/30/2019,1610612753,Orlando Magic,0,1,1610612754,Indiana Pacers,1,0,32,22,54,15,23,38,47,45,92,12,2,14,11,35,37,4,7,95,121
2018,2,21801140,3/30/2019,1610612754,Indiana Pacers,1,0,1610612753,Orlando Magic,0,1,39,27,66,9,15,24,48,42,90,11,6,17,16,29,26,9,15,96,116
2018,2,21800764,1/31/2019,1610612742,Dallas Mavericks,0,0,1610612765,Detroit Pistons,1,1,29,34,63,7,18,25,36,52,88,10,4,14,16,39,18,5,12,91,89
2018,2,21800764,1/31/2019,1610612765,Detroit Pistons,1,1,1610612742,Dallas Mavericks,0,0,24,29,53,9,24,33,33,53,86,18,5,23,18,36,21,2,11,90,93
2018,2,21800679,1/19/2019,1610612756,Phoenix Suns,0,0,1610612766,Charlotte Hornets,1,1,28,26,54,11,22,33,39,48,87,26,7,33,12,40,21,5,8,100,115
2018,2,21800679,1/19/2019,1610612766,Charlotte Hornets,1,1,1610612756,Phoenix Suns,0,0,32,22,54,16,18,34,48,40,88,23,4,27,16,25,31,7,18,101,135
2018,2,21800605,1/8/2019,1610612744,Golden State Warriors,1,1,1610612752,New York Knicks,0,0,35,16,51,14,31,45,49,47,96,10,2,12,17,31,36,11,16,100,122
2018,2,21800605,1/8/2019,1610612752,New York Knicks,0,0,1610612744,Golden State Warriors,1,1,29,35,64,6,18,24,35,53,88,19,2,21,15,38,13,9,17,101,95
2018,2,21800524,12/28/2018,1610612743,Denver Nuggets,1,1,1610612759,San Antonio Spurs,0,0,29,27,56,10,19,29,39,46,85,14,3,17,19,27,29,14,20,94,102
2018,2,21800524,12/28/2018,1610612759,San Antonio Spurs,0,0,1610612743,Denver Nuggets,1,1,32,30,62,8,19,27,40,49,89,11,9,20,15,37,23,5,10,96,99
2018,2,21800450,12/17/2018,1610612746,LA Clippers,1,0,1610612757,Portland Trail Blazers,0,1,32,24,56,10,17,27,42,41,83,33,6,39,13,30,27,5,12,102,127
2018,2,21800450,12/17/2018,1610612757,Portland Trail Blazers,0,1,1610612746,LA Clippers,1,0,37,29,66,10,10,20,47,39,86,27,4,31,10,30,26,5,11,102,131
2017,2,21701189,4/6/2018,1610612740,New Orleans Pelicans,0,1,1610612756,Phoenix Suns,1,0,29,32,61,16,22,38,45,54,99,16,4,20,19,38,29,8,15,106,122
2017,2,21701189,4/6/2018,1610612756,Phoenix Suns,1,0,1610612740,New Orleans Pelicans,0,1,28,33,61,9,24,33,37,57,94,20,6,26,16,45,20,9,14,106,103
2017,2,21701145,4/1/2018,1610612745,Houston Rockets,0,0,1610612759,San Antonio Spurs,1,1,19,27,46,7,24,31,26,51,77,24,5,29,13,41,12,8,10,88,83
2017,2,21701145,4/1/2018,1610612759,San Antonio Spurs,1,1,1610612745,Houston Rockets,0,0,34,30,64,6,11,17,40,41,81,14,7,21,10,36,19,3,9,88,100
2017,2,21701127,3/29/2018,1610612754,Indiana Pacers,0,1,1610612758,Sacramento Kings,1,0,32,22,54,8,18,26,40,40,80,18,2,20,10,31,23,3,10,87,106
2017,2,21701127,3/29/2018,1610612758,Sacramento Kings,1,0,1610612754,Indiana Pacers,0,1,29,18,47,13,18,31,42,36,78,6,3,9,12,27,27,9,18,89,103
2017,2,21701079,3/23/2018,1610612743,Denver Nuggets,0,1,1610612764,Washington Wizards,1,0,20,31,51,17,17,34,37,48,85,17,1,18,9,39,25,3,10,94,108
2017,2,21701079,3/23/2018,1610612764,Washington Wizards,1,0,1610612743,Denver Nuggets,0,1,24,28,52,14,14,28,38,42,80,10,4,14,10,33,28,5,17,95,100
2017,2,21701067,3/21/2018,1610612751,Brooklyn Nets,1,0,1610612766,Charlotte Hornets,0,1,26,30,56,13,24,37,39,54,93,14,7,21,12,47,22,3,13,104,105
2017,2,21701067,3/21/2018,1610612766,Charlotte Hornets,0,1,1610612751,Brooklyn Nets,1,0,33,45,78,3,13,16,36,58,94,36,11,47,27,37,18,6,13,103,111
2016,2,21601106,3/28/2017,1610612737,Atlanta Hawks,1,1,1610612756,Phoenix Suns,0,0,28,30,58,6,21,27,34,51,85,21,8,29,15,41,24,12,19,104,95
2016,2,21601106,3/28/2017,1610612756,Phoenix Suns,0,0,1610612737,Atlanta Hawks,1,1,28,37,65,7,24,31,35,61,96,14,10,24,20,46,25,5,15,104,91
2014,2,21400759,2/7/2015,1610612751,Brooklyn Nets,0,0,1610612764,Washington Wizards,1,1,22,37,59,4,14,18,26,51,77,21,10,31,17,38,17,9,15,89,77
2014,2,21400759,2/7/2015,1610612764,Washington Wizards,1,1,1610612751,Brooklyn Nets,0,0,35,32,67,9,11,20,44,43,87,17,6,23,21,25,31,8,14,90,114
2018,2,21800862,2/13/2019,1610612744,Golden State Warriors,0,0,1610612757,Portland Trail Blazers,1,1,26,33,59,13,25,38,39,58,97,16,2,18,22,36,26,3,9,94,107
2018,2,21800862,2/13/2019,1610612757,Portland Trail Blazers,1,1,1610612744,Golden State Warriors,0,0,27,29,56,16,21,37,43,50,93,27,7,34,19,35,24,1,4,93,129
2018,2,21800604,1/8/2019,1610612756,Phoenix Suns,1,1,1610612758,Sacramento Kings,0,0,35,28,63,10,15,25,45,43,88,15,4,19,12,33,31,11,19,104,115
2018,2,21800604,1/8/2019,1610612758,Sacramento Kings,0,0,1610612756,Phoenix Suns,1,1,23,28,51,15,14,29,38,42,80,20,9,29,15,30,26,18,26,105,111
2018,2,21800523,12/28/2018,1610612740,New Orleans Pelicans,1,1,1610612742,Dallas Mavericks,0,0,40,33,73,4,19,23,44,52,96,22,5,27,26,29,22,7,11,94,114
2018,2,21800523,12/28/2018,1610612742,Dallas Mavericks,0,0,1610612740,New Orleans Pelicans,1,1,22,24,46,15,17,32,37,41,78,23,10,33,15,31,19,7,16,94,112
2018,2,21800150,11/6/2018,1610612742,Dallas Mavericks,1,1,1610612764,Washington Wizards,0,0,24,24,48,15,19,34,39,43,82,26,1,27,13,30,25,8,18,99,119
2018,2,21800150,11/6/2018,1610612764,Washington Wizards,0,0,1610612742,Dallas Mavericks,1,1,26,26,52,11,24,35,37,50,87,15,5,20,9,42,27,4,10,99,100
2017,2,21701146,4/1/2018,1610612746,LA Clippers,1,0,1610612754,Indiana Pacers,0,1,33,24,57,9,16,25,42,40,82,11,3,14,13,28,24,8,13,88,104
2017,2,21701146,4/1/2018,1610612754,Indiana Pacers,0,1,1610612746,LA Clippers,1,0,31,27,58,11,17,28,42,44,86,16,5,21,18,26,23,6,11,88,111
2017,2,21701094,3/25/2018,1610612739,Cleveland Cavaliers,0,1,1610612751,Brooklyn Nets,1,0,32,27,59,12,16,28,44,43,87,21,5,26,13,33,25,7,11,96,121
2017,2,21701094,3/25/2018,1610612751,Brooklyn Nets,1,0,1610612739,Cleveland Cavaliers,0,1,21,25,46,17,20,37,38,45,83,21,5,26,9,39,27,5,10,97,114
2014,2,21400758,2/7/2015,1610612740,New Orleans Pelicans,1,0,1610612741,Chicago Bulls,0,1,28,41,69,4,13,17,32,54,86,4,3,7,13,42,16,6,12,88,72
2014,2,21400758,2/7/2015,1610612741,Chicago Bulls,0,1,1610612740,New Orleans Pelicans,1,0,33,29,62,10,12,22,43,41,84,11,2,13,14,28,18,8,11,89,107
2018,2,21801139,3/30/2019,1610612757,Portland Trail Blazers,0,0,1610612765,Detroit Pistons,1,1,34,47,81,4,17,21,38,64,102,10,1,11,24,40,18,8,17,101,90
2018,2,21801139,3/30/2019,1610612765,Detroit Pistons,1,1,1610612757,Portland Trail Blazers,0,0,32,29,61,5,20,25,37,49,86,20,6,26,9,43,20,7,10,99,99
2018,2,21800991,3/9/2019,1610612756,Phoenix Suns,0,0,1610612757,Portland Trail Blazers,1,1,34,42,76,9,18,27,43,60,103,25,4,29,19,43,27,5,8,106,120
2018,2,21800991,3/9/2019,1610612757,Portland Trail Blazers,1,1,1610612756,Phoenix Suns,0,0,30,27,57,13,16,29,43,43,86,28,8,36,13,35,19,7,17,106,127
2018,2,21800316,11/29/2018,1610612744,Golden State Warriors,0,0,1610612761,Toronto Raptors,1,1,39,34,73,11,19,30,50,53,103,17,3,20,23,31,27,5,15,105,128
2018,2,21800316,11/29/2018,1610612761,Toronto Raptors,1,1,1610612744,Golden State Warriors,0,0,32,20,52,15,23,38,47,43,90,22,2,24,13,31,25,6,15,106,131
2018,2,21800151,11/6/2018,1610612751,Brooklyn Nets,0,1,1610612756,Phoenix Suns,1,0,32,24,56,9,27,36,41,51,92,13,6,19,14,41,22,4,10,97,104
2018,2,21800151,11/6/2018,1610612756,Phoenix Suns,1,0,1610612751,Brooklyn Nets,0,1,19,37,56,9,16,25,28,53,81,17,3,20,15,41,16,9,20,98,82
2017,2,21701126,3/29/2018,1610612759,San Antonio Spurs,1,1,1610612760,Oklahoma City Thunder,0,0,21,29,50,13,18,31,34,47,81,22,8,30,17,34,22,11,18,97,103
2017,2,21701126,3/29/2018,1610612760,Oklahoma City Thunder,0,0,1610612759,San Antonio Spurs,1,1,26,29,55,11,19,30,37,48,85,14,7,21,13,37,19,13,15,98,99
2016,2,21601105,3/28/2017,1610612751,Brooklyn Nets,1,0,1610612755,Philadelphia 76ers,0,1,29,33,62,9,23,32,38,56,94,16,8,24,16,44,22,7,13,103,101
2016,2,21601105,3/28/2017,1610612755,Philadelphia 76ers,0,1,1610612751,Brooklyn Nets,1,0,29,29,58,10,23,33,39,52,91,18,3,21,16,37,21,11,16,103,106
2016,2,21600549,1/6/2017,1610612747,Los Angeles Lakers,1,1,1610612748,Miami Heat,0,0,38,30,68,10,18,28,48,48,96,21,8,29,21,31,22,5,13,103,127
2016,2,21600549,1/6/2017,1610612748,Miami Heat,0,0,1610612747,Los Angeles Lakers,1,1,30,30,60,8,24,32,38,54,92,16,11,27,14,45,17,6,10,103,100
2014,2,21401206,4/13/2015,1610612741,Chicago Bulls,0,1,1610612751,Brooklyn Nets,1,0,32,26,58,12,18,30,44,44,88,13,4,17,15,31,26,2,9,92,113
2014,2,21401206,4/13/2015,1610612751,Brooklyn Nets,1,0,1610612741,Chicago Bulls,0,1,29,46,75,3,9,12,32,55,87,19,3,22,16,40,12,7,10,91,86
2014,2,21400757,2/6/2015,1610612748,Miami Heat,0,0,1610612759,San Antonio Spurs,1,1,31,33,64,5,11,16,36,44,80,8,1,9,13,31,23,12,17,90,85
2014,2,21400757,2/6/2015,1610612759,San Antonio Spurs,1,1,1610612748,Miami Heat,0,0,29,25,54,11,18,29,40,43,83,7,2,9,15,28,31,7,16,89,98
2018,2,21800763,1/30/2019,1610612757,Portland Trail Blazers,1,1,1610612762,Utah Jazz,0,0,32,26,58,16,16,32,48,42,90,20,3,23,14,30,28,9,15,102,132
2018,2,21800763,1/30/2019,1610612762,Utah Jazz,0,0,1610612757,Portland Trail Blazers,1,1,27,24,51,11,23,34,38,47,85,18,3,21,11,38,24,7,17,103,105
2018,2,21800378,12/8/2018,1610612742,Dallas Mavericks,1,1,1610612745,Houston Rockets,0,0,29,24,53,12,18,30,41,42,83,13,3,16,17,27,21,5,17,90,107
2018,2,21800378,12/8/2018,1610612745,Houston Rockets,0,0,1610612742,Dallas Mavericks,1,1,24,15,39,15,32,47,39,47,86,11,2,13,15,33,20,9,12,91,104
2018,2,21800259,11/21/2018,1610612749,Milwaukee Bucks,1,1,1610612757,Portland Trail Blazers,0,0,42,21,63,15,30,45,57,51,108,14,3,17,20,32,34,8,14,107,143
2018,2,21800259,11/21/2018,1610612757,Portland Trail Blazers,0,0,1610612749,Milwaukee Bucks,1,1,25,27,52,9,32,41,34,59,93,23,5,28,14,48,13,8,17,106,100
2018,2,21800205,11/14/2018,1610612748,Miami Heat,0,1,1610612751,Brooklyn Nets,1,0,38,18,56,8,21,29,46,39,85,20,8,28,9,35,23,10,18,108,120
2018,2,21800205,11/14/2018,1610612751,Brooklyn Nets,1,0,1610612748,Miami Heat,0,1,33,40,73,8,20,28,41,60,101,17,7,24,20,43,17,6,15,108,107
2017,2,21701047,3/18/2018,1610612738,Boston Celtics,0,0,1610612740,New Orleans Pelicans,1,1,26,35,61,9,17,26,35,52,87,10,10,20,11,44,17,9,13,99,89
2017,2,21701047,3/18/2018,1610612740,New Orleans Pelicans,1,1,1610612738,Boston Celtics,0,0,35,29,64,6,12,18,41,41,82,20,5,25,7,36,33,8,13,99,108
2017,2,21701041,3/17/2018,1610612737,Atlanta Hawks,0,0,1610612749,Milwaukee Bucks,1,1,27,22,49,12,24,36,39,46,85,25,1,26,11,35,23,12,19,105,115
2017,2,21701041,3/17/2018,1610612749,Milwaukee Bucks,1,1,1610612737,Atlanta Hawks,0,0,30,31,61,11,14,25,41,45,86,29,3,32,9,37,31,7,12,103,122
2017,2,21701037,3/17/2018,1610612742,Dallas Mavericks,0,0,1610612751,Brooklyn Nets,1,1,29,41,70,12,10,22,41,51,92,12,2,14,16,37,25,4,10,92,106
2017,2,21701037,3/17/2018,1610612751,Brooklyn Nets,1,1,1610612742,Dallas Mavericks,0,0,29,19,48,14,22,36,43,41,84,14,5,19,10,35,25,5,10,91,114
2016,2,21600111,11/9/2016,1610612737,Atlanta Hawks,1,1,1610612741,Chicago Bulls,0,0,33,30,63,9,11,20,42,41,83,22,5,27,18,24,24,14,23,101,115
2016,2,21600111,11/9/2016,1610612741,Chicago Bulls,0,0,1610612737,Atlanta Hawks,1,1,32,32,64,9,18,27,41,50,91,16,5,21,15,39,24,8,14,100,107
2018,2,21800990,3/9/2019,1610612749,Milwaukee Bucks,1,1,1610612766,Charlotte Hornets,0,0,27,19,46,17,27,44,44,46,90,26,4,30,15,33,27,4,13,102,131
2018,2,21800990,3/9/2019,1610612766,Charlotte Hornets,0,0,1610612749,Milwaukee Bucks,1,1,29,25,54,15,24,39,44,49,93,11,3,14,8,43,25,9,13,103,114
2018,2,21800206,11/14/2018,1610612761,Toronto Raptors,1,0,1610612765,Detroit Pistons,0,1,41,31,72,4,16,20,45,47,92,10,7,17,16,34,23,8,20,105,104
2018,2,21800206,11/14/2018,1610612765,Detroit Pistons,0,1,1610612761,Toronto Raptors,1,0,34,24,58,10,23,33,44,47,91,8,5,13,11,39,24,9,18,104,106
2017,2,21701164,4/3/2018,1610612742,Dallas Mavericks,1,1,1610612757,Portland Trail Blazers,0,0,25,23,48,17,27,44,42,50,92,14,6,20,8,43,27,6,7,101,115
2017,2,21701164,4/3/2018,1610612757,Portland Trail Blazers,0,0,1610612742,Dallas Mavericks,1,1,29,18,47,10,30,40,39,48,87,21,3,24,11,38,28,8,13,101,109
2017,2,21701109,3/27/2018,1610612743,Denver Nuggets,0,0,1610612761,Toronto Raptors,1,1,29,30,59,13,17,30,42,47,89,13,1,14,16,31,26,6,13,92,110
2017,2,21701109,3/27/2018,1610612761,Toronto Raptors,1,1,1610612743,Denver Nuggets,0,0,34,24,58,13,21,34,47,45,92,7,2,9,13,33,33,6,9,92,114
2017,2,21701078,3/23/2018,1610612746,LA Clippers,0,0,1610612754,Indiana Pacers,1,1,32,18,50,10,16,26,42,34,76,10,4,14,6,29,24,6,14,90,104
2017,2,21701078,3/23/2018,1610612754,Indiana Pacers,1,1,1610612746,LA Clippers,0,0,32,30,62,11,20,31,43,50,93,12,2,14,19,31,25,4,9,91,109
2017,2,21701056,3/19/2018,1610612744,Golden State Warriors,0,0,1610612759,San Antonio Spurs,1,1,27,28,55,3,16,19,30,44,74,12,4,16,5,40,17,6,15,91,75
2017,2,21701056,3/19/2018,1610612759,San Antonio Spurs,1,1,1610612744,Golden State Warriors,0,0,25,34,59,8,15,23,33,49,82,15,6,21,15,37,21,7,16,93,89
2016,2,21600548,1/6/2017,1610612749,Milwaukee Bucks,1,0,1610612752,New York Knicks,0,1,27,29,56,12,10,22,39,39,78,21,7,28,10,32,24,5,15,96,111
2016,2,21600548,1/6/2017,1610612752,New York Knicks,0,1,1610612749,Milwaukee Bucks,1,0,28,32,60,13,10,23,41,42,83,21,6,27,15,29,29,9,16,96,116
2018,2,21801138,3/30/2019,1610612745,Houston Rockets,1,1,1610612758,Sacramento Kings,0,0,22,9,31,17,35,52,39,44,83,24,3,27,10,36,19,3,10,95,119
2018,2,21801138,3/30/2019,1610612758,Sacramento Kings,0,0,1610612745,Houston Rockets,1,1,27,38,65,15,14,29,42,52,94,9,6,15,18,36,28,6,12,94,108
2014,2,21401205,4/13/2015,1610612737,Atlanta Hawks,1,0,1610612752,New York Knicks,0,1,28,28,56,11,21,32,39,49,88,19,4,23,14,36,27,7,8,93,108
2014,2,21401205,4/13/2015,1610612752,New York Knicks,0,1,1610612737,Atlanta Hawks,1,0,30,22,52,13,12,25,43,34,77,13,6,19,11,27,33,10,18,91,112
2018,2,21800861,2/13/2019,1610612745,Houston Rockets,0,0,1610612750,Minnesota Timberwolves,1,1,21,24,45,19,34,53,40,58,98,12,1,13,21,38,23,4,11,95,111
2018,2,21800861,2/13/2019,1610612750,Minnesota Timberwolves,1,1,1610612745,Houston Rockets,0,0,39,31,70,10,10,20,49,41,90,13,4,17,15,28,31,5,10,93,121
2014,2,21400756,2/6/2015,1610612756,Phoenix Suns,1,1,1610612762,Utah Jazz,0,0,24,33,57,14,13,27,38,46,84,10,4,14,10,38,20,8,12,93,100
2014,2,21400756,2/6/2015,1610612762,Utah Jazz,0,0,1610612756,Phoenix Suns,1,1,30,30,60,7,13,20,37,43,80,12,6,18,9,38,23,10,14,95,93
2018,2,21800603,1/8/2019,1610612750,Minnesota Timberwolves,0,1,1610612760,Oklahoma City Thunder,1,0,27,32,59,11,20,31,38,52,90,32,8,40,20,37,25,4,10,100,119
2018,2,21800603,1/8/2019,1610612760,Oklahoma City Thunder,1,0,1610612750,Minnesota Timberwolves,0,1,31,24,55,12,18,30,43,42,85,19,7,26,16,30,22,9,16,101,117
2018,2,21800522,12/28/2018,1610612737,Atlanta Hawks,0,1,1610612750,Minnesota Timberwolves,1,0,31,34,65,16,19,35,47,53,100,13,7,20,23,33,32,14,24,110,123
2018,2,21800522,12/28/2018,1610612750,Minnesota Timberwolves,1,0,1610612737,Atlanta Hawks,0,1,33,33,66,11,21,32,44,54,98,21,17,38,21,44,28,10,14,110,120
2018,2,21800377,12/7/2018,1610612744,Golden State Warriors,0,1,1610612749,Milwaukee Bucks,1,0,21,22,43,19,27,46,40,49,89,6,1,7,9,41,32,10,18,101,105
2018,2,21800377,12/7/2018,1610612749,Milwaukee Bucks,1,0,1610612744,Golden State Warriors,0,1,29,24,53,7,32,39,36,56,92,16,7,23,19,41,18,7,19,103,95
2018,2,21800258,11/21/2018,1610612745,Houston Rockets,1,1,1610612765,Detroit Pistons,0,0,27,12,39,13,20,33,40,32,72,33,3,36,7,25,18,8,15,101,126
2018,2,21800258,11/21/2018,1610612765,Detroit Pistons,0,0,1610612745,Houston Rockets,1,1,24,27,51,16,18,34,40,45,85,28,9,37,18,31,20,8,16,101,124
2018,2,21800101,10/30/2018,1610612745,Houston Rockets,1,0,1610612757,Portland Trail Blazers,0,1,21,32,53,10,33,43,31,65,96,13,10,23,23,48,18,4,12,97,85
2018,2,21800101,10/30/2018,1610612757,Portland Trail Blazers,0,1,1610612745,Houston Rockets,1,0,30,30,60,8,12,20,38,42,80,20,3,23,14,29,17,7,20,98,104
2016,2,21601104,3/28/2017,1610612750,Minnesota Timberwolves,0,1,1610612754,Indiana Pacers,1,0,28,30,58,9,11,20,37,41,78,32,5,37,15,27,22,8,14,95,115
2016,2,21601104,3/28/2017,1610612754,Indiana Pacers,1,0,1610612750,Minnesota Timberwolves,0,1,35,28,63,5,13,18,40,41,81,29,6,35,19,25,25,10,15,95,114
2014,2,21401203,4/13/2015,1610612739,Cleveland Cavaliers,1,1,1610612765,Detroit Pistons,0,0,26,27,53,17,15,32,43,42,85,6,6,12,17,26,30,4,12,86,109
2014,2,21401203,4/13/2015,1610612765,Detroit Pistons,0,0,1610612739,Cleveland Cavaliers,1,1,29,29,58,9,16,25,38,45,83,12,8,20,15,35,21,5,8,86,97
2016,2,21600110,11/9/2016,1610612754,Indiana Pacers,1,1,1610612755,Philadelphia 76ers,0,0,40,31,71,9,10,19,49,41,90,15,5,20,9,35,25,11,16,105,122
2016,2,21600110,11/9/2016,1610612755,Philadelphia 76ers,0,0,1610612754,Indiana Pacers,1,1,32,27,59,14,22,36,46,49,95,9,10,19,15,38,23,9,17,108,115
2014,2,21400755,2/6/2015,1610612740,New Orleans Pelicans,0,1,1610612760,Oklahoma City Thunder,1,0,29,34,63,11,9,20,40,43,83,25,5,30,11,33,26,11,18,103,116
2014,2,21400755,2/6/2015,1610612760,Oklahoma City Thunder,1,0,1610612740,New Orleans Pelicans,0,1,32,33,65,8,16,24,40,49,89,25,3,28,12,38,19,5,13,102,113
2018,2,21800989,3/9/2019,1610612738,Boston Celtics,0,1,1610612747,Los Angeles Lakers,1,0,34,21,55,14,24,38,48,45,93,10,4,14,12,35,32,4,13,100,120
2018,2,21800989,3/9/2019,1610612747,Los Angeles Lakers,1,0,1610612738,Boston Celtics,0,1,39,25,64,5,22,27,44,47,91,14,4,18,11,39,28,6,12,101,107
2018,2,21800447,12/17/2018,1610612741,Chicago Bulls,0,0,1610612760,Oklahoma City Thunder,1,1,30,33,63,8,14,22,38,47,85,12,4,16,15,33,20,14,25,103,96
2018,2,21800447,12/17/2018,1610612760,Oklahoma City Thunder,1,1,1610612741,Chicago Bulls,0,0,35,33,68,8,13,21,43,46,89,27,6,33,19,29,24,10,20,103,121
2018,2,21800315,11/28/2018,1610612746,LA Clippers,1,1,1610612756,Phoenix Suns,0,0,29,36,65,11,10,21,40,46,86,24,8,32,22,29,21,17,21,102,115
2018,2,21800315,11/28/2018,1610612756,Phoenix Suns,0,0,1610612746,LA Clippers,1,1,31,32,63,8,18,26,39,50,89,13,5,18,12,39,20,6,17,102,99
2018,2,21800102,10/30/2018,1610612763,Memphis Grizzlies,1,1,1610612764,Washington Wizards,0,0,23,23,46,13,15,28,36,38,74,22,9,31,12,32,28,9,17,95,107
2018,2,21800102,10/30/2018,1610612764,Washington Wizards,0,0,1610612763,Memphis Grizzlies,1,1,18,21,39,14,21,35,32,42,74,17,3,20,8,34,24,16,20,95,95
2017,2,21701186,4/6/2018,1610612748,Miami Heat,0,0,1610612752,New York Knicks,1,1,28,33,61,7,20,27,35,53,88,21,1,22,11,42,20,7,12,99,98
2017,2,21701186,4/6/2018,1610612752,New York Knicks,1,1,1610612748,Miami Heat,0,0,27,25,52,18,19,37,45,44,89,14,7,21,12,36,33,7,12,98,122
2017,2,21701165,4/3/2018,1610612743,Denver Nuggets,1,1,1610612754,Indiana Pacers,0,0,31,26,57,10,22,32,41,48,89,15,5,20,17,32,31,11,16,99,107
2017,2,21701165,4/3/2018,1610612754,Indiana Pacers,0,0,1610612743,Denver Nuggets,1,1,32,33,65,9,10,19,41,43,84,13,3,16,7,37,23,10,13,99,104
2017,2,21701125,3/29/2018,1610612741,Chicago Bulls,0,0,1610612748,Miami Heat,1,1,27,37,64,6,20,26,33,57,90,20,6,26,21,39,19,7,18,99,92
2017,2,21701125,3/29/2018,1610612748,Miami Heat,1,1,1610612741,Chicago Bulls,0,0,30,25,55,7,20,27,37,45,82,22,2,24,8,39,20,10,17,100,103
2017,2,21701093,3/24/2018,1610612742,Dallas Mavericks,1,0,1610612766,Charlotte Hornets,0,1,24,26,50,12,29,41,36,55,91,14,5,19,9,50,22,10,12,105,98
2017,2,21701093,3/24/2018,1610612766,Charlotte Hornets,0,1,1610612742,Dallas Mavericks,1,0,23,44,67,12,13,25,35,57,92,20,9,29,16,47,21,10,13,104,102
2017,2,21701055,3/19/2018,1610612741,Chicago Bulls,0,0,1610612752,New York Knicks,1,1,30,32,62,3,27,30,33,59,92,23,8,31,18,46,21,6,13,102,92
2017,2,21701055,3/19/2018,1610612752,New York Knicks,1,1,1610612741,Chicago Bulls,0,0,32,29,61,11,24,35,43,53,96,13,4,17,19,36,28,9,17,102,110
2017,2,21701033,3/16/2018,1610612744,Golden State Warriors,1,0,1610612758,Sacramento Kings,0,1,22,33,55,12,14,26,34,47,81,13,5,18,12,37,21,7,12,88,93
2017,2,21701033,3/16/2018,1610612758,Sacramento Kings,0,1,1610612744,Golden State Warriors,1,0,22,30,52,14,17,31,36,47,83,12,5,17,17,33,25,10,14,88,98
2017,2,21701031,3/16/2018,1610612742,Dallas Mavericks,0,0,1610612761,Toronto Raptors,1,1,42,27,69,6,16,22,48,43,91,13,5,18,9,36,25,5,12,103,115
2016,2,21601103,3/28/2017,1610612749,Milwaukee Bucks,0,1,1610612766,Charlotte Hornets,1,0,32,12,44,14,16,30,46,28,74,12,5,17,5,26,31,7,14,91,118
2016,2,21601103,3/28/2017,1610612766,Charlotte Hornets,1,0,1610612749,Milwaukee Bucks,0,1,32,20,52,7,21,28,39,41,80,23,6,29,6,40,25,1,4,90,108
2016,2,21600547,1/6/2017,1610612739,Cleveland Cavaliers,0,1,1610612751,Brooklyn Nets,1,0,29,26,55,9,24,33,38,50,88,31,12,43,12,44,19,6,12,110,116
2016,2,21600547,1/6/2017,1610612751,Brooklyn Nets,1,0,1610612739,Cleveland Cavaliers,0,1,32,29,61,9,21,30,41,50,91,17,2,19,10,42,21,14,19,109,108
2018,2,21801137,3/30/2019,1610612738,Boston Celtics,0,0,1610612751,Brooklyn Nets,1,1,27,36,63,8,12,20,35,48,83,18,5,23,10,40,19,7,15,99,96
2018,2,21801137,3/30/2019,1610612751,Brooklyn Nets,1,1,1610612738,Boston Celtics,0,0,26,19,45,12,26,38,38,45,83,22,6,28,13,33,22,8,14,101,110
2014,2,21401204,4/13/2015,1610612749,Milwaukee Bucks,0,1,1610612755,Philadelphia 76ers,1,0,36,36,72,4,5,9,40,41,81,23,13,36,15,32,23,11,20,102,107
2014,2,21401204,4/13/2015,1610612755,Philadelphia 76ers,1,0,1610612749,Milwaukee Bucks,0,1,26,27,53,6,22,28,32,49,81,27,7,34,23,30,22,13,30,102,97
2018,2,21800762,1/30/2019,1610612737,Atlanta Hawks,0,0,1610612758,Sacramento Kings,1,1,22,18,40,16,30,46,38,48,86,21,4,25,13,38,24,7,21,107,113
2018,2,21800762,1/30/2019,1610612758,Sacramento Kings,1,1,1610612737,Atlanta Hawks,0,0,43,21,64,11,24,35,54,45,99,16,5,21,17,30,36,7,14,107,135
2018,2,21800678,1/19/2019,1610612755,Philadelphia 76ers,1,0,1610612760,Oklahoma City Thunder,0,1,27,22,49,11,21,32,38,43,81,28,11,39,15,35,28,10,19,101,115
2018,2,21800678,1/19/2019,1610612760,Oklahoma City Thunder,0,1,1610612755,Philadelphia 76ers,1,0,29,33,62,12,19,31,41,52,93,23,3,26,14,39,20,6,10,101,117
2014,2,21400754,2/6/2015,1610612750,Minnesota Timberwolves,1,1,1610612763,Memphis Grizzlies,0,0,30,34,64,5,12,17,35,46,81,15,2,17,14,32,17,11,17,93,90
2014,2,21400754,2/6/2015,1610612763,Memphis Grizzlies,0,0,1610612750,Minnesota Timberwolves,1,1,34,23,57,2,10,12,36,33,69,15,5,20,4,33,19,8,18,93,89
2018,2,21800448,12/17/2018,1610612755,Philadelphia 76ers,0,0,1610612759,San Antonio Spurs,1,1,29,32,61,11,26,37,40,58,98,5,2,7,17,42,29,5,11,96,96
2018,2,21800448,12/17/2018,1610612759,San Antonio Spurs,1,1,1610612755,Philadelphia 76ers,0,0,40,24,64,9,14,23,49,38,87,16,1,17,7,31,28,3,7,95,123
2018,2,21800314,11/28/2018,1610612753,Orlando Magic,0,0,1610612757,Portland Trail Blazers,1,1,28,23,51,14,16,30,42,39,81,14,1,15,5,35,28,8,15,98,112
2018,2,21800314,11/28/2018,1610612757,Portland Trail Blazers,1,1,1610612753,Orlando Magic,0,0,18,28,46,19,20,39,37,48,85,22,10,32,16,36,24,3,12,97,115
2018,2,21800148,11/5/2018,1610612746,LA Clippers,1,1,1610612750,Minnesota Timberwolves,0,0,29,28,57,14,17,31,43,45,88,20,2,22,14,32,30,9,12,96,120
2018,2,21800148,11/5/2018,1610612750,Minnesota Timberwolves,0,0,1610612746,LA Clippers,1,1,35,29,64,5,16,21,40,45,85,24,6,30,13,34,20,5,11,97,109
2017,2,21701207,4/9/2018,1610612739,Cleveland Cavaliers,0,1,1610612752,New York Knicks,1,0,21,19,40,19,26,45,40,45,85,24,4,28,14,31,29,4,10,96,123
2017,2,21701207,4/9/2018,1610612752,New York Knicks,1,0,1610612739,Cleveland Cavaliers,0,1,35,22,57,11,19,30,46,41,87,6,6,12,9,35,26,9,15,96,109
2014,2,21400753,2/6/2015,1610612745,Houston Rockets,1,1,1610612749,Milwaukee Bucks,0,0,26,23,49,15,17,32,41,40,81,20,9,29,12,31,32,10,18,102,117
2014,2,21400753,2/6/2015,1610612749,Milwaukee Bucks,0,0,1610612745,Houston Rockets,1,1,44,34,78,4,13,17,48,47,95,11,4,15,15,34,29,11,14,102,111
2018,2,21800147,11/5/2018,1610612744,Golden State Warriors,1,1,1610612763,Memphis Grizzlies,0,0,28,29,57,13,11,24,41,40,81,22,1,23,11,29,29,8,13,93,117
2018,2,21800147,11/5/2018,1610612763,Memphis Grizzlies,0,0,1610612744,Golden State Warriors,1,1,29,27,56,9,18,27,38,45,83,16,5,21,8,39,31,4,10,94,101
2017,2,21701208,4/9/2018,1610612749,Milwaukee Bucks,1,1,1610612753,Orlando Magic,0,0,30,35,65,9,17,26,39,52,91,15,3,18,13,40,26,8,17,102,102
2017,2,21701208,4/9/2018,1610612753,Orlando Magic,0,0,1610612749,Milwaukee Bucks,1,1,29,29,58,5,19,24,34,48,82,13,7,20,9,44,24,13,20,102,86
2017,2,21701187,4/6/2018,1610612754,Indiana Pacers,0,0,1610612761,Toronto Raptors,1,1,19,47,66,7,14,21,26,61,87,14,6,20,15,48,16,9,13,95,73
2017,2,21701187,4/6/2018,1610612761,Toronto Raptors,1,1,1610612754,Indiana Pacers,0,0,27,27,54,9,21,30,36,48,84,11,5,16,20,32,27,8,23,96,92
2017,2,21701108,3/27/2018,1610612759,San Antonio Spurs,0,0,1610612764,Washington Wizards,1,1,29,33,62,10,15,25,39,48,87,18,15,33,14,41,29,5,8,98,106
2017,2,21701108,3/27/2018,1610612764,Washington Wizards,1,1,1610612759,San Antonio Spurs,0,0,36,25,61,10,14,24,46,39,85,14,4,18,13,29,33,7,16,97,116
2017,2,21701077,3/22/2018,1610612737,Atlanta Hawks,0,0,1610612758,Sacramento Kings,1,1,21,27,48,12,24,36,33,51,84,12,6,18,12,41,19,8,14,95,90
2016,2,21601102,3/27/2017,1610612740,New Orleans Pelicans,0,0,1610612762,Utah Jazz,1,1,27,28,55,10,15,25,37,43,80,16,8,24,6,41,17,6,9,92,100
2016,2,21601102,3/27/2017,1610612762,Utah Jazz,1,1,1610612740,New Orleans Pelicans,0,0,26,32,58,15,12,27,41,44,85,11,7,18,15,33,27,7,12,92,108
2018,2,21801136,3/30/2019,1610612739,Cleveland Cavaliers,0,0,1610612746,LA Clippers,1,1,38,31,69,3,20,23,41,51,92,23,5,28,19,36,18,5,13,99,108
2018,2,21801136,3/30/2019,1610612746,LA Clippers,1,1,1610612739,Cleveland Cavaliers,0,0,38,14,52,15,18,33,53,32,85,11,5,16,10,24,33,11,16,99,132
2018,2,21800988,3/9/2019,1610612750,Minnesota Timberwolves,1,1,1610612764,Washington Wizards,0,0,39,39,78,12,24,36,51,63,114,21,3,24,21,44,25,8,10,114,135
2018,2,21800988,3/9/2019,1610612764,Washington Wizards,0,0,1610612750,Minnesota Timberwolves,1,1,32,24,56,16,28,44,48,52,100,18,6,24,16,40,31,9,19,115,130
2018,2,21800860,2/13/2019,1610612743,Denver Nuggets,1,1,1610612758,Sacramento Kings,0,0,37,31,68,8,23,31,45,54,99,22,3,25,20,36,26,12,14,105,120
2018,2,21800860,2/13/2019,1610612758,Sacramento Kings,0,0,1610612743,Denver Nuggets,1,1,31,30,61,11,21,32,42,51,93,23,5,28,13,41,30,7,12,105,118
2016,2,21600546,1/6/2017,1610612738,Boston Celtics,1,1,1610612755,Philadelphia 76ers,0,0,16,31,47,19,21,40,35,52,87,21,4,25,17,37,28,9,18,100,110
2016,2,21600546,1/6/2017,1610612755,Philadelphia 76ers,0,0,1610612738,Boston Celtics,1,1,28,23,51,9,19,28,37,42,79,23,3,26,7,36,30,6,15,100,106
2016,2,21600109,11/9/2016,1610612750,Minnesota Timberwolves,0,1,1610612753,Orlando Magic,1,0,32,32,64,13,10,23,45,42,87,20,6,26,14,29,27,2,7,92,123
2016,2,21600109,11/9/2016,1610612753,Orlando Magic,1,0,1610612750,Minnesota Timberwolves,0,1,30,31,61,8,16,24,38,47,85,23,7,30,16,36,20,8,9,91,107
2018,2,21800602,1/8/2019,1610612737,Atlanta Hawks,0,0,1610612761,Toronto Raptors,1,1,30,30,60,10,17,27,40,47,87,11,5,16,17,34,22,18,27,103,101
2018,2,21800602,1/8/2019,1610612761,Toronto Raptors,1,1,1610612737,Atlanta Hawks,0,0,27,21,48,10,22,32,37,43,80,20,7,27,10,37,26,12,19,104,104
2018,2,21800521,12/28/2018,1610612739,Cleveland Cavaliers,0,0,1610612748,Miami Heat,1,1,18,26,44,13,24,37,31,50,81,19,3,22,14,37,21,8,15,94,94
2018,2,21800521,12/28/2018,1610612748,Miami Heat,1,1,1610612739,Cleveland Cavaliers,0,0,38,22,60,10,21,31,48,43,91,12,4,16,11,35,29,6,7,94,118
2018,2,21800376,12/7/2018,1610612748,Miami Heat,0,1,1610612756,Phoenix Suns,1,0,27,22,49,15,22,37,42,44,86,16,2,18,7,38,32,7,12,99,115
2018,2,21800376,12/7/2018,1610612756,Phoenix Suns,1,0,1610612748,Miami Heat,0,1,22,23,45,14,20,34,36,43,79,12,4,16,8,35,27,10,21,100,98
2018,2,21800257,11/21/2018,1610612741,Chicago Bulls,1,1,1610612756,Phoenix Suns,0,0,35,21,56,11,14,25,46,35,81,21,3,24,5,32,28,9,17,103,124
2018,2,21800257,11/21/2018,1610612756,Phoenix Suns,0,0,1610612741,Chicago Bulls,1,1,38,26,64,10,24,34,48,50,98,10,0,10,12,38,28,8,13,103,116
2018,2,21800149,11/6/2018,1610612737,Atlanta Hawks,0,0,1610612766,Charlotte Hornets,1,1,35,20,55,6,24,30,41,44,85,14,4,18,8,37,22,9,22,105,102
2018,2,21800149,11/6/2018,1610612766,Charlotte Hornets,1,1,1610612737,Atlanta Hawks,0,0,32,29,61,13,18,31,45,47,92,10,8,18,17,32,27,13,21,106,113
2014,2,21400752,2/6/2015,1610612746,LA Clippers,0,0,1610612761,Toronto Raptors,1,1,32,23,55,6,17,23,38,40,78,25,6,31,8,35,21,7,8,93,107
2014,2,21400752,2/6/2015,1610612761,Toronto Raptors,1,1,1610612746,LA Clippers,0,0,27,18,45,13,17,30,40,35,75,30,7,37,15,23,25,8,14,93,123
2018,2,21800761,1/30/2019,1610612740,New Orleans Pelicans,1,0,1610612743,Denver Nuggets,0,1,22,31,53,15,21,36,37,52,89,10,3,13,13,40,27,10,15,97,99
2018,2,21800761,1/30/2019,1610612743,Denver Nuggets,0,1,1610612740,New Orleans Pelicans,1,0,33,26,59,9,21,30,42,47,89,12,7,19,9,42,31,4,10,98,105
2018,2,21800313,11/28/2018,1610612739,Cleveland Cavaliers,0,0,1610612760,Oklahoma City Thunder,1,1,26,40,66,9,14,23,35,54,89,4,5,9,12,45,20,5,14,97,83
2018,2,21800313,11/28/2018,1610612760,Oklahoma City Thunder,1,1,1610612739,Cleveland Cavaliers,0,0,35,24,59,6,21,27,41,45,86,12,3,15,10,37,25,4,13,95,100
2018,2,21800204,11/14/2018,1610612738,Boston Celtics,1,1,1610612741,Chicago Bulls,0,0,27,29,56,15,19,34,42,48,90,12,2,14,8,40,27,8,14,102,111
2018,2,21800204,11/14/2018,1610612741,Chicago Bulls,0,0,1610612738,Boston Celtics,1,1,26,35,61,7,16,23,33,51,84,9,0,9,8,43,16,12,22,103,82
2022,2,22200467,12/21/2022,1610612755,Philadelphia 76ers,1,1,1610612765,Detroit Pistons,0,0,30,26,56,11,26,37,41,52,93,20,2,22,14,38,27,6,12,102,113
2022,2,22200467,12/21/2022,1610612765,Detroit Pistons,0,0,1610612755,Philadelphia 76ers,1,1,25,31,56,6,17,23,31,48,79,25,9,34,16,37,15,8,22,102,93
2017,2,21701230,4/11/2018,1610612745,Houston Rockets,0,0,1610612758,Sacramento Kings,1,1,18,18,36,13,33,46,31,51,82,8,4,12,11,42,11,6,14,90,83
2017,2,21701230,4/11/2018,1610612758,Sacramento Kings,1,1,1610612745,Houston Rockets,0,0,31,23,54,7,19,26,38,42,80,13,7,20,10,34,22,2,11,90,96
2017,2,21701142,3/31/2018,1610612744,Golden State Warriors,0,1,1610612758,Sacramento Kings,1,0,32,25,57,9,17,26,41,42,83,21,7,28,10,37,28,5,11,97,112
2017,2,21701142,3/31/2018,1610612758,Sacramento Kings,1,0,1610612744,Golden State Warriors,0,1,28,31,59,8,20,28,36,51,87,16,3,19,15,37,27,9,16,96,96
2017,2,21701077,3/22/2018,1610612758,Sacramento Kings,1,1,1610612737,Atlanta Hawks,0,0,33,39,72,10,11,21,43,50,93,9,0,9,15,35,28,7,14,96,105
2017,2,21701066,3/21/2018,1610612755,Philadelphia 76ers,1,1,1610612763,Memphis Grizzlies,0,0,35,18,53,11,20,31,46,38,84,16,4,20,5,36,32,6,14,100,119
2017,2,21701066,3/21/2018,1610612763,Memphis Grizzlies,0,0,1610612755,Philadelphia 76ers,1,1,31,41,72,9,18,27,40,59,99,16,4,20,22,38,25,8,13,101,105
2017,2,21701031,3/16/2018,1610612761,Toronto Raptors,1,1,1610612742,Dallas Mavericks,0,0,33,28,61,10,20,30,43,48,91,26,5,31,17,33,26,7,14,103,122
2017,2,21701030,3/16/2018,1610612751,Brooklyn Nets,0,0,1610612755,Philadelphia 76ers,1,1,25,34,59,15,15,30,40,49,89,21,6,27,18,33,25,9,12,96,116
2017,2,21701030,3/16/2018,1610612755,Philadelphia 76ers,1,1,1610612751,Brooklyn Nets,0,0,31,37,68,12,15,27,43,52,95,22,4,26,16,38,30,4,5,96,120
2017,2,21701029,3/16/2018,1610612753,Orlando Magic,1,0,1610612738,Boston Celtics,0,1,29,30,59,5,23,28,34,53,87,10,1,11,11,42,14,7,15,96,83
2017,2,21701028,3/15/2018,1610612739,Cleveland Cavaliers,0,0,1610612757,Portland Trail Blazers,1,1,30,17,47,11,22,33,41,39,80,12,9,21,4,39,17,4,11,96,105
2017,2,21701028,3/15/2018,1610612757,Portland Trail Blazers,1,1,1610612739,Cleveland Cavaliers,0,0,31,30,61,12,23,35,43,53,96,15,4,19,17,38,26,5,7,95,113
2016,2,21600545,1/6/2017,1610612745,Houston Rockets,0,1,1610612753,Orlando Magic,1,0,24,13,37,15,34,49,39,47,86,7,5,12,18,32,26,8,16,89,100
2016,2,21600545,1/6/2017,1610612753,Orlando Magic,1,0,1610612745,Houston Rockets,0,1,30,38,68,8,15,23,38,53,91,9,4,13,21,35,18,12,15,89,93
2014,2,21400751,2/6/2015,1610612743,Denver Nuggets,0,0,1610612765,Detroit Pistons,1,1,28,35,63,5,17,22,33,52,85,17,5,22,12,43,22,4,13,98,88
2014,2,21400751,2/6/2015,1610612765,Detroit Pistons,1,1,1610612743,Denver Nuggets,0,0,33,25,58,4,20,24,37,45,82,20,6,26,14,33,23,7,17,97,98
2018,2,21801135,3/29/2019,1610612747,Los Angeles Lakers,1,1,1610612766,Charlotte Hornets,0,0,33,20,53,18,20,38,51,40,91,9,3,12,13,30,34,8,14,96,129
2018,2,21801135,3/29/2019,1610612766,Charlotte Hornets,0,0,1610612747,Los Angeles Lakers,1,1,27,22,49,15,24,39,42,46,88,16,1,17,12,34,26,8,13,97,115
2018,2,21800859,2/13/2019,1610612742,Dallas Mavericks,1,0,1610612748,Miami Heat,0,1,19,17,36,15,37,52,34,54,88,18,4,22,15,41,24,7,12,96,101
2018,2,21800859,2/13/2019,1610612748,Miami Heat,0,1,1610612742,Dallas Mavericks,1,0,32,19,51,12,18,30,44,37,81,12,4,16,10,30,24,10,19,96,112
2018,2,21800520,12/28/2018,1610612741,Chicago Bulls,0,1,1610612764,Washington Wizards,1,0,29,28,57,8,14,22,37,42,79,19,6,25,8,36,20,7,10,93,101
2018,2,21800520,12/28/2018,1610612764,Washington Wizards,1,0,1610612741,Chicago Bulls,0,1,25,30,55,9,21,30,34,51,85,15,3,18,13,40,22,9,13,93,92
2017,2,21701209,4/9/2018,1610612750,Minnesota Timberwolves,1,1,1610612763,Memphis Grizzlies,0,0,35,30,65,7,15,22,42,45,87,22,4,26,22,25,27,11,18,97,113
2017,2,21701209,4/9/2018,1610612763,Memphis Grizzlies,0,0,1610612750,Minnesota Timberwolves,1,1,30,37,67,5,13,18,35,50,85,19,2,21,16,36,20,10,17,97,94
2017,2,21701143,4/1/2018,1610612755,Philadelphia 76ers,0,1,1610612766,Charlotte Hornets,1,0,34,28,62,14,18,32,48,46,94,9,1,10,13,33,36,8,14,101,119
2017,2,21701143,4/1/2018,1610612766,Charlotte Hornets,1,0,1610612755,Philadelphia 76ers,0,1,24,28,52,9,21,30,33,49,82,27,7,34,13,40,17,15,16,101,102
2017,2,21701107,3/26/2018,1610612738,Boston Celtics,0,1,1610612756,Phoenix Suns,1,0,23,35,58,14,15,29,37,50,87,14,0,14,13,37,24,8,12,92,102
2017,2,21701107,3/26/2018,1610612756,Phoenix Suns,1,0,1610612738,Boston Celtics,0,1,24,22,46,12,23,35,36,45,81,10,9,19,14,36,18,10,17,92,94
2017,2,21701092,3/24/2018,1610612747,Los Angeles Lakers,0,1,1610612763,Memphis Grizzlies,1,0,22,26,48,13,25,38,35,51,86,17,8,25,18,35,19,7,12,91,100
2017,2,21701092,3/24/2018,1610612763,Memphis Grizzlies,1,0,1610612747,Los Angeles Lakers,0,1,30,25,55,5,24,29,35,49,84,18,4,22,14,35,20,7,11,92,93
2016,2,21601101,3/27/2017,1610612758,Sacramento Kings,1,1,1610612763,Memphis Grizzlies,0,0,25,17,42,6,19,25,31,36,67,23,7,30,10,30,16,4,12,83,91
2016,2,21601101,3/27/2017,1610612763,Memphis Grizzlies,0,0,1610612758,Sacramento Kings,1,1,26,38,64,5,21,26,31,59,90,23,6,29,29,32,15,4,8,84,90
2016,2,21600108,11/9/2016,1610612762,Utah Jazz,0,0,1610612766,Charlotte Hornets,1,1,30,18,48,8,26,34,38,44,82,14,4,18,11,34,24,8,14,93,98
2016,2,21600108,11/9/2016,1610612766,Charlotte Hornets,1,1,1610612762,Utah Jazz,0,0,30,26,56,8,18,26,38,44,82,20,9,29,12,37,24,5,9,93,104
2018,2,21800987,3/9/2019,1610612737,Atlanta Hawks,1,0,1610612751,Brooklyn Nets,0,1,31,33,64,8,33,41,39,66,105,26,6,32,22,47,22,7,10,109,112
2018,2,21800987,3/9/2019,1610612751,Brooklyn Nets,0,1,1610612737,Atlanta Hawks,1,0,18,24,42,15,29,44,33,53,86,33,21,54,20,43,21,7,14,109,114
2014,2,21400750,2/6/2015,1610612738,Boston Celtics,1,1,1610612755,Philadelphia 76ers,0,0,29,30,59,10,17,27,39,47,86,19,6,25,13,36,27,6,10,97,107
2014,2,21400750,2/6/2015,1610612755,Philadelphia 76ers,0,0,1610612738,Boston Celtics,1,1,24,30,54,11,14,25,35,44,79,15,16,31,12,42,22,8,17,97,96
2018,2,21800677,1/18/2019,1610612740,New Orleans Pelicans,0,0,1610612757,Portland Trail Blazers,1,1,33,26,59,8,17,25,41,43,84,22,5,27,10,35,23,8,12,101,112
2018,2,21800677,1/18/2019,1610612757,Portland Trail Blazers,1,1,1610612740,New Orleans Pelicans,0,0,37,32,69,11,23,34,48,55,103,21,5,26,21,37,30,4,7,101,128
2018,2,21800375,12/7/2018,1610612747,Los Angeles Lakers,0,0,1610612759,San Antonio Spurs,1,1,35,29,64,11,25,36,46,54,100,17,4,21,12,44,24,4,9,105,120
2018,2,21800375,12/7/2018,1610612759,San Antonio Spurs,1,1,1610612747,Los Angeles Lakers,0,0,33,27,60,13,18,31,46,45,91,28,5,33,9,38,27,8,10,105,133
2017,2,21701144,4/1/2018,1610612741,Chicago Bulls,1,1,1610612764,Washington Wizards,0,0,25,23,48,18,16,34,43,39,82,9,4,13,10,31,30,5,17,95,113
2017,2,21701144,4/1/2018,1610612764,Washington Wizards,0,0,1610612741,Chicago Bulls,1,1,29,22,51,8,22,30,37,44,81,12,0,12,8,36,27,7,17,95,94
2017,2,21701124,3/29/2018,1610612764,Washington Wizards,0,0,1610612765,Detroit Pistons,1,1,31,26,57,6,26,32,37,52,89,12,3,15,14,38,28,9,15,97,92
2017,2,21701124,3/29/2018,1610612765,Detroit Pistons,1,1,1610612764,Washington Wizards,0,0,35,28,63,6,15,21,41,43,84,15,5,20,15,33,26,9,18,97,103
2017,2,21701036,3/17/2018,1610612740,New Orleans Pelicans,1,0,1610612745,Houston Rockets,0,1,33,26,59,8,16,24,41,42,83,11,1,12,9,34,18,8,12,90,101
2017,2,21701036,3/17/2018,1610612745,Houston Rockets,0,1,1610612740,New Orleans Pelicans,1,0,24,28,52,15,26,41,39,54,93,14,4,18,18,37,19,4,8,91,107
2017,2,21701032,3/16/2018,1610612746,LA Clippers,0,0,1610612760,Oklahoma City Thunder,1,1,31,29,60,11,15,26,42,44,86,18,5,23,18,29,21,17,23,102,113
2014,2,21401202,4/13/2015,1610612745,Houston Rockets,0,1,1610612766,Charlotte Hornets,1,0,26,24,50,9,26,35,35,50,85,21,5,26,15,37,19,8,12,95,100
2014,2,21401202,4/13/2015,1610612766,Charlotte Hornets,1,0,1610612745,Houston Rockets,0,1,21,30,51,13,19,32,34,49,83,9,8,17,11,41,23,9,15,96,90
2016,2,21600544,1/6/2017,1610612750,Minnesota Timberwolves,0,0,1610612764,Washington Wizards,1,1,35,35,70,7,11,18,42,46,88,14,3,17,16,31,22,3,10,89,105
2016,2,21600544,1/6/2017,1610612764,Washington Wizards,1,1,1610612750,Minnesota Timberwolves,0,0,34,23,57,12,10,22,46,33,79,8,1,9,7,26,31,6,13,90,112
2014,2,21400749,2/6/2015,1610612737,Atlanta Hawks,1,1,1610612744,Golden State Warriors,0,0,23,27,50,15,12,27,38,39,77,33,4,37,8,34,28,7,13,101,124
2014,2,21400749,2/6/2015,1610612744,Golden State Warriors,0,0,1610612737,Atlanta Hawks,1,1,35,35,70,12,21,33,47,56,103,10,5,15,23,36,31,13,14,101,116
2018,2,21800676,1/18/2019,1610612744,Golden State Warriors,0,1,1610612746,LA Clippers,1,0,33,16,49,9,28,37,42,44,86,19,8,27,4,44,31,6,10,103,112
2018,2,21800676,1/18/2019,1610612746,LA Clippers,1,0,1610612744,Golden State Warriors,0,1,27,33,60,4,21,25,31,54,85,28,7,35,15,42,11,11,18,105,94
2018,2,21800601,1/8/2019,1610612743,Denver Nuggets,0,1,1610612748,Miami Heat,1,0,32,28,60,9,18,27,41,46,87,12,5,17,19,30,32,9,16,92,103
2018,2,21800601,1/8/2019,1610612748,Miami Heat,1,0,1610612743,Denver Nuggets,0,1,30,22,52,8,23,31,38,45,83,15,10,25,9,40,24,2,6,91,99
2018,2,21800445,12/17/2018,1610612745,Houston Rockets,1,1,1610612762,Utah Jazz,0,0,20,29,49,12,25,37,32,54,86,26,5,31,13,43,16,9,17,105,102
2018,2,21800445,12/17/2018,1610612762,Utah Jazz,0,0,1610612745,Houston Rockets,1,1,22,25,47,10,25,35,32,50,82,23,8,31,17,35,23,13,24,104,97
2018,2,21800203,11/14/2018,1610612739,Cleveland Cavaliers,0,0,1610612764,Washington Wizards,1,1,31,25,56,4,17,21,35,42,77,21,10,31,13,33,22,17,24,103,95
2018,2,21800203,11/14/2018,1610612764,Washington Wizards,1,1,1610612739,Cleveland Cavaliers,0,0,31,21,52,13,27,40,44,48,92,18,8,26,18,35,30,12,18,103,119
2017,2,21701184,4/6/2018,1610612737,Atlanta Hawks,0,1,1610612764,Washington Wizards,1,0,27,19,46,11,22,33,38,41,79,16,7,23,8,36,24,8,18,99,103
2017,2,21701184,4/6/2018,1610612764,Washington Wizards,1,0,1610612737,Atlanta Hawks,0,1,26,36,62,9,16,25,35,52,87,18,5,23,10,44,18,5,12,99,97
2017,2,21701091,3/24/2018,1610612740,New Orleans Pelicans,0,0,1610612745,Houston Rockets,1,1,32,43,75,6,15,21,38,58,96,9,3,12,15,44,19,10,16,103,91
2017,2,21701091,3/24/2018,1610612745,Houston Rockets,1,1,1610612740,New Orleans Pelicans,0,0,27,19,46,18,29,47,45,48,93,6,2,8,14,36,22,10,22,104,114
2017,2,21701065,3/21/2018,1610612739,Cleveland Cavaliers,1,1,1610612761,Toronto Raptors,0,0,32,22,54,15,9,24,47,31,78,23,5,28,8,24,28,4,10,93,132
2016,2,21601100,3/27/2017,1610612742,Dallas Mavericks,1,0,1610612760,Oklahoma City Thunder,0,1,23,28,51,10,19,29,33,47,80,15,4,19,12,37,23,10,15,92,91
2016,2,21601100,3/27/2017,1610612760,Oklahoma City Thunder,0,1,1610612742,Dallas Mavericks,1,0,31,31,62,6,17,23,37,48,85,12,2,14,17,31,17,12,18,91,92
2018,2,21800986,3/9/2019,1610612752,New York Knicks,1,0,1610612758,Sacramento Kings,0,1,25,34,59,10,25,35,35,59,94,14,7,21,17,44,16,5,10,98,94
2018,2,21800986,3/9/2019,1610612758,Sacramento Kings,0,1,1610612752,New York Knicks,1,0,24,35,59,12,24,36,36,59,95,18,4,22,15,48,16,3,7,97,102
2018,2,21800858,2/13/2019,1610612741,Chicago Bulls,1,1,1610612763,Memphis Grizzlies,0,0,37,23,60,8,12,20,45,35,80,24,5,29,10,26,28,9,14,97,122
2018,2,21800858,2/13/2019,1610612763,Memphis Grizzlies,0,0,1610612741,Chicago Bulls,1,1,32,26,58,11,20,31,43,46,89,13,4,17,9,39,33,2,9,98,110
2018,2,21800760,1/30/2019,1610612750,Minnesota Timberwolves,1,1,1610612763,Memphis Grizzlies,0,0,29,31,60,8,27,35,37,58,95,17,5,22,20,40,25,3,13,97,99
2018,2,21800760,1/30/2019,1610612763,Memphis Grizzlies,0,0,1610612750,Minnesota Timberwolves,1,1,30,34,64,6,17,23,36,51,87,19,3,22,20,31,21,12,18,95,97
2015,2,21501123,3/31/2016,1610612753,Orlando Magic,0,1,1610612754,Indiana Pacers,1,0,43,31,74,5,11,16,48,42,90,13,5,18,14,33,26,11,13,98,114
2015,2,21501123,3/31/2016,1610612754,Indiana Pacers,1,0,1610612753,Orlando Magic,0,1,29,38,67,7,12,19,36,50,86,15,6,21,19,33,18,6,19,97,94
2015,2,21501069,3/24/2016,1610612739,Cleveland Cavaliers,0,0,1610612751,Brooklyn Nets,1,1,29,22,51,10,28,38,39,50,89,7,2,9,14,38,22,10,15,94,95
2015,2,21501069,3/24/2016,1610612751,Brooklyn Nets,1,1,1610612739,Cleveland Cavaliers,0,0,33,34,67,8,14,22,41,48,89,14,5,19,14,36,28,3,9,95,104
2018,2,21800600,1/8/2019,1610612755,Philadelphia 76ers,1,1,1610612764,Washington Wizards,0,0,32,23,55,17,16,33,49,39,88,17,8,25,14,30,39,14,20,105,132
2018,2,21800600,1/8/2019,1610612764,Washington Wizards,0,0,1610612755,Philadelphia 76ers,1,1,28,24,52,14,18,32,42,42,84,17,4,21,7,36,26,10,17,105,115
2018,2,21800519,12/28/2018,1610612753,Orlando Magic,1,1,1610612761,Toronto Raptors,0,0,35,32,67,9,17,26,44,49,93,19,3,22,19,32,29,4,15,98,116
2018,2,21800519,12/28/2018,1610612761,Toronto Raptors,0,0,1610612753,Orlando Magic,1,1,16,45,61,12,22,34,28,67,95,19,5,24,19,49,18,3,11,98,87
2018,2,21800446,12/17/2018,1610612750,Minnesota Timberwolves,1,1,1610612758,Sacramento Kings,0,0,38,31,69,10,17,27,48,48,96,26,4,30,15,33,37,5,11,108,132
2018,2,21800446,12/17/2018,1610612758,Sacramento Kings,0,0,1610612750,Minnesota Timberwolves,1,1,24,28,52,14,24,38,38,52,90,15,8,23,8,49,20,10,15,107,105
2018,2,21800256,11/21/2018,1610612739,Cleveland Cavaliers,1,0,1610612747,Los Angeles Lakers,0,1,26,42,68,13,21,34,39,63,102,14,1,15,17,47,18,2,3,93,105
2018,2,21800256,11/21/2018,1610612747,Los Angeles Lakers,0,1,1610612739,Cleveland Cavaliers,1,0,31,22,53,9,16,25,40,38,78,20,8,28,11,31,23,3,15,94,109
2018,2,21800145,11/5/2018,1610612738,Boston Celtics,0,0,1610612743,Denver Nuggets,1,1,35,21,56,9,22,31,44,43,87,10,2,12,9,36,22,5,12,95,107
2018,2,21800145,11/5/2018,1610612743,Denver Nuggets,1,1,1610612738,Boston Celtics,0,0,28,28,56,13,21,34,41,49,90,20,8,28,20,34,25,9,13,97,115
2018,2,21800099,10/30/2018,1610612738,Boston Celtics,1,1,1610612765,Detroit Pistons,0,0,28,25,53,9,22,31,37,47,84,25,7,32,12,40,25,6,14,105,108
2018,2,21800099,10/30/2018,1610612765,Detroit Pistons,0,0,1610612738,Boston Celtics,1,1,29,29,58,8,22,30,37,51,88,23,4,27,13,41,17,8,17,104,105
2022,2,22200468,12/21/2022,1610612737,Atlanta Hawks,1,0,1610612741,Chicago Bulls,0,1,25,29,54,14,23,37,39,52,91,16,0,16,13,39,22,9,15,100,108
2022,2,22200468,12/21/2022,1610612741,Chicago Bulls,0,1,1610612737,Atlanta Hawks,1,0,36,26,62,7,17,24,43,43,86,17,5,22,8,38,20,6,11,100,110
2016,2,21600543,1/5/2017,1610612743,Denver Nuggets,1,0,1610612759,San Antonio Spurs,0,1,32,29,61,7,18,25,39,47,86,14,3,17,12,37,25,5,13,94,99
2016,2,21600543,1/5/2017,1610612759,San Antonio Spurs,0,1,1610612743,Denver Nuggets,1,0,39,27,66,12,12,24,51,39,90,13,4,17,11,30,34,7,8,95,127
2014,2,21401201,4/12/2015,1610612742,Dallas Mavericks,0,1,1610612747,Los Angeles Lakers,1,0,35,27,62,10,11,21,45,38,83,20,6,26,9,32,31,4,12,97,120
2014,2,21401201,4/12/2015,1610612747,Los Angeles Lakers,1,0,1610612742,Dallas Mavericks,0,1,25,29,54,9,15,24,34,44,78,29,7,36,11,36,20,7,15,98,106
2014,2,21400748,2/6/2015,1610612747,Los Angeles Lakers,0,0,1610612753,Orlando Magic,1,1,28,43,71,11,15,26,39,58,97,8,5,13,20,40,27,9,15,98,97
2014,2,21400748,2/6/2015,1610612753,Orlando Magic,1,1,1610612747,Los Angeles Lakers,0,0,38,30,68,5,10,15,43,40,83,12,2,14,11,30,26,12,19,97,103
2018,2,21801134,3/29/2019,1610612762,Utah Jazz,1,1,1610612764,Washington Wizards,0,0,34,21,55,14,18,32,48,39,87,18,0,18,8,31,26,11,18,104,128
2018,2,21801134,3/29/2019,1610612764,Washington Wizards,0,0,1610612762,Utah Jazz,1,1,33,28,61,15,22,37,48,50,98,13,9,22,15,39,32,7,13,104,124
2018,2,21800202,11/14/2018,1610612753,Orlando Magic,1,1,1610612755,Philadelphia 76ers,0,0,28,24,52,12,16,28,40,40,80,19,3,22,7,35,23,2,11,96,111
2018,2,21800202,11/14/2018,1610612755,Philadelphia 76ers,0,0,1610612753,Orlando Magic,1,1,27,30,57,14,15,29,41,45,86,10,5,15,12,35,32,7,15,97,106
2018,2,21800146,11/5/2018,1610612761,Toronto Raptors,0,1,1610612762,Utah Jazz,1,0,36,17,53,13,20,33,49,37,86,13,1,14,8,30,21,10,15,99,124
2018,2,21800146,11/5/2018,1610612762,Utah Jazz,1,0,1610612761,Toronto Raptors,0,1,30,25,55,8,23,31,38,48,86,27,14,41,17,36,29,9,12,98,111
2017,2,21701162,4/3/2018,1610612738,Boston Celtics,0,0,1610612749,Milwaukee Bucks,1,1,31,27,58,7,16,23,38,43,81,19,5,24,12,33,19,6,17,95,102
2017,2,21701162,4/3/2018,1610612749,Milwaukee Bucks,1,1,1610612738,Boston Celtics,0,0,38,21,59,5,15,20,43,36,79,15,6,21,10,27,27,10,15,95,106
2017,2,21701123,3/28/2018,1610612742,Dallas Mavericks,0,0,1610612747,Los Angeles Lakers,1,1,20,20,40,13,31,44,33,51,84,14,5,19,8,45,17,6,11,98,93
2017,2,21701123,3/28/2018,1610612747,Los Angeles Lakers,1,1,1610612742,Dallas Mavericks,0,0,27,17,44,9,24,33,36,41,77,22,10,32,10,36,25,10,15,98,103
2017,2,21701106,3/26/2018,1610612750,Minnesota Timberwolves,1,0,1610612763,Memphis Grizzlies,0,1,25,30,55,8,16,24,33,46,79,19,5,24,16,33,21,8,16,89,93
2017,2,21701106,3/26/2018,1610612763,Memphis Grizzlies,0,1,1610612750,Minnesota Timberwolves,1,0,25,28,53,15,16,31,40,44,84,6,3,9,14,31,25,7,14,89,101
2017,2,21701065,3/21/2018,1610612761,Toronto Raptors,0,0,1610612739,Cleveland Cavaliers,1,1,32,22,54,15,19,34,47,41,88,20,3,23,14,30,32,3,7,95,129
2017,2,21701046,3/18/2018,1610612760,Oklahoma City Thunder,0,1,1610612761,Toronto Raptors,1,0,39,28,67,10,11,21,49,39,88,24,10,34,20,23,27,5,18,102,132
2017,2,21701046,3/18/2018,1610612761,Toronto Raptors,1,0,1610612760,Oklahoma City Thunder,0,1,31,20,51,15,15,30,46,35,81,18,5,23,10,27,31,11,19,100,125
2017,2,21701040,3/17/2018,1610612743,Denver Nuggets,0,0,1610612763,Memphis Grizzlies,1,1,23,31,54,9,24,33,32,55,87,21,8,29,21,38,17,5,10,90,94
2017,2,21701040,3/17/2018,1610612763,Memphis Grizzlies,1,1,1610612743,Denver Nuggets,0,0,20,29,49,13,19,32,33,48,81,22,6,28,18,32,21,10,11,89,101
2016,2,21600542,1/5/2017,1610612747,Los Angeles Lakers,0,0,1610612757,Portland Trail Blazers,1,1,26,29,55,10,21,31,36,50,86,27,6,33,13,40,15,6,11,100,109
2016,2,21600542,1/5/2017,1610612757,Portland Trail Blazers,1,1,1610612747,Los Angeles Lakers,0,0,31,17,48,12,21,33,43,38,81,20,10,30,11,31,29,7,13,100,118
2014,2,21400747,2/6/2015,1610612739,Cleveland Cavaliers,0,0,1610612754,Indiana Pacers,1,1,29,25,54,11,24,35,40,49,89,8,4,12,19,32,18,9,15,91,99
2014,2,21400747,2/6/2015,1610612754,Indiana Pacers,1,1,1610612739,Cleveland Cavaliers,0,0,29,29,58,8,13,21,37,42,79,21,5,26,10,33,26,6,8,90,103
2018,2,21800985,3/8/2019,1610612746,LA Clippers,1,1,1610612760,Oklahoma City Thunder,0,0,30,31,61,9,16,25,39,47,86,31,15,46,14,41,20,3,10,103,118
2018,2,21800985,3/8/2019,1610612760,Oklahoma City Thunder,0,0,1610612746,LA Clippers,1,1,30,28,58,11,33,44,41,61,102,17,9,26,20,46,20,7,11,105,110
2018,2,21800312,11/28/2018,1610612740,New Orleans Pelicans,1,1,1610612764,Washington Wizards,0,0,35,24,59,11,25,36,46,49,95,22,6,28,23,28,24,12,20,105,125
2018,2,21800312,11/28/2018,1610612764,Washington Wizards,0,0,1610612740,New Orleans Pelicans,1,1,28,28,56,13,26,39,41,54,95,9,7,16,12,48,26,10,16,105,104
2017,2,21701185,4/6/2018,1610612738,Boston Celtics,1,1,1610612741,Chicago Bulls,0,0,31,16,47,14,20,34,45,36,81,7,10,17,6,35,35,15,18,100,111
2017,2,21701185,4/6/2018,1610612741,Chicago Bulls,0,0,1610612738,Boston Celtics,1,1,26,30,56,14,16,30,40,46,86,10,7,17,9,42,25,9,17,101,104
2017,2,21701163,4/3/2018,1610612744,Golden State Warriors,0,1,1610612760,Oklahoma City Thunder,1,0,33,21,54,8,21,29,41,42,83,21,3,24,7,36,27,8,13,101,111
2017,2,21701163,4/3/2018,1610612760,Oklahoma City Thunder,1,0,1610612744,Golden State Warriors,0,1,26,29,55,9,29,38,35,58,93,28,9,37,26,36,13,9,16,102,107
2017,2,21701076,3/22/2018,1610612742,Dallas Mavericks,1,0,1610612762,Utah Jazz,0,1,25,28,53,17,15,32,42,43,85,11,3,14,12,33,22,11,15,95,112
2017,2,21701076,3/22/2018,1610612762,Utah Jazz,0,1,1610612742,Dallas Mavericks,1,0,34,24,58,12,17,29,46,41,87,15,1,16,10,32,32,5,11,94,119
2017,2,21701054,3/19/2018,1610612743,Denver Nuggets,0,0,1610612748,Miami Heat,1,1,28,34,62,18,20,38,46,54,100,31,6,37,16,41,23,5,14,116,141
2017,2,21701054,3/19/2018,1610612748,Miami Heat,1,1,1610612743,Denver Nuggets,0,0,36,30,66,20,16,36,56,46,102,17,10,27,13,38,36,10,11,115,149
2017,2,21701045,3/17/2018,1610612757,Portland Trail Blazers,1,1,1610612765,Detroit Pistons,0,0,30,26,56,8,23,31,38,49,87,16,2,18,14,36,23,6,11,93,100
2017,2,21701045,3/17/2018,1610612765,Detroit Pistons,0,0,1610612757,Portland Trail Blazers,1,1,21,34,55,10,15,25,31,49,80,15,5,20,10,42,17,8,12,93,87
2017,2,21701035,3/17/2018,1610612754,Indiana Pacers,0,0,1610612764,Washington Wizards,1,1,27,35,62,12,12,24,39,47,86,12,3,15,12,37,24,9,15,95,102
2017,2,21701035,3/17/2018,1610612764,Washington Wizards,1,1,1610612754,Indiana Pacers,0,0,30,24,54,10,10,20,40,34,74,19,4,23,6,30,29,6,14,93,109
2017,2,21701032,3/16/2018,1610612760,Oklahoma City Thunder,1,1,1610612746,LA Clippers,0,0,35,27,62,11,21,32,46,48,94,18,4,22,17,34,30,10,14,101,121
2016,2,21601099,3/27/2017,1610612739,Cleveland Cavaliers,0,0,1610612759,San Antonio Spurs,1,1,27,30,57,4,22,26,31,52,83,8,5,13,15,42,20,11,19,95,74
2016,2,21601099,3/27/2017,1610612759,San Antonio Spurs,1,1,1610612739,Cleveland Cavaliers,0,0,34,26,60,7,19,26,41,45,86,14,3,17,13,33,24,8,12,95,103
2016,2,21600107,11/9/2016,1610612738,Boston Celtics,0,0,1610612764,Washington Wizards,1,1,25,25,50,10,21,31,35,46,81,13,9,22,11,37,21,9,11,92,93
2016,2,21600107,11/9/2016,1610612764,Washington Wizards,1,1,1610612738,Boston Celtics,0,0,36,35,71,10,11,21,46,46,92,16,4,20,21,27,29,5,12,91,118
2014,2,21401200,4/12/2015,1610612756,Phoenix Suns,0,0,1610612759,San Antonio Spurs,1,1,31,38,69,4,12,16,35,50,85,17,6,23,16,39,17,7,13,94,91
2014,2,21401200,4/12/2015,1610612759,San Antonio Spurs,1,1,1610612756,Phoenix Suns,0,0,27,23,50,8,11,19,35,34,69,29,5,34,8,28,22,6,15,94,107
2018,2,21801133,3/29/2019,1610612743,Denver Nuggets,0,1,1610612760,Oklahoma City Thunder,1,0,34,18,52,14,19,33,48,37,85,5,1,6,10,27,30,5,13,93,115
2018,2,21801133,3/29/2019,1610612760,Oklahoma City Thunder,1,0,1610612743,Denver Nuggets,0,1,35,26,61,8,19,27,43,45,88,11,5,16,15,34,19,6,13,92,105
2014,2,21400746,2/6/2015,1610612751,Brooklyn Nets,1,1,1610612752,New York Knicks,0,0,34,29,63,3,8,11,37,37,74,15,7,22,13,28,23,8,14,86,92
2014,2,21400746,2/6/2015,1610612752,New York Knicks,0,0,1610612751,Brooklyn Nets,1,1,28,37,65,6,18,24,34,55,89,14,3,17,18,38,23,1,6,87,88
2018,2,21800857,2/13/2019,1610612761,Toronto Raptors,1,1,1610612764,Washington Wizards,0,0,28,26,54,16,22,38,44,48,92,25,5,30,10,40,32,6,15,113,129
2018,2,21800857,2/13/2019,1610612764,Washington Wizards,0,0,1610612761,Toronto Raptors,1,1,23,21,44,14,26,40,37,47,84,32,7,39,7,44,27,8,18,113,120
2018,2,21800675,1/18/2019,1610612739,Cleveland Cavaliers,0,0,1610612762,Utah Jazz,1,1,29,34,63,7,17,24,36,51,87,20,6,26,12,41,16,6,15,101,99
2018,2,21800675,1/18/2019,1610612762,Utah Jazz,1,1,1610612739,Cleveland Cavaliers,0,0,31,17,48,13,24,37,44,41,85,14,1,15,10,32,33,9,19,100,115
2018,2,21800444,12/17/2018,1610612752,New York Knicks,1,0,1610612756,Phoenix Suns,0,1,31,33,64,9,26,35,40,59,99,21,8,29,21,42,15,8,11,102,110
2018,2,21800444,12/17/2018,1610612756,Phoenix Suns,0,1,1610612752,New York Knicks,1,0,39,26,65,9,18,27,48,44,92,23,4,27,10,35,27,5,7,102,128
2018,2,21800374,12/7/2018,1610612740,New Orleans Pelicans,1,0,1610612763,Memphis Grizzlies,0,1,31,24,55,7,22,29,38,46,84,20,4,24,13,35,25,10,18,98,103
2018,2,21800374,12/7/2018,1610612763,Memphis Grizzlies,0,1,1610612740,New Orleans Pelicans,1,0,31,33,64,8,11,19,39,44,83,21,7,28,12,34,30,5,11,97,107
2018,2,21800255,11/21/2018,1610612738,Boston Celtics,1,0,1610612752,New York Knicks,0,1,28,36,64,10,23,33,38,59,97,23,9,32,20,44,30,3,8,100,109
2018,2,21800255,11/21/2018,1610612752,New York Knicks,0,1,1610612738,Boston Celtics,1,0,29,30,59,15,15,30,44,45,89,14,3,17,12,35,25,10,17,102,117
2018,2,21800100,10/30/2018,1610612755,Philadelphia 76ers,0,0,1610612761,Toronto Raptors,1,1,24,27,51,14,26,40,38,53,91,22,8,30,22,35,25,13,23,105,112
2018,2,21800100,10/30/2018,1610612761,Toronto Raptors,1,1,1610612755,Philadelphia 76ers,0,0,36,29,65,11,16,27,47,45,92,24,4,28,13,34,29,7,16,107,129
2017,2,21701227,4/11/2018,1610612760,Oklahoma City Thunder,1,1,1610612763,Memphis Grizzlies,0,0,27,15,42,20,23,43,47,38,85,23,9,32,9,32,32,9,14,103,137
2017,2,21701227,4/11/2018,1610612763,Memphis Grizzlies,0,0,1610612760,Oklahoma City Thunder,1,1,31,29,60,13,18,31,44,47,91,22,2,24,11,37,22,8,13,102,123
2017,2,21701064,3/20/2018,1610612745,Houston Rockets,0,1,1610612757,Portland Trail Blazers,1,0,19,24,43,19,17,36,38,41,79,20,9,29,12,34,18,6,9,89,115
2017,2,21701064,3/20/2018,1610612757,Portland Trail Blazers,1,0,1610612745,Houston Rockets,0,1,29,24,53,11,17,28,40,41,81,20,7,27,12,34,20,3,8,89,111
2017,2,21701039,3/17/2018,1610612739,Cleveland Cavaliers,0,1,1610612741,Chicago Bulls,1,0,31,19,50,13,24,37,44,43,87,13,7,20,13,36,25,4,13,94,114
2017,2,21701039,3/17/2018,1610612741,Chicago Bulls,1,0,1610612739,Cleveland Cavaliers,0,1,25,32,57,16,18,34,41,50,91,11,4,15,15,35,30,4,12,95,109
2016,2,21601098,3/27/2017,1610612752,New York Knicks,1,1,1610612765,Detroit Pistons,0,0,38,25,63,7,14,21,45,39,84,12,1,13,4,35,26,4,13,98,109
2016,2,21601098,3/27/2017,1610612765,Detroit Pistons,0,0,1610612752,New York Knicks,1,1,27,34,61,9,14,23,36,48,84,14,7,21,17,34,18,13,20,97,95
2014,2,21400745,2/5/2015,1610612756,Phoenix Suns,0,0,1610612757,Portland Trail Blazers,1,1,28,37,65,6,17,23,34,54,88,13,4,17,11,46,20,7,16,100,87
2014,2,21400745,2/5/2015,1610612757,Portland Trail Blazers,1,1,1610612756,Phoenix Suns,0,0,32,27,59,8,23,31,40,50,90,20,3,23,17,34,21,11,14,100,108
2018,2,21800984,3/8/2019,1610612743,Denver Nuggets,0,0,1610612744,Golden State Warriors,1,1,21,33,54,12,21,33,33,54,87,27,8,35,19,38,21,11,19,104,105
2018,2,21800984,3/8/2019,1610612744,Golden State Warriors,1,1,1610612743,Denver Nuggets,0,0,27,22,49,18,17,35,45,39,84,14,7,21,7,34,32,9,17,103,122
2018,2,21800759,1/30/2019,1610612754,Indiana Pacers,0,0,1610612764,Washington Wizards,1,1,24,29,53,9,22,31,33,51,84,14,4,18,17,37,27,8,17,94,89
2018,2,21800759,1/30/2019,1610612764,Washington Wizards,1,1,1610612754,Indiana Pacers,0,0,29,21,50,12,16,28,41,37,78,13,8,21,10,30,27,6,15,93,107
2018,2,21800599,1/8/2019,1610612739,Cleveland Cavaliers,1,0,1610612754,Indiana Pacers,0,1,28,19,47,13,16,29,41,35,76,20,3,23,10,26,24,11,16,93,115
2018,2,21800599,1/8/2019,1610612754,Indiana Pacers,0,1,1610612739,Cleveland Cavaliers,1,0,39,26,65,10,16,26,49,42,91,15,4,19,14,29,34,4,6,93,123
2018,2,21800518,12/28/2018,1610612754,Indiana Pacers,1,1,1610612765,Detroit Pistons,0,0,48,20,68,5,14,19,53,34,87,14,6,20,9,29,33,7,13,98,125
2018,2,21800518,12/28/2018,1610612765,Detroit Pistons,0,0,1610612754,Indiana Pacers,1,1,25,30,55,9,27,36,34,57,91,11,1,12,19,38,25,11,22,98,88
2018,2,21800311,11/28/2018,1610612750,Minnesota Timberwolves,1,1,1610612759,San Antonio Spurs,0,0,32,26,58,18,23,41,50,49,99,10,5,15,17,35,33,1,9,98,128
2018,2,21800311,11/28/2018,1610612759,San Antonio Spurs,0,0,1610612750,Minnesota Timberwolves,1,1,26,34,60,8,19,27,34,53,87,13,0,13,15,38,23,12,19,98,89
2018,2,21800201,11/13/2018,1610612737,Atlanta Hawks,0,0,1610612744,Golden State Warriors,1,1,28,29,57,12,20,32,40,49,89,11,4,15,12,40,25,8,17,100,103
2018,2,21800201,11/13/2018,1610612744,Golden State Warriors,1,1,1610612737,Atlanta Hawks,0,0,27,37,64,12,15,27,39,52,91,20,1,21,14,38,28,9,13,100,110
2017,2,21701205,4/9/2018,1610612741,Chicago Bulls,0,0,1610612751,Brooklyn Nets,1,1,31,30,61,12,16,28,43,46,89,7,5,12,14,35,26,8,19,100,105
2017,2,21701205,4/9/2018,1610612751,Brooklyn Nets,1,1,1610612741,Chicago Bulls,0,0,23,17,40,18,24,42,41,41,82,14,1,15,7,35,32,7,18,99,114
2016,2,21600541,1/5/2017,1610612742,Dallas Mavericks,1,0,1610612756,Phoenix Suns,0,1,27,23,50,9,20,29,36,43,79,14,3,17,8,36,18,4,11,91,95
2016,2,21600541,1/5/2017,1610612756,Phoenix Suns,0,1,1610612742,Dallas Mavericks,1,0,31,37,68,7,10,17,38,47,85,19,3,22,21,26,15,6,16,90,102
2016,2,21600106,11/9/2016,1610612751,Brooklyn Nets,0,0,1610612752,New York Knicks,1,1,22,24,46,11,22,33,33,46,79,19,8,27,9,41,19,11,18,101,96
2016,2,21600106,11/9/2016,1610612752,New York Knicks,1,1,1610612751,Brooklyn Nets,0,0,34,28,62,10,20,30,44,48,92,12,5,17,15,34,25,9,14,102,110
2018,2,21801132,3/29/2019,1610612744,Golden State Warriors,0,0,1610612750,Minnesota Timberwolves,1,1,28,30,58,18,22,40,46,52,98,20,8,28,11,46,27,7,15,115,130
2018,2,21801132,3/29/2019,1610612750,Minnesota Timberwolves,1,1,1610612744,Golden State Warriors,0,0,31,34,65,14,24,38,45,58,103,27,7,34,21,41,25,11,16,116,131
2017,2,21701228,4/11/2018,1610612746,LA Clippers,1,0,1610612747,Los Angeles Lakers,0,1,35,30,65,6,12,18,41,42,83,12,16,28,11,41,27,8,17,102,100
2017,2,21701228,4/11/2018,1610612747,Los Angeles Lakers,0,1,1610612746,LA Clippers,1,0,25,24,49,17,22,39,42,46,88,14,2,16,11,36,25,8,17,101,115
2017,2,21701206,4/9/2018,1610612748,Miami Heat,1,0,1610612760,Oklahoma City Thunder,0,1,35,30,65,5,17,22,40,47,87,8,6,14,11,39,21,9,15,97,93
2017,2,21701206,4/9/2018,1610612760,Oklahoma City Thunder,0,1,1610612748,Miami Heat,1,0,21,25,46,14,21,35,35,46,81,31,7,38,11,40,21,6,10,98,115
2017,2,21701122,3/28/2018,1610612746,LA Clippers,0,1,1610612756,Phoenix Suns,1,0,35,28,63,8,9,17,43,37,80,17,8,25,12,30,26,13,21,99,111
2017,2,21701122,3/28/2018,1610612756,Phoenix Suns,1,0,1610612746,LA Clippers,0,1,28,26,54,10,24,34,38,50,88,13,5,18,11,42,17,7,14,99,99
2017,2,21701090,3/24/2018,1610612753,Orlando Magic,1,1,1610612756,Phoenix Suns,0,0,26,28,54,11,19,30,37,47,84,20,7,27,17,35,29,14,20,100,105
2017,2,21701090,3/24/2018,1610612756,Phoenix Suns,0,0,1610612753,Orlando Magic,1,1,29,31,60,7,22,29,36,53,89,20,6,26,13,43,21,9,14,102,99
2017,2,21701075,3/22/2018,1610612740,New Orleans Pelicans,1,1,1610612747,Los Angeles Lakers,0,0,46,25,71,6,18,24,52,43,95,18,4,22,9,35,28,4,10,107,128
2017,2,21701075,3/22/2018,1610612747,Los Angeles Lakers,0,0,1610612740,New Orleans Pelicans,1,1,26,22,48,17,22,39,43,44,87,22,6,28,10,36,19,13,16,109,125
2016,2,21601097,3/27/2017,1610612753,Orlando Magic,0,0,1610612761,Toronto Raptors,1,1,39,29,68,4,16,20,43,45,88,22,6,28,12,35,19,7,12,99,112
2016,2,21601097,3/27/2017,1610612761,Toronto Raptors,1,1,1610612753,Orlando Magic,0,0,39,29,68,10,5,15,49,34,83,23,12,35,15,25,24,11,15,100,131
2014,2,21400744,2/5/2015,1610612742,Dallas Mavericks,0,1,1610612758,Sacramento Kings,1,0,29,33,62,12,22,34,41,55,96,7,3,10,13,44,25,5,9,96,101
2014,2,21400744,2/5/2015,1610612758,Sacramento Kings,1,0,1610612742,Dallas Mavericks,0,1,26,32,58,3,18,21,29,50,79,17,5,22,11,41,13,9,17,95,78
2016,2,21601096,3/26/2017,1610612747,Los Angeles Lakers,1,0,1610612757,Portland Trail Blazers,0,1,28,35,63,5,16,21,33,51,84,10,7,17,4,52,19,8,10,99,81
2016,2,21601096,3/26/2017,1610612757,Portland Trail Blazers,0,1,1610612747,Los Angeles Lakers,1,0,24,37,61,12,16,28,36,53,89,13,5,18,13,43,24,6,13,97,97
2016,2,21600540,1/5/2017,1610612745,Houston Rockets,1,1,1610612760,Oklahoma City Thunder,0,0,26,21,47,15,24,39,41,45,86,21,9,30,12,38,27,6,10,97,118
2016,2,21600540,1/5/2017,1610612760,Oklahoma City Thunder,0,0,1610612745,Houston Rockets,1,1,29,32,61,12,18,30,41,50,91,22,5,27,16,36,15,6,9,96,116
2014,2,21400743,2/5/2015,1610612739,Cleveland Cavaliers,1,1,1610612746,LA Clippers,0,0,23,19,42,8,22,30,31,41,72,35,9,44,15,32,23,9,18,95,105
2014,2,21400743,2/5/2015,1610612746,LA Clippers,0,0,1610612739,Cleveland Cavaliers,1,1,33,36,69,5,17,22,38,53,91,13,7,20,19,39,24,10,12,95,94
2014,2,21400742,2/5/2015,1610612764,Washington Wizards,0,0,1610612766,Charlotte Hornets,1,1,30,44,74,5,5,10,35,49,84,12,5,17,14,39,20,5,13,90,87
2014,2,21400742,2/5/2015,1610612766,Charlotte Hornets,1,1,1610612764,Washington Wizards,0,0,27,24,51,6,19,25,33,43,76,22,5,27,16,28,15,2,17,89,94
2022,2,22201189,4/5/2023,1610612751,Brooklyn Nets,0,1,1610612765,Detroit Pistons,1,0,28,15,43,17,26,43,45,41,86,16,7,23,16,28,36,5,13,93,123
2023,2,22300467,1/3/2024,1610612737,Atlanta Hawks,1,1,1610612760,Oklahoma City Thunder,0,0,34,22,56,14,25,39,48,47,95,31,2,33,18,30,30,10,13,107,141
2023,2,22300364,12/20/2023,1610612739,Cleveland Cavaliers,1,1,1610612762,Utah Jazz,0,0,22,23,45,23,28,51,45,51,96,11,5,16,18,34,34,5,12,98,124
2023,2,22300520,1/10/2024,1610612764,Washington Wizards,0,0,1610612754,Indiana Pacers,1,1,31,26,57,7,24,31,38,50,88,21,9,30,15,41,24,7,14,101,104
2023,2,22300507,1/8/2024,1610612754,Indiana Pacers,1,1,1610612738,Boston Celtics,0,0,29,22,51,19,21,40,48,43,91,18,4,22,14,32,29,3,14,99,133
2023,2,22300565,1/15/2024,1610612760,Oklahoma City Thunder,0,0,1610612747,Los Angeles Lakers,1,1,25,22,47,15,34,49,40,56,96,10,1,11,16,40,23,7,11,97,105
2016,2,21600539,1/5/2017,1610612737,Atlanta Hawks,0,1,1610612740,New Orleans Pelicans,1,0,29,38,67,9,14,23,38,52,90,14,3,17,14,40,23,8,15,100,99
2016,2,21600539,1/5/2017,1610612740,New Orleans Pelicans,1,0,1610612737,Atlanta Hawks,0,1,19,39,58,15,20,35,34,59,93,11,3,14,16,44,19,9,15,100,94
2016,2,21600105,11/8/2016,1610612740,New Orleans Pelicans,0,0,1610612758,Sacramento Kings,1,1,33,30,63,5,16,21,38,46,84,13,5,18,13,35,23,7,11,91,94
2016,2,21600105,11/8/2016,1610612758,Sacramento Kings,1,1,1610612740,New Orleans Pelicans,0,0,31,25,56,8,17,25,39,42,81,16,4,20,8,36,24,5,10,90,102
2014,2,21401199,4/12/2015,1610612740,New Orleans Pelicans,0,0,1610612745,Houston Rockets,1,1,33,31,64,11,16,27,44,47,91,15,7,22,17,33,22,6,11,95,114
2014,2,21401199,4/12/2015,1610612745,Houston Rockets,1,1,1610612740,New Orleans Pelicans,0,0,30,19,49,9,15,24,39,34,73,34,14,48,12,29,16,6,11,96,121
2014,2,21400741,2/4/2015,1610612742,Dallas Mavericks,0,0,1610612744,Golden State Warriors,1,1,31,37,68,10,20,30,41,57,98,22,6,28,19,40,24,5,8,102,114
2014,2,21400741,2/4/2015,1610612744,Golden State Warriors,1,1,1610612742,Dallas Mavericks,0,0,26,22,48,19,19,38,45,41,86,19,6,25,11,33,29,8,13,100,128
2016,2,21601095,3/26/2017,1610612740,New Orleans Pelicans,0,1,1610612743,Denver Nuggets,1,0,39,31,70,9,18,27,48,49,97,10,2,12,10,41,29,3,9,101,115
2016,2,21601095,3/26/2017,1610612743,Denver Nuggets,1,0,1610612740,New Orleans Pelicans,0,1,30,40,70,6,19,25,36,59,95,12,2,14,9,52,21,6,9,101,90
2016,2,21600538,1/5/2017,1610612765,Detroit Pistons,1,1,1610612766,Charlotte Hornets,0,0,29,40,69,10,18,28,39,58,97,27,5,32,19,41,24,4,7,99,115
2016,2,21600538,1/5/2017,1610612766,Charlotte Hornets,0,0,1610612765,Detroit Pistons,1,1,27,38,65,10,16,26,37,54,91,30,4,34,12,43,20,2,5,100,114
2016,2,21601094,3/26/2017,1610612744,Golden State Warriors,1,1,1610612763,Memphis Grizzlies,0,0,22,18,40,17,14,31,39,32,71,11,4,15,7,28,30,11,18,88,106
2016,2,21601094,3/26/2017,1610612763,Memphis Grizzlies,0,0,1610612744,Golden State Warriors,1,1,30,26,56,8,21,29,38,47,85,10,5,15,19,32,21,9,15,89,94
2014,2,21401198,4/12/2015,1610612737,Atlanta Hawks,0,0,1610612764,Washington Wizards,1,1,27,31,58,9,20,29,36,51,87,18,6,24,13,41,24,8,12,98,99
2014,2,21401198,4/12/2015,1610612764,Washington Wizards,1,1,1610612737,Atlanta Hawks,0,0,30,34,64,9,12,21,39,46,85,21,6,27,18,31,22,10,19,98,108
2014,2,21400740,2/4/2015,1610612762,Utah Jazz,1,0,1610612763,Memphis Grizzlies,0,1,26,24,50,7,16,23,33,40,73,17,9,26,13,30,15,7,14,87,90
2014,2,21400740,2/4/2015,1610612763,Memphis Grizzlies,0,1,1610612762,Utah Jazz,1,0,32,35,67,6,7,13,38,42,80,18,4,22,13,31,26,6,9,87,100
2014,2,21401197,4/12/2015,1610612754,Indiana Pacers,1,1,1610612760,Oklahoma City Thunder,0,0,32,27,59,10,10,20,42,37,79,22,13,35,11,30,25,5,13,97,116
2014,2,21401197,4/12/2015,1610612760,Oklahoma City Thunder,0,0,1610612754,Indiana Pacers,1,1,30,37,67,11,17,28,41,54,95,11,17,28,17,46,18,4,8,97,104
2016,2,21600104,11/8/2016,1610612742,Dallas Mavericks,0,1,1610612747,Los Angeles Lakers,1,0,33,26,59,10,13,23,43,39,82,13,2,15,11,29,24,6,11,91,109
2016,2,21600104,11/8/2016,1610612747,Los Angeles Lakers,1,0,1610612742,Dallas Mavericks,0,1,28,24,52,10,16,26,38,40,78,11,3,14,11,31,20,11,17,91,97
2014,2,21400739,2/4/2015,1610612753,Orlando Magic,0,0,1610612759,San Antonio Spurs,1,1,32,31,63,10,11,21,42,42,84,9,5,14,8,36,27,7,13,95,103
2014,2,21400739,2/4/2015,1610612759,San Antonio Spurs,1,1,1610612753,Orlando Magic,0,0,30,22,52,14,18,32,44,40,84,8,6,14,7,37,32,6,11,94,110
2015,2,21501122,3/31/2016,1610612739,Cleveland Cavaliers,1,1,1610612751,Brooklyn Nets,0,0,26,23,49,12,26,38,38,49,87,19,5,24,12,42,29,12,17,103,107
2015,2,21501122,3/31/2016,1610612751,Brooklyn Nets,0,0,1610612739,Cleveland Cavaliers,1,1,31,42,73,4,17,21,35,59,94,13,8,21,19,45,26,10,17,103,87
2015,2,21500960,3/10/2016,1610612741,Chicago Bulls,0,0,1610612759,San Antonio Spurs,1,1,28,36,64,11,11,22,39,47,86,12,1,13,16,32,23,14,21,99,101
2015,2,21500960,3/10/2016,1610612759,San Antonio Spurs,1,1,1610612741,Chicago Bulls,0,0,38,38,76,6,11,17,44,49,93,15,4,19,11,41,29,5,8,99,109
2023,2,22300469,1/3/2024,1610612745,Houston Rockets,1,1,1610612751,Brooklyn Nets,0,0,18,19,37,19,20,39,37,39,76,19,8,27,6,37,27,11,16,98,112
2015,2,21500397,12/18/2015,1610612744,Golden State Warriors,1,1,1610612749,Milwaukee Bucks,0,0,33,28,61,9,17,26,42,45,87,28,9,37,19,31,31,6,15,102,121
2015,2,21500397,12/18/2015,1610612749,Milwaukee Bucks,0,0,1610612744,Golden State Warriors,1,1,38,35,73,4,14,18,42,49,91,24,4,28,18,33,25,7,16,103,112
2023,2,22300476,1/3/2024,1610612753,Orlando Magic,0,0,1610612758,Sacramento Kings,1,1,19,27,46,25,19,44,44,46,90,22,5,27,8,40,33,9,21,115,135
2023,2,22300531,1/11/2024,1610612756,Phoenix Suns,0,1,1610612747,Los Angeles Lakers,1,0,32,22,54,14,25,39,46,47,93,21,2,23,15,33,23,8,13,100,127
2015,2,21500295,12/5/2015,1610612749,Milwaukee Bucks,1,1,1610612752,New York Knicks,0,0,42,43,85,2,2,4,44,45,89,16,8,24,16,32,25,4,13,99,106
2015,2,21500295,12/5/2015,1610612752,New York Knicks,0,0,1610612749,Milwaukee Bucks,1,1,26,25,51,6,19,25,32,44,76,21,7,28,8,38,22,5,15,98,91
2014,2,21400738,2/4/2015,1610612740,New Orleans Pelicans,1,0,1610612760,Oklahoma City Thunder,0,1,30,42,72,7,18,25,37,60,97,10,3,13,23,38,23,3,11,92,91
2014,2,21400738,2/4/2015,1610612760,Oklahoma City Thunder,0,1,1610612740,New Orleans Pelicans,1,0,40,30,70,5,10,15,45,40,85,7,4,11,13,30,21,7,15,92,102
2015,2,21501194,4/10/2016,1610612764,Washington Wizards,1,1,1610612766,Charlotte Hornets,0,0,33,26,59,9,12,21,42,38,80,20,8,28,5,37,27,7,12,101,113
2015,2,21501194,4/10/2016,1610612766,Charlotte Hornets,0,0,1610612764,Washington Wizards,1,1,16,32,48,12,21,33,28,53,81,30,5,35,11,45,21,8,15,100,98
2015,2,21501012,3/17/2016,1610612754,Indiana Pacers,1,0,1610612761,Toronto Raptors,0,1,27,36,63,8,20,28,35,56,91,16,7,23,14,45,21,5,15,103,94
2015,2,21501012,3/17/2016,1610612761,Toronto Raptors,0,1,1610612754,Indiana Pacers,1,0,25,41,66,7,15,22,32,56,88,30,8,38,20,39,11,9,15,104,101
2014,2,21400737,2/4/2015,1610612748,Miami Heat,0,0,1610612750,Minnesota Timberwolves,1,1,32,32,64,7,9,16,39,41,80,16,8,24,17,30,18,10,18,94,101
2014,2,21400737,2/4/2015,1610612750,Minnesota Timberwolves,1,1,1610612748,Miami Heat,0,0,31,30,61,6,5,11,37,35,72,22,5,27,5,32,27,11,14,94,102
2023,2,22300505,1/7/2024,1610612746,LA Clippers,0,0,1610612747,Los Angeles Lakers,1,1,22,32,54,14,23,37,36,55,91,17,2,19,18,38,21,9,16,97,103
2015,2,21501068,3/24/2016,1610612740,New Orleans Pelicans,0,0,1610612754,Indiana Pacers,1,1,31,38,69,4,12,16,35,50,85,10,4,14,11,41,15,10,16,97,84
2015,2,21501068,3/24/2016,1610612754,Indiana Pacers,1,1,1610612740,New Orleans Pelicans,0,0,29,30,59,7,13,20,36,43,79,13,2,15,4,40,26,7,14,95,92
2023,2,22300508,1/8/2024,1610612764,Washington Wizards,1,0,1610612760,Oklahoma City Thunder,0,1,29,28,57,15,17,32,44,45,89,25,4,29,16,30,32,11,15,102,128
2023,2,22300476,1/3/2024,1610612758,Sacramento Kings,1,1,1610612753,Orlando Magic,0,0,36,29,65,15,25,40,51,54,105,21,10,31,24,35,36,10,21,115,138
2023,2,22300531,1/11/2024,1610612747,Los Angeles Lakers,1,0,1610612756,Phoenix Suns,0,1,27,19,46,13,21,34,40,40,80,16,9,25,9,35,33,12,18,101,109
2015,2,21501011,3/16/2016,1610612744,Golden State Warriors,1,1,1610612752,New York Knicks,0,0,28,26,54,18,19,37,46,45,91,11,1,12,17,29,32,7,13,94,121
2015,2,21501011,3/16/2016,1610612752,New York Knicks,0,0,1610612744,Golden State Warriors,1,1,29,43,72,7,12,19,36,55,91,6,4,10,12,46,29,4,10,94,85
2022,2,22200506,12/27/2022,1610612755,Philadelphia 76ers,0,0,1610612764,Washington Wizards,1,1,33,20,53,6,25,31,39,45,84,27,4,31,16,29,21,7,16,99,111
2022,2,22200506,12/27/2022,1610612764,Washington Wizards,1,1,1610612755,Philadelphia 76ers,0,0,28,24,52,11,22,33,39,46,85,27,4,31,18,31,18,8,18,98,116
2015,2,21500900,3/2/2016,1610612761,Toronto Raptors,1,1,1610612762,Utah Jazz,0,0,34,24,58,6,16,22,40,40,80,18,3,21,15,27,12,6,10,85,104
2015,2,21500900,3/2/2016,1610612762,Utah Jazz,0,0,1610612761,Toronto Raptors,1,1,27,30,57,10,16,26,37,46,83,10,6,16,14,36,21,7,9,85,94
2015,2,21500499,1/2/2016,1610612739,Cleveland Cavaliers,1,1,1610612753,Orlando Magic,0,0,22,23,45,12,25,37,34,48,82,24,15,39,15,41,24,1,7,90,104
2015,2,21500499,1/2/2016,1610612753,Orlando Magic,0,0,1610612739,Cleveland Cavaliers,1,1,23,28,51,6,19,25,29,47,76,15,2,17,8,41,16,6,14,90,79
2015,2,21500396,12/18/2015,1610612740,New Orleans Pelicans,0,0,1610612756,Phoenix Suns,1,1,22,27,49,4,18,22,26,45,71,32,6,38,12,35,13,10,21,97,88
2015,2,21500396,12/18/2015,1610612756,Phoenix Suns,1,1,1610612740,New Orleans Pelicans,0,0,38,30,68,6,10,16,44,40,84,10,7,17,15,28,22,8,19,99,104
2015,2,21500294,12/5/2015,1610612750,Minnesota Timberwolves,1,0,1610612757,Portland Trail Blazers,0,1,33,35,68,5,10,15,38,45,83,22,4,26,15,32,24,7,14,95,103
2015,2,21500294,12/5/2015,1610612757,Portland Trail Blazers,0,1,1610612750,Minnesota Timberwolves,1,0,29,28,57,10,10,20,39,38,77,21,9,30,12,32,23,3,15,96,109
2023,2,22300505,1/7/2024,1610612747,Los Angeles Lakers,1,1,1610612746,LA Clippers,0,0,31,22,53,11,18,29,42,40,82,11,5,16,10,32,23,12,19,97,106
2014,2,21400736,2/4/2015,1610612747,Los Angeles Lakers,0,0,1610612749,Milwaukee Bucks,1,1,30,35,65,9,19,28,39,54,93,18,7,25,24,32,22,10,18,99,105
2014,2,21400736,2/4/2015,1610612749,Milwaukee Bucks,1,1,1610612747,Los Angeles Lakers,0,0,30,26,56,11,15,26,41,41,82,20,2,22,6,36,25,3,12,99,113
2015,2,21501121,3/30/2016,1610612747,Los Angeles Lakers,1,1,1610612748,Miami Heat,0,0,31,51,82,6,14,20,37,65,102,22,7,29,24,46,14,6,10,102,102
2015,2,21501121,3/30/2016,1610612748,Miami Heat,0,0,1610612747,Los Angeles Lakers,1,1,38,31,69,3,14,17,41,45,86,15,11,26,16,34,26,9,18,102,100
2015,2,21500742,2/3/2016,1610612740,New Orleans Pelicans,0,0,1610612759,San Antonio Spurs,1,1,38,33,71,3,16,19,41,49,90,12,2,14,17,34,21,6,19,99,97
2015,2,21500742,2/3/2016,1610612759,San Antonio Spurs,1,1,1610612740,New Orleans Pelicans,0,0,33,33,66,9,6,15,42,39,81,17,1,18,6,34,30,12,14,100,110
2015,2,21500653,1/22/2016,1610612747,Los Angeles Lakers,1,0,1610612759,San Antonio Spurs,0,1,32,36,68,6,10,16,38,46,84,13,5,18,17,30,19,10,13,90,95
2015,2,21500653,1/22/2016,1610612759,San Antonio Spurs,0,1,1610612747,Los Angeles Lakers,1,0,32,32,64,11,10,21,43,42,85,11,2,13,10,34,26,3,7,90,108
2015,2,21500597,1/15/2016,1610612741,Chicago Bulls,1,0,1610612742,Dallas Mavericks,0,1,29,38,67,2,17,19,31,55,86,13,2,15,17,39,16,1,9,86,77
2015,2,21500597,1/15/2016,1610612742,Dallas Mavericks,0,1,1610612741,Chicago Bulls,1,0,22,33,55,8,14,22,30,47,77,15,2,17,9,38,20,6,10,87,83
2023,2,22300838,2/27/2024,1610612759,San Antonio Spurs,0,0,1610612750,Minnesota Timberwolves,1,1,23,18,41,16,25,41,39,43,82,11,4,15,10,36,28,16,23,101,105
2014,2,21400735,2/4/2015,1610612741,Chicago Bulls,0,0,1610612745,Houston Rockets,1,1,23,41,64,8,17,25,31,58,89,20,6,26,21,38,16,6,13,94,90
2014,2,21400735,2/4/2015,1610612745,Houston Rockets,1,1,1610612741,Chicago Bulls,0,0,30,35,65,8,19,27,38,54,92,17,6,23,14,45,18,3,6,94,101
2022,2,22200507,12/27/2022,1610612738,Boston Celtics,1,1,1610612745,Houston Rockets,0,0,23,12,35,20,36,56,43,48,91,20,3,23,12,38,32,5,11,100,126
2022,2,22200507,12/27/2022,1610612745,Houston Rockets,0,0,1610612738,Boston Celtics,1,1,24,26,50,14,31,45,38,57,95,12,2,14,16,41,24,8,15,100,102
2015,2,21500899,3/2/2016,1610612738,Boston Celtics,1,1,1610612757,Portland Trail Blazers,0,0,36,45,81,7,19,26,43,64,107,23,1,24,27,38,20,4,5,97,116
2015,2,21500899,3/2/2016,1610612757,Portland Trail Blazers,0,0,1610612738,Boston Celtics,1,1,23,32,55,11,18,29,34,50,84,14,6,20,13,39,15,9,14,97,93
2015,2,21500693,1/28/2016,1610612743,Denver Nuggets,0,1,1610612764,Washington Wizards,1,0,32,31,63,9,9,18,41,40,81,26,7,33,10,34,25,13,15,102,117
2015,2,21500693,1/28/2016,1610612764,Washington Wizards,1,0,1610612743,Denver Nuggets,0,1,28,32,60,11,17,28,39,49,88,24,6,30,16,35,21,9,15,103,113
2015,2,21500395,12/18/2015,1610612743,Denver Nuggets,0,0,1610612762,Utah Jazz,1,1,25,26,51,6,22,28,31,48,79,20,5,25,16,36,15,8,15,89,88
2015,2,21500395,12/18/2015,1610612762,Utah Jazz,1,1,1610612743,Denver Nuggets,0,0,24,24,48,10,15,25,34,39,73,19,6,25,11,30,15,10,15,89,97
2014,2,21400734,2/4/2015,1610612751,Brooklyn Nets,0,1,1610612761,Toronto Raptors,1,0,31,31,62,9,10,19,40,41,81,20,3,23,11,30,24,3,9,87,109
2014,2,21400734,2/4/2015,1610612761,Toronto Raptors,1,0,1610612751,Brooklyn Nets,0,1,25,21,46,10,23,33,35,44,79,13,5,18,11,36,22,7,9,86,93
2015,2,21501067,3/23/2016,1610612742,Dallas Mavericks,0,0,1610612757,Portland Trail Blazers,1,1,33,33,66,9,21,30,42,54,96,10,1,11,17,38,21,12,17,103,103
2015,2,21501067,3/23/2016,1610612757,Portland Trail Blazers,1,1,1610612742,Dallas Mavericks,0,0,33,29,62,7,20,27,40,49,89,22,3,25,12,37,19,8,14,101,109
2015,2,21501010,3/16/2016,1610612740,New Orleans Pelicans,0,1,1610612758,Sacramento Kings,1,0,37,32,69,12,9,21,49,41,90,13,3,16,11,32,26,7,9,99,123
2015,2,21501010,3/16/2016,1610612758,Sacramento Kings,1,0,1610612740,New Orleans Pelicans,0,1,33,39,72,9,9,18,42,48,90,15,2,17,11,37,23,5,11,98,108
2015,2,21500959,3/10/2016,1610612737,Atlanta Hawks,0,0,1610612761,Toronto Raptors,1,1,28,31,59,7,16,23,35,47,82,19,8,27,11,40,17,6,12,97,96
2014,2,21401195,4/12/2015,1610612765,Detroit Pistons,1,1,1610612766,Charlotte Hornets,0,0,25,28,53,16,12,28,41,40,81,18,5,23,15,27,33,8,16,93,116
2014,2,21401195,4/12/2015,1610612766,Charlotte Hornets,0,0,1610612765,Detroit Pistons,1,1,23,41,64,4,11,15,27,52,79,19,10,29,9,48,16,6,9,93,77
2015,2,21500959,3/10/2016,1610612761,Toronto Raptors,1,1,1610612737,Atlanta Hawks,0,0,31,27,58,7,17,24,38,44,82,21,8,29,15,32,16,8,15,98,104
2015,2,21500836,2/22/2016,1610612737,Atlanta Hawks,1,0,1610612744,Golden State Warriors,0,1,26,26,52,10,24,34,36,50,86,10,6,16,13,40,23,14,18,103,92
2023,2,22300565,1/15/2024,1610612747,Los Angeles Lakers,1,1,1610612760,Oklahoma City Thunder,0,0,36,24,60,8,16,24,44,40,84,16,2,18,12,29,30,11,17,98,112
2014,2,21401196,4/12/2015,1610612743,Denver Nuggets,1,1,1610612758,Sacramento Kings,0,0,36,20,56,9,17,26,45,37,82,23,7,30,11,30,32,13,18,104,122
2014,2,21401196,4/12/2015,1610612758,Sacramento Kings,0,0,1610612743,Denver Nuggets,1,1,33,23,56,5,13,18,38,36,74,30,12,42,8,34,28,15,20,105,111
2014,2,21400733,2/4/2015,1610612738,Boston Celtics,1,1,1610612743,Denver Nuggets,0,0,28,43,71,12,16,28,40,59,99,12,5,17,23,39,27,9,13,96,104
2014,2,21400733,2/4/2015,1610612743,Denver Nuggets,0,0,1610612738,Boston Celtics,1,1,29,27,56,4,20,24,33,47,80,30,3,33,15,33,18,10,15,98,100
2015,2,21501193,4/9/2016,1610612758,Sacramento Kings,1,1,1610612760,Oklahoma City Thunder,0,0,32,30,62,13,19,32,45,49,94,11,9,20,18,33,22,6,11,98,114
2015,2,21501193,4/9/2016,1610612760,Oklahoma City Thunder,0,0,1610612758,Sacramento Kings,1,1,26,23,49,13,19,32,39,42,81,21,7,28,17,27,24,12,21,98,112
2015,2,21500836,2/22/2016,1610612744,Golden State Warriors,0,1,1610612737,Atlanta Hawks,1,0,25,19,44,14,31,45,39,50,89,10,2,12,7,44,30,7,13,101,102
2015,2,21500787,2/9/2016,1610612742,Dallas Mavericks,1,0,1610612762,Utah Jazz,0,1,25,21,46,11,18,29,36,39,75,36,5,41,9,31,24,3,11,99,119
2015,2,21500787,2/9/2016,1610612762,Utah Jazz,0,1,1610612742,Dallas Mavericks,1,0,42,24,66,6,20,26,48,44,92,19,8,27,16,32,23,5,11,99,121
2014,2,21400732,2/4/2015,1610612737,Atlanta Hawks,1,1,1610612764,Washington Wizards,0,0,27,28,55,11,14,25,38,42,80,18,9,27,9,36,24,7,14,95,105
2014,2,21400732,2/4/2015,1610612764,Washington Wizards,0,0,1610612737,Atlanta Hawks,1,1,30,31,61,4,12,16,34,43,77,24,6,30,6,39,19,7,12,96,96
2015,2,21501192,4/9/2016,1610612750,Minnesota Timberwolves,0,1,1610612757,Portland Trail Blazers,1,0,36,35,71,5,8,13,41,43,84,19,6,25,17,28,24,2,11,91,106
2015,2,21501192,4/9/2016,1610612757,Portland Trail Blazers,1,0,1610612750,Minnesota Timberwolves,0,1,31,25,56,9,15,24,40,40,80,16,2,18,16,26,19,8,19,92,105
2015,2,21501066,3/23/2016,1610612744,Golden State Warriors,1,1,1610612746,LA Clippers,0,0,24,29,53,15,19,34,39,48,87,21,7,28,13,41,23,8,12,98,114
2015,2,21501066,3/23/2016,1610612746,LA Clippers,0,0,1610612744,Golden State Warriors,1,1,28,29,57,8,20,28,36,49,85,18,9,27,10,41,21,9,10,98,98
2015,2,21501009,3/16/2016,1610612745,Houston Rockets,1,0,1610612746,LA Clippers,0,1,31,26,57,9,16,25,40,42,82,17,7,24,15,29,23,9,16,95,106
2015,2,21501009,3/16/2016,1610612746,LA Clippers,0,1,1610612745,Houston Rockets,1,0,31,15,46,12,18,30,43,33,76,24,8,32,8,29,31,5,11,95,122
2015,2,21500692,1/28/2016,1610612737,Atlanta Hawks,0,0,1610612754,Indiana Pacers,1,1,26,29,55,7,21,28,33,50,83,19,2,21,9,43,20,10,14,97,92
2015,2,21500692,1/28/2016,1610612754,Indiana Pacers,1,1,1610612737,Atlanta Hawks,0,0,29,34,63,9,6,15,38,40,78,26,4,30,13,28,20,9,18,98,111
2015,2,21500596,1/15/2016,1610612751,Brooklyn Nets,1,0,1610612757,Portland Trail Blazers,0,1,30,36,66,8,11,19,38,47,85,20,8,28,17,33,22,7,12,93,104
2015,2,21500596,1/15/2016,1610612757,Portland Trail Blazers,0,1,1610612751,Brooklyn Nets,1,0,32,26,58,15,20,35,47,46,93,7,4,11,16,33,26,6,9,94,116
2015,2,21500498,1/2/2016,1610612754,Indiana Pacers,1,1,1610612765,Detroit Pistons,0,0,26,29,55,7,11,18,33,40,73,21,8,29,8,36,11,5,14,94,94
2015,2,21500498,1/2/2016,1610612765,Detroit Pistons,0,0,1610612754,Indiana Pacers,1,1,30,43,73,3,17,20,33,60,93,13,10,23,21,43,17,7,10,94,82
2015,2,21500293,12/5/2015,1610612745,Houston Rockets,1,1,1610612758,Sacramento Kings,0,0,20,24,44,16,18,34,36,42,78,32,11,43,15,34,25,12,18,101,120
2015,2,21500293,12/5/2015,1610612758,Sacramento Kings,0,0,1610612745,Houston Rockets,1,1,36,36,72,10,16,26,46,52,98,11,2,13,17,36,35,9,14,102,113
2015,2,21500101,11/9/2015,1610612737,Atlanta Hawks,1,0,1610612750,Minnesota Timberwolves,0,1,31,24,55,13,18,31,44,42,86,6,1,7,8,35,30,10,17,99,107
2015,2,21500101,11/9/2015,1610612750,Minnesota Timberwolves,0,1,1610612737,Atlanta Hawks,1,0,39,26,65,7,8,15,46,34,80,18,4,22,12,26,27,13,19,100,117
2015,2,21500005,10/28/2015,1610612738,Boston Celtics,1,1,1610612755,Philadelphia 76ers,0,0,31,30,61,8,16,24,39,46,85,26,1,27,14,33,31,11,17,102,112
2015,2,21500005,10/28/2015,1610612755,Philadelphia 76ers,0,0,1610612738,Boston Celtics,1,1,27,34,61,7,15,22,34,49,83,20,3,23,17,35,12,10,24,101,95
2015,2,21501120,3/30/2016,1610612758,Sacramento Kings,1,1,1610612764,Washington Wizards,0,0,39,27,66,8,10,18,47,37,84,18,7,25,8,33,27,6,17,105,120
2015,2,21501120,3/30/2016,1610612764,Washington Wizards,0,0,1610612758,Sacramento Kings,1,1,34,29,63,9,17,26,43,46,89,16,4,20,12,36,30,13,20,105,111
2015,2,21500958,3/9/2016,1610612744,Golden State Warriors,1,1,1610612762,Utah Jazz,0,0,35,19,54,13,17,30,48,36,84,6,4,10,9,29,36,9,15,96,115
2015,2,21500958,3/9/2016,1610612762,Utah Jazz,0,0,1610612744,Golden State Warriors,1,1,24,35,59,8,12,20,32,47,79,22,9,31,18,33,21,10,20,95,94
2015,2,21500898,3/2/2016,1610612755,Philadelphia 76ers,1,0,1610612766,Charlotte Hornets,0,1,21,31,52,13,20,33,34,51,85,18,8,26,13,43,23,9,14,100,99
2015,2,21500898,3/2/2016,1610612766,Charlotte Hornets,0,1,1610612755,Philadelphia 76ers,1,0,30,26,56,10,15,25,40,41,81,29,6,35,10,33,20,8,12,100,119
2014,2,21401194,4/12/2015,1610612738,Boston Celtics,1,1,1610612739,Cleveland Cavaliers,0,0,36,24,60,10,14,24,46,38,84,15,7,22,8,34,29,1,9,95,117
2014,2,21401194,4/12/2015,1610612739,Cleveland Cavaliers,0,0,1610612738,Boston Celtics,1,1,28,29,57,3,19,22,31,48,79,13,6,19,17,34,18,20,25,97,78
2023,2,22301228,12/8/2023,1610612758,Sacramento Kings,0,1,1610612756,Phoenix Suns,1,0,28,25,53,14,25,39,42,50,92,16,4,20,16,35,25,8,13,95,114
2015,2,21500394,12/18/2015,1610612742,Dallas Mavericks,1,1,1610612763,Memphis Grizzlies,0,0,24,25,49,10,19,29,34,44,78,19,2,21,14,30,27,11,19,93,97
2015,2,21500394,12/18/2015,1610612763,Memphis Grizzlies,0,0,1610612742,Dallas Mavericks,1,1,24,39,63,6,11,17,30,50,80,22,2,24,11,40,13,7,12,92,88
2015,2,21500292,12/5/2015,1610612741,Chicago Bulls,1,0,1610612766,Charlotte Hornets,0,1,28,36,64,9,16,25,37,52,89,13,6,19,16,40,29,10,14,97,96
2023,2,22300470,1/3/2024,1610612761,Toronto Raptors,0,1,1610612763,Memphis Grizzlies,1,0,29,30,59,12,14,26,41,44,85,22,5,27,8,38,25,7,11,101,116
2023,2,22300562,1/15/2024,1610612748,Miami Heat,0,1,1610612751,Brooklyn Nets,1,0,25,31,56,8,23,31,33,54,87,22,3,25,13,42,22,9,13,101,96
2023,2,22300775,2/13/2024,1610612757,Portland Trail Blazers,1,0,1610612750,Minnesota Timberwolves,0,1,28,30,58,11,18,29,39,48,87,20,5,25,16,33,26,8,16,99,109
2023,2,22300508,1/8/2024,1610612760,Oklahoma City Thunder,0,1,1610612764,Washington Wizards,1,0,38,22,60,14,14,28,52,36,88,18,6,24,13,27,37,7,15,100,136
2014,2,21400731,2/4/2015,1610612754,Indiana Pacers,1,1,1610612765,Detroit Pistons,0,0,34,22,56,12,9,21,46,31,77,10,8,18,10,24,28,7,13,89,114
2014,2,21400731,2/4/2015,1610612765,Detroit Pistons,0,0,1610612754,Indiana Pacers,1,1,31,32,63,12,12,24,43,44,87,11,4,15,15,31,23,5,10,88,109
2015,2,21501008,3/16/2016,1610612750,Minnesota Timberwolves,0,1,1610612763,Memphis Grizzlies,1,0,30,20,50,10,11,21,40,31,71,24,7,31,11,24,31,3,14,90,114
2015,2,21501008,3/16/2016,1610612763,Memphis Grizzlies,1,0,1610612750,Minnesota Timberwolves,0,1,40,40,80,4,16,20,44,56,100,16,5,21,31,29,22,5,13,90,108
2015,2,21500835,2/22/2016,1610612752,New York Knicks,1,0,1610612761,Toronto Raptors,0,1,31,33,64,6,14,20,37,47,84,15,8,23,14,37,18,7,8,90,95
2015,2,21500835,2/22/2016,1610612761,Toronto Raptors,0,1,1610612752,New York Knicks,1,0,35,27,62,11,14,25,46,41,87,19,6,25,15,31,26,2,7,90,122
2015,2,21500652,1/22/2016,1610612744,Golden State Warriors,1,1,1610612754,Indiana Pacers,0,0,29,28,57,14,19,33,43,47,90,22,3,25,17,32,31,11,17,102,122
2015,2,21500652,1/22/2016,1610612754,Indiana Pacers,0,0,1610612744,Golden State Warriors,1,1,41,37,78,3,14,17,44,51,95,19,8,27,18,38,22,9,13,101,110
2015,2,21500497,1/2/2016,1610612760,Oklahoma City Thunder,0,1,1610612766,Charlotte Hornets,1,0,26,30,56,9,14,23,35,44,79,30,7,37,16,32,20,7,14,94,109
2015,2,21500497,1/2/2016,1610612766,Charlotte Hornets,1,0,1610612760,Oklahoma City Thunder,0,1,23,39,62,6,16,22,29,55,84,26,8,34,12,45,18,2,4,96,90
2015,2,21501065,3/23/2016,1610612747,Los Angeles Lakers,0,0,1610612756,Phoenix Suns,1,1,32,34,66,7,20,27,39,54,93,22,4,26,18,39,13,6,10,98,107
2015,2,21501065,3/23/2016,1610612756,Phoenix Suns,1,1,1610612747,Los Angeles Lakers,0,0,34,31,65,13,15,28,47,46,93,12,8,20,18,30,31,6,13,97,119
2015,2,21500897,3/2/2016,1610612741,Chicago Bulls,0,0,1610612753,Orlando Magic,1,1,32,48,80,6,13,19,38,61,99,7,4,11,9,52,24,5,8,105,89
2015,2,21500897,3/2/2016,1610612753,Orlando Magic,1,1,1610612741,Chicago Bulls,0,0,32,44,76,7,14,21,39,58,97,17,5,22,11,49,25,6,10,104,102
2023,2,22301060,3/28/2024,1610612738,Boston Celtics,0,0,1610612737,Atlanta Hawks,1,1,31,27,58,14,22,36,45,49,94,18,3,21,12,38,28,5,12,102,122
2014,2,21401193,4/12/2015,1610612749,Milwaukee Bucks,1,1,1610612751,Brooklyn Nets,0,0,35,28,63,6,14,20,41,42,83,8,4,12,12,34,30,9,17,96,96
2014,2,21401193,4/12/2015,1610612751,Brooklyn Nets,0,0,1610612749,Milwaukee Bucks,1,1,24,41,65,3,15,18,27,56,83,16,6,22,19,40,17,13,21,95,73
2014,2,21400730,2/3/2015,1610612744,Golden State Warriors,0,1,1610612758,Sacramento Kings,1,0,36,32,68,10,13,23,46,45,91,19,7,26,16,33,33,7,11,99,121
2015,2,21501119,3/30/2016,1610612744,Golden State Warriors,0,1,1610612762,Utah Jazz,1,0,27,27,54,12,23,35,39,50,89,13,5,18,13,39,19,11,18,103,103
2015,2,21501119,3/30/2016,1610612762,Utah Jazz,1,0,1610612744,Golden State Warriors,0,1,28,32,60,9,23,32,37,55,92,13,16,29,19,42,14,6,15,103,96
2015,2,21501064,3/23/2016,1610612743,Denver Nuggets,1,1,1610612755,Philadelphia 76ers,0,0,27,32,59,6,11,17,33,43,76,32,8,40,10,38,18,7,17,101,104
2015,2,21501064,3/23/2016,1610612755,Philadelphia 76ers,0,0,1610612743,Denver Nuggets,1,1,22,35,57,15,22,37,37,57,94,14,1,15,11,46,26,7,10,102,103
2014,2,21400730,2/3/2015,1610612758,Sacramento Kings,1,0,1610612744,Golden State Warriors,0,1,28,35,63,7,9,16,35,44,79,19,5,24,9,37,17,13,18,98,96
2015,2,21500786,2/9/2016,1610612738,Boston Celtics,0,0,1610612749,Milwaukee Bucks,1,1,29,26,55,10,19,29,39,45,84,23,1,24,15,30,28,5,18,99,111
2015,2,21500786,2/9/2016,1610612749,Milwaukee Bucks,1,1,1610612738,Boston Celtics,0,0,38,31,69,7,12,19,45,43,88,15,8,23,14,34,25,11,14,98,112
2015,2,21500741,2/3/2016,1610612742,Dallas Mavericks,1,0,1610612748,Miami Heat,0,1,26,41,67,8,12,20,34,53,87,14,5,19,10,45,18,3,4,91,90
2015,2,21501191,4/9/2016,1610612739,Cleveland Cavaliers,0,0,1610612741,Chicago Bulls,1,1,17,26,43,19,21,40,36,47,83,11,7,18,18,34,24,8,16,90,102
2015,2,21501191,4/9/2016,1610612741,Chicago Bulls,1,1,1610612739,Cleveland Cavaliers,0,0,32,33,65,8,16,24,40,49,89,17,4,21,19,32,19,5,12,91,105
2022,2,22200504,12/26/2022,1610612757,Portland Trail Blazers,1,1,1610612766,Charlotte Hornets,0,0,29,19,48,14,24,38,43,43,86,24,4,28,13,31,28,8,15,102,124
2022,2,22200504,12/26/2022,1610612766,Charlotte Hornets,0,0,1610612757,Portland Trail Blazers,1,1,29,38,67,12,24,36,41,62,103,19,6,25,26,42,25,8,13,103,113
2015,2,21500741,2/3/2016,1610612748,Miami Heat,0,1,1610612742,Dallas Mavericks,1,0,35,38,73,2,13,15,37,51,88,17,6,23,16,38,18,4,8,91,93
2015,2,21500595,1/15/2016,1610612738,Boston Celtics,1,1,1610612756,Phoenix Suns,0,0,28,38,66,14,16,30,42,54,96,19,10,29,21,38,30,9,13,103,117
2015,2,21500595,1/15/2016,1610612756,Phoenix Suns,0,0,1610612738,Boston Celtics,1,1,25,37,62,10,17,27,35,54,89,23,5,28,16,40,24,12,15,103,103
2015,2,21500292,12/5/2015,1610612766,Charlotte Hornets,0,1,1610612741,Chicago Bulls,1,0,27,28,55,10,24,34,37,52,89,18,7,25,15,41,23,5,10,95,102
2015,2,21500195,11/21/2015,1610612759,San Antonio Spurs,1,1,1610612763,Memphis Grizzlies,0,0,27,24,51,7,14,21,34,38,72,17,5,22,10,29,20,13,18,92,92
2015,2,21500195,11/21/2015,1610612763,Memphis Grizzlies,0,0,1610612759,San Antonio Spurs,1,1,31,34,65,1,8,9,32,42,74,17,0,17,8,34,19,7,17,91,82
2015,2,21501063,3/23/2016,1610612748,Miami Heat,0,0,1610612759,San Antonio Spurs,1,1,30,33,63,7,7,14,37,40,77,7,5,12,7,35,23,7,15,90,88
2015,2,21501063,3/23/2016,1610612759,San Antonio Spurs,1,1,1610612748,Miami Heat,0,0,34,33,67,8,6,14,42,39,81,20,4,24,12,30,26,8,10,91,112
2015,2,21501007,3/16/2016,1610612737,Atlanta Hawks,0,1,1610612765,Detroit Pistons,1,0,27,28,55,12,22,34,39,50,89,28,6,34,13,39,25,3,12,108,118
2015,2,21501007,3/16/2016,1610612765,Detroit Pistons,1,0,1610612737,Atlanta Hawks,0,1,31,28,59,8,17,25,39,45,84,28,11,39,10,39,23,10,14,106,114
2015,2,21500834,2/22/2016,1610612748,Miami Heat,1,1,1610612754,Indiana Pacers,0,0,36,51,87,2,11,13,38,62,100,23,11,34,26,41,19,8,15,106,101
2015,2,21500834,2/22/2016,1610612754,Indiana Pacers,0,0,1610612748,Miami Heat,1,1,31,46,77,5,10,15,36,56,92,16,9,25,11,49,17,8,13,106,93
2014,2,21400729,2/3/2015,1610612757,Portland Trail Blazers,1,1,1610612762,Utah Jazz,0,0,29,24,53,7,16,23,36,40,76,24,10,34,16,30,18,8,14,91,103
2014,2,21400729,2/3/2015,1610612762,Utah Jazz,0,0,1610612757,Portland Trail Blazers,1,1,33,39,72,6,7,13,39,46,85,18,8,26,16,36,18,8,10,91,102
2015,2,21500691,1/27/2016,1610612742,Dallas Mavericks,0,0,1610612744,Golden State Warriors,1,1,33,23,56,11,20,31,44,43,87,8,4,12,10,36,20,5,10,92,107
2015,2,21500691,1/27/2016,1610612744,Golden State Warriors,1,1,1610612742,Dallas Mavericks,0,0,33,19,52,14,15,29,47,34,81,19,2,21,9,26,33,4,9,92,127
2015,2,21500496,1/2/2016,1610612756,Phoenix Suns,0,0,1610612758,Sacramento Kings,1,1,33,21,54,10,19,29,43,40,83,23,5,28,4,38,27,9,16,106,119
2015,2,21500496,1/2/2016,1610612758,Sacramento Kings,1,1,1610612756,Phoenix Suns,0,0,44,20,64,9,14,23,53,34,87,27,7,34,12,25,30,9,15,106,142
2015,2,21500393,12/18/2015,1610612746,LA Clippers,0,0,1610612759,San Antonio Spurs,1,1,26,22,48,10,14,24,36,36,72,25,15,40,8,35,23,7,11,94,107
2015,2,21500393,12/18/2015,1610612759,San Antonio Spurs,1,1,1610612746,LA Clippers,0,0,33,35,68,10,9,19,43,44,87,19,5,24,12,35,25,6,9,94,115
2015,2,21500291,12/5/2015,1610612739,Cleveland Cavaliers,0,0,1610612748,Miami Heat,1,1,25,32,57,6,22,28,31,54,85,16,8,24,19,39,14,5,15,92,84
2015,2,21500291,12/5/2015,1610612748,Miami Heat,1,1,1610612739,Cleveland Cavaliers,0,0,30,22,52,7,9,16,37,31,68,18,11,29,8,28,21,8,17,91,99
2015,2,21500957,3/9/2016,1610612739,Cleveland Cavaliers,0,1,1610612758,Sacramento Kings,1,0,26,20,46,13,31,44,39,51,90,29,6,35,18,36,17,8,14,102,120
2015,2,21500957,3/9/2016,1610612758,Sacramento Kings,1,0,1610612739,Cleveland Cavaliers,0,1,32,30,62,8,14,22,40,44,84,23,9,32,10,37,20,5,10,100,111
2014,2,21400728,2/3/2015,1610612738,Boston Celtics,0,1,1610612752,New York Knicks,1,0,36,17,53,6,18,24,42,35,77,18,5,23,16,24,23,7,17,89,108
2015,2,21500740,2/3/2016,1610612753,Orlando Magic,0,0,1610612760,Oklahoma City Thunder,1,1,37,35,72,10,13,23,47,48,95,10,2,12,15,34,25,7,9,96,114
2015,2,21500740,2/3/2016,1610612760,Oklahoma City Thunder,1,1,1610612753,Orlando Magic,0,0,35,31,66,9,18,27,44,49,93,20,5,25,20,30,25,3,13,94,117
2014,2,21400728,2/3/2015,1610612752,New York Knicks,1,0,1610612738,Boston Celtics,0,1,34,29,63,7,13,20,41,42,83,8,3,11,13,30,22,6,13,88,97
2015,2,21500956,3/9/2016,1610612752,New York Knicks,0,1,1610612756,Phoenix Suns,1,0,30,28,58,16,8,24,46,36,82,20,4,24,9,30,31,6,11,96,128
2015,2,21500956,3/9/2016,1610612756,Phoenix Suns,1,0,1610612752,New York Knicks,0,1,30,30,60,9,20,29,39,50,89,10,5,15,12,40,16,8,11,96,97
2015,2,21500896,3/1/2016,1610612747,Los Angeles Lakers,1,1,1610612751,Brooklyn Nets,0,0,30,27,57,11,15,26,41,42,83,14,7,21,11,36,22,8,13,95,107
2014,2,21400727,2/3/2015,1610612748,Miami Heat,0,0,1610612765,Detroit Pistons,1,1,29,31,60,6,8,14,35,39,74,15,8,23,9,33,23,7,10,85,91
2015,2,21500896,3/1/2016,1610612751,Brooklyn Nets,0,0,1610612747,Los Angeles Lakers,1,1,34,37,71,5,13,18,39,50,89,18,9,27,16,38,28,5,8,94,101
2015,2,21500833,2/22/2016,1610612739,Cleveland Cavaliers,1,0,1610612765,Detroit Pistons,0,1,26,27,53,8,18,26,34,45,79,12,1,13,7,39,19,10,18,96,88
2014,2,21400727,2/3/2015,1610612765,Detroit Pistons,1,1,1610612748,Miami Heat,0,0,33,35,68,9,11,20,42,46,88,15,3,18,19,28,27,1,8,86,108
2015,2,21500833,2/22/2016,1610612765,Detroit Pistons,0,1,1610612739,Cleveland Cavaliers,1,0,29,26,55,8,17,25,37,43,80,14,7,21,9,36,17,8,15,97,96
2015,2,21501062,3/23/2016,1610612750,Minnesota Timberwolves,1,1,1610612758,Sacramento Kings,0,0,40,27,67,5,8,13,45,35,80,18,14,32,11,27,29,6,18,103,113
2015,2,21501062,3/23/2016,1610612758,Sacramento Kings,0,0,1610612750,Minnesota Timberwolves,1,1,34,37,71,8,12,20,42,49,91,12,11,23,17,36,23,8,17,103,104
2015,2,21501006,3/16/2016,1610612741,Chicago Bulls,0,0,1610612764,Washington Wizards,1,1,29,38,67,6,14,20,35,52,87,20,3,23,12,41,20,12,18,103,96
2015,2,21501006,3/16/2016,1610612764,Washington Wizards,1,1,1610612741,Chicago Bulls,0,0,30,37,67,13,8,21,43,45,88,18,6,24,13,35,25,10,15,103,117
2023,2,22300421,12/28/2023,1610612765,Detroit Pistons,0,0,1610612738,Boston Celtics,1,1,34,24,58,14,29,43,48,53,101,12,7,19,24,32,27,10,19,106,122
2014,2,21401192,4/11/2015,1610612744,Golden State Warriors,1,1,1610612750,Minnesota Timberwolves,0,0,31,31,62,11,20,31,42,51,93,15,6,21,17,36,28,9,12,97,110
2014,2,21401192,4/11/2015,1610612750,Minnesota Timberwolves,0,0,1610612744,Golden State Warriors,1,1,24,31,55,11,13,24,35,44,79,20,6,26,10,38,27,10,15,97,101
2014,2,21400726,2/3/2015,1610612743,Denver Nuggets,0,0,1610612755,Philadelphia 76ers,1,1,21,33,54,12,19,31,33,52,85,20,8,28,12,43,26,10,14,101,98
2014,2,21400726,2/3/2015,1610612755,Philadelphia 76ers,1,1,1610612743,Denver Nuggets,0,0,20,23,43,11,16,27,31,39,70,32,10,42,11,32,26,13,21,100,105
2023,2,22300354,12/18/2023,1610612761,Toronto Raptors,1,1,1610612766,Charlotte Hornets,0,0,36,21,57,8,21,29,44,42,86,18,4,22,17,27,30,8,19,96,114
2023,2,22300469,1/3/2024,1610612751,Brooklyn Nets,0,0,1610612745,Houston Rockets,1,1,23,26,49,13,31,44,36,57,93,16,10,26,17,46,25,5,10,100,101
2023,2,22300517,1/10/2024,1610612750,Minnesota Timberwolves,0,0,1610612738,Boston Celtics,1,1,30,31,61,14,20,34,44,51,95,18,2,20,10,42,22,5,9,102,120
2023,2,22300506,1/8/2024,1610612766,Charlotte Hornets,1,0,1610612741,Chicago Bulls,0,1,23,29,52,17,25,42,40,54,94,15,2,17,16,39,26,7,15,101,112
2023,2,22300670,1/30/2024,1610612738,Boston Celtics,1,1,1610612754,Indiana Pacers,0,0,30,21,51,17,19,36,47,40,87,18,4,22,10,34,25,4,12,98,129
2015,2,21500832,2/21/2016,1610612757,Portland Trail Blazers,1,1,1610612762,Utah Jazz,0,0,27,31,58,12,20,32,39,51,90,25,13,38,28,31,20,6,14,96,115
2015,2,21500832,2/21/2016,1610612762,Utah Jazz,0,0,1610612757,Portland Trail Blazers,1,1,35,35,70,8,8,16,43,43,86,17,6,23,13,31,19,7,11,97,111
2015,2,21500651,1/22/2016,1610612742,Dallas Mavericks,1,0,1610612760,Oklahoma City Thunder,0,1,30,24,54,10,23,33,40,47,87,16,2,18,10,37,24,3,8,96,106
2015,2,21500651,1/22/2016,1610612760,Oklahoma City Thunder,0,1,1610612742,Dallas Mavericks,1,0,37,24,61,8,22,30,45,46,91,11,4,15,18,29,18,9,14,94,109
2015,2,21500594,1/15/2016,1610612750,Minnesota Timberwolves,0,0,1610612760,Oklahoma City Thunder,1,1,29,44,73,5,7,12,34,51,85,20,3,23,18,33,15,10,13,89,93
2015,2,21500594,1/15/2016,1610612760,Oklahoma City Thunder,1,1,1610612750,Minnesota Timberwolves,0,0,42,24,66,5,18,23,47,42,89,14,7,21,16,30,31,3,6,90,113
2015,2,21501190,4/9/2016,1610612744,Golden State Warriors,0,1,1610612763,Memphis Grizzlies,1,0,29,22,51,10,26,36,39,48,87,12,1,13,11,38,20,8,11,94,100
2015,2,21501190,4/9/2016,1610612763,Memphis Grizzlies,1,0,1610612744,Golden State Warriors,0,1,30,45,75,7,14,21,37,59,96,18,2,20,19,42,19,3,7,93,99
2015,2,21500895,3/1/2016,1610612737,Atlanta Hawks,0,0,1610612744,Golden State Warriors,1,1,25,22,47,12,21,33,37,43,80,19,5,24,8,36,25,11,17,101,105
2015,2,21500895,3/1/2016,1610612744,Golden State Warriors,1,1,1610612737,Atlanta Hawks,0,0,29,38,67,12,24,36,41,62,103,15,2,17,25,38,28,9,13,103,109
2014,2,21400725,2/2/2015,1610612756,Phoenix Suns,1,0,1610612763,Memphis Grizzlies,0,1,36,32,68,6,10,16,42,42,84,11,7,18,15,31,18,12,16,94,101
2014,2,21400725,2/2/2015,1610612763,Memphis Grizzlies,0,1,1610612756,Phoenix Suns,1,0,33,39,72,3,8,11,36,47,83,27,7,34,20,29,19,12,14,92,102
2015,2,21501189,4/9/2016,1610612740,New Orleans Pelicans,1,0,1610612756,Phoenix Suns,0,1,32,42,74,7,14,21,39,56,95,15,5,20,16,43,19,6,11,100,100
2015,2,21501189,4/9/2016,1610612756,Phoenix Suns,0,1,1610612740,New Orleans Pelicans,1,0,33,25,58,10,15,25,43,40,83,25,6,31,13,32,27,8,17,101,121
2015,2,21501118,3/30/2016,1610612740,New Orleans Pelicans,0,0,1610612759,San Antonio Spurs,1,1,28,35,63,8,9,17,36,44,80,12,6,18,14,34,27,10,17,93,92
2015,2,21501118,3/30/2016,1610612759,San Antonio Spurs,1,1,1610612740,New Orleans Pelicans,0,0,24,27,51,12,12,24,36,39,75,16,6,22,6,36,23,6,12,93,100
2015,2,21501061,3/23/2016,1610612745,Houston Rockets,1,0,1610612762,Utah Jazz,0,1,24,27,51,9,14,23,33,41,74,12,10,22,10,37,22,8,15,90,87
2015,2,21501061,3/23/2016,1610612762,Utah Jazz,0,1,1610612745,Houston Rockets,1,0,20,28,48,11,18,29,31,46,77,16,4,20,19,29,22,13,23,91,89
2023,2,22300467,1/3/2024,1610612760,Oklahoma City Thunder,0,0,1610612737,Atlanta Hawks,1,1,32,23,55,18,18,36,50,41,91,20,6,26,10,35,30,8,13,106,138
2023,2,22300551,1/14/2024,1610612748,Miami Heat,1,1,1610612766,Charlotte Hornets,0,0,29,27,56,11,14,25,40,41,81,13,3,16,8,33,27,5,14,96,104
2023,2,22300554,1/14/2024,1610612756,Phoenix Suns,0,1,1610612757,Portland Trail Blazers,1,0,33,15,48,13,15,28,46,30,76,22,5,27,7,26,27,8,14,95,127
2014,2,21401191,4/11/2015,1610612757,Portland Trail Blazers,1,0,1610612762,Utah Jazz,0,1,35,22,57,6,24,30,41,46,87,17,5,22,14,33,22,9,13,98,105
2014,2,21401191,4/11/2015,1610612762,Utah Jazz,0,1,1610612757,Portland Trail Blazers,1,0,30,32,62,6,11,17,36,43,79,33,9,42,19,31,20,11,17,97,111
2014,2,21400724,2/2/2015,1610612742,Dallas Mavericks,1,1,1610612750,Minnesota Timberwolves,0,0,29,24,53,10,21,31,39,45,84,12,6,18,15,33,27,10,15,94,100
2014,2,21400724,2/2/2015,1610612750,Minnesota Timberwolves,0,0,1610612742,Dallas Mavericks,1,1,31,38,69,3,10,13,34,48,82,23,3,26,18,32,18,11,17,93,94
2023,2,22301228,12/8/2023,1610612756,Phoenix Suns,1,0,1610612758,Sacramento Kings,0,1,29,22,51,11,21,32,40,43,83,15,8,23,10,36,26,7,11,96,106
2023,2,22300775,2/13/2024,1610612750,Minnesota Timberwolves,0,1,1610612757,Portland Trail Blazers,1,0,26,25,51,13,20,33,39,45,84,30,4,34,14,34,24,5,12,98,121
2015,2,21500831,2/21/2016,1610612741,Chicago Bulls,1,1,1610612747,Los Angeles Lakers,0,0,31,29,60,13,6,19,44,35,79,25,1,26,9,28,30,5,8,92,126
2015,2,21500831,2/21/2016,1610612747,Los Angeles Lakers,0,0,1610612741,Chicago Bulls,1,1,36,36,72,7,14,21,43,50,93,22,11,33,23,31,13,2,8,92,115
2015,2,21500785,2/9/2016,1610612752,New York Knicks,1,0,1610612764,Washington Wizards,0,1,36,21,57,8,18,26,44,39,83,12,2,14,9,31,22,8,16,98,108
2015,2,21500785,2/9/2016,1610612764,Washington Wizards,0,1,1610612752,New York Knicks,1,0,23,29,52,16,10,26,39,39,78,17,8,25,3,39,26,6,10,98,111
2014,2,21401190,4/11/2015,1610612746,LA Clippers,1,1,1610612763,Memphis Grizzlies,0,0,29,32,61,6,21,27,35,53,88,18,4,22,21,34,25,8,13,93,94
2014,2,21401190,4/11/2015,1610612763,Memphis Grizzlies,0,0,1610612746,LA Clippers,1,1,32,36,68,2,7,9,34,43,77,16,8,24,13,34,24,10,18,92,86
2014,2,21400723,2/2/2015,1610612753,Orlando Magic,0,0,1610612760,Oklahoma City Thunder,1,1,32,35,67,6,17,23,38,52,90,15,3,18,18,34,23,10,14,93,97
2014,2,21400723,2/2/2015,1610612760,Oklahoma City Thunder,1,1,1610612753,Orlando Magic,0,0,29,26,55,8,12,20,37,38,75,22,4,26,9,31,25,5,13,91,104
2015,2,21501117,3/30/2016,1610612742,Dallas Mavericks,1,1,1610612752,New York Knicks,0,0,27,33,60,8,17,25,35,50,85,13,4,17,16,35,18,11,15,92,91
2015,2,21501117,3/30/2016,1610612752,New York Knicks,0,0,1610612742,Dallas Mavericks,1,1,32,28,60,3,14,17,35,42,77,16,2,18,15,29,17,7,20,93,89
2023,2,22301224,12/8/2023,1610612743,Denver Nuggets,1,0,1610612745,Houston Rockets,0,1,28,34,62,10,18,28,38,52,90,20,7,27,16,40,22,3,10,95,106
2023,2,22300562,1/15/2024,1610612751,Brooklyn Nets,1,0,1610612748,Miami Heat,0,1,22,22,44,12,43,55,34,65,99,15,1,16,13,53,26,6,8,102,95
2023,2,22300552,1/14/2024,1610612749,Milwaukee Bucks,1,1,1610612758,Sacramento Kings,0,0,28,21,49,20,23,43,48,44,92,27,5,32,8,40,31,6,14,113,143
2023,2,22300652,1/28/2024,1610612763,Memphis Grizzlies,0,0,1610612754,Indiana Pacers,1,1,27,25,52,11,19,30,38,44,82,23,8,31,15,34,20,8,13,97,110
2014,2,21400722,2/2/2015,1610612737,Atlanta Hawks,0,0,1610612740,New Orleans Pelicans,1,1,33,34,67,7,15,22,40,49,89,13,4,17,12,39,19,5,6,91,100
2014,2,21400722,2/2/2015,1610612740,New Orleans Pelicans,1,1,1610612737,Atlanta Hawks,0,0,34,29,63,9,14,23,43,43,86,20,3,23,20,24,30,6,13,91,115
2015,2,21500830,2/21/2016,1610612742,Dallas Mavericks,1,1,1610612755,Philadelphia 76ers,0,0,28,23,51,13,21,34,41,44,85,34,2,36,16,28,23,8,11,98,129
2015,2,21500830,2/21/2016,1610612755,Philadelphia 76ers,0,0,1610612742,Dallas Mavericks,1,1,25,24,49,12,16,28,37,40,77,17,10,27,9,35,19,8,16,96,103
2015,2,21500784,2/9/2016,1610612748,Miami Heat,1,0,1610612759,San Antonio Spurs,0,1,36,22,58,4,8,12,40,30,70,17,7,24,3,32,21,10,18,96,101
2015,2,21500784,2/9/2016,1610612759,San Antonio Spurs,0,1,1610612748,Miami Heat,1,0,41,34,75,6,8,14,47,42,89,19,7,26,16,30,25,7,10,96,119
2015,2,21501060,3/23/2016,1610612741,Chicago Bulls,1,0,1610612752,New York Knicks,0,1,23,27,50,15,17,32,38,44,82,16,5,21,6,41,29,4,6,91,107
2015,2,21501060,3/23/2016,1610612752,New York Knicks,0,1,1610612741,Chicago Bulls,1,0,31,31,62,14,11,25,45,42,87,11,4,15,16,29,28,7,12,91,115
2014,2,21400721,2/2/2015,1610612749,Milwaukee Bucks,0,1,1610612761,Toronto Raptors,1,0,26,38,64,7,9,16,33,47,80,9,8,17,13,37,24,7,13,89,82
2014,2,21400721,2/2/2015,1610612761,Toronto Raptors,1,0,1610612749,Milwaukee Bucks,0,1,18,33,51,7,20,27,25,53,78,18,4,22,16,38,14,8,16,89,75
2015,2,21500894,3/1/2016,1610612742,Dallas Mavericks,1,1,1610612753,Orlando Magic,0,0,34,24,58,9,10,19,43,34,77,26,5,31,8,28,27,11,15,99,121
2015,2,21500894,3/1/2016,1610612753,Orlando Magic,0,0,1610612742,Dallas Mavericks,1,1,32,29,61,9,21,30,41,50,91,17,3,20,19,32,29,7,16,98,108
2015,2,21500829,2/21/2016,1610612761,Toronto Raptors,1,1,1610612763,Memphis Grizzlies,0,0,26,27,53,7,21,28,33,48,81,25,6,31,15,35,12,6,14,94,98
2015,2,21500829,2/21/2016,1610612763,Memphis Grizzlies,0,0,1610612761,Toronto Raptors,1,1,25,31,56,3,17,20,28,48,76,26,6,32,11,39,13,4,13,92,85
2022,2,22200552,1/2/2023,1610612739,Cleveland Cavaliers,1,1,1610612741,Chicago Bulls,0,0,32,14,46,16,30,46,48,44,92,33,12,45,14,38,27,8,10,108,145
2022,2,22200552,1/2/2023,1610612741,Chicago Bulls,0,0,1610612739,Cleveland Cavaliers,1,1,37,25,62,10,23,33,47,48,95,30,4,34,12,39,22,1,7,109,134
2015,2,21501005,3/16/2016,1610612739,Cleveland Cavaliers,1,1,1610612742,Dallas Mavericks,0,0,29,22,51,10,27,37,39,49,88,11,2,13,19,31,21,6,16,92,99
2015,2,21501005,3/16/2016,1610612742,Dallas Mavericks,0,0,1610612739,Cleveland Cavaliers,1,1,30,27,57,7,15,22,37,42,79,17,2,19,6,37,24,9,11,92,98
2015,2,21500955,3/9/2016,1610612746,LA Clippers,0,0,1610612760,Oklahoma City Thunder,1,1,29,18,47,12,22,34,41,40,81,14,9,23,2,44,29,6,10,101,108
2015,2,21500955,3/9/2016,1610612760,Oklahoma City Thunder,1,1,1610612746,LA Clippers,0,0,39,28,67,9,15,24,48,43,91,15,3,18,16,28,33,11,16,100,120
2023,2,22300370,12/20/2023,1610612741,Chicago Bulls,1,1,1610612747,Los Angeles Lakers,0,0,30,24,54,18,16,34,48,40,88,10,1,11,8,32,25,7,16,101,124
2015,2,21501116,3/30/2016,1610612746,LA Clippers,0,1,1610612750,Minnesota Timberwolves,1,0,28,25,53,9,22,31,37,47,84,16,2,18,7,41,26,2,8,92,99
2015,2,21501116,3/30/2016,1610612750,Minnesota Timberwolves,1,0,1610612746,LA Clippers,0,1,22,42,64,8,15,23,30,57,87,11,6,17,22,38,20,8,16,91,79
2023,2,22300471,1/3/2024,1610612750,Minnesota Timberwolves,1,0,1610612740,New Orleans Pelicans,0,1,27,24,51,10,21,31,37,45,82,22,5,27,13,36,26,7,13,94,106
2023,2,22300506,1/8/2024,1610612741,Chicago Bulls,0,1,1610612766,Charlotte Hornets,1,0,36,30,66,9,17,26,45,47,92,20,4,24,17,32,27,3,14,102,119
2023,2,22300520,1/10/2024,1610612754,Indiana Pacers,1,1,1610612764,Washington Wizards,0,0,33,34,67,8,17,25,41,51,92,22,2,24,18,35,31,8,14,100,112
2022,2,22201226,4/9/2023,1610612760,Oklahoma City Thunder,1,1,1610612763,Memphis Grizzlies,0,0,33,21,54,12,24,36,45,45,90,13,3,16,13,34,30,8,16,101,115
2023,2,22300568,1/16/2024,1610612760,Oklahoma City Thunder,0,0,1610612746,LA Clippers,1,1,26,23,49,16,18,34,42,41,83,17,3,20,12,29,30,5,12,92,117
2014,2,21401189,4/11/2015,1610612741,Chicago Bulls,1,1,1610612755,Philadelphia 76ers,0,0,31,33,64,9,17,26,40,50,90,25,11,36,20,36,20,5,10,99,114
2014,2,21401189,4/11/2015,1610612755,Philadelphia 76ers,0,0,1610612741,Chicago Bulls,1,1,24,24,48,13,28,41,37,52,89,20,5,25,16,37,19,8,15,98,107
2014,2,21400720,2/2/2015,1610612746,LA Clippers,0,0,1610612751,Brooklyn Nets,1,1,34,32,66,8,15,23,42,47,89,8,17,25,18,38,23,4,13,96,100
2014,2,21400720,2/2/2015,1610612751,Brooklyn Nets,1,1,1610612746,LA Clippers,0,0,29,27,56,12,15,27,41,42,83,8,10,18,10,37,21,6,16,97,102
2015,2,21500954,3/9/2016,1610612742,Dallas Mavericks,1,0,1610612765,Detroit Pistons,0,1,30,26,56,9,21,30,39,47,86,9,2,11,9,38,25,7,10,93,96
2015,2,21500954,3/9/2016,1610612765,Detroit Pistons,0,1,1610612742,Dallas Mavericks,1,0,29,29,58,9,18,27,38,47,85,17,13,30,19,35,19,6,14,94,102
2022,2,22200550,1/2/2023,1610612752,New York Knicks,1,1,1610612756,Phoenix Suns,0,0,23,18,41,13,20,33,36,38,74,17,8,25,10,32,26,4,8,85,102
2015,2,21501188,4/9/2016,1610612737,Atlanta Hawks,1,1,1610612738,Boston Celtics,0,0,29,26,55,17,16,33,46,42,88,9,2,11,9,34,31,10,18,102,118
2015,2,21501188,4/9/2016,1610612738,Boston Celtics,0,0,1610612737,Atlanta Hawks,1,1,29,33,62,11,17,28,40,50,90,16,8,24,16,39,26,10,15,102,107
2014,2,21401188,4/11/2015,1610612748,Miami Heat,1,0,1610612761,Toronto Raptors,0,1,31,30,61,6,14,20,37,44,81,24,20,44,19,35,14,7,7,91,104
2015,2,21501059,3/23/2016,1610612739,Cleveland Cavaliers,1,1,1610612749,Milwaukee Bucks,0,0,30,19,49,10,24,34,40,43,83,23,4,27,21,23,29,8,15,91,113
2015,2,21501059,3/23/2016,1610612749,Milwaukee Bucks,0,0,1610612739,Cleveland Cavaliers,1,1,36,28,64,7,9,16,43,37,80,11,4,15,12,26,23,6,14,91,104
2014,2,21401188,4/11/2015,1610612761,Toronto Raptors,0,1,1610612748,Miami Heat,1,0,26,31,57,9,17,26,35,48,83,28,9,37,16,36,12,3,7,90,107
2014,2,21400719,2/2/2015,1610612764,Washington Wizards,1,0,1610612766,Charlotte Hornets,0,1,27,39,66,6,9,15,33,48,81,16,3,19,11,38,19,6,12,91,88
2014,2,21400719,2/2/2015,1610612766,Charlotte Hornets,0,1,1610612764,Washington Wizards,1,0,33,31,64,4,11,15,37,42,79,14,5,19,10,35,21,7,13,90,92
2015,2,21500739,2/3/2016,1610612744,Golden State Warriors,0,1,1610612764,Washington Wizards,1,0,29,23,52,20,21,41,49,44,93,16,13,29,13,36,35,16,18,112,134
2015,2,21500739,2/3/2016,1610612764,Washington Wizards,1,0,1610612744,Golden State Warriors,0,1,38,30,68,8,15,23,46,45,91,21,9,30,8,42,26,10,14,111,121
2015,2,21500650,1/22/2016,1610612745,Houston Rockets,1,1,1610612749,Milwaukee Bucks,0,0,23,27,50,15,29,44,38,56,94,11,5,16,23,36,27,7,12,93,102
2015,2,21500650,1/22/2016,1610612749,Milwaukee Bucks,0,0,1610612745,Houston Rockets,1,1,36,35,71,3,11,14,39,46,85,17,5,22,18,31,30,10,15,93,98
2015,2,21500593,1/15/2016,1610612754,Indiana Pacers,1,0,1610612764,Washington Wizards,0,1,35,28,63,3,14,17,38,42,80,25,7,32,9,38,19,8,13,100,104
2015,2,21500593,1/15/2016,1610612764,Washington Wizards,0,1,1610612754,Indiana Pacers,1,0,40,33,73,11,14,25,51,47,98,5,5,10,19,30,26,9,15,98,118
2015,2,21500495,1/2/2016,1610612738,Boston Celtics,1,0,1610612751,Brooklyn Nets,0,1,27,29,56,7,25,32,34,54,88,22,6,28,18,38,17,5,14,99,97
2015,2,21500495,1/2/2016,1610612751,Brooklyn Nets,0,1,1610612738,Boston Celtics,1,0,35,40,75,3,15,18,38,55,93,21,1,22,17,38,23,8,14,98,100
2015,2,21501187,4/8/2016,1610612746,LA Clippers,0,1,1610612762,Utah Jazz,1,0,24,30,54,13,16,29,37,46,83,15,4,19,9,40,16,7,14,98,102
2015,2,21501187,4/8/2016,1610612762,Utah Jazz,1,0,1610612746,LA Clippers,0,1,25,26,51,11,20,31,36,46,82,16,7,23,13,36,14,13,18,100,99
2014,2,21400718,2/2/2015,1610612739,Cleveland Cavaliers,1,1,1610612755,Philadelphia 76ers,0,0,23,28,51,12,15,27,35,43,78,15,7,22,19,28,22,16,20,91,97
2014,2,21400718,2/2/2015,1610612755,Philadelphia 76ers,0,0,1610612739,Cleveland Cavaliers,1,1,19,26,45,12,21,33,31,47,78,10,4,14,14,33,23,8,22,92,84
2015,2,21501004,3/16/2016,1610612753,Orlando Magic,0,0,1610612766,Charlotte Hornets,1,1,24,34,58,11,14,25,35,48,83,18,3,21,4,45,23,3,10,98,99
2015,2,21501004,3/16/2016,1610612766,Charlotte Hornets,1,1,1610612753,Orlando Magic,0,0,29,34,63,11,26,37,40,60,100,16,5,21,21,40,23,4,8,99,107
2015,2,21500893,3/1/2016,1610612752,New York Knicks,1,0,1610612757,Portland Trail Blazers,0,1,27,40,67,6,15,21,33,55,88,13,5,18,9,48,11,5,8,95,85
2015,2,21500893,3/1/2016,1610612757,Portland Trail Blazers,0,1,1610612752,New York Knicks,1,0,25,33,58,12,18,30,37,51,88,18,2,20,12,40,17,4,10,95,104
2022,2,22200550,1/2/2023,1610612756,Phoenix Suns,0,0,1610612752,New York Knicks,1,1,24,26,50,10,27,37,34,53,87,5,2,7,12,42,22,1,8,86,83
2023,2,22300761,2/12/2024,1610612766,Charlotte Hornets,1,1,1610612754,Indiana Pacers,0,0,34,14,48,10,24,34,44,38,82,13,3,16,9,32,27,9,19,100,111
2015,2,21501115,3/30/2016,1610612749,Milwaukee Bucks,1,1,1610612756,Phoenix Suns,0,0,31,31,62,6,9,15,37,40,77,25,9,34,12,34,21,6,14,98,105
2015,2,21501115,3/30/2016,1610612756,Phoenix Suns,0,0,1610612749,Milwaukee Bucks,1,1,33,27,60,5,19,24,38,46,84,13,4,17,19,30,23,13,24,97,94
2014,2,21400717,2/1/2015,1610612747,Los Angeles Lakers,0,0,1610612752,New York Knicks,1,1,20,40,60,7,9,16,27,49,76,19,4,23,15,35,15,7,15,88,80
2014,2,21400717,2/1/2015,1610612752,New York Knicks,1,1,1610612747,Los Angeles Lakers,0,0,27,35,62,10,12,22,37,47,84,8,5,13,13,37,18,7,10,88,92
2023,2,22300840,2/27/2024,1610612749,Milwaukee Bucks,1,1,1610612766,Charlotte Hornets,0,0,30,19,49,16,24,40,46,43,89,15,3,18,12,33,29,6,10,94,123
2015,2,21501058,3/23/2016,1610612753,Orlando Magic,0,0,1610612765,Detroit Pistons,1,1,31,42,73,8,17,25,39,59,98,16,3,19,18,42,24,4,6,95,102
2015,2,21501058,3/23/2016,1610612765,Detroit Pistons,1,1,1610612753,Orlando Magic,0,0,32,24,56,11,13,24,43,37,80,21,4,25,12,27,30,9,16,97,118
2015,2,21501186,4/8/2016,1610612743,Denver Nuggets,1,1,1610612759,San Antonio Spurs,0,0,34,30,64,6,16,22,40,46,86,16,3,19,9,38,21,6,11,98,102
2015,2,21501186,4/8/2016,1610612759,San Antonio Spurs,0,0,1610612743,Denver Nuggets,1,1,33,38,71,3,11,14,36,49,85,23,5,28,10,40,20,9,10,99,98
2023,2,22300517,1/10/2024,1610612738,Boston Celtics,1,1,1610612750,Minnesota Timberwolves,0,0,20,23,43,19,28,47,39,51,90,30,1,31,11,41,21,4,8,103,127
2022,2,22201229,4/9/2023,1610612756,Phoenix Suns,1,0,1610612746,LA Clippers,0,1,28,34,62,14,23,37,42,57,99,16,6,22,16,43,29,3,7,101,114
2023,2,22300421,12/28/2023,1610612738,Boston Celtics,1,1,1610612765,Detroit Pistons,0,0,37,23,60,11,28,39,48,51,99,21,4,25,14,40,25,7,12,107,128
2023,2,22300470,1/3/2024,1610612763,Memphis Grizzlies,1,0,1610612761,Toronto Raptors,0,1,25,27,52,15,27,42,40,54,94,16,3,19,15,40,25,5,11,102,111
2023,2,22300509,1/8/2024,1610612748,Miami Heat,1,1,1610612745,Houston Rockets,0,0,26,20,46,15,21,36,41,41,82,23,9,32,11,32,30,8,11,96,120
2023,2,22300534,1/12/2024,1610612745,Houston Rockets,0,1,1610612765,Detroit Pistons,1,0,33,27,60,8,22,30,41,49,90,22,3,25,13,38,21,6,9,98,112
2023,2,22300693,2/2/2024,1610612744,Golden State Warriors,0,1,1610612763,Memphis Grizzlies,1,0,35,19,54,11,18,29,46,37,83,18,4,22,9,29,32,7,14,99,121
2014,2,21401187,4/11/2015,1610612752,New York Knicks,0,1,1610612753,Orlando Magic,1,0,25,37,62,6,14,20,31,51,82,12,1,13,14,38,22,10,15,90,80
2015,2,21500953,3/9/2016,1610612738,Boston Celtics,1,1,1610612763,Memphis Grizzlies,0,0,26,29,55,15,17,32,41,46,87,19,5,24,14,36,26,8,13,98,116
2015,2,21500953,3/9/2016,1610612763,Memphis Grizzlies,0,0,1610612738,Boston Celtics,1,1,25,33,58,7,19,26,32,52,84,25,6,31,21,34,20,9,19,97,96
2014,2,21401187,4/11/2015,1610612753,Orlando Magic,1,0,1610612752,New York Knicks,0,1,24,38,62,6,16,22,30,54,84,13,5,18,18,39,15,3,15,90,79
2014,2,21400716,2/1/2015,1610612738,Boston Celtics,1,0,1610612748,Miami Heat,0,1,26,36,62,4,15,19,30,51,81,11,7,18,14,38,24,7,14,92,75
2014,2,21400716,2/1/2015,1610612748,Miami Heat,0,1,1610612738,Boston Celtics,1,0,28,28,56,4,17,21,32,45,77,15,6,21,15,34,18,7,20,92,83
2015,2,21500828,2/21/2016,1610612753,Orlando Magic,1,0,1610612754,Indiana Pacers,0,1,31,35,66,7,18,25,38,53,91,19,10,29,15,41,27,7,15,107,102
2015,2,21500828,2/21/2016,1610612754,Indiana Pacers,0,1,1610612753,Orlando Magic,1,0,32,26,58,9,15,24,41,41,82,14,7,21,8,35,26,12,21,106,105
2015,2,21501114,3/30/2016,1610612743,Denver Nuggets,0,1,1610612763,Memphis Grizzlies,1,0,25,24,49,13,16,29,38,40,78,20,4,24,14,27,24,5,16,93,109
2015,2,21501114,3/30/2016,1610612763,Memphis Grizzlies,1,0,1610612743,Denver Nuggets,0,1,35,41,76,6,13,19,41,54,95,17,10,27,25,33,18,4,10,94,105
2014,2,21400715,1/31/2015,1610612744,Golden State Warriors,1,1,1610612756,Phoenix Suns,0,0,28,27,55,12,20,32,40,47,87,14,4,18,11,38,27,10,15,102,106
2014,2,21400715,1/31/2015,1610612756,Phoenix Suns,0,0,1610612744,Golden State Warriors,1,1,24,41,65,9,17,26,33,58,91,12,5,17,21,40,22,11,22,102,87
2015,2,21500892,3/1/2016,1610612741,Chicago Bulls,0,0,1610612748,Miami Heat,1,1,30,37,67,11,12,23,41,49,90,18,8,26,14,38,20,5,10,99,111
2015,2,21500892,3/1/2016,1610612748,Miami Heat,1,1,1610612741,Chicago Bulls,0,0,46,19,65,6,6,12,52,25,77,19,6,25,6,21,28,10,15,98,129
2015,2,21501057,3/23/2016,1610612738,Boston Celtics,1,1,1610612761,Toronto Raptors,0,0,27,33,60,8,12,20,35,45,80,13,8,21,10,39,24,3,8,90,91
2015,2,21501057,3/23/2016,1610612761,Toronto Raptors,0,0,1610612738,Boston Celtics,1,1,25,42,67,6,16,22,31,58,89,11,9,20,19,44,13,5,12,90,79
2023,2,22300585,1/19/2024,1610612755,Philadelphia 76ers,0,1,1610612753,Orlando Magic,1,0,29,28,57,13,17,30,42,45,87,27,2,29,17,28,23,3,8,92,124
2014,2,21401186,4/10/2015,1610612747,Los Angeles Lakers,1,1,1610612750,Minnesota Timberwolves,0,0,32,28,60,9,14,23,41,42,83,15,9,24,16,31,35,7,14,92,106
2014,2,21401186,4/10/2015,1610612750,Minnesota Timberwolves,0,0,1610612747,Los Angeles Lakers,1,1,29,30,59,3,12,15,32,42,74,31,3,34,11,33,17,6,12,93,98
2014,2,21400714,1/31/2015,1610612746,LA Clippers,0,1,1610612759,San Antonio Spurs,1,0,32,37,69,8,14,22,40,51,91,17,1,18,18,34,20,11,15,95,105
2014,2,21400714,1/31/2015,1610612759,San Antonio Spurs,1,0,1610612746,LA Clippers,0,1,18,27,45,10,20,30,28,47,75,19,9,28,8,44,18,12,17,96,85
2023,2,22300510,1/8/2024,1610612749,Milwaukee Bucks,1,0,1610612762,Utah Jazz,0,1,25,33,58,17,19,36,42,52,94,15,4,19,15,39,31,6,9,98,116
2023,2,22300371,12/20/2023,1610612737,Atlanta Hawks,0,1,1610612745,Houston Rockets,1,0,30,21,51,17,23,40,47,44,91,23,5,28,17,30,31,4,12,97,134
2023,2,22300474,1/3/2024,1610612765,Detroit Pistons,0,0,1610612762,Utah Jazz,1,1,37,27,64,19,22,41,56,49,105,17,5,22,21,31,33,11,17,111,148
2023,2,22300522,1/10/2024,1610612760,Oklahoma City Thunder,0,1,1610612748,Miami Heat,1,0,37,16,53,14,19,33,51,35,86,12,4,16,6,30,36,8,13,99,128
2014,2,21400713,1/31/2015,1610612743,Denver Nuggets,1,0,1610612766,Charlotte Hornets,0,1,28,40,68,5,19,24,33,59,92,15,5,20,13,48,21,10,12,101,86
2014,2,21400713,1/31/2015,1610612766,Charlotte Hornets,0,1,1610612743,Denver Nuggets,1,0,44,38,82,0,11,11,44,49,93,16,9,25,15,37,32,2,10,100,104
2015,2,21500783,2/8/2016,1610612756,Phoenix Suns,1,0,1610612760,Oklahoma City Thunder,0,1,36,26,62,1,10,11,37,36,73,31,8,39,11,28,22,8,18,98,106
2015,2,21500783,2/8/2016,1610612760,Oklahoma City Thunder,0,1,1610612756,Phoenix Suns,1,0,27,25,52,15,18,33,42,43,85,23,7,30,16,31,23,9,14,98,122
2023,2,22301224,12/8/2023,1610612745,Houston Rockets,0,1,1610612743,Denver Nuggets,1,0,22,21,43,13,26,39,35,47,82,31,11,42,15,35,21,4,10,95,114
2023,2,22301226,12/8/2023,1610612742,Dallas Mavericks,0,1,1610612757,Portland Trail Blazers,1,0,35,17,52,12,27,39,47,44,91,19,3,22,12,34,26,9,15,103,125
2023,2,22300549,1/13/2024,1610612762,Utah Jazz,1,1,1610612747,Los Angeles Lakers,0,0,30,26,56,12,25,37,42,51,93,36,3,39,18,35,28,6,10,106,132
2023,2,22300471,1/3/2024,1610612740,New Orleans Pelicans,0,1,1610612750,Minnesota Timberwolves,1,0,33,22,55,12,14,26,45,36,81,15,2,17,12,24,30,7,14,92,117
2023,2,22300672,1/30/2024,1610612741,Chicago Bulls,1,0,1610612761,Toronto Raptors,0,1,27,16,43,11,21,32,38,37,75,20,7,27,8,32,21,10,20,99,107
2015,2,21501003,3/16/2016,1610612738,Boston Celtics,1,0,1610612760,Oklahoma City Thunder,0,1,35,39,74,5,14,19,40,53,93,24,3,27,16,39,17,7,11,99,109
2015,2,21501003,3/16/2016,1610612760,Oklahoma City Thunder,0,1,1610612738,Boston Celtics,1,0,35,32,67,12,17,29,47,49,96,24,6,30,23,30,23,4,10,100,130
2015,2,21501185,4/8/2016,1610612742,Dallas Mavericks,1,1,1610612763,Memphis Grizzlies,0,0,18,11,29,12,19,31,30,30,60,31,8,39,8,28,18,9,19,90,103
2015,2,21501185,4/8/2016,1610612763,Memphis Grizzlies,0,0,1610612742,Dallas Mavericks,1,1,28,37,65,7,15,22,35,52,87,16,6,22,21,34,17,7,15,91,93
2015,2,21501113,3/30/2016,1610612737,Atlanta Hawks,0,0,1610612761,Toronto Raptors,1,1,23,27,50,14,19,33,37,46,83,9,4,13,11,38,24,14,18,94,97
2015,2,21501113,3/30/2016,1610612761,Toronto Raptors,1,1,1610612737,Atlanta Hawks,0,0,25,32,57,11,12,23,36,44,80,22,6,28,10,34,26,3,11,95,105
2014,2,21400712,1/31/2015,1610612749,Milwaukee Bucks,1,1,1610612757,Portland Trail Blazers,0,0,29,32,61,8,13,21,37,45,82,13,1,14,12,34,22,11,20,96,95
2014,2,21400712,1/31/2015,1610612757,Portland Trail Blazers,0,0,1610612749,Milwaukee Bucks,1,1,24,34,58,9,22,31,33,56,89,13,5,18,16,43,19,12,16,98,88
2015,2,21500952,3/9/2016,1610612748,Miami Heat,0,0,1610612749,Milwaukee Bucks,1,1,36,29,65,6,9,15,42,38,80,18,1,19,13,25,23,7,17,95,108
2015,2,21500952,3/9/2016,1610612749,Milwaukee Bucks,1,1,1610612748,Miami Heat,0,0,38,34,72,4,4,8,42,38,80,26,11,37,15,30,27,6,13,95,114
2015,2,21501002,3/15/2016,1610612747,Los Angeles Lakers,1,0,1610612758,Sacramento Kings,0,1,32,26,58,5,21,26,37,47,84,19,7,26,13,38,20,17,22,106,98
2023,2,22300584,1/19/2024,1610612759,San Antonio Spurs,0,0,1610612766,Charlotte Hornets,1,1,32,20,52,15,17,32,47,37,84,11,6,17,9,32,36,9,13,96,120
2023,2,22301226,12/8/2023,1610612757,Portland Trail Blazers,1,0,1610612742,Dallas Mavericks,0,1,21,31,52,18,35,53,39,66,105,16,2,18,26,40,20,8,15,103,112
2023,2,22300564,1/15/2024,1610612762,Utah Jazz,1,1,1610612754,Indiana Pacers,0,0,34,22,56,11,14,25,45,36,81,31,4,35,12,26,29,9,15,101,132
2023,2,22300584,1/19/2024,1610612766,Charlotte Hornets,1,1,1610612759,San Antonio Spurs,0,0,31,24,55,16,13,29,47,37,84,14,2,16,11,27,25,9,18,97,124
2014,2,21400711,1/31/2015,1610612739,Cleveland Cavaliers,0,1,1610612750,Minnesota Timberwolves,1,0,32,23,55,10,22,32,42,45,87,12,7,19,21,24,16,6,13,91,106
2014,2,21400711,1/31/2015,1610612750,Minnesota Timberwolves,1,0,1610612739,Cleveland Cavaliers,0,1,28,41,69,6,7,13,34,48,82,16,5,21,15,37,19,8,12,90,90
2015,2,21501002,3/15/2016,1610612758,Sacramento Kings,0,1,1610612747,Los Angeles Lakers,1,0,34,27,61,4,14,18,38,41,79,26,7,33,7,39,26,10,17,105,106
2015,2,21500738,2/3/2016,1610612751,Brooklyn Nets,1,0,1610612754,Indiana Pacers,0,1,29,29,58,7,16,23,36,45,81,21,10,31,17,34,25,11,17,97,100
2015,2,21500738,2/3/2016,1610612754,Indiana Pacers,0,1,1610612751,Brooklyn Nets,1,0,32,32,64,12,12,24,44,44,88,14,3,17,14,33,23,5,15,97,114
2015,2,21500004,10/28/2015,1610612753,Orlando Magic,1,0,1610612764,Washington Wizards,0,1,32,42,74,5,21,26,37,63,100,8,4,12,25,38,20,8,16,99,87
2015,2,21500004,10/28/2015,1610612764,Washington Wizards,0,1,1610612753,Orlando Magic,1,0,26,30,56,7,21,28,33,51,84,15,10,25,17,39,17,9,18,97,88
2023,2,22300585,1/19/2024,1610612753,Orlando Magic,1,0,1610612755,Philadelphia 76ers,0,1,27,28,55,10,13,23,37,41,78,25,2,27,14,28,24,11,16,93,109
2014,2,21401185,4/10/2015,1610612762,Utah Jazz,1,0,1610612763,Memphis Grizzlies,0,1,20,28,48,11,12,23,31,40,71,15,7,22,14,32,16,8,17,86,88
2014,2,21401185,4/10/2015,1610612763,Memphis Grizzlies,0,1,1610612762,Utah Jazz,1,0,31,30,61,5,10,15,36,40,76,12,7,19,11,33,22,4,11,85,89
2014,2,21400710,1/31/2015,1610612760,Oklahoma City Thunder,0,0,1610612763,Memphis Grizzlies,1,1,21,37,58,6,14,20,27,51,78,14,4,18,16,37,15,11,18,89,74
2014,2,21400710,1/31/2015,1610612763,Memphis Grizzlies,1,1,1610612760,Oklahoma City Thunder,0,0,31,49,80,3,8,11,34,57,91,14,3,17,21,36,22,5,12,89,85
2023,2,22300423,12/28/2023,1610612742,Dallas Mavericks,0,0,1610612750,Minnesota Timberwolves,1,1,26,31,57,14,19,33,40,50,90,16,3,19,17,34,29,9,18,100,110
2021,2,22100175,11/12/2021,1610612738,Boston Celtics,1,1,1610612749,Milwaukee Bucks,0,0,35,20,55,12,29,41,47,49,96,16,2,18,21,29,22,7,17,103,122
2021,2,22100175,11/12/2021,1610612749,Milwaukee Bucks,0,0,1610612738,Boston Celtics,1,1,28,23,51,16,31,47,44,54,98,9,2,11,16,39,23,5,13,102,113
2016,2,21601093,3/26/2017,1610612738,Boston Celtics,1,1,1610612748,Miami Heat,0,0,33,20,53,8,16,24,41,36,77,22,3,25,11,26,32,9,19,96,112
2016,2,21601093,3/26/2017,1610612748,Miami Heat,0,0,1610612738,Boston Celtics,1,1,34,28,62,7,22,29,41,50,91,19,5,24,22,32,19,8,16,97,108
2019,2,21900036,10/27/2019,1610612744,Golden State Warriors,0,0,1610612760,Oklahoma City Thunder,1,1,25,34,59,5,28,33,30,62,92,27,4,31,19,45,17,8,15,104,92
2019,2,21900036,10/27/2019,1610612760,Oklahoma City Thunder,1,1,1610612744,Golden State Warriors,0,0,29,17,46,15,17,32,44,34,78,17,5,22,9,28,24,13,24,103,120
2016,2,21600537,1/5/2017,1610612761,Toronto Raptors,1,1,1610612762,Utah Jazz,0,0,28,42,70,8,13,21,36,55,91,21,7,28,23,36,14,2,4,87,101
2016,2,21600537,1/5/2017,1610612762,Utah Jazz,0,0,1610612761,Toronto Raptors,1,1,27,26,53,7,13,20,34,39,73,18,3,21,15,25,16,10,19,87,93
2014,2,21400709,1/31/2015,1610612745,Houston Rockets,0,0,1610612765,Detroit Pistons,1,1,28,27,55,11,21,32,39,48,87,12,7,19,16,34,23,8,14,93,101
2014,2,21400709,1/31/2015,1610612765,Detroit Pistons,1,1,1610612745,Houston Rockets,0,0,31,26,57,10,15,25,41,41,82,22,13,35,17,30,28,10,13,94,114
2018,2,21800598,1/7/2019,1610612753,Orlando Magic,0,0,1610612758,Sacramento Kings,1,1,19,31,50,13,24,37,32,55,87,18,6,24,7,50,15,11,16,107,95
2018,2,21800598,1/7/2019,1610612758,Sacramento Kings,1,1,1610612753,Orlando Magic,0,0,35,29,64,10,24,34,45,53,98,11,9,20,11,46,24,8,9,107,111
2018,2,21800443,12/17/2018,1610612749,Milwaukee Bucks,0,1,1610612765,Detroit Pistons,1,0,35,28,63,9,16,25,44,44,88,10,5,15,7,38,33,3,11,98,107
2018,2,21800443,12/17/2018,1610612765,Detroit Pistons,1,0,1610612749,Milwaukee Bucks,0,1,25,28,53,14,21,35,39,49,88,12,3,15,14,37,25,8,16,99,104
2018,2,21800373,12/7/2018,1610612741,Chicago Bulls,1,1,1610612760,Oklahoma City Thunder,0,0,31,26,57,12,13,25,43,39,82,16,7,23,7,37,25,12,21,107,114
2018,2,21800373,12/7/2018,1610612760,Oklahoma City Thunder,0,0,1610612741,Chicago Bulls,1,1,33,33,66,10,18,28,43,51,94,16,8,24,20,36,25,15,22,107,112
2018,2,21800254,11/21/2018,1610612737,Atlanta Hawks,1,0,1610612761,Toronto Raptors,0,1,32,25,57,10,26,36,42,51,93,14,4,18,9,44,24,6,9,101,108
2018,2,21800254,11/21/2018,1610612761,Toronto Raptors,0,1,1610612737,Atlanta Hawks,1,0,37,24,61,11,18,29,48,42,90,17,6,23,19,26,33,10,19,100,124
2018,2,21800144,11/5/2018,1610612740,New Orleans Pelicans,0,0,1610612760,Oklahoma City Thunder,1,1,32,23,55,9,20,29,41,43,84,25,5,30,14,32,27,15,21,106,116
2018,2,21800144,11/5/2018,1610612760,Oklahoma City Thunder,1,1,1610612740,New Orleans Pelicans,0,0,35,31,66,10,17,27,45,48,93,22,9,31,14,36,26,8,12,106,122
2019,2,21900257,11/27/2019,1610612755,Philadelphia 76ers,1,1,1610612758,Sacramento Kings,0,0,31,20,51,5,21,26,36,41,77,20,4,24,9,35,20,9,17,99,97
2019,2,21900257,11/27/2019,1610612758,Sacramento Kings,0,0,1610612755,Philadelphia 76ers,1,1,30,31,61,9,25,34,39,56,95,4,5,9,12,46,22,8,11,99,91
2020,2,22000885,4/21/2021,1610612744,Golden State Warriors,0,0,1610612764,Washington Wizards,1,1,25,31,56,15,30,45,40,61,101,19,2,21,15,47,22,12,17,112,114
2020,2,22000885,4/21/2021,1610612764,Washington Wizards,1,1,1610612744,Golden State Warriors,0,0,28,35,63,10,18,28,38,53,91,32,6,38,19,37,23,15,23,113,118
2018,2,21800758,1/30/2019,1610612742,Dallas Mavericks,0,1,1610612752,New York Knicks,1,0,30,16,46,15,23,38,45,39,84,9,2,11,11,30,31,10,19,96,114
2018,2,21800758,1/30/2019,1610612752,New York Knicks,1,0,1610612742,Dallas Mavericks,0,1,26,26,52,6,20,26,32,46,78,20,8,28,7,44,16,4,12,95,90
2018,2,21800310,11/28/2018,1610612741,Chicago Bulls,0,0,1610612749,Milwaukee Bucks,1,1,29,23,52,11,26,37,40,49,89,22,7,29,12,41,28,6,11,102,113
2018,2,21800310,11/28/2018,1610612749,Milwaukee Bucks,1,1,1610612741,Chicago Bulls,0,0,31,21,52,12,23,35,43,44,87,18,6,24,8,40,29,9,12,101,116
2018,2,21800200,11/13/2018,1610612743,Denver Nuggets,1,0,1610612745,Houston Rockets,0,1,27,24,51,11,14,25,38,38,76,12,4,16,12,28,27,7,16,88,99
2018,2,21800200,11/13/2018,1610612745,Houston Rockets,0,1,1610612743,Denver Nuggets,1,0,26,8,34,13,24,37,39,32,71,18,8,26,11,26,23,11,15,87,109
2018,2,21800143,11/5/2018,1610612741,Chicago Bulls,0,1,1610612752,New York Knicks,1,0,35,30,65,8,22,30,43,52,95,22,8,30,13,43,15,7,19,115,116
2018,2,21800143,11/5/2018,1610612752,New York Knicks,1,0,1610612741,Chicago Bulls,0,1,34,46,80,7,19,26,41,65,106,26,3,29,24,43,20,9,18,114,115
2021,2,22100174,11/12/2021,1610612752,New York Knicks,0,0,1610612766,Charlotte Hornets,1,1,23,35,58,13,22,35,36,57,93,11,7,18,20,39,17,10,19,101,96
2021,2,22100174,11/12/2021,1610612766,Charlotte Hornets,1,1,1610612752,New York Knicks,0,0,29,25,54,10,26,36,39,51,90,16,8,24,16,40,25,8,14,100,104
2016,2,21600536,1/5/2017,1610612751,Brooklyn Nets,0,0,1610612754,Indiana Pacers,1,1,24,28,52,17,21,38,41,49,90,10,3,13,11,38,22,7,13,99,109
2016,2,21600536,1/5/2017,1610612754,Indiana Pacers,1,1,1610612751,Brooklyn Nets,0,0,38,33,71,10,12,22,48,45,93,15,4,19,8,40,23,5,6,100,121
2014,2,21401184,4/10/2015,1610612742,Dallas Mavericks,0,1,1610612743,Denver Nuggets,1,0,46,34,80,11,18,29,57,52,109,19,5,24,18,36,39,10,17,121,144
2014,2,21401184,4/10/2015,1610612743,Denver Nuggets,1,0,1610612742,Dallas Mavericks,0,1,38,44,82,15,28,43,53,72,125,22,3,25,34,40,29,8,15,120,143
2014,2,21400708,1/31/2015,1610612737,Atlanta Hawks,1,1,1610612755,Philadelphia 76ers,0,0,24,26,50,10,18,28,34,44,78,13,5,18,11,35,20,7,12,90,91
2014,2,21400708,1/31/2015,1610612755,Philadelphia 76ers,0,0,1610612737,Atlanta Hawks,1,1,17,29,46,14,21,35,31,50,81,9,6,15,15,38,21,6,15,90,85
2018,2,21800983,3/8/2019,1610612740,New Orleans Pelicans,1,0,1610612761,Toronto Raptors,0,1,33,33,66,10,29,39,43,62,105,8,5,13,16,47,28,10,17,111,104
2018,2,21800983,3/8/2019,1610612761,Toronto Raptors,0,1,1610612740,New Orleans Pelicans,1,0,40,22,62,13,24,37,53,46,99,8,1,9,8,38,31,11,16,111,127
2018,2,21800856,2/13/2019,1610612752,New York Knicks,1,0,1610612755,Philadelphia 76ers,0,1,31,40,71,9,20,29,40,60,100,22,5,27,19,44,27,8,12,103,111
2018,2,21800856,2/13/2019,1610612755,Philadelphia 76ers,0,1,1610612752,New York Knicks,1,0,34,21,55,8,15,23,42,36,78,34,9,43,10,32,33,8,15,102,126
2018,2,21800442,12/16/2018,1610612743,Denver Nuggets,1,1,1610612761,Toronto Raptors,0,0,26,29,55,10,20,30,36,49,85,13,3,16,11,40,21,5,9,89,95
2018,2,21800442,12/16/2018,1610612761,Toronto Raptors,0,0,1610612743,Denver Nuggets,1,1,28,25,53,7,28,35,35,53,88,9,5,14,19,36,13,7,12,90,86
2018,2,21800372,12/7/2018,1610612739,Cleveland Cavaliers,1,0,1610612758,Sacramento Kings,0,1,33,22,55,10,16,26,43,38,81,14,5,19,10,30,20,6,18,97,110
2018,2,21800372,12/7/2018,1610612758,Sacramento Kings,0,1,1610612739,Cleveland Cavaliers,1,0,43,26,69,13,16,29,56,42,98,4,3,7,14,30,31,4,9,97,129
2018,2,21800097,10/30/2018,1610612737,Atlanta Hawks,0,0,1610612739,Cleveland Cavaliers,1,1,29,18,47,15,20,35,44,38,82,11,6,17,6,37,25,13,23,106,114
2018,2,21800097,10/30/2018,1610612739,Cleveland Cavaliers,1,1,1610612737,Atlanta Hawks,0,0,32,33,65,13,12,25,45,45,90,33,10,43,16,35,23,6,13,105,136
2021,2,22100173,11/11/2021,1610612746,LA Clippers,1,1,1610612748,Miami Heat,0,0,32,22,54,11,26,37,43,48,91,15,2,17,15,34,20,9,12,99,112
2021,2,22100173,11/11/2021,1610612748,Miami Heat,0,0,1610612746,LA Clippers,1,1,34,22,56,9,32,41,43,54,97,14,3,17,21,34,18,9,15,97,109
2016,2,21601092,3/26/2017,1610612754,Indiana Pacers,1,1,1610612755,Philadelphia 76ers,0,0,31,41,72,7,10,17,38,51,89,24,5,29,14,40,16,7,11,99,107
2016,2,21601092,3/26/2017,1610612755,Philadelphia 76ers,0,0,1610612754,Indiana Pacers,1,1,21,26,47,14,27,41,35,53,88,10,4,14,12,43,19,9,16,99,94
2020,2,22000884,4/21/2021,1610612751,Brooklyn Nets,0,0,1610612761,Toronto Raptors,1,1,23,27,50,13,28,41,36,55,91,18,5,23,17,39,19,7,13,98,103
2020,2,22000884,4/21/2021,1610612761,Toronto Raptors,1,1,1610612751,Brooklyn Nets,0,0,21,22,43,18,29,47,39,51,90,18,3,21,12,41,23,3,11,100,114
2018,2,21801131,3/29/2019,1610612737,Atlanta Hawks,1,0,1610612757,Portland Trail Blazers,0,1,29,27,56,9,29,38,38,56,94,13,1,14,11,46,20,4,10,100,98
2018,2,21801131,3/29/2019,1610612757,Portland Trail Blazers,0,1,1610612737,Atlanta Hawks,1,0,36,28,64,9,23,32,45,51,96,19,3,22,16,37,19,5,9,99,118
2023,2,22301225,12/8/2023,1610612762,Utah Jazz,1,0,1610612746,LA Clippers,0,1,29,24,53,9,22,31,38,46,84,18,6,24,14,34,23,8,16,96,103
2023,2,22300424,12/28/2023,1610612740,New Orleans Pelicans,1,1,1610612762,Utah Jazz,0,0,35,20,55,10,17,27,45,37,82,12,3,15,9,30,27,5,15,94,112
2018,2,21800674,1/18/2019,1610612750,Minnesota Timberwolves,1,0,1610612759,San Antonio Spurs,0,1,30,28,58,7,19,26,37,47,84,32,6,38,16,34,21,3,12,101,113
2018,2,21800674,1/18/2019,1610612759,San Antonio Spurs,0,1,1610612750,Minnesota Timberwolves,1,0,30,28,58,11,13,24,41,41,82,23,6,29,11,34,24,5,16,99,116
2018,2,21800597,1/7/2019,1610612752,New York Knicks,0,0,1610612757,Portland Trail Blazers,1,1,29,37,66,7,16,23,36,53,89,22,5,27,15,41,18,7,11,98,101
2018,2,21800597,1/7/2019,1610612757,Portland Trail Blazers,1,1,1610612752,New York Knicks,0,0,29,25,54,11,20,31,40,45,85,20,9,29,14,36,25,9,15,98,111
2018,2,21800517,12/28/2018,1610612751,Brooklyn Nets,0,0,1610612766,Charlotte Hornets,1,1,29,27,56,4,23,27,33,50,83,17,3,20,11,41,15,4,14,94,87
2018,2,21800517,12/28/2018,1610612766,Charlotte Hornets,1,1,1610612751,Brooklyn Nets,0,0,30,37,67,11,22,33,41,59,100,7,3,10,18,42,19,4,9,96,100
2023,2,22300522,1/10/2024,1610612748,Miami Heat,1,0,1610612760,Oklahoma City Thunder,0,1,26,27,53,15,21,36,41,48,89,23,5,28,13,38,25,4,10,99,120
2023,2,22300603,1/21/2024,1610612738,Boston Celtics,0,1,1610612745,Houston Rockets,1,0,26,25,51,17,30,47,43,55,98,13,5,18,19,38,31,9,16,104,116
2023,2,22300567,1/16/2024,1610612756,Phoenix Suns,1,1,1610612758,Sacramento Kings,0,0,25,23,48,17,20,37,42,43,85,18,2,20,13,30,32,7,20,103,119
2018,2,21800098,10/30/2018,1610612753,Orlando Magic,1,0,1610612758,Sacramento Kings,0,1,25,23,48,11,32,43,36,55,91,16,6,22,16,44,28,8,17,104,99
2018,2,21800098,10/30/2018,1610612758,Sacramento Kings,0,1,1610612753,Orlando Magic,1,0,33,29,62,8,14,22,41,43,84,17,9,26,9,40,22,10,15,104,107
2021,2,22100172,11/11/2021,1610612754,Indiana Pacers,0,1,1610612762,Utah Jazz,1,0,32,33,65,11,20,31,43,53,96,14,5,19,20,35,19,6,13,100,111
2021,2,22100172,11/11/2021,1610612762,Utah Jazz,1,0,1610612754,Indiana Pacers,0,1,30,21,51,9,23,32,39,44,83,13,10,23,8,41,22,7,12,98,100
2016,2,21600103,11/8/2016,1610612756,Phoenix Suns,0,0,1610612757,Portland Trail Blazers,1,1,36,29,65,7,14,21,43,43,86,28,5,33,17,28,18,5,16,102,121
2016,2,21600103,11/8/2016,1610612757,Portland Trail Blazers,1,1,1610612756,Phoenix Suns,0,0,31,19,50,14,17,31,45,36,81,20,8,28,12,30,22,10,20,101,124
2014,2,21400707,1/31/2015,1610612761,Toronto Raptors,0,1,1610612764,Washington Wizards,1,0,33,29,62,11,15,26,44,44,88,21,9,30,14,32,26,8,14,102,120
2014,2,21400707,1/31/2015,1610612764,Washington Wizards,1,0,1610612761,Toronto Raptors,0,1,27,28,55,10,14,24,37,42,79,32,9,41,14,31,26,7,22,104,116
2018,2,21801130,3/29/2019,1610612738,Boston Celtics,1,1,1610612754,Indiana Pacers,0,0,31,28,59,13,14,27,44,42,86,13,4,17,11,32,27,9,14,96,114
2018,2,21801130,3/29/2019,1610612754,Indiana Pacers,0,0,1610612738,Boston Celtics,1,1,30,33,63,12,15,27,42,48,90,16,7,23,16,38,27,8,12,96,112
2018,2,21800982,3/8/2019,1610612762,Utah Jazz,0,0,1610612763,Memphis Grizzlies,1,1,17,17,34,18,30,48,35,47,82,16,8,24,11,39,21,5,13,96,104
2018,2,21800982,3/8/2019,1610612763,Memphis Grizzlies,1,1,1610612762,Utah Jazz,0,0,37,31,68,9,13,22,46,44,90,13,2,15,12,32,31,8,11,95,114
2018,2,21800855,2/13/2019,1610612738,Boston Celtics,1,1,1610612765,Detroit Pistons,0,0,29,20,49,16,23,39,45,43,88,12,3,15,13,32,32,7,16,101,118
2018,2,21800855,2/13/2019,1610612765,Detroit Pistons,0,0,1610612738,Boston Celtics,1,1,23,21,44,13,27,40,36,48,84,25,9,34,11,40,19,8,11,101,110
2018,2,21800757,1/30/2019,1610612741,Chicago Bulls,0,1,1610612748,Miami Heat,1,0,32,27,59,8,11,19,40,38,78,17,4,21,7,34,26,6,13,92,105
2018,2,21800757,1/30/2019,1610612748,Miami Heat,1,0,1610612741,Chicago Bulls,0,1,22,25,47,12,30,42,34,55,89,9,4,13,18,38,22,6,15,91,89
2018,2,21800673,1/18/2019,1610612751,Brooklyn Nets,0,1,1610612753,Orlando Magic,1,0,25,26,51,19,27,46,44,53,97,10,5,15,15,40,24,5,11,100,117
2018,2,21800673,1/18/2019,1610612753,Orlando Magic,1,0,1610612751,Brooklyn Nets,0,1,37,31,68,10,16,26,47,47,94,11,3,14,14,33,26,5,13,99,115
2018,2,21800253,11/21/2018,1610612740,New Orleans Pelicans,0,0,1610612755,Philadelphia 76ers,1,1,31,37,68,11,19,30,42,56,98,25,8,33,24,38,24,7,15,105,120
2018,2,21800253,11/21/2018,1610612755,Philadelphia 76ers,1,1,1610612740,New Orleans Pelicans,0,0,34,35,69,10,19,29,44,54,98,23,3,26,18,37,27,8,16,105,121
2021,2,22100171,11/11/2021,1610612755,Philadelphia 76ers,1,0,1610612761,Toronto Raptors,0,1,29,25,54,11,23,34,40,48,88,18,1,19,13,35,29,10,12,95,109
2021,2,22100171,11/11/2021,1610612761,Toronto Raptors,0,1,1610612755,Philadelphia 76ers,1,0,28,35,63,14,19,33,42,54,96,17,0,17,21,33,25,8,12,96,115
2016,2,21601091,3/26/2017,1610612745,Houston Rockets,1,1,1610612760,Oklahoma City Thunder,0,0,30,10,40,20,19,39,50,29,79,17,4,21,4,27,32,15,20,105,137
2016,2,21601091,3/26/2017,1610612760,Oklahoma City Thunder,0,0,1610612745,Houston Rockets,1,1,36,28,64,11,19,30,47,47,94,20,8,28,17,35,27,8,16,105,125
2023,2,22300603,1/21/2024,1610612745,Houston Rockets,1,0,1610612738,Boston Celtics,0,1,31,28,59,10,25,35,41,53,94,15,7,22,15,41,26,10,15,104,107
2019,2,21900035,10/26/2019,1610612746,LA Clippers,0,0,1610612756,Phoenix Suns,1,1,29,26,55,11,21,32,40,47,87,31,8,39,12,40,20,9,12,104,122
2019,2,21900035,10/26/2019,1610612756,Phoenix Suns,1,1,1610612746,LA Clippers,0,0,26,17,43,17,26,43,43,43,86,27,7,34,13,34,32,8,16,103,130
2020,2,22000883,4/21/2021,1610612755,Philadelphia 76ers,1,0,1610612756,Phoenix Suns,0,1,28,27,55,13,12,25,41,39,80,18,8,26,19,24,24,7,17,90,113
2020,2,22000883,4/21/2021,1610612756,Phoenix Suns,0,1,1610612755,Philadelphia 76ers,1,0,26,18,44,15,27,42,41,45,86,19,2,21,16,30,30,7,10,88,116
2016,2,21600535,1/4/2017,1610612748,Miami Heat,0,1,1610612758,Sacramento Kings,1,0,23,21,44,12,16,28,35,37,72,25,4,29,11,26,24,8,19,96,107
2016,2,21600535,1/4/2017,1610612758,Sacramento Kings,1,0,1610612748,Miami Heat,0,1,32,26,58,8,12,20,40,38,78,14,3,17,7,33,26,8,17,96,102
2023,2,22300523,1/10/2024,1610612741,Chicago Bulls,1,1,1610612745,Houston Rockets,0,0,23,25,48,19,28,47,42,53,95,21,4,25,12,42,31,9,14,110,124
2018,2,21800981,3/8/2019,1610612745,Houston Rockets,1,1,1610612755,Philadelphia 76ers,0,0,29,15,44,13,28,41,42,43,85,10,5,15,9,38,22,9,17,100,107
2018,2,21800981,3/8/2019,1610612755,Philadelphia 76ers,0,0,1610612745,Houston Rockets,1,1,32,37,69,3,23,26,35,60,95,18,5,23,24,39,20,13,18,100,91
2018,2,21800516,12/27/2018,1610612744,Golden State Warriors,1,0,1610612757,Portland Trail Blazers,0,1,32,30,62,13,31,44,45,61,106,6,9,15,19,45,36,7,15,112,109
2018,2,21800516,12/27/2018,1610612757,Portland Trail Blazers,0,1,1610612744,Golden State Warriors,1,0,25,40,65,13,27,40,38,67,105,21,2,23,19,49,20,10,15,112,110
2018,2,21800441,12/16/2018,1610612740,New Orleans Pelicans,1,0,1610612748,Miami Heat,0,1,22,28,50,13,23,36,35,51,86,13,4,17,15,37,26,7,12,90,96
2018,2,21800441,12/16/2018,1610612748,Miami Heat,0,1,1610612740,New Orleans Pelicans,1,0,28,28,56,10,25,35,38,53,91,16,7,23,29,28,22,11,18,89,102
2023,2,22300521,1/10/2024,1610612737,Atlanta Hawks,1,1,1610612755,Philadelphia 76ers,0,0,36,32,68,12,22,34,48,54,102,31,11,42,21,40,32,8,13,112,139
2023,2,22300515,1/9/2024,1610612742,Dallas Mavericks,1,0,1610612763,Memphis Grizzlies,0,1,27,28,55,9,18,27,36,46,82,22,5,27,9,38,20,7,13,98,103
2023,2,22300564,1/15/2024,1610612754,Indiana Pacers,0,0,1610612762,Utah Jazz,1,1,29,35,64,9,22,31,38,57,95,20,5,25,21,39,27,5,14,101,105
2023,2,22301225,12/8/2023,1610612746,LA Clippers,0,1,1610612762,Utah Jazz,1,0,28,26,54,15,19,34,43,45,88,16,5,21,12,35,23,10,14,97,117
2023,2,22300468,1/3/2024,1610612752,New York Knicks,1,1,1610612741,Chicago Bulls,0,0,31,20,51,15,23,38,46,43,89,9,2,11,16,29,29,9,16,93,116
2023,2,22300482,1/5/2024,1610612764,Washington Wizards,0,0,1610612739,Cleveland Cavaliers,1,1,26,28,54,9,21,30,35,49,84,11,4,15,10,41,19,9,17,98,90
2023,2,22300521,1/10/2024,1610612755,Philadelphia 76ers,0,0,1610612737,Atlanta Hawks,1,1,34,34,68,12,22,34,46,56,102,28,5,33,18,40,26,6,11,111,132
2023,2,22300322,12/14/2023,1610612751,Brooklyn Nets,0,0,1610612743,Denver Nuggets,1,1,31,34,65,8,22,30,39,56,95,15,5,20,19,39,28,13,16,101,101
2023,2,22300530,1/11/2024,1610612742,Dallas Mavericks,1,1,1610612752,New York Knicks,0,0,27,20,47,17,24,41,44,44,88,23,7,30,13,34,27,7,10,99,128
2023,2,22300494,1/6/2024,1610612764,Washington Wizards,1,0,1610612752,New York Knicks,0,1,27,21,48,13,24,37,40,45,85,12,8,20,13,36,33,9,20,100,105
2023,2,22300462,1/2/2024,1610612738,Boston Celtics,0,0,1610612760,Oklahoma City Thunder,1,1,27,25,52,15,25,40,42,50,92,24,5,29,22,30,33,7,14,99,123
2023,2,22300372,12/20/2023,1610612746,LA Clippers,0,1,1610612742,Dallas Mavericks,1,0,32,14,46,11,20,31,43,34,77,23,2,25,9,26,27,8,14,92,120
2023,2,22300525,1/10/2024,1610612740,New Orleans Pelicans,0,1,1610612744,Golden State Warriors,1,0,35,19,54,19,21,40,54,40,94,14,5,19,15,29,37,4,11,98,141
2023,2,22300604,1/21/2024,1610612756,Phoenix Suns,1,1,1610612754,Indiana Pacers,0,0,39,18,57,8,17,25,47,35,82,15,3,18,10,27,25,9,17,98,117
2023,2,22300554,1/14/2024,1610612757,Portland Trail Blazers,1,0,1610612756,Phoenix Suns,0,1,20,27,47,20,22,42,40,49,89,16,6,22,18,35,23,7,14,95,116
2023,2,22300610,1/22/2024,1610612750,Minnesota Timberwolves,1,0,1610612766,Charlotte Hornets,0,1,26,17,43,18,23,41,44,40,84,19,6,25,11,30,34,8,13,100,125
2023,2,22300524,1/10/2024,1610612743,Denver Nuggets,0,0,1610612762,Utah Jazz,1,1,24,24,48,13,20,33,37,44,81,24,4,28,12,34,26,12,16,100,111
2023,2,22300568,1/16/2024,1610612746,LA Clippers,1,1,1610612760,Oklahoma City Thunder,0,0,27,17,44,20,23,43,47,40,87,14,9,23,15,28,30,5,10,92,128
2023,2,22300524,1/10/2024,1610612762,Utah Jazz,1,1,1610612743,Denver Nuggets,0,0,33,17,50,13,20,33,46,37,83,19,4,23,12,27,34,11,17,100,124
2023,2,22300364,12/20/2023,1610612762,Utah Jazz,0,0,1610612739,Cleveland Cavaliers,1,1,27,21,48,13,17,30,40,38,78,23,5,28,10,30,24,8,16,97,116
2023,2,22300483,1/5/2024,1610612755,Philadelphia 76ers,1,0,1610612752,New York Knicks,0,1,27,31,58,6,17,23,33,48,81,20,7,27,10,41,22,7,14,98,92
2021,2,22100170,11/10/2021,1610612747,Los Angeles Lakers,1,1,1610612748,Miami Heat,0,0,28,26,54,18,20,38,46,46,92,10,6,16,13,37,26,14,23,111,120
2023,2,22300424,12/28/2023,1610612762,Utah Jazz,0,0,1610612740,New Orleans Pelicans,1,1,24,22,46,12,27,39,36,49,85,21,4,25,22,29,27,10,19,95,105
2023,2,22300523,1/10/2024,1610612745,Houston Rockets,0,0,1610612741,Chicago Bulls,1,1,37,19,56,11,34,45,48,53,101,12,8,20,14,43,29,9,14,112,119
2023,2,22300529,1/11/2024,1610612760,Oklahoma City Thunder,1,1,1610612757,Portland Trail Blazers,0,0,39,19,58,14,21,35,53,40,93,19,3,22,13,29,41,8,13,101,139
2023,2,22300464,1/2/2024,1610612766,Charlotte Hornets,0,1,1610612758,Sacramento Kings,1,0,30,18,48,12,22,34,42,40,82,15,4,19,5,37,23,8,15,99,111
2023,2,22300567,1/16/2024,1610612758,Sacramento Kings,0,0,1610612756,Phoenix Suns,1,1,28,24,52,18,22,40,46,46,92,7,5,12,9,41,34,7,14,103,117
2023,2,22300697,2/2/2024,1610612757,Portland Trail Blazers,0,0,1610612743,Denver Nuggets,1,1,27,25,52,10,18,28,37,43,80,24,6,30,15,33,14,3,10,89,108
2023,2,22300516,1/9/2024,1610612761,Toronto Raptors,0,0,1610612747,Los Angeles Lakers,1,1,36,23,59,17,18,35,53,41,94,8,5,13,7,36,34,6,12,105,131
2021,2,22100170,11/10/2021,1610612748,Miami Heat,0,0,1610612747,Los Angeles Lakers,1,1,30,29,59,10,27,37,40,56,96,27,8,35,15,45,26,5,14,111,117
2023,2,22300368,12/20/2023,1610612751,Brooklyn Nets,1,0,1610612752,New York Knicks,0,1,22,32,54,15,32,47,37,64,101,13,4,17,21,46,25,8,11,100,102
2023,2,22300483,1/5/2024,1610612752,New York Knicks,0,1,1610612755,Philadelphia 76ers,1,0,25,23,48,18,23,41,43,46,89,24,1,25,15,31,27,8,13,98,128
2023,2,22300423,12/28/2023,1610612750,Minnesota Timberwolves,1,1,1610612742,Dallas Mavericks,0,0,21,20,41,17,16,33,38,36,74,25,9,34,12,29,23,9,22,101,118
2023,2,22300322,12/14/2023,1610612743,Denver Nuggets,1,1,1610612751,Brooklyn Nets,0,0,35,28,63,12,24,36,47,52,99,18,3,21,17,37,31,5,9,102,124
2023,2,22300464,1/2/2024,1610612758,Sacramento Kings,1,0,1610612766,Charlotte Hornets,0,1,26,30,56,14,22,36,40,52,92,10,7,17,21,35,23,8,21,101,104
2023,2,22300473,1/3/2024,1610612756,Phoenix Suns,1,0,1610612746,LA Clippers,0,1,27,17,44,15,20,35,42,37,79,23,3,26,12,27,23,9,17,93,122
2023,2,22300518,1/10/2024,1610612766,Charlotte Hornets,1,0,1610612758,Sacramento Kings,0,1,19,30,49,16,22,38,35,52,87,12,4,16,11,41,17,2,10,94,98
2019,2,21900034,10/26/2019,1610612758,Sacramento Kings,0,0,1610612762,Utah Jazz,1,1,23,32,55,7,19,26,30,51,81,14,3,17,10,42,16,6,18,98,81
2019,2,21900034,10/26/2019,1610612762,Utah Jazz,1,1,1610612758,Sacramento Kings,0,0,26,15,41,18,19,37,44,34,78,7,5,12,8,29,28,5,21,98,113
2023,2,22300672,1/30/2024,1610612761,Toronto Raptors,0,1,1610612741,Chicago Bulls,1,0,29,25,54,14,15,29,43,40,83,18,2,20,15,27,34,9,20,99,118
2023,2,22300329,12/15/2023,1610612738,Boston Celtics,1,1,1610612753,Orlando Magic,0,0,30,20,50,18,24,42,48,44,92,14,6,20,14,34,31,5,11,98,128
2023,2,22300530,1/11/2024,1610612752,New York Knicks,0,0,1610612742,Dallas Mavericks,1,1,30,17,47,14,28,42,44,45,89,22,6,28,18,30,27,6,16,99,124
2023,2,22300580,1/18/2024,1610612761,Toronto Raptors,1,0,1610612741,Chicago Bulls,0,1,32,13,45,10,28,38,42,41,83,16,4,20,10,35,31,7,14,97,110
2023,2,22300493,1/6/2024,1610612754,Indiana Pacers,1,0,1610612738,Boston Celtics,0,1,30,20,50,8,34,42,38,54,92,17,5,22,11,47,23,6,9,100,101
2023,2,22300605,1/21/2024,1610612747,Los Angeles Lakers,1,1,1610612757,Portland Trail Blazers,0,0,34,19,53,13,20,33,47,39,86,27,2,29,14,26,28,7,14,100,134
2023,2,22300580,1/18/2024,1610612741,Chicago Bulls,0,1,1610612761,Toronto Raptors,1,0,42,25,67,6,18,24,48,43,91,14,3,17,15,31,30,7,12,96,116
2023,2,22300604,1/21/2024,1610612754,Indiana Pacers,0,0,1610612756,Phoenix Suns,1,1,27,36,63,14,17,31,41,53,94,14,9,23,18,40,28,7,11,98,110
2023,2,22300611,1/22/2024,1610612738,Boston Celtics,0,1,1610612742,Dallas Mavericks,1,0,26,16,42,15,31,46,41,47,88,22,8,30,9,40,26,4,6,99,119
2023,2,22300516,1/9/2024,1610612747,Los Angeles Lakers,1,1,1610612761,Toronto Raptors,0,0,28,17,45,16,20,36,44,37,81,28,8,36,8,33,34,8,15,103,132
2023,2,22300629,1/25/2024,1610612751,Brooklyn Nets,1,0,1610612750,Minnesota Timberwolves,0,1,25,19,44,10,23,33,35,42,77,14,2,16,8,35,22,6,15,91,94
2023,2,22300422,12/28/2023,1610612754,Indiana Pacers,0,1,1610612741,Chicago Bulls,1,0,24,19,43,19,23,42,43,42,85,15,7,22,10,36,30,7,14,99,120
2023,2,22300422,12/28/2023,1610612741,Chicago Bulls,1,0,1610612754,Indiana Pacers,0,1,33,37,70,7,20,27,40,57,97,17,5,22,18,43,19,6,8,99,104
2023,2,22300480,1/5/2024,1610612737,Atlanta Hawks,0,0,1610612754,Indiana Pacers,1,1,30,21,51,10,32,42,40,53,93,26,4,30,16,39,21,12,14,104,116
2023,2,22300366,12/20/2023,1610612753,Orlando Magic,1,0,1610612748,Miami Heat,0,1,32,21,53,9,27,36,41,48,89,15,4,19,18,32,29,6,12,94,106
2021,2,22100169,11/10/2021,1610612744,Golden State Warriors,1,1,1610612750,Minnesota Timberwolves,0,0,29,16,45,11,29,40,40,45,85,32,8,40,23,24,23,8,16,99,123
2021,2,22100169,11/10/2021,1610612750,Minnesota Timberwolves,0,0,1610612744,Golden State Warriors,1,1,22,29,51,17,27,44,39,56,95,15,5,20,22,36,30,14,17,99,110
2023,2,22300463,1/2/2024,1610612753,Orlando Magic,0,0,1610612744,Golden State Warriors,1,1,27,29,56,14,22,36,41,51,92,19,4,23,22,30,19,9,18,98,115
2019,2,21900256,11/27/2019,1610612754,Indiana Pacers,1,1,1610612762,Utah Jazz,0,0,42,32,74,8,14,22,50,46,96,13,3,16,16,30,23,7,12,100,121
2019,2,21900256,11/27/2019,1610612762,Utah Jazz,0,0,1610612754,Indiana Pacers,1,1,26,25,51,10,22,32,36,47,83,20,5,25,11,36,19,8,16,100,102
2014,2,21401183,4/10/2015,1610612758,Sacramento Kings,0,0,1610612760,Oklahoma City Thunder,1,1,28,29,57,9,15,24,37,44,81,20,8,28,14,32,19,8,16,96,103
2014,2,21401183,4/10/2015,1610612760,Oklahoma City Thunder,1,1,1610612758,Sacramento Kings,0,0,34,32,66,10,21,31,44,53,97,18,6,24,18,39,21,4,7,96,116
2020,2,22000882,4/21/2021,1610612754,Indiana Pacers,1,1,1610612760,Oklahoma City Thunder,0,0,32,29,61,14,26,40,46,55,101,16,4,20,16,40,30,8,11,105,122
2020,2,22000882,4/21/2021,1610612760,Oklahoma City Thunder,0,0,1610612754,Indiana Pacers,1,1,39,36,75,9,20,29,48,56,104,11,5,16,24,34,26,13,17,106,116
2023,2,22300533,1/12/2024,1610612737,Atlanta Hawks,1,0,1610612754,Indiana Pacers,0,1,29,30,59,11,19,30,40,49,89,17,6,23,15,37,25,12,15,99,108
2016,2,21600102,11/8/2016,1610612743,Denver Nuggets,0,0,1610612763,Memphis Grizzlies,1,1,25,21,46,10,14,24,35,35,70,27,7,34,13,24,24,14,22,96,107
2016,2,21600102,11/8/2016,1610612763,Memphis Grizzlies,1,1,1610612743,Denver Nuggets,0,0,37,25,62,7,17,24,44,42,86,13,6,19,12,34,29,6,14,96,108
2014,2,21400706,1/31/2015,1610612742,Dallas Mavericks,0,1,1610612753,Orlando Magic,1,0,31,22,53,11,10,21,42,32,74,13,9,22,5,32,26,9,12,91,108
2014,2,21400706,1/31/2015,1610612753,Orlando Magic,1,0,1610612742,Dallas Mavericks,0,1,25,29,54,8,16,24,33,45,78,19,5,24,14,33,21,9,15,92,93
2018,2,21800854,2/13/2019,1610612749,Milwaukee Bucks,0,1,1610612754,Indiana Pacers,1,0,29,26,55,9,22,31,38,48,86,21,8,29,12,41,22,6,10,98,106
2018,2,21800854,2/13/2019,1610612754,Indiana Pacers,1,0,1610612749,Milwaukee Bucks,0,1,27,34,61,10,17,27,37,51,88,13,2,15,8,43,22,7,11,98,97
2019,2,21900255,11/27/2019,1610612739,Cleveland Cavaliers,1,0,1610612753,Orlando Magic,0,1,26,21,47,11,23,34,37,44,81,19,3,22,14,30,20,13,25,103,104
2019,2,21900255,11/27/2019,1610612753,Orlando Magic,0,1,1610612739,Cleveland Cavaliers,1,0,33,27,60,12,21,33,45,48,93,14,3,17,10,39,23,5,11,103,116
2014,2,21400705,1/31/2015,1610612754,Indiana Pacers,1,0,1610612758,Sacramento Kings,0,1,28,27,55,5,20,25,33,47,80,23,2,25,10,37,22,8,15,98,94
2023,2,22300533,1/12/2024,1610612754,Indiana Pacers,0,1,1610612737,Atlanta Hawks,1,0,42,19,61,11,7,18,53,26,79,9,3,12,12,16,41,14,27,98,126
2014,2,21400705,1/31/2015,1610612758,Sacramento Kings,0,1,1610612754,Indiana Pacers,1,0,29,36,65,5,10,15,34,46,80,26,3,29,11,36,16,8,14,97,99
2018,2,21801129,3/28/2019,1610612739,Cleveland Cavaliers,0,0,1610612759,San Antonio Spurs,1,1,33,30,63,12,17,29,45,47,92,8,2,10,18,30,18,8,14,96,110
2018,2,21801129,3/28/2019,1610612759,San Antonio Spurs,1,1,1610612739,Cleveland Cavaliers,0,0,31,21,52,14,19,33,45,40,85,12,5,17,8,35,27,6,11,95,116
2023,2,22300528,1/11/2024,1610612738,Boston Celtics,0,0,1610612749,Milwaukee Bucks,1,1,25,31,56,9,26,35,34,57,91,25,5,30,14,45,22,3,6,99,102
2018,2,21800756,1/30/2019,1610612738,Boston Celtics,1,1,1610612766,Charlotte Hornets,0,0,38,23,61,12,17,29,50,40,90,14,2,16,16,25,34,7,12,94,126
2018,2,21800756,1/30/2019,1610612766,Charlotte Hornets,0,0,1610612738,Boston Celtics,1,1,26,23,49,13,27,40,39,50,89,3,4,7,11,41,20,10,12,94,94
2018,2,21800596,1/7/2019,1610612742,Dallas Mavericks,1,0,1610612747,Los Angeles Lakers,0,1,28,28,56,8,22,30,36,50,86,17,7,24,17,36,12,12,19,100,97
2018,2,21800596,1/7/2019,1610612747,Los Angeles Lakers,0,1,1610612742,Dallas Mavericks,1,0,33,32,65,8,21,29,41,53,94,17,10,27,18,42,28,10,14,101,107
2023,2,22300368,12/20/2023,1610612752,New York Knicks,0,1,1610612751,Brooklyn Nets,1,0,31,31,62,13,20,33,44,51,95,20,5,25,19,35,24,6,11,99,121
2018,2,21800371,12/7/2018,1610612751,Brooklyn Nets,1,1,1610612761,Toronto Raptors,0,0,32,31,63,11,24,35,43,55,98,9,4,13,18,39,22,9,20,106,106
2018,2,21800371,12/7/2018,1610612761,Toronto Raptors,0,0,1610612751,Brooklyn Nets,1,1,24,30,54,11,24,35,35,54,89,24,5,29,10,46,25,8,15,106,105
2018,2,21800309,11/28/2018,1610612742,Dallas Mavericks,0,1,1610612745,Houston Rockets,1,0,29,22,51,17,17,34,46,39,85,19,5,24,17,23,27,10,15,94,128
2018,2,21800309,11/28/2018,1610612745,Houston Rockets,1,0,1610612742,Dallas Mavericks,0,1,27,15,42,13,32,45,40,47,87,15,8,23,21,30,28,10,18,94,108
2023,2,22300472,1/3/2024,1610612757,Portland Trail Blazers,0,0,1610612742,Dallas Mavericks,1,1,21,26,47,13,27,40,34,53,87,16,6,22,16,40,23,12,22,103,97
2021,2,22100168,11/10/2021,1610612756,Phoenix Suns,1,1,1610612757,Portland Trail Blazers,0,0,38,28,66,11,17,28,49,45,94,10,2,12,13,33,27,5,11,100,119
2021,2,22100168,11/10/2021,1610612757,Portland Trail Blazers,0,0,1610612756,Phoenix Suns,1,1,37,24,61,7,23,30,44,47,91,14,2,16,17,32,24,6,16,99,109
2016,2,21601090,3/26/2017,1610612741,Chicago Bulls,0,1,1610612749,Milwaukee Bucks,1,0,36,28,64,10,11,21,46,39,85,7,3,10,13,27,33,8,15,92,109
2016,2,21601090,3/26/2017,1610612749,Milwaukee Bucks,1,0,1610612741,Chicago Bulls,0,1,30,31,61,7,16,23,37,47,84,13,4,17,10,39,20,4,10,93,94
2020,2,22000881,4/21/2021,1610612739,Cleveland Cavaliers,1,1,1610612741,Chicago Bulls,0,0,29,23,52,16,20,36,45,43,88,15,4,19,10,36,27,6,12,98,121
2020,2,22000881,4/21/2021,1610612741,Chicago Bulls,0,0,1610612739,Cleveland Cavaliers,1,1,26,16,42,13,24,37,39,40,79,14,4,18,10,34,27,8,20,99,105
2018,2,21801128,3/28/2019,1610612740,New Orleans Pelicans,1,1,1610612758,Sacramento Kings,0,0,40,29,69,9,19,28,49,48,97,14,0,14,10,38,27,6,12,105,121
2018,2,21801128,3/28/2019,1610612758,Sacramento Kings,0,0,1610612740,New Orleans Pelicans,1,1,37,35,72,10,13,23,47,48,95,14,2,16,9,40,28,6,12,106,118
2018,2,21800980,3/8/2019,1610612741,Chicago Bulls,1,0,1610612765,Detroit Pistons,0,1,37,28,65,5,12,17,42,40,82,15,8,23,9,36,20,5,16,99,104
2018,2,21800980,3/8/2019,1610612765,Detroit Pistons,0,1,1610612741,Chicago Bulls,1,0,36,20,56,9,18,27,45,38,83,13,8,21,12,30,23,9,17,99,112
2016,2,21600101,11/8/2016,1610612750,Minnesota Timberwolves,0,0,1610612751,Brooklyn Nets,1,1,27,37,64,12,16,28,39,53,92,20,8,28,19,38,20,5,17,103,110
2016,2,21600101,11/8/2016,1610612751,Brooklyn Nets,1,1,1610612750,Minnesota Timberwolves,0,0,30,13,43,12,21,33,42,34,76,23,3,26,7,29,20,11,21,102,119
2014,2,21400704,1/30/2015,1610612741,Chicago Bulls,0,0,1610612756,Phoenix Suns,1,1,32,37,69,4,14,18,36,51,87,17,10,27,15,42,20,7,12,97,93
2014,2,21400704,1/30/2015,1610612756,Phoenix Suns,1,1,1610612741,Chicago Bulls,0,0,33,35,68,6,16,22,39,51,90,15,2,17,14,39,16,6,13,97,99
2018,2,21800515,12/27/2018,1610612755,Philadelphia 76ers,0,1,1610612762,Utah Jazz,1,0,30,21,51,13,22,35,43,43,86,15,3,18,10,35,31,11,13,98,114
2018,2,21800515,12/27/2018,1610612762,Utah Jazz,1,0,1610612755,Philadelphia 76ers,0,1,22,29,51,11,24,35,33,53,86,20,7,27,17,38,19,7,16,98,97
2023,2,22300366,12/20/2023,1610612748,Miami Heat,0,1,1610612753,Orlando Magic,1,0,25,29,54,15,14,29,40,43,83,20,4,24,11,34,25,8,11,94,115
2023,2,22300519,1/10/2024,1610612765,Detroit Pistons,1,0,1610612759,San Antonio Spurs,0,1,34,30,64,10,22,32,44,52,96,10,3,13,16,37,33,7,9,96,108
2023,2,22300463,1/2/2024,1610612744,Golden State Warriors,1,1,1610612753,Orlando Magic,0,0,29,14,43,13,22,35,42,36,78,24,13,37,11,28,23,8,12,96,121
2023,2,22300525,1/10/2024,1610612744,Golden State Warriors,1,0,1610612740,New Orleans Pelicans,0,1,27,23,50,12,27,39,39,50,89,15,3,18,17,35,24,11,17,98,105
2016,2,21601089,3/26/2017,1610612746,LA Clippers,1,0,1610612758,Sacramento Kings,0,1,22,27,49,10,19,29,32,46,78,23,5,28,9,41,20,5,10,93,97
2016,2,21601089,3/26/2017,1610612758,Sacramento Kings,0,1,1610612746,LA Clippers,1,0,25,31,56,13,15,28,38,46,84,9,4,13,9,40,23,7,12,93,98
2016,2,21600534,1/4/2017,1610612744,Golden State Warriors,1,1,1610612757,Portland Trail Blazers,0,0,31,20,51,13,23,36,44,43,87,24,5,29,11,35,31,8,15,103,125
2016,2,21600534,1/4/2017,1610612757,Portland Trail Blazers,0,0,1610612744,Golden State Warriors,1,1,28,35,63,12,14,26,40,49,89,25,3,28,16,33,23,14,17,104,117
2018,2,21800672,1/18/2019,1610612748,Miami Heat,0,0,1610612765,Detroit Pistons,1,1,29,19,48,10,19,29,39,38,77,5,14,19,11,35,25,7,19,95,93
2018,2,21800672,1/18/2019,1610612765,Detroit Pistons,1,1,1610612748,Miami Heat,0,0,22,27,49,13,20,33,35,47,82,15,3,18,9,40,23,3,12,93,98
2018,2,21800595,1/7/2019,1610612740,New Orleans Pelicans,1,1,1610612763,Memphis Grizzlies,0,0,38,24,62,6,11,17,44,35,79,20,9,29,8,33,27,5,14,95,114
2018,2,21800595,1/7/2019,1610612763,Memphis Grizzlies,0,0,1610612740,New Orleans Pelicans,1,1,25,23,48,10,20,30,35,43,78,15,3,18,9,36,28,13,18,96,95
2023,2,22300519,1/10/2024,1610612759,San Antonio Spurs,0,1,1610612765,Detroit Pistons,1,0,40,27,67,9,18,27,49,45,94,23,4,27,14,34,36,4,6,96,130
2023,2,22300515,1/9/2024,1610612763,Memphis Grizzlies,0,1,1610612742,Dallas Mavericks,1,0,30,24,54,14,23,37,44,47,91,18,3,21,21,28,27,9,17,98,120
2021,2,22100167,11/10/2021,1610612743,Denver Nuggets,1,1,1610612754,Indiana Pacers,0,0,24,30,54,12,18,30,36,48,84,17,3,20,13,38,19,5,10,90,101
2021,2,22100167,11/10/2021,1610612754,Indiana Pacers,0,0,1610612743,Denver Nuggets,1,1,29,24,53,11,20,31,40,44,84,7,4,11,15,31,22,5,15,91,98
2014,2,21400703,1/30/2015,1610612744,Golden State Warriors,0,0,1610612762,Utah Jazz,1,1,29,30,59,8,19,27,37,49,86,18,7,25,12,40,21,10,13,99,100
2014,2,21400703,1/30/2015,1610612762,Utah Jazz,1,1,1610612744,Golden State Warriors,0,0,33,36,69,9,16,25,42,52,94,17,11,28,24,33,21,8,14,99,110
2020,2,22000880,4/20/2021,1610612750,Minnesota Timberwolves,0,1,1610612758,Sacramento Kings,1,0,33,14,47,18,25,43,51,39,90,14,5,19,13,27,34,10,18,102,134
2020,2,22000880,4/20/2021,1610612758,Sacramento Kings,1,0,1610612750,Minnesota Timberwolves,0,1,26,29,55,18,24,42,44,53,97,14,2,16,14,39,28,5,11,102,120
2018,2,21800755,1/29/2019,1610612747,Los Angeles Lakers,1,0,1610612755,Philadelphia 76ers,0,1,36,33,69,7,16,23,43,49,92,12,4,16,18,33,26,15,21,103,105
2018,2,21800755,1/29/2019,1610612755,Philadelphia 76ers,0,1,1610612747,Los Angeles Lakers,1,0,27,30,57,15,21,36,42,51,93,22,6,28,16,37,33,7,12,101,121
2018,2,21800440,12/16/2018,1610612742,Dallas Mavericks,1,0,1610612758,Sacramento Kings,0,1,31,30,61,9,26,35,40,56,96,24,7,31,18,42,22,6,14,106,113
2018,2,21800440,12/16/2018,1610612758,Sacramento Kings,0,1,1610612742,Dallas Mavericks,1,0,37,30,67,9,22,31,46,52,98,19,2,21,12,41,20,6,9,105,120
2018,2,21800252,11/21/2018,1610612754,Indiana Pacers,0,0,1610612766,Charlotte Hornets,1,1,30,21,51,11,22,33,41,43,84,16,1,17,11,33,26,7,14,95,109
2018,2,21800252,11/21/2018,1610612766,Charlotte Hornets,1,1,1610612754,Indiana Pacers,0,0,27,24,51,18,11,29,45,35,80,19,3,22,8,28,30,5,12,95,127
2018,2,21800199,11/13/2018,1610612739,Cleveland Cavaliers,1,1,1610612766,Charlotte Hornets,0,0,32,29,61,13,11,24,45,40,85,10,2,12,15,27,23,12,20,96,113
2018,2,21800199,11/13/2018,1610612766,Charlotte Hornets,0,0,1610612739,Cleveland Cavaliers,1,1,25,29,54,8,33,41,33,62,95,15,4,19,16,49,22,5,9,98,89
2018,2,21800141,11/5/2018,1610612745,Houston Rockets,0,1,1610612754,Indiana Pacers,1,0,19,10,29,15,32,47,34,42,76,15,1,16,8,35,23,8,17,94,98
2018,2,21800141,11/5/2018,1610612754,Indiana Pacers,1,0,1610612745,Houston Rockets,0,1,25,22,47,8,20,28,33,42,75,20,10,30,12,36,17,9,16,94,94
2016,2,21601088,3/26/2017,1610612737,Atlanta Hawks,1,0,1610612751,Brooklyn Nets,0,1,29,42,71,5,22,27,34,64,98,19,13,32,32,40,16,13,21,102,92
2016,2,21601088,3/26/2017,1610612751,Brooklyn Nets,0,1,1610612737,Atlanta Hawks,1,0,32,32,64,6,16,22,38,48,86,25,5,30,16,33,21,10,18,102,107
2019,2,21900254,11/27/2019,1610612765,Detroit Pistons,0,0,1610612766,Charlotte Hornets,1,1,31,25,56,10,22,32,41,47,88,9,6,15,14,36,23,3,9,89,101
2019,2,21900254,11/27/2019,1610612766,Charlotte Hornets,1,1,1610612765,Detroit Pistons,0,0,32,26,58,7,23,30,39,49,88,17,3,20,12,39,27,2,4,88,102
2019,2,21900033,10/26/2019,1610612759,San Antonio Spurs,1,1,1610612764,Washington Wizards,0,0,40,40,80,10,18,28,50,58,108,14,3,17,25,33,29,3,9,100,124
2019,2,21900033,10/26/2019,1610612764,Washington Wizards,0,0,1610612759,San Antonio Spurs,1,1,31,30,61,16,18,34,47,48,95,12,5,17,16,35,30,6,13,99,122
2020,2,22000879,4/20/2021,1610612746,LA Clippers,0,1,1610612757,Portland Trail Blazers,1,0,34,18,52,11,27,38,45,45,90,12,3,15,16,31,24,7,10,94,113
2020,2,22000879,4/20/2021,1610612757,Portland Trail Blazers,1,0,1610612746,LA Clippers,0,1,28,22,50,14,30,44,42,52,94,14,5,19,16,39,22,3,6,94,112
2016,2,21600533,1/4/2017,1610612746,LA Clippers,1,1,1610612763,Memphis Grizzlies,0,0,28,22,50,9,14,23,37,36,73,32,13,45,10,32,23,6,13,95,115
2016,2,21600533,1/4/2017,1610612763,Memphis Grizzlies,0,0,1610612746,LA Clippers,1,1,27,33,60,11,17,28,38,50,88,19,6,25,13,41,30,5,9,96,106
2018,2,21801127,3/28/2019,1610612746,LA Clippers,0,0,1610612749,Milwaukee Bucks,1,1,25,34,59,17,16,33,42,50,92,17,5,22,8,45,26,5,11,103,118
2018,2,21801127,3/28/2019,1610612749,Milwaukee Bucks,1,1,1610612746,LA Clippers,0,0,29,20,49,16,21,37,45,41,86,22,5,27,5,39,25,7,10,104,128
2023,2,22300365,12/20/2023,1610612754,Indiana Pacers,1,1,1610612766,Charlotte Hornets,0,0,31,10,41,18,21,39,49,31,80,28,2,30,10,23,37,6,13,96,144
2023,2,22300496,1/6/2024,1610612745,Houston Rockets,1,1,1610612749,Milwaukee Bucks,0,0,23,26,49,13,21,34,36,47,83,27,5,32,9,38,22,7,10,99,112
2018,2,21800979,3/8/2019,1610612739,Cleveland Cavaliers,0,0,1610612748,Miami Heat,1,1,20,18,38,19,24,43,39,42,81,13,3,16,12,32,28,5,15,91,110
2018,2,21800979,3/8/2019,1610612748,Miami Heat,1,1,1610612739,Cleveland Cavaliers,0,0,33,21,54,12,13,25,45,34,79,24,9,33,15,24,31,6,12,89,126
2018,2,21800853,2/13/2019,1610612739,Cleveland Cavaliers,1,0,1610612751,Brooklyn Nets,0,1,36,42,78,18,24,42,54,66,120,13,5,18,21,48,35,4,15,123,139
2018,2,21800853,2/13/2019,1610612751,Brooklyn Nets,0,1,1610612739,Cleveland Cavaliers,1,0,34,34,68,18,27,45,52,61,113,26,8,34,24,40,31,7,18,123,148
2023,2,22300673,1/30/2024,1610612755,Philadelphia 76ers,0,0,1610612744,Golden State Warriors,1,1,26,29,55,13,17,30,39,46,85,16,5,21,13,37,11,6,16,96,107
2023,2,22300705,2/4/2024,1610612756,Phoenix Suns,0,1,1610612764,Washington Wizards,1,0,43,20,63,11,14,25,54,34,88,21,5,26,12,25,33,11,18,107,140
2021,2,22100166,11/10/2021,1610612758,Sacramento Kings,0,0,1610612759,San Antonio Spurs,1,1,37,18,55,10,26,36,47,44,91,13,3,16,12,33,20,11,15,102,117
2021,2,22100166,11/10/2021,1610612759,San Antonio Spurs,1,1,1610612758,Sacramento Kings,0,0,31,29,60,18,14,32,49,43,92,20,11,31,15,34,34,4,8,101,136
2014,2,21401182,4/10/2015,1610612740,New Orleans Pelicans,1,1,1610612756,Phoenix Suns,0,0,32,33,65,5,14,19,37,47,84,11,8,19,18,34,29,9,11,84,90
2016,2,21600532,1/4/2017,1610612739,Cleveland Cavaliers,1,0,1610612741,Chicago Bulls,0,1,26,32,58,8,17,25,34,49,83,18,6,24,18,33,13,8,15,92,94
2016,2,21600532,1/4/2017,1610612741,Chicago Bulls,0,1,1610612739,Cleveland Cavaliers,1,0,28,27,55,13,17,30,41,44,85,11,4,15,14,33,23,6,13,92,106
2014,2,21401182,4/10/2015,1610612756,Phoenix Suns,0,0,1610612740,New Orleans Pelicans,1,1,23,37,60,7,18,25,30,55,85,8,2,10,16,41,18,4,10,86,75
2014,2,21400702,1/30/2015,1610612742,Dallas Mavericks,0,1,1610612748,Miami Heat,1,0,21,32,53,13,16,29,34,48,82,12,8,20,15,37,24,6,11,89,93
2014,2,21400702,1/30/2015,1610612748,Miami Heat,1,0,1610612742,Dallas Mavericks,0,1,20,39,59,9,20,29,29,59,88,5,5,10,22,39,18,10,17,88,72
2023,2,22300369,12/20/2023,1610612743,Denver Nuggets,0,1,1610612761,Toronto Raptors,1,0,37,28,65,12,21,33,49,49,98,3,4,7,18,32,29,3,9,93,113
2023,2,22300532,1/12/2024,1610612758,Sacramento Kings,0,0,1610612755,Philadelphia 76ers,1,1,24,33,57,8,30,38,32,63,95,21,5,26,29,35,20,11,17,95,93
2018,2,21800671,1/18/2019,1610612738,Boston Celtics,1,1,1610612763,Memphis Grizzlies,0,0,27,21,48,17,21,38,44,42,86,17,5,22,15,30,29,11,17,98,122
2018,2,21800671,1/18/2019,1610612763,Memphis Grizzlies,0,0,1610612738,Boston Celtics,1,1,25,32,57,16,19,35,41,51,92,18,2,20,11,42,33,5,9,98,116
2018,2,21800514,12/27/2018,1610612747,Los Angeles Lakers,0,0,1610612758,Sacramento Kings,1,1,35,28,63,10,15,25,45,43,88,16,7,23,12,33,25,10,18,105,116
2018,2,21800514,12/27/2018,1610612758,Sacramento Kings,1,1,1610612747,Los Angeles Lakers,0,0,35,37,72,10,19,29,45,56,101,17,4,21,20,38,25,7,15,105,117
2023,2,22300425,12/28/2023,1610612763,Memphis Grizzlies,0,0,1610612743,Denver Nuggets,1,1,24,30,54,13,22,35,37,52,89,18,7,25,12,44,23,6,11,99,105
2018,2,21800308,11/28/2018,1610612751,Brooklyn Nets,1,0,1610612762,Utah Jazz,0,1,19,37,56,11,19,30,30,56,86,20,8,28,18,42,11,10,20,101,91
2018,2,21800308,11/28/2018,1610612762,Utah Jazz,0,1,1610612751,Brooklyn Nets,1,0,30,24,54,9,19,28,39,43,82,14,7,21,12,36,17,12,19,101,101
2023,2,22300495,1/6/2024,1610612762,Utah Jazz,0,1,1610612755,Philadelphia 76ers,1,0,38,12,50,8,22,30,46,34,80,20,4,24,14,21,30,12,24,102,120
2023,2,22300673,1/30/2024,1610612744,Golden State Warriors,1,1,1610612755,Philadelphia 76ers,0,0,30,17,47,14,18,32,44,35,79,17,2,19,10,26,32,14,18,96,119
2018,2,21800142,11/5/2018,1610612739,Cleveland Cavaliers,0,0,1610612753,Orlando Magic,1,1,31,26,57,10,13,23,41,39,80,8,4,12,9,32,20,11,18,94,100
2018,2,21800142,11/5/2018,1610612753,Orlando Magic,1,1,1610612739,Cleveland Cavaliers,0,0,28,25,53,11,23,34,39,48,87,13,2,15,14,36,22,8,15,96,102
2016,2,21601087,3/26/2017,1610612756,Phoenix Suns,0,0,1610612766,Charlotte Hornets,1,1,35,30,65,6,10,16,41,40,81,18,4,22,9,34,25,8,12,94,106
2016,2,21601087,3/26/2017,1610612766,Charlotte Hornets,1,1,1610612756,Phoenix Suns,0,0,28,29,57,14,16,30,42,45,87,22,2,24,11,35,29,6,7,95,120
2020,2,22000878,4/20/2021,1610612740,New Orleans Pelicans,1,0,1610612751,Brooklyn Nets,0,1,39,19,58,12,21,33,51,40,91,15,9,24,11,35,28,7,13,104,129
2020,2,22000878,4/20/2021,1610612751,Brooklyn Nets,0,1,1610612740,New Orleans Pelicans,1,0,35,17,52,14,23,37,49,40,89,22,6,28,12,31,30,5,13,103,134
2014,2,21400701,1/30/2015,1610612740,New Orleans Pelicans,1,1,1610612746,LA Clippers,0,0,23,38,61,13,12,25,36,50,86,23,3,26,19,32,26,5,10,89,108
2014,2,21400701,1/30/2015,1610612746,LA Clippers,0,0,1610612740,New Orleans Pelicans,1,1,35,29,64,7,21,28,42,50,92,12,5,17,15,38,20,5,5,90,103
2023,2,22300365,12/20/2023,1610612766,Charlotte Hornets,0,0,1610612754,Indiana Pacers,1,1,37,27,64,8,23,31,45,50,95,15,4,19,19,33,23,6,12,97,113
2023,2,22300544,1/13/2024,1610612752,New York Knicks,0,1,1610612763,Memphis Grizzlies,1,0,27,18,45,13,25,38,40,43,83,13,6,19,19,28,25,14,23,98,106
2023,2,22300526,1/10/2024,1610612746,LA Clippers,1,1,1610612761,Toronto Raptors,0,0,34,25,59,15,19,34,49,44,93,13,0,13,12,32,34,4,7,95,126
2023,2,22300425,12/28/2023,1610612743,Denver Nuggets,1,1,1610612763,Memphis Grizzlies,0,0,35,20,55,20,21,41,55,41,96,12,2,14,15,27,43,8,12,100,142
2018,2,21800370,12/7/2018,1610612753,Orlando Magic,1,0,1610612754,Indiana Pacers,0,1,28,28,56,8,25,33,36,53,89,10,3,13,11,44,20,8,16,100,90
2018,2,21800370,12/7/2018,1610612754,Indiana Pacers,0,1,1610612753,Orlando Magic,1,0,35,32,67,9,17,26,44,49,93,15,3,18,12,39,26,3,10,99,112
2023,2,22300605,1/21/2024,1610612757,Portland Trail Blazers,0,0,1610612747,Los Angeles Lakers,1,1,33,28,61,9,20,29,42,48,90,17,3,20,13,36,24,9,14,100,110
2018,2,21800198,11/12/2018,1610612744,Golden State Warriors,0,0,1610612746,LA Clippers,1,1,32,31,63,12,19,31,44,50,94,16,7,23,11,43,27,11,17,110,116
2018,2,21800198,11/12/2018,1610612746,LA Clippers,1,1,1610612744,Golden State Warriors,0,0,38,33,71,5,15,20,43,48,91,30,4,34,12,39,23,7,17,110,121
2021,2,22100165,11/10/2021,1610612740,New Orleans Pelicans,1,0,1610612760,Oklahoma City Thunder,0,1,25,37,62,9,26,35,34,63,97,23,9,32,24,47,24,6,10,99,100
2021,2,22100165,11/10/2021,1610612760,Oklahoma City Thunder,0,1,1610612740,New Orleans Pelicans,1,0,27,26,53,10,24,34,37,50,87,24,6,30,17,36,23,13,18,98,108
2019,2,21900253,11/27/2019,1610612738,Boston Celtics,1,1,1610612751,Brooklyn Nets,0,0,30,33,63,13,21,34,43,54,97,22,2,24,22,33,23,5,14,101,121
2019,2,21900253,11/27/2019,1610612751,Brooklyn Nets,0,0,1610612738,Boston Celtics,1,1,19,15,34,21,35,56,40,50,90,9,10,19,15,40,32,10,17,102,110
2014,2,21401179,4/10/2015,1610612754,Indiana Pacers,0,1,1610612765,Detroit Pistons,1,0,27,33,60,11,8,19,38,41,79,20,2,22,10,32,29,5,10,89,107
2016,2,21600531,1/4/2017,1610612749,Milwaukee Bucks,0,1,1610612752,New York Knicks,1,0,28,22,50,9,19,28,37,41,78,22,9,31,12,32,20,9,13,94,105
2016,2,21600531,1/4/2017,1610612752,New York Knicks,1,0,1610612749,Milwaukee Bucks,0,1,29,37,66,13,15,28,42,52,94,7,5,12,21,35,26,7,13,95,104
2023,2,22300532,1/12/2024,1610612755,Philadelphia 76ers,1,1,1610612758,Sacramento Kings,0,0,25,33,58,15,20,35,40,53,93,17,1,18,21,32,23,6,14,94,112
2018,2,21800978,3/8/2019,1610612742,Dallas Mavericks,0,0,1610612753,Orlando Magic,1,1,32,23,55,10,24,34,42,47,89,12,4,16,12,37,22,9,14,97,106
2018,2,21800978,3/8/2019,1610612753,Orlando Magic,1,1,1610612742,Dallas Mavericks,0,0,28,30,58,14,15,29,42,45,87,13,5,18,14,34,26,6,16,95,111
2018,2,21800852,2/12/2019,1610612744,Golden State Warriors,1,1,1610612762,Utah Jazz,0,0,31,17,48,13,28,41,44,45,89,14,7,21,6,43,29,3,7,100,115
2018,2,21800852,2/12/2019,1610612762,Utah Jazz,0,0,1610612744,Golden State Warriors,1,1,31,30,61,10,16,26,41,46,87,16,5,21,12,37,23,12,16,100,108
2023,2,22300372,12/20/2023,1610612742,Dallas Mavericks,1,0,1610612746,LA Clippers,0,1,25,23,48,14,29,43,39,52,91,19,8,27,17,37,23,6,8,93,111
2023,2,22300481,1/5/2024,1610612751,Brooklyn Nets,1,1,1610612760,Oklahoma City Thunder,0,0,27,25,52,14,25,39,41,50,91,28,5,33,22,31,25,8,15,99,124
2023,2,22300526,1/10/2024,1610612761,Toronto Raptors,0,0,1610612746,LA Clippers,1,1,34,20,54,12,18,30,46,38,84,16,2,18,12,27,31,6,15,95,120
2023,2,22300468,1/3/2024,1610612741,Chicago Bulls,0,0,1610612752,New York Knicks,1,1,24,33,57,13,19,32,37,52,89,13,3,16,13,41,24,6,11,94,100
2023,2,22300528,1/11/2024,1610612749,Milwaukee Bucks,1,1,1610612738,Boston Celtics,0,0,34,16,50,18,24,42,52,40,92,13,3,16,13,27,34,5,11,97,135
2023,2,22300546,1/13/2024,1610612760,Oklahoma City Thunder,1,1,1610612753,Orlando Magic,0,0,35,23,58,8,28,36,43,51,94,18,3,21,12,41,23,5,9,97,112
2023,2,22300551,1/14/2024,1610612766,Charlotte Hornets,0,0,1610612748,Miami Heat,1,1,23,31,54,10,31,41,33,62,95,11,4,15,21,42,17,6,15,95,87
2023,2,22300611,1/22/2024,1610612742,Dallas Mavericks,1,0,1610612738,Boston Celtics,0,1,29,28,57,14,26,40,43,54,97,10,4,14,14,43,24,7,10,99,110
2021,2,22100164,11/10/2021,1610612763,Memphis Grizzlies,1,0,1610612766,Charlotte Hornets,0,1,36,33,69,9,29,38,45,62,107,9,6,15,23,42,27,13,16,106,108
2021,2,22100164,11/10/2021,1610612766,Charlotte Hornets,0,1,1610612763,Memphis Grizzlies,1,0,26,28,54,15,21,36,41,49,90,21,3,24,11,39,32,14,17,107,118
2016,2,21601086,3/25/2017,1610612750,Minnesota Timberwolves,0,0,1610612757,Portland Trail Blazers,1,1,35,31,66,2,8,10,37,39,76,24,8,32,8,34,15,5,8,90,100
2016,2,21601086,3/25/2017,1610612757,Portland Trail Blazers,1,1,1610612750,Minnesota Timberwolves,0,0,34,15,49,11,11,22,45,26,71,11,6,17,5,24,24,10,15,89,112
2014,2,21401179,4/10/2015,1610612765,Detroit Pistons,1,0,1610612754,Indiana Pacers,0,1,29,37,66,11,12,23,40,49,89,12,11,23,20,34,25,6,11,90,103
2014,2,21400700,1/30/2015,1610612739,Cleveland Cavaliers,1,1,1610612758,Sacramento Kings,0,0,27,22,49,11,20,31,38,42,80,14,8,22,7,39,22,10,17,99,101
2019,2,21900032,10/26/2019,1610612740,New Orleans Pelicans,0,0,1610612745,Houston Rockets,1,1,28,22,50,18,32,50,46,54,100,13,3,16,15,41,27,7,17,111,123
2019,2,21900032,10/26/2019,1610612745,Houston Rockets,1,1,1610612740,New Orleans Pelicans,0,0,30,19,49,13,32,45,43,51,94,27,3,30,15,37,27,9,19,110,126
2020,2,22000877,4/20/2021,1610612752,New York Knicks,1,1,1610612766,Charlotte Hornets,0,0,22,16,38,18,27,45,40,43,83,11,1,12,14,30,22,6,12,88,109
2020,2,22000877,4/20/2021,1610612766,Charlotte Hornets,0,0,1610612752,New York Knicks,1,1,23,24,47,16,23,39,39,47,86,3,5,8,16,33,26,5,13,87,97
2014,2,21400700,1/30/2015,1610612758,Sacramento Kings,0,0,1610612739,Cleveland Cavaliers,1,1,27,39,66,3,15,18,30,54,84,27,5,32,17,41,15,11,16,101,90
2018,2,21801126,3/28/2019,1610612743,Denver Nuggets,0,0,1610612745,Houston Rockets,1,1,27,33,60,4,20,24,31,53,84,19,1,20,13,40,22,8,15,94,85
2018,2,21801126,3/28/2019,1610612745,Houston Rockets,1,1,1610612743,Denver Nuggets,0,0,25,22,47,15,25,40,40,47,87,17,3,20,13,35,22,7,10,95,112
2018,2,21800851,2/12/2019,1610612740,New Orleans Pelicans,1,0,1610612753,Orlando Magic,0,1,26,39,65,10,19,29,36,58,94,6,2,8,12,47,21,9,14,100,88
2018,2,21800851,2/12/2019,1610612753,Orlando Magic,0,1,1610612740,New Orleans Pelicans,1,0,29,34,63,13,19,32,42,53,95,21,1,22,16,37,32,5,10,99,118
2018,2,21800439,12/16/2018,1610612747,Los Angeles Lakers,0,0,1610612764,Washington Wizards,1,1,33,22,55,11,25,36,44,47,91,11,7,18,12,38,24,14,22,110,110
2018,2,21800439,12/16/2018,1610612764,Washington Wizards,1,1,1610612747,Los Angeles Lakers,0,0,41,34,75,13,18,31,54,52,106,7,3,10,17,36,30,10,17,110,128
2021,2,22100163,11/10/2021,1610612741,Chicago Bulls,1,1,1610612742,Dallas Mavericks,0,0,30,28,58,15,16,31,45,44,89,12,2,14,10,35,26,9,11,97,117
2021,2,22100163,11/10/2021,1610612742,Dallas Mavericks,0,0,1610612741,Chicago Bulls,1,1,26,24,50,12,21,33,38,45,83,19,5,24,9,39,23,9,12,97,107
2016,2,21601085,3/25/2017,1610612752,New York Knicks,0,0,1610612759,San Antonio Spurs,1,1,38,39,77,3,7,10,41,46,87,13,2,15,13,34,24,11,16,97,98
2016,2,21601085,3/25/2017,1610612759,San Antonio Spurs,1,1,1610612752,New York Knicks,0,0,35,39,74,10,15,25,45,54,99,6,2,8,21,34,28,6,14,96,106
2016,2,21600530,1/4/2017,1610612737,Atlanta Hawks,0,1,1610612753,Orlando Magic,1,0,34,28,62,10,9,19,44,37,81,13,5,18,8,31,27,9,14,96,111
2016,2,21600530,1/4/2017,1610612753,Orlando Magic,1,0,1610612737,Atlanta Hawks,0,1,28,30,58,9,19,28,37,49,86,9,1,10,12,37,19,12,17,96,92
2016,2,21600100,11/8/2016,1610612737,Atlanta Hawks,0,1,1610612739,Cleveland Cavaliers,1,0,30,22,52,11,18,29,41,40,81,17,7,24,15,28,22,12,19,98,110
2016,2,21600100,11/8/2016,1610612739,Cleveland Cavaliers,1,0,1610612737,Atlanta Hawks,0,1,26,31,57,11,31,42,37,62,99,21,4,25,21,42,21,1,6,98,106
2014,2,21401180,4/10/2015,1610612749,Milwaukee Bucks,0,1,1610612752,New York Knicks,1,0,31,28,59,6,11,17,37,39,76,19,10,29,7,37,18,7,18,100,99
2014,2,21401180,4/10/2015,1610612752,New York Knicks,1,0,1610612749,Milwaukee Bucks,0,1,29,30,59,5,8,13,34,38,72,18,6,24,8,33,22,17,26,100,91
2018,2,21800754,1/29/2019,1610612756,Phoenix Suns,0,0,1610612759,San Antonio Spurs,1,1,35,16,51,13,16,29,48,32,80,15,4,19,5,29,26,9,18,101,124
2018,2,21800754,1/29/2019,1610612759,San Antonio Spurs,1,1,1610612756,Phoenix Suns,0,0,32,34,66,15,19,34,47,53,100,17,3,20,19,35,29,8,11,101,126
2018,2,21800594,1/7/2019,1610612749,Milwaukee Bucks,1,1,1610612762,Utah Jazz,0,0,37,36,73,9,16,25,46,52,98,13,3,16,17,37,27,6,11,99,114
2018,2,21800594,1/7/2019,1610612762,Utah Jazz,0,0,1610612749,Milwaukee Bucks,1,1,22,27,49,14,23,37,36,50,86,16,7,23,15,38,20,10,15,99,102
2023,2,22300705,2/4/2024,1610612764,Washington Wizards,1,0,1610612756,Phoenix Suns,0,1,40,24,64,7,25,32,47,49,96,11,6,17,17,34,32,13,18,106,112
2018,2,21800251,11/20/2018,1610612752,New York Knicks,1,0,1610612757,Portland Trail Blazers,0,1,29,25,54,13,16,29,42,41,83,17,5,22,12,32,22,8,15,97,114
2018,2,21800251,11/20/2018,1610612757,Portland Trail Blazers,0,1,1610612752,New York Knicks,1,0,29,31,60,16,19,35,45,50,95,12,5,17,18,35,25,8,12,96,118
2021,2,22100162,11/10/2021,1610612745,Houston Rockets,1,0,1610612765,Detroit Pistons,0,1,23,25,48,12,22,34,35,47,82,22,12,34,16,37,17,6,16,99,104
2021,2,22100162,11/10/2021,1610612765,Detroit Pistons,0,1,1610612745,Houston Rockets,1,0,26,23,49,16,32,48,42,55,97,12,6,18,20,38,23,5,14,98,112
2014,2,21401181,4/10/2015,1610612745,Houston Rockets,1,0,1610612759,San Antonio Spurs,0,1,22,23,45,9,12,21,31,35,66,32,20,52,14,32,19,12,20,98,103
2014,2,21401181,4/10/2015,1610612759,San Antonio Spurs,0,1,1610612745,Houston Rockets,1,0,37,31,68,4,13,17,41,44,85,18,6,24,14,33,23,9,16,98,104
2020,2,22000876,4/20/2021,1610612737,Atlanta Hawks,1,1,1610612753,Orlando Magic,0,0,30,30,60,9,25,34,39,55,94,25,4,29,19,39,20,11,14,100,112
2020,2,22000876,4/20/2021,1610612753,Orlando Magic,0,0,1610612737,Atlanta Hawks,1,1,26,23,49,8,29,37,34,52,86,20,9,29,9,48,13,6,10,101,96
2014,2,21400699,1/30/2015,1610612751,Brooklyn Nets,1,0,1610612761,Toronto Raptors,0,1,45,37,82,4,15,19,49,52,101,20,6,26,17,39,19,5,7,105,122
2014,2,21400699,1/30/2015,1610612761,Toronto Raptors,0,1,1610612751,Brooklyn Nets,1,0,40,26,66,7,19,26,47,45,92,26,4,30,10,38,22,7,10,105,127
2016,2,21600099,11/7/2016,1610612740,New Orleans Pelicans,0,0,1610612744,Golden State Warriors,1,1,32,27,59,7,14,21,39,41,80,21,6,27,11,31,26,14,20,101,106
2016,2,21600099,11/7/2016,1610612744,Golden State Warriors,1,1,1610612740,New Orleans Pelicans,0,0,29,26,55,16,19,35,45,45,90,10,2,12,13,34,35,8,15,102,116
2018,2,21801125,3/28/2019,1610612752,New York Knicks,1,0,1610612761,Toronto Raptors,0,1,25,34,59,6,20,26,31,54,85,24,8,32,17,41,16,8,17,100,92
2018,2,21801125,3/28/2019,1610612761,Toronto Raptors,0,1,1610612752,New York Knicks,1,0,20,22,42,20,27,47,40,49,89,17,5,22,9,44,32,3,9,101,117
2021,2,22100161,11/10/2021,1610612749,Milwaukee Bucks,0,1,1610612752,New York Knicks,1,0,14,26,40,26,24,50,40,50,90,6,3,9,17,34,29,9,15,92,112
2021,2,22100161,11/10/2021,1610612752,New York Knicks,1,0,1610612749,Milwaukee Bucks,0,1,20,26,46,16,21,37,36,47,83,12,5,17,10,39,19,4,11,94,100
2016,2,21601084,3/25/2017,1610612742,Dallas Mavericks,1,0,1610612761,Toronto Raptors,0,1,24,30,54,7,21,28,31,51,82,17,3,20,16,36,20,9,12,87,86
2016,2,21601084,3/25/2017,1610612761,Toronto Raptors,0,1,1610612742,Dallas Mavericks,1,0,30,30,60,9,12,21,39,42,81,7,2,9,14,29,22,10,15,86,94
2014,2,21400698,1/30/2015,1610612738,Boston Celtics,1,0,1610612745,Houston Rockets,0,1,25,41,66,7,17,24,32,58,90,16,7,23,18,43,14,6,12,96,87
2014,2,21400698,1/30/2015,1610612745,Houston Rockets,0,1,1610612738,Boston Celtics,1,0,27,27,54,8,22,30,35,49,84,15,5,20,15,37,22,8,17,95,93
2018,2,21800977,3/8/2019,1610612764,Washington Wizards,0,0,1610612766,Charlotte Hornets,1,1,31,28,59,9,18,27,40,46,86,22,4,26,15,35,28,7,14,99,111
2018,2,21800977,3/8/2019,1610612766,Charlotte Hornets,1,1,1610612764,Washington Wizards,0,0,26,29,55,14,27,41,40,56,96,18,2,20,21,36,24,8,14,98,112
2018,2,21800438,12/16/2018,1610612752,New York Knicks,0,0,1610612754,Indiana Pacers,1,1,27,30,57,10,22,32,37,52,89,15,7,22,19,36,21,9,17,97,99
2018,2,21800438,12/16/2018,1610612754,Indiana Pacers,1,1,1610612752,New York Knicks,0,0,28,25,53,12,22,34,40,47,87,18,5,23,15,34,28,7,13,96,110
2016,2,21601083,3/25/2017,1610612739,Cleveland Cavaliers,1,0,1610612764,Washington Wizards,0,1,29,21,50,12,21,33,41,42,83,21,6,27,15,30,24,10,13,94,115
2016,2,21601083,3/25/2017,1610612764,Washington Wizards,0,1,1610612739,Cleveland Cavaliers,1,0,41,23,64,8,10,18,49,33,82,21,5,26,13,23,24,6,12,94,127
2019,2,21900252,11/26/2019,1610612743,Denver Nuggets,1,1,1610612764,Washington Wizards,0,0,41,25,66,6,18,24,47,43,90,17,6,23,12,33,31,9,21,110,117
2019,2,21900252,11/26/2019,1610612764,Washington Wizards,0,0,1610612743,Denver Nuggets,1,1,30,25,55,10,30,40,40,55,95,14,7,21,7,50,26,8,12,109,104
2019,2,21900031,10/26/2019,1610612741,Chicago Bulls,1,0,1610612761,Toronto Raptors,0,1,20,42,62,9,26,35,29,68,97,17,8,25,17,54,18,9,15,106,84
2019,2,21900031,10/26/2019,1610612761,Toronto Raptors,0,1,1610612741,Chicago Bulls,1,0,23,17,40,15,27,42,38,44,82,17,1,18,10,34,27,9,24,104,108
2020,2,22000875,4/19/2021,1610612747,Los Angeles Lakers,1,0,1610612762,Utah Jazz,0,1,22,29,51,12,16,28,34,45,79,17,8,25,8,40,17,5,10,93,97
2020,2,22000875,4/19/2021,1610612762,Utah Jazz,0,1,1610612747,Los Angeles Lakers,1,0,28,14,42,15,18,33,43,32,75,10,1,11,5,28,29,10,17,93,111
2014,2,21400697,1/30/2015,1610612737,Atlanta Hawks,1,1,1610612757,Portland Trail Blazers,0,0,29,32,61,11,12,23,40,44,84,14,8,22,10,37,26,7,13,97,105
2014,2,21400697,1/30/2015,1610612757,Portland Trail Blazers,0,0,1610612737,Atlanta Hawks,1,1,28,29,57,11,19,30,39,48,87,10,1,11,12,36,25,12,17,98,99
2018,2,21800850,2/12/2019,1610612759,San Antonio Spurs,0,1,1610612763,Memphis Grizzlies,1,0,23,42,65,13,8,21,36,50,86,23,6,29,11,42,23,5,8,97,108
2018,2,21800850,2/12/2019,1610612763,Memphis Grizzlies,1,0,1610612759,San Antonio Spurs,0,1,36,29,65,8,16,24,44,45,89,11,5,16,14,33,25,6,13,99,107
2018,2,21800753,1/29/2019,1610612740,New Orleans Pelicans,0,1,1610612745,Houston Rockets,1,0,37,22,59,9,22,31,46,44,90,20,5,25,15,32,27,11,17,103,121
2018,2,21800753,1/29/2019,1610612745,Houston Rockets,1,0,1610612740,New Orleans Pelicans,0,1,21,24,45,19,37,56,40,61,101,17,7,24,21,44,22,8,12,104,116
2018,2,21800670,1/17/2019,1610612747,Los Angeles Lakers,0,1,1610612760,Oklahoma City Thunder,1,0,31,28,59,19,21,40,50,49,99,19,2,21,20,30,37,10,24,114,138
2018,2,21800670,1/17/2019,1610612760,Oklahoma City Thunder,1,0,1610612747,Los Angeles Lakers,0,1,19,31,50,22,32,54,41,63,104,24,12,36,20,51,31,11,15,114,128
2021,2,22100160,11/10/2021,1610612738,Boston Celtics,1,1,1610612761,Toronto Raptors,0,0,32,33,65,10,19,29,42,52,94,10,5,15,19,35,21,8,15,96,104
2021,2,22100160,11/10/2021,1610612761,Toronto Raptors,0,0,1610612738,Boston Celtics,1,1,27,25,52,6,19,25,33,44,77,16,3,19,8,36,20,10,18,97,88
2016,2,21600529,1/4/2017,1610612760,Oklahoma City Thunder,0,0,1610612766,Charlotte Hornets,1,1,33,33,66,9,21,30,42,54,96,19,4,23,18,38,22,8,14,103,112
2016,2,21600529,1/4/2017,1610612766,Charlotte Hornets,1,1,1610612760,Oklahoma City Thunder,0,0,28,28,56,9,15,24,37,43,80,40,9,49,13,37,25,6,11,102,123
2018,2,21801124,3/28/2019,1610612742,Dallas Mavericks,0,0,1610612748,Miami Heat,1,1,20,25,45,16,31,47,36,56,92,11,6,17,12,47,26,7,13,101,99
2023,2,22300534,1/12/2024,1610612765,Detroit Pistons,1,0,1610612745,Houston Rockets,0,1,32,21,53,12,23,35,44,44,88,10,6,16,13,33,32,8,15,97,110
2022,2,22201190,4/5/2023,1610612752,New York Knicks,0,1,1610612754,Indiana Pacers,1,0,34,20,54,18,28,46,52,48,100,16,9,25,25,28,34,6,18,105,138
2018,2,21801124,3/28/2019,1610612748,Miami Heat,1,1,1610612742,Dallas Mavericks,0,0,32,27,59,7,23,30,39,50,89,20,7,27,11,43,24,4,11,100,105
2023,2,22300485,1/5/2024,1610612745,Houston Rockets,1,0,1610612750,Minnesota Timberwolves,0,1,24,34,58,12,20,32,36,54,90,11,4,15,10,46,18,12,15,100,95
2016,2,21600098,11/7/2016,1610612746,LA Clippers,1,1,1610612765,Detroit Pistons,0,0,28,23,51,13,12,25,41,35,76,19,3,22,3,32,28,5,12,94,114
2016,2,21600098,11/7/2016,1610612765,Detroit Pistons,0,0,1610612746,LA Clippers,1,1,26,44,70,4,8,12,30,52,82,18,8,26,11,46,14,8,11,93,82
2014,2,21400696,1/30/2015,1610612750,Minnesota Timberwolves,0,0,1610612755,Philadelphia 76ers,1,1,29,33,62,5,9,14,34,42,76,21,4,25,16,28,24,13,21,93,94
2014,2,21400696,1/30/2015,1610612755,Philadelphia 76ers,1,1,1610612750,Minnesota Timberwolves,0,0,29,22,51,8,15,23,37,37,74,21,4,25,10,29,27,8,15,93,103
2018,2,21800593,1/7/2019,1610612743,Denver Nuggets,0,0,1610612745,Houston Rockets,1,1,37,27,64,7,22,29,44,49,93,18,3,21,17,33,26,8,14,98,113
2023,2,22300496,1/6/2024,1610612749,Milwaukee Bucks,0,0,1610612745,Houston Rockets,1,1,26,16,42,9,25,34,35,41,76,29,13,42,8,41,20,7,11,99,108
2016,2,21601082,3/25/2017,1610612746,LA Clippers,1,1,1610612762,Utah Jazz,0,0,31,26,57,7,20,27,38,46,84,25,3,28,14,33,14,5,10,92,108
2016,2,21601082,3/25/2017,1610612762,Utah Jazz,0,0,1610612746,LA Clippers,1,1,29,31,60,8,18,26,37,49,86,13,5,18,14,37,22,9,14,92,95
2016,2,21600528,1/3/2017,1610612747,Los Angeles Lakers,1,1,1610612763,Memphis Grizzlies,0,0,25,24,49,17,16,33,42,40,82,15,12,27,11,36,34,6,10,94,116
2016,2,21600528,1/3/2017,1610612763,Memphis Grizzlies,0,0,1610612747,Los Angeles Lakers,1,1,20,26,46,10,21,31,30,47,77,32,3,35,11,37,18,5,10,94,102
2020,2,22000874,4/19/2021,1610612743,Denver Nuggets,1,1,1610612763,Memphis Grizzlies,0,0,36,27,63,15,24,39,51,51,102,22,4,26,15,38,30,15,24,122,139
2020,2,22000874,4/19/2021,1610612763,Memphis Grizzlies,0,0,1610612743,Denver Nuggets,1,1,34,33,67,17,23,40,51,56,107,18,6,24,14,46,33,6,15,122,137
2018,2,21800976,3/7/2019,1610612757,Portland Trail Blazers,1,0,1610612760,Oklahoma City Thunder,0,1,28,25,53,9,32,41,37,57,94,38,9,47,17,44,14,7,14,115,121
2018,2,21800976,3/7/2019,1610612760,Oklahoma City Thunder,0,1,1610612757,Portland Trail Blazers,1,0,40,38,78,8,19,27,48,57,105,25,7,32,23,38,14,7,16,114,129
2023,2,22300475,1/3/2024,1610612748,Miami Heat,0,1,1610612747,Los Angeles Lakers,1,0,25,26,51,16,26,42,41,52,93,12,5,17,10,45,30,3,10,101,110
2023,2,22300493,1/6/2024,1610612738,Boston Celtics,0,1,1610612754,Indiana Pacers,1,0,30,19,49,16,25,41,46,44,90,10,9,19,17,30,26,12,18,100,118
2018,2,21800669,1/17/2019,1610612741,Chicago Bulls,0,0,1610612743,Denver Nuggets,1,1,34,31,65,10,18,28,44,49,93,7,4,11,17,33,27,6,12,94,105
2018,2,21800669,1/17/2019,1610612743,Denver Nuggets,1,1,1610612741,Chicago Bulls,0,0,30,26,56,20,20,40,50,46,96,15,5,20,18,30,34,3,7,94,135
2018,2,21800593,1/7/2019,1610612745,Houston Rockets,1,1,1610612743,Denver Nuggets,0,0,16,13,29,22,25,47,38,38,76,27,7,34,8,32,28,7,15,97,125
2023,2,22300485,1/5/2024,1610612750,Minnesota Timberwolves,0,1,1610612745,Houston Rockets,1,0,32,23,55,14,19,33,46,42,88,16,4,20,12,32,31,7,14,100,122
2018,2,21800369,12/7/2018,1610612755,Philadelphia 76ers,0,1,1610612765,Detroit Pistons,1,0,35,23,58,9,23,32,44,46,90,20,1,21,13,34,26,10,16,101,117
2018,2,21800369,12/7/2018,1610612765,Detroit Pistons,1,0,1610612755,Philadelphia 76ers,0,1,30,31,61,7,21,28,37,52,89,30,7,37,24,31,22,11,18,103,111
2018,2,21800307,11/28/2018,1610612752,New York Knicks,0,0,1610612755,Philadelphia 76ers,1,1,26,37,63,6,23,29,32,60,92,21,1,22,16,45,14,7,15,100,91
2021,2,22100159,11/10/2021,1610612751,Brooklyn Nets,0,1,1610612753,Orlando Magic,1,0,30,24,54,16,21,37,46,45,91,15,2,17,9,37,29,10,15,102,123
2021,2,22100159,11/10/2021,1610612753,Orlando Magic,1,0,1610612751,Brooklyn Nets,0,1,31,28,59,4,29,33,35,57,92,16,8,24,16,45,19,8,17,104,90
2019,2,21900251,11/26/2019,1610612742,Dallas Mavericks,1,0,1610612746,LA Clippers,0,1,19,22,41,11,27,38,30,49,79,28,7,35,9,42,16,12,20,105,99
2019,2,21900251,11/26/2019,1610612746,LA Clippers,0,1,1610612742,Dallas Mavericks,1,0,30,34,64,11,22,33,41,56,97,21,9,30,20,40,22,12,14,106,114
2023,2,22300475,1/3/2024,1610612747,Los Angeles Lakers,1,0,1610612748,Miami Heat,0,1,31,22,53,4,26,30,35,48,83,22,2,24,15,34,29,14,22,101,96
2023,2,22300494,1/6/2024,1610612752,New York Knicks,0,1,1610612764,Washington Wizards,1,0,29,22,51,14,22,36,43,44,87,21,3,24,12,34,27,5,14,99,121
2023,2,22300486,1/5/2024,1610612746,LA Clippers,0,1,1610612740,New Orleans Pelicans,1,0,25,21,46,15,21,36,40,42,82,16,4,20,14,30,28,9,15,93,111
2023,2,22300545,1/13/2024,1610612744,Golden State Warriors,0,0,1610612749,Milwaukee Bucks,1,1,32,30,62,15,21,36,47,51,98,9,5,14,15,38,23,6,8,98,118
2019,2,21900030,10/26/2019,1610612739,Cleveland Cavaliers,1,1,1610612754,Indiana Pacers,0,0,29,20,49,11,20,31,40,40,80,19,10,29,15,31,23,7,19,97,110
2019,2,21900030,10/26/2019,1610612754,Indiana Pacers,0,0,1610612739,Cleveland Cavaliers,1,1,29,30,59,10,18,28,39,48,87,11,2,13,12,38,23,9,17,99,99
2023,2,22300484,1/5/2024,1610612766,Charlotte Hornets,0,0,1610612741,Chicago Bulls,1,1,26,29,55,10,24,34,36,53,89,9,3,12,15,40,20,7,13,92,91
2020,2,22000873,4/19/2021,1610612749,Milwaukee Bucks,1,0,1610612756,Phoenix Suns,0,1,38,30,68,11,23,34,49,53,102,18,1,19,13,41,19,7,12,112,127
2020,2,22000873,4/19/2021,1610612756,Phoenix Suns,0,1,1610612749,Milwaukee Bucks,1,0,34,30,64,17,25,42,51,55,106,9,1,10,12,44,28,7,11,112,128
2023,2,22300693,2/2/2024,1610612763,Memphis Grizzlies,1,0,1610612744,Golden State Warriors,0,1,21,20,41,14,32,46,35,52,87,17,7,24,12,42,30,7,14,101,101
2023,2,22300498,1/7/2024,1610612757,Portland Trail Blazers,0,1,1610612751,Brooklyn Nets,1,0,25,32,57,20,18,38,45,50,95,24,6,30,15,36,21,7,10,104,134
2023,2,22300566,1/16/2024,1610612755,Philadelphia 76ers,1,1,1610612743,Denver Nuggets,0,0,28,17,45,15,16,31,43,33,76,25,9,34,8,31,27,4,8,92,126
2021,2,22100158,11/10/2021,1610612739,Cleveland Cavaliers,1,0,1610612764,Washington Wizards,0,1,26,19,45,9,22,31,35,41,76,15,6,21,8,38,21,9,15,92,94
2021,2,22100158,11/10/2021,1610612764,Washington Wizards,0,1,1610612739,Cleveland Cavaliers,1,0,25,31,56,10,18,28,35,49,84,17,0,17,13,36,25,7,12,91,97
2016,2,21601081,3/24/2017,1610612744,Golden State Warriors,1,1,1610612758,Sacramento Kings,0,0,34,24,58,10,21,31,44,45,89,16,2,18,14,32,37,7,13,96,114
2016,2,21601081,3/24/2017,1610612758,Sacramento Kings,0,0,1610612744,Golden State Warriors,1,1,30,32,62,10,11,21,40,43,83,10,3,13,12,33,27,14,21,97,100
2016,2,21600527,1/3/2017,1610612748,Miami Heat,0,0,1610612756,Phoenix Suns,1,1,30,38,68,6,17,23,36,55,91,12,4,16,19,36,18,7,13,91,90
2016,2,21600527,1/3/2017,1610612756,Phoenix Suns,1,1,1610612748,Miami Heat,0,0,27,27,54,9,14,23,36,41,77,18,4,22,15,28,21,8,18,90,99
2014,2,21400695,1/29/2015,1610612741,Chicago Bulls,0,0,1610612747,Los Angeles Lakers,1,1,37,42,79,6,19,25,43,61,104,26,6,32,24,39,26,5,14,110,118
2014,2,21400695,1/29/2015,1610612747,Los Angeles Lakers,1,1,1610612741,Chicago Bulls,0,0,47,50,97,3,6,9,50,56,106,20,5,25,22,35,26,9,13,110,123
2018,2,21800513,12/27/2018,1610612749,Milwaukee Bucks,1,1,1610612752,New York Knicks,0,0,31,30,61,11,21,32,42,51,93,17,4,21,19,35,20,8,15,100,112
2018,2,21800513,12/27/2018,1610612752,New York Knicks,0,0,1610612749,Milwaukee Bucks,1,1,23,43,66,13,18,31,36,61,97,11,5,16,16,46,21,4,10,99,96
2023,2,22300613,1/22/2024,1610612758,Sacramento Kings,1,1,1610612737,Atlanta Hawks,0,0,31,24,55,12,26,38,43,50,93,24,3,27,12,39,22,2,9,102,122
2023,2,22300653,1/28/2024,1610612737,Atlanta Hawks,1,1,1610612761,Toronto Raptors,0,0,38,30,68,6,21,27,44,51,95,32,8,40,26,31,27,12,14,102,126
2023,2,22300638,1/26/2024,1610612753,Orlando Magic,0,0,1610612763,Memphis Grizzlies,1,1,29,18,47,9,25,34,38,43,81,21,8,29,13,34,21,9,11,95,106
2021,2,22100157,11/9/2021,1610612746,LA Clippers,1,1,1610612757,Portland Trail Blazers,0,0,28,27,55,16,14,30,44,41,85,13,6,19,7,37,25,6,8,95,117
2021,2,22100157,11/9/2021,1610612757,Portland Trail Blazers,0,0,1610612746,LA Clippers,1,1,29,25,54,14,23,37,43,48,91,9,3,12,10,40,29,5,10,95,109
2019,2,21900250,11/25/2019,1610612744,Golden State Warriors,1,0,1610612760,Oklahoma City Thunder,0,1,28,41,69,9,11,20,37,52,89,14,2,16,15,39,27,5,13,95,97
2019,2,21900250,11/25/2019,1610612760,Oklahoma City Thunder,0,1,1610612744,Golden State Warriors,1,0,29,24,53,11,21,32,40,45,85,9,2,11,10,35,26,10,16,96,100
2020,2,22000872,4/19/2021,1610612760,Oklahoma City Thunder,0,0,1610612764,Washington Wizards,1,1,23,27,50,13,20,33,36,47,83,22,5,27,11,39,23,8,19,103,107
2020,2,22000872,4/19/2021,1610612764,Washington Wizards,1,1,1610612760,Oklahoma City Thunder,0,0,36,24,60,10,21,31,46,45,91,17,12,29,12,39,31,6,12,104,119
2016,2,21600097,11/7/2016,1610612748,Miami Heat,0,0,1610612760,Oklahoma City Thunder,1,1,27,40,67,4,13,17,31,53,84,19,3,22,16,38,12,8,12,92,85
2016,2,21600097,11/7/2016,1610612760,Oklahoma City Thunder,1,1,1610612748,Miami Heat,0,0,28,29,57,9,19,28,37,48,85,14,3,17,19,32,24,8,18,91,97
2023,2,22300543,1/13/2024,1610612737,Atlanta Hawks,1,0,1610612764,Washington Wizards,0,1,21,32,53,11,29,40,32,61,93,24,9,33,22,46,21,10,16,103,99
2023,2,22300592,1/20/2024,1610612749,Milwaukee Bucks,0,1,1610612765,Detroit Pistons,1,0,35,18,53,12,20,32,47,38,85,35,14,49,10,34,30,6,10,108,141
2023,2,22300612,1/22/2024,1610612741,Chicago Bulls,0,0,1610612756,Phoenix Suns,1,1,31,25,56,14,23,37,45,48,93,9,5,14,16,34,25,5,10,96,113
2023,2,22300656,1/28/2024,1610612757,Portland Trail Blazers,1,0,1610612741,Chicago Bulls,0,1,26,20,46,6,27,33,32,47,79,26,3,29,12,37,22,7,14,94,96
2021,2,22100156,11/9/2021,1610612737,Atlanta Hawks,0,0,1610612762,Utah Jazz,1,1,19,31,50,18,17,35,37,48,85,6,4,10,12,39,22,8,13,91,98
2021,2,22100156,11/9/2021,1610612762,Utah Jazz,1,1,1610612737,Atlanta Hawks,0,0,26,17,43,15,23,38,41,40,81,13,3,16,14,28,21,6,15,91,110
2014,2,21401176,4/10/2015,1610612737,Atlanta Hawks,1,1,1610612766,Charlotte Hornets,0,0,31,23,54,10,18,28,41,41,82,12,4,16,10,36,31,8,14,92,104
2023,2,22300495,1/6/2024,1610612755,Philadelphia 76ers,1,0,1610612762,Utah Jazz,0,1,35,31,66,7,31,38,42,62,104,18,5,23,21,45,30,4,6,102,109
2023,2,22300557,1/15/2024,1610612753,Orlando Magic,0,1,1610612752,New York Knicks,1,0,30,26,56,8,21,29,38,47,85,14,7,21,16,34,26,3,8,86,98
2016,2,21600526,1/3/2017,1610612743,Denver Nuggets,1,0,1610612758,Sacramento Kings,0,1,23,21,44,18,20,38,41,41,82,13,0,13,9,32,29,7,14,95,113
2016,2,21600526,1/3/2017,1610612758,Sacramento Kings,0,1,1610612743,Denver Nuggets,1,0,35,24,59,11,18,29,46,42,88,17,1,18,11,31,26,6,8,94,120
2023,2,22300497,1/7/2024,1610612759,San Antonio Spurs,0,0,1610612739,Cleveland Cavaliers,1,1,27,22,49,14,23,37,41,45,86,19,3,22,10,36,22,6,11,98,115
2023,2,22300498,1/7/2024,1610612751,Brooklyn Nets,1,0,1610612757,Portland Trail Blazers,0,1,32,22,54,14,23,37,46,45,91,21,4,25,13,33,29,5,16,107,127
2023,2,22300527,1/11/2024,1610612751,Brooklyn Nets,0,0,1610612739,Cleveland Cavaliers,1,1,29,26,55,8,19,27,37,45,82,20,8,28,12,37,18,11,17,100,102
2023,2,22300542,1/13/2024,1610612738,Boston Celtics,1,1,1610612745,Houston Rockets,0,0,27,21,48,24,23,47,51,44,95,19,6,25,11,36,26,10,12,107,145
2023,2,22300612,1/22/2024,1610612756,Phoenix Suns,1,1,1610612741,Chicago Bulls,0,0,30,21,51,14,20,34,44,41,85,13,4,17,5,37,32,6,7,95,115
2023,2,22300656,1/28/2024,1610612741,Chicago Bulls,0,1,1610612757,Portland Trail Blazers,1,0,34,24,58,8,24,32,42,48,90,12,5,17,9,43,27,2,5,94,104
2023,2,22300617,1/23/2024,1610612757,Portland Trail Blazers,0,0,1610612760,Oklahoma City Thunder,1,1,19,28,47,18,21,39,37,49,86,17,4,21,15,35,27,9,19,100,109
2021,2,22100155,11/9/2021,1610612749,Milwaukee Bucks,0,1,1610612755,Philadelphia 76ers,1,0,29,27,56,15,24,39,44,51,95,15,6,21,17,38,21,7,9,98,118
2021,2,22100155,11/9/2021,1610612755,Philadelphia 76ers,1,0,1610612749,Milwaukee Bucks,0,1,28,32,60,14,29,43,42,61,103,11,1,12,17,44,21,5,7,98,109
2023,2,22300558,1/15/2024,1610612764,Washington Wizards,1,0,1610612765,Detroit Pistons,0,1,25,29,54,19,22,41,44,51,95,10,1,11,11,41,30,4,8,96,117
2023,2,22300479,1/5/2024,1610612762,Utah Jazz,0,0,1610612738,Boston Celtics,1,1,28,32,60,6,28,34,34,60,94,23,11,34,19,49,23,9,18,109,97
2023,2,22300497,1/7/2024,1610612739,Cleveland Cavaliers,1,1,1610612759,San Antonio Spurs,0,0,27,18,45,16,27,43,43,45,88,15,6,21,15,33,27,10,16,98,117
2023,2,22300547,1/13/2024,1610612742,Dallas Mavericks,1,0,1610612740,New Orleans Pelicans,0,1,22,19,41,15,26,41,37,45,82,19,1,20,12,34,23,7,12,91,108
2019,2,21900249,11/25/2019,1610612747,Los Angeles Lakers,0,1,1610612759,San Antonio Spurs,1,0,30,26,56,14,19,33,44,45,89,12,6,18,14,35,28,4,9,91,114
2019,2,21900249,11/25/2019,1610612759,San Antonio Spurs,1,0,1610612747,Los Angeles Lakers,0,1,31,32,63,10,15,25,41,47,88,12,3,15,15,33,23,7,13,92,104
2023,2,22300572,1/17/2024,1610612739,Cleveland Cavaliers,1,1,1610612749,Milwaukee Bucks,0,0,43,22,65,12,16,28,55,38,93,13,6,19,13,30,36,6,11,98,135
2020,2,22000871,4/19/2021,1610612745,Houston Rockets,0,0,1610612748,Miami Heat,1,1,24,23,47,9,29,38,33,52,85,16,1,17,9,43,20,7,13,96,91
2020,2,22000871,4/19/2021,1610612748,Miami Heat,1,1,1610612745,Houston Rockets,0,0,26,19,45,19,29,48,45,48,93,4,3,7,15,35,31,8,15,96,113
2019,2,21900029,10/26/2019,1610612738,Boston Celtics,0,1,1610612752,New York Knicks,1,0,27,25,52,15,26,41,42,51,93,19,10,29,17,41,24,7,13,102,118
2019,2,21900029,10/26/2019,1610612752,New York Knicks,1,0,1610612738,Boston Celtics,0,1,24,31,55,7,20,27,31,51,82,26,8,34,22,34,15,14,24,101,95
2023,2,22300566,1/16/2024,1610612743,Denver Nuggets,0,0,1610612755,Philadelphia 76ers,1,1,33,27,60,12,17,29,45,44,89,19,6,25,18,28,23,6,11,92,121
2023,2,22300592,1/20/2024,1610612765,Detroit Pistons,1,0,1610612749,Milwaukee Bucks,0,1,23,34,57,21,16,37,44,50,94,26,6,32,11,43,30,6,9,107,135
2023,2,22300613,1/22/2024,1610612737,Atlanta Hawks,0,0,1610612758,Sacramento Kings,1,1,22,31,53,14,26,40,36,57,93,21,6,27,16,46,19,8,12,101,107
2023,2,22300487,1/5/2024,1610612742,Dallas Mavericks,1,1,1610612757,Portland Trail Blazers,0,0,39,19,58,17,21,38,56,40,96,10,5,15,11,33,35,9,17,107,139
2023,2,22300548,1/13/2024,1610612759,San Antonio Spurs,1,0,1610612741,Chicago Bulls,0,1,21,28,49,18,28,46,39,56,95,20,3,23,16,43,26,5,9,98,116
2023,2,22300575,1/17/2024,1610612740,New Orleans Pelicans,1,1,1610612766,Charlotte Hornets,0,0,19,22,41,25,22,47,44,44,88,19,4,23,18,27,32,7,13,95,132
2021,2,22100154,11/8/2021,1610612747,Los Angeles Lakers,1,1,1610612766,Charlotte Hornets,0,0,31,28,59,13,19,32,44,47,91,25,10,35,11,42,30,5,15,112,126
2021,2,22100154,11/8/2021,1610612766,Charlotte Hornets,0,0,1610612747,Los Angeles Lakers,1,1,29,28,57,14,28,42,43,56,99,23,5,28,16,44,23,11,18,112,123
2023,2,22300536,1/12/2024,1610612741,Chicago Bulls,1,0,1610612744,Golden State Warriors,0,1,32,14,46,18,22,40,50,36,86,13,3,16,7,31,31,7,12,96,131
2023,2,22301061,3/28/2024,1610612749,Milwaukee Bucks,0,0,1610612740,New Orleans Pelicans,1,1,24,19,43,14,25,39,38,44,82,10,9,19,7,41,21,11,14,98,100
2023,2,22300723,2/6/2024,1610612741,Chicago Bulls,1,1,1610612750,Minnesota Timberwolves,0,0,33,30,63,12,18,30,45,48,93,27,5,32,19,32,24,6,14,105,129
2023,2,22300548,1/13/2024,1610612741,Chicago Bulls,0,1,1610612759,San Antonio Spurs,1,0,31,25,56,15,19,34,46,44,90,15,5,20,11,36,31,7,9,98,122
2023,2,22300487,1/5/2024,1610612757,Portland Trail Blazers,0,0,1610612742,Dallas Mavericks,1,1,26,29,55,13,27,40,39,56,95,12,5,17,14,45,27,11,19,108,103
2023,2,22300541,1/12/2024,1610612759,San Antonio Spurs,1,1,1610612766,Charlotte Hornets,0,0,27,22,49,18,20,38,45,42,87,27,7,34,13,32,31,11,15,104,135
2021,2,22100153,11/8/2021,1610612756,Phoenix Suns,0,1,1610612758,Sacramento Kings,1,0,32,31,63,12,18,30,44,49,93,9,2,11,10,40,28,6,15,104,109
2021,2,22100153,11/8/2021,1610612758,Sacramento Kings,1,0,1610612756,Phoenix Suns,0,1,27,31,58,10,14,24,37,45,82,20,6,26,13,34,18,14,24,103,104
2016,2,21601080,3/24/2017,1610612747,Los Angeles Lakers,1,1,1610612750,Minnesota Timberwolves,0,0,32,33,65,14,9,23,46,42,88,24,4,28,15,27,26,13,20,106,130
2016,2,21601080,3/24/2017,1610612750,Minnesota Timberwolves,0,0,1610612747,Los Angeles Lakers,1,1,39,35,74,7,14,21,46,49,95,20,2,22,16,36,32,6,14,105,119
2014,2,21401176,4/10/2015,1610612766,Charlotte Hornets,0,0,1610612737,Atlanta Hawks,1,1,22,31,53,8,22,30,30,53,83,12,6,18,15,37,21,10,15,92,80
2023,2,22300557,1/15/2024,1610612752,New York Knicks,1,0,1610612753,Orlando Magic,0,1,20,23,43,13,27,40,33,50,83,15,7,22,18,35,20,2,10,86,94
2023,2,22300618,1/23/2024,1610612746,LA Clippers,1,1,1610612747,Los Angeles Lakers,0,0,38,23,61,14,13,27,52,36,88,9,3,12,8,30,33,9,15,99,127
2021,2,22100152,11/8/2021,1610612737,Atlanta Hawks,0,0,1610612744,Golden State Warriors,1,1,21,18,39,17,26,43,38,44,82,20,6,26,12,33,21,13,18,102,113
2021,2,22100152,11/8/2021,1610612744,Golden State Warriors,1,1,1610612737,Atlanta Hawks,0,0,26,22,48,18,26,44,44,48,92,21,1,22,13,36,31,6,14,102,127
2023,2,22300537,1/12/2024,1610612763,Memphis Grizzlies,1,0,1610612746,LA Clippers,0,1,23,28,51,18,26,44,41,54,95,19,8,27,21,34,30,9,9,96,119
2020,2,22000870,4/19/2021,1610612744,Golden State Warriors,0,1,1610612755,Philadelphia 76ers,1,0,20,24,44,14,18,32,34,42,76,25,7,32,10,34,15,9,15,98,107
2023,2,22300547,1/13/2024,1610612740,New Orleans Pelicans,0,1,1610612742,Dallas Mavericks,1,0,27,22,49,12,18,30,39,40,79,28,9,37,18,27,29,6,11,91,118
2020,2,22000870,4/19/2021,1610612755,Philadelphia 76ers,1,0,1610612744,Golden State Warriors,0,1,23,34,57,12,20,32,35,54,89,14,4,18,14,43,26,2,14,97,96
2023,2,22300618,1/23/2024,1610612747,Los Angeles Lakers,0,0,1610612746,LA Clippers,1,1,34,26,60,11,21,32,45,47,92,15,7,22,18,32,27,8,15,100,116
2023,2,22300950,3/13/2024,1610612766,Charlotte Hornets,0,1,1610612763,Memphis Grizzlies,1,0,31,15,46,13,23,36,44,38,82,9,4,13,10,31,26,12,20,97,110
2019,2,21900248,11/25/2019,1610612749,Milwaukee Bucks,1,1,1610612762,Utah Jazz,0,0,30,26,56,13,28,41,43,54,97,23,6,29,18,38,21,4,9,101,122
2019,2,21900248,11/25/2019,1610612762,Utah Jazz,0,0,1610612749,Milwaukee Bucks,1,1,22,18,40,21,24,45,43,42,85,11,1,12,6,36,29,6,17,101,118
2023,2,22300541,1/12/2024,1610612766,Charlotte Hornets,0,0,1610612759,San Antonio Spurs,1,1,22,33,55,10,24,34,32,57,89,25,3,28,18,41,22,9,20,104,99
2023,2,22300546,1/13/2024,1610612753,Orlando Magic,0,0,1610612760,Oklahoma City Thunder,1,1,32,17,49,7,28,35,39,45,84,15,9,24,14,35,21,9,16,97,100
2021,2,22100151,11/8/2021,1610612743,Denver Nuggets,1,1,1610612748,Miami Heat,0,0,30,20,50,12,29,41,42,49,91,17,7,24,19,33,28,3,10,93,113
2021,2,22100151,11/8/2021,1610612748,Miami Heat,0,0,1610612743,Denver Nuggets,1,1,18,24,42,13,23,36,31,47,78,21,4,25,9,40,22,7,13,93,96
2023,2,22300538,1/12/2024,1610612750,Minnesota Timberwolves,1,1,1610612757,Portland Trail Blazers,0,0,33,16,49,11,20,31,44,36,80,17,7,24,10,29,35,8,16,97,116
2023,2,22300545,1/13/2024,1610612749,Milwaukee Bucks,1,1,1610612744,Golden State Warriors,0,0,38,25,63,13,18,31,51,43,94,14,3,17,14,32,33,5,12,97,129
2016,2,21600525,1/3/2017,1610612759,San Antonio Spurs,1,1,1610612761,Toronto Raptors,0,0,30,24,54,13,11,24,43,35,78,11,4,15,9,29,32,8,15,93,110
2016,2,21600525,1/3/2017,1610612761,Toronto Raptors,0,0,1610612759,San Antonio Spurs,1,1,27,38,65,4,14,18,31,52,83,16,6,22,14,39,8,7,14,94,82
2016,2,21600096,11/7/2016,1610612741,Chicago Bulls,1,1,1610612753,Orlando Magic,0,0,39,31,70,3,16,19,42,47,89,25,6,31,17,34,26,6,9,96,112
2016,2,21600096,11/7/2016,1610612753,Orlando Magic,0,0,1610612741,Chicago Bulls,1,1,24,31,55,9,21,30,33,52,85,5,1,6,10,43,28,7,15,94,80
2023,2,22300569,1/17/2024,1610612765,Detroit Pistons,1,0,1610612750,Minnesota Timberwolves,0,1,34,24,58,12,19,31,46,43,89,13,6,19,9,37,30,7,12,100,117
2023,2,22300553,1/14/2024,1610612750,Minnesota Timberwolves,1,1,1610612746,LA Clippers,0,0,25,16,41,13,13,26,38,29,67,20,11,31,9,28,25,9,19,92,109
2023,2,22300542,1/13/2024,1610612745,Houston Rockets,0,0,1610612738,Boston Celtics,1,1,33,36,69,7,23,30,40,59,99,26,4,30,18,43,20,7,13,108,113
2023,2,22300569,1/17/2024,1610612750,Minnesota Timberwolves,0,1,1610612765,Detroit Pistons,1,0,32,31,63,15,15,30,47,46,93,15,6,21,15,32,32,4,11,99,124
2022,2,22201227,4/9/2023,1610612743,Denver Nuggets,1,1,1610612758,Sacramento Kings,0,0,35,21,56,7,21,28,42,42,84,18,7,25,21,25,25,7,20,96,109
2023,2,22300543,1/13/2024,1610612764,Washington Wizards,0,1,1610612737,Atlanta Hawks,1,0,35,30,65,12,20,32,47,50,97,21,5,26,17,36,32,9,12,103,127
2023,2,22300553,1/14/2024,1610612746,LA Clippers,0,0,1610612750,Minnesota Timberwolves,1,1,19,25,44,17,22,39,36,47,83,16,2,18,11,38,28,8,11,93,105
2023,2,22300537,1/12/2024,1610612746,LA Clippers,0,1,1610612763,Memphis Grizzlies,1,0,34,24,58,15,16,31,49,40,89,15,5,20,14,29,22,5,12,95,128
2019,2,21900028,10/26/2019,1610612737,Atlanta Hawks,1,1,1610612753,Orlando Magic,0,0,34,20,54,9,21,30,43,41,84,8,7,15,10,33,22,8,18,101,103
2023,2,22300692,2/2/2024,1610612761,Toronto Raptors,0,0,1610612745,Houston Rockets,1,1,29,29,58,11,22,33,40,51,91,15,5,20,9,44,17,9,14,106,106
2019,2,21900028,10/26/2019,1610612753,Orlando Magic,0,0,1610612737,Atlanta Hawks,1,1,30,38,68,5,26,31,35,64,99,24,2,26,21,44,15,5,10,101,99
2020,2,22000869,4/19/2021,1610612738,Boston Celtics,1,0,1610612741,Chicago Bulls,0,1,26,26,52,10,15,25,36,41,77,14,1,15,6,35,21,11,16,94,96
2020,2,22000869,4/19/2021,1610612741,Chicago Bulls,0,1,1610612738,Boston Celtics,1,0,30,29,59,11,21,32,41,50,91,9,1,10,13,37,30,8,12,96,102
2023,2,22300587,1/19/2024,1610612748,Miami Heat,1,0,1610612737,Atlanta Hawks,0,1,26,25,51,12,19,31,38,44,82,20,2,22,15,29,21,6,18,95,108
2021,2,22100150,11/8/2021,1610612740,New Orleans Pelicans,0,0,1610612742,Dallas Mavericks,1,1,28,25,53,9,25,34,37,50,87,9,2,11,14,38,27,7,14,93,92
2021,2,22100150,11/8/2021,1610612742,Dallas Mavericks,1,1,1610612740,New Orleans Pelicans,0,0,29,21,50,14,21,35,43,42,85,8,5,13,12,31,27,7,13,94,108
2016,2,21601079,3/24/2017,1610612740,New Orleans Pelicans,0,0,1610612745,Houston Rockets,1,1,27,26,53,14,24,38,41,50,91,11,3,14,6,45,28,5,10,101,107
2016,2,21601079,3/24/2017,1610612745,Houston Rockets,1,1,1610612740,New Orleans Pelicans,0,0,30,24,54,14,25,39,44,49,93,15,5,20,20,32,29,9,19,102,117
2019,2,21900247,11/25/2019,1610612741,Chicago Bulls,1,0,1610612757,Portland Trail Blazers,0,1,27,20,47,9,30,39,36,50,86,13,7,20,10,43,24,7,16,99,94
2019,2,21900247,11/25/2019,1610612757,Portland Trail Blazers,0,1,1610612741,Chicago Bulls,1,0,38,24,62,8,19,27,46,43,89,17,5,22,15,30,23,9,16,99,117
2023,2,22300536,1/12/2024,1610612744,Golden State Warriors,0,1,1610612741,Chicago Bulls,1,0,29,18,47,20,27,47,49,45,94,22,8,30,17,33,39,1,5,96,140
2023,2,22300575,1/17/2024,1610612766,Charlotte Hornets,0,0,1610612740,New Orleans Pelicans,1,1,20,25,45,19,26,45,39,51,90,15,3,18,18,34,29,11,14,94,112
2023,2,22300579,1/18/2024,1610612752,New York Knicks,1,1,1610612764,Washington Wizards,0,0,26,22,48,13,25,38,39,47,86,22,4,26,11,39,22,9,17,103,113
2023,2,22301013,3/22/2024,1610612748,Miami Heat,1,0,1610612740,New Orleans Pelicans,0,1,18,21,39,13,34,47,31,55,86,13,2,15,11,46,22,3,6,88,88
2014,2,21401177,4/10/2015,1610612751,Brooklyn Nets,1,1,1610612764,Washington Wizards,0,0,33,36,69,12,8,20,45,44,89,15,8,23,15,33,29,3,6,91,117
2023,2,22300552,1/14/2024,1610612758,Sacramento Kings,0,0,1610612749,Milwaukee Bucks,1,1,38,26,64,17,24,41,55,50,105,15,5,20,11,40,34,5,9,111,142
2023,2,22300734,2/8/2024,1610612753,Orlando Magic,1,1,1610612759,San Antonio Spurs,0,0,33,22,55,16,11,27,49,33,82,13,7,20,11,25,34,7,17,97,127
2021,2,22100149,11/8/2021,1610612750,Minnesota Timberwolves,0,0,1610612763,Memphis Grizzlies,1,1,24,28,52,17,28,45,41,56,97,19,4,23,19,40,23,7,16,104,118
2021,2,22100149,11/8/2021,1610612763,Memphis Grizzlies,1,1,1610612750,Minnesota Timberwolves,0,0,35,29,64,11,17,28,46,46,92,22,4,26,17,32,28,7,16,103,125
2016,2,21601078,3/24/2017,1610612737,Atlanta Hawks,0,0,1610612749,Milwaukee Bucks,1,1,26,35,61,8,14,22,34,49,83,21,3,24,20,30,20,10,17,93,97
2016,2,21601078,3/24/2017,1610612749,Milwaukee Bucks,1,1,1610612737,Atlanta Hawks,0,0,31,30,61,8,19,27,39,49,88,14,2,16,12,38,27,5,9,93,100
2023,2,22300574,1/17/2024,1610612748,Miami Heat,0,0,1610612761,Toronto Raptors,1,1,35,27,62,6,22,28,41,49,90,9,3,12,18,34,24,9,14,93,97
2023,2,22300535,1/12/2024,1610612753,Orlando Magic,0,0,1610612748,Miami Heat,1,1,24,18,42,12,28,40,36,46,82,12,8,20,16,33,26,6,13,93,96
2020,2,22000868,4/19/2021,1610612739,Cleveland Cavaliers,0,0,1610612765,Detroit Pistons,1,1,37,23,60,5,21,26,42,44,86,16,4,20,13,35,24,8,18,98,105
2020,2,22000868,4/19/2021,1610612765,Detroit Pistons,1,1,1610612739,Cleveland Cavaliers,0,0,32,27,59,10,17,27,42,44,86,15,6,21,14,33,25,9,17,98,109
2019,2,21900027,10/26/2019,1610612755,Philadelphia 76ers,0,1,1610612765,Detroit Pistons,1,0,29,24,53,13,21,34,42,45,87,20,10,30,15,34,30,11,22,110,117
2019,2,21900027,10/26/2019,1610612765,Detroit Pistons,1,0,1610612755,Philadelphia 76ers,0,1,33,24,57,8,11,19,41,35,76,21,15,36,8,35,20,14,23,109,111
2020,2,22000867,4/18/2021,1610612746,LA Clippers,1,1,1610612750,Minnesota Timberwolves,0,0,24,23,47,21,21,42,45,44,89,13,4,17,12,34,31,6,15,99,124
2020,2,22000867,4/18/2021,1610612750,Minnesota Timberwolves,0,0,1610612746,LA Clippers,1,1,19,24,43,17,28,45,36,52,88,16,5,21,10,45,27,6,11,100,105
2023,2,22300758,2/10/2024,1610612740,New Orleans Pelicans,0,1,1610612757,Portland Trail Blazers,1,0,26,23,49,10,17,27,36,40,76,11,5,16,12,31,27,7,12,84,93
2023,2,22300573,1/17/2024,1610612752,New York Knicks,1,1,1610612745,Houston Rockets,0,0,26,24,50,13,24,37,39,48,87,18,4,22,17,33,24,6,15,94,109
2021,2,22100148,11/8/2021,1610612741,Chicago Bulls,1,1,1610612751,Brooklyn Nets,0,0,37,30,67,9,22,31,46,52,98,17,3,20,18,37,21,6,9,100,118
2023,2,22300758,2/10/2024,1610612757,Portland Trail Blazers,1,0,1610612740,New Orleans Pelicans,0,1,27,28,55,6,15,21,33,43,76,12,5,17,16,29,19,9,18,85,84
2023,2,22300627,1/25/2024,1610612755,Philadelphia 76ers,0,0,1610612754,Indiana Pacers,1,1,35,23,58,7,22,29,42,45,87,31,12,43,8,45,24,6,12,107,122
2021,2,22100148,11/8/2021,1610612751,Brooklyn Nets,0,0,1610612741,Chicago Bulls,1,1,23,30,53,11,22,33,34,52,86,16,3,19,10,44,19,8,15,100,95
2019,2,21900246,11/25/2019,1610612755,Philadelphia 76ers,0,0,1610612761,Toronto Raptors,1,1,21,27,48,15,25,40,36,52,88,9,7,16,19,37,25,5,16,93,96
2019,2,21900246,11/25/2019,1610612761,Toronto Raptors,1,1,1610612755,Philadelphia 76ers,0,0,27,23,50,11,23,34,38,46,84,14,8,22,11,38,27,7,10,94,101
2022,2,22201228,4/9/2023,1610612747,Los Angeles Lakers,1,1,1610612762,Utah Jazz,0,0,29,23,52,18,27,45,47,50,97,16,5,21,13,39,28,4,11,105,128
2020,2,22000866,4/18/2021,1610612742,Dallas Mavericks,1,0,1610612758,Sacramento Kings,0,1,23,16,39,16,32,48,39,48,87,13,7,20,13,36,15,11,14,96,107
2020,2,22000866,4/18/2021,1610612758,Sacramento Kings,0,1,1610612742,Dallas Mavericks,1,0,33,32,65,11,13,24,44,45,89,22,3,25,12,35,22,3,8,96,121
2023,2,22300573,1/17/2024,1610612745,Houston Rockets,0,0,1610612752,New York Knicks,1,1,27,27,54,8,22,30,35,49,84,16,3,19,9,41,23,6,10,94,94
2023,2,22300586,1/19/2024,1610612738,Boston Celtics,1,0,1610612743,Denver Nuggets,0,1,24,21,45,14,30,44,38,51,89,10,4,14,14,39,21,0,3,85,100
2023,2,22300558,1/15/2024,1610612765,Detroit Pistons,0,1,1610612764,Washington Wizards,1,0,38,21,59,12,19,31,50,40,90,17,6,23,18,27,30,8,16,95,129
2023,2,22300629,1/25/2024,1610612750,Minnesota Timberwolves,0,1,1610612751,Brooklyn Nets,1,0,27,27,54,10,11,21,37,38,75,12,4,16,10,31,24,7,17,91,96
2023,2,22300748,2/10/2024,1610612760,Oklahoma City Thunder,0,0,1610612742,Dallas Mavericks,1,1,21,30,51,17,30,47,38,60,98,18,3,21,14,48,23,8,10,104,111
2021,2,22100147,11/8/2021,1610612752,New York Knicks,0,1,1610612755,Philadelphia 76ers,1,0,27,24,51,13,27,40,40,51,91,10,3,13,17,35,25,7,13,94,103
2021,2,22100147,11/8/2021,1610612755,Philadelphia 76ers,1,0,1610612752,New York Knicks,0,1,22,29,51,13,27,40,35,56,91,13,3,16,14,42,20,4,9,94,96
2023,2,22300630,1/25/2024,1610612748,Miami Heat,1,0,1610612738,Boston Celtics,0,1,26,26,52,16,26,42,42,52,94,10,3,13,11,42,25,4,5,94,110
2023,2,22300587,1/19/2024,1610612737,Atlanta Hawks,0,1,1610612748,Miami Heat,1,0,25,27,52,15,20,35,40,47,87,14,3,17,15,33,23,7,15,96,109
2021,2,22100146,11/7/2021,1610612746,LA Clippers,1,1,1610612766,Charlotte Hornets,0,0,23,15,38,18,30,48,41,45,86,20,1,21,13,33,24,13,20,103,120
2021,2,22100146,11/7/2021,1610612766,Charlotte Hornets,0,0,1610612746,LA Clippers,1,1,31,37,68,10,23,33,41,60,101,14,4,18,18,46,20,8,13,102,106
2022,2,22201224,4/9/2023,1610612742,Dallas Mavericks,1,0,1610612759,San Antonio Spurs,0,1,29,26,55,17,36,53,46,62,108,8,8,16,9,56,28,2,4,110,117
2023,2,22300527,1/11/2024,1610612739,Cleveland Cavaliers,1,1,1610612751,Brooklyn Nets,0,0,19,19,38,13,31,44,32,50,82,34,9,43,17,37,16,5,11,100,111
2023,2,22300621,1/24/2024,1610612748,Miami Heat,1,0,1610612763,Memphis Grizzlies,0,1,22,26,48,11,23,34,33,49,82,19,6,25,14,39,21,8,17,100,96
2023,2,22300574,1/17/2024,1610612761,Toronto Raptors,1,1,1610612748,Miami Heat,0,0,25,25,50,20,18,38,45,43,88,11,7,18,16,28,34,4,12,92,121
2023,2,22300556,1/15/2024,1610612742,Dallas Mavericks,1,1,1610612740,New Orleans Pelicans,0,0,21,21,42,18,25,43,39,46,85,29,6,35,16,32,24,9,11,96,125
2023,2,22300702,2/3/2024,1610612749,Milwaukee Bucks,0,1,1610612742,Dallas Mavericks,1,0,38,20,58,12,18,30,50,38,88,17,8,25,5,37,34,9,12,104,129
2023,2,22300582,1/18/2024,1610612750,Minnesota Timberwolves,1,1,1610612763,Memphis Grizzlies,0,0,33,21,54,12,16,28,45,37,82,16,5,21,12,26,30,9,15,96,118
2023,2,22300614,1/23/2024,1610612743,Denver Nuggets,0,1,1610612754,Indiana Pacers,1,0,33,22,55,11,22,33,44,44,88,15,2,17,14,31,22,4,12,95,114
2023,2,22300732,2/7/2024,1610612765,Detroit Pistons,0,1,1610612758,Sacramento Kings,1,0,30,23,53,17,14,31,47,37,84,22,0,22,7,30,32,7,13,100,133
2023,2,22300759,2/11/2024,1610612738,Boston Celtics,0,1,1610612748,Miami Heat,1,0,25,17,42,16,23,39,41,40,81,12,5,17,11,31,27,4,11,89,110
2023,2,22300993,3/19/2024,1610612740,New Orleans Pelicans,0,1,1610612751,Brooklyn Nets,1,0,32,17,49,10,24,34,42,41,83,10,3,13,13,29,29,6,14,90,104
2023,2,22301061,3/28/2024,1610612740,New Orleans Pelicans,1,1,1610612749,Milwaukee Bucks,0,0,28,31,59,8,24,32,36,55,91,27,7,34,16,44,22,1,7,97,107
2021,2,22100145,11/7/2021,1610612744,Golden State Warriors,1,1,1610612745,Houston Rockets,0,0,29,10,39,15,31,46,44,41,85,17,3,20,11,32,31,11,17,101,120
2021,2,22100145,11/7/2021,1610612745,Houston Rockets,0,0,1610612744,Golden State Warriors,1,1,26,20,46,10,23,33,36,43,79,25,12,37,14,36,17,12,21,101,107
2014,2,21401177,4/10/2015,1610612764,Washington Wizards,0,0,1610612751,Brooklyn Nets,1,1,27,40,67,5,10,15,32,50,82,11,6,17,21,33,23,10,21,91,80
2023,2,22300559,1/15/2024,1610612759,San Antonio Spurs,0,0,1610612737,Atlanta Hawks,1,1,27,26,53,11,31,42,38,57,95,12,5,17,13,45,27,8,18,107,99
2023,2,22300748,2/10/2024,1610612742,Dallas Mavericks,1,1,1610612760,Oklahoma City Thunder,0,0,38,15,53,15,23,38,53,38,91,25,8,33,13,29,30,5,12,104,146
2023,2,22300631,1/25/2024,1610612743,Denver Nuggets,0,0,1610612752,New York Knicks,1,1,29,29,58,5,21,26,34,50,84,11,2,13,18,32,20,12,19,92,84
2023,2,22300736,2/8/2024,1610612742,Dallas Mavericks,0,1,1610612752,New York Knicks,1,0,25,15,40,18,24,42,43,39,82,18,5,23,7,34,30,5,9,94,122
2021,2,22100144,11/7/2021,1610612759,San Antonio Spurs,0,0,1610612760,Oklahoma City Thunder,1,1,35,35,70,6,24,30,41,59,100,6,3,9,14,47,29,5,10,100,94
2021,2,22100144,11/7/2021,1610612760,Oklahoma City Thunder,1,1,1610612759,San Antonio Spurs,0,0,23,29,52,12,30,42,35,59,94,17,3,20,18,42,21,9,15,100,99
2022,2,22201224,4/9/2023,1610612759,San Antonio Spurs,0,1,1610612742,Dallas Mavericks,1,0,36,30,66,15,23,38,51,53,104,21,9,30,16,41,31,4,12,111,138
2020,2,22000865,4/18/2021,1610612760,Oklahoma City Thunder,0,0,1610612761,Toronto Raptors,1,1,23,26,49,14,19,33,37,45,82,18,3,21,14,33,22,9,23,101,106
2020,2,22000865,4/18/2021,1610612761,Toronto Raptors,1,1,1610612760,Oklahoma City Thunder,0,0,20,38,58,17,21,38,37,59,96,21,3,24,22,38,23,6,15,102,112
2023,2,22300628,1/25/2024,1610612762,Utah Jazz,0,1,1610612764,Washington Wizards,1,0,37,29,66,13,18,31,50,47,97,10,2,12,17,32,34,11,16,102,123
2023,2,22300770,2/12/2024,1610612746,LA Clippers,1,0,1610612750,Minnesota Timberwolves,0,1,25,31,56,9,19,28,34,50,84,23,3,26,14,37,20,9,13,95,100
2023,2,22300577,1/17/2024,1610612742,Dallas Mavericks,0,0,1610612747,Los Angeles Lakers,1,1,31,20,51,11,29,40,42,49,91,15,3,18,14,36,26,8,15,101,110
2021,2,22100143,11/7/2021,1610612754,Indiana Pacers,0,1,1610612758,Sacramento Kings,1,0,31,27,58,6,19,25,37,46,83,14,4,18,19,28,13,14,21,93,94
2022,2,22201230,4/9/2023,1610612744,Golden State Warriors,0,1,1610612757,Portland Trail Blazers,1,0,31,16,47,27,22,49,58,38,96,14,2,16,9,29,47,5,16,110,157
2023,2,22300583,1/18/2024,1610612754,Indiana Pacers,0,1,1610612758,Sacramento Kings,1,0,36,20,56,13,20,33,49,40,89,15,4,19,11,33,33,7,12,100,126
2021,2,22100143,11/7/2021,1610612758,Sacramento Kings,1,0,1610612754,Indiana Pacers,0,1,21,29,50,10,24,34,31,53,84,19,3,22,11,43,20,8,12,93,91
2023,2,22300577,1/17/2024,1610612747,Los Angeles Lakers,1,1,1610612742,Dallas Mavericks,0,0,37,26,63,12,16,28,49,42,91,17,7,24,13,32,33,4,11,100,127
2016,2,21601077,3/24/2017,1610612741,Chicago Bulls,1,0,1610612755,Philadelphia 76ers,0,1,27,40,67,10,14,24,37,54,91,23,8,31,22,36,22,10,15,100,107
2016,2,21601077,3/24/2017,1610612755,Philadelphia 76ers,0,1,1610612741,Chicago Bulls,1,0,38,20,58,8,17,25,46,37,83,17,6,23,15,25,23,9,19,99,117
2022,2,22201228,4/9/2023,1610612762,Utah Jazz,0,0,1610612747,Los Angeles Lakers,1,1,41,25,66,10,25,35,51,50,101,5,1,6,10,41,31,4,11,103,117
2023,2,22300770,2/12/2024,1610612750,Minnesota Timberwolves,0,1,1610612746,LA Clippers,1,0,35,17,52,11,23,34,46,40,86,18,1,19,14,26,33,6,13,95,121
2023,2,22300559,1/15/2024,1610612737,Atlanta Hawks,1,1,1610612759,San Antonio Spurs,0,0,27,28,55,13,25,38,40,53,93,16,5,21,14,41,24,10,20,108,109
2021,2,22100142,11/7/2021,1610612749,Milwaukee Bucks,0,0,1610612764,Washington Wizards,1,1,27,31,58,10,26,36,37,57,94,10,8,18,19,41,17,8,13,98,94
2021,2,22100142,11/7/2021,1610612764,Washington Wizards,1,1,1610612749,Milwaukee Bucks,0,0,30,24,54,11,16,27,41,40,81,8,5,13,7,33,24,14,19,98,101
2023,2,22300556,1/15/2024,1610612740,New Orleans Pelicans,0,0,1610612742,Dallas Mavericks,1,1,34,24,58,7,16,23,41,40,81,31,10,41,13,30,21,4,11,98,120
2023,2,22300628,1/25/2024,1610612764,Washington Wizards,1,0,1610612762,Utah Jazz,0,1,36,22,58,7,23,30,43,45,88,15,5,20,7,40,33,6,11,101,108
2023,2,22300699,2/3/2024,1610612737,Atlanta Hawks,1,1,1610612744,Golden State Warriors,0,0,41,30,71,14,29,43,55,59,114,17,5,22,17,45,27,4,8,114,141
2023,2,22300657,1/29/2024,1610612752,New York Knicks,0,1,1610612766,Charlotte Hornets,1,0,32,15,47,12,25,37,44,40,84,13,3,16,8,34,25,4,9,89,113
2023,2,22300657,1/29/2024,1610612766,Charlotte Hornets,1,0,1610612752,New York Knicks,0,1,26,23,49,11,21,32,37,44,81,7,7,14,11,36,23,5,14,89,92
2019,2,21900245,11/25/2019,1610612748,Miami Heat,1,1,1610612766,Charlotte Hornets,0,0,27,19,46,13,18,31,40,37,77,24,4,28,13,26,29,11,19,96,117
2019,2,21900245,11/25/2019,1610612766,Charlotte Hornets,0,0,1610612748,Miami Heat,1,1,27,27,54,9,24,33,36,51,87,19,6,25,14,43,25,9,14,96,100
2016,2,21600524,1/3/2017,1610612742,Dallas Mavericks,1,1,1610612764,Washington Wizards,0,0,20,26,46,17,15,32,37,41,78,22,2,24,7,34,20,6,15,97,113
2016,2,21600524,1/3/2017,1610612764,Washington Wizards,0,0,1610612742,Dallas Mavericks,1,1,30,32,62,11,19,30,41,51,92,12,2,14,9,44,27,4,10,98,105
2020,2,22000864,4/18/2021,1610612745,Houston Rockets,0,1,1610612753,Orlando Magic,1,0,26,22,48,16,18,34,42,40,82,14,6,20,12,29,26,10,19,100,114
2020,2,22000864,4/18/2021,1610612753,Orlando Magic,1,0,1610612745,Houston Rockets,0,1,30,29,59,11,21,32,41,50,91,17,2,19,16,36,28,7,15,99,110
2022,2,22201229,4/9/2023,1610612746,LA Clippers,0,1,1610612756,Phoenix Suns,1,0,44,33,77,5,18,23,49,51,100,16,8,24,18,38,22,4,10,101,119
2023,2,22300578,1/17/2024,1610612751,Brooklyn Nets,0,0,1610612757,Portland Trail Blazers,1,1,20,15,35,15,23,38,35,38,73,18,9,27,10,32,28,2,11,89,103
2023,2,22300571,1/17/2024,1610612759,San Antonio Spurs,0,0,1610612738,Boston Celtics,1,1,32,27,59,7,27,34,39,54,93,13,3,16,14,43,26,5,10,98,98
2023,2,22300588,1/19/2024,1610612740,New Orleans Pelicans,1,0,1610612756,Phoenix Suns,0,1,31,20,51,10,32,42,41,52,93,17,6,23,13,43,27,7,11,101,109
2023,2,22300630,1/25/2024,1610612738,Boston Celtics,0,1,1610612748,Miami Heat,1,0,29,11,40,22,18,40,51,29,80,19,1,20,8,21,36,7,11,93,143
2023,2,22300732,2/7/2024,1610612758,Sacramento Kings,1,0,1610612765,Detroit Pistons,0,1,30,21,51,15,29,44,45,50,95,15,7,22,9,45,31,2,4,100,120
2023,2,22300933,3/11/2024,1610612765,Detroit Pistons,1,1,1610612766,Charlotte Hornets,0,0,31,13,44,10,32,42,41,45,86,22,2,24,13,33,26,7,12,97,114
2023,2,22300570,1/17/2024,1610612753,Orlando Magic,0,0,1610612737,Atlanta Hawks,1,1,29,24,53,10,25,35,39,49,88,16,6,22,18,37,18,8,13,94,104
2023,2,22300578,1/17/2024,1610612757,Portland Trail Blazers,1,1,1610612751,Brooklyn Nets,0,0,33,26,59,9,18,27,42,44,86,12,2,14,16,28,21,9,13,89,105
2023,2,22300831,2/26/2024,1610612758,Sacramento Kings,1,0,1610612748,Miami Heat,0,1,32,21,53,13,19,32,45,40,85,7,5,12,11,32,30,12,15,95,110
2023,2,22300631,1/25/2024,1610612752,New York Knicks,1,1,1610612743,Denver Nuggets,0,0,30,17,47,15,23,38,45,40,85,17,3,20,12,31,26,2,10,91,122
2023,2,22300627,1/25/2024,1610612754,Indiana Pacers,1,1,1610612755,Philadelphia 76ers,0,0,41,24,65,12,16,28,53,40,93,16,5,21,16,27,35,13,21,107,134
2021,2,22100141,11/7/2021,1610612753,Orlando Magic,1,1,1610612762,Utah Jazz,0,0,31,24,55,12,20,32,43,44,87,9,2,11,10,35,24,10,13,96,107
2021,2,22100141,11/7/2021,1610612762,Utah Jazz,0,0,1610612753,Orlando Magic,1,1,26,21,47,8,34,42,34,55,89,24,5,29,25,32,21,8,18,96,100
2023,2,22300697,2/2/2024,1610612743,Denver Nuggets,1,1,1610612757,Portland Trail Blazers,0,0,34,21,55,12,24,36,46,45,91,16,1,17,21,24,34,7,12,91,120
2023,2,22300749,2/10/2024,1610612746,LA Clippers,1,1,1610612765,Detroit Pistons,0,0,24,19,43,13,26,39,37,45,82,25,1,26,1,44,20,7,11,102,112
2022,2,22201226,4/9/2023,1610612763,Memphis Grizzlies,0,0,1610612760,Oklahoma City Thunder,1,1,33,22,55,7,30,37,40,52,92,13,5,18,12,43,25,5,12,100,100
2019,2,21900026,10/26/2019,1610612748,Miami Heat,0,1,1610612749,Milwaukee Bucks,1,0,30,27,57,16,28,44,46,55,101,23,13,36,15,47,33,8,18,122,131
2019,2,21900026,10/26/2019,1610612749,Milwaukee Bucks,1,0,1610612748,Miami Heat,0,1,24,16,40,17,37,54,41,53,94,27,8,35,6,51,22,7,18,122,126
2023,2,22300572,1/17/2024,1610612749,Milwaukee Bucks,0,0,1610612739,Cleveland Cavaliers,1,1,26,27,53,12,30,42,38,57,95,7,3,10,12,45,19,5,10,99,95
2023,2,22300614,1/23/2024,1610612754,Indiana Pacers,1,0,1610612743,Denver Nuggets,0,1,38,28,66,5,16,21,43,44,87,18,3,21,14,32,24,5,10,94,109
2023,2,22300951,3/13/2024,1610612739,Cleveland Cavaliers,0,1,1610612740,New Orleans Pelicans,1,0,27,20,47,20,25,45,47,45,92,2,1,3,9,36,38,7,12,97,116
2023,2,22300731,2/7/2024,1610612746,LA Clippers,1,0,1610612740,New Orleans Pelicans,0,1,24,22,46,12,20,32,36,42,78,22,4,26,11,32,23,13,19,99,106
2023,2,22300749,2/10/2024,1610612765,Detroit Pistons,0,0,1610612746,LA Clippers,1,1,36,36,72,9,21,30,45,57,102,7,0,7,16,41,27,9,14,102,106
2022,2,22200589,1/6/2023,1610612748,Miami Heat,0,1,1610612756,Phoenix Suns,1,0,21,19,40,12,26,38,33,45,78,26,5,31,8,38,19,5,13,96,104
2022,2,22200589,1/6/2023,1610612756,Phoenix Suns,1,0,1610612748,Miami Heat,0,1,28,31,59,6,17,23,34,48,82,22,3,25,12,36,22,10,14,95,96
2021,2,22100140,11/7/2021,1610612739,Cleveland Cavaliers,0,1,1610612752,New York Knicks,1,0,30,25,55,19,16,35,49,41,90,9,2,11,14,28,31,9,17,98,126
2021,2,22100140,11/7/2021,1610612752,New York Knicks,1,0,1610612739,Cleveland Cavaliers,0,1,30,24,54,9,22,31,39,46,85,22,2,24,9,39,21,8,11,97,109
2019,2,21900244,11/25/2019,1610612738,Boston Celtics,1,1,1610612758,Sacramento Kings,0,0,31,24,55,7,23,30,38,47,85,20,3,23,18,29,20,3,12,89,103
2019,2,21900244,11/25/2019,1610612758,Sacramento Kings,0,0,1610612738,Boston Celtics,1,1,19,13,32,18,29,47,37,42,79,10,5,15,15,30,28,10,17,90,102
2022,2,22201230,4/9/2023,1610612757,Portland Trail Blazers,1,0,1610612744,Golden State Warriors,0,1,29,31,60,9,26,35,38,57,95,16,8,24,11,50,25,13,14,110,101
2023,2,22300571,1/17/2024,1610612738,Boston Celtics,1,1,1610612759,San Antonio Spurs,0,0,24,28,52,18,20,38,42,48,90,15,4,19,17,33,22,5,14,97,117
2023,2,22300703,2/3/2024,1610612739,Cleveland Cavaliers,0,1,1610612759,San Antonio Spurs,1,0,33,20,53,13,31,44,46,51,97,12,1,13,12,40,31,6,10,100,117
2023,2,22300731,2/7/2024,1610612740,New Orleans Pelicans,0,1,1610612746,LA Clippers,1,0,35,21,56,12,20,32,47,41,88,11,5,16,13,32,30,7,15,99,117
2023,2,22300684,2/1/2024,1610612738,Boston Celtics,1,0,1610612747,Los Angeles Lakers,0,1,25,24,49,16,32,48,41,56,97,7,0,7,18,38,30,11,15,99,105
2020,2,22000863,4/18/2021,1610612748,Miami Heat,1,1,1610612751,Brooklyn Nets,0,0,22,26,48,16,23,39,38,49,87,17,4,21,18,34,28,10,17,95,109
2020,2,22000863,4/18/2021,1610612751,Brooklyn Nets,0,0,1610612748,Miami Heat,1,1,22,17,39,17,26,43,39,43,82,12,6,18,9,37,26,9,11,94,107
2021,2,22100139,11/7/2021,1610612751,Brooklyn Nets,0,1,1610612761,Toronto Raptors,1,0,24,18,42,17,21,38,41,39,80,17,3,20,12,29,29,10,16,92,116
2021,2,22100139,11/7/2021,1610612761,Toronto Raptors,1,0,1610612751,Brooklyn Nets,0,1,34,23,57,7,23,30,41,46,87,14,4,18,10,38,23,3,8,94,103
2023,2,22300951,3/13/2024,1610612740,New Orleans Pelicans,1,0,1610612739,Cleveland Cavaliers,0,1,31,27,58,4,18,22,35,45,80,21,5,26,7,40,22,4,12,96,95
2023,2,22300570,1/17/2024,1610612737,Atlanta Hawks,1,1,1610612753,Orlando Magic,0,0,31,20,51,8,17,25,39,37,76,20,2,22,13,26,21,16,23,96,106
2023,2,22300560,1/15/2024,1610612763,Memphis Grizzlies,1,1,1610612744,Golden State Warriors,0,0,12,20,32,20,34,54,32,54,86,32,8,40,18,41,24,4,13,101,116
2023,2,22300831,2/26/2024,1610612748,Miami Heat,0,1,1610612758,Sacramento Kings,1,0,34,23,57,11,19,30,45,42,87,20,5,25,12,33,27,10,11,96,121
2023,2,22300666,1/29/2024,1610612742,Dallas Mavericks,1,1,1610612753,Orlando Magic,0,0,30,12,42,13,14,27,43,26,69,32,11,43,5,26,27,7,15,98,131
2023,2,22300703,2/3/2024,1610612759,San Antonio Spurs,1,0,1610612739,Cleveland Cavaliers,0,1,24,34,58,12,28,40,36,62,98,17,4,21,20,44,23,6,12,101,101
2023,2,22300762,2/12/2024,1610612755,Philadelphia 76ers,0,1,1610612739,Cleveland Cavaliers,1,0,37,25,62,11,15,26,48,40,88,16,3,19,12,29,25,6,11,94,123
2023,2,22300936,3/11/2024,1610612744,Golden State Warriors,0,1,1610612759,San Antonio Spurs,1,0,34,32,66,12,15,27,46,47,93,8,4,12,13,37,28,6,14,100,112
2023,2,22300701,2/3/2024,1610612752,New York Knicks,1,0,1610612747,Los Angeles Lakers,0,1,31,34,65,10,25,35,41,59,100,13,2,15,21,39,21,4,7,92,105
2023,2,22300660,1/29/2024,1610612762,Utah Jazz,0,0,1610612751,Brooklyn Nets,1,1,30,29,59,9,18,27,39,47,86,27,7,34,15,36,23,12,17,103,114
2023,2,22300663,1/29/2024,1610612758,Sacramento Kings,0,1,1610612763,Memphis Grizzlies,1,0,32,14,46,11,27,38,43,41,84,6,4,10,13,31,24,11,19,96,103
2021,2,22100138,11/6/2021,1610612747,Los Angeles Lakers,0,0,1610612757,Portland Trail Blazers,1,1,22,36,58,9,23,32,31,59,90,19,5,24,15,45,20,14,19,107,90
2021,2,22100138,11/6/2021,1610612757,Portland Trail Blazers,1,1,1610612747,Los Angeles Lakers,0,0,21,19,40,15,40,55,36,59,95,18,6,24,13,49,22,8,12,105,105
2016,2,21600523,1/3/2017,1610612754,Indiana Pacers,0,1,1610612765,Detroit Pistons,1,0,34,24,58,9,7,16,43,31,74,26,4,30,6,26,26,5,11,92,121
2022,2,22201227,4/9/2023,1610612758,Sacramento Kings,0,0,1610612743,Denver Nuggets,1,1,26,16,42,11,32,43,37,48,85,10,5,15,12,38,24,11,15,96,95
2023,2,22300595,1/20/2024,1610612739,Cleveland Cavaliers,0,1,1610612737,Atlanta Hawks,1,0,27,15,42,16,27,43,43,42,85,14,2,16,7,36,32,5,14,100,116
2023,2,22300701,2/3/2024,1610612747,Los Angeles Lakers,0,1,1610612752,New York Knicks,1,0,27,22,49,12,19,31,39,41,80,23,4,27,6,36,28,1,5,93,113
2023,2,22300666,1/29/2024,1610612753,Orlando Magic,0,0,1610612742,Dallas Mavericks,1,1,27,23,50,18,20,38,45,43,88,21,7,28,14,33,27,6,12,98,129
2023,2,22301004,3/21/2024,1610612753,Orlando Magic,1,1,1610612740,New Orleans Pelicans,0,0,33,17,50,14,22,36,47,39,86,13,6,19,12,31,33,11,16,100,121
2023,2,22300560,1/15/2024,1610612744,Golden State Warriors,0,0,1610612763,Memphis Grizzlies,1,1,34,25,59,10,21,31,44,46,90,9,1,10,14,32,28,13,19,100,107
2021,2,22100137,11/6/2021,1610612737,Atlanta Hawks,0,0,1610612756,Phoenix Suns,1,1,29,35,64,13,20,33,42,55,97,20,3,23,16,41,18,8,12,104,117
2021,2,22100137,11/6/2021,1610612756,Phoenix Suns,1,1,1610612737,Atlanta Hawks,0,0,31,14,45,14,29,43,45,43,88,17,4,21,6,40,26,3,12,104,121
2023,2,22300615,1/23/2024,1610612752,New York Knicks,0,1,1610612751,Brooklyn Nets,1,0,30,27,57,10,19,29,40,46,86,18,1,19,18,29,21,7,14,93,108
2023,2,22300685,2/1/2024,1610612752,New York Knicks,1,1,1610612754,Indiana Pacers,0,0,33,32,65,8,30,38,41,62,103,19,6,25,27,38,15,9,10,98,109
2023,2,22300933,3/11/2024,1610612766,Charlotte Hornets,0,0,1610612765,Detroit Pistons,1,1,21,27,48,13,27,40,34,54,88,16,7,23,13,44,27,8,13,98,97
2023,2,22300588,1/19/2024,1610612756,Phoenix Suns,0,1,1610612740,New Orleans Pelicans,1,0,31,21,52,15,26,41,46,47,93,16,5,21,12,36,32,4,10,101,123
2021,2,22100136,11/6/2021,1610612738,Boston Celtics,0,0,1610612742,Dallas Mavericks,1,1,33,22,55,9,22,31,42,44,86,11,5,16,13,34,20,7,11,92,104
2021,2,22100136,11/6/2021,1610612742,Dallas Mavericks,1,1,1610612738,Boston Celtics,0,0,28,11,39,13,26,39,41,37,78,12,2,14,9,28,19,6,15,92,107
2023,2,22300615,1/23/2024,1610612751,Brooklyn Nets,1,0,1610612752,New York Knicks,0,1,27,26,53,15,27,42,42,53,95,4,1,5,18,35,29,8,13,92,103
2021,2,22100135,11/6/2021,1610612741,Chicago Bulls,1,0,1610612755,Philadelphia 76ers,0,1,30,33,63,7,22,29,37,55,92,24,6,30,20,36,20,6,9,95,105
2021,2,22100135,11/6/2021,1610612755,Philadelphia 76ers,0,1,1610612741,Chicago Bulls,1,0,30,25,55,13,13,26,43,38,81,15,4,19,9,30,22,7,14,94,114
2016,2,21601076,3/24/2017,1610612738,Boston Celtics,1,1,1610612756,Phoenix Suns,0,0,30,23,53,14,27,41,44,50,94,28,7,35,15,40,31,9,15,109,130
2023,2,22300737,2/8/2024,1610612741,Chicago Bulls,0,1,1610612763,Memphis Grizzlies,1,0,31,22,53,12,14,26,43,36,79,20,2,22,11,26,24,8,15,94,118
2023,2,22300659,1/29/2024,1610612740,New Orleans Pelicans,0,0,1610612738,Boston Celtics,1,1,36,20,56,10,25,35,46,45,91,10,3,13,12,35,21,7,12,96,112
2021,2,22100134,11/6/2021,1610612748,Miami Heat,1,1,1610612762,Utah Jazz,0,0,36,21,57,11,10,21,47,31,78,13,4,17,10,24,30,10,14,90,118
2021,2,22100134,11/6/2021,1610612762,Utah Jazz,0,0,1610612748,Miami Heat,1,1,28,10,38,15,30,45,43,40,83,14,5,19,9,34,26,3,6,90,115
2023,2,22300774,2/13/2024,1610612758,Sacramento Kings,0,0,1610612756,Phoenix Suns,1,1,40,24,64,9,22,31,49,46,95,18,6,24,15,33,27,11,13,103,125
2023,2,22300702,2/3/2024,1610612742,Dallas Mavericks,1,0,1610612749,Milwaukee Bucks,0,1,24,18,42,16,23,39,40,41,81,21,2,23,9,33,22,13,21,103,117
2023,2,22300586,1/19/2024,1610612743,Denver Nuggets,0,1,1610612738,Boston Celtics,1,0,34,16,50,8,23,31,42,39,81,10,3,13,13,28,20,5,11,84,102
2023,2,22300664,1/29/2024,1610612760,Oklahoma City Thunder,1,0,1610612750,Minnesota Timberwolves,0,1,21,23,44,14,21,35,35,44,79,17,5,22,9,39,21,7,12,92,101
2023,2,22300774,2/13/2024,1610612756,Phoenix Suns,1,1,1610612758,Sacramento Kings,0,0,31,23,54,13,18,31,44,41,85,29,7,36,11,35,29,8,12,103,130
2023,2,22300711,2/4/2024,1610612762,Utah Jazz,1,1,1610612749,Milwaukee Bucks,0,0,26,19,45,17,27,44,43,46,89,20,4,24,17,30,31,8,16,99,123
2023,2,22300936,3/11/2024,1610612759,San Antonio Spurs,1,0,1610612744,Golden State Warriors,0,1,25,31,56,14,23,37,39,54,93,10,5,15,17,39,27,7,15,98,102
2021,2,22100133,11/6/2021,1610612743,Denver Nuggets,1,1,1610612745,Houston Rockets,0,0,27,22,49,9,31,40,36,53,89,14,3,17,11,43,19,8,11,96,95
2021,2,22100133,11/6/2021,1610612745,Houston Rockets,0,0,1610612743,Denver Nuggets,1,1,27,20,47,8,20,28,35,40,75,16,8,24,8,36,19,10,17,96,94
2023,2,22300660,1/29/2024,1610612751,Brooklyn Nets,1,1,1610612762,Utah Jazz,0,0,33,27,60,21,24,45,54,51,105,18,1,19,19,32,41,3,9,104,147
2023,2,22300616,1/23/2024,1610612740,New Orleans Pelicans,1,1,1610612762,Utah Jazz,0,0,37,21,58,23,23,46,60,44,104,10,5,15,14,34,41,4,9,106,153
2023,2,22300620,1/24/2024,1610612750,Minnesota Timberwolves,0,1,1610612764,Washington Wizards,1,0,33,35,68,9,23,32,42,58,100,25,4,29,16,45,26,2,7,103,118
2023,2,22300737,2/8/2024,1610612763,Memphis Grizzlies,1,0,1610612741,Chicago Bulls,0,1,24,21,45,18,28,46,42,49,91,8,5,13,13,39,26,3,10,94,110
2022,2,22201225,4/9/2023,1610612750,Minnesota Timberwolves,1,1,1610612740,New Orleans Pelicans,0,0,26,20,46,13,23,36,39,43,82,22,9,31,11,38,25,13,17,103,113
2023,2,22300640,1/26/2024,1610612740,New Orleans Pelicans,1,0,1610612760,Oklahoma City Thunder,0,1,23,23,46,9,27,36,32,50,82,10,4,14,11,41,24,11,20,97,83
2021,2,22100132,11/5/2021,1610612758,Sacramento Kings,1,1,1610612766,Charlotte Hornets,0,0,26,17,43,22,22,44,48,39,87,22,4,26,14,25,29,8,18,103,140
2021,2,22100132,11/5/2021,1610612766,Charlotte Hornets,0,0,1610612758,Sacramento Kings,1,1,32,25,57,11,24,35,43,49,92,13,8,21,10,44,29,5,10,103,110
2019,2,21900025,10/25/2019,1610612747,Los Angeles Lakers,1,1,1610612762,Utah Jazz,0,0,26,34,60,8,18,26,34,52,86,19,5,24,16,39,19,8,14,94,95
2019,2,21900025,10/25/2019,1610612762,Utah Jazz,0,0,1610612747,Los Angeles Lakers,1,1,21,24,45,8,17,25,29,41,70,20,1,21,8,34,19,14,23,95,86
2023,2,22300684,2/1/2024,1610612747,Los Angeles Lakers,0,1,1610612738,Boston Celtics,1,0,19,39,58,19,17,36,38,56,94,19,7,26,16,43,30,4,7,97,114
2023,2,22300616,1/23/2024,1610612762,Utah Jazz,0,0,1610612740,New Orleans Pelicans,1,1,31,25,56,12,24,36,43,49,92,26,6,32,9,45,27,5,8,105,124
2023,2,22300661,1/29/2024,1610612756,Phoenix Suns,0,1,1610612748,Miami Heat,1,0,32,22,54,14,26,40,46,48,94,12,5,17,14,39,30,5,8,94,118
2021,2,22100131,11/5/2021,1610612754,Indiana Pacers,0,0,1610612757,Portland Trail Blazers,1,1,29,17,46,14,28,42,43,45,88,6,4,10,10,37,28,7,11,96,106
2021,2,22100131,11/5/2021,1610612757,Portland Trail Blazers,1,1,1610612754,Indiana Pacers,0,0,23,20,43,17,22,39,40,42,82,13,2,15,8,35,27,8,14,96,110
2023,2,22300898,3/6/2024,1610612762,Utah Jazz,1,0,1610612741,Chicago Bulls,0,1,29,20,49,15,32,47,44,52,96,14,2,16,20,33,28,7,10,96,117
2023,2,22300658,1/29/2024,1610612739,Cleveland Cavaliers,1,1,1610612746,LA Clippers,0,0,29,17,46,13,27,40,42,44,86,21,5,26,14,33,28,8,13,96,118
2023,2,22300617,1/23/2024,1610612760,Oklahoma City Thunder,1,1,1610612757,Portland Trail Blazers,0,0,36,30,66,7,16,23,43,46,89,18,10,28,13,38,23,6,12,99,111
2023,2,22300712,2/4/2024,1610612743,Denver Nuggets,1,1,1610612757,Portland Trail Blazers,0,0,30,28,58,12,16,28,42,44,86,16,3,19,16,29,26,6,9,89,112
2020,2,22000862,4/18/2021,1610612740,New Orleans Pelicans,0,0,1610612752,New York Knicks,1,1,35,39,74,6,21,27,41,60,101,24,6,30,24,39,25,9,13,105,112
2020,2,22000862,4/18/2021,1610612752,New York Knicks,1,1,1610612740,New Orleans Pelicans,0,0,34,32,66,11,18,29,45,50,95,21,3,24,16,36,27,6,13,105,122
2023,2,22300711,2/4/2024,1610612749,Milwaukee Bucks,0,0,1610612762,Utah Jazz,1,1,24,19,43,15,26,41,39,45,84,15,10,25,9,42,27,3,12,99,108
2021,2,22100130,11/5/2021,1610612740,New Orleans Pelicans,0,0,1610612744,Golden State Warriors,1,1,20,24,44,11,33,44,31,57,88,12,4,16,16,41,23,10,19,98,85
2021,2,22100130,11/5/2021,1610612744,Golden State Warriors,1,1,1610612740,New Orleans Pelicans,0,0,27,14,41,20,30,50,47,44,91,12,2,14,12,33,36,6,11,98,126
2023,2,22300712,2/4/2024,1610612757,Portland Trail Blazers,0,0,1610612743,Denver Nuggets,1,1,28,26,54,11,20,31,39,46,85,14,1,15,16,31,29,8,13,88,103
2023,2,22300994,3/19/2024,1610612759,San Antonio Spurs,1,0,1610612742,Dallas Mavericks,0,1,25,25,50,14,25,39,39,50,89,15,6,21,12,41,31,6,16,103,107
2023,2,22300664,1/29/2024,1610612750,Minnesota Timberwolves,0,1,1610612760,Oklahoma City Thunder,1,0,26,28,54,14,15,29,40,43,83,13,2,15,13,31,21,5,13,92,107
2023,2,22300685,2/1/2024,1610612754,Indiana Pacers,0,0,1610612752,New York Knicks,1,1,29,31,60,13,20,33,42,51,93,8,5,13,14,39,21,8,13,99,105
2016,2,21601076,3/24/2017,1610612756,Phoenix Suns,0,0,1610612738,Boston Celtics,1,1,33,34,67,6,13,19,39,47,86,36,13,49,12,40,23,8,13,108,120
2023,2,22300687,2/1/2024,1610612739,Cleveland Cavaliers,0,1,1610612763,Memphis Grizzlies,1,0,27,24,51,14,21,35,41,45,86,12,6,18,11,37,26,9,14,98,108
2016,2,21601075,3/24/2017,1610612743,Denver Nuggets,0,1,1610612754,Indiana Pacers,1,0,32,23,55,7,20,27,39,43,82,40,3,43,16,28,23,9,13,101,125
2021,2,22100129,11/5/2021,1610612746,LA Clippers,0,1,1610612750,Minnesota Timberwolves,1,0,30,30,60,6,22,28,36,52,88,26,6,32,18,37,18,8,17,102,104
2021,2,22100129,11/5/2021,1610612750,Minnesota Timberwolves,1,0,1610612746,LA Clippers,0,1,14,23,37,17,35,52,31,58,89,5,2,7,12,48,17,12,22,103,84
2023,2,22300659,1/29/2024,1610612738,Boston Celtics,1,1,1610612740,New Orleans Pelicans,0,0,26,13,39,17,29,46,43,42,85,15,5,20,9,34,27,7,11,96,118
2016,2,21601075,3/24/2017,1610612754,Indiana Pacers,1,0,1610612743,Denver Nuggets,0,1,35,36,71,13,11,24,48,47,95,8,3,11,14,35,19,8,13,100,117
2016,2,21600523,1/3/2017,1610612765,Detroit Pistons,1,0,1610612754,Indiana Pacers,0,1,38,30,68,10,19,29,48,49,97,10,2,12,20,30,31,7,10,94,116
2023,2,22300687,2/1/2024,1610612763,Memphis Grizzlies,1,0,1610612739,Cleveland Cavaliers,0,1,25,27,52,12,26,38,37,53,90,15,2,17,13,41,25,6,13,98,101
2020,2,22000861,4/18/2021,1610612737,Atlanta Hawks,1,1,1610612754,Indiana Pacers,0,0,32,28,60,13,19,32,45,47,92,26,8,34,16,35,20,7,10,102,129
2020,2,22000861,4/18/2021,1610612754,Indiana Pacers,0,0,1610612737,Atlanta Hawks,1,1,35,25,60,10,22,32,45,47,92,17,3,20,11,37,33,8,12,103,117
2021,2,22100128,11/5/2021,1610612749,Milwaukee Bucks,1,0,1610612752,New York Knicks,0,1,17,22,39,16,27,43,33,49,82,16,5,21,9,43,19,12,15,101,98
2021,2,22100128,11/5/2021,1610612752,New York Knicks,0,1,1610612749,Milwaukee Bucks,1,0,31,25,56,10,30,40,41,55,96,21,5,26,25,32,16,5,15,99,113
2023,2,22300639,1/26/2024,1610612749,Milwaukee Bucks,1,0,1610612739,Cleveland Cavaliers,0,1,22,31,53,13,21,34,35,52,87,17,7,24,15,40,21,7,18,102,100
2023,2,22300938,3/11/2024,1610612757,Portland Trail Blazers,1,0,1610612738,Boston Celtics,0,1,29,30,59,10,18,28,39,48,87,11,0,11,14,34,23,7,11,89,99
2023,2,22300661,1/29/2024,1610612748,Miami Heat,1,0,1610612756,Phoenix Suns,0,1,19,29,48,14,22,36,33,51,84,25,0,25,13,38,20,8,13,95,105
2023,2,22300686,2/1/2024,1610612755,Philadelphia 76ers,0,1,1610612762,Utah Jazz,1,0,33,29,62,14,18,32,47,47,94,19,2,21,12,35,27,3,5,96,127
2021,2,22100127,11/5/2021,1610612739,Cleveland Cavaliers,0,1,1610612761,Toronto Raptors,1,0,28,25,53,10,20,30,38,45,83,16,3,19,19,28,22,10,18,89,102
2021,2,22100127,11/5/2021,1610612761,Toronto Raptors,1,0,1610612739,Cleveland Cavaliers,0,1,30,42,72,12,15,27,42,57,99,5,4,9,25,32,20,4,10,90,101
2022,2,22200593,1/7/2023,1610612740,New Orleans Pelicans,0,0,1610612742,Dallas Mavericks,1,1,40,25,65,5,24,29,45,49,94,22,13,35,20,35,26,5,13,104,117
2022,2,22200593,1/7/2023,1610612742,Dallas Mavericks,1,1,1610612740,New Orleans Pelicans,0,0,29,16,45,13,16,29,42,32,74,30,8,38,7,29,23,14,17,104,127
2023,2,22300663,1/29/2024,1610612763,Memphis Grizzlies,1,0,1610612758,Sacramento Kings,0,1,17,27,44,13,23,36,30,50,80,21,7,28,11,42,22,10,14,95,94
2023,2,22300686,2/1/2024,1610612762,Utah Jazz,1,0,1610612755,Philadelphia 76ers,0,1,33,18,51,12,24,36,45,42,87,22,3,25,12,32,36,6,11,97,124
2021,2,22100126,11/5/2021,1610612763,Memphis Grizzlies,0,0,1610612764,Washington Wizards,1,1,28,37,65,6,25,31,34,62,96,13,4,17,13,49,19,4,9,100,87
2021,2,22100126,11/5/2021,1610612764,Washington Wizards,1,1,1610612763,Memphis Grizzlies,0,0,39,20,59,10,15,25,49,35,84,7,6,13,10,28,34,12,19,99,115
2020,2,22000860,4/17/2021,1610612756,Phoenix Suns,1,0,1610612759,San Antonio Spurs,0,1,30,33,63,6,21,27,36,54,90,7,9,16,16,42,19,10,14,96,85
2020,2,22000860,4/17/2021,1610612759,San Antonio Spurs,0,1,1610612756,Phoenix Suns,1,0,33,27,60,12,17,29,45,44,89,9,3,12,12,34,23,7,13,97,111
2021,2,22100125,11/5/2021,1610612753,Orlando Magic,1,0,1610612759,San Antonio Spurs,0,1,23,25,48,12,29,41,35,54,89,7,3,10,12,43,23,11,18,100,89
2021,2,22100125,11/5/2021,1610612759,San Antonio Spurs,0,1,1610612753,Orlando Magic,1,0,34,37,71,6,13,19,40,50,90,16,2,18,11,39,23,9,13,100,102
2021,2,22100124,11/5/2021,1610612751,Brooklyn Nets,0,1,1610612765,Detroit Pistons,1,0,25,28,53,11,16,27,36,44,80,13,1,14,7,37,25,11,17,96,96
2021,2,22100124,11/5/2021,1610612765,Detroit Pistons,1,0,1610612751,Brooklyn Nets,0,1,22,31,53,11,23,34,33,54,87,13,5,18,11,45,17,3,14,98,90
2023,2,22300638,1/26/2024,1610612763,Memphis Grizzlies,1,1,1610612753,Orlando Magic,0,0,27,22,49,15,26,41,42,48,90,8,5,13,17,33,30,8,14,94,107
2020,2,22000859,4/17/2021,1610612749,Milwaukee Bucks,1,0,1610612763,Memphis Grizzlies,0,1,23,21,44,16,31,47,39,52,91,21,6,27,18,38,27,10,16,102,115
2020,2,22000859,4/17/2021,1610612763,Memphis Grizzlies,0,1,1610612749,Milwaukee Bucks,1,0,36,17,53,15,25,40,51,42,93,11,1,12,8,34,31,7,11,102,128
2023,2,22300658,1/29/2024,1610612746,LA Clippers,0,0,1610612739,Cleveland Cavaliers,1,1,27,19,46,11,23,34,38,42,80,21,7,28,10,36,28,6,13,95,108
2023,2,22300665,1/29/2024,1610612764,Washington Wizards,0,1,1610612759,San Antonio Spurs,1,0,37,24,61,9,16,25,46,40,86,17,7,24,15,28,32,10,19,100,118
2023,2,22300715,2/5/2024,1610612742,Dallas Mavericks,0,1,1610612755,Philadelphia 76ers,1,0,25,19,44,17,26,43,42,45,87,17,6,23,11,36,28,8,10,96,118
2023,2,22300948,3/13/2024,1610612741,Chicago Bulls,0,1,1610612754,Indiana Pacers,1,0,38,26,64,10,18,28,48,44,92,26,6,32,9,40,22,4,12,109,132
2023,2,22300597,1/20/2024,1610612763,Memphis Grizzlies,0,0,1610612741,Chicago Bulls,1,1,19,14,33,13,29,42,32,43,75,19,4,23,4,40,28,11,16,97,96
2023,2,22300640,1/26/2024,1610612760,Oklahoma City Thunder,0,1,1610612740,New Orleans Pelicans,1,0,32,23,55,10,23,33,42,46,88,13,1,14,10,36,22,9,13,98,107
2023,2,22300776,2/13/2024,1610612747,Los Angeles Lakers,1,1,1610612765,Detroit Pistons,0,0,29,20,49,14,21,35,43,41,84,25,5,30,9,34,32,8,16,105,125
2021,2,22100123,11/4/2021,1610612747,Los Angeles Lakers,1,0,1610612760,Oklahoma City Thunder,0,1,27,34,61,12,21,33,39,55,94,14,3,17,18,39,22,7,14,101,104
2021,2,22100123,11/4/2021,1610612760,Oklahoma City Thunder,0,1,1610612747,Los Angeles Lakers,1,0,22,24,46,15,26,41,37,50,87,18,8,26,16,38,23,8,16,102,107
2023,2,22300776,2/13/2024,1610612765,Detroit Pistons,0,0,1610612747,Los Angeles Lakers,1,1,37,43,80,8,20,28,45,63,108,13,4,17,22,43,30,6,10,105,111
2023,2,22300641,1/26/2024,1610612757,Portland Trail Blazers,0,0,1610612759,San Antonio Spurs,1,1,28,25,53,10,27,37,38,52,90,14,5,19,11,43,23,12,15,102,100
2021,2,22100122,11/4/2021,1610612745,Houston Rockets,0,0,1610612756,Phoenix Suns,1,1,27,29,56,11,21,32,38,50,88,24,4,28,14,37,25,12,19,105,111
2021,2,22100122,11/4/2021,1610612756,Phoenix Suns,1,1,1610612745,Houston Rockets,0,0,30,32,62,14,17,31,44,49,93,21,2,23,13,36,29,4,12,103,123
2023,2,22300579,1/18/2024,1610612764,Washington Wizards,0,0,1610612752,New York Knicks,1,1,31,28,59,10,21,31,41,49,90,17,5,22,10,42,31,6,12,102,109
2023,2,22300639,1/26/2024,1610612739,Cleveland Cavaliers,0,1,1610612749,Milwaukee Bucks,1,0,24,32,56,14,22,36,38,54,92,22,9,31,18,39,20,6,13,102,112
2023,2,22300803,2/22/2024,1610612759,San Antonio Spurs,0,0,1610612758,Sacramento Kings,1,1,39,34,73,11,14,25,50,48,98,11,5,16,13,36,37,5,8,101,122
2023,2,22300803,2/22/2024,1610612758,Sacramento Kings,1,1,1610612759,San Antonio Spurs,0,0,39,21,60,13,20,33,52,41,93,10,4,14,11,33,29,9,10,100,127
2023,2,22300619,1/24/2024,1610612766,Charlotte Hornets,0,0,1610612765,Detroit Pistons,1,1,23,26,49,15,23,38,38,49,87,15,4,19,9,42,27,4,11,97,106
2023,2,22300662,1/29/2024,1610612747,Los Angeles Lakers,0,0,1610612745,Houston Rockets,1,1,32,24,56,13,22,35,45,46,91,16,10,26,6,44,26,10,12,108,119
2023,2,22300714,2/5/2024,1610612758,Sacramento Kings,0,0,1610612739,Cleveland Cavaliers,1,1,26,23,49,17,27,44,43,50,93,7,5,12,11,42,28,10,12,98,110
2023,2,22300718,2/5/2024,1610612740,New Orleans Pelicans,1,1,1610612761,Toronto Raptors,0,0,34,25,59,19,26,45,53,51,104,13,0,13,22,29,36,4,7,96,138
2023,2,22300662,1/29/2024,1610612745,Houston Rockets,1,1,1610612747,Los Angeles Lakers,0,0,40,22,62,12,24,36,52,46,98,19,6,25,15,33,36,10,15,108,135
2020,2,22000858,4/17/2021,1610612738,Boston Celtics,1,1,1610612744,Golden State Warriors,0,0,29,19,48,15,31,46,44,50,94,16,4,20,16,36,18,6,9,97,119
2020,2,22000858,4/17/2021,1610612744,Golden State Warriors,0,0,1610612738,Boston Celtics,1,1,24,16,40,17,23,40,41,39,80,15,5,20,10,32,22,9,18,96,114
2023,2,22301014,3/22/2024,1610612739,Cleveland Cavaliers,0,0,1610612750,Minnesota Timberwolves,1,1,27,25,52,7,22,29,34,47,81,16,3,19,14,34,22,9,12,90,91
2021,2,22100121,11/4/2021,1610612738,Boston Celtics,0,1,1610612748,Miami Heat,1,0,15,22,37,16,25,41,31,47,78,17,3,20,14,34,16,8,16,89,95
2022,2,22201190,4/5/2023,1610612754,Indiana Pacers,1,0,1610612752,New York Knicks,0,1,30,27,57,15,15,30,45,42,87,24,6,30,13,32,33,13,17,105,129
2023,2,22300678,1/31/2024,1610612758,Sacramento Kings,0,0,1610612748,Miami Heat,1,1,29,24,53,12,28,40,41,52,93,12,6,18,14,42,26,3,9,96,106
2023,2,22300984,3/18/2024,1610612738,Boston Celtics,1,1,1610612765,Detroit Pistons,0,0,21,25,46,22,27,49,43,52,95,11,2,13,18,35,30,6,11,95,119
2023,2,22300641,1/26/2024,1610612759,San Antonio Spurs,1,1,1610612757,Portland Trail Blazers,0,0,32,26,58,10,24,34,42,50,92,22,4,26,19,33,30,11,18,103,116
2023,2,22300937,3/11/2024,1610612761,Toronto Raptors,0,0,1610612743,Denver Nuggets,1,1,36,27,63,11,19,30,47,46,93,14,3,17,14,33,30,8,12,99,119
2023,2,22300898,3/6/2024,1610612741,Chicago Bulls,0,1,1610612762,Utah Jazz,1,0,28,23,51,17,22,39,45,45,90,12,3,15,11,34,29,4,9,95,119
2023,2,22301015,3/22/2024,1610612763,Memphis Grizzlies,0,1,1610612759,San Antonio Spurs,1,0,21,27,48,12,22,34,33,49,82,21,10,31,12,43,18,12,18,105,99
2021,2,22100121,11/4/2021,1610612748,Miami Heat,1,0,1610612738,Boston Celtics,0,1,19,21,40,9,32,41,28,53,81,13,6,19,19,37,18,7,18,89,78
2020,2,22000857,4/17/2021,1610612739,Cleveland Cavaliers,0,0,1610612741,Chicago Bulls,1,1,27,31,58,12,18,30,39,49,88,6,1,7,13,36,27,6,11,90,96
2020,2,22000857,4/17/2021,1610612741,Chicago Bulls,1,1,1610612739,Cleveland Cavaliers,0,0,25,17,42,16,24,40,41,41,82,8,1,9,6,35,30,6,10,91,106
2019,2,21900243,11/25/2019,1610612737,Atlanta Hawks,1,0,1610612750,Minnesota Timberwolves,0,1,31,31,62,10,22,32,41,53,94,21,5,26,20,36,26,10,18,105,113
2019,2,21900243,11/25/2019,1610612750,Minnesota Timberwolves,0,1,1610612737,Atlanta Hawks,1,0,26,29,55,15,20,35,41,49,90,28,8,36,17,36,27,6,14,105,125
2020,2,22000856,4/17/2021,1610612764,Washington Wizards,1,1,1610612765,Detroit Pistons,0,0,41,37,78,9,7,16,50,44,94,12,7,19,11,36,25,7,14,102,121
2020,2,22000856,4/17/2021,1610612765,Detroit Pistons,0,0,1610612764,Washington Wizards,1,1,28,29,57,9,18,27,37,47,84,17,6,23,12,39,19,11,18,102,100
2023,2,22300590,1/19/2024,1610612757,Portland Trail Blazers,1,1,1610612754,Indiana Pacers,0,0,38,34,72,4,8,12,42,42,84,30,5,35,12,31,18,3,11,100,118
2021,2,22100120,11/4/2021,1610612737,Atlanta Hawks,1,0,1610612762,Utah Jazz,0,1,28,26,54,7,21,28,35,47,82,21,5,26,10,40,18,6,9,93,98
2021,2,22100120,11/4/2021,1610612762,Utah Jazz,0,1,1610612737,Atlanta Hawks,1,0,24,16,40,17,24,41,41,40,81,17,6,23,14,29,30,11,17,93,116
2023,2,22300620,1/24/2024,1610612764,Washington Wizards,1,0,1610612750,Minnesota Timberwolves,0,1,27,26,53,10,14,24,37,40,77,23,6,29,8,33,31,8,21,103,107
2020,2,22000855,4/17/2021,1610612747,Los Angeles Lakers,1,1,1610612762,Utah Jazz,0,0,37,23,60,11,22,33,48,45,93,20,3,23,13,33,26,10,15,108,127
2020,2,22000855,4/17/2021,1610612762,Utah Jazz,0,0,1610612747,Los Angeles Lakers,1,1,19,23,42,23,36,59,42,59,101,8,0,8,16,43,31,8,16,108,115
2023,2,22300984,3/18/2024,1610612765,Detroit Pistons,0,0,1610612738,Boston Celtics,1,1,27,28,55,9,20,29,36,48,84,13,2,15,9,40,21,8,13,94,94
2020,2,22000854,4/16/2021,1610612742,Dallas Mavericks,1,0,1610612752,New York Knicks,0,1,25,21,46,15,30,45,40,51,91,14,5,19,16,38,30,4,9,95,109
2020,2,22000854,4/16/2021,1610612752,New York Knicks,0,1,1610612742,Dallas Mavericks,1,0,30,28,58,14,14,28,44,42,86,15,6,21,10,34,22,6,10,95,117
2023,2,22300983,3/18/2024,1610612739,Cleveland Cavaliers,0,1,1610612754,Indiana Pacers,1,0,26,22,48,12,20,32,38,42,80,20,8,28,14,31,27,8,14,93,108
2023,2,22300937,3/11/2024,1610612743,Denver Nuggets,1,1,1610612761,Toronto Raptors,0,0,42,24,66,10,19,29,52,43,95,11,7,18,15,32,36,6,9,98,125
2023,2,22300995,3/19/2024,1610612743,Denver Nuggets,0,1,1610612750,Minnesota Timberwolves,1,0,28,26,54,14,13,27,42,39,81,17,5,22,11,31,26,10,17,96,115
2023,2,22300762,2/12/2024,1610612739,Cleveland Cavaliers,1,0,1610612755,Philadelphia 76ers,0,1,31,24,55,13,24,37,44,48,92,20,5,25,19,31,33,5,11,96,121
2023,2,22300934,3/11/2024,1610612756,Phoenix Suns,0,1,1610612739,Cleveland Cavaliers,1,0,34,18,52,12,20,32,46,38,84,13,6,19,12,30,23,9,14,94,117
2021,2,22100119,11/4/2021,1610612755,Philadelphia 76ers,0,1,1610612765,Detroit Pistons,1,0,29,22,51,12,20,32,41,42,83,15,7,22,18,29,22,6,15,91,109
2021,2,22100119,11/4/2021,1610612765,Detroit Pistons,1,0,1610612755,Philadelphia 76ers,0,1,24,27,51,11,25,36,35,52,87,17,2,19,16,37,21,8,11,92,98
2022,2,22200529,12/30/2022,1610612753,Orlando Magic,1,0,1610612764,Washington Wizards,0,1,37,36,73,5,22,27,42,58,100,11,5,16,12,50,24,4,11,105,100
2022,2,22200529,12/30/2022,1610612764,Washington Wizards,0,1,1610612753,Orlando Magic,1,0,27,13,40,15,20,35,42,33,75,20,5,25,6,30,33,8,26,106,119
2023,2,22300938,3/11/2024,1610612738,Boston Celtics,0,1,1610612757,Portland Trail Blazers,1,0,34,26,60,15,25,40,49,51,100,8,4,12,20,33,34,3,3,90,121
2021,2,22100118,11/3/2021,1610612740,New Orleans Pelicans,0,0,1610612758,Sacramento Kings,1,1,25,27,52,12,22,34,37,49,86,13,2,15,15,35,24,8,17,96,99
2021,2,22100118,11/3/2021,1610612758,Sacramento Kings,1,1,1610612740,New Orleans Pelicans,0,0,32,18,50,10,20,30,42,38,80,18,4,22,4,34,27,1,8,94,112
2023,2,22300581,1/18/2024,1610612760,Oklahoma City Thunder,0,1,1610612762,Utah Jazz,1,0,34,20,54,14,18,32,48,38,86,24,4,28,10,29,36,7,16,104,134
2020,2,22000853,4/16/2021,1610612757,Portland Trail Blazers,0,1,1610612759,San Antonio Spurs,1,0,30,30,60,11,18,29,41,48,89,14,2,16,13,36,23,7,11,96,107
2020,2,22000853,4/16/2021,1610612759,San Antonio Spurs,1,0,1610612757,Portland Trail Blazers,0,1,38,34,72,7,16,23,45,50,95,9,1,10,19,31,30,9,14,96,106
2023,2,22300619,1/24/2024,1610612765,Detroit Pistons,1,1,1610612766,Charlotte Hornets,0,0,28,20,48,15,23,38,43,43,86,12,8,20,9,41,26,5,11,97,113
2023,2,22300590,1/19/2024,1610612754,Indiana Pacers,0,0,1610612757,Portland Trail Blazers,1,1,19,25,44,20,27,47,39,52,91,17,8,25,15,41,34,3,14,100,115
2023,2,22300667,1/29/2024,1610612743,Denver Nuggets,1,1,1610612749,Milwaukee Bucks,0,0,40,33,73,4,14,18,44,47,91,21,3,24,11,36,29,3,8,99,113
2023,2,22300983,3/18/2024,1610612754,Indiana Pacers,1,0,1610612739,Cleveland Cavaliers,0,1,33,20,53,9,29,38,42,49,91,10,6,16,19,32,28,8,11,93,103
2021,2,22100117,11/3/2021,1610612744,Golden State Warriors,1,1,1610612766,Charlotte Hornets,0,0,24,17,41,18,27,45,42,44,86,12,6,18,9,40,33,10,17,106,114
2021,2,22100117,11/3/2021,1610612766,Charlotte Hornets,0,0,1610612744,Golden State Warriors,1,1,24,31,55,10,26,36,34,57,91,14,5,19,12,49,18,14,16,105,92
2020,2,22000852,4/16/2021,1610612748,Miami Heat,0,0,1610612750,Minnesota Timberwolves,1,1,25,21,46,14,20,34,39,41,80,19,7,26,8,37,33,8,14,99,111
2020,2,22000852,4/16/2021,1610612750,Minnesota Timberwolves,1,1,1610612748,Miami Heat,0,0,27,18,45,15,21,36,42,39,81,20,9,29,18,27,30,11,21,97,119
2014,2,21401178,4/10/2015,1610612738,Boston Celtics,0,1,1610612739,Cleveland Cavaliers,1,0,30,32,62,8,14,22,38,46,84,15,6,21,13,33,30,4,15,95,99
2016,2,21600522,1/3/2017,1610612738,Boston Celtics,1,1,1610612762,Utah Jazz,0,0,24,19,43,17,14,31,41,33,74,16,1,17,7,27,31,7,14,90,115
2016,2,21600522,1/3/2017,1610612762,Utah Jazz,0,0,1610612738,Boston Celtics,1,1,27,29,56,11,15,26,38,44,82,17,4,21,13,31,27,5,11,90,104
2019,2,21900024,10/25/2019,1610612757,Portland Trail Blazers,0,1,1610612758,Sacramento Kings,1,0,35,20,55,11,19,30,46,39,85,19,3,22,8,34,23,10,16,103,122
2023,2,22300582,1/18/2024,1610612763,Memphis Grizzlies,0,0,1610612750,Minnesota Timberwolves,1,1,25,26,51,14,20,34,39,46,85,11,6,17,13,36,22,8,15,94,103
2019,2,21900024,10/25/2019,1610612758,Sacramento Kings,1,0,1610612757,Portland Trail Blazers,0,1,22,28,50,15,22,37,37,50,87,23,4,27,13,38,17,8,17,102,112
2016,2,21600095,11/7/2016,1610612754,Indiana Pacers,0,0,1610612766,Charlotte Hornets,1,1,31,30,61,9,24,33,40,54,94,11,4,15,16,40,23,12,18,104,100
2016,2,21600095,11/7/2016,1610612766,Charlotte Hornets,1,1,1610612754,Indiana Pacers,0,0,29,23,52,12,20,32,41,43,84,28,4,32,5,41,30,8,12,102,122
2014,2,21401178,4/10/2015,1610612739,Cleveland Cavaliers,1,0,1610612738,Boston Celtics,0,1,23,20,43,9,25,34,32,45,77,17,8,25,14,35,25,11,22,96,90
2023,2,22300599,1/20/2024,1610612750,Minnesota Timberwolves,1,0,1610612760,Oklahoma City Thunder,0,1,17,21,38,14,23,37,31,44,75,21,8,29,14,33,22,12,21,97,97
2023,2,22300801,2/22/2024,1610612762,Utah Jazz,1,0,1610612766,Charlotte Hornets,0,1,28,19,47,9,30,39,37,49,86,24,3,27,19,32,26,11,19,99,107
2023,2,22300607,1/22/2024,1610612739,Cleveland Cavaliers,0,1,1610612753,Orlando Magic,1,0,25,17,42,20,18,38,45,35,80,16,6,22,9,29,29,7,12,92,126
2018,2,21801123,3/28/2019,1610612751,Brooklyn Nets,0,0,1610612755,Philadelphia 76ers,1,1,29,29,58,11,21,32,40,50,90,19,10,29,16,38,25,10,15,103,110
2018,2,21801123,3/28/2019,1610612755,Philadelphia 76ers,1,1,1610612751,Brooklyn Nets,0,0,33,32,65,12,13,25,45,45,90,21,7,28,11,37,27,4,10,103,123
2018,2,21800975,3/7/2019,1610612749,Milwaukee Bucks,1,1,1610612754,Indiana Pacers,0,0,29,22,51,14,21,35,43,43,86,17,4,21,10,36,21,10,13,100,117
2018,2,21800975,3/7/2019,1610612754,Indiana Pacers,0,0,1610612749,Milwaukee Bucks,1,1,21,32,53,14,23,37,35,55,90,14,6,20,11,46,26,7,11,102,98
2023,2,22300591,1/19/2024,1610612751,Brooklyn Nets,0,1,1610612747,Los Angeles Lakers,1,0,31,17,48,19,28,47,50,45,95,11,3,14,12,34,31,7,11,100,130
2018,2,21800849,2/12/2019,1610612738,Boston Celtics,0,1,1610612755,Philadelphia 76ers,1,0,28,31,59,13,16,29,41,47,88,17,4,21,9,40,24,4,5,95,112
2018,2,21800849,2/12/2019,1610612755,Philadelphia 76ers,1,0,1610612738,Boston Celtics,0,1,30,23,53,9,18,27,39,41,80,22,9,31,10,36,21,9,14,95,109
2018,2,21800752,1/29/2019,1610612741,Chicago Bulls,0,0,1610612751,Brooklyn Nets,1,1,38,28,66,9,19,28,47,47,94,14,5,19,12,39,17,11,18,110,117
2018,2,21800752,1/29/2019,1610612751,Brooklyn Nets,1,1,1610612741,Chicago Bulls,0,0,32,27,59,10,25,35,42,52,94,28,12,40,11,48,25,6,8,110,122
2023,2,22300668,1/29/2024,1610612757,Portland Trail Blazers,1,1,1610612755,Philadelphia 76ers,0,0,34,22,56,12,16,28,46,38,84,26,3,29,14,25,29,6,13,95,130
2023,2,22300934,3/11/2024,1610612739,Cleveland Cavaliers,1,0,1610612756,Phoenix Suns,0,1,25,13,38,15,31,46,40,44,84,16,3,19,12,32,30,8,13,95,111
2018,2,21800512,12/27/2018,1610612738,Boston Celtics,0,0,1610612745,Houston Rockets,1,1,26,24,50,12,19,31,38,43,81,25,6,31,8,40,28,4,11,98,113
2018,2,21800512,12/27/2018,1610612745,Houston Rockets,1,1,1610612738,Boston Celtics,0,0,23,18,41,18,27,45,41,45,86,27,8,35,16,34,17,9,13,99,127
2023,2,22301029,3/24/2024,1610612739,Cleveland Cavaliers,0,0,1610612748,Miami Heat,1,1,21,22,43,9,20,29,30,42,72,15,5,20,6,37,24,13,17,92,84
2023,2,22300714,2/5/2024,1610612739,Cleveland Cavaliers,1,1,1610612758,Sacramento Kings,0,0,28,19,47,23,18,41,51,37,88,11,6,17,8,31,36,5,9,96,136
2023,2,22301031,3/24/2024,1610612744,Golden State Warriors,0,0,1610612750,Minnesota Timberwolves,1,1,24,25,49,14,22,36,38,47,85,20,6,26,11,38,23,9,13,101,110
2021,2,22100116,11/3/2021,1610612742,Dallas Mavericks,0,1,1610612759,San Antonio Spurs,1,0,32,27,59,8,26,34,40,53,93,21,8,29,21,38,21,10,19,105,109
2021,2,22100116,11/3/2021,1610612759,San Antonio Spurs,1,0,1610612742,Dallas Mavericks,0,1,36,31,67,7,14,21,43,45,88,15,5,20,7,41,25,10,15,105,108
2016,2,21601074,3/24/2017,1610612753,Orlando Magic,1,1,1610612765,Detroit Pistons,0,0,35,30,65,12,14,26,47,44,91,9,4,13,9,38,36,3,11,98,115
2016,2,21601074,3/24/2017,1610612765,Detroit Pistons,0,0,1610612753,Orlando Magic,1,1,32,42,74,2,20,22,34,62,96,17,3,20,17,47,21,4,9,99,87
2023,2,22300581,1/18/2024,1610612762,Utah Jazz,1,0,1610612760,Oklahoma City Thunder,0,1,30,27,57,13,19,32,43,46,89,30,6,36,16,33,33,8,15,104,129
2022,2,22201193,4/5/2023,1610612741,Chicago Bulls,0,0,1610612749,Milwaukee Bucks,1,1,25,25,50,11,22,33,36,47,83,9,2,11,7,41,28,7,15,95,92
2020,2,22000851,4/16/2021,1610612743,Denver Nuggets,0,1,1610612745,Houston Rockets,1,0,37,26,63,9,22,31,46,48,94,27,4,31,20,29,22,7,9,96,128
2020,2,22000851,4/16/2021,1610612745,Houston Rockets,1,0,1610612743,Denver Nuggets,0,1,27,24,51,11,24,35,38,48,86,12,6,18,12,40,23,11,14,97,99
2023,2,22300606,1/22/2024,1610612765,Detroit Pistons,1,0,1610612749,Milwaukee Bucks,0,1,30,29,59,10,20,30,40,49,89,23,6,29,9,41,25,7,10,103,113
2018,2,21801122,3/28/2019,1610612753,Orlando Magic,0,0,1610612765,Detroit Pistons,1,1,29,34,63,8,23,31,37,57,94,16,4,20,22,36,21,8,12,91,98
2018,2,21801122,3/28/2019,1610612765,Detroit Pistons,1,1,1610612753,Orlando Magic,0,0,29,22,51,17,18,35,46,40,86,6,6,12,13,31,25,5,12,91,115
2023,2,22300935,3/11/2024,1610612742,Dallas Mavericks,0,1,1610612741,Chicago Bulls,1,0,38,14,52,13,28,41,51,42,93,12,3,15,13,31,33,6,6,93,127
2014,2,21400694,1/29/2015,1610612752,New York Knicks,0,0,1610612754,Indiana Pacers,1,1,29,36,65,5,11,16,34,47,81,9,4,13,8,42,22,4,11,91,82
2014,2,21400694,1/29/2015,1610612754,Indiana Pacers,1,1,1610612752,New York Knicks,0,0,36,25,61,6,12,18,42,37,79,13,5,18,10,30,25,3,12,90,103
2023,2,22300985,3/18/2024,1610612755,Philadelphia 76ers,1,1,1610612748,Miami Heat,0,0,24,25,49,13,23,36,37,48,85,11,1,12,8,41,23,8,12,96,98
2023,2,22300986,3/18/2024,1610612741,Chicago Bulls,1,1,1610612757,Portland Trail Blazers,0,0,30,30,60,11,22,33,41,52,93,17,4,21,15,39,26,7,9,96,110
2018,2,21800668,1/17/2019,1610612756,Phoenix Suns,0,0,1610612761,Toronto Raptors,1,1,27,27,54,9,21,30,36,48,84,28,8,36,19,32,18,8,16,98,109
2018,2,21800668,1/17/2019,1610612761,Toronto Raptors,1,1,1610612756,Phoenix Suns,0,0,36,22,58,7,21,28,43,43,86,18,7,25,11,34,27,9,14,99,111
2023,2,22300713,2/5/2024,1610612766,Charlotte Hornets,1,0,1610612747,Los Angeles Lakers,0,1,34,30,64,13,19,32,47,49,96,11,3,14,6,45,26,5,9,105,118
2023,2,22301015,3/22/2024,1610612759,San Antonio Spurs,1,0,1610612763,Memphis Grizzlies,0,1,30,27,57,7,31,38,37,58,95,16,7,23,19,45,24,10,16,105,97
2021,2,22100115,11/3/2021,1610612746,LA Clippers,0,1,1610612750,Minnesota Timberwolves,1,0,26,16,42,21,15,36,47,31,78,11,1,12,7,24,33,11,21,101,126
2021,2,22100115,11/3/2021,1610612750,Minnesota Timberwolves,1,0,1610612746,LA Clippers,0,1,29,25,54,14,26,40,43,51,94,15,1,16,17,34,27,6,17,100,115
2019,2,21900242,11/25/2019,1610612754,Indiana Pacers,1,1,1610612763,Memphis Grizzlies,0,0,33,28,61,18,15,33,51,43,94,6,4,10,13,33,29,6,13,101,126
2019,2,21900242,11/25/2019,1610612763,Memphis Grizzlies,0,0,1610612754,Indiana Pacers,1,1,33,34,67,13,16,29,46,50,96,9,4,13,11,40,30,6,9,101,114
2023,2,22300583,1/18/2024,1610612758,Sacramento Kings,1,0,1610612754,Indiana Pacers,0,1,29,19,48,15,22,37,44,41,85,18,14,32,13,36,27,5,11,100,121
2023,2,22300609,1/22/2024,1610612763,Memphis Grizzlies,0,1,1610612761,Toronto Raptors,1,0,31,30,61,13,21,34,44,51,95,7,5,12,21,35,30,7,15,94,108
2016,2,21600521,1/3/2017,1610612750,Minnesota Timberwolves,0,0,1610612755,Philadelphia 76ers,1,1,26,32,58,7,17,24,33,49,82,18,2,20,13,38,20,10,18,97,91
2016,2,21600521,1/3/2017,1610612755,Philadelphia 76ers,1,1,1610612750,Minnesota Timberwolves,0,0,26,27,53,7,25,32,33,52,85,20,5,25,17,38,19,7,16,98,93
2023,2,22300644,1/27/2024,1610612743,Denver Nuggets,1,1,1610612755,Philadelphia 76ers,0,0,24,21,45,13,24,37,37,45,82,24,14,38,18,35,25,5,8,93,111
2016,2,21600094,11/7/2016,1610612745,Houston Rockets,0,1,1610612764,Washington Wizards,1,0,24,18,42,17,20,37,41,38,79,15,3,18,7,32,28,12,18,99,114
2016,2,21600094,11/7/2016,1610612764,Washington Wizards,1,0,1610612745,Houston Rockets,0,1,29,38,67,10,17,27,39,55,94,18,2,20,24,32,20,6,16,100,106
2018,2,21800974,3/6/2019,1610612743,Denver Nuggets,0,1,1610612747,Los Angeles Lakers,1,0,32,24,56,13,29,42,45,53,98,12,5,17,19,36,33,5,8,95,115
2018,2,21800974,3/6/2019,1610612747,Los Angeles Lakers,1,0,1610612743,Denver Nuggets,0,1,33,20,53,7,24,31,40,44,84,12,11,23,9,40,26,6,12,96,99
2023,2,22300994,3/19/2024,1610612742,Dallas Mavericks,0,1,1610612759,San Antonio Spurs,1,0,34,27,61,10,20,30,44,47,91,15,2,17,6,43,31,6,9,103,113
2023,2,22300698,2/3/2024,1610612755,Philadelphia 76ers,1,0,1610612751,Brooklyn Nets,0,1,32,35,67,12,17,29,44,52,96,21,6,27,13,42,26,3,5,100,121
2023,2,22300715,2/5/2024,1610612755,Philadelphia 76ers,1,0,1610612742,Dallas Mavericks,0,1,32,32,64,8,21,29,40,53,93,14,6,20,20,38,20,6,12,95,102
2023,2,22300717,2/5/2024,1610612751,Brooklyn Nets,1,0,1610612744,Golden State Warriors,0,1,21,26,47,13,29,42,34,55,89,17,5,22,14,44,23,7,10,97,98
2023,2,22300667,1/29/2024,1610612749,Milwaukee Bucks,0,0,1610612743,Denver Nuggets,1,1,20,24,44,16,24,40,36,48,84,19,6,25,10,41,24,7,13,99,107
2014,2,21400693,1/29/2015,1610612743,Denver Nuggets,0,0,1610612763,Memphis Grizzlies,1,1,27,34,61,2,24,26,29,58,87,9,1,10,14,45,19,8,17,96,69
2014,2,21400693,1/29/2015,1610612763,Memphis Grizzlies,1,1,1610612743,Denver Nuggets,0,0,36,36,72,3,13,16,39,49,88,18,9,27,16,38,17,6,9,95,99
2020,2,22000850,4/16/2021,1610612741,Chicago Bulls,1,0,1610612763,Memphis Grizzlies,0,1,32,30,62,13,21,34,45,51,96,12,3,15,17,37,34,9,12,96,115
2023,2,22300682,1/31/2024,1610612743,Denver Nuggets,0,0,1610612760,Oklahoma City Thunder,1,1,22,34,56,15,22,37,37,56,93,11,5,16,16,43,21,2,10,95,100
2020,2,22000850,4/16/2021,1610612763,Memphis Grizzlies,0,1,1610612741,Chicago Bulls,1,0,28,18,46,17,23,40,45,41,86,19,5,24,8,34,33,3,6,96,126
2022,2,22201191,4/5/2023,1610612737,Atlanta Hawks,1,1,1610612764,Washington Wizards,0,0,30,24,54,13,17,30,43,41,84,35,5,40,14,28,30,10,17,105,134
2018,2,21800973,3/6/2019,1610612738,Boston Celtics,0,1,1610612758,Sacramento Kings,1,0,27,19,46,13,20,33,40,39,79,18,3,21,5,35,26,8,18,101,111
2018,2,21800973,3/6/2019,1610612758,Sacramento Kings,1,0,1610612738,Boston Celtics,0,1,27,24,51,13,16,29,40,40,80,16,6,22,9,34,23,11,18,101,109
2018,2,21800751,1/29/2019,1610612753,Orlando Magic,1,0,1610612760,Oklahoma City Thunder,0,1,30,31,61,14,27,41,44,58,102,15,3,18,20,40,26,7,12,103,117
2018,2,21800751,1/29/2019,1610612760,Oklahoma City Thunder,0,1,1610612753,Orlando Magic,1,0,40,30,70,9,12,21,49,42,91,19,7,26,8,37,25,4,7,102,126
2023,2,22300645,1/27/2024,1610612751,Brooklyn Nets,1,1,1610612745,Houston Rockets,0,0,24,16,40,12,22,34,36,38,74,22,15,37,6,42,24,6,19,104,106
2023,2,22300935,3/11/2024,1610612741,Chicago Bulls,1,0,1610612742,Dallas Mavericks,0,1,28,27,55,7,27,34,35,54,89,15,7,22,18,41,19,10,13,94,92
2023,2,22300985,3/18/2024,1610612748,Miami Heat,0,0,1610612755,Philadelphia 76ers,1,1,23,33,56,12,21,33,35,54,89,9,5,14,17,40,23,7,15,93,91
2023,2,22300802,2/22/2024,1610612747,Los Angeles Lakers,0,0,1610612744,Golden State Warriors,1,1,33,20,53,10,25,35,43,45,88,14,7,21,11,36,28,6,11,98,110
2023,2,22300716,2/5/2024,1610612737,Atlanta Hawks,1,0,1610612746,LA Clippers,0,1,31,25,56,20,19,39,51,44,95,22,5,27,16,32,35,8,11,102,144
2023,2,22300716,2/5/2024,1610612746,LA Clippers,0,1,1610612737,Atlanta Hawks,1,0,31,23,54,21,14,35,52,37,89,24,7,31,8,31,32,5,8,101,149
2021,2,22100114,11/3/2021,1610612743,Denver Nuggets,0,0,1610612763,Memphis Grizzlies,1,1,35,29,64,8,19,27,43,48,91,12,1,13,15,34,24,9,12,94,106
2021,2,22100114,11/3/2021,1610612763,Memphis Grizzlies,1,1,1610612743,Denver Nuggets,0,0,26,21,47,16,18,34,42,39,81,8,6,14,6,36,28,7,12,94,108
2016,2,21601073,3/24/2017,1610612739,Cleveland Cavaliers,0,1,1610612766,Charlotte Hornets,1,0,32,17,49,9,16,25,41,33,74,21,3,24,6,28,26,6,12,93,112
2016,2,21601073,3/24/2017,1610612766,Charlotte Hornets,1,0,1610612739,Cleveland Cavaliers,0,1,28,24,52,10,28,38,38,52,90,19,5,24,19,36,18,6,11,93,105
2016,2,21600520,1/2/2017,1610612743,Denver Nuggets,0,0,1610612744,Golden State Warriors,1,1,39,27,66,9,26,35,48,53,101,14,4,18,20,34,33,7,15,104,119
2023,2,22300591,1/19/2024,1610612747,Los Angeles Lakers,1,0,1610612751,Brooklyn Nets,0,1,28,29,57,12,21,33,40,50,90,20,4,24,15,36,31,10,14,100,112
2023,2,22300594,1/20/2024,1610612764,Washington Wizards,1,0,1610612759,San Antonio Spurs,0,1,40,34,74,9,20,29,49,54,103,20,3,23,19,36,28,6,12,108,127
2023,2,22300665,1/29/2024,1610612759,San Antonio Spurs,1,0,1610612764,Washington Wizards,0,1,31,31,62,12,18,30,43,49,92,15,2,17,16,34,31,9,15,99,113
2023,2,22300621,1/24/2024,1610612763,Memphis Grizzlies,0,1,1610612748,Miami Heat,1,0,19,25,44,17,19,36,36,44,80,16,3,19,9,36,30,9,18,98,105
2022,2,22201193,4/5/2023,1610612749,Milwaukee Bucks,1,1,1610612741,Chicago Bulls,0,0,21,25,46,18,28,46,39,53,92,9,2,11,16,38,26,10,13,96,105
2023,2,22300995,3/19/2024,1610612750,Minnesota Timberwolves,1,0,1610612743,Denver Nuggets,0,1,30,23,53,12,23,35,42,46,88,16,7,23,11,38,25,5,7,97,112
2023,2,22300647,1/27/2024,1610612762,Utah Jazz,0,1,1610612766,Charlotte Hornets,1,0,35,17,52,17,24,41,52,41,93,13,4,17,15,28,38,7,14,99,134
2018,2,21800848,2/12/2019,1610612737,Atlanta Hawks,1,1,1610612747,Los Angeles Lakers,0,0,24,26,50,16,26,42,40,52,92,21,5,26,15,39,29,10,21,110,117
2018,2,21800848,2/12/2019,1610612747,Los Angeles Lakers,0,0,1610612737,Atlanta Hawks,1,1,27,28,55,14,26,40,41,54,95,17,8,25,13,45,25,8,17,109,113
2023,2,22301014,3/22/2024,1610612750,Minnesota Timberwolves,1,1,1610612739,Cleveland Cavaliers,0,0,27,31,58,14,13,27,41,44,85,8,8,16,16,31,27,6,12,88,104
2023,2,22300802,2/22/2024,1610612744,Golden State Warriors,1,1,1610612747,Los Angeles Lakers,0,0,34,32,66,16,25,41,50,57,107,12,2,14,23,35,32,5,9,99,128
2018,2,21800592,1/7/2019,1610612738,Boston Celtics,1,1,1610612751,Brooklyn Nets,0,0,35,26,61,12,20,32,47,46,93,10,2,12,8,39,37,5,14,104,116
2018,2,21800592,1/7/2019,1610612751,Brooklyn Nets,0,0,1610612738,Boston Celtics,1,1,21,16,37,11,31,42,32,47,79,20,2,22,11,38,19,13,25,103,95
2018,2,21800511,12/26/2018,1610612746,LA Clippers,1,1,1610612758,Sacramento Kings,0,0,36,32,68,12,16,28,48,48,96,19,4,23,15,33,23,8,15,106,127
2018,2,21800511,12/26/2018,1610612758,Sacramento Kings,0,0,1610612746,LA Clippers,1,1,39,35,74,10,20,30,49,55,104,10,5,15,18,38,26,7,13,108,118
2019,2,21900241,11/25/2019,1610612753,Orlando Magic,0,0,1610612765,Detroit Pistons,1,1,24,35,59,8,17,25,32,52,84,16,6,22,12,42,15,6,10,93,88
2019,2,21900241,11/25/2019,1610612765,Detroit Pistons,1,1,1610612753,Orlando Magic,0,0,20,21,41,14,24,38,34,45,79,21,4,25,11,36,23,8,15,94,103
2019,2,21900023,10/25/2019,1610612743,Denver Nuggets,1,1,1610612756,Phoenix Suns,0,0,29,36,65,7,20,27,36,56,92,29,7,36,15,45,21,5,14,107,108
2019,2,21900023,10/25/2019,1610612756,Phoenix Suns,0,0,1610612743,Denver Nuggets,1,1,26,32,58,8,20,28,34,52,86,31,1,32,13,39,25,7,18,106,107
2016,2,21601072,3/24/2017,1610612751,Brooklyn Nets,0,0,1610612764,Washington Wizards,1,1,40,27,67,3,12,15,43,39,82,19,7,26,7,35,24,9,14,101,108
2016,2,21601072,3/24/2017,1610612764,Washington Wizards,1,1,1610612751,Brooklyn Nets,0,0,39,32,71,10,16,26,49,48,97,21,1,22,14,34,29,5,10,103,129
2020,2,22000849,4/16/2021,1610612753,Orlando Magic,0,0,1610612761,Toronto Raptors,1,1,27,27,54,8,15,23,35,42,77,24,10,34,9,37,20,6,11,95,102
2020,2,22000849,4/16/2021,1610612761,Toronto Raptors,1,1,1610612753,Orlando Magic,0,0,27,20,47,14,21,35,41,41,82,17,1,18,12,29,24,8,17,96,113
2016,2,21600520,1/2/2017,1610612744,Golden State Warriors,1,1,1610612743,Denver Nuggets,0,0,39,31,70,11,14,25,50,45,95,16,5,21,13,35,33,10,13,104,127
2022,2,22201192,4/5/2023,1610612738,Boston Celtics,1,1,1610612761,Toronto Raptors,0,0,27,24,51,11,27,38,38,51,89,10,8,18,18,37,20,10,15,96,97
2014,2,21400692,1/29/2015,1610612749,Milwaukee Bucks,0,1,1610612753,Orlando Magic,1,0,33,29,62,12,13,25,45,42,87,13,5,18,7,37,29,8,15,101,115
2014,2,21400692,1/29/2015,1610612753,Orlando Magic,1,0,1610612749,Milwaukee Bucks,0,1,32,32,64,5,13,18,37,45,82,21,9,30,18,32,14,16,24,101,100
2023,2,22300610,1/22/2024,1610612766,Charlotte Hornets,0,1,1610612750,Minnesota Timberwolves,1,0,36,15,51,14,23,37,50,38,88,14,4,18,8,32,30,4,10,98,128
2023,2,22300644,1/27/2024,1610612755,Philadelphia 76ers,0,0,1610612743,Denver Nuggets,1,1,37,22,59,6,16,22,43,38,81,13,3,16,7,34,25,5,11,93,105
2023,2,22300718,2/5/2024,1610612761,Toronto Raptors,0,0,1610612740,New Orleans Pelicans,1,1,30,23,53,10,21,31,40,44,84,10,5,15,13,34,27,11,18,97,100
2023,2,22300647,1/27/2024,1610612766,Charlotte Hornets,1,0,1610612762,Utah Jazz,0,1,34,26,60,13,19,32,47,45,92,15,6,21,13,34,35,6,10,99,122
2023,2,22300636,1/26/2024,1610612754,Indiana Pacers,1,1,1610612756,Phoenix Suns,0,0,50,33,83,8,18,26,58,51,109,9,6,15,24,31,34,8,13,103,133
2023,2,22300760,2/11/2024,1610612760,Oklahoma City Thunder,1,1,1610612758,Sacramento Kings,0,0,33,25,58,13,14,27,46,39,85,22,5,27,11,30,30,5,11,99,127
2018,2,21800368,12/7/2018,1610612743,Denver Nuggets,0,0,1610612766,Charlotte Hornets,1,1,31,35,66,8,27,35,39,62,101,21,5,26,25,41,24,8,9,99,107
2023,2,22300593,1/20/2024,1610612755,Philadelphia 76ers,0,1,1610612766,Charlotte Hornets,1,0,31,29,60,5,20,25,36,49,85,20,4,24,9,42,21,2,10,97,97
2023,2,22300986,3/18/2024,1610612757,Portland Trail Blazers,0,0,1610612741,Chicago Bulls,1,1,32,28,60,8,20,28,40,48,88,19,6,25,17,33,21,9,13,97,107
2018,2,21800368,12/7/2018,1610612766,Charlotte Hornets,1,1,1610612743,Denver Nuggets,0,0,20,31,51,13,22,35,33,53,86,34,4,38,17,38,20,6,10,98,113
2018,2,21800307,11/28/2018,1610612755,Philadelphia 76ers,1,1,1610612752,New York Knicks,0,0,35,27,62,12,13,25,47,40,87,11,5,16,11,31,34,11,16,100,117
2023,2,22300717,2/5/2024,1610612744,Golden State Warriors,0,1,1610612751,Brooklyn Nets,1,0,39,32,71,4,18,22,43,50,93,19,4,23,20,31,24,7,14,96,109
2021,2,22100113,11/3/2021,1610612737,Atlanta Hawks,0,0,1610612751,Brooklyn Nets,1,1,28,31,59,13,22,35,41,53,94,13,2,15,14,41,23,7,14,102,108
2021,2,22100113,11/3/2021,1610612751,Brooklyn Nets,1,1,1610612737,Atlanta Hawks,0,0,21,19,40,22,26,48,43,45,88,9,3,12,8,40,34,8,16,102,117
2014,2,21401175,4/10/2015,1610612753,Orlando Magic,1,0,1610612761,Toronto Raptors,0,1,34,35,69,7,13,20,41,48,89,10,0,10,18,30,21,8,17,94,99
2014,2,21401175,4/10/2015,1610612761,Toronto Raptors,0,1,1610612753,Orlando Magic,1,0,30,34,64,9,21,30,39,55,94,14,1,15,22,34,22,11,16,94,101
2023,2,22300760,2/11/2024,1610612758,Sacramento Kings,0,0,1610612760,Oklahoma City Thunder,1,1,28,20,48,16,26,42,44,46,90,9,4,13,15,33,32,8,18,100,113
2023,2,22300668,1/29/2024,1610612755,Philadelphia 76ers,0,0,1610612757,Portland Trail Blazers,1,1,32,22,54,5,24,29,37,46,83,25,3,28,17,30,17,7,17,97,104
2023,2,22300650,1/27/2024,1610612747,Los Angeles Lakers,0,1,1610612744,Golden State Warriors,1,0,40,34,74,9,18,27,49,52,101,38,5,43,14,42,33,11,20,126,145
2020,2,22000848,4/16/2021,1610612751,Brooklyn Nets,1,1,1610612766,Charlotte Hornets,0,0,26,18,44,21,20,41,47,38,85,15,1,16,8,31,35,12,18,100,130
2020,2,22000848,4/16/2021,1610612766,Charlotte Hornets,0,0,1610612751,Brooklyn Nets,1,1,32,17,49,12,22,34,44,39,83,15,5,20,11,31,26,12,19,101,115
2023,2,22301029,3/24/2024,1610612748,Miami Heat,1,1,1610612739,Cleveland Cavaliers,0,0,28,17,45,15,23,38,43,40,83,20,3,23,13,27,29,3,12,94,121
2023,2,22300649,1/27/2024,1610612759,San Antonio Spurs,1,1,1610612750,Minnesota Timberwolves,0,0,33,21,54,13,17,30,46,38,84,8,7,15,16,26,35,9,15,91,113
2016,2,21600093,11/7/2016,1610612755,Philadelphia 76ers,1,0,1610612762,Utah Jazz,0,1,24,32,56,7,14,21,31,46,77,15,7,22,13,36,16,10,18,92,84
2016,2,21600093,11/7/2016,1610612762,Utah Jazz,0,1,1610612755,Philadelphia 76ers,1,0,32,34,66,11,8,19,43,42,85,12,8,20,11,35,20,5,10,93,109
2018,2,21801121,3/27/2019,1610612747,Los Angeles Lakers,0,0,1610612762,Utah Jazz,1,1,28,42,70,9,18,27,37,60,97,17,7,24,13,50,21,4,6,103,100
2018,2,21801121,3/27/2019,1610612762,Utah Jazz,1,1,1610612747,Los Angeles Lakers,0,0,31,20,51,10,22,32,41,42,83,23,13,36,11,36,33,9,11,102,115
2023,2,22300989,3/18/2024,1610612763,Memphis Grizzlies,0,0,1610612758,Sacramento Kings,1,1,24,36,60,13,25,38,37,61,98,24,6,30,18,47,22,7,14,107,111
2023,2,22301187,4/14/2024,1610612766,Charlotte Hornets,0,1,1610612739,Cleveland Cavaliers,1,0,27,24,51,19,21,40,46,45,91,9,2,11,11,34,36,4,10,96,120
2021,2,22100112,11/3/2021,1610612761,Toronto Raptors,0,1,1610612764,Washington Wizards,1,0,31,32,63,10,15,25,41,47,88,17,3,20,14,36,17,6,12,96,109
2021,2,22100112,11/3/2021,1610612764,Washington Wizards,1,0,1610612761,Toronto Raptors,0,1,26,20,46,8,24,32,34,44,78,24,6,30,12,37,19,10,13,94,100
2023,2,22300624,1/24/2024,1610612749,Milwaukee Bucks,1,1,1610612739,Cleveland Cavaliers,0,0,34,27,61,11,18,29,45,45,90,25,3,28,12,34,24,5,12,103,126
2019,2,21900022,10/25/2019,1610612760,Oklahoma City Thunder,1,0,1610612764,Washington Wizards,0,1,28,32,60,5,18,23,33,50,83,14,8,22,9,43,14,9,19,103,85
2019,2,21900022,10/25/2019,1610612764,Washington Wizards,0,1,1610612760,Oklahoma City Thunder,1,0,28,28,56,11,30,41,39,58,97,8,2,10,15,43,21,7,15,104,97
2020,2,22000847,4/16/2021,1610612740,New Orleans Pelicans,0,0,1610612764,Washington Wizards,1,1,33,36,69,7,21,28,40,57,97,28,5,33,15,44,26,5,16,115,115
2020,2,22000847,4/16/2021,1610612764,Washington Wizards,1,1,1610612740,New Orleans Pelicans,0,0,41,28,69,4,23,27,45,51,96,23,9,32,10,45,24,11,13,115,117
2023,2,22300626,1/24/2024,1610612744,Golden State Warriors,1,1,1610612737,Atlanta Hawks,0,0,35,23,58,16,17,33,51,40,91,16,6,22,12,32,26,7,10,99,134
2023,2,22300635,1/26/2024,1610612766,Charlotte Hornets,1,0,1610612745,Houston Rockets,0,1,26,30,56,9,20,29,35,50,85,25,7,32,12,44,20,7,13,101,104
2023,2,22300651,1/27/2024,1610612758,Sacramento Kings,0,1,1610612742,Dallas Mavericks,1,0,32,18,50,11,19,30,43,37,80,23,7,30,9,31,27,7,14,101,120
2022,2,22201191,4/5/2023,1610612764,Washington Wizards,0,0,1610612737,Atlanta Hawks,1,1,39,27,66,6,22,28,45,49,94,20,6,26,15,38,23,10,14,105,116
2022,2,22200483,12/23/2022,1610612749,Milwaukee Bucks,0,0,1610612751,Brooklyn Nets,1,1,28,19,47,9,28,37,37,47,84,17,5,22,16,35,17,11,18,95,100
2022,2,22200483,12/23/2022,1610612751,Brooklyn Nets,1,1,1610612749,Milwaukee Bucks,0,0,32,29,61,14,18,32,46,47,93,12,1,13,16,32,30,7,12,97,118
2018,2,21801120,3/27/2019,1610612756,Phoenix Suns,1,0,1610612764,Washington Wizards,0,1,29,21,50,14,23,37,43,44,87,21,5,26,11,38,22,10,15,101,121
2021,2,22100111,11/3/2021,1610612741,Chicago Bulls,0,0,1610612755,Philadelphia 76ers,1,1,32,29,61,6,15,21,38,44,82,16,2,18,10,34,19,9,16,97,98
2021,2,22100111,11/3/2021,1610612755,Philadelphia 76ers,1,1,1610612741,Chicago Bulls,0,0,26,23,49,12,16,28,38,39,77,15,6,21,6,38,24,11,14,95,103
2022,2,22201192,4/5/2023,1610612761,Toronto Raptors,0,0,1610612738,Boston Celtics,1,1,31,26,57,6,27,33,37,53,90,13,4,17,15,40,20,5,12,97,93
2023,2,22300625,1/24/2024,1610612742,Dallas Mavericks,1,0,1610612756,Phoenix Suns,0,1,24,22,46,17,26,43,41,48,89,10,8,18,12,41,25,10,14,99,109
2016,2,21600519,1/2/2017,1610612746,LA Clippers,1,1,1610612756,Phoenix Suns,0,0,30,34,64,7,9,16,37,43,80,28,10,38,18,30,17,11,19,102,109
2016,2,21600519,1/2/2017,1610612756,Phoenix Suns,0,0,1610612746,LA Clippers,1,1,37,50,87,2,13,15,39,63,102,18,4,22,23,42,22,1,12,101,98
2023,2,22300624,1/24/2024,1610612739,Cleveland Cavaliers,0,0,1610612749,Milwaukee Bucks,1,1,33,20,53,13,25,38,46,45,91,11,4,15,8,39,26,9,13,102,116
2023,2,22300634,1/26/2024,1610612742,Dallas Mavericks,0,1,1610612737,Atlanta Hawks,1,0,32,18,50,19,16,35,51,34,85,27,5,32,7,27,28,7,13,106,148
2020,2,22000846,4/16/2021,1610612746,LA Clippers,0,0,1610612755,Philadelphia 76ers,1,1,18,25,43,19,20,39,37,45,82,10,6,16,13,37,26,13,19,94,103
2023,2,22300595,1/20/2024,1610612737,Atlanta Hawks,1,0,1610612739,Cleveland Cavaliers,0,1,26,29,55,11,27,38,37,56,93,10,5,15,12,47,25,7,11,99,95
2020,2,22000846,4/16/2021,1610612755,Philadelphia 76ers,1,1,1610612746,LA Clippers,0,0,21,18,39,14,30,44,35,48,83,22,8,30,16,36,21,6,13,94,106
2023,2,22300682,1/31/2024,1610612760,Oklahoma City Thunder,1,1,1610612743,Denver Nuggets,0,0,26,35,61,11,15,26,37,50,87,20,5,25,16,36,24,7,13,95,105
2023,2,22300692,2/2/2024,1610612745,Houston Rockets,1,1,1610612761,Toronto Raptors,0,0,44,18,62,11,20,31,55,38,93,14,3,17,10,29,30,11,15,107,135
2018,2,21801120,3/27/2019,1610612764,Washington Wizards,0,1,1610612756,Phoenix Suns,1,0,34,31,65,9,16,25,43,47,90,29,14,43,18,37,18,9,10,101,124
2018,2,21800591,1/7/2019,1610612759,San Antonio Spurs,0,1,1610612765,Detroit Pistons,1,0,36,23,59,7,13,20,43,36,79,26,6,32,9,30,24,5,9,93,119
2018,2,21800591,1/7/2019,1610612765,Detroit Pistons,1,0,1610612759,San Antonio Spurs,0,1,33,20,53,9,23,32,42,43,85,14,3,17,13,32,22,5,13,94,107
2021,2,22100110,11/3/2021,1610612738,Boston Celtics,0,1,1610612753,Orlando Magic,1,0,23,19,42,10,27,37,33,46,79,16,9,25,10,42,24,8,11,92,92
2021,2,22100110,11/3/2021,1610612753,Orlando Magic,1,0,1610612738,Boston Celtics,0,1,18,23,41,9,34,43,27,57,84,16,4,20,14,45,15,7,15,94,79
2023,2,22300594,1/20/2024,1610612759,San Antonio Spurs,0,1,1610612764,Washington Wizards,1,0,39,26,65,12,19,31,51,45,96,17,6,23,16,34,38,10,17,106,131
2023,2,22300838,2/27/2024,1610612750,Minnesota Timberwolves,1,1,1610612759,San Antonio Spurs,0,0,30,32,62,13,18,31,43,50,93,15,2,17,15,36,28,9,14,102,114
2019,2,21900240,11/25/2019,1610612739,Cleveland Cavaliers,1,0,1610612751,Brooklyn Nets,0,1,27,35,62,13,19,32,40,54,94,13,7,20,21,37,24,8,12,94,106
2019,2,21900240,11/25/2019,1610612751,Brooklyn Nets,0,1,1610612739,Cleveland Cavaliers,1,0,33,27,60,11,23,34,44,50,94,9,2,11,15,35,29,5,10,94,108
2023,2,22300839,2/27/2024,1610612765,Detroit Pistons,0,1,1610612741,Chicago Bulls,1,0,23,15,38,14,23,37,37,38,75,17,6,23,12,30,22,11,20,93,105
2023,2,22300623,1/24/2024,1610612745,Houston Rockets,1,0,1610612757,Portland Trail Blazers,0,1,38,20,58,12,24,36,50,44,94,19,3,22,10,36,29,6,8,103,131
2023,2,22300625,1/24/2024,1610612756,Phoenix Suns,0,1,1610612742,Dallas Mavericks,1,0,37,14,51,14,20,34,51,34,85,16,6,22,12,25,30,4,16,99,132
2023,2,22300677,1/31/2024,1610612756,Phoenix Suns,0,1,1610612751,Brooklyn Nets,1,0,35,16,51,14,14,28,49,30,79,24,8,32,10,22,35,11,16,99,136
2020,2,22000845,4/16/2021,1610612760,Oklahoma City Thunder,0,0,1610612765,Detroit Pistons,1,1,32,26,58,7,32,39,39,58,97,19,7,26,22,40,19,13,22,107,104
2020,2,22000845,4/16/2021,1610612765,Detroit Pistons,1,1,1610612760,Oklahoma City Thunder,0,0,28,27,55,10,25,35,38,52,90,24,10,34,17,39,22,13,18,107,110
2023,2,22300710,2/4/2024,1610612760,Oklahoma City Thunder,1,1,1610612761,Toronto Raptors,0,0,29,18,47,23,40,63,52,58,110,8,0,8,20,38,40,6,11,104,135
2023,2,22301048,3/27/2024,1610612766,Charlotte Hornets,1,1,1610612739,Cleveland Cavaliers,0,0,31,12,43,13,20,33,44,32,76,17,5,22,11,24,30,7,16,92,118
2016,2,21601071,3/23/2017,1610612752,New York Knicks,0,0,1610612757,Portland Trail Blazers,1,1,31,35,66,5,17,22,36,52,88,18,2,20,12,42,23,8,11,95,95
2023,2,22300646,1/27/2024,1610612738,Boston Celtics,1,0,1610612746,LA Clippers,0,1,26,34,60,10,30,40,36,64,100,14,2,16,20,44,21,8,11,97,96
2023,2,22300648,1/27/2024,1610612740,New Orleans Pelicans,0,0,1610612749,Milwaukee Bucks,1,1,31,31,62,9,14,23,40,45,85,28,8,36,10,40,20,12,15,106,117
2023,2,22301018,3/22/2024,1610612755,Philadelphia 76ers,0,0,1610612747,Los Angeles Lakers,1,1,25,34,59,8,29,37,33,63,96,20,4,24,18,47,20,1,9,99,94
2023,2,22301026,3/23/2024,1610612743,Denver Nuggets,0,1,1610612757,Portland Trail Blazers,1,0,33,34,67,8,16,24,41,50,91,24,9,33,24,32,25,8,14,98,114
2016,2,21601071,3/23/2017,1610612757,Portland Trail Blazers,1,1,1610612752,New York Knicks,0,0,28,31,59,11,10,21,39,41,80,21,8,29,12,33,15,5,13,97,110
2016,2,21600518,1/2/2017,1610612745,Houston Rockets,1,1,1610612764,Washington Wizards,0,0,25,22,47,12,27,39,37,49,86,15,6,21,11,40,25,9,15,100,101
2016,2,21600518,1/2/2017,1610612764,Washington Wizards,0,0,1610612745,Houston Rockets,1,1,32,29,61,6,20,26,38,49,87,9,3,12,11,40,23,9,17,99,91
2023,2,22300646,1/27/2024,1610612746,LA Clippers,0,1,1610612738,Boston Celtics,1,0,35,27,62,10,30,40,45,57,102,15,3,18,21,37,28,2,8,98,115
2020,2,22000844,4/16/2021,1610612754,Indiana Pacers,0,0,1610612762,Utah Jazz,1,1,28,38,66,13,26,39,41,64,105,16,1,17,17,47,23,5,10,105,111
2020,2,22000844,4/16/2021,1610612762,Utah Jazz,1,1,1610612754,Indiana Pacers,0,0,26,19,45,16,26,42,42,45,87,19,5,24,14,34,22,13,21,105,119
2023,2,22300623,1/24/2024,1610612757,Portland Trail Blazers,0,1,1610612745,Houston Rockets,1,0,35,28,63,15,20,35,50,48,98,22,2,24,19,30,31,8,12,104,137
2023,2,22300626,1/24/2024,1610612737,Atlanta Hawks,0,0,1610612744,Golden State Warriors,1,1,25,26,51,14,29,43,39,55,94,20,6,26,17,41,30,6,11,99,112
2023,2,22301081,3/31/2024,1610612764,Washington Wizards,1,0,1610612748,Miami Heat,0,1,29,21,50,11,27,38,40,48,88,16,5,21,13,36,27,11,16,103,107
2018,2,21800972,3/6/2019,1610612752,New York Knicks,0,0,1610612756,Phoenix Suns,1,1,29,33,62,6,9,15,35,42,77,20,5,25,13,30,17,11,22,97,96
2018,2,21800972,3/6/2019,1610612756,Phoenix Suns,1,1,1610612752,New York Knicks,0,0,27,25,52,12,17,29,39,42,81,17,5,22,5,41,21,6,13,97,107
2018,2,21800847,2/11/2019,1610612743,Denver Nuggets,1,1,1610612748,Miami Heat,0,0,22,30,52,16,21,37,38,51,89,11,2,13,12,40,27,10,15,98,103
2018,2,21800847,2/11/2019,1610612748,Miami Heat,0,0,1610612743,Denver Nuggets,1,1,25,24,49,9,24,33,34,48,82,10,6,16,13,38,23,7,19,97,87
2018,2,21800750,1/29/2019,1610612749,Milwaukee Bucks,0,1,1610612765,Detroit Pistons,1,0,34,21,55,13,19,32,47,40,87,8,2,10,8,34,32,8,11,94,115
2018,2,21800750,1/29/2019,1610612765,Detroit Pistons,1,0,1610612749,Milwaukee Bucks,0,1,30,22,52,12,25,37,42,47,89,9,3,12,13,35,29,9,12,93,105
2023,2,22300635,1/26/2024,1610612745,Houston Rockets,0,1,1610612766,Charlotte Hornets,1,0,37,19,56,13,20,33,50,39,89,25,6,31,13,29,34,6,14,101,138
2023,2,22301016,3/22/2024,1610612744,Golden State Warriors,1,0,1610612754,Indiana Pacers,0,1,29,29,58,14,34,48,43,63,106,11,5,16,25,40,24,8,14,104,111
2021,2,22100109,11/3/2021,1610612752,New York Knicks,0,0,1610612754,Indiana Pacers,1,1,31,32,63,5,19,24,36,51,87,21,6,27,14,40,23,7,10,95,98
2021,2,22100109,11/3/2021,1610612754,Indiana Pacers,1,1,1610612752,New York Knicks,0,0,26,24,50,16,25,41,42,49,91,11,3,14,16,34,26,7,13,95,111
2023,2,22300622,1/24/2024,1610612759,San Antonio Spurs,1,0,1610612760,Oklahoma City Thunder,0,1,34,20,54,9,23,32,43,43,86,19,6,25,14,31,30,11,19,102,114
2014,2,21401174,4/9/2015,1610612744,Golden State Warriors,1,1,1610612757,Portland Trail Blazers,0,0,36,28,64,12,14,26,48,42,90,8,1,9,12,30,27,6,14,95,116
2014,2,21401174,4/9/2015,1610612757,Portland Trail Blazers,0,0,1610612744,Golden State Warriors,1,1,39,35,74,7,17,24,46,52,98,6,2,8,17,37,28,6,9,96,105
2023,2,22300669,1/30/2024,1610612737,Atlanta Hawks,1,1,1610612747,Los Angeles Lakers,0,0,37,26,63,16,22,38,53,48,101,16,2,18,15,34,32,12,12,107,138
2019,2,21900021,10/25/2019,1610612740,New Orleans Pelicans,1,0,1610612742,Dallas Mavericks,0,1,30,27,57,15,26,41,45,53,98,11,4,15,16,39,30,8,14,104,116
2019,2,21900021,10/25/2019,1610612742,Dallas Mavericks,0,1,1610612740,New Orleans Pelicans,1,0,31,22,53,14,26,40,45,48,93,19,7,26,14,39,23,6,11,103,123
2023,2,22300696,2/2/2024,1610612759,San Antonio Spurs,1,0,1610612740,New Orleans Pelicans,0,1,36,21,57,10,29,39,46,50,96,11,7,18,25,27,35,14,18,99,113
2016,2,21600092,11/6/2016,1610612747,Los Angeles Lakers,1,1,1610612756,Phoenix Suns,0,0,31,36,67,10,13,23,41,49,90,27,8,35,21,30,22,8,19,106,119
2016,2,21600092,11/6/2016,1610612756,Phoenix Suns,0,0,1610612747,Los Angeles Lakers,1,1,34,37,71,6,14,20,40,51,91,22,6,28,14,41,20,8,18,106,108
2023,2,22300597,1/20/2024,1610612741,Chicago Bulls,1,1,1610612763,Memphis Grizzlies,0,0,33,25,58,14,19,33,47,44,91,17,4,21,16,30,32,6,12,98,125
2023,2,22300681,1/31/2024,1610612753,Orlando Magic,0,1,1610612759,San Antonio Spurs,1,0,34,32,66,7,13,20,41,45,86,19,4,23,13,35,29,9,16,101,108
2014,2,21400691,1/28/2015,1610612756,Phoenix Suns,1,1,1610612764,Washington Wizards,0,0,29,30,59,11,18,29,40,48,88,15,3,18,12,37,23,2,11,97,106
2014,2,21400691,1/28/2015,1610612764,Washington Wizards,0,0,1610612756,Phoenix Suns,1,1,29,41,70,8,10,18,37,51,88,16,7,23,17,37,13,10,13,95,98
2023,2,22300728,2/7/2024,1610612764,Washington Wizards,1,0,1610612739,Cleveland Cavaliers,0,1,26,28,54,16,24,40,42,52,94,6,3,9,13,41,27,4,15,99,106
2023,2,22300636,1/26/2024,1610612756,Phoenix Suns,0,0,1610612754,Indiana Pacers,1,1,38,21,59,13,17,30,51,38,89,16,2,18,11,28,24,8,20,106,131
2023,2,22301023,3/23/2024,1610612741,Chicago Bulls,1,0,1610612738,Boston Celtics,0,1,38,20,58,9,15,24,47,35,82,10,1,11,5,30,36,5,7,88,113
2023,2,22300816,2/24/2024,1610612752,New York Knicks,1,0,1610612738,Boston Celtics,0,1,24,20,44,13,25,38,37,45,82,15,1,16,19,27,21,8,14,83,102
2023,2,22300649,1/27/2024,1610612750,Minnesota Timberwolves,0,0,1610612759,San Antonio Spurs,1,1,31,22,53,14,12,26,45,34,79,8,7,15,9,29,30,7,13,91,112
2023,2,22300963,3/15/2024,1610612753,Orlando Magic,0,1,1610612761,Toronto Raptors,1,0,26,23,49,14,17,31,40,40,80,19,3,22,9,33,25,11,15,98,113
2023,2,22301026,3/23/2024,1610612757,Portland Trail Blazers,1,0,1610612743,Denver Nuggets,0,1,33,32,65,10,18,28,43,50,93,15,2,17,19,33,27,8,16,98,111
2019,2,21900239,11/24/2019,1610612740,New Orleans Pelicans,0,0,1610612746,LA Clippers,1,1,30,27,57,13,28,41,43,55,98,10,8,18,14,45,26,4,9,101,109
2019,2,21900239,11/24/2019,1610612746,LA Clippers,1,1,1610612740,New Orleans Pelicans,0,0,30,25,55,16,27,43,46,52,98,26,7,33,19,39,27,1,8,100,134
2016,2,21601070,3/23/2017,1610612759,San Antonio Spurs,1,1,1610612763,Memphis Grizzlies,0,0,29,22,51,8,18,26,37,40,77,15,8,23,11,34,26,4,6,85,97
2016,2,21601070,3/23/2017,1610612763,Memphis Grizzlies,0,0,1610612759,San Antonio Spurs,1,1,24,25,49,10,19,29,34,44,78,12,3,15,15,30,18,6,14,84,90
2023,2,22300839,2/27/2024,1610612741,Chicago Bulls,1,0,1610612765,Detroit Pistons,0,1,37,32,69,2,27,29,39,59,98,15,3,18,19,42,22,3,6,93,95
2023,2,22300963,3/15/2024,1610612761,Toronto Raptors,1,0,1610612753,Orlando Magic,0,1,24,23,47,14,20,34,38,43,81,13,7,20,10,36,24,7,16,96,103
2023,2,22300598,1/20/2024,1610612762,Utah Jazz,0,0,1610612745,Houston Rockets,1,1,35,27,62,13,30,43,48,57,105,17,5,22,24,37,28,11,17,110,126
2016,2,21600517,1/2/2017,1610612741,Chicago Bulls,1,1,1610612766,Charlotte Hornets,0,0,35,32,67,7,16,23,42,48,90,27,2,29,17,31,23,7,12,97,118
2016,2,21600517,1/2/2017,1610612766,Charlotte Hornets,0,0,1610612741,Chicago Bulls,1,1,32,32,64,9,10,19,41,42,83,20,2,22,10,32,24,10,16,98,111
2023,2,22300634,1/26/2024,1610612737,Atlanta Hawks,1,0,1610612742,Dallas Mavericks,0,1,36,27,63,15,19,34,51,46,97,26,4,30,14,33,32,3,7,106,143
2023,2,22300669,1/30/2024,1610612747,Los Angeles Lakers,0,0,1610612737,Atlanta Hawks,1,1,36,21,57,12,21,33,48,42,90,14,11,25,9,39,28,10,14,108,122
2023,2,22300675,1/31/2024,1610612765,Detroit Pistons,0,0,1610612739,Cleveland Cavaliers,1,1,29,21,50,16,15,31,45,36,81,15,4,19,12,25,27,13,19,99,121
2018,2,21801119,3/27/2019,1610612754,Indiana Pacers,0,0,1610612760,Oklahoma City Thunder,1,1,27,34,61,13,18,31,40,52,92,6,5,11,15,40,26,7,12,94,99
2018,2,21801119,3/27/2019,1610612760,Oklahoma City Thunder,1,1,1610612754,Indiana Pacers,0,0,28,28,56,13,23,36,41,51,92,12,7,19,14,40,29,4,7,94,107
2018,2,21800971,3/6/2019,1610612740,New Orleans Pelicans,1,0,1610612762,Utah Jazz,0,1,32,33,65,9,15,24,41,48,89,13,7,20,10,40,17,9,18,107,104
2018,2,21800971,3/6/2019,1610612762,Utah Jazz,0,1,1610612740,New Orleans Pelicans,1,0,38,20,58,8,22,30,46,42,88,14,8,22,11,35,31,6,20,106,114
2023,2,22301185,4/12/2024,1610612758,Sacramento Kings,1,0,1610612756,Phoenix Suns,0,1,26,27,53,14,24,38,40,51,91,13,1,14,12,39,26,4,7,93,107
2023,2,22300696,2/2/2024,1610612740,New Orleans Pelicans,0,1,1610612759,San Antonio Spurs,1,0,39,30,69,7,19,26,46,49,95,15,6,21,15,37,29,6,9,98,114
2018,2,21800749,1/29/2019,1610612739,Cleveland Cavaliers,1,1,1610612764,Washington Wizards,0,0,30,20,50,15,19,34,45,39,84,11,13,24,13,34,30,8,16,98,116
2018,2,21800749,1/29/2019,1610612764,Washington Wizards,0,0,1610612739,Cleveland Cavaliers,1,1,30,21,51,12,24,36,42,45,87,17,6,23,4,42,31,3,6,99,113
2023,2,22300713,2/5/2024,1610612747,Los Angeles Lakers,0,1,1610612766,Charlotte Hornets,1,0,42,13,55,8,26,34,50,39,89,16,3,19,9,32,36,9,17,106,124
2023,2,22300987,3/18/2024,1610612762,Utah Jazz,1,0,1610612750,Minnesota Timberwolves,0,1,25,27,52,14,18,32,39,45,84,12,2,14,15,30,25,9,17,92,104
2023,2,22301000,3/20/2024,1610612760,Oklahoma City Thunder,1,1,1610612762,Utah Jazz,0,0,33,21,54,10,24,34,43,45,88,23,6,29,11,37,29,6,10,99,119
2023,2,22300637,1/26/2024,1610612761,Toronto Raptors,1,0,1610612746,LA Clippers,0,1,38,26,64,6,26,32,44,52,96,13,9,22,18,40,26,6,11,100,107
2023,2,22300735,2/8/2024,1610612739,Cleveland Cavaliers,0,1,1610612751,Brooklyn Nets,1,0,28,15,43,15,22,37,43,37,80,17,0,17,9,28,26,9,17,96,118
2023,2,22300653,1/28/2024,1610612761,Toronto Raptors,0,0,1610612737,Atlanta Hawks,1,1,26,32,58,15,16,31,41,48,89,28,4,32,17,32,29,7,14,102,125
2023,2,22300671,1/30/2024,1610612752,New York Knicks,1,1,1610612762,Utah Jazz,0,0,31,29,60,13,21,34,44,50,94,17,1,18,17,34,29,3,6,90,118
2023,2,22300694,2/2/2024,1610612753,Orlando Magic,0,1,1610612750,Minnesota Timberwolves,1,0,30,30,60,9,16,25,39,46,85,21,5,26,14,34,24,8,15,99,108
2023,2,22300688,2/2/2024,1610612746,LA Clippers,0,1,1610612765,Detroit Pistons,1,0,39,21,60,14,15,29,53,36,89,16,3,19,11,26,31,5,11,97,136
2023,2,22300648,1/27/2024,1610612749,Milwaukee Bucks,1,1,1610612740,New Orleans Pelicans,0,0,31,15,46,20,25,45,51,40,91,19,6,25,8,35,30,5,9,106,141
2023,2,22300735,2/8/2024,1610612751,Brooklyn Nets,1,0,1610612739,Cleveland Cavaliers,0,1,27,41,68,10,15,25,37,56,93,11,3,14,16,41,22,8,12,96,95
2023,2,22300738,2/8/2024,1610612750,Minnesota Timberwolves,0,1,1610612749,Milwaukee Bucks,1,0,27,19,46,21,20,41,48,39,87,12,4,16,14,29,34,6,8,90,129
2023,2,22300987,3/18/2024,1610612750,Minnesota Timberwolves,0,1,1610612762,Utah Jazz,1,0,28,22,50,16,25,41,44,47,91,10,2,12,14,34,27,6,9,92,114
2023,2,22300754,2/10/2024,1610612737,Atlanta Hawks,1,1,1610612745,Houston Rockets,0,0,26,21,47,14,27,41,40,48,88,28,9,37,11,43,25,6,11,105,122
2023,2,22300816,2/24/2024,1610612738,Boston Celtics,0,1,1610612752,New York Knicks,1,0,31,15,46,15,20,35,46,35,81,9,3,12,12,26,27,1,7,82,116
2023,2,22301022,3/23/2024,1610612761,Toronto Raptors,0,0,1610612764,Washington Wizards,1,1,32,29,61,8,25,33,40,54,94,21,5,26,17,40,27,7,12,100,109
2023,2,22301000,3/20/2024,1610612762,Utah Jazz,0,0,1610612760,Oklahoma City Thunder,1,1,30,24,54,10,26,36,40,50,90,17,1,18,15,36,20,10,16,100,107
2023,2,22301002,3/20/2024,1610612755,Philadelphia 76ers,0,0,1610612756,Phoenix Suns,1,1,28,30,58,13,24,37,41,54,95,7,11,18,16,42,33,7,11,100,102
2023,2,22300999,3/20/2024,1610612758,Sacramento Kings,0,1,1610612761,Toronto Raptors,1,0,36,17,53,12,28,40,48,45,93,15,3,18,21,25,32,11,16,98,123
2023,2,22301002,3/20/2024,1610612756,Phoenix Suns,1,1,1610612755,Philadelphia 76ers,0,0,26,25,51,19,20,39,45,45,90,6,2,8,17,29,34,12,23,100,115
2023,2,22301010,3/21/2024,1610612756,Phoenix Suns,1,1,1610612737,Atlanta Hawks,0,0,19,14,33,22,19,41,41,33,74,24,3,27,9,24,28,11,17,95,128
2023,2,22300688,2/2/2024,1610612765,Detroit Pistons,1,0,1610612746,LA Clippers,0,1,28,21,49,17,23,40,45,44,89,18,6,24,17,30,28,12,17,99,125
2023,2,22300637,1/26/2024,1610612746,LA Clippers,0,1,1610612761,Toronto Raptors,1,0,39,24,63,9,23,32,48,47,95,22,2,24,16,31,29,6,11,100,127
2023,2,22300671,1/30/2024,1610612762,Utah Jazz,0,0,1610612752,New York Knicks,1,1,27,23,50,12,24,36,39,47,86,13,4,17,17,33,23,9,15,90,103
2023,2,22300988,3/18/2024,1610612752,New York Knicks,0,1,1610612744,Golden State Warriors,1,0,30,24,54,14,23,37,44,47,91,17,3,20,19,30,29,7,13,94,119
2023,2,22300650,1/27/2024,1610612744,Golden State Warriors,1,0,1610612747,Los Angeles Lakers,0,1,32,29,61,23,35,58,55,64,119,11,5,16,19,48,37,9,17,126,144
2023,2,22301044,3/26/2024,1610612748,Miami Heat,1,0,1610612744,Golden State Warriors,0,1,29,30,59,8,25,33,37,55,92,10,3,13,16,39,24,6,9,93,92
2023,2,22301083,3/31/2024,1610612742,Dallas Mavericks,0,1,1610612745,Houston Rockets,1,0,24,22,46,24,23,47,48,45,93,5,4,9,15,33,24,9,14,98,125
2023,2,22300655,1/28/2024,1610612756,Phoenix Suns,0,0,1610612753,Orlando Magic,1,1,37,22,59,4,10,14,41,32,73,12,9,21,8,29,19,12,23,97,98
2023,2,22300733,2/8/2024,1610612754,Indiana Pacers,1,0,1610612744,Golden State Warriors,0,1,27,23,50,12,19,31,39,42,81,19,8,27,8,40,31,7,14,98,109
2023,2,22300694,2/2/2024,1610612750,Minnesota Timberwolves,1,0,1610612753,Orlando Magic,0,1,26,18,44,12,26,38,38,44,82,18,2,20,8,38,24,11,17,101,106
2023,2,22300743,2/9/2024,1610612738,Boston Celtics,1,1,1610612764,Washington Wizards,0,0,37,21,58,11,23,34,48,44,92,26,2,28,9,35,25,8,13,108,133
2023,2,22301003,3/20/2024,1610612757,Portland Trail Blazers,1,0,1610612746,LA Clippers,0,1,24,23,47,15,19,34,39,42,81,10,5,15,10,35,21,15,17,96,103
2023,2,22300962,3/15/2024,1610612748,Miami Heat,0,1,1610612765,Detroit Pistons,1,0,36,21,57,7,27,34,43,48,91,15,6,21,10,41,23,5,8,97,108
2023,2,22300998,3/20/2024,1610612738,Boston Celtics,1,1,1610612749,Milwaukee Bucks,0,0,22,23,45,18,22,40,40,45,85,24,5,29,14,35,25,3,9,94,122
2023,2,22301030,3/24/2024,1610612749,Milwaukee Bucks,1,1,1610612760,Oklahoma City Thunder,0,0,38,20,58,11,23,34,49,43,92,9,5,14,16,29,33,9,17,97,118
2023,2,22301032,3/24/2024,1610612747,Los Angeles Lakers,1,1,1610612754,Indiana Pacers,0,0,38,26,64,12,13,25,50,39,89,38,5,43,10,31,28,6,10,108,150
2023,2,22301038,3/25/2024,1610612745,Houston Rockets,1,1,1610612757,Portland Trail Blazers,0,0,25,29,54,12,27,39,37,56,93,24,1,25,16,40,19,5,9,98,110
2023,2,22301039,3/25/2024,1610612756,Phoenix Suns,0,0,1610612759,San Antonio Spurs,1,1,32,23,55,10,18,28,42,41,83,8,6,14,7,37,28,10,15,98,102
2023,2,22300741,2/8/2024,1610612765,Detroit Pistons,0,1,1610612757,Portland Trail Blazers,1,0,29,37,66,16,11,27,45,48,93,22,9,31,21,31,26,9,17,104,128
2023,2,22300700,2/3/2024,1610612741,Chicago Bulls,1,0,1610612758,Sacramento Kings,0,1,31,26,57,11,23,34,42,49,91,20,2,22,13,37,24,12,16,104,115
2023,2,22300598,1/20/2024,1610612745,Houston Rockets,1,1,1610612762,Utah Jazz,0,0,37,41,78,13,26,39,50,67,117,14,8,22,26,46,27,4,7,107,127
2023,2,22300651,1/27/2024,1610612742,Dallas Mavericks,1,0,1610612758,Sacramento Kings,0,1,27,25,52,16,30,46,43,55,98,13,5,18,18,38,35,4,10,100,115
2023,2,22300645,1/27/2024,1610612745,Houston Rockets,0,0,1610612751,Brooklyn Nets,1,1,27,30,57,10,27,37,37,57,94,20,3,23,18,41,20,11,17,104,104
2023,2,22300707,2/4/2024,1610612754,Indiana Pacers,0,1,1610612766,Charlotte Hornets,1,0,34,25,59,11,22,33,45,47,92,14,4,18,12,37,34,6,11,98,115
2023,2,22300655,1/28/2024,1610612753,Orlando Magic,1,1,1610612756,Phoenix Suns,0,0,29,27,56,12,24,36,41,51,92,19,7,26,18,38,30,4,10,96,113
2023,2,22301032,3/24/2024,1610612754,Indiana Pacers,0,0,1610612747,Los Angeles Lakers,1,1,41,30,71,18,18,36,59,48,107,9,7,16,17,35,39,6,11,108,145
2023,2,22300998,3/20/2024,1610612749,Milwaukee Bucks,0,0,1610612738,Boston Celtics,1,1,28,21,49,17,18,35,45,39,84,12,2,14,12,28,20,6,15,94,119
2023,2,22300677,1/31/2024,1610612751,Brooklyn Nets,1,0,1610612756,Phoenix Suns,0,1,31,24,55,16,23,39,47,47,94,10,3,13,12,36,28,5,11,99,120
2023,2,22301081,3/31/2024,1610612748,Miami Heat,0,1,1610612764,Washington Wizards,1,0,26,19,45,14,22,36,40,41,81,25,4,29,7,36,22,6,14,102,119
2023,2,22301031,3/24/2024,1610612750,Minnesota Timberwolves,1,1,1610612744,Golden State Warriors,0,0,19,25,44,21,19,40,40,44,84,13,5,18,9,38,30,8,16,99,114
2023,2,22301003,3/20/2024,1610612746,LA Clippers,0,1,1610612757,Portland Trail Blazers,1,0,32,23,55,13,18,31,45,41,86,13,2,15,9,33,29,6,12,95,116
2023,2,22300755,2/10/2024,1610612754,Indiana Pacers,0,1,1610612752,New York Knicks,1,0,36,17,53,14,15,29,50,32,82,11,8,19,8,29,30,7,16,98,125
2023,2,22301050,3/27/2024,1610612751,Brooklyn Nets,0,1,1610612764,Washington Wizards,1,0,37,28,65,10,23,33,47,51,98,18,5,23,12,42,24,4,8,104,122
2023,2,22301075,3/30/2024,1610612753,Orlando Magic,1,1,1610612763,Memphis Grizzlies,0,0,16,18,34,22,22,44,38,40,78,20,3,23,7,34,28,11,17,99,118
2023,2,22301189,4/14/2024,1610612748,Miami Heat,1,1,1610612761,Toronto Raptors,0,0,37,14,51,9,27,36,46,41,87,17,2,19,14,28,29,6,19,99,118
2023,2,22301037,3/25/2024,1610612741,Chicago Bulls,1,0,1610612764,Washington Wizards,0,1,26,26,52,10,25,35,36,51,87,23,5,28,15,39,27,8,12,100,105
2023,2,22300680,1/31/2024,1610612742,Dallas Mavericks,0,0,1610612750,Minnesota Timberwolves,1,1,25,22,47,6,23,29,31,45,76,19,7,26,10,38,18,6,17,93,87
2021,2,22100108,11/3/2021,1610612739,Cleveland Cavaliers,1,1,1610612757,Portland Trail Blazers,0,0,24,20,44,15,15,30,39,35,74,14,4,18,8,29,29,12,19,93,107
2021,2,22100108,11/3/2021,1610612757,Portland Trail Blazers,0,0,1610612739,Cleveland Cavaliers,1,1,27,26,53,13,24,37,40,50,90,11,6,17,13,41,24,4,9,94,104
2016,2,21601069,3/23/2017,1610612742,Dallas Mavericks,1,1,1610612746,LA Clippers,0,0,29,27,56,9,17,26,38,44,82,12,6,18,7,40,26,6,9,94,97
2020,2,22000843,4/15/2021,1610612756,Phoenix Suns,1,1,1610612758,Sacramento Kings,0,0,34,14,48,14,24,38,48,38,86,12,2,14,11,28,30,7,11,94,122
2020,2,22000843,4/15/2021,1610612758,Sacramento Kings,0,0,1610612756,Phoenix Suns,1,1,29,19,48,14,16,30,43,35,78,14,5,19,7,31,22,9,15,94,114
2023,2,22301001,3/20/2024,1610612744,Golden State Warriors,1,1,1610612763,Memphis Grizzlies,0,0,39,22,61,19,20,39,58,42,100,2,4,6,16,29,43,4,7,95,137
2023,2,22300750,2/10/2024,1610612759,San Antonio Spurs,0,0,1610612751,Brooklyn Nets,1,1,25,32,57,11,23,34,36,55,91,20,1,21,22,33,20,8,14,94,103
2023,2,22300689,2/2/2024,1610612748,Miami Heat,0,1,1610612764,Washington Wizards,1,0,31,26,57,7,24,31,38,50,88,27,8,35,17,38,24,5,12,99,110
2023,2,22300736,2/8/2024,1610612752,New York Knicks,1,0,1610612742,Dallas Mavericks,0,1,28,29,57,14,23,37,42,52,94,10,1,11,17,36,27,7,14,94,108
2023,2,22300707,2/4/2024,1610612766,Charlotte Hornets,1,0,1610612754,Indiana Pacers,0,1,27,32,59,8,21,29,35,53,88,21,4,25,13,42,18,5,11,98,99
2023,2,22300990,3/18/2024,1610612737,Atlanta Hawks,0,0,1610612747,Los Angeles Lakers,1,1,33,24,57,9,32,41,42,56,98,12,3,15,14,44,32,6,9,99,105
2023,2,22300999,3/20/2024,1610612761,Toronto Raptors,1,0,1610612758,Sacramento Kings,0,1,23,26,49,10,21,31,33,47,80,13,5,18,13,36,21,14,22,98,89
2023,2,22301049,3/27/2024,1610612753,Orlando Magic,1,0,1610612744,Golden State Warriors,0,1,26,27,53,10,22,32,36,49,85,11,10,21,12,42,25,5,11,92,93
2023,2,22301044,3/26/2024,1610612744,Golden State Warriors,0,1,1610612748,Miami Heat,1,0,34,13,47,13,25,38,47,38,85,6,4,10,10,31,31,3,12,91,113
2023,2,22300741,2/8/2024,1610612757,Portland Trail Blazers,1,0,1610612765,Detroit Pistons,0,1,30,29,59,11,19,30,41,48,89,29,4,33,17,32,29,3,17,105,122
2023,2,22300961,3/15/2024,1610612756,Phoenix Suns,0,1,1610612766,Charlotte Hornets,1,0,29,20,49,11,27,38,40,47,87,16,4,20,12,37,31,6,10,93,107
2023,2,22301085,3/31/2024,1610612744,Golden State Warriors,0,1,1610612759,San Antonio Spurs,1,0,29,24,53,16,23,39,45,47,92,11,2,13,17,30,34,7,16,99,117
2023,2,22301030,3/24/2024,1610612760,Oklahoma City Thunder,0,0,1610612749,Milwaukee Bucks,1,1,23,23,46,10,33,43,33,56,89,17,5,22,15,43,20,7,12,98,93
2023,2,22301075,3/30/2024,1610612763,Memphis Grizzlies,0,0,1610612753,Orlando Magic,1,1,19,31,50,12,24,36,31,55,86,14,3,17,15,42,25,8,19,99,88
2023,2,22301040,3/25/2024,1610612743,Denver Nuggets,1,1,1610612763,Memphis Grizzlies,0,0,33,25,58,15,17,32,48,42,90,17,1,18,17,26,38,9,16,98,128
2023,2,22301118,4/5/2024,1610612738,Boston Celtics,1,1,1610612758,Sacramento Kings,0,0,26,19,45,12,32,44,38,51,89,13,5,18,13,39,25,4,8,93,101
2023,2,22301137,4/7/2024,1610612761,Toronto Raptors,1,1,1610612764,Washington Wizards,0,0,38,27,65,11,20,31,49,47,96,21,7,28,13,38,33,9,14,109,130
2023,2,22301184,4/12/2024,1610612762,Utah Jazz,0,1,1610612746,LA Clippers,1,0,35,18,53,6,29,35,41,47,88,22,3,25,19,29,26,9,18,96,110
2023,2,22300740,2/8/2024,1610612747,Los Angeles Lakers,1,0,1610612743,Denver Nuggets,0,1,33,31,64,8,17,25,41,48,89,16,6,22,12,39,27,4,7,95,106
2023,2,22300740,2/8/2024,1610612743,Denver Nuggets,0,1,1610612747,Los Angeles Lakers,1,0,33,32,65,14,18,32,47,50,97,6,1,7,21,30,33,12,14,94,114
2021,2,22100107,11/2/2021,1610612745,Houston Rockets,0,0,1610612747,Los Angeles Lakers,1,1,32,17,49,16,26,42,48,43,91,5,7,12,14,34,27,10,25,109,117
2021,2,22100107,11/2/2021,1610612747,Los Angeles Lakers,1,1,1610612745,Houston Rockets,0,0,43,25,68,6,19,25,49,44,93,15,5,20,15,31,26,8,17,109,119
2016,2,21601069,3/23/2017,1610612746,LA Clippers,0,0,1610612742,Dallas Mavericks,1,1,27,26,53,9,18,27,36,44,80,14,7,21,14,32,18,11,17,94,95
2023,2,22300738,2/8/2024,1610612749,Milwaukee Bucks,1,0,1610612750,Minnesota Timberwolves,0,1,26,22,48,14,19,33,40,41,81,11,5,16,12,32,35,8,13,90,105
2023,2,22300599,1/20/2024,1610612760,Oklahoma City Thunder,0,1,1610612750,Minnesota Timberwolves,1,0,24,33,57,8,16,24,32,49,81,30,5,35,10,42,21,4,8,96,102
2023,2,22300709,2/4/2024,1610612745,Houston Rockets,0,0,1610612750,Minnesota Timberwolves,1,1,21,37,58,10,20,30,31,57,88,18,9,27,10,49,20,6,11,101,90
2023,2,22300967,3/16/2024,1610612745,Houston Rockets,1,1,1610612739,Cleveland Cavaliers,0,0,32,24,56,15,27,42,47,51,98,8,4,12,14,39,28,6,10,99,117
2023,2,22300759,2/11/2024,1610612748,Miami Heat,1,0,1610612738,Boston Celtics,0,1,28,29,57,12,28,40,40,57,97,14,1,15,20,37,21,1,7,90,106
2023,2,22300670,1/30/2024,1610612754,Indiana Pacers,0,0,1610612738,Boston Celtics,1,1,38,31,69,12,27,39,50,58,108,12,3,15,24,36,33,6,8,99,124
2023,2,22300755,2/10/2024,1610612752,New York Knicks,1,0,1610612754,Indiana Pacers,0,1,30,22,52,10,22,32,40,44,84,21,2,23,7,38,16,4,9,97,111
2023,2,22300790,2/15/2024,1610612749,Milwaukee Bucks,0,0,1610612763,Memphis Grizzlies,1,1,31,15,46,11,33,44,42,48,90,15,5,20,16,34,24,9,14,99,110
2023,2,22300970,3/16/2024,1610612740,New Orleans Pelicans,1,1,1610612757,Portland Trail Blazers,0,0,39,25,64,13,20,33,52,45,97,9,1,10,16,30,36,3,10,96,126
2023,2,22300860,3/1/2024,1610612744,Golden State Warriors,0,1,1610612761,Toronto Raptors,1,0,26,28,54,18,26,44,44,54,98,14,4,18,18,37,26,9,14,103,120
2023,2,22301045,3/26/2024,1610612749,Milwaukee Bucks,1,0,1610612747,Los Angeles Lakers,0,1,34,34,68,15,36,51,49,70,119,11,6,17,19,55,37,4,14,123,124
2023,2,22300990,3/18/2024,1610612747,Los Angeles Lakers,1,1,1610612737,Atlanta Hawks,0,0,37,17,54,15,21,36,52,38,90,17,3,20,6,33,39,8,9,101,136
2023,2,22301186,4/14/2024,1610612738,Boston Celtics,1,1,1610612764,Washington Wizards,0,0,35,22,57,16,16,32,51,38,89,14,7,21,12,30,29,9,17,103,132
2023,2,22301010,3/21/2024,1610612737,Atlanta Hawks,0,0,1610612756,Phoenix Suns,1,1,28,28,56,12,23,35,40,51,91,23,6,29,20,33,27,4,11,94,115
2023,2,22300733,2/8/2024,1610612744,Golden State Warriors,0,1,1610612754,Indiana Pacers,1,0,35,26,61,17,15,32,52,41,93,10,3,13,17,26,33,11,17,100,131
2023,2,22301008,3/21/2024,1610612742,Dallas Mavericks,1,1,1610612762,Utah Jazz,0,0,33,21,54,10,22,32,43,43,86,17,11,28,13,34,33,6,13,101,113
2023,2,22300709,2/4/2024,1610612750,Minnesota Timberwolves,1,1,1610612745,Houston Rockets,0,0,29,31,60,11,19,30,40,50,90,20,7,27,18,33,21,10,16,101,111
2023,2,22300689,2/2/2024,1610612764,Washington Wizards,1,0,1610612748,Miami Heat,0,1,26,22,48,11,31,42,37,53,90,17,4,21,10,46,28,4,9,99,102
2023,2,22300719,2/6/2024,1610612745,Houston Rockets,0,0,1610612754,Indiana Pacers,1,1,38,34,72,12,13,25,50,47,97,17,6,23,24,25,26,7,15,100,129
2023,2,22300721,2/6/2024,1610612753,Orlando Magic,0,0,1610612748,Miami Heat,1,1,25,20,45,10,25,35,35,45,80,15,6,21,12,37,25,10,18,97,95
2023,2,22300989,3/18/2024,1610612758,Sacramento Kings,1,1,1610612763,Memphis Grizzlies,0,0,31,28,59,11,24,35,42,52,94,26,6,32,20,35,30,13,19,110,121
2023,2,22301039,3/25/2024,1610612759,San Antonio Spurs,1,1,1610612756,Phoenix Suns,0,0,32,28,60,8,23,31,40,51,91,16,3,19,10,44,23,5,7,98,104
2023,2,22300971,3/16/2024,1610612741,Chicago Bulls,1,1,1610612764,Washington Wizards,0,0,41,20,61,8,16,24,49,36,85,21,8,29,14,24,33,12,15,99,127
2023,2,22300867,3/2/2024,1610612748,Miami Heat,1,1,1610612762,Utah Jazz,0,0,33,21,54,13,21,34,46,42,88,21,4,25,11,34,33,3,6,95,126
2023,2,22301041,3/25/2024,1610612762,Utah Jazz,1,0,1610612742,Dallas Mavericks,0,1,24,24,48,13,26,39,37,50,87,18,4,22,13,39,28,9,13,96,105
2023,2,22300769,2/12/2024,1610612744,Golden State Warriors,0,1,1610612762,Utah Jazz,1,0,28,28,56,20,24,44,48,52,100,13,4,17,16,37,31,8,13,105,129
2023,2,22301007,3/21/2024,1610612751,Brooklyn Nets,0,0,1610612749,Milwaukee Bucks,1,1,28,20,48,13,31,44,41,51,92,13,3,16,19,32,29,5,14,97,108
2023,2,22300971,3/16/2024,1610612764,Washington Wizards,0,0,1610612741,Chicago Bulls,1,1,23,29,52,13,19,32,36,48,84,13,9,22,10,42,27,9,16,101,98
2023,2,22301079,3/31/2024,1610612766,Charlotte Hornets,1,0,1610612746,LA Clippers,0,1,21,15,36,23,29,52,44,44,88,7,4,11,11,35,32,4,9,93,118
2023,2,22300975,3/16/2024,1610612752,New York Knicks,0,1,1610612758,Sacramento Kings,1,0,26,21,47,11,28,39,37,49,86,13,3,16,14,37,19,7,16,94,98
2023,2,22301046,3/26/2024,1610612760,Oklahoma City Thunder,0,1,1610612740,New Orleans Pelicans,1,0,31,21,52,15,19,34,46,40,86,12,2,14,7,33,28,7,13,96,119
2023,2,22300720,2/6/2024,1610612742,Dallas Mavericks,0,1,1610612751,Brooklyn Nets,1,0,27,21,48,19,24,43,46,45,91,8,5,13,9,38,25,6,11,98,119
2023,2,22300728,2/7/2024,1610612739,Cleveland Cavaliers,0,1,1610612764,Washington Wizards,1,0,31,22,53,12,23,35,43,45,88,16,6,22,12,36,25,10,14,99,114
2023,2,22300706,2/4/2024,1610612738,Boston Celtics,1,1,1610612763,Memphis Grizzlies,0,0,29,19,48,19,32,51,48,51,99,16,2,18,19,33,30,5,11,100,131
2023,2,22300764,2/12/2024,1610612759,San Antonio Spurs,0,1,1610612761,Toronto Raptors,1,0,35,22,57,11,19,30,46,41,87,19,4,23,9,34,37,11,19,108,122
2023,2,22300988,3/18/2024,1610612744,Golden State Warriors,1,0,1610612752,New York Knicks,0,1,28,24,52,14,22,36,42,46,88,14,4,18,15,32,29,6,13,95,112
2023,2,22300964,3/15/2024,1610612740,New Orleans Pelicans,1,1,1610612746,LA Clippers,0,0,29,23,52,13,22,35,42,45,87,15,5,20,13,34,28,6,9,93,112
2023,2,22300972,3/16/2024,1610612760,Oklahoma City Thunder,0,1,1610612763,Memphis Grizzlies,1,0,33,19,52,12,23,35,45,42,87,16,5,21,11,32,25,7,12,97,118
2023,2,22301024,3/23/2024,1610612762,Utah Jazz,0,0,1610612745,Houston Rockets,1,1,29,23,52,11,26,37,40,49,89,28,5,33,17,34,24,7,10,99,119
2023,2,22300975,3/16/2024,1610612758,Sacramento Kings,1,0,1610612752,New York Knicks,0,1,20,28,48,10,27,37,30,55,85,21,5,26,14,45,22,8,12,95,91
2023,2,22301046,3/26/2024,1610612740,New Orleans Pelicans,1,0,1610612760,Oklahoma City Thunder,0,1,25,23,48,14,24,38,39,47,86,20,3,23,8,40,26,5,9,97,112
2023,2,22301185,4/12/2024,1610612756,Phoenix Suns,0,1,1610612758,Sacramento Kings,1,0,28,16,44,12,20,32,40,36,76,16,1,17,9,27,25,12,19,92,108
2023,2,22301047,3/26/2024,1610612758,Sacramento Kings,1,0,1610612742,Dallas Mavericks,0,1,24,36,60,11,19,30,35,55,90,15,4,19,13,45,27,10,14,101,96
2023,2,22301028,3/24/2024,1610612746,LA Clippers,1,0,1610612755,Philadelphia 76ers,0,1,30,25,55,10,18,28,40,43,83,17,1,18,15,29,27,7,14,89,107
2023,2,22300708,2/4/2024,1610612748,Miami Heat,1,0,1610612746,LA Clippers,0,1,30,31,61,8,22,30,38,53,91,11,1,12,13,40,24,6,10,93,95
2023,2,22300194,11/15/2023,1610612755,Philadelphia 76ers,1,0,1610612738,Boston Celtics,0,1,28,27,55,11,19,30,39,46,85,18,4,22,13,36,18,7,9,94,107
2023,2,22300734,2/8/2024,1610612759,San Antonio Spurs,0,0,1610612753,Orlando Magic,1,1,31,15,46,11,24,35,42,39,81,16,1,17,6,33,29,11,15,96,111
2022,2,22201018,3/12/2023,1610612759,San Antonio Spurs,1,0,1610612760,Oklahoma City Thunder,0,1,23,29,52,10,26,36,33,55,88,14,5,19,14,44,24,8,19,101,90
2022,2,22201018,3/12/2023,1610612760,Oklahoma City Thunder,0,1,1610612759,San Antonio Spurs,1,0,26,30,56,10,29,39,36,59,95,20,3,23,15,45,26,3,9,101,102
2022,2,22200951,3/3/2023,1610612760,Oklahoma City Thunder,1,1,1610612762,Utah Jazz,0,0,35,26,61,17,26,43,52,52,104,9,5,14,15,39,31,5,7,102,130
2021,2,22100106,11/2/2021,1610612740,New Orleans Pelicans,0,0,1610612756,Phoenix Suns,1,1,23,29,52,13,26,39,36,55,91,15,1,16,18,38,21,8,18,100,100
2021,2,22100106,11/2/2021,1610612756,Phoenix Suns,1,1,1610612740,New Orleans Pelicans,0,0,34,22,56,9,17,26,43,39,82,17,1,18,9,31,32,17,19,99,112
2022,2,22200951,3/3/2023,1610612762,Utah Jazz,0,0,1610612760,Oklahoma City Thunder,1,1,29,20,49,9,20,29,38,40,78,18,5,23,13,30,24,12,26,102,103
2023,2,22300679,1/31/2024,1610612740,New Orleans Pelicans,0,1,1610612745,Houston Rockets,1,0,30,18,48,11,23,34,41,41,82,17,7,24,15,28,20,11,16,95,110
2023,2,22300772,2/13/2024,1610612760,Oklahoma City Thunder,0,1,1610612753,Orlando Magic,1,0,33,19,52,13,19,32,46,38,84,22,2,24,6,34,28,6,12,103,127
2023,2,22300746,2/9/2024,1610612758,Sacramento Kings,1,1,1610612743,Denver Nuggets,0,0,34,19,53,17,17,34,51,36,87,16,2,18,8,29,32,9,16,104,135
2022,2,22201195,4/5/2023,1610612758,Sacramento Kings,0,0,1610612742,Dallas Mavericks,1,1,34,35,69,12,25,37,46,60,106,15,4,19,27,34,31,4,9,98,119
2023,2,22300699,2/3/2024,1610612744,Golden State Warriors,0,0,1610612737,Atlanta Hawks,1,1,32,24,56,18,38,56,50,62,112,16,4,20,19,46,26,5,14,116,134
2023,2,22300752,2/10/2024,1610612753,Orlando Magic,1,1,1610612741,Chicago Bulls,0,0,28,21,49,13,26,39,41,47,88,19,7,26,24,27,23,10,17,95,114
2023,2,22301078,3/31/2024,1610612747,Los Angeles Lakers,0,1,1610612751,Brooklyn Nets,1,0,27,10,37,15,25,40,42,35,77,17,5,22,7,31,24,12,20,101,116
2023,2,22300964,3/15/2024,1610612746,LA Clippers,0,0,1610612740,New Orleans Pelicans,1,1,25,19,44,12,21,33,37,40,77,18,1,19,7,33,18,8,15,93,104
2023,2,22301102,4/3/2024,1610612757,Portland Trail Blazers,0,1,1610612766,Charlotte Hornets,1,0,30,37,67,7,19,26,37,56,93,8,4,12,21,37,19,10,16,95,89
2023,2,22301186,4/14/2024,1610612764,Washington Wizards,0,0,1610612738,Boston Celtics,1,1,35,30,65,14,24,38,49,54,103,10,0,10,14,40,33,10,12,105,122
2023,2,22301027,3/24/2024,1610612765,Detroit Pistons,1,0,1610612740,New Orleans Pelicans,0,1,21,17,38,11,30,41,32,47,79,26,6,32,13,37,20,8,17,97,101
2023,2,22300725,2/6/2024,1610612749,Milwaukee Bucks,0,0,1610612756,Phoenix Suns,1,1,26,24,50,13,27,40,39,51,90,15,10,25,14,42,23,8,13,100,106
2023,2,22300739,2/8/2024,1610612756,Phoenix Suns,1,1,1610612762,Utah Jazz,0,0,38,21,59,14,15,29,52,36,88,11,5,16,6,34,37,7,12,101,129
2023,2,22300725,2/6/2024,1610612756,Phoenix Suns,1,1,1610612749,Milwaukee Bucks,0,0,36,23,59,8,20,28,44,43,87,18,9,27,12,36,17,10,14,99,114
2022,2,22200869,2/14/2023,1610612738,Boston Celtics,0,0,1610612749,Milwaukee Bucks,1,1,29,20,49,17,33,50,46,53,99,16,4,20,9,46,28,6,13,112,125
2021,2,22100105,11/2/2021,1610612758,Sacramento Kings,0,0,1610612762,Utah Jazz,1,1,30,32,62,12,19,31,42,51,93,17,7,24,12,45,24,7,11,105,113
2021,2,22100105,11/2/2021,1610612762,Utah Jazz,1,1,1610612758,Sacramento Kings,0,0,29,21,50,14,34,48,43,55,98,19,8,27,24,34,16,8,17,104,119
2023,2,22300756,2/10/2024,1610612739,Cleveland Cavaliers,0,1,1610612761,Toronto Raptors,1,0,34,17,51,14,27,41,48,44,92,9,4,13,17,29,36,7,11,92,119
2022,2,22200869,2/14/2023,1610612749,Milwaukee Bucks,1,1,1610612738,Boston Celtics,0,0,25,23,48,18,24,42,43,47,90,27,8,35,13,37,29,8,19,112,131
2022,2,22200795,2/4/2023,1610612746,LA Clippers,0,1,1610612752,New York Knicks,1,0,28,27,55,16,21,37,44,48,92,30,5,35,14,38,24,6,13,108,134
2023,2,22300726,2/7/2024,1610612766,Charlotte Hornets,1,0,1610612761,Toronto Raptors,0,1,28,23,51,16,23,39,44,46,90,13,7,20,13,36,27,5,10,96,117
2023,2,22300708,2/4/2024,1610612746,LA Clippers,0,1,1610612748,Miami Heat,1,0,18,20,38,16,23,39,34,43,77,19,3,22,11,34,23,9,17,94,103
2023,2,22300723,2/6/2024,1610612750,Minnesota Timberwolves,0,0,1610612741,Chicago Bulls,1,1,22,25,47,20,25,45,42,50,92,19,7,26,15,38,28,9,14,103,123
2022,2,22200156,11/7/2022,1610612758,Sacramento Kings,0,0,1610612744,Golden State Warriors,1,1,23,28,51,14,26,40,37,54,91,25,4,29,13,44,24,5,11,104,113
2023,2,22300700,2/3/2024,1610612758,Sacramento Kings,0,1,1610612741,Chicago Bulls,1,0,27,18,45,15,24,39,42,42,84,24,5,29,8,37,33,13,17,105,123
2020,2,22000842,4/15/2021,1610612738,Boston Celtics,0,1,1610612747,Los Angeles Lakers,1,0,34,19,53,14,18,32,48,37,85,11,2,13,11,28,33,12,21,100,121
2020,2,22000842,4/15/2021,1610612747,Los Angeles Lakers,1,0,1610612738,Boston Celtics,0,1,32,29,61,12,25,37,44,54,98,13,6,19,14,45,28,4,8,100,113
2023,2,22301027,3/24/2024,1610612740,New Orleans Pelicans,0,1,1610612765,Detroit Pistons,1,0,30,17,47,11,23,34,41,40,81,21,10,31,9,37,27,4,10,97,114
2023,2,22301038,3/25/2024,1610612757,Portland Trail Blazers,0,0,1610612745,Houston Rockets,1,1,29,25,54,7,26,33,36,51,87,13,2,15,15,38,14,7,17,99,92
2023,2,22300632,1/25/2024,1610612744,Golden State Warriors,1,0,1610612758,Sacramento Kings,0,1,29,20,49,19,18,37,48,38,86,18,5,23,11,29,30,8,13,96,133
2023,2,22300459,1/2/2024,1610612741,Chicago Bulls,0,0,1610612755,Philadelphia 76ers,1,1,30,29,59,7,30,37,37,59,96,16,7,23,24,38,17,9,18,102,97
2022,2,22200111,11/2/2022,1610612741,Chicago Bulls,1,1,1610612766,Charlotte Hornets,0,0,24,33,57,14,17,31,38,50,88,16,2,18,15,36,28,12,20,101,106
2022,2,22200092,10/30/2022,1610612750,Minnesota Timberwolves,0,0,1610612759,San Antonio Spurs,1,1,36,34,70,4,25,29,40,59,99,14,6,20,22,41,21,6,11,100,98
2023,2,22300681,1/31/2024,1610612759,San Antonio Spurs,1,0,1610612753,Orlando Magic,0,1,27,22,49,9,22,31,36,44,80,17,7,24,10,38,24,10,19,101,98
2022,2,22200092,10/30/2022,1610612759,San Antonio Spurs,1,1,1610612750,Minnesota Timberwolves,0,0,20,26,46,16,24,40,36,50,86,19,6,25,19,33,27,11,20,99,107
2022,2,22201194,4/5/2023,1610612763,Memphis Grizzlies,0,0,1610612740,New Orleans Pelicans,1,1,38,30,68,12,24,36,50,54,104,19,6,25,19,39,33,9,14,110,131
2023,2,22300710,2/4/2024,1610612761,Toronto Raptors,0,0,1610612760,Oklahoma City Thunder,1,1,34,32,66,14,21,35,48,53,101,17,4,21,19,35,38,6,12,107,127
2023,2,22300967,3/16/2024,1610612739,Cleveland Cavaliers,0,0,1610612745,Houston Rockets,1,1,25,19,44,12,26,38,37,45,82,17,3,20,8,39,22,9,16,99,103
2023,2,22301080,3/31/2024,1610612761,Toronto Raptors,1,0,1610612755,Philadelphia 76ers,0,1,36,24,60,11,19,30,47,43,90,15,5,20,15,31,31,6,12,96,120
2023,2,22300961,3/15/2024,1610612766,Charlotte Hornets,1,0,1610612756,Phoenix Suns,0,1,29,28,57,6,31,37,35,59,94,20,7,27,17,47,20,3,5,95,96
2023,2,22300726,2/7/2024,1610612761,Toronto Raptors,0,1,1610612766,Charlotte Hornets,1,0,26,22,48,17,16,33,43,38,81,20,4,24,9,30,30,6,11,95,123
2023,2,22300722,2/6/2024,1610612752,New York Knicks,1,1,1610612763,Memphis Grizzlies,0,0,37,22,59,11,16,27,48,38,86,16,4,20,10,29,28,4,10,95,123
2023,2,22300739,2/8/2024,1610612762,Utah Jazz,0,0,1610612756,Phoenix Suns,1,1,29,30,59,12,23,35,41,53,94,21,10,31,23,35,28,10,15,101,115
2023,2,22301047,3/26/2024,1610612742,Dallas Mavericks,0,1,1610612758,Sacramento Kings,1,0,29,24,53,22,17,39,51,41,92,8,5,13,7,35,34,6,9,101,132
2023,2,22300954,3/13/2024,1610612747,Los Angeles Lakers,0,0,1610612758,Sacramento Kings,1,1,24,22,46,14,18,32,38,40,78,17,5,22,7,35,25,11,14,94,107
2023,2,22300974,3/16/2024,1610612762,Utah Jazz,1,0,1610612750,Minnesota Timberwolves,0,1,32,25,57,6,20,26,38,45,83,18,3,21,10,37,23,8,16,98,100
2023,2,22301007,3/21/2024,1610612749,Milwaukee Bucks,1,1,1610612751,Brooklyn Nets,0,0,27,23,50,16,25,41,43,48,91,13,2,15,12,37,27,7,10,95,115
2023,2,22300970,3/16/2024,1610612757,Portland Trail Blazers,0,0,1610612740,New Orleans Pelicans,1,1,30,21,51,12,21,33,42,42,84,11,1,12,13,30,23,8,20,96,107
2023,2,22301023,3/23/2024,1610612738,Boston Celtics,0,1,1610612741,Chicago Bulls,1,0,23,15,38,21,27,48,44,42,86,15,2,17,16,27,28,7,12,90,124
2023,2,22301037,3/25/2024,1610612764,Washington Wizards,0,1,1610612741,Chicago Bulls,1,0,25,23,48,14,35,49,39,58,97,15,3,18,20,40,32,9,14,99,107
2023,2,22301134,4/7/2024,1610612738,Boston Celtics,1,1,1610612757,Portland Trail Blazers,0,0,33,16,49,16,22,38,49,38,87,10,3,13,7,33,34,8,13,100,124
2023,2,22301084,3/31/2024,1610612750,Minnesota Timberwolves,1,0,1610612741,Chicago Bulls,0,1,27,17,44,11,26,37,38,43,81,14,7,21,11,36,28,11,14,93,101
2023,2,22301055,3/27/2024,1610612763,Memphis Grizzlies,1,0,1610612747,Los Angeles Lakers,0,1,29,25,54,17,26,43,46,51,97,15,4,19,13,40,30,5,14,105,124
2023,2,22301054,3/27/2024,1610612741,Chicago Bulls,1,1,1610612754,Indiana Pacers,0,0,37,34,71,12,15,27,49,49,98,15,3,18,19,30,28,3,8,96,125
2023,2,22300722,2/6/2024,1610612763,Memphis Grizzlies,0,0,1610612752,New York Knicks,1,1,20,23,43,21,16,37,41,39,80,10,6,16,12,30,33,12,18,94,113
2023,2,22300691,2/2/2024,1610612758,Sacramento Kings,0,1,1610612754,Indiana Pacers,1,0,38,18,56,13,21,34,51,39,90,18,10,28,13,31,26,13,17,109,133
2022,2,22201195,4/5/2023,1610612742,Dallas Mavericks,1,1,1610612758,Sacramento Kings,0,0,24,21,45,20,24,44,44,45,89,15,3,18,10,36,24,7,10,98,123
2023,2,22300706,2/4/2024,1610612763,Memphis Grizzlies,0,0,1610612738,Boston Celtics,1,1,24,30,54,11,27,38,35,57,92,10,2,12,17,41,19,12,20,100,91
2023,2,22300674,1/31/2024,1610612766,Charlotte Hornets,1,0,1610612741,Chicago Bulls,0,1,24,20,44,16,30,46,40,50,90,14,3,17,13,38,25,4,10,94,110
2021,2,22100104,11/2/2021,1610612742,Dallas Mavericks,1,0,1610612748,Miami Heat,0,1,23,19,42,14,28,42,37,47,84,22,9,31,14,39,17,6,10,94,110
2021,2,22100104,11/2/2021,1610612748,Miami Heat,0,1,1610612742,Dallas Mavericks,1,0,30,28,58,13,12,25,43,40,83,26,4,30,11,32,25,1,7,93,125
2023,2,22300308,12/12/2023,1610612744,Golden State Warriors,0,0,1610612756,Phoenix Suns,1,1,25,21,46,16,30,46,41,51,92,18,9,27,17,39,26,8,15,101,116
2023,2,22300308,12/12/2023,1610612756,Phoenix Suns,1,1,1610612744,Golden State Warriors,0,0,24,21,45,14,25,39,38,46,84,29,5,34,11,38,27,9,15,102,119
2023,2,22300719,2/6/2024,1610612754,Indiana Pacers,1,1,1610612745,Houston Rockets,0,0,39,15,54,15,17,32,54,32,86,9,5,14,6,30,35,5,12,98,132
2023,2,22300752,2/10/2024,1610612741,Chicago Bulls,0,0,1610612753,Orlando Magic,1,1,31,31,62,12,25,37,43,56,99,10,4,14,20,37,21,4,8,93,108
2023,2,22300790,2/15/2024,1610612763,Memphis Grizzlies,1,1,1610612749,Milwaukee Bucks,0,0,31,26,57,13,13,26,44,39,83,12,7,19,8,35,30,10,16,98,113
2023,2,22300962,3/15/2024,1610612765,Detroit Pistons,1,0,1610612748,Miami Heat,0,1,26,20,46,10,28,38,36,48,84,13,2,15,12,36,27,14,18,97,95
2020,2,22000841,4/15/2021,1610612739,Cleveland Cavaliers,1,0,1610612744,Golden State Warriors,0,1,25,25,50,10,21,31,35,46,81,21,6,27,9,39,21,9,15,99,101
2020,2,22000841,4/15/2021,1610612744,Golden State Warriors,0,1,1610612739,Cleveland Cavaliers,1,0,30,16,46,17,29,46,47,45,92,8,2,10,14,33,33,11,16,99,119
2023,2,22301022,3/23/2024,1610612764,Washington Wizards,1,1,1610612761,Toronto Raptors,0,0,33,24,57,11,24,35,44,48,92,13,6,19,18,31,28,9,18,100,112
2023,2,22301005,3/21/2024,1610612764,Washington Wizards,1,1,1610612758,Sacramento Kings,0,0,31,25,56,10,15,25,41,40,81,17,6,23,13,30,20,12,20,97,109
2023,2,22300974,3/16/2024,1610612750,Minnesota Timberwolves,0,1,1610612762,Utah Jazz,1,0,25,27,52,19,22,41,44,49,93,12,3,15,7,44,31,4,9,100,119
2023,2,22300976,3/17/2024,1610612749,Milwaukee Bucks,1,1,1610612756,Phoenix Suns,0,0,27,26,53,24,17,41,51,43,94,14,0,14,10,33,35,7,11,101,140
2023,2,22301080,3/31/2024,1610612755,Philadelphia 76ers,0,1,1610612761,Toronto Raptors,1,0,25,15,40,24,19,43,49,34,83,13,3,16,10,26,28,10,16,97,135
2022,2,22201194,4/5/2023,1610612740,New Orleans Pelicans,1,1,1610612763,Memphis Grizzlies,0,0,23,26,49,21,18,39,44,44,88,29,10,39,13,37,35,10,16,108,138
2023,2,22300720,2/6/2024,1610612751,Brooklyn Nets,1,0,1610612742,Dallas Mavericks,0,1,29,29,58,12,21,33,41,50,91,13,2,15,9,41,33,7,10,98,107
2023,2,22300680,1/31/2024,1610612750,Minnesota Timberwolves,1,1,1610612742,Dallas Mavericks,0,0,32,18,50,13,17,30,45,35,80,18,12,30,12,27,31,4,10,92,121
2023,2,22300815,2/24/2024,1610612750,Minnesota Timberwolves,1,1,1610612751,Brooklyn Nets,0,0,24,22,46,12,26,38,36,48,84,17,6,23,10,42,22,7,13,99,101
2023,2,22300815,2/24/2024,1610612751,Brooklyn Nets,0,0,1610612750,Minnesota Timberwolves,1,1,29,40,69,6,29,35,35,69,104,10,1,11,20,49,20,6,11,100,86
2023,2,22300943,3/12/2024,1610612738,Boston Celtics,0,1,1610612762,Utah Jazz,1,0,23,20,43,20,29,49,43,49,92,17,2,19,18,32,25,4,9,91,123
2023,2,22301025,3/23/2024,1610612759,San Antonio Spurs,1,0,1610612756,Phoenix Suns,0,1,31,21,52,9,24,33,40,45,85,17,4,21,12,33,27,11,15,98,106
2023,2,22300867,3/2/2024,1610612762,Utah Jazz,0,0,1610612748,Miami Heat,1,1,28,24,52,14,21,35,42,45,87,22,4,26,16,30,24,6,11,95,120
2023,2,22300976,3/17/2024,1610612756,Phoenix Suns,0,0,1610612749,Milwaukee Bucks,1,1,37,17,54,14,19,33,51,36,87,13,2,15,8,28,36,11,14,100,129
2023,2,22300690,2/2/2024,1610612737,Atlanta Hawks,1,1,1610612756,Phoenix Suns,0,0,32,19,51,17,27,44,49,46,95,14,4,18,14,32,29,6,10,100,129
2023,2,22301005,3/21/2024,1610612758,Sacramento Kings,0,0,1610612764,Washington Wizards,1,1,26,21,47,11,28,39,37,49,86,17,2,19,13,38,21,9,15,98,102
2023,2,22301045,3/26/2024,1610612747,Los Angeles Lakers,0,1,1610612749,Milwaukee Bucks,1,0,28,36,64,14,30,44,42,66,108,30,2,32,20,47,30,9,17,122,128
2023,2,22301082,3/31/2024,1610612760,Oklahoma City Thunder,0,1,1610612752,New York Knicks,1,0,31,17,48,13,21,34,44,38,82,12,12,24,12,32,29,8,13,95,113
2023,2,22300729,2/7/2024,1610612738,Boston Celtics,1,1,1610612737,Atlanta Hawks,0,0,32,12,44,17,32,49,49,44,93,10,1,11,7,37,33,8,14,104,125
2023,2,22300576,2/15/2024,1610612762,Utah Jazz,1,0,1610612744,Golden State Warriors,0,1,21,23,44,22,27,49,43,50,93,29,3,32,22,28,33,8,16,103,137
2023,2,22301078,3/31/2024,1610612751,Brooklyn Nets,1,0,1610612747,Los Angeles Lakers,0,1,27,29,56,12,24,36,39,53,92,14,5,19,12,45,19,8,13,102,104
2023,2,22300942,3/12/2024,1610612759,San Antonio Spurs,1,0,1610612745,Houston Rockets,0,1,28,18,46,11,25,36,39,43,82,12,2,14,12,33,30,10,15,91,101
2023,2,22301049,3/27/2024,1610612744,Golden State Warriors,0,1,1610612753,Orlando Magic,1,0,30,26,56,10,24,34,40,50,90,11,2,13,18,32,26,10,13,92,101
2023,2,22301056,3/27/2024,1610612765,Detroit Pistons,0,0,1610612750,Minnesota Timberwolves,1,1,22,27,49,9,23,32,31,50,81,20,5,25,16,35,15,8,12,91,91
2023,2,22301040,3/25/2024,1610612763,Memphis Grizzlies,0,0,1610612743,Denver Nuggets,1,1,26,24,50,11,33,44,37,57,94,18,9,27,24,38,25,10,17,99,103
2023,2,22301085,3/31/2024,1610612759,San Antonio Spurs,1,0,1610612744,Golden State Warriors,0,1,23,23,46,17,26,43,40,49,89,16,2,18,18,33,31,15,19,99,113
2023,2,22301086,3/31/2024,1610612758,Sacramento Kings,1,1,1610612762,Utah Jazz,0,0,25,19,44,20,20,40,45,39,84,17,6,23,18,24,34,6,15,93,127
2023,2,22301103,4/3/2024,1610612747,Los Angeles Lakers,0,1,1610612764,Washington Wizards,1,0,38,25,63,8,20,28,46,45,91,25,4,29,13,35,21,11,17,107,125
2023,2,22301133,4/7/2024,1610612748,Miami Heat,0,0,1610612754,Indiana Pacers,1,1,31,26,57,8,19,27,39,45,84,29,3,32,9,37,21,4,7,94,115
2023,2,22300978,3/17/2024,1610612742,Dallas Mavericks,1,1,1610612743,Denver Nuggets,0,0,33,32,65,9,26,35,42,58,100,14,7,21,27,36,22,7,12,96,107
2023,2,22300742,2/9/2024,1610612755,Philadelphia 76ers,1,0,1610612737,Atlanta Hawks,0,1,27,26,53,15,30,45,42,56,98,22,7,29,24,35,24,4,10,98,121
2023,2,22300691,2/2/2024,1610612754,Indiana Pacers,1,0,1610612758,Sacramento Kings,0,1,36,20,56,10,19,29,46,39,85,20,4,24,10,31,23,15,22,108,122
2023,2,22300729,2/7/2024,1610612737,Atlanta Hawks,0,0,1610612738,Boston Celtics,1,1,30,31,61,13,28,41,43,59,102,18,2,20,17,42,24,6,9,105,117
2023,2,22301086,3/31/2024,1610612762,Utah Jazz,0,0,1610612758,Sacramento Kings,1,1,18,24,42,16,25,41,34,49,83,22,6,28,15,35,22,8,12,92,106
2023,2,22301092,4/1/2024,1610612756,Phoenix Suns,0,1,1610612740,New Orleans Pelicans,1,0,25,15,40,18,29,47,43,44,87,20,5,25,20,26,29,10,14,94,124
2023,2,22300721,2/6/2024,1610612748,Miami Heat,1,1,1610612753,Orlando Magic,0,0,34,17,51,13,23,36,47,40,87,14,4,18,13,31,31,7,13,96,121
2023,2,22301183,4/12/2024,1610612757,Portland Trail Blazers,1,0,1610612745,Houston Rockets,0,1,25,35,60,12,23,35,37,58,95,21,8,29,19,40,20,3,7,97,107
2023,2,22300766,2/12/2024,1610612740,New Orleans Pelicans,0,1,1610612763,Memphis Grizzlies,1,0,19,24,43,13,22,35,32,46,78,19,5,24,14,33,21,7,19,95,96
2023,2,22301056,3/27/2024,1610612750,Minnesota Timberwolves,1,1,1610612765,Detroit Pistons,0,0,31,15,46,11,25,36,42,40,82,11,5,16,10,33,28,9,12,90,106
2023,2,22301001,3/20/2024,1610612763,Memphis Grizzlies,0,0,1610612744,Golden State Warriors,1,1,24,23,47,18,31,49,42,54,96,14,4,18,21,36,29,6,12,94,116
2023,2,22301091,4/1/2024,1610612741,Chicago Bulls,1,0,1610612737,Atlanta Hawks,0,1,30,36,66,7,21,28,37,57,94,20,4,24,20,40,17,4,8,96,101
2023,2,22301097,4/5/2024,1610612742,Dallas Mavericks,1,1,1610612744,Golden State Warriors,0,0,28,22,50,12,22,34,40,44,84,16,5,21,10,35,30,12,18,101,108
2023,2,22300978,3/17/2024,1610612743,Denver Nuggets,0,0,1610612742,Dallas Mavericks,1,1,25,31,56,12,16,28,37,47,84,19,3,22,9,38,26,5,8,94,105
2023,2,22300943,3/12/2024,1610612762,Utah Jazz,1,0,1610612738,Boston Celtics,0,1,26,28,54,15,17,32,41,45,86,10,1,11,12,34,23,5,10,90,107
2023,2,22300727,2/7/2024,1610612744,Golden State Warriors,0,1,1610612755,Philadelphia 76ers,1,0,31,25,56,16,22,38,47,47,94,17,5,22,16,33,30,7,13,103,127
2023,2,22300727,2/7/2024,1610612755,Philadelphia 76ers,1,0,1610612744,Golden State Warriors,0,1,33,33,66,8,24,32,41,57,98,14,0,14,17,40,21,7,15,102,104
2023,2,22300690,2/2/2024,1610612756,Phoenix Suns,0,0,1610612737,Atlanta Hawks,1,1,33,18,51,14,23,37,47,41,88,12,2,14,9,34,31,7,17,101,120
2023,2,22300676,1/31/2024,1610612746,LA Clippers,0,1,1610612764,Washington Wizards,1,0,35,35,70,12,18,30,47,53,100,19,3,22,19,36,25,4,8,98,125
2016,2,21601068,3/23/2017,1610612748,Miami Heat,1,0,1610612761,Toronto Raptors,0,1,26,33,59,6,17,23,32,50,82,14,9,23,15,43,20,9,17,94,84
2016,2,21601068,3/23/2017,1610612761,Toronto Raptors,0,1,1610612748,Miami Heat,1,0,29,27,56,6,17,23,35,44,79,25,7,32,20,28,10,8,18,94,101
2023,2,22300763,2/12/2024,1610612741,Chicago Bulls,0,1,1610612737,Atlanta Hawks,1,0,38,26,64,13,15,28,51,41,92,21,8,29,8,36,29,4,6,104,136
2023,2,22300724,2/6/2024,1610612760,Oklahoma City Thunder,0,0,1610612762,Utah Jazz,1,1,24,29,53,19,18,37,43,47,90,12,6,18,12,38,26,9,11,97,117
2023,2,22300969,3/16/2024,1610612766,Charlotte Hornets,0,0,1610612755,Philadelphia 76ers,1,1,27,24,51,10,21,31,37,45,82,14,4,18,14,33,21,9,17,92,98
2020,2,22000840,4/15/2021,1610612737,Atlanta Hawks,1,0,1610612749,Milwaukee Bucks,0,1,25,27,52,14,20,34,39,47,86,17,2,19,10,38,23,8,12,96,109
2020,2,22000840,4/15/2021,1610612749,Milwaukee Bucks,0,1,1610612737,Atlanta Hawks,1,0,30,22,52,16,27,43,46,49,95,12,5,17,17,35,25,5,9,96,120
2023,2,22300750,2/10/2024,1610612751,Brooklyn Nets,1,1,1610612759,San Antonio Spurs,0,0,32,21,53,17,17,34,49,38,87,8,3,11,11,28,31,5,12,94,123
2023,2,22300859,3/1/2024,1610612742,Dallas Mavericks,0,0,1610612738,Boston Celtics,1,1,35,25,60,9,25,34,44,50,94,13,5,18,12,41,20,4,8,98,110
2023,2,22301103,4/3/2024,1610612764,Washington Wizards,1,0,1610612747,Los Angeles Lakers,0,1,27,22,49,18,24,42,45,46,91,12,1,13,7,40,26,10,18,107,120
2023,2,22301188,4/14/2024,1610612754,Indiana Pacers,1,1,1610612737,Atlanta Hawks,0,0,46,18,64,19,17,36,65,35,100,8,2,10,12,24,41,6,16,106,157
2023,2,22300942,3/12/2024,1610612745,Houston Rockets,0,1,1610612759,San Antonio Spurs,1,0,27,21,48,10,22,32,37,43,80,19,2,21,12,32,21,9,13,92,103
2023,2,22300744,2/9/2024,1610612745,Houston Rockets,0,0,1610612761,Toronto Raptors,1,1,23,24,47,15,23,38,38,47,85,13,3,16,20,28,22,14,22,97,104
2023,2,22300674,1/31/2024,1610612741,Chicago Bulls,0,1,1610612766,Charlotte Hornets,1,0,34,24,58,11,18,29,45,42,87,16,6,22,13,32,28,4,10,93,117
2023,2,22300751,2/10/2024,1610612763,Memphis Grizzlies,0,0,1610612766,Charlotte Hornets,1,1,27,21,48,16,28,44,43,49,92,4,4,8,10,41,33,8,12,97,106
2021,2,22100103,11/2/2021,1610612749,Milwaukee Bucks,0,1,1610612765,Detroit Pistons,1,0,25,22,47,17,20,37,42,42,84,16,5,21,13,31,28,5,17,98,117
2021,2,22100103,11/2/2021,1610612765,Detroit Pistons,1,0,1610612749,Milwaukee Bucks,0,1,22,24,46,8,39,47,30,63,93,21,9,30,20,48,21,7,14,99,89
2023,2,22300765,2/12/2024,1610612745,Houston Rockets,1,1,1610612752,New York Knicks,0,0,26,28,54,10,16,26,36,44,80,23,10,33,15,34,22,4,12,92,105
2023,2,22300724,2/6/2024,1610612762,Utah Jazz,1,1,1610612760,Oklahoma City Thunder,0,0,32,22,54,14,21,35,46,43,89,18,2,20,19,25,29,9,17,97,124
2023,2,22300730,2/7/2024,1610612748,Miami Heat,1,1,1610612759,San Antonio Spurs,0,0,31,18,49,12,26,38,43,44,87,18,5,23,7,40,29,6,11,101,116
2023,2,22301019,3/23/2024,1610612751,Brooklyn Nets,0,0,1610612752,New York Knicks,1,1,22,20,42,12,22,34,34,42,76,13,2,15,8,35,26,10,15,90,93
2023,2,22301133,4/7/2024,1610612754,Indiana Pacers,1,1,1610612748,Miami Heat,0,0,35,19,54,9,23,32,44,42,86,20,1,21,9,34,27,3,7,94,117
2023,2,22300907,3/7/2024,1610612741,Chicago Bulls,0,1,1610612744,Golden State Warriors,1,0,30,21,51,16,20,36,46,41,87,17,6,23,8,36,29,8,14,102,125
2023,2,22300907,3/7/2024,1610612744,Golden State Warriors,1,0,1610612741,Chicago Bulls,0,1,33,22,55,11,31,42,44,53,97,23,5,28,20,35,31,6,11,103,122
2023,2,22300906,3/7/2024,1610612738,Boston Celtics,0,0,1610612743,Denver Nuggets,1,1,30,23,53,11,27,38,41,50,91,16,9,25,16,39,24,10,12,97,109
2023,2,22300908,3/7/2024,1610612759,San Antonio Spurs,0,0,1610612758,Sacramento Kings,1,1,30,27,57,16,18,34,46,45,91,21,0,21,11,34,39,8,12,101,129
2020,2,22000839,4/14/2021,1610612758,Sacramento Kings,1,0,1610612764,Washington Wizards,0,1,33,31,64,9,18,27,42,49,91,18,6,24,9,43,22,12,17,111,111
2020,2,22000839,4/14/2021,1610612764,Washington Wizards,0,1,1610612758,Sacramento Kings,1,0,40,26,66,7,17,24,47,43,90,22,5,27,18,27,23,17,26,111,123
2023,2,22300969,3/16/2024,1610612755,Philadelphia 76ers,1,1,1610612766,Charlotte Hornets,0,0,23,17,40,13,28,41,36,45,81,24,1,25,14,32,25,11,15,93,109
2023,2,22300906,3/7/2024,1610612743,Denver Nuggets,1,1,1610612738,Boston Celtics,0,0,41,28,69,4,17,21,45,45,90,21,1,22,10,36,27,6,8,97,115
2023,2,22301043,3/25/2024,1610612746,LA Clippers,1,0,1610612754,Indiana Pacers,0,1,40,25,65,6,14,20,46,39,85,18,4,22,13,29,26,7,10,93,116
2023,2,22300977,3/17/2024,1610612748,Miami Heat,0,1,1610612765,Detroit Pistons,1,0,28,26,54,12,23,35,40,49,89,12,4,16,13,38,24,4,10,93,104
2023,2,22300944,3/12/2024,1610612750,Minnesota Timberwolves,0,1,1610612746,LA Clippers,1,0,36,25,61,12,21,33,48,46,94,10,4,14,21,28,26,7,11,90,118
2023,2,22301057,3/27/2024,1610612745,Houston Rockets,0,1,1610612760,Oklahoma City Thunder,1,0,35,26,61,15,28,43,50,54,104,17,6,23,18,40,25,7,16,111,132
2023,2,22301059,3/27/2024,1610612756,Phoenix Suns,0,1,1610612743,Denver Nuggets,1,0,23,27,50,16,17,33,39,44,83,10,1,11,14,30,29,9,17,90,104
2023,2,22301077,3/31/2024,1610612739,Cleveland Cavaliers,0,0,1610612743,Denver Nuggets,1,1,30,27,57,8,17,25,38,44,82,17,4,21,7,41,26,7,15,97,101
2023,2,22300751,2/10/2024,1610612766,Charlotte Hornets,1,1,1610612763,Memphis Grizzlies,0,0,31,20,51,16,15,31,47,35,82,5,2,7,9,26,30,12,19,97,115
2022,2,22201196,4/5/2023,1610612746,LA Clippers,1,1,1610612747,Los Angeles Lakers,0,0,27,19,46,16,20,36,43,39,82,23,4,27,5,36,23,4,13,102,125
2023,2,22300679,1/31/2024,1610612745,Houston Rockets,1,0,1610612740,New Orleans Pelicans,0,1,22,21,43,13,31,44,35,52,87,16,1,17,6,47,19,3,5,94,99
2023,2,22300730,2/7/2024,1610612759,San Antonio Spurs,0,0,1610612748,Miami Heat,1,1,29,24,53,12,25,37,41,49,90,10,7,17,10,41,30,8,15,101,104
2023,2,22300908,3/7/2024,1610612758,Sacramento Kings,1,1,1610612759,San Antonio Spurs,0,0,42,28,70,10,22,32,52,50,102,17,1,18,21,29,31,8,13,102,131
2023,2,22300859,3/1/2024,1610612738,Boston Celtics,1,1,1610612742,Dallas Mavericks,0,0,31,20,51,21,22,43,52,42,94,13,0,13,10,32,33,4,9,99,138
2023,2,22301102,4/3/2024,1610612766,Charlotte Hornets,1,0,1610612757,Portland Trail Blazers,0,1,27,20,47,5,26,31,32,46,78,17,5,22,6,41,22,4,11,95,86
2023,2,22301104,4/3/2024,1610612765,Detroit Pistons,0,0,1610612737,Atlanta Hawks,1,1,33,31,64,10,20,30,43,51,94,17,4,21,10,43,24,9,10,103,113
2023,2,22301092,4/1/2024,1610612740,New Orleans Pelicans,1,0,1610612756,Phoenix Suns,0,1,31,31,62,11,16,27,42,47,89,16,8,24,15,37,29,7,9,92,111
2023,2,22301182,4/12/2024,1610612744,Golden State Warriors,1,0,1610612740,New Orleans Pelicans,0,1,27,25,52,13,21,34,40,46,86,16,5,21,12,37,27,11,16,100,109
2023,2,22300939,3/12/2024,1610612752,New York Knicks,1,1,1610612755,Philadelphia 76ers,0,0,26,13,39,14,26,40,40,39,79,12,3,15,13,28,32,7,13,86,106
2023,2,22301019,3/23/2024,1610612752,New York Knicks,1,1,1610612751,Brooklyn Nets,0,0,27,30,57,15,25,40,42,55,97,6,6,12,23,37,25,5,10,88,105
2023,2,22300944,3/12/2024,1610612746,LA Clippers,1,0,1610612750,Minnesota Timberwolves,0,1,23,19,42,11,19,30,34,38,72,21,4,25,10,30,22,11,18,91,100
2023,2,22300977,3/17/2024,1610612765,Detroit Pistons,1,0,1610612748,Miami Heat,0,1,24,23,47,14,22,36,38,45,83,11,3,14,8,38,24,7,12,93,101
2023,2,22301077,3/31/2024,1610612743,Denver Nuggets,1,1,1610612739,Cleveland Cavaliers,0,0,29,25,54,21,12,33,50,37,87,9,4,13,15,24,36,10,17,97,130
2022,2,22201196,4/5/2023,1610612747,Los Angeles Lakers,0,0,1610612746,LA Clippers,1,1,33,27,60,12,17,29,45,44,89,16,8,24,11,35,27,9,14,103,118
2023,2,22300945,3/12/2024,1610612749,Milwaukee Bucks,0,0,1610612758,Sacramento Kings,1,1,23,20,43,7,32,39,30,52,82,27,8,35,11,46,23,11,13,100,94
2014,2,21401173,4/9/2015,1610612741,Chicago Bulls,0,1,1610612748,Miami Heat,1,0,29,39,68,6,17,23,35,56,91,13,4,17,21,37,17,2,11,90,89
2014,2,21401173,4/9/2015,1610612748,Miami Heat,1,0,1610612741,Chicago Bulls,0,1,29,41,70,5,13,18,34,54,88,5,2,7,15,40,14,10,14,91,78
2023,2,22301028,3/24/2024,1610612755,Philadelphia 76ers,0,1,1610612746,LA Clippers,1,0,30,23,53,18,19,37,48,42,90,7,2,9,14,29,32,2,8,89,121
2019,2,21900238,11/24/2019,1610612743,Denver Nuggets,1,1,1610612756,Phoenix Suns,0,0,29,31,60,14,17,31,43,48,91,16,7,23,20,31,24,4,11,92,116
2019,2,21900238,11/24/2019,1610612756,Phoenix Suns,0,0,1610612743,Denver Nuggets,1,1,29,18,47,12,23,35,41,41,82,10,2,12,8,33,25,4,12,92,104
2023,2,22300939,3/12/2024,1610612755,Philadelphia 76ers,0,0,1610612752,New York Knicks,1,1,22,25,47,8,25,33,30,50,80,11,5,16,10,44,17,4,8,86,79
2019,2,21900020,10/25/2019,1610612741,Chicago Bulls,0,1,1610612763,Memphis Grizzlies,1,0,28,23,51,12,30,42,40,53,93,18,6,24,14,42,18,8,14,105,110
2019,2,21900020,10/25/2019,1610612763,Memphis Grizzlies,1,0,1610612741,Chicago Bulls,0,1,29,36,65,10,19,29,39,55,94,14,6,20,18,40,24,14,18,105,102
2023,2,22301106,4/3/2024,1610612754,Indiana Pacers,0,0,1610612751,Brooklyn Nets,1,1,36,29,65,10,28,38,46,57,103,9,2,11,20,38,27,4,9,96,111
2022,2,22201197,4/6/2023,1610612753,Orlando Magic,1,0,1610612739,Cleveland Cavaliers,0,1,20,24,44,13,26,39,33,50,83,15,4,19,15,35,21,13,22,99,94
2023,2,22300851,2/29/2024,1610612751,Brooklyn Nets,1,1,1610612737,Atlanta Hawks,0,0,24,20,44,22,24,46,46,44,90,10,3,13,15,32,30,3,10,92,124
2023,2,22301091,4/1/2024,1610612737,Atlanta Hawks,0,1,1610612741,Chicago Bulls,1,0,22,20,42,19,21,40,41,41,82,12,6,18,9,36,29,8,15,96,113
2020,2,22000838,4/14/2021,1610612743,Denver Nuggets,1,1,1610612748,Miami Heat,0,0,31,22,53,17,19,36,48,41,89,10,3,13,16,26,32,7,11,90,123
2020,2,22000838,4/14/2021,1610612748,Miami Heat,0,0,1610612743,Denver Nuggets,1,1,26,21,47,13,19,32,39,40,79,15,3,18,6,36,29,5,8,89,106
2023,2,22301182,4/12/2024,1610612740,New Orleans Pelicans,0,1,1610612744,Golden State Warriors,1,0,22,30,52,20,18,38,42,48,90,10,6,16,6,44,24,6,9,99,114
2023,2,22300743,2/9/2024,1610612764,Washington Wizards,0,0,1610612738,Boston Celtics,1,1,25,23,48,20,27,47,45,50,95,19,2,21,7,44,32,9,12,109,129
2023,2,22300851,2/29/2024,1610612737,Atlanta Hawks,0,0,1610612751,Brooklyn Nets,1,1,29,29,58,8,20,28,37,49,86,15,6,21,16,38,18,6,14,93,97
2023,2,22301004,3/21/2024,1610612740,New Orleans Pelicans,0,0,1610612753,Orlando Magic,1,1,36,22,58,6,14,20,42,36,78,16,5,21,7,32,24,12,19,100,106
2023,2,22301025,3/23/2024,1610612756,Phoenix Suns,0,1,1610612759,San Antonio Spurs,1,0,45,25,70,11,13,24,56,38,94,8,2,10,11,28,38,6,10,97,131
2023,2,22301139,4/7/2024,1610612752,New York Knicks,0,1,1610612749,Milwaukee Bucks,1,0,31,32,63,14,15,29,45,47,92,18,4,22,16,32,25,3,7,91,122
2023,2,22300924,3/10/2024,1610612746,LA Clippers,1,0,1610612749,Milwaukee Bucks,0,1,33,24,57,14,33,47,47,57,104,9,1,10,21,36,30,5,10,99,117
2023,2,22300753,2/10/2024,1610612764,Washington Wizards,1,0,1610612755,Philadelphia 76ers,0,1,29,22,51,13,22,35,42,44,86,16,5,21,9,36,28,8,17,104,113
2023,2,22301134,4/7/2024,1610612757,Portland Trail Blazers,0,0,1610612738,Boston Celtics,1,1,26,38,64,14,24,38,40,62,102,13,0,13,25,37,26,11,15,98,107
2023,2,22300945,3/12/2024,1610612758,Sacramento Kings,1,1,1610612749,Milwaukee Bucks,0,0,31,21,52,18,22,40,49,43,92,13,3,16,8,37,34,3,9,101,129
2023,2,22301105,4/3/2024,1610612760,Oklahoma City Thunder,0,0,1610612738,Boston Celtics,1,1,30,27,57,5,19,24,35,46,81,25,3,28,12,36,21,7,14,97,100
2023,2,22301184,4/12/2024,1610612746,LA Clippers,1,0,1610612762,Utah Jazz,0,1,33,24,57,10,29,39,43,53,96,13,6,19,22,33,23,7,13,96,109
2023,2,22301041,3/25/2024,1610612742,Dallas Mavericks,0,1,1610612762,Utah Jazz,1,0,32,18,50,12,30,42,44,48,92,15,3,18,11,38,31,6,6,95,115
2023,2,22300756,2/10/2024,1610612761,Toronto Raptors,1,0,1610612739,Cleveland Cavaliers,0,1,26,30,56,9,22,31,35,52,87,16,7,23,17,37,22,5,11,92,95
2023,2,22300757,2/10/2024,1610612744,Golden State Warriors,1,1,1610612756,Phoenix Suns,0,0,28,32,60,17,24,41,45,56,101,6,5,11,18,40,33,9,14,104,113
2023,2,22300767,2/12/2024,1610612743,Denver Nuggets,0,0,1610612749,Milwaukee Bucks,1,1,25,29,54,11,29,40,36,58,94,12,5,17,17,42,24,8,13,97,95
2023,2,22300899,3/6/2024,1610612749,Milwaukee Bucks,0,0,1610612744,Golden State Warriors,1,1,23,27,50,11,28,39,34,55,89,11,4,15,11,45,19,10,15,100,90
2023,2,22301009,3/21/2024,1610612743,Denver Nuggets,1,1,1610612752,New York Knicks,0,0,39,25,64,6,14,20,45,39,84,17,3,20,14,27,31,6,10,89,113
2023,2,22301024,3/23/2024,1610612745,Houston Rockets,1,1,1610612762,Utah Jazz,0,0,27,21,48,27,22,49,54,43,97,12,2,14,14,30,31,2,9,98,147
2023,2,22301006,3/21/2024,1610612741,Chicago Bulls,0,0,1610612745,Houston Rockets,1,1,30,32,62,12,19,31,42,51,93,21,4,25,14,39,23,7,11,102,117
2023,2,22300954,3/13/2024,1610612758,Sacramento Kings,1,1,1610612747,Los Angeles Lakers,0,0,27,20,47,19,22,41,46,42,88,9,3,12,12,33,30,8,14,96,120
2023,2,22300980,3/17/2024,1610612738,Boston Celtics,0,1,1610612764,Washington Wizards,1,0,19,18,37,24,26,50,43,44,87,20,4,24,16,31,30,3,15,98,130
2023,2,22301106,4/3/2024,1610612751,Brooklyn Nets,1,1,1610612754,Indiana Pacers,0,0,30,25,55,12,20,32,42,45,87,19,8,27,19,29,22,8,13,95,115
2023,2,22300924,3/10/2024,1610612749,Milwaukee Bucks,0,1,1610612746,LA Clippers,1,0,26,23,49,17,21,38,43,44,87,21,6,27,10,38,28,3,7,97,124
2023,2,22300771,2/13/2024,1610612751,Brooklyn Nets,1,0,1610612738,Boston Celtics,0,1,24,22,46,15,18,33,39,40,79,17,9,26,8,36,28,6,12,94,110
2023,2,22301105,4/3/2024,1610612738,Boston Celtics,1,1,1610612760,Oklahoma City Thunder,0,0,33,19,52,17,23,40,50,42,92,18,1,19,16,26,33,8,11,98,135
2023,2,22300871,3/3/2024,1610612742,Dallas Mavericks,1,0,1610612755,Philadelphia 76ers,0,1,24,21,45,16,25,41,40,46,86,20,3,23,17,31,20,10,17,97,116
2023,2,22300871,3/3/2024,1610612755,Philadelphia 76ers,0,1,1610612742,Dallas Mavericks,1,0,29,22,51,11,26,37,40,48,88,29,2,31,14,35,26,6,9,96,120
2023,2,22301042,3/25/2024,1610612758,Sacramento Kings,1,1,1610612755,Philadelphia 76ers,0,0,28,20,48,10,28,38,38,48,86,22,6,28,20,33,25,2,8,88,108
2023,2,22301136,4/7/2024,1610612741,Chicago Bulls,0,0,1610612753,Orlando Magic,1,1,32,23,55,6,14,20,38,37,75,16,6,22,10,32,20,12,21,94,98
2023,2,22301183,4/12/2024,1610612745,Houston Rockets,0,1,1610612757,Portland Trail Blazers,1,0,33,20,53,11,28,39,44,48,92,17,3,20,14,35,25,4,9,97,116
2023,2,22300899,3/6/2024,1610612744,Golden State Warriors,1,1,1610612749,Milwaukee Bucks,0,0,32,20,52,19,20,39,51,40,91,4,3,7,11,31,37,8,16,100,125
2023,2,22300829,2/26/2024,1610612754,Indiana Pacers,1,0,1610612761,Toronto Raptors,0,1,33,25,58,13,29,42,46,54,100,17,6,23,21,35,27,4,10,101,122
2023,2,22301137,4/7/2024,1610612764,Washington Wizards,0,0,1610612761,Toronto Raptors,1,1,26,23,49,16,24,40,42,47,89,22,8,30,9,42,29,9,15,108,122
2023,2,22300753,2/10/2024,1610612755,Philadelphia 76ers,0,1,1610612764,Washington Wizards,1,0,40,33,73,8,19,27,48,52,100,15,8,23,19,37,28,7,11,103,119
2023,2,22301119,4/5/2024,1610612741,Chicago Bulls,1,1,1610612752,New York Knicks,0,0,37,33,70,7,16,23,44,49,93,13,3,16,20,31,27,9,17,96,108
2023,2,22300745,2/9/2024,1610612766,Charlotte Hornets,0,0,1610612749,Milwaukee Bucks,1,1,20,30,50,7,22,29,27,52,79,23,6,29,11,44,17,8,15,97,84
2023,2,22301021,3/23/2024,1610612737,Atlanta Hawks,1,1,1610612766,Charlotte Hornets,0,0,30,18,48,20,22,42,50,40,90,12,2,14,13,29,40,3,9,92,132
2023,2,22301009,3/21/2024,1610612752,New York Knicks,0,0,1610612743,Denver Nuggets,1,1,27,21,48,11,20,31,38,41,79,13,4,17,8,35,28,5,10,89,100
2023,2,22300757,2/10/2024,1610612756,Phoenix Suns,0,0,1610612744,Golden State Warriors,1,1,32,28,60,11,23,34,43,51,94,15,1,16,10,41,28,6,14,103,112
2023,2,22300771,2/13/2024,1610612738,Boston Celtics,0,1,1610612751,Brooklyn Nets,1,0,28,18,46,15,22,37,43,40,83,17,6,23,13,32,31,6,14,97,118
2023,2,22301008,3/21/2024,1610612762,Utah Jazz,0,0,1610612742,Dallas Mavericks,1,1,34,19,53,4,26,30,38,45,83,17,2,19,9,36,29,12,18,100,97
2023,2,22300991,3/19/2024,1610612753,Orlando Magic,1,1,1610612766,Charlotte Hornets,0,0,32,15,47,12,22,34,44,37,81,12,1,13,11,26,32,8,18,92,112
2023,2,22301109,4/3/2024,1610612753,Orlando Magic,0,1,1610612740,New Orleans Pelicans,1,0,28,20,48,13,19,32,41,39,80,22,8,30,12,32,27,9,13,97,117
2023,2,22301110,4/3/2024,1610612739,Cleveland Cavaliers,0,0,1610612756,Phoenix Suns,1,1,32,25,57,7,19,26,39,44,83,16,3,19,9,37,28,11,15,99,101
2023,2,22301076,3/30/2024,1610612749,Milwaukee Bucks,0,1,1610612737,Atlanta Hawks,1,0,35,15,50,8,20,28,43,35,78,28,7,35,8,31,27,5,12,97,122
2023,2,22301142,4/7/2024,1610612744,Golden State Warriors,1,1,1610612762,Utah Jazz,0,0,35,22,57,14,21,35,49,43,92,6,0,6,16,27,32,4,16,96,118
2023,2,22300744,2/9/2024,1610612761,Toronto Raptors,1,1,1610612745,Houston Rockets,0,0,30,32,62,10,23,33,40,55,95,17,2,19,18,37,24,5,12,97,107
2023,2,22300819,2/25/2024,1610612742,Dallas Mavericks,0,0,1610612754,Indiana Pacers,1,1,27,29,56,14,17,31,41,46,87,15,6,21,9,42,15,12,16,104,111
2023,2,22300819,2/25/2024,1610612754,Indiana Pacers,1,1,1610612742,Dallas Mavericks,0,0,38,19,57,14,22,36,52,41,93,15,2,17,11,32,38,9,15,104,133
2023,2,22301006,3/21/2024,1610612745,Houston Rockets,1,1,1610612741,Chicago Bulls,0,0,30,18,48,17,28,45,47,46,93,16,4,20,16,31,27,8,16,101,127
2023,2,22300953,3/13/2024,1610612737,Atlanta Hawks,0,0,1610612757,Portland Trail Blazers,1,1,24,25,49,14,25,39,38,50,88,12,6,18,16,38,19,7,15,96,102
2023,2,22301076,3/30/2024,1610612737,Atlanta Hawks,1,0,1610612749,Milwaukee Bucks,0,1,28,29,57,14,21,35,42,50,92,15,3,18,14,37,24,7,11,98,113
2023,2,22300829,2/26/2024,1610612761,Toronto Raptors,0,1,1610612754,Indiana Pacers,1,0,41,27,68,12,16,28,53,43,96,12,5,17,16,31,35,8,12,99,130
2023,2,22300900,3/6/2024,1610612757,Portland Trail Blazers,1,0,1610612760,Oklahoma City Thunder,0,1,27,20,47,14,20,34,41,40,81,24,3,27,8,34,27,10,17,102,120
2023,2,22300900,3/6/2024,1610612760,Oklahoma City Thunder,0,1,1610612757,Portland Trail Blazers,1,0,34,18,52,9,13,22,43,31,74,33,6,39,8,26,23,10,18,101,128
2023,2,22301138,4/7/2024,1610612756,Phoenix Suns,1,0,1610612740,New Orleans Pelicans,0,1,25,23,48,14,25,39,39,48,87,13,1,14,12,37,30,8,16,98,105
2023,2,22300973,3/16/2024,1610612747,Los Angeles Lakers,1,0,1610612744,Golden State Warriors,0,1,35,23,58,12,22,34,47,45,92,15,3,18,15,31,32,3,10,96,121
2023,2,22300940,3/12/2024,1610612763,Memphis Grizzlies,1,1,1610612764,Washington Wizards,0,0,34,27,61,8,25,33,42,52,94,17,4,21,25,28,27,9,18,97,109
2023,2,22301119,4/5/2024,1610612752,New York Knicks,0,0,1610612741,Chicago Bulls,1,1,26,28,54,10,19,29,36,47,83,18,6,24,13,39,22,11,18,97,100
2023,2,22301110,4/3/2024,1610612756,Phoenix Suns,1,1,1610612739,Cleveland Cavaliers,0,0,26,28,54,18,15,33,44,43,87,16,1,17,13,30,32,9,16,97,122
2023,2,22301108,4/3/2024,1610612750,Minnesota Timberwolves,1,1,1610612761,Toronto Raptors,0,0,29,24,53,20,23,43,49,47,96,15,7,22,12,39,37,4,9,104,133
2023,2,22301042,3/25/2024,1610612755,Philadelphia 76ers,0,0,1610612758,Sacramento Kings,1,1,23,25,48,11,23,34,34,48,82,17,3,20,18,30,18,6,15,88,96
2023,2,22301142,4/7/2024,1610612762,Utah Jazz,0,0,1610612744,Golden State Warriors,1,1,24,24,48,15,20,35,39,44,83,17,4,21,8,38,21,9,11,94,110
2023,2,22300745,2/9/2024,1610612749,Milwaukee Bucks,1,1,1610612766,Charlotte Hornets,0,0,23,19,42,18,34,52,41,53,94,20,4,24,14,42,26,2,7,98,120
2023,2,22300754,2/10/2024,1610612745,Houston Rockets,0,0,1610612737,Atlanta Hawks,1,1,31,26,57,13,30,43,44,56,100,12,7,19,22,37,22,7,17,105,113
2023,2,22300761,2/12/2024,1610612754,Indiana Pacers,0,0,1610612766,Charlotte Hornets,1,1,34,19,53,8,22,30,42,41,83,10,6,16,3,41,31,5,11,98,102
2023,2,22300955,3/14/2024,1610612738,Boston Celtics,1,1,1610612756,Phoenix Suns,0,0,22,17,39,25,25,50,47,42,89,8,3,11,8,35,31,4,10,97,127
2023,2,22300973,3/16/2024,1610612744,Golden State Warriors,0,1,1610612747,Los Angeles Lakers,1,0,37,26,63,14,20,34,51,46,97,12,3,15,16,31,38,3,7,94,128
2023,2,22300852,2/29/2024,1610612752,New York Knicks,1,0,1610612744,Golden State Warriors,0,1,23,33,56,12,27,39,35,60,95,17,7,24,21,42,23,8,13,97,99
2023,2,22300991,3/19/2024,1610612766,Charlotte Hornets,0,0,1610612753,Orlando Magic,1,1,29,21,50,9,20,29,38,41,79,7,2,9,9,33,19,10,17,92,92
2023,2,22300980,3/17/2024,1610612764,Washington Wizards,1,0,1610612738,Boston Celtics,0,1,31,24,55,10,24,34,41,48,89,12,2,14,15,34,24,9,16,96,104
2023,2,22301141,4/7/2024,1610612751,Brooklyn Nets,1,0,1610612758,Sacramento Kings,0,1,23,33,56,7,23,30,30,56,86,10,3,13,12,46,17,8,17,97,77
2023,2,22300901,3/6/2024,1610612758,Sacramento Kings,0,1,1610612747,Los Angeles Lakers,1,0,42,24,66,12,19,31,54,43,97,10,2,12,11,33,32,4,15,104,130
2023,2,22300941,3/12/2024,1610612754,Indiana Pacers,0,1,1610612760,Oklahoma City Thunder,1,0,39,22,61,9,19,28,48,41,89,16,3,19,5,38,34,5,9,102,121
2023,2,22301138,4/7/2024,1610612740,New Orleans Pelicans,0,1,1610612756,Phoenix Suns,1,0,24,22,46,16,23,39,40,45,85,17,2,19,12,33,26,7,14,97,113
2023,2,22300953,3/13/2024,1610612757,Portland Trail Blazers,1,1,1610612737,Atlanta Hawks,0,0,28,24,52,10,20,30,38,44,82,20,4,24,16,30,24,11,18,96,106
2023,2,22301122,4/5/2024,1610612761,Toronto Raptors,0,1,1610612749,Milwaukee Bucks,1,0,22,21,43,14,22,36,36,43,79,31,5,36,10,35,24,8,17,103,117
2023,2,22301109,4/3/2024,1610612740,New Orleans Pelicans,1,0,1610612753,Orlando Magic,0,1,24,23,47,12,17,29,36,40,76,24,4,28,8,34,21,9,14,94,108
2023,2,22300997,3/20/2024,1610612754,Indiana Pacers,0,1,1610612765,Detroit Pistons,1,0,39,20,59,11,18,29,50,38,88,11,7,18,6,36,38,8,13,102,122
2023,2,22301122,4/5/2024,1610612749,Milwaukee Bucks,1,0,1610612761,Toronto Raptors,0,1,29,23,52,12,30,42,41,53,94,17,4,21,15,39,21,9,13,102,111
2023,2,22301043,3/25/2024,1610612754,Indiana Pacers,0,1,1610612746,LA Clippers,1,0,33,25,58,17,11,28,50,36,86,16,6,22,11,29,28,4,8,93,133
2023,2,22300763,2/12/2024,1610612737,Atlanta Hawks,1,0,1610612741,Chicago Bulls,0,1,30,21,51,14,29,43,44,50,94,24,5,29,15,38,33,6,12,104,126
2023,2,22300941,3/12/2024,1610612760,Oklahoma City Thunder,1,0,1610612754,Indiana Pacers,0,1,29,33,62,14,23,37,43,56,99,11,4,15,17,42,24,8,13,103,111
2023,2,22301143,4/7/2024,1610612747,Los Angeles Lakers,1,0,1610612750,Minnesota Timberwolves,0,1,28,25,53,11,20,31,39,45,84,28,4,32,13,33,27,12,15,102,117
2023,2,22300968,3/16/2024,1610612754,Indiana Pacers,1,1,1610612751,Brooklyn Nets,0,0,44,31,75,6,24,30,50,55,105,15,1,16,23,33,21,8,13,101,121
2023,2,22301054,3/27/2024,1610612754,Indiana Pacers,0,0,1610612741,Chicago Bulls,1,1,21,22,43,13,29,42,34,51,85,18,5,23,12,42,25,7,13,95,99
2023,2,22300901,3/6/2024,1610612747,Los Angeles Lakers,1,0,1610612758,Sacramento Kings,0,1,27,22,49,15,17,32,42,39,81,21,4,25,4,37,25,8,13,101,120
2023,2,22301140,4/7/2024,1610612755,Philadelphia 76ers,0,1,1610612759,San Antonio Spurs,1,0,40,35,75,12,27,39,52,62,114,17,2,19,15,48,31,5,12,122,133
2023,2,22300742,2/9/2024,1610612737,Atlanta Hawks,0,1,1610612755,Philadelphia 76ers,1,0,26,19,45,16,20,36,42,39,81,27,6,33,10,32,31,7,13,99,127
2023,2,22300952,3/13/2024,1610612744,Golden State Warriors,0,0,1610612742,Dallas Mavericks,1,1,28,36,64,9,19,28,37,55,92,16,3,19,22,35,19,6,17,96,99
2023,2,22300952,3/13/2024,1610612742,Dallas Mavericks,1,1,1610612744,Golden State Warriors,0,0,38,17,55,6,21,27,44,38,82,15,4,19,11,30,30,9,17,95,109
2023,2,22300955,3/14/2024,1610612756,Phoenix Suns,0,0,1610612738,Boston Celtics,1,1,36,32,68,11,20,31,47,52,99,7,3,10,24,29,27,12,14,94,112
2023,2,22301108,4/3/2024,1610612761,Toronto Raptors,0,0,1610612750,Minnesota Timberwolves,1,1,26,34,60,7,23,30,33,57,90,12,2,14,14,44,19,13,21,103,85
2023,2,22300996,3/20/2024,1610612748,Miami Heat,0,1,1610612739,Cleveland Cavaliers,1,0,25,22,47,13,23,36,38,45,83,18,1,19,9,36,19,3,8,89,107
2023,2,22301059,3/27/2024,1610612743,Denver Nuggets,1,0,1610612756,Phoenix Suns,0,1,28,20,48,10,30,40,38,50,88,11,1,12,11,40,24,3,8,91,97
2023,2,22301154,4/9/2024,1610612743,Denver Nuggets,0,1,1610612762,Utah Jazz,1,0,32,25,57,14,23,37,46,48,94,5,6,11,16,35,30,5,10,95,111
2023,2,22301155,4/9/2024,1610612747,Los Angeles Lakers,1,0,1610612744,Golden State Warriors,0,1,32,29,61,12,23,35,44,52,96,20,4,24,14,39,31,3,8,100,120
2023,2,22300968,3/16/2024,1610612751,Brooklyn Nets,0,0,1610612754,Indiana Pacers,1,1,23,29,52,10,15,25,33,44,77,24,7,31,12,36,18,13,21,100,100
2023,2,22300981,3/17/2024,1610612751,Brooklyn Nets,0,0,1610612759,San Antonio Spurs,1,1,39,32,71,8,23,31,47,55,102,13,6,19,14,44,29,6,12,108,115
2023,2,22300940,3/12/2024,1610612764,Washington Wizards,0,0,1610612763,Memphis Grizzlies,1,1,26,20,46,11,25,36,37,45,82,12,4,16,6,39,26,8,13,97,97
2023,2,22301118,4/5/2024,1610612758,Sacramento Kings,0,0,1610612738,Boston Celtics,1,1,21,27,48,17,34,51,38,61,99,7,6,13,21,42,21,6,7,94,100
2023,2,22300947,3/13/2024,1610612753,Orlando Magic,1,1,1610612751,Brooklyn Nets,0,0,26,19,45,14,18,32,40,37,77,20,6,26,9,28,29,7,13,94,114
2023,2,22301055,3/27/2024,1610612747,Los Angeles Lakers,0,1,1610612763,Memphis Grizzlies,1,0,27,21,48,18,15,33,45,36,81,28,7,35,9,31,31,10,16,106,136
2023,2,22300997,3/20/2024,1610612765,Detroit Pistons,1,0,1610612754,Indiana Pacers,0,1,32,35,67,5,18,23,37,53,90,24,6,30,18,39,23,13,15,103,103
2023,2,22300828,2/26/2024,1610612752,New York Knicks,1,1,1610612765,Detroit Pistons,0,0,26,27,53,15,24,39,41,51,92,16,5,21,21,35,31,9,14,94,113
2023,2,22301033,3/25/2024,1610612766,Charlotte Hornets,0,0,1610612739,Cleveland Cavaliers,1,1,25,27,52,9,19,28,34,46,80,15,3,18,9,38,22,4,12,90,92
2023,2,22300992,3/19/2024,1610612764,Washington Wizards,1,0,1610612745,Houston Rockets,0,1,27,32,59,15,24,39,42,56,98,15,5,20,20,38,24,6,11,99,114
2023,2,22301069,3/29/2024,1610612760,Oklahoma City Thunder,1,1,1610612756,Phoenix Suns,0,0,33,24,57,16,14,30,49,38,87,14,0,14,11,27,33,6,11,95,128
2023,2,22301107,4/3/2024,1610612763,Memphis Grizzlies,0,1,1610612749,Milwaukee Bucks,1,0,39,29,68,7,16,23,46,45,91,12,5,17,14,34,25,5,9,93,111
2023,2,22301140,4/7/2024,1610612759,San Antonio Spurs,1,0,1610612755,Philadelphia 76ers,0,1,28,26,54,16,28,44,44,54,98,22,4,26,14,41,31,15,25,120,126
2023,2,22301143,4/7/2024,1610612750,Minnesota Timberwolves,0,1,1610612747,Los Angeles Lakers,1,0,35,23,58,15,24,39,50,47,97,12,2,14,17,31,29,10,16,102,127
2023,2,22301154,4/9/2024,1610612762,Utah Jazz,1,0,1610612743,Denver Nuggets,0,1,26,34,60,10,21,31,36,55,91,13,0,13,19,36,19,12,15,95,95
2023,2,22301155,4/9/2024,1610612744,Golden State Warriors,0,1,1610612747,Los Angeles Lakers,1,0,21,18,39,26,15,41,47,33,80,14,7,21,5,31,37,8,15,100,134
2022,2,22200595,1/7/2023,1610612747,Los Angeles Lakers,0,1,1610612758,Sacramento Kings,1,0,41,20,61,9,12,21,50,32,82,27,6,33,12,24,26,5,17,101,136
2022,2,22200595,1/7/2023,1610612758,Sacramento Kings,1,0,1610612747,Los Angeles Lakers,0,1,31,23,54,14,18,32,45,41,86,30,7,37,17,29,25,4,14,101,134
2023,2,22300992,3/19/2024,1610612745,Houston Rockets,0,1,1610612764,Washington Wizards,1,0,34,18,52,13,26,39,47,44,91,30,6,36,16,30,25,6,7,97,137
2023,2,22301121,4/5/2024,1610612765,Detroit Pistons,0,0,1610612763,Memphis Grizzlies,1,1,24,25,49,8,22,30,32,47,79,18,6,24,12,38,22,13,18,96,90
2023,2,22300972,3/16/2024,1610612763,Memphis Grizzlies,1,0,1610612760,Oklahoma City Thunder,0,1,19,18,37,18,26,44,37,44,81,20,6,26,9,39,34,7,14,98,112
2023,2,22301033,3/25/2024,1610612739,Cleveland Cavaliers,1,1,1610612766,Charlotte Hornets,0,0,29,16,45,17,24,41,46,40,86,6,4,10,13,29,41,5,14,90,115
2023,2,22301158,4/10/2024,1610612739,Cleveland Cavaliers,1,1,1610612763,Memphis Grizzlies,0,0,22,23,45,15,22,37,37,45,82,21,8,29,14,34,27,10,16,97,110
2023,2,22300981,3/17/2024,1610612759,San Antonio Spurs,1,1,1610612751,Brooklyn Nets,0,0,37,25,62,9,28,37,46,53,99,21,2,23,17,37,30,13,18,110,122
2023,2,22300828,2/26/2024,1610612765,Detroit Pistons,0,0,1610612752,New York Knicks,1,1,24,25,49,14,16,30,38,41,79,21,5,26,13,31,25,9,17,95,111
2023,2,22301107,4/3/2024,1610612749,Milwaukee Bucks,1,0,1610612763,Memphis Grizzlies,0,1,20,31,51,18,26,44,38,57,95,7,5,12,18,43,26,5,11,92,101
2023,2,22301153,4/9/2024,1610612758,Sacramento Kings,0,0,1610612760,Oklahoma City Thunder,1,1,13,25,38,20,38,58,33,63,96,19,7,26,24,44,23,11,17,102,105
2023,2,22301141,4/7/2024,1610612758,Sacramento Kings,0,1,1610612751,Brooklyn Nets,1,0,25,21,46,15,33,48,40,54,94,12,4,16,12,43,31,5,9,98,107
2023,2,22301139,4/7/2024,1610612749,Milwaukee Bucks,1,0,1610612752,New York Knicks,0,1,23,18,41,12,22,34,35,40,75,27,5,32,11,31,27,9,14,91,109
2023,2,22301158,4/10/2024,1610612763,Memphis Grizzlies,0,0,1610612739,Cleveland Cavaliers,1,1,19,33,52,14,18,32,33,51,84,18,1,19,14,37,21,11,16,96,98
2023,2,22301156,4/9/2024,1610612756,Phoenix Suns,1,0,1610612746,LA Clippers,0,1,22,32,54,8,27,35,30,59,89,24,4,28,8,53,17,5,8,101,92
2023,2,22300772,2/13/2024,1610612753,Orlando Magic,1,0,1610612760,Oklahoma City Thunder,0,1,30,25,55,11,25,36,41,50,91,20,5,25,18,33,29,9,16,102,113
2023,2,22300947,3/13/2024,1610612751,Brooklyn Nets,0,0,1610612753,Orlando Magic,1,1,31,24,55,7,19,26,38,43,81,23,4,27,13,31,21,6,13,93,106
2023,2,22301151,4/9/2024,1610612759,San Antonio Spurs,0,1,1610612763,Memphis Grizzlies,1,0,32,15,47,10,30,40,42,45,87,8,0,8,11,34,30,10,17,96,102
2023,2,22300861,3/1/2024,1610612763,Memphis Grizzlies,1,0,1610612757,Portland Trail Blazers,0,1,26,29,55,9,15,24,35,44,79,13,9,22,17,33,15,13,23,95,92
2023,2,22301052,3/27/2024,1610612755,Philadelphia 76ers,1,0,1610612746,LA Clippers,0,1,26,23,49,13,20,33,39,43,82,16,3,19,11,33,17,8,12,93,107
2023,2,22300996,3/20/2024,1610612739,Cleveland Cavaliers,1,0,1610612748,Miami Heat,0,1,20,13,33,15,27,42,35,40,75,19,3,22,10,32,30,7,12,88,104
2023,2,22301164,4/10/2024,1610612743,Denver Nuggets,1,1,1610612750,Minnesota Timberwolves,0,0,35,23,58,11,14,25,46,37,83,13,10,23,16,28,31,9,14,90,116
2023,2,22301120,4/5/2024,1610612748,Miami Heat,0,1,1610612745,Houston Rockets,1,0,31,22,53,13,23,36,44,45,89,18,3,21,10,35,27,7,9,99,119
2023,2,22301164,4/10/2024,1610612750,Minnesota Timberwolves,0,0,1610612743,Denver Nuggets,1,1,28,24,52,13,17,30,41,41,82,12,9,21,12,35,23,7,10,91,107
2023,2,22301136,4/7/2024,1610612753,Orlando Magic,1,1,1610612741,Chicago Bulls,0,0,31,25,56,11,23,34,42,48,90,18,1,19,16,32,24,7,10,92,113
2023,2,22301104,4/3/2024,1610612737,Atlanta Hawks,1,1,1610612765,Detroit Pistons,0,0,36,16,52,13,25,38,49,41,90,10,5,15,11,31,36,14,16,103,121
2023,2,22301156,4/9/2024,1610612746,LA Clippers,0,1,1610612756,Phoenix Suns,1,0,29,32,61,12,14,26,41,46,87,11,0,11,12,34,28,16,21,102,105
2023,2,22301021,3/23/2024,1610612766,Charlotte Hornets,0,0,1610612737,Atlanta Hawks,1,1,24,21,45,11,28,39,35,49,84,10,4,14,15,36,25,9,15,91,91
2023,2,22301159,4/10/2024,1610612737,Atlanta Hawks,1,0,1610612766,Charlotte Hornets,0,1,25,17,42,18,22,40,43,39,82,10,6,16,11,31,35,11,18,97,114
2023,2,22301163,4/10/2024,1610612760,Oklahoma City Thunder,1,1,1610612759,San Antonio Spurs,0,0,31,32,63,16,22,38,47,54,101,17,4,21,10,47,33,8,12,113,127
2023,2,22301165,4/10/2024,1610612756,Phoenix Suns,0,1,1610612746,LA Clippers,1,0,28,17,45,18,32,50,46,49,95,14,1,15,13,36,29,9,13,102,124
2023,2,22301168,4/11/2024,1610612745,Houston Rockets,0,0,1610612762,Utah Jazz,1,1,19,29,48,21,26,47,40,55,95,20,2,22,20,36,22,8,10,95,121
2023,2,22301036,3/25/2024,1610612761,Toronto Raptors,1,0,1610612751,Brooklyn Nets,0,1,32,26,58,5,22,27,37,48,85,9,3,12,11,38,23,3,10,90,88
2023,2,22300861,3/1/2024,1610612757,Portland Trail Blazers,0,1,1610612763,Memphis Grizzlies,1,0,35,26,61,13,18,31,48,44,92,13,3,16,19,27,31,6,14,94,122
2023,2,22301121,4/5/2024,1610612763,Memphis Grizzlies,1,1,1610612765,Detroit Pistons,0,0,32,27,59,10,21,31,42,48,90,14,2,16,22,28,24,13,21,98,108
2023,2,22300931,3/10/2024,1610612760,Oklahoma City Thunder,1,1,1610612763,Memphis Grizzlies,0,0,28,18,46,21,26,47,49,44,93,5,0,5,11,33,36,8,10,96,124
2023,2,22301051,3/27/2024,1610612757,Portland Trail Blazers,0,0,1610612737,Atlanta Hawks,1,1,29,25,54,14,17,31,43,42,85,6,4,10,10,35,35,12,19,98,106
2023,2,22300946,3/13/2024,1610612761,Toronto Raptors,0,0,1610612765,Detroit Pistons,1,1,32,25,57,9,27,36,41,52,93,13,6,19,4,51,32,7,11,109,104
2023,2,22301126,4/5/2024,1610612746,LA Clippers,1,1,1610612762,Utah Jazz,0,0,38,18,56,13,22,35,51,40,91,16,2,18,11,31,32,11,15,104,131
2023,2,22301012,3/22/2024,1610612761,Toronto Raptors,1,0,1610612760,Oklahoma City Thunder,0,1,29,17,46,11,19,30,40,36,76,12,5,17,7,33,34,17,27,103,103
2023,2,22301098,4/2/2024,1610612750,Minnesota Timberwolves,1,1,1610612745,Houston Rockets,0,0,30,21,51,11,15,26,41,36,77,20,2,22,10,28,29,10,18,94,113
2023,2,22301129,4/6/2024,1610612755,Philadelphia 76ers,0,1,1610612763,Memphis Grizzlies,1,0,25,15,40,16,23,39,41,38,79,18,5,23,10,31,27,9,19,98,116
2023,2,22301125,4/5/2024,1610612756,Phoenix Suns,1,1,1610612750,Minnesota Timberwolves,0,0,24,26,50,9,17,26,33,43,76,22,7,29,9,38,29,9,18,99,97
2023,2,22301090,4/1/2024,1610612757,Portland Trail Blazers,0,0,1610612753,Orlando Magic,1,1,29,30,59,11,20,31,40,50,90,12,3,15,15,36,28,4,11,95,103
2023,2,22301068,3/29/2024,1610612757,Portland Trail Blazers,0,0,1610612748,Miami Heat,1,1,30,27,57,5,25,30,35,52,87,7,4,11,14,41,20,17,24,102,82
2023,2,22301127,4/6/2024,1610612747,Los Angeles Lakers,1,1,1610612739,Cleveland Cavaliers,0,0,29,14,43,16,21,37,45,35,80,10,6,16,8,31,30,11,20,100,116
2023,2,22301098,4/2/2024,1610612745,Houston Rockets,0,0,1610612750,Minnesota Timberwolves,1,1,27,17,44,14,34,48,41,51,92,10,4,14,19,36,23,12,15,96,106
2023,2,22301131,4/7/2024,1610612742,Dallas Mavericks,1,1,1610612745,Houston Rockets,0,0,31,15,46,15,24,39,46,39,85,40,5,45,10,32,21,11,17,112,147
2023,2,22301130,4/6/2024,1610612737,Atlanta Hawks,0,0,1610612743,Denver Nuggets,1,1,25,25,50,12,25,37,37,50,87,24,5,29,12,42,30,9,16,103,110
2023,2,22300576,2/15/2024,1610612744,Golden State Warriors,0,1,1610612762,Utah Jazz,1,0,29,21,50,20,22,42,49,43,92,22,6,28,14,32,42,10,13,102,140
2023,2,22301034,3/25/2024,1610612738,Boston Celtics,0,0,1610612737,Atlanta Hawks,1,1,36,21,57,11,27,38,47,48,95,13,6,19,18,33,21,5,9,94,118
2023,2,22301011,3/22/2024,1610612765,Detroit Pistons,1,0,1610612738,Boston Celtics,0,1,33,19,52,9,22,31,42,41,83,9,4,13,12,30,25,9,19,96,102
2023,2,22301127,4/6/2024,1610612739,Cleveland Cavaliers,0,0,1610612747,Los Angeles Lakers,1,1,28,27,55,11,24,35,39,51,90,8,4,12,16,36,24,11,19,100,97
2023,2,22301126,4/5/2024,1610612762,Utah Jazz,0,0,1610612746,LA Clippers,1,1,26,35,61,9,21,30,35,56,91,23,6,29,17,43,20,9,15,102,102
2023,2,22301051,3/27/2024,1610612737,Atlanta Hawks,1,1,1610612757,Portland Trail Blazers,0,0,28,16,44,16,25,41,44,41,85,16,4,20,12,31,23,8,17,98,120
2023,2,22301124,4/4/2024,1610612742,Dallas Mavericks,1,1,1610612737,Atlanta Hawks,0,0,20,25,45,18,31,49,38,56,94,15,2,17,12,46,20,7,14,102,109
2023,2,22300863,3/1/2024,1610612754,Indiana Pacers,0,0,1610612740,New Orleans Pelicans,1,1,30,33,63,10,22,32,40,55,95,12,6,18,20,36,25,9,16,101,102
2023,2,22301063,3/29/2024,1610612747,Los Angeles Lakers,0,0,1610612754,Indiana Pacers,1,1,30,26,56,5,25,30,35,51,86,15,3,18,11,41,24,8,16,98,90
2023,2,22300956,3/14/2024,1610612741,Chicago Bulls,1,0,1610612746,LA Clippers,0,1,25,26,51,16,19,35,41,45,86,13,3,16,16,30,28,9,13,91,111
2023,2,22301153,4/9/2024,1610612760,Oklahoma City Thunder,1,1,1610612758,Sacramento Kings,0,0,28,22,50,11,19,30,39,41,80,23,8,31,8,36,21,8,14,101,112
2023,2,22301083,3/31/2024,1610612745,Houston Rockets,1,0,1610612742,Dallas Mavericks,0,1,26,28,54,13,25,38,39,53,92,16,3,19,16,38,22,7,12,96,107
2023,2,22301135,4/7/2024,1610612766,Charlotte Hornets,1,0,1610612760,Oklahoma City Thunder,0,1,28,15,43,17,23,40,45,38,83,11,3,14,12,27,29,14,18,97,118
2023,2,22301123,4/5/2024,1610612759,San Antonio Spurs,0,1,1610612740,New Orleans Pelicans,1,0,25,12,37,17,29,46,42,41,83,10,3,13,10,34,34,11,17,97,111
2023,2,22301129,4/6/2024,1610612763,Memphis Grizzlies,1,0,1610612755,Philadelphia 76ers,0,1,27,34,61,9,17,26,36,51,87,15,6,21,19,34,21,12,19,100,96
2023,2,22301157,4/9/2024,1610612757,Portland Trail Blazers,1,0,1610612740,New Orleans Pelicans,0,1,27,20,47,13,25,38,40,45,85,7,1,8,14,32,28,13,22,96,100
2023,2,22301125,4/5/2024,1610612750,Minnesota Timberwolves,0,0,1610612756,Phoenix Suns,1,1,23,33,56,10,19,29,33,52,85,11,3,14,10,44,23,12,19,100,87
2023,2,22301128,4/6/2024,1610612765,Detroit Pistons,0,0,1610612751,Brooklyn Nets,1,1,25,28,53,17,22,39,42,50,92,2,2,4,10,41,25,3,10,95,103
2023,2,22301113,4/4/2024,1610612744,Golden State Warriors,0,1,1610612745,Houston Rockets,1,0,30,15,45,17,18,35,47,33,80,22,3,25,14,20,29,11,21,98,133
2023,2,22301130,4/6/2024,1610612743,Denver Nuggets,1,1,1610612737,Atlanta Hawks,0,0,30,17,47,23,18,41,53,35,88,13,3,16,8,28,38,8,17,104,142
2023,2,22301132,4/7/2024,1610612739,Cleveland Cavaliers,0,0,1610612746,LA Clippers,1,1,31,27,58,11,19,30,42,46,88,23,4,27,11,38,27,5,11,101,118
2023,2,22301165,4/10/2024,1610612746,LA Clippers,1,0,1610612756,Phoenix Suns,0,1,32,27,59,12,24,36,44,51,95,8,2,10,11,42,23,8,13,101,108
2023,2,22301160,4/10/2024,1610612761,Toronto Raptors,0,0,1610612751,Brooklyn Nets,1,1,19,35,54,16,24,40,35,59,94,16,2,18,18,43,19,4,10,95,102
2023,2,22301163,4/10/2024,1610612759,San Antonio Spurs,0,0,1610612760,Oklahoma City Thunder,1,1,23,33,56,9,31,40,32,64,96,16,4,20,8,58,24,12,15,113,89
2023,2,22301168,4/11/2024,1610612762,Utah Jazz,1,1,1610612745,Houston Rockets,0,0,30,18,48,14,25,39,44,43,87,22,5,27,21,23,27,8,16,95,124
2022,2,22201198,4/6/2023,1610612755,Philadelphia 76ers,1,0,1610612748,Miami Heat,0,1,29,11,40,10,26,36,39,37,76,13,2,15,4,34,23,3,17,95,101
2023,2,22300956,3/14/2024,1610612746,LA Clippers,0,1,1610612741,Chicago Bulls,1,0,28,12,40,20,20,40,48,32,80,10,4,14,7,26,32,4,10,91,126
2022,2,22201200,4/6/2023,1610612762,Utah Jazz,1,0,1610612760,Oklahoma City Thunder,0,1,36,16,52,5,26,31,41,42,83,11,5,16,7,37,24,12,19,102,98
2023,2,22301089,4/1/2024,1610612754,Indiana Pacers,1,1,1610612751,Brooklyn Nets,0,0,40,32,72,13,18,31,53,50,103,14,3,17,19,33,35,3,10,103,133
2023,2,22301070,3/29/2024,1610612752,New York Knicks,0,0,1610612759,San Antonio Spurs,1,1,37,36,73,14,23,37,51,59,110,10,2,12,21,39,24,3,12,106,126
2023,2,22301052,3/27/2024,1610612746,LA Clippers,0,1,1610612755,Philadelphia 76ers,1,0,26,28,54,14,22,36,40,50,90,14,6,20,13,41,28,3,8,93,108
2023,2,22301036,3/25/2024,1610612751,Brooklyn Nets,0,1,1610612761,Toronto Raptors,1,0,28,14,42,9,30,39,37,44,81,13,5,18,20,26,20,10,20,90,96
2023,2,22301135,4/7/2024,1610612760,Oklahoma City Thunder,0,1,1610612766,Charlotte Hornets,1,0,27,24,51,18,18,36,45,42,87,13,4,17,15,29,33,12,17,97,121
2023,2,22301162,4/10/2024,1610612749,Milwaukee Bucks,1,1,1610612753,Orlando Magic,0,0,28,16,44,15,25,40,43,41,84,16,4,20,13,31,27,6,15,94,117
2023,2,22301020,3/23/2024,1610612753,Orlando Magic,1,0,1610612758,Sacramento Kings,0,1,32,21,53,10,25,35,42,46,88,13,5,18,13,37,27,6,13,95,107
2023,2,22301144,4/9/2024,1610612742,Dallas Mavericks,0,1,1610612766,Charlotte Hornets,1,0,33,10,43,17,33,50,50,43,93,13,7,20,17,31,35,8,15,99,130
2023,2,22301123,4/5/2024,1610612740,New Orleans Pelicans,1,0,1610612759,San Antonio Spurs,0,1,35,22,57,9,20,29,44,42,86,12,0,12,12,30,28,9,17,96,109
2023,2,22301011,3/22/2024,1610612738,Boston Celtics,0,1,1610612765,Detroit Pistons,1,0,31,13,44,16,29,45,47,42,89,19,8,27,11,36,31,4,7,98,129
2023,2,22301017,3/22/2024,1610612746,LA Clippers,0,1,1610612757,Portland Trail Blazers,1,0,30,14,44,14,19,33,44,33,77,23,4,27,8,27,26,11,17,96,125
2023,2,22301131,4/7/2024,1610612745,Houston Rockets,0,0,1610612742,Dallas Mavericks,1,1,29,23,52,17,24,41,46,47,93,27,8,35,11,41,31,4,11,114,136
2023,2,22301149,4/9/2024,1610612741,Chicago Bulls,1,0,1610612752,New York Knicks,0,1,37,23,60,10,18,28,47,41,88,13,6,19,13,30,20,6,9,94,117
2023,2,22301157,4/9/2024,1610612740,New Orleans Pelicans,0,1,1610612757,Portland Trail Blazers,1,0,25,26,51,11,25,36,36,51,87,27,2,29,14,37,25,3,9,96,110
2023,2,22301159,4/10/2024,1610612766,Charlotte Hornets,0,1,1610612737,Atlanta Hawks,1,0,26,17,43,14,22,36,40,39,79,21,1,22,6,34,25,7,14,96,115
2023,2,22300958,3/14/2024,1610612755,Philadelphia 76ers,0,0,1610612749,Milwaukee Bucks,1,1,22,22,44,17,18,35,39,40,79,10,4,14,8,32,20,6,13,89,105
2023,2,22300274,12/1/2023,1610612764,Washington Wizards,0,0,1610612753,Orlando Magic,1,1,32,29,61,13,15,28,45,44,89,22,9,31,12,39,25,6,14,106,125
2023,2,22301132,4/7/2024,1610612746,LA Clippers,1,1,1610612739,Cleveland Cavaliers,0,0,27,22,49,14,21,35,41,43,84,24,0,24,13,30,26,10,16,100,120
2023,2,22301113,4/4/2024,1610612745,Houston Rockets,1,0,1610612744,Golden State Warriors,0,1,24,22,46,12,28,40,36,50,86,26,4,30,15,37,23,6,12,98,110
2023,2,22301124,4/4/2024,1610612737,Atlanta Hawks,0,0,1610612742,Dallas Mavericks,1,1,21,26,47,13,25,38,34,51,85,14,7,21,12,43,21,7,21,103,95
2023,2,22301162,4/10/2024,1610612753,Orlando Magic,0,0,1610612749,Milwaukee Bucks,1,1,25,23,48,11,19,30,36,42,78,16,7,23,10,35,19,9,16,95,99
2023,2,22301017,3/22/2024,1610612757,Portland Trail Blazers,1,0,1610612746,LA Clippers,0,1,33,27,60,12,21,33,45,48,93,15,10,25,17,36,29,8,10,97,117
2023,2,22301152,4/9/2024,1610612750,Minnesota Timberwolves,1,1,1610612764,Washington Wizards,0,0,25,24,49,18,23,41,43,47,90,26,6,32,15,36,30,5,8,100,130
2023,2,22301012,3/22/2024,1610612760,Oklahoma City Thunder,0,1,1610612761,Toronto Raptors,1,0,36,27,63,12,20,32,48,47,95,15,4,19,17,31,27,12,16,104,123
2023,2,22301145,4/9/2024,1610612765,Detroit Pistons,0,0,1610612755,Philadelphia 76ers,1,1,20,34,54,14,16,30,34,50,84,20,4,24,14,38,20,11,16,99,102
2023,2,22301057,3/27/2024,1610612760,Oklahoma City Thunder,1,0,1610612745,Houston Rockets,0,1,33,25,58,14,24,38,47,49,96,18,6,24,15,37,26,10,19,111,126
2023,2,22300925,3/10/2024,1610612737,Atlanta Hawks,1,0,1610612740,New Orleans Pelicans,0,1,21,24,45,17,29,46,38,53,91,10,3,13,14,40,28,8,11,95,103
2023,2,22301034,3/25/2024,1610612737,Atlanta Hawks,1,1,1610612738,Boston Celtics,0,0,28,23,51,18,18,36,46,41,87,10,7,17,16,28,30,7,13,93,120
2023,2,22300823,2/25/2024,1610612740,New Orleans Pelicans,1,0,1610612741,Chicago Bulls,0,1,24,23,47,16,25,41,40,48,88,10,4,14,13,38,25,12,19,100,106
2023,2,22300823,2/25/2024,1610612741,Chicago Bulls,0,1,1610612740,New Orleans Pelicans,1,0,28,27,55,13,27,40,41,54,95,19,2,21,16,39,29,5,11,101,114
2023,2,22301128,4/6/2024,1610612751,Brooklyn Nets,1,1,1610612765,Detroit Pistons,0,0,27,19,46,11,16,27,38,35,73,26,7,33,13,25,20,9,18,94,113
2023,2,22300840,2/27/2024,1610612766,Charlotte Hornets,0,0,1610612749,Milwaukee Bucks,1,1,19,22,41,11,29,40,30,51,81,14,3,17,9,43,24,7,13,94,85
2023,2,22300593,1/20/2024,1610612766,Charlotte Hornets,1,0,1610612755,Philadelphia 76ers,0,1,26,22,48,9,28,37,35,50,85,10,4,14,11,40,23,7,17,97,89
2023,2,22300049,11/24/2023,1610612764,Washington Wizards,0,0,1610612749,Milwaukee Bucks,1,1,33,30,63,15,22,37,48,52,100,17,4,21,13,41,29,6,9,104,128
2023,2,22300205,11/18/2023,1610612742,Dallas Mavericks,0,0,1610612749,Milwaukee Bucks,1,1,35,21,56,16,31,47,51,52,103,7,3,10,14,40,27,7,11,103,125
2023,2,22301160,4/10/2024,1610612751,Brooklyn Nets,1,1,1610612761,Toronto Raptors,0,0,27,23,50,11,25,36,38,48,86,19,5,24,17,33,25,8,15,94,106
2023,2,22300205,11/18/2023,1610612749,Milwaukee Bucks,1,1,1610612742,Dallas Mavericks,0,0,32,17,49,17,28,45,49,45,94,17,3,20,7,39,29,2,8,103,132
2022,2,22201198,4/6/2023,1610612748,Miami Heat,0,1,1610612755,Philadelphia 76ers,1,0,31,18,49,18,21,39,49,39,88,13,2,15,11,29,39,7,11,93,129
2023,2,22300821,2/25/2024,1610612737,Atlanta Hawks,1,1,1610612753,Orlando Magic,0,0,29,32,61,12,17,29,41,49,90,15,2,17,13,37,31,7,10,96,109
2023,2,22301035,3/25/2024,1610612765,Detroit Pistons,0,0,1610612752,New York Knicks,1,1,24,30,54,10,24,34,34,54,88,21,1,22,12,42,22,6,12,100,99
2023,2,22301120,4/5/2024,1610612745,Houston Rockets,1,0,1610612748,Miami Heat,0,1,20,26,46,14,30,44,34,56,90,22,3,25,14,43,25,8,9,98,104
2023,2,22300931,3/10/2024,1610612763,Memphis Grizzlies,0,0,1610612760,Oklahoma City Thunder,1,1,21,24,45,11,22,33,32,46,78,18,9,27,11,40,21,8,16,96,93
2023,2,22301089,4/1/2024,1610612751,Brooklyn Nets,0,0,1610612754,Indiana Pacers,1,1,31,30,61,10,16,26,41,46,87,19,9,28,14,37,20,6,15,100,111
2023,2,22301151,4/9/2024,1610612763,Memphis Grizzlies,1,0,1610612759,San Antonio Spurs,0,1,30,44,74,6,24,30,36,68,104,9,2,11,22,46,21,5,8,95,87
2023,2,22301146,4/9/2024,1610612754,Indiana Pacers,0,1,1610612761,Toronto Raptors,1,0,38,16,54,16,29,45,54,45,99,16,7,23,21,27,33,8,14,104,140
2023,2,22300902,3/7/2024,1610612751,Brooklyn Nets,0,0,1610612765,Detroit Pistons,1,1,24,19,43,17,24,41,41,43,84,13,5,18,6,39,24,7,14,101,112
2023,2,22300957,3/14/2024,1610612745,Houston Rockets,1,1,1610612764,Washington Wizards,0,0,39,20,59,12,16,28,51,36,87,21,3,24,11,27,24,11,19,107,135
2023,2,22301018,3/22/2024,1610612747,Los Angeles Lakers,1,1,1610612755,Philadelphia 76ers,0,0,20,22,42,12,19,31,32,41,73,25,8,33,11,33,22,13,21,98,101
2023,2,22301111,4/4/2024,1610612748,Miami Heat,1,0,1610612755,Philadelphia 76ers,0,1,26,25,51,13,30,43,39,55,94,14,2,16,20,35,24,11,17,97,105
2023,2,22301112,4/4/2024,1610612752,New York Knicks,1,1,1610612758,Sacramento Kings,0,0,32,20,52,12,16,28,44,36,80,20,9,29,11,29,34,6,13,93,120
2023,2,22301082,3/31/2024,1610612752,New York Knicks,1,0,1610612760,Oklahoma City Thunder,0,1,25,24,49,13,30,43,38,54,92,23,11,34,22,36,24,6,11,97,112
2023,2,22301166,4/11/2024,1610612765,Detroit Pistons,1,0,1610612741,Chicago Bulls,0,1,24,18,42,14,21,35,38,39,77,15,8,23,11,32,27,14,20,97,105
2023,2,22301020,3/23/2024,1610612758,Sacramento Kings,0,1,1610612753,Orlando Magic,1,0,23,24,47,15,25,40,38,49,87,18,3,21,10,40,26,5,7,95,109
2023,2,22301161,4/10/2024,1610612742,Dallas Mavericks,0,1,1610612748,Miami Heat,1,0,28,15,43,15,29,44,43,44,87,10,3,13,10,36,27,3,7,90,111
2023,2,22300274,12/1/2023,1610612753,Orlando Magic,1,1,1610612764,Washington Wizards,0,0,34,24,58,12,19,31,46,43,89,26,7,33,14,33,35,8,15,105,130
2021,2,22100102,11/1/2021,1610612746,LA Clippers,1,1,1610612760,Oklahoma City Thunder,0,0,20,30,50,15,27,42,35,57,92,14,5,19,17,41,18,8,14,98,99
2021,2,22100102,11/1/2021,1610612760,Oklahoma City Thunder,0,0,1610612746,LA Clippers,1,1,24,29,53,11,26,37,35,55,90,13,3,16,15,41,17,8,16,99,94
2023,2,22301097,4/5/2024,1610612744,Golden State Warriors,0,0,1610612742,Dallas Mavericks,1,1,29,29,58,12,23,35,41,52,93,12,6,18,16,39,27,9,15,102,106
2023,2,22301062,3/29/2024,1610612744,Golden State Warriors,0,1,1610612766,Charlotte Hornets,1,0,37,20,57,11,21,32,48,41,89,8,1,9,11,31,35,4,13,94,115
2023,2,22300929,3/10/2024,1610612745,Houston Rockets,0,1,1610612758,Sacramento Kings,1,0,27,28,55,12,17,29,39,45,84,22,5,27,8,39,23,10,12,100,112
2023,2,22301084,3/31/2024,1610612741,Chicago Bulls,0,1,1610612750,Minnesota Timberwolves,1,0,25,26,51,17,12,29,42,38,80,8,4,12,9,30,30,12,16,92,109
2023,2,22301149,4/9/2024,1610612752,New York Knicks,0,1,1610612741,Chicago Bulls,1,0,29,18,47,17,19,36,46,37,83,19,1,20,9,28,31,4,11,94,128
2023,2,22300957,3/14/2024,1610612764,Washington Wizards,0,0,1610612745,Houston Rockets,1,1,34,21,55,12,26,38,46,47,93,15,4,19,8,41,29,7,14,108,119
2023,2,22301050,3/27/2024,1610612764,Washington Wizards,1,0,1610612751,Brooklyn Nets,0,1,32,25,57,14,20,34,46,45,91,13,4,17,11,37,26,8,14,104,119
2023,2,22301016,3/22/2024,1610612754,Indiana Pacers,0,1,1610612744,Golden State Warriors,1,0,33,30,63,15,21,36,48,51,99,12,4,16,13,40,32,6,11,104,123
2023,2,22301035,3/25/2024,1610612752,New York Knicks,1,1,1610612765,Detroit Pistons,0,0,26,17,43,19,27,46,45,44,89,15,7,22,14,34,30,8,14,100,124
2023,2,22301146,4/9/2024,1610612761,Toronto Raptors,1,0,1610612754,Indiana Pacers,0,1,42,31,73,5,16,21,47,47,94,24,9,33,23,30,21,9,15,101,123
2023,2,22301090,4/1/2024,1610612753,Orlando Magic,1,1,1610612757,Portland Trail Blazers,0,0,25,19,44,11,21,32,36,40,76,21,6,27,10,34,26,9,16,94,104
2023,2,22301070,3/29/2024,1610612759,San Antonio Spurs,1,1,1610612752,New York Knicks,0,0,28,14,42,16,24,40,44,38,82,26,6,32,9,33,34,10,15,104,130
2023,2,22301111,4/4/2024,1610612755,Philadelphia 76ers,0,1,1610612748,Miami Heat,1,0,29,23,52,14,26,40,43,49,92,9,2,11,12,37,28,8,11,98,109
2023,2,22301166,4/11/2024,1610612741,Chicago Bulls,0,1,1610612765,Detroit Pistons,1,0,37,23,60,14,22,36,51,45,96,11,4,15,15,32,28,4,9,97,127
2023,2,22301161,4/10/2024,1610612748,Miami Heat,1,0,1610612742,Dallas Mavericks,0,1,20,31,51,13,17,30,33,48,81,13,0,13,16,32,22,8,18,89,92
2023,2,22301071,3/29/2024,1610612743,Denver Nuggets,1,0,1610612750,Minnesota Timberwolves,0,1,27,33,60,8,20,28,35,53,88,20,7,27,20,33,29,6,13,96,98
2023,2,22301112,4/4/2024,1610612758,Sacramento Kings,0,0,1610612752,New York Knicks,1,1,24,20,44,18,24,42,42,44,86,7,5,12,14,33,26,9,16,92,109
2023,2,22300293,12/11/2023,1610612765,Detroit Pistons,1,0,1610612754,Indiana Pacers,0,1,35,17,52,10,19,29,45,36,81,23,7,30,6,33,26,8,15,104,123
2023,2,22301079,3/31/2024,1610612746,LA Clippers,0,1,1610612766,Charlotte Hornets,1,0,29,17,46,14,15,29,43,32,75,30,4,34,8,26,28,3,10,92,130
2023,2,22300927,3/10/2024,1610612755,Philadelphia 76ers,0,1,1610612752,New York Knicks,1,0,22,28,50,9,21,30,31,49,80,8,6,14,16,35,20,9,15,87,79
2023,2,22300958,3/14/2024,1610612749,Milwaukee Bucks,1,1,1610612755,Philadelphia 76ers,0,0,23,13,36,16,20,36,39,33,72,20,4,24,10,24,29,6,15,89,114
2023,2,22301144,4/9/2024,1610612766,Charlotte Hornets,1,0,1610612742,Dallas Mavericks,0,1,29,28,57,10,22,32,39,50,89,16,5,21,10,42,24,6,12,100,104
2023,2,22301095,4/2/2024,1610612764,Washington Wizards,1,1,1610612749,Milwaukee Bucks,0,0,38,17,55,9,29,38,47,46,93,14,3,17,8,39,26,8,11,103,117
2023,2,22301053,3/27/2024,1610612761,Toronto Raptors,1,0,1610612752,New York Knicks,0,1,28,25,53,11,20,31,39,45,84,12,1,13,15,30,31,7,18,92,101
2023,2,22300295,12/11/2023,1610612755,Philadelphia 76ers,1,1,1610612764,Washington Wizards,0,0,32,17,49,20,26,46,52,43,95,22,3,25,12,34,37,5,14,109,146
2023,2,22301167,4/11/2024,1610612738,Boston Celtics,1,0,1610612752,New York Knicks,0,1,24,20,44,16,26,42,40,46,86,13,3,16,10,38,25,7,12,95,109
2023,2,22301088,4/1/2024,1610612763,Memphis Grizzlies,0,1,1610612765,Detroit Pistons,1,0,29,29,58,11,22,33,40,51,91,19,4,23,22,32,28,7,13,93,110
2023,2,22300295,12/11/2023,1610612764,Washington Wizards,0,0,1610612755,Philadelphia 76ers,1,1,27,27,54,9,22,31,36,49,85,20,11,31,15,39,21,14,22,107,101
2023,2,22301152,4/9/2024,1610612764,Washington Wizards,0,0,1610612750,Minnesota Timberwolves,1,1,24,22,46,20,23,43,44,45,89,13,4,17,11,36,26,9,13,101,121
2023,2,22301064,3/29/2024,1610612753,Orlando Magic,1,0,1610612746,LA Clippers,0,1,28,29,57,10,19,29,38,48,86,11,4,15,19,30,20,11,17,92,97
2023,2,22301099,4/2/2024,1610612743,Denver Nuggets,1,1,1610612759,San Antonio Spurs,0,0,32,32,64,11,23,34,43,55,98,13,3,16,13,44,28,4,8,100,110
2023,2,22301073,3/29/2024,1610612758,Sacramento Kings,1,0,1610612742,Dallas Mavericks,0,1,25,35,60,15,17,32,40,52,92,8,4,12,15,39,24,4,11,93,103
2023,2,22301072,3/29/2024,1610612762,Utah Jazz,1,0,1610612745,Houston Rockets,0,1,29,20,49,8,23,31,37,43,80,18,1,19,14,30,23,10,21,94,100
2023,2,22300902,3/7/2024,1610612765,Detroit Pistons,1,1,1610612751,Brooklyn Nets,0,0,31,21,52,12,18,30,43,39,82,20,1,21,15,25,24,12,23,101,118
2021,2,22100101,11/1/2021,1610612750,Minnesota Timberwolves,1,0,1610612753,Orlando Magic,0,1,22,24,46,14,37,51,36,61,97,11,8,19,21,44,21,5,14,99,97
2021,2,22100101,11/1/2021,1610612753,Orlando Magic,0,1,1610612750,Minnesota Timberwolves,1,0,20,19,39,17,26,43,37,45,82,24,6,30,14,33,21,8,16,98,115
2023,2,22301088,4/1/2024,1610612765,Detroit Pistons,1,0,1610612763,Memphis Grizzlies,0,1,29,22,51,11,17,28,40,39,79,17,5,22,11,33,22,11,14,92,108
2023,2,22301072,3/29/2024,1610612745,Houston Rockets,0,1,1610612762,Utah Jazz,1,0,22,27,49,13,29,42,35,56,91,18,10,28,22,41,19,4,10,92,101
2016,2,21601067,3/23/2017,1610612751,Brooklyn Nets,1,1,1610612756,Phoenix Suns,0,0,35,31,66,8,21,29,43,52,95,32,10,42,20,36,25,14,17,111,126
2016,2,21601067,3/23/2017,1610612756,Phoenix Suns,0,0,1610612751,Brooklyn Nets,1,1,27,41,68,7,18,25,34,59,93,23,11,34,18,47,16,11,20,111,98
2023,2,22300903,3/7/2024,1610612754,Indiana Pacers,1,0,1610612750,Minnesota Timberwolves,0,1,32,24,56,10,16,26,42,40,82,17,6,23,9,35,26,9,15,97,111
2016,2,21600516,1/2/2017,1610612752,New York Knicks,1,0,1610612753,Orlando Magic,0,1,31,31,62,8,13,21,39,44,83,17,7,24,21,26,18,10,20,93,103
2016,2,21600516,1/2/2017,1610612753,Orlando Magic,0,1,1610612752,New York Knicks,1,0,30,30,60,15,16,31,45,46,91,10,4,14,18,31,35,7,13,93,115
2023,2,22301053,3/27/2024,1610612752,New York Knicks,0,1,1610612761,Toronto Raptors,1,0,33,17,50,22,22,44,55,39,94,13,3,16,20,20,37,7,11,92,145
2023,2,22300277,12/1/2023,1610612763,Memphis Grizzlies,0,1,1610612742,Dallas Mavericks,1,0,33,23,56,11,23,34,44,46,90,9,2,11,16,32,27,9,15,93,108
2023,2,22300903,3/7/2024,1610612750,Minnesota Timberwolves,0,1,1610612754,Indiana Pacers,1,0,39,34,73,7,18,25,46,52,98,14,5,19,19,37,23,5,11,98,113
2020,2,22000837,4/14/2021,1610612742,Dallas Mavericks,0,1,1610612763,Memphis Grizzlies,1,0,31,17,48,13,27,40,44,44,88,13,4,17,12,36,25,7,11,97,114
2020,2,22000837,4/14/2021,1610612763,Memphis Grizzlies,1,0,1610612742,Dallas Mavericks,0,1,29,27,56,13,21,34,42,48,90,16,5,21,12,39,27,4,7,95,113
2023,2,22301094,4/2/2024,1610612747,Los Angeles Lakers,0,1,1610612761,Toronto Raptors,1,0,34,26,60,18,23,41,52,49,101,6,6,12,16,38,38,11,15,104,128
2023,2,22301094,4/2/2024,1610612761,Toronto Raptors,1,0,1610612747,Los Angeles Lakers,0,1,33,24,57,10,22,32,43,46,89,15,6,21,11,38,25,6,17,105,111
2023,2,22301071,3/29/2024,1610612750,Minnesota Timberwolves,0,1,1610612743,Denver Nuggets,1,0,29,17,46,9,19,28,38,36,74,26,11,37,6,34,28,6,9,94,111
2023,2,22301073,3/29/2024,1610612742,Dallas Mavericks,0,1,1610612758,Sacramento Kings,1,0,20,19,39,15,20,35,35,39,74,22,11,33,7,39,24,9,10,92,107
2021,2,22100100,11/1/2021,1610612743,Denver Nuggets,0,0,1610612763,Memphis Grizzlies,1,1,30,20,50,9,29,38,39,49,88,10,5,15,9,44,27,8,12,98,97
2021,2,22100100,11/1/2021,1610612763,Memphis Grizzlies,1,1,1610612743,Denver Nuggets,0,0,31,32,63,13,21,34,44,53,97,5,2,7,17,36,20,8,13,98,106
2023,2,22300277,12/1/2023,1610612742,Dallas Mavericks,1,0,1610612763,Memphis Grizzlies,0,1,22,31,53,12,27,39,34,58,92,14,7,21,19,44,27,8,12,94,94
2023,2,22301188,4/14/2024,1610612737,Atlanta Hawks,0,0,1610612754,Indiana Pacers,1,1,27,26,53,12,24,36,39,50,89,25,2,27,13,38,25,10,17,105,115
2023,2,22301150,4/9/2024,1610612753,Orlando Magic,0,0,1610612745,Houston Rockets,1,1,32,30,62,7,17,24,39,47,86,21,2,23,12,37,23,8,15,99,106
2023,2,22301058,3/27/2024,1610612759,San Antonio Spurs,0,1,1610612762,Utah Jazz,1,0,28,25,53,16,17,33,44,42,86,14,7,21,12,32,40,8,21,106,118
2023,2,22301145,4/9/2024,1610612755,Philadelphia 76ers,1,1,1610612765,Detroit Pistons,0,0,31,30,61,13,24,37,44,54,98,19,4,23,19,37,29,3,9,100,120
2023,2,22300929,3/10/2024,1610612758,Sacramento Kings,1,0,1610612745,Houston Rockets,0,1,33,21,54,6,26,32,39,47,86,20,3,23,9,39,24,8,13,100,104
2023,2,22301087,4/1/2024,1610612766,Charlotte Hornets,1,0,1610612738,Boston Celtics,0,1,28,26,54,13,24,37,41,50,91,9,2,11,9,42,28,3,7,93,104
2023,2,22301066,3/29/2024,1610612741,Chicago Bulls,0,0,1610612751,Brooklyn Nets,1,1,29,16,45,9,21,30,38,37,75,23,6,29,9,31,24,9,13,95,108
2023,2,22301095,4/2/2024,1610612749,Milwaukee Bucks,0,0,1610612764,Washington Wizards,1,1,34,21,55,11,37,48,45,58,103,12,6,18,19,41,31,9,12,103,113
2023,2,22301167,4/11/2024,1610612752,New York Knicks,0,1,1610612738,Boston Celtics,1,0,35,28,63,14,22,36,49,50,99,6,4,10,23,28,24,7,15,96,118
2023,2,22301170,4/11/2024,1610612740,New Orleans Pelicans,0,1,1610612758,Sacramento Kings,1,0,27,19,46,22,18,40,49,37,86,15,3,18,8,30,35,7,13,100,135
2023,2,22301148,4/9/2024,1610612738,Boston Celtics,0,0,1610612749,Milwaukee Bucks,1,1,20,21,41,17,35,52,37,56,93,0,0,0,16,40,27,6,12,89,91
2023,2,22301150,4/9/2024,1610612745,Houston Rockets,1,1,1610612753,Orlando Magic,0,0,30,21,51,15,20,35,45,41,86,13,5,18,9,33,29,9,12,99,118
2023,2,22301148,4/9/2024,1610612749,Milwaukee Bucks,1,1,1610612738,Boston Celtics,0,0,26,19,45,17,19,36,43,38,81,1,1,2,12,27,29,11,18,88,104
2023,2,22301058,3/27/2024,1610612762,Utah Jazz,1,0,1610612759,San Antonio Spurs,0,1,26,22,48,13,22,35,39,44,83,20,2,22,11,34,25,9,22,107,111
2023,2,22301062,3/29/2024,1610612766,Charlotte Hornets,1,0,1610612744,Golden State Warriors,0,1,22,16,38,12,34,46,34,50,84,17,7,24,13,41,23,7,11,94,97
2023,2,22301173,4/12/2024,1610612738,Boston Celtics,1,1,1610612766,Charlotte Hornets,0,0,40,23,63,14,27,41,54,50,104,9,4,13,18,33,34,3,6,98,131
2023,2,22301191,4/14/2024,1610612749,Milwaukee Bucks,0,0,1610612753,Orlando Magic,1,1,23,25,48,7,20,27,30,45,75,21,2,23,9,36,16,11,17,93,88
2023,2,22300276,12/1/2023,1610612752,New York Knicks,0,1,1610612761,Toronto Raptors,1,0,29,25,54,16,20,36,45,45,90,13,3,16,14,32,30,7,13,96,119
2023,2,22301169,4/11/2024,1610612744,Golden State Warriors,0,1,1610612757,Portland Trail Blazers,1,0,24,18,42,12,23,35,36,41,77,16,4,20,13,30,24,9,16,90,100
2023,2,22301087,4/1/2024,1610612738,Boston Celtics,0,1,1610612766,Charlotte Hornets,1,0,24,12,36,19,34,53,43,46,89,13,3,16,14,34,28,3,11,92,118
2023,2,22301180,4/12/2024,1610612759,San Antonio Spurs,1,1,1610612743,Denver Nuggets,0,0,30,22,52,15,18,33,45,40,85,16,7,23,15,29,31,9,18,99,121
2023,2,22301099,4/2/2024,1610612759,San Antonio Spurs,0,0,1610612743,Denver Nuggets,1,1,29,32,61,13,31,44,42,63,105,8,8,16,22,45,33,5,8,101,105
2023,2,22300276,12/1/2023,1610612761,Toronto Raptors,1,0,1610612752,New York Knicks,0,1,38,30,68,6,26,32,44,56,100,12,5,17,25,35,32,6,12,96,106
2023,2,22301178,4/12/2024,1610612737,Atlanta Hawks,0,0,1610612750,Minnesota Timberwolves,1,1,31,29,60,9,21,30,40,50,90,17,8,25,15,39,23,8,15,101,106
2023,2,22301114,4/4/2024,1610612743,Denver Nuggets,0,0,1610612746,LA Clippers,1,1,25,23,48,11,24,35,36,47,83,17,8,25,9,42,27,10,14,100,100
2023,2,22300862,3/1/2024,1610612758,Sacramento Kings,0,1,1610612750,Minnesota Timberwolves,1,0,39,32,71,11,18,29,50,50,100,13,11,24,18,38,29,4,8,102,124
2023,2,22300925,3/10/2024,1610612740,New Orleans Pelicans,0,1,1610612737,Atlanta Hawks,1,0,29,19,48,14,13,27,43,32,75,16,6,22,5,32,32,6,12,93,116
2023,2,22301174,4/12/2024,1610612739,Cleveland Cavaliers,1,1,1610612754,Indiana Pacers,0,0,37,26,63,13,19,32,50,45,95,16,7,23,14,34,28,7,11,101,129
2023,2,22301100,4/2/2024,1610612762,Utah Jazz,1,0,1610612739,Cleveland Cavaliers,0,1,25,23,48,16,21,37,41,44,85,15,3,18,14,32,26,10,20,99,113
2023,2,22301190,4/14/2024,1610612741,Chicago Bulls,0,0,1610612752,New York Knicks,1,1,41,29,70,8,23,31,49,52,101,13,3,16,16,38,25,7,12,104,119
2023,2,22301147,4/9/2024,1610612748,Miami Heat,0,1,1610612737,Atlanta Hawks,1,0,24,19,43,18,27,45,42,46,88,15,6,21,7,43,29,13,18,108,117
2023,2,22301093,4/2/2024,1610612755,Philadelphia 76ers,1,1,1610612760,Oklahoma City Thunder,0,0,22,26,48,14,16,30,36,42,78,23,2,25,11,33,27,10,18,97,109
2023,2,22301169,4/11/2024,1610612757,Portland Trail Blazers,1,0,1610612744,Golden State Warriors,0,1,27,36,63,8,26,34,35,62,97,14,3,17,27,37,22,8,13,91,92
2021,2,22100099,11/1/2021,1610612752,New York Knicks,1,0,1610612761,Toronto Raptors,0,1,19,19,38,16,22,38,35,41,76,18,6,24,9,36,20,12,17,96,104
2021,2,22100099,11/1/2021,1610612761,Toronto Raptors,0,1,1610612752,New York Knicks,1,0,29,28,57,14,28,42,43,56,99,13,1,14,19,37,24,3,9,97,113
2023,2,22301065,3/29/2024,1610612764,Washington Wizards,1,0,1610612765,Detroit Pistons,0,1,27,28,55,9,24,33,36,52,88,6,2,8,12,40,22,9,19,100,87
2023,2,22300293,12/11/2023,1610612754,Indiana Pacers,0,1,1610612765,Detroit Pistons,1,0,39,22,61,13,18,31,52,40,92,14,5,19,16,27,33,11,18,104,131
2016,2,21601066,3/22/2017,1610612752,New York Knicks,0,0,1610612762,Utah Jazz,1,1,29,30,59,9,12,21,38,42,80,16,2,18,12,31,19,5,12,89,101
2023,2,22301176,4/12/2024,1610612748,Miami Heat,1,1,1610612761,Toronto Raptors,0,0,28,17,45,17,24,41,45,41,86,18,5,23,9,35,37,1,7,96,125
2023,2,22301067,3/29/2024,1610612755,Philadelphia 76ers,0,0,1610612739,Cleveland Cavaliers,1,1,26,28,54,16,24,40,42,52,94,14,3,17,20,33,28,4,9,92,114
2023,2,22300927,3/10/2024,1610612752,New York Knicks,1,0,1610612755,Philadelphia 76ers,0,1,17,23,40,9,31,40,26,54,80,12,4,16,21,34,19,9,21,88,73
2023,2,22301147,4/9/2024,1610612737,Atlanta Hawks,1,0,1610612748,Miami Heat,0,1,35,32,67,10,36,46,45,68,113,11,3,14,26,45,28,8,16,110,111
2023,2,22301093,4/2/2024,1610612760,Oklahoma City Thunder,0,0,1610612755,Philadelphia 76ers,1,1,24,24,48,13,26,39,37,50,87,18,4,22,16,37,30,8,15,96,105
2023,2,22301200,4/14/2024,1610612757,Portland Trail Blazers,0,0,1610612758,Sacramento Kings,1,1,24,29,53,7,38,45,31,67,98,13,4,17,28,40,18,11,18,98,82
2023,2,22301170,4/11/2024,1610612758,Sacramento Kings,1,0,1610612740,New Orleans Pelicans,0,1,30,16,46,16,22,38,46,38,84,15,5,20,6,36,26,7,14,100,123
2023,2,22301173,4/12/2024,1610612766,Charlotte Hornets,0,0,1610612738,Boston Celtics,1,1,17,24,41,15,20,35,32,44,76,19,3,22,6,41,20,12,20,100,98
2023,2,22301100,4/2/2024,1610612739,Cleveland Cavaliers,0,1,1610612762,Utah Jazz,1,0,30,16,46,16,23,39,46,39,85,21,3,24,13,26,38,7,15,99,129
2023,2,22301114,4/4/2024,1610612746,LA Clippers,1,1,1610612743,Denver Nuggets,0,0,27,30,57,7,26,33,34,56,90,27,5,32,12,47,22,3,7,100,102
2023,2,22301063,3/29/2024,1610612754,Indiana Pacers,1,1,1610612747,Los Angeles Lakers,0,0,33,25,58,10,21,31,43,46,89,13,1,14,8,39,27,3,10,98,109
2023,2,22300822,2/25/2024,1610612760,Oklahoma City Thunder,0,1,1610612745,Houston Rockets,1,0,29,33,62,17,18,35,46,51,97,14,1,15,13,39,30,6,12,103,123
2023,2,22300821,2/25/2024,1610612753,Orlando Magic,0,0,1610612737,Atlanta Hawks,1,1,21,25,46,14,24,38,35,49,84,8,10,18,17,37,23,10,20,96,92
2022,2,22201199,4/6/2023,1610612759,San Antonio Spurs,1,1,1610612757,Portland Trail Blazers,0,0,37,34,71,10,25,35,47,59,106,25,3,28,25,35,29,7,15,105,129
2023,2,22301172,4/12/2024,1610612741,Chicago Bulls,0,1,1610612764,Washington Wizards,1,0,34,29,63,14,21,35,48,50,98,19,9,28,19,36,28,6,13,104,129
2023,2,22301096,4/2/2024,1610612748,Miami Heat,1,1,1610612752,New York Knicks,0,0,19,17,36,17,21,38,36,38,74,20,1,21,11,27,24,11,18,92,109
2023,2,22300843,2/28/2024,1610612740,New Orleans Pelicans,0,0,1610612754,Indiana Pacers,1,1,31,30,61,11,18,29,42,48,90,19,4,23,11,39,26,5,10,100,114
2023,2,22300843,2/28/2024,1610612754,Indiana Pacers,1,1,1610612740,New Orleans Pelicans,0,0,36,28,64,14,24,38,50,52,102,9,0,9,17,35,34,2,10,100,123
2023,2,22301199,4/14/2024,1610612745,Houston Rockets,0,1,1610612746,LA Clippers,1,0,39,26,65,11,27,38,50,53,103,5,9,14,21,37,31,13,18,106,116
2023,2,22301199,4/14/2024,1610612746,LA Clippers,1,0,1610612745,Houston Rockets,0,1,33,34,67,8,29,37,41,63,104,15,2,17,18,45,23,7,12,106,105
2023,2,22301174,4/12/2024,1610612754,Indiana Pacers,0,0,1610612739,Cleveland Cavaliers,1,1,37,20,57,9,23,32,46,43,89,19,3,22,12,32,37,9,14,101,120
2023,2,22301176,4/12/2024,1610612761,Toronto Raptors,0,0,1610612748,Miami Heat,1,1,27,19,46,10,21,31,37,40,77,19,3,22,8,33,23,7,17,96,103
2023,2,22301096,4/2/2024,1610612752,New York Knicks,0,0,1610612748,Miami Heat,1,1,23,19,42,12,22,34,35,41,76,17,4,21,9,35,25,5,14,91,99
2023,2,22301171,4/12/2024,1610612755,Philadelphia 76ers,1,1,1610612753,Orlando Magic,0,0,24,27,51,18,19,37,42,46,88,23,5,28,11,38,22,7,13,102,125
2023,2,22301175,4/12/2024,1610612751,Brooklyn Nets,0,0,1610612752,New York Knicks,1,1,30,20,50,11,21,32,41,41,82,14,5,19,17,25,22,10,14,88,107
2023,2,22300292,12/11/2023,1610612748,Miami Heat,0,1,1610612766,Charlotte Hornets,1,0,22,20,42,15,20,35,37,40,77,27,7,34,10,31,31,3,11,93,116
2022,2,22201199,4/6/2023,1610612757,Portland Trail Blazers,0,0,1610612759,San Antonio Spurs,1,1,41,27,68,10,18,28,51,45,96,15,3,18,14,33,34,9,16,106,127
2023,2,22301064,3/29/2024,1610612746,LA Clippers,0,1,1610612753,Orlando Magic,1,0,33,28,61,8,16,24,41,44,85,10,2,12,16,29,19,10,17,93,100
2023,2,22301177,4/12/2024,1610612747,Los Angeles Lakers,0,1,1610612763,Memphis Grizzlies,1,0,29,15,44,13,24,37,42,39,81,26,8,34,13,27,25,14,19,101,123
2023,2,22301194,4/14/2024,1610612756,Phoenix Suns,0,1,1610612750,Minnesota Timberwolves,1,0,31,26,57,16,13,29,47,39,86,15,3,18,15,26,28,7,13,91,125
2023,2,22301180,4/12/2024,1610612743,Denver Nuggets,0,0,1610612759,San Antonio Spurs,1,1,36,25,61,13,23,36,49,48,97,9,1,10,10,39,31,2,9,100,120
2022,2,22200582,1/6/2023,1610612752,New York Knicks,0,1,1610612761,Toronto Raptors,1,0,23,23,46,16,21,37,39,44,83,18,8,26,16,34,19,7,13,92,112
2022,2,22200582,1/6/2023,1610612761,Toronto Raptors,1,0,1610612752,New York Knicks,0,1,25,29,54,10,19,29,35,48,83,28,7,35,13,40,22,3,7,93,108
2023,2,22300879,3/4/2024,1610612763,Memphis Grizzlies,0,1,1610612751,Brooklyn Nets,1,0,26,19,45,12,25,37,38,44,82,18,4,22,21,24,26,10,19,91,106
2023,2,22300862,3/1/2024,1610612750,Minnesota Timberwolves,1,0,1610612758,Sacramento Kings,0,1,30,24,54,12,19,31,42,43,85,24,8,32,14,32,29,8,13,102,120
2023,2,22300918,3/9/2024,1610612766,Charlotte Hornets,1,1,1610612751,Brooklyn Nets,0,0,33,18,51,11,19,30,44,37,81,11,4,15,13,26,26,4,17,92,110
2023,2,22300294,12/11/2023,1610612753,Orlando Magic,1,1,1610612739,Cleveland Cavaliers,0,0,32,26,58,7,19,26,39,45,84,19,6,25,18,30,22,10,14,90,104
2023,2,22301175,4/12/2024,1610612752,New York Knicks,1,1,1610612751,Brooklyn Nets,0,0,24,29,53,14,16,30,38,45,83,21,4,25,13,33,21,3,5,89,111
2023,2,22301066,3/29/2024,1610612751,Brooklyn Nets,1,1,1610612741,Chicago Bulls,0,0,18,29,47,25,19,44,43,48,91,14,8,22,14,39,26,3,7,94,125
2023,2,22300844,2/28/2024,1610612742,Dallas Mavericks,0,1,1610612761,Toronto Raptors,1,0,37,16,53,15,28,43,52,44,96,17,4,21,15,33,32,11,16,106,136
2023,2,22300844,2/28/2024,1610612761,Toronto Raptors,1,0,1610612742,Dallas Mavericks,0,1,33,30,63,13,22,35,46,52,98,20,10,30,18,40,34,7,12,106,125
2023,2,22301172,4/12/2024,1610612764,Washington Wizards,1,0,1610612741,Chicago Bulls,0,1,27,16,43,18,25,43,45,41,86,19,10,29,6,41,32,9,12,105,127
2023,2,22300292,12/11/2023,1610612766,Charlotte Hornets,1,0,1610612748,Miami Heat,0,1,23,20,43,17,24,41,40,44,84,17,5,22,11,37,31,7,11,95,114
2023,2,22300918,3/9/2024,1610612751,Brooklyn Nets,0,0,1610612766,Charlotte Hornets,1,1,22,26,48,14,28,42,36,54,90,13,4,17,19,37,22,9,16,93,99
2023,2,22300904,3/7/2024,1610612748,Miami Heat,0,0,1610612742,Dallas Mavericks,1,1,23,21,44,17,21,38,40,42,82,11,6,17,8,37,30,5,12,95,108
2023,2,22300904,3/7/2024,1610612742,Dallas Mavericks,1,1,1610612748,Miami Heat,0,0,24,22,46,16,25,41,40,47,87,18,5,23,14,36,27,7,10,94,114
2021,2,22100098,11/1/2021,1610612738,Boston Celtics,1,0,1610612741,Chicago Bulls,0,1,27,36,63,15,18,33,42,54,96,15,5,20,15,42,20,7,9,100,114
2021,2,22100098,11/1/2021,1610612741,Chicago Bulls,0,1,1610612738,Boston Celtics,1,0,36,19,55,13,18,31,49,37,86,17,1,18,12,25,30,10,18,100,128
2022,2,22200450,12/18/2022,1610612743,Denver Nuggets,1,1,1610612766,Charlotte Hornets,0,0,32,29,61,11,22,33,43,51,94,22,12,34,19,37,33,7,14,108,119
2022,2,22200450,12/18/2022,1610612766,Charlotte Hornets,0,0,1610612743,Denver Nuggets,1,1,29,29,58,12,26,38,41,55,96,21,2,23,12,43,26,6,11,107,115
2023,2,22301065,3/29/2024,1610612765,Detroit Pistons,0,1,1610612764,Washington Wizards,1,0,31,34,65,6,18,24,37,52,89,16,4,20,11,42,19,2,13,99,96
2023,2,22301171,4/12/2024,1610612753,Orlando Magic,0,0,1610612755,Philadelphia 76ers,1,1,35,33,68,8,19,27,43,52,95,19,6,25,15,40,25,6,11,103,113
2023,2,22300841,2/27/2024,1610612745,Houston Rockets,0,0,1610612760,Oklahoma City Thunder,1,1,28,28,56,9,30,39,37,58,95,12,6,18,16,44,22,7,15,102,95
2019,2,21900237,11/24/2019,1610612758,Sacramento Kings,0,1,1610612764,Washington Wizards,1,0,28,22,50,11,20,31,39,42,81,24,4,28,9,35,22,5,14,100,113
2019,2,21900237,11/24/2019,1610612764,Washington Wizards,1,0,1610612758,Sacramento Kings,0,1,29,29,58,13,21,34,42,50,92,9,3,12,15,36,29,9,17,99,106
2023,2,22301197,4/14/2024,1610612765,Detroit Pistons,0,0,1610612759,San Antonio Spurs,1,1,28,31,59,8,25,33,36,56,92,15,5,20,16,42,17,9,14,100,95
2023,2,22301178,4/12/2024,1610612750,Minnesota Timberwolves,1,1,1610612737,Atlanta Hawks,0,0,28,14,42,10,27,37,38,41,79,23,6,29,8,37,29,4,14,100,109
2019,2,21900019,10/25/2019,1610612751,Brooklyn Nets,1,1,1610612752,New York Knicks,0,0,21,20,41,16,21,37,37,41,78,23,11,34,13,34,21,14,26,108,113
2019,2,21900019,10/25/2019,1610612752,New York Knicks,0,0,1610612751,Brooklyn Nets,1,1,21,35,56,17,8,25,38,43,81,16,12,28,12,38,17,11,26,108,109
2020,2,22000836,4/14/2021,1610612744,Golden State Warriors,0,1,1610612760,Oklahoma City Thunder,1,0,28,20,48,24,23,47,52,43,95,19,4,23,10,35,39,6,14,105,147
2020,2,22000836,4/14/2021,1610612760,Oklahoma City Thunder,1,0,1610612744,Golden State Warriors,0,1,37,28,65,7,20,27,44,48,92,14,11,25,20,33,22,12,21,106,109
2023,2,22300842,2/27/2024,1610612757,Portland Trail Blazers,1,0,1610612748,Miami Heat,0,1,25,30,55,10,21,31,35,51,86,16,3,19,21,31,24,8,18,93,96
2023,2,22300842,2/27/2024,1610612748,Miami Heat,0,1,1610612757,Portland Trail Blazers,1,0,23,21,44,14,12,26,37,33,70,18,8,26,9,27,29,9,20,92,106
2023,2,22300841,2/27/2024,1610612760,Oklahoma City Thunder,1,1,1610612745,Houston Rockets,0,0,34,32,66,10,17,27,44,49,93,14,4,18,14,37,19,5,15,102,112
2023,2,22301116,4/5/2024,1610612760,Oklahoma City Thunder,0,0,1610612754,Indiana Pacers,1,1,34,22,56,8,22,30,42,44,86,20,4,24,10,36,24,8,15,101,112
2023,2,22300824,2/25/2024,1610612743,Denver Nuggets,0,1,1610612744,Golden State Warriors,1,0,32,24,56,11,21,32,43,45,88,22,4,26,13,34,29,5,10,97,119
2023,2,22301194,4/14/2024,1610612750,Minnesota Timberwolves,1,0,1610612756,Phoenix Suns,0,1,27,17,44,9,17,26,36,34,70,25,6,31,14,21,22,13,24,93,106
2023,2,22300824,2/25/2024,1610612744,Golden State Warriors,1,0,1610612743,Denver Nuggets,0,1,24,23,47,11,23,34,35,46,81,22,7,29,15,35,27,10,17,97,103
2023,2,22300822,2/25/2024,1610612745,Houston Rockets,1,0,1610612760,Oklahoma City Thunder,0,1,22,30,52,16,25,41,38,55,93,18,5,23,19,39,18,12,18,103,110
2023,2,22301177,4/12/2024,1610612763,Memphis Grizzlies,1,0,1610612747,Los Angeles Lakers,0,1,26,30,56,17,22,39,43,52,95,17,4,21,19,34,19,5,15,101,120
2023,2,22301196,4/14/2024,1610612742,Dallas Mavericks,0,0,1610612760,Oklahoma City Thunder,1,1,24,34,58,8,31,39,32,65,97,14,3,17,16,52,19,6,15,104,86
2023,2,22300894,3/6/2024,1610612764,Washington Wizards,1,0,1610612753,Orlando Magic,0,1,28,22,50,12,26,38,40,48,88,17,3,20,11,37,26,4,9,95,109
2023,2,22300275,12/1/2023,1610612738,Boston Celtics,1,1,1610612755,Philadelphia 76ers,0,0,23,21,44,16,17,33,39,38,77,31,5,36,11,29,25,16,20,102,125
2023,2,22301068,3/29/2024,1610612748,Miami Heat,1,1,1610612757,Portland Trail Blazers,0,0,33,20,53,21,18,39,54,38,92,13,5,18,8,33,41,4,9,102,142
2023,2,22300880,3/4/2024,1610612746,LA Clippers,0,0,1610612749,Milwaukee Bucks,1,1,21,23,44,16,24,40,37,47,84,16,9,25,11,40,25,8,14,98,106
2023,2,22301179,4/12/2024,1610612749,Milwaukee Bucks,0,0,1610612760,Oklahoma City Thunder,1,1,31,24,55,11,19,30,42,43,85,12,1,13,11,32,27,13,19,99,107
2023,2,22300589,4/2/2024,1610612742,Dallas Mavericks,0,0,1610612744,Golden State Warriors,1,1,24,25,49,15,25,40,39,50,89,7,4,11,9,44,27,9,15,100,100
2023,2,22301191,4/14/2024,1610612753,Orlando Magic,1,1,1610612749,Milwaukee Bucks,0,0,31,19,50,11,24,35,42,43,85,18,1,19,15,29,27,10,14,94,113
2023,2,22301116,4/5/2024,1610612754,Indiana Pacers,1,1,1610612760,Oklahoma City Thunder,0,0,31,22,53,15,20,35,46,42,88,19,2,21,10,34,30,8,14,101,126
2023,2,22300880,3/4/2024,1610612749,Milwaukee Bucks,1,1,1610612746,LA Clippers,0,0,22,18,40,15,23,38,37,41,78,24,4,28,7,35,20,9,12,96,113
2023,2,22301069,3/29/2024,1610612756,Phoenix Suns,0,0,1610612760,Oklahoma City Thunder,1,1,26,20,46,13,28,41,39,48,87,12,3,15,14,36,26,7,14,94,103
2023,2,22300919,3/9/2024,1610612742,Dallas Mavericks,0,1,1610612765,Detroit Pistons,1,0,37,17,54,14,24,38,51,41,92,26,6,32,7,37,29,8,14,109,142
2023,2,22301179,4/12/2024,1610612760,Oklahoma City Thunder,1,1,1610612749,Milwaukee Bucks,0,0,34,17,51,13,25,38,47,42,89,18,2,20,9,34,29,7,10,98,125
2023,2,22301193,4/14/2024,1610612743,Denver Nuggets,0,1,1610612763,Memphis Grizzlies,1,0,34,19,53,12,24,36,46,43,89,22,4,26,18,28,32,9,18,103,126
2023,2,22301187,4/14/2024,1610612739,Cleveland Cavaliers,1,0,1610612766,Charlotte Hornets,0,1,28,32,60,16,17,33,44,49,93,6,3,9,14,38,30,10,14,96,110
2023,2,22300881,3/4/2024,1610612757,Portland Trail Blazers,0,0,1610612750,Minnesota Timberwolves,1,1,29,24,53,16,23,39,45,47,92,8,3,11,18,31,28,9,14,92,114
2023,2,22300275,12/1/2023,1610612755,Philadelphia 76ers,0,0,1610612738,Boston Celtics,1,1,27,32,59,16,19,35,43,51,94,17,6,23,17,38,16,10,16,103,119
2023,2,22301067,3/29/2024,1610612739,Cleveland Cavaliers,1,1,1610612755,Philadelphia 76ers,0,0,29,16,45,16,21,37,45,37,82,11,2,13,10,28,34,6,14,90,117
2023,2,22300881,3/4/2024,1610612750,Minnesota Timberwolves,1,1,1610612757,Portland Trail Blazers,0,0,29,22,51,11,17,28,40,39,79,28,9,37,14,29,28,5,11,92,119
2023,2,22301117,4/5/2024,1610612764,Washington Wizards,1,0,1610612757,Portland Trail Blazers,0,1,33,22,55,5,28,33,38,50,88,21,9,30,14,41,24,7,10,96,102
2023,2,22301192,4/14/2024,1610612755,Philadelphia 76ers,1,1,1610612751,Brooklyn Nets,0,0,27,25,52,14,30,44,41,55,96,11,4,15,19,39,30,8,14,99,107
2023,2,22301198,4/14/2024,1610612762,Utah Jazz,0,0,1610612744,Golden State Warriors,1,1,32,23,55,14,20,34,46,43,89,10,6,16,16,32,22,10,20,98,116
2023,2,22301190,4/14/2024,1610612752,New York Knicks,1,1,1610612741,Chicago Bulls,0,0,34,25,59,12,20,32,46,45,91,16,5,21,19,29,27,15,21,104,120
2023,2,22301198,4/14/2024,1610612744,Golden State Warriors,1,1,1610612762,Utah Jazz,0,0,31,20,51,14,29,43,45,49,94,19,4,23,15,36,35,6,9,98,123
2023,2,22300919,3/9/2024,1610612765,Detroit Pistons,1,0,1610612742,Dallas Mavericks,0,1,32,30,62,13,24,37,45,54,99,21,4,25,22,34,27,13,20,108,124
2023,2,22300860,3/1/2024,1610612761,Toronto Raptors,1,0,1610612744,Golden State Warriors,0,1,29,21,50,12,33,45,41,54,95,11,6,17,14,42,31,10,14,104,105
2023,2,22300894,3/6/2024,1610612753,Orlando Magic,0,1,1610612764,Washington Wizards,1,0,32,23,55,12,15,27,44,38,82,19,2,21,13,27,21,7,15,96,119
2023,2,22300278,12/1/2023,1610612740,New Orleans Pelicans,1,1,1610612759,San Antonio Spurs,0,0,32,22,54,10,21,31,42,43,85,27,2,29,12,32,26,5,12,99,121
2022,2,22201201,4/6/2023,1610612743,Denver Nuggets,0,0,1610612756,Phoenix Suns,1,1,36,24,60,8,15,23,44,39,83,19,4,23,15,27,24,4,13,93,115
2023,2,22301200,4/14/2024,1610612758,Sacramento Kings,1,1,1610612757,Portland Trail Blazers,0,0,30,23,53,13,21,34,43,44,87,22,5,27,15,32,29,11,14,98,121
2023,2,22301189,4/14/2024,1610612761,Toronto Raptors,0,0,1610612748,Miami Heat,1,1,29,27,56,9,25,34,38,52,90,18,3,21,19,35,23,13,19,99,103
2023,2,22301115,4/5/2024,1610612753,Orlando Magic,0,0,1610612766,Charlotte Hornets,1,1,33,23,56,9,29,38,42,52,94,22,4,26,20,34,24,6,10,96,115
2023,2,22300825,2/25/2024,1610612759,San Antonio Spurs,0,0,1610612762,Utah Jazz,1,1,29,31,60,13,18,31,42,49,91,12,7,19,12,41,34,13,20,108,109
2023,2,22300845,2/28/2024,1610612763,Memphis Grizzlies,0,0,1610612750,Minnesota Timberwolves,1,1,25,31,56,11,26,37,36,57,93,18,2,20,19,38,23,4,15,98,101
2023,2,22301193,4/14/2024,1610612763,Memphis Grizzlies,1,0,1610612743,Denver Nuggets,0,1,37,30,67,8,25,33,45,55,100,13,5,18,19,38,22,9,13,102,111
2022,2,22201200,4/6/2023,1610612760,Oklahoma City Thunder,0,1,1610612762,Utah Jazz,1,0,24,28,52,15,30,45,39,58,97,21,5,26,21,40,29,5,13,103,114
2022,2,22201197,4/6/2023,1610612739,Cleveland Cavaliers,0,1,1610612753,Orlando Magic,1,0,28,22,50,18,20,38,46,42,88,8,1,9,10,32,31,8,17,99,118
2023,2,22301115,4/5/2024,1610612766,Charlotte Hornets,1,1,1610612753,Orlando Magic,0,0,28,14,42,15,15,30,43,29,72,23,0,23,6,23,29,9,20,95,124
2023,2,22300278,12/1/2023,1610612759,San Antonio Spurs,0,0,1610612740,New Orleans Pelicans,1,1,22,22,44,16,23,39,38,45,83,14,3,17,13,33,28,8,20,99,106
2023,2,22300294,12/11/2023,1610612739,Cleveland Cavaliers,0,0,1610612753,Orlando Magic,1,1,21,24,45,9,31,40,30,55,85,25,8,33,23,36,15,7,14,91,94
2023,2,22300845,2/28/2024,1610612750,Minnesota Timberwolves,1,1,1610612763,Memphis Grizzlies,0,0,25,19,44,14,21,35,39,40,79,18,4,22,5,38,29,8,14,97,110
2022,2,22201201,4/6/2023,1610612756,Phoenix Suns,1,1,1610612743,Denver Nuggets,0,0,24,19,43,17,19,36,41,38,79,20,5,25,10,31,26,7,10,94,119
2023,2,22300869,3/2/2024,1610612747,Los Angeles Lakers,1,0,1610612743,Denver Nuggets,0,1,35,25,60,12,17,29,47,42,89,8,3,11,7,38,33,5,7,94,114
2023,2,22301197,4/14/2024,1610612759,San Antonio Spurs,1,1,1610612765,Detroit Pistons,0,0,34,23,57,15,19,34,49,42,91,10,4,14,12,32,33,7,14,99,123
2023,2,22301196,4/14/2024,1610612760,Oklahoma City Thunder,1,1,1610612742,Dallas Mavericks,0,0,40,23,63,14,20,34,54,43,97,13,3,16,14,31,38,8,15,104,135
2023,2,22301117,4/5/2024,1610612757,Portland Trail Blazers,0,1,1610612764,Washington Wizards,1,0,32,33,65,9,20,29,41,53,94,17,7,24,22,34,29,9,13,97,108
2023,2,22300885,3/5/2024,1610612753,Orlando Magic,0,1,1610612766,Charlotte Hornets,1,0,27,12,39,13,22,35,40,34,74,8,7,15,9,29,23,7,18,91,101
2023,2,22300825,2/25/2024,1610612762,Utah Jazz,1,1,1610612759,San Antonio Spurs,0,0,29,26,55,17,18,35,46,44,90,19,3,22,9,37,36,8,17,108,128
2023,2,22300826,2/25/2024,1610612766,Charlotte Hornets,0,1,1610612757,Portland Trail Blazers,1,0,30,21,51,7,17,24,37,38,75,12,5,17,6,37,24,11,19,95,93
2023,2,22301195,4/14/2024,1610612740,New Orleans Pelicans,1,0,1610612747,Los Angeles Lakers,0,1,26,23,49,15,22,37,41,45,86,11,3,14,11,36,26,12,19,101,108
2023,2,22300885,3/5/2024,1610612766,Charlotte Hornets,1,0,1610612753,Orlando Magic,0,1,21,18,39,12,21,33,33,39,72,11,0,11,4,35,19,9,19,89,89
2023,2,22300868,3/2/2024,1610612757,Portland Trail Blazers,0,1,1610612763,Memphis Grizzlies,1,0,28,29,57,11,24,35,39,53,92,18,6,24,17,38,23,15,23,108,107
2023,2,22300826,2/25/2024,1610612757,Portland Trail Blazers,1,0,1610612766,Charlotte Hornets,0,1,30,33,63,3,29,32,33,62,95,11,5,16,24,40,14,12,16,96,80
2023,2,22301195,4/14/2024,1610612747,Los Angeles Lakers,0,1,1610612740,New Orleans Pelicans,1,0,37,21,58,11,18,29,48,39,87,17,1,18,9,30,32,8,15,102,124
2023,2,22300853,2/29/2024,1610612759,San Antonio Spurs,1,1,1610612760,Oklahoma City Thunder,0,0,29,23,52,19,20,39,48,43,91,17,3,20,13,31,39,6,12,98,132
2023,2,22300853,2/29/2024,1610612760,Oklahoma City Thunder,0,0,1610612759,San Antonio Spurs,1,1,35,23,58,9,22,31,44,45,89,21,1,22,11,35,20,6,11,99,118
2023,2,22300895,3/6/2024,1610612737,Atlanta Hawks,1,1,1610612739,Cleveland Cavaliers,0,0,32,22,54,11,19,30,43,41,84,15,5,20,9,36,27,5,11,94,112
2023,2,22300870,3/2/2024,1610612756,Phoenix Suns,1,0,1610612745,Houston Rockets,0,1,30,26,56,9,20,29,39,46,85,22,7,29,10,40,23,13,19,107,109
2023,2,22300870,3/2/2024,1610612745,Houston Rockets,0,1,1610612756,Phoenix Suns,1,0,26,28,54,16,26,42,42,54,96,18,8,26,15,42,27,6,13,106,118
2023,2,22300868,3/2/2024,1610612763,Memphis Grizzlies,1,0,1610612757,Portland Trail Blazers,0,1,15,28,43,15,25,40,30,53,83,25,8,33,16,41,21,8,24,107,100
2023,2,22300874,3/3/2024,1610612753,Orlando Magic,1,1,1610612765,Detroit Pistons,0,0,36,13,49,7,16,23,43,29,72,20,5,25,9,23,24,11,22,97,113
2023,2,22300875,3/3/2024,1610612766,Charlotte Hornets,0,0,1610612761,Toronto Raptors,1,1,35,30,65,8,19,27,43,49,92,12,4,16,13,36,24,8,17,104,106
2023,2,22300833,2/27/2024,1610612753,Orlando Magic,1,1,1610612751,Brooklyn Nets,0,0,30,19,49,9,16,25,39,35,74,21,4,25,9,29,20,10,19,94,108
2023,2,22300895,3/6/2024,1610612739,Cleveland Cavaliers,0,0,1610612737,Atlanta Hawks,1,1,29,16,45,10,34,44,39,50,89,13,4,17,17,35,27,7,15,96,101
2023,2,22300874,3/3/2024,1610612765,Detroit Pistons,0,0,1610612753,Orlando Magic,1,1,25,25,50,8,28,36,33,53,86,17,3,20,10,44,25,7,12,96,91
2023,2,22300827,2/25/2024,1610612746,LA Clippers,1,0,1610612758,Sacramento Kings,0,1,32,23,55,8,19,27,40,42,82,19,1,20,14,28,23,10,16,93,107
2022,2,22200649,1/15/2023,1610612745,Houston Rockets,0,0,1610612746,LA Clippers,1,1,31,22,53,7,24,31,38,46,84,17,6,23,13,37,22,13,20,101,100
2022,2,22200649,1/15/2023,1610612746,LA Clippers,1,1,1610612745,Houston Rockets,0,0,32,24,56,14,18,32,46,42,88,15,6,21,13,32,21,8,17,101,121
2023,2,22300297,12/11/2023,1610612752,New York Knicks,1,1,1610612761,Toronto Raptors,0,0,35,22,57,17,12,29,52,34,86,15,8,23,15,24,36,12,15,98,136
2023,2,22300832,2/27/2024,1610612739,Cleveland Cavaliers,1,1,1610612742,Dallas Mavericks,0,0,24,19,43,20,20,40,44,39,83,13,5,18,10,31,35,11,16,97,121
2023,2,22300827,2/25/2024,1610612758,Sacramento Kings,0,1,1610612746,LA Clippers,1,0,30,24,54,15,22,37,45,46,91,18,4,22,20,29,29,7,10,93,123
2023,2,22300869,3/2/2024,1610612743,Denver Nuggets,0,1,1610612747,Los Angeles Lakers,1,0,43,23,66,11,15,26,54,38,92,5,2,7,13,26,34,5,10,93,124
2023,2,22300832,2/27/2024,1610612742,Dallas Mavericks,0,0,1610612739,Cleveland Cavaliers,1,1,34,24,58,14,19,33,48,43,91,9,6,15,7,41,23,2,5,96,119
2021,2,22100097,11/1/2021,1610612737,Atlanta Hawks,1,1,1610612764,Washington Wizards,0,0,25,24,49,13,21,34,38,45,83,29,0,29,15,30,24,7,11,95,118
2021,2,22100097,11/1/2021,1610612764,Washington Wizards,0,0,1610612737,Atlanta Hawks,1,1,28,19,47,13,26,39,41,45,86,16,0,16,10,35,27,9,12,94,111
2023,2,22300296,12/11/2023,1610612737,Atlanta Hawks,1,0,1610612743,Denver Nuggets,0,1,27,25,52,17,27,44,44,52,96,17,1,18,17,36,25,9,10,98,122
2023,2,22300846,2/28/2024,1610612739,Cleveland Cavaliers,0,0,1610612741,Chicago Bulls,1,1,23,27,50,22,32,54,45,59,104,11,8,19,11,53,37,6,12,116,123
2023,2,22300846,2/28/2024,1610612741,Chicago Bulls,1,1,1610612739,Cleveland Cavaliers,0,0,31,42,73,13,24,37,44,66,110,31,7,38,32,36,29,7,19,116,132
2016,2,21601066,3/22/2017,1610612762,Utah Jazz,1,1,1610612752,New York Knicks,0,0,34,28,62,7,21,28,41,49,90,19,10,29,23,31,18,5,8,88,108
2020,2,22000835,4/14/2021,1610612740,New Orleans Pelicans,1,0,1610612752,New York Knicks,0,1,34,26,60,6,22,28,40,48,88,20,4,24,11,39,25,6,9,95,106
2020,2,22000835,4/14/2021,1610612752,New York Knicks,0,1,1610612740,New Orleans Pelicans,1,0,27,37,64,17,16,33,44,53,97,11,2,13,13,42,19,3,6,95,116
2023,2,22300882,3/4/2024,1610612764,Washington Wizards,0,0,1610612762,Utah Jazz,1,1,24,32,56,16,22,38,40,54,94,19,4,23,15,42,26,6,15,105,115
2023,2,22300834,2/27/2024,1610612764,Washington Wizards,1,0,1610612744,Golden State Warriors,0,1,34,24,58,12,23,35,46,47,93,8,2,10,13,35,34,12,21,104,112
2023,2,22300882,3/4/2024,1610612762,Utah Jazz,1,1,1610612764,Washington Wizards,0,0,33,28,61,16,24,40,49,52,101,13,2,15,16,38,29,6,13,105,127
2023,2,22300297,12/11/2023,1610612761,Toronto Raptors,0,0,1610612752,New York Knicks,1,1,33,24,57,14,25,39,47,49,96,22,8,30,21,32,32,5,10,99,130
2023,2,22300896,3/6/2024,1610612755,Philadelphia 76ers,1,0,1610612763,Memphis Grizzlies,0,1,26,41,67,13,22,35,39,63,102,18,3,21,25,39,25,3,11,97,109
2021,2,22100096,11/1/2021,1610612755,Philadelphia 76ers,1,1,1610612757,Portland Trail Blazers,0,0,30,17,47,13,23,36,43,40,83,14,2,16,8,33,34,5,11,92,113
2021,2,22100096,11/1/2021,1610612757,Portland Trail Blazers,0,0,1610612755,Philadelphia 76ers,1,1,28,22,50,12,22,34,40,44,84,11,7,18,16,31,21,11,15,92,103
2023,2,22300852,2/29/2024,1610612744,Golden State Warriors,0,1,1610612752,New York Knicks,1,0,30,24,54,14,30,44,44,54,98,8,8,16,18,42,26,7,11,97,110
2023,2,22300834,2/27/2024,1610612744,Golden State Warriors,0,1,1610612764,Washington Wizards,1,0,26,22,48,21,25,46,47,47,94,8,3,11,16,31,39,5,19,105,123
2023,2,22300858,3/1/2024,1610612755,Philadelphia 76ers,1,1,1610612766,Charlotte Hornets,0,0,27,25,52,19,25,44,46,50,96,10,1,11,22,29,38,5,7,86,121
2023,2,22300896,3/6/2024,1610612763,Memphis Grizzlies,0,1,1610612755,Philadelphia 76ers,1,0,28,26,54,13,24,37,41,50,91,20,3,23,20,32,21,11,15,96,115
2022,2,22200573,1/4/2023,1610612744,Golden State Warriors,1,0,1610612765,Detroit Pistons,0,1,30,17,47,15,25,40,45,42,87,14,1,15,10,32,31,9,14,98,119
2022,2,22200573,1/4/2023,1610612765,Detroit Pistons,0,1,1610612744,Golden State Warriors,1,0,29,27,56,16,20,36,45,47,92,16,7,23,14,35,29,3,10,98,122
2023,2,22300847,2/28/2024,1610612743,Denver Nuggets,1,1,1610612758,Sacramento Kings,0,0,31,20,51,15,20,35,46,40,86,10,1,11,10,31,35,8,16,97,117
2023,2,22300847,2/28/2024,1610612758,Sacramento Kings,0,0,1610612743,Denver Nuggets,1,1,26,34,60,12,23,35,38,57,95,8,5,13,18,42,28,10,14,98,96
2023,2,22300298,12/11/2023,1610612759,San Antonio Spurs,0,0,1610612745,Houston Rockets,1,1,26,20,46,5,36,41,31,56,87,15,7,22,13,46,20,7,17,102,82
2019,2,21900018,10/25/2019,1610612750,Minnesota Timberwolves,0,1,1610612766,Charlotte Hornets,1,0,31,22,53,12,26,38,43,48,91,23,8,31,17,35,30,6,17,105,121
2023,2,22300296,12/11/2023,1610612743,Denver Nuggets,0,1,1610612737,Atlanta Hawks,1,0,35,24,59,12,17,29,47,41,88,23,6,29,17,24,29,9,16,98,129
2019,2,21900018,10/25/2019,1610612766,Charlotte Hornets,1,0,1610612750,Minnesota Timberwolves,0,1,25,30,55,12,17,29,37,47,84,13,13,26,12,43,26,11,20,105,99
2023,2,22300835,2/27/2024,1610612737,Atlanta Hawks,1,1,1610612762,Utah Jazz,0,0,34,27,61,12,20,32,46,47,93,20,3,23,17,31,27,11,18,104,124
2023,2,22300302,12/11/2023,1610612760,Oklahoma City Thunder,1,1,1610612762,Utah Jazz,0,0,32,26,58,18,20,38,50,46,96,16,1,17,11,36,35,9,12,104,134
2023,2,22300299,12/11/2023,1610612742,Dallas Mavericks,0,1,1610612763,Memphis Grizzlies,1,0,26,20,46,17,23,40,43,43,86,17,2,19,14,30,27,9,17,99,120
2023,2,22300298,12/11/2023,1610612745,Houston Rockets,1,1,1610612759,San Antonio Spurs,0,0,20,34,54,12,27,39,32,61,93,17,3,20,18,44,20,9,16,100,93
2023,2,22300302,12/11/2023,1610612762,Utah Jazz,0,0,1610612760,Oklahoma City Thunder,1,1,32,22,54,12,26,38,44,48,92,20,1,21,13,35,32,9,17,106,120
2023,2,22300897,3/6/2024,1610612745,Houston Rockets,1,0,1610612746,LA Clippers,0,1,29,28,57,16,21,37,45,49,94,10,7,17,18,33,33,5,8,94,116
2023,2,22300910,3/8/2024,1610612764,Washington Wizards,1,1,1610612766,Charlotte Hornets,0,0,37,17,54,6,27,33,43,44,87,20,3,23,11,35,25,6,11,98,112
2023,2,22300876,3/3/2024,1610612739,Cleveland Cavaliers,1,0,1610612752,New York Knicks,0,1,22,21,43,17,27,44,39,48,87,3,5,8,12,39,31,8,11,89,98
2021,2,22100095,11/1/2021,1610612754,Indiana Pacers,1,1,1610612759,San Antonio Spurs,0,0,34,19,53,18,20,38,52,39,91,9,3,12,14,28,37,6,16,98,131
2021,2,22100095,11/1/2021,1610612759,San Antonio Spurs,0,0,1610612754,Indiana Pacers,1,1,33,28,61,14,14,28,47,42,89,10,4,14,14,31,34,11,17,98,118
2020,2,22000834,4/14/2021,1610612749,Milwaukee Bucks,0,1,1610612750,Minnesota Timberwolves,1,0,27,31,58,19,21,40,46,52,98,19,4,23,14,39,26,13,16,111,130
2020,2,22000834,4/14/2021,1610612750,Minnesota Timberwolves,1,0,1610612749,Milwaukee Bucks,0,1,19,32,51,15,26,41,34,58,92,22,9,31,13,50,22,14,16,111,105
2023,2,22300301,12/11/2023,1610612740,New Orleans Pelicans,1,1,1610612750,Minnesota Timberwolves,0,0,30,25,55,10,17,27,40,42,82,31,9,40,12,37,27,5,14,100,121
2023,2,22300301,12/11/2023,1610612750,Minnesota Timberwolves,0,0,1610612740,New Orleans Pelicans,1,1,27,28,55,13,23,36,40,51,91,14,5,19,13,40,26,7,14,99,107
2023,2,22300877,3/3/2024,1610612759,San Antonio Spurs,1,1,1610612754,Indiana Pacers,0,0,36,24,60,10,15,25,46,39,85,15,4,19,12,28,33,9,16,99,117
2023,2,22300877,3/3/2024,1610612754,Indiana Pacers,0,0,1610612759,San Antonio Spurs,1,1,35,28,63,6,24,30,41,52,93,17,4,21,17,36,20,6,12,98,105
2023,2,22300876,3/3/2024,1610612752,New York Knicks,0,1,1610612739,Cleveland Cavaliers,1,0,26,21,47,16,23,39,42,44,86,7,3,10,13,32,32,7,12,90,107
2023,2,22300299,12/11/2023,1610612763,Memphis Grizzlies,1,0,1610612742,Dallas Mavericks,0,1,23,22,45,18,26,44,41,48,89,13,3,16,14,36,26,8,18,100,113
2023,2,22300897,3/6/2024,1610612746,LA Clippers,0,1,1610612745,Houston Rockets,1,0,32,19,51,12,17,29,44,36,80,22,4,26,8,29,19,6,9,92,122
2023,2,22300848,2/28/2024,1610612747,Los Angeles Lakers,0,1,1610612746,LA Clippers,1,0,33,17,50,14,22,36,47,39,86,8,2,10,11,29,28,10,17,96,116
2023,2,22300864,3/1/2024,1610612741,Chicago Bulls,1,0,1610612749,Milwaukee Bucks,0,1,25,34,59,11,16,27,36,50,86,14,2,16,12,38,25,7,12,93,97
2023,2,22300864,3/1/2024,1610612749,Milwaukee Bucks,0,1,1610612741,Chicago Bulls,1,0,22,18,40,15,31,46,37,49,86,24,8,32,14,38,22,4,7,94,113
2023,2,22300890,3/5/2024,1610612740,New Orleans Pelicans,0,1,1610612761,Toronto Raptors,1,0,29,27,56,24,25,49,53,52,105,9,2,11,18,36,38,6,11,103,139
2023,2,22300848,2/28/2024,1610612746,LA Clippers,1,0,1610612747,Los Angeles Lakers,0,1,35,17,52,10,27,37,45,44,89,12,4,16,12,34,29,6,14,97,112
2023,2,22300875,3/3/2024,1610612761,Toronto Raptors,1,1,1610612766,Charlotte Hornets,0,0,29,24,53,13,25,38,42,49,91,14,4,18,13,38,27,8,16,102,111
2023,2,22300886,3/5/2024,1610612739,Cleveland Cavaliers,1,1,1610612738,Boston Celtics,0,0,19,29,48,20,22,42,39,51,90,7,4,11,10,43,28,6,9,94,105
2023,2,22300865,3/1/2024,1610612764,Washington Wizards,0,0,1610612746,LA Clippers,1,1,34,30,64,12,22,34,46,52,98,11,4,15,13,41,29,5,10,102,115
2023,2,22300865,3/1/2024,1610612746,LA Clippers,1,1,1610612764,Washington Wizards,0,0,41,21,62,13,19,32,54,40,94,19,6,25,11,32,32,5,9,102,140
2023,2,22300863,3/1/2024,1610612740,New Orleans Pelicans,1,1,1610612754,Indiana Pacers,0,0,33,21,54,15,17,32,48,38,86,18,8,26,13,28,25,9,17,102,129
2020,2,22000833,4/14/2021,1610612741,Chicago Bulls,1,0,1610612753,Orlando Magic,0,1,24,25,49,17,20,37,41,45,86,7,2,9,10,35,23,8,12,91,106
2020,2,22000833,4/14/2021,1610612753,Orlando Magic,0,1,1610612741,Chicago Bulls,1,0,32,30,62,12,15,27,44,45,89,15,5,20,15,33,29,7,7,89,115
2023,2,22300854,2/29/2024,1610612756,Phoenix Suns,1,1,1610612745,Houston Rockets,0,0,23,29,52,13,24,37,36,53,89,25,12,37,17,42,20,8,14,104,110
2023,2,22300890,3/5/2024,1610612761,Toronto Raptors,1,0,1610612740,New Orleans Pelicans,0,1,23,26,49,13,31,44,36,57,93,13,9,22,13,48,21,9,12,103,98
2021,2,22100094,11/1/2021,1610612739,Cleveland Cavaliers,0,1,1610612766,Charlotte Hornets,1,0,30,32,62,9,19,28,39,51,90,26,12,38,25,28,21,12,16,101,113
2021,2,22100094,11/1/2021,1610612766,Charlotte Hornets,1,0,1610612739,Cleveland Cavaliers,0,1,27,35,62,15,24,39,42,59,101,11,4,15,26,34,27,12,17,101,110
2023,2,22300854,2/29/2024,1610612745,Houston Rockets,0,0,1610612756,Phoenix Suns,1,1,22,32,54,11,34,45,33,66,99,28,3,31,24,44,14,6,13,103,105
2020,2,22000832,4/14/2021,1610612746,LA Clippers,0,1,1610612765,Detroit Pistons,1,0,30,34,64,7,22,29,37,56,93,19,2,21,18,39,10,5,11,95,100
2020,2,22000832,4/14/2021,1610612765,Detroit Pistons,1,0,1610612746,LA Clippers,0,1,30,31,61,7,17,24,37,48,85,17,5,22,15,36,17,8,16,96,98
2023,2,22300910,3/8/2024,1610612766,Charlotte Hornets,0,0,1610612764,Washington Wizards,1,1,31,27,58,9,33,42,40,60,100,11,4,15,16,46,18,5,7,99,100
2023,2,22300889,3/5/2024,1610612752,New York Knicks,1,0,1610612737,Atlanta Hawks,0,1,22,25,47,16,36,52,38,61,99,8,3,11,21,41,27,6,12,95,100
2023,2,22300300,12/11/2023,1610612741,Chicago Bulls,0,0,1610612749,Milwaukee Bucks,1,1,32,48,80,15,19,34,47,67,114,20,5,25,24,45,25,5,6,108,129
2023,2,22300888,3/5/2024,1610612765,Detroit Pistons,0,0,1610612748,Miami Heat,1,1,27,20,47,12,30,42,39,50,89,20,2,22,16,34,26,7,11,94,110
2023,2,22300909,3/8/2024,1610612740,New Orleans Pelicans,0,1,1610612755,Philadelphia 76ers,1,0,24,24,48,11,20,31,35,44,79,22,1,23,11,33,22,8,14,92,103
2023,2,22300889,3/5/2024,1610612737,Atlanta Hawks,0,1,1610612752,New York Knicks,1,0,34,22,56,10,21,31,44,43,87,18,5,23,19,26,26,8,16,94,116
2023,2,22300300,12/11/2023,1610612749,Milwaukee Bucks,1,1,1610612741,Chicago Bulls,0,0,29,20,49,15,22,37,44,42,86,30,7,37,9,35,34,3,11,106,133
2023,2,22300888,3/5/2024,1610612748,Miami Heat,1,1,1610612765,Detroit Pistons,0,0,28,26,54,14,17,31,42,43,85,20,3,23,12,32,27,5,9,93,118
2023,2,22300887,3/5/2024,1610612755,Philadelphia 76ers,0,0,1610612751,Brooklyn Nets,1,1,28,26,54,12,16,28,40,42,82,15,4,19,9,36,25,4,12,93,107
2023,2,22300887,3/5/2024,1610612751,Brooklyn Nets,1,1,1610612755,Philadelphia 76ers,0,0,29,25,54,12,18,30,41,43,84,18,6,24,14,32,25,6,14,93,112
2023,2,22300920,3/9/2024,1610612738,Boston Celtics,0,1,1610612756,Phoenix Suns,1,0,31,24,55,15,24,39,46,48,94,10,3,13,16,33,29,6,12,96,117
2023,2,22300920,3/9/2024,1610612756,Phoenix Suns,1,0,1610612738,Boston Celtics,0,1,35,21,56,9,22,31,44,43,87,10,6,16,13,32,21,7,15,95,107
2023,2,22300878,3/3/2024,1610612760,Oklahoma City Thunder,0,1,1610612756,Phoenix Suns,1,0,40,31,71,9,22,31,49,53,102,11,4,15,14,39,21,2,6,102,118
2023,2,22300279,12/1/2023,1610612756,Phoenix Suns,1,0,1610612743,Denver Nuggets,0,1,30,27,57,9,18,27,39,45,84,24,2,26,14,31,22,8,12,97,111
2023,2,22300878,3/3/2024,1610612756,Phoenix Suns,1,0,1610612760,Oklahoma City Thunder,0,1,26,26,52,14,25,39,40,51,91,16,2,18,20,31,26,16,22,102,110
2023,2,22300855,2/29/2024,1610612743,Denver Nuggets,1,1,1610612748,Miami Heat,0,0,24,26,50,12,22,34,36,48,84,19,2,21,11,39,22,10,15,99,103
2023,2,22300793,2/22/2024,1610612765,Detroit Pistons,0,0,1610612754,Indiana Pacers,1,1,35,24,59,12,18,30,47,42,89,9,9,18,9,38,27,10,15,104,115
2023,2,22300855,2/29/2024,1610612748,Miami Heat,0,0,1610612743,Denver Nuggets,1,1,28,29,57,7,19,26,35,48,83,20,4,24,12,37,21,10,15,98,97
2023,2,22300793,2/22/2024,1610612754,Indiana Pacers,1,1,1610612765,Detroit Pistons,0,0,37,27,64,13,17,30,50,44,94,16,3,19,11,36,36,6,14,106,129
2023,2,22300921,3/9/2024,1610612759,San Antonio Spurs,0,1,1610612744,Golden State Warriors,1,0,27,26,53,17,16,33,44,42,86,21,7,28,15,32,34,9,14,99,126
2021,2,22100093,10/31/2021,1610612745,Houston Rockets,0,0,1610612747,Los Angeles Lakers,1,1,26,22,48,6,22,28,32,44,76,15,14,29,15,36,18,15,27,101,85
2021,2,22100093,10/31/2021,1610612747,Los Angeles Lakers,1,1,1610612745,Houston Rockets,0,0,30,35,65,9,22,31,39,57,96,8,5,13,14,47,22,8,14,102,95
2016,2,21600515,1/2/2017,1610612751,Brooklyn Nets,1,0,1610612762,Utah Jazz,0,1,27,24,51,6,21,27,33,45,78,17,6,23,11,37,13,9,15,93,89
2023,2,22300856,2/29/2024,1610612764,Washington Wizards,0,0,1610612747,Los Angeles Lakers,1,1,35,26,61,17,24,41,52,50,102,10,2,12,12,39,35,6,15,111,131
2023,2,22300921,3/9/2024,1610612744,Golden State Warriors,1,0,1610612759,San Antonio Spurs,0,1,31,27,58,10,20,30,41,47,88,21,8,29,13,38,26,6,12,99,113
2023,2,22300795,2/22/2024,1610612761,Toronto Raptors,1,1,1610612751,Brooklyn Nets,0,0,27,26,53,14,17,31,41,43,84,25,5,30,9,36,24,7,11,100,121
2023,2,22300856,2/29/2024,1610612747,Los Angeles Lakers,1,1,1610612764,Washington Wizards,0,0,45,33,78,8,15,23,53,48,101,20,4,24,12,39,30,6,11,112,134
2021,2,22100092,10/31/2021,1610612751,Brooklyn Nets,1,1,1610612765,Detroit Pistons,0,0,34,13,47,13,12,25,47,25,72,10,6,16,5,23,30,12,20,96,117
2021,2,22100092,10/31/2021,1610612765,Detroit Pistons,0,0,1610612751,Brooklyn Nets,1,1,20,26,46,12,21,33,32,47,79,15,7,22,8,43,21,7,15,95,91
2020,2,22000831,4/14/2021,1610612759,San Antonio Spurs,0,0,1610612761,Toronto Raptors,1,1,21,29,50,17,22,39,38,51,89,19,8,27,14,43,26,8,13,100,112
2020,2,22000831,4/14/2021,1610612761,Toronto Raptors,1,1,1610612759,San Antonio Spurs,0,0,27,31,58,14,16,30,41,47,88,21,4,25,17,31,21,6,16,99,117
2023,2,22300794,2/22/2024,1610612755,Philadelphia 76ers,1,0,1610612752,New York Knicks,0,1,27,28,55,10,19,29,37,47,84,12,2,14,12,36,23,11,18,95,96
2023,2,22300891,3/5/2024,1610612745,Houston Rockets,1,1,1610612759,San Antonio Spurs,0,0,40,31,71,9,25,34,49,56,105,7,4,11,18,41,23,1,7,99,114
2023,2,22300794,2/22/2024,1610612752,New York Knicks,0,1,1610612755,Philadelphia 76ers,1,0,23,22,45,15,19,34,38,41,79,19,8,27,13,32,24,7,18,96,110
2023,2,22300922,3/9/2024,1610612743,Denver Nuggets,1,1,1610612762,Utah Jazz,0,0,36,15,51,19,13,32,55,28,83,13,3,16,7,22,40,7,14,98,142
2023,2,22300922,3/9/2024,1610612762,Utah Jazz,0,0,1610612743,Denver Nuggets,1,1,39,29,68,8,18,26,47,47,94,19,6,25,21,32,22,8,15,97,121
2023,2,22300792,2/22/2024,1610612739,Cleveland Cavaliers,1,0,1610612753,Orlando Magic,0,1,29,19,48,10,12,22,39,31,70,21,5,26,10,24,31,8,19,92,109
2023,2,22300891,3/5/2024,1610612759,San Antonio Spurs,0,0,1610612745,Houston Rockets,1,1,26,25,51,12,24,36,38,49,87,13,3,16,15,35,24,15,19,99,101
2021,2,22100091,10/31/2021,1610612749,Milwaukee Bucks,1,0,1610612762,Utah Jazz,0,1,27,28,55,12,29,41,39,57,96,5,1,6,19,38,16,6,11,92,95
2021,2,22100091,10/31/2021,1610612762,Utah Jazz,0,1,1610612749,Milwaukee Bucks,1,0,23,15,38,12,25,37,35,40,75,25,2,27,10,32,13,7,13,92,107
2023,2,22300777,2/14/2024,1610612737,Atlanta Hawks,0,0,1610612766,Charlotte Hornets,1,1,27,24,51,9,29,38,36,53,89,18,2,20,18,36,23,7,16,97,99
2023,2,22300795,2/22/2024,1610612751,Brooklyn Nets,0,0,1610612761,Toronto Raptors,1,1,22,21,43,11,26,37,33,47,80,16,6,22,10,39,19,10,20,101,93
2021,2,22100090,10/31/2021,1610612757,Portland Trail Blazers,0,0,1610612766,Charlotte Hornets,1,1,26,17,43,17,37,54,43,54,97,10,1,11,19,35,30,4,12,96,113
2021,2,22100090,10/31/2021,1610612766,Charlotte Hornets,1,1,1610612757,Portland Trail Blazers,0,0,26,21,47,20,22,42,46,43,89,13,8,21,13,35,36,4,9,96,125
2020,2,22000830,4/14/2021,1610612751,Brooklyn Nets,0,0,1610612755,Philadelphia 76ers,1,1,39,23,62,4,17,21,43,40,83,27,3,30,12,30,23,8,16,101,117
2020,2,22000830,4/14/2021,1610612755,Philadelphia 76ers,1,1,1610612751,Brooklyn Nets,0,0,32,27,59,13,15,28,45,42,87,20,5,25,9,34,23,6,10,102,123
2020,2,22000829,4/14/2021,1610612739,Cleveland Cavaliers,0,1,1610612766,Charlotte Hornets,1,0,24,21,45,13,18,31,37,39,76,16,3,19,10,31,27,8,16,90,103
2020,2,22000829,4/14/2021,1610612766,Charlotte Hornets,1,0,1610612739,Cleveland Cavaliers,0,1,18,22,40,16,28,44,34,50,84,6,6,12,13,41,23,9,13,91,90
2023,2,22300912,3/8/2024,1610612752,New York Knicks,1,1,1610612753,Orlando Magic,0,0,22,24,46,16,17,33,38,41,79,6,2,8,13,29,20,7,16,85,98
2021,2,22100089,10/31/2021,1610612742,Dallas Mavericks,1,1,1610612758,Sacramento Kings,0,0,28,25,53,12,25,37,40,50,90,13,7,20,14,40,24,6,10,96,105
2021,2,22100089,10/31/2021,1610612758,Sacramento Kings,0,0,1610612742,Dallas Mavericks,1,1,31,29,60,7,29,36,38,58,96,16,4,20,22,38,20,8,13,96,99
2022,2,22200639,1/13/2023,1610612743,Denver Nuggets,0,1,1610612746,LA Clippers,1,0,27,22,49,14,19,33,41,41,82,19,6,25,11,34,24,6,11,93,115
2022,2,22200639,1/13/2023,1610612746,LA Clippers,1,0,1610612743,Denver Nuggets,0,1,31,27,58,10,19,29,41,46,87,11,3,14,14,33,20,7,12,94,103
2016,2,21601065,3/22/2017,1610612749,Milwaukee Bucks,0,1,1610612758,Sacramento Kings,1,0,27,19,46,16,19,35,43,38,81,14,5,19,11,30,28,6,11,89,116
2016,2,21601065,3/22/2017,1610612758,Sacramento Kings,1,0,1610612749,Milwaukee Bucks,0,1,31,27,58,10,16,26,41,43,84,6,4,10,13,33,19,9,13,90,98
2016,2,21600515,1/2/2017,1610612762,Utah Jazz,0,1,1610612751,Brooklyn Nets,1,0,32,37,69,7,17,24,39,54,93,16,4,20,19,38,11,5,9,93,101
2023,2,22300792,2/22/2024,1610612753,Orlando Magic,0,1,1610612739,Cleveland Cavaliers,1,0,29,30,59,14,11,25,43,41,84,16,2,18,13,29,26,8,13,91,116
2020,2,22000828,4/13/2021,1610612738,Boston Celtics,0,1,1610612757,Portland Trail Blazers,1,0,27,28,55,15,20,35,42,48,90,17,7,24,13,39,30,6,10,99,116
2020,2,22000828,4/13/2021,1610612757,Portland Trail Blazers,1,0,1610612738,Boston Celtics,0,1,26,21,47,17,26,43,43,47,90,12,5,17,14,37,31,5,14,99,115
2016,2,21600091,11/6/2016,1610612738,Boston Celtics,1,0,1610612743,Denver Nuggets,0,1,33,32,65,8,17,25,41,49,90,17,4,21,12,40,31,7,12,100,107
2016,2,21600091,11/6/2016,1610612743,Denver Nuggets,0,1,1610612738,Boston Celtics,1,0,33,28,61,11,12,23,44,40,84,24,7,31,15,30,21,3,18,102,123
2018,2,21800846,2/11/2019,1610612757,Portland Trail Blazers,0,0,1610612760,Oklahoma City Thunder,1,1,25,33,58,11,18,29,36,51,87,28,10,38,14,41,18,9,12,100,111
2018,2,21800846,2/11/2019,1610612760,Oklahoma City Thunder,1,1,1610612757,Portland Trail Blazers,0,0,25,26,51,16,19,35,41,45,86,22,7,29,10,38,23,8,13,100,120
2023,2,22300778,2/14/2024,1610612752,New York Knicks,0,0,1610612753,Orlando Magic,1,1,24,31,55,11,18,29,35,49,84,19,5,24,21,30,15,7,12,84,100
2023,2,22300303,12/11/2023,1610612758,Sacramento Kings,1,1,1610612751,Brooklyn Nets,0,0,23,26,49,25,20,45,48,46,94,10,4,14,15,33,38,4,13,98,131
2023,2,22300912,3/8/2024,1610612753,Orlando Magic,0,0,1610612752,New York Knicks,1,1,21,32,53,6,20,26,27,52,79,14,6,20,17,37,12,7,14,87,74
2023,2,22300923,3/9/2024,1610612761,Toronto Raptors,0,0,1610612757,Portland Trail Blazers,1,1,27,21,48,16,27,43,43,48,91,16,3,19,15,34,29,10,20,104,118
2023,2,22300923,3/9/2024,1610612757,Portland Trail Blazers,1,1,1610612761,Toronto Raptors,0,0,33,30,63,16,24,40,49,54,103,14,1,15,20,35,31,9,15,106,128
2023,2,22300303,12/11/2023,1610612751,Brooklyn Nets,0,0,1610612758,Sacramento Kings,1,1,28,31,59,14,15,29,42,46,88,20,1,21,11,35,24,4,13,99,118
2022,2,22200575,1/4/2023,1610612737,Atlanta Hawks,0,1,1610612758,Sacramento Kings,1,0,35,19,54,10,20,30,45,39,84,20,2,22,9,32,21,9,16,100,120
2022,2,22200575,1/4/2023,1610612758,Sacramento Kings,1,0,1610612737,Atlanta Hawks,0,1,31,32,63,10,15,25,41,47,88,25,2,27,11,37,26,9,11,100,117
2022,2,22200640,1/13/2023,1610612745,Houston Rockets,0,0,1610612758,Sacramento Kings,1,1,31,23,54,12,25,37,43,48,91,16,9,25,19,36,23,10,15,99,114
2022,2,22200640,1/13/2023,1610612758,Sacramento Kings,1,1,1610612745,Houston Rockets,0,0,27,19,46,20,20,40,47,39,86,25,4,29,16,24,34,10,14,97,139
2023,2,22300777,2/14/2024,1610612766,Charlotte Hornets,1,1,1610612737,Atlanta Hawks,0,0,29,23,52,15,22,37,44,45,89,19,1,20,14,31,27,5,13,97,122
2023,2,22300778,2/14/2024,1610612753,Orlando Magic,1,1,1610612752,New York Knicks,0,0,36,14,50,12,14,26,48,28,76,10,1,11,9,19,25,8,12,83,118
2023,2,22300304,12/11/2023,1610612746,LA Clippers,1,1,1610612757,Portland Trail Blazers,0,0,36,19,55,13,21,34,49,40,89,21,1,22,13,27,33,5,9,95,132
2023,2,22300304,12/11/2023,1610612757,Portland Trail Blazers,0,0,1610612746,LA Clippers,1,1,24,26,50,19,21,40,43,47,90,22,4,26,17,33,25,7,12,96,127
2023,2,22300909,3/8/2024,1610612755,Philadelphia 76ers,1,0,1610612740,New Orleans Pelicans,0,1,26,25,51,9,28,37,35,53,88,16,4,20,16,40,21,7,12,92,95
2023,2,22300779,2/14/2024,1610612748,Miami Heat,0,1,1610612755,Philadelphia 76ers,1,0,31,22,53,11,24,35,42,46,88,14,1,15,13,34,27,3,13,94,109
2023,2,22300779,2/14/2024,1610612755,Philadelphia 76ers,1,0,1610612748,Miami Heat,0,1,31,20,51,10,25,35,41,45,86,12,4,16,12,36,29,10,14,95,104
2023,2,22300886,3/5/2024,1610612738,Boston Celtics,0,0,1610612739,Cleveland Cavaliers,1,1,24,31,55,15,23,38,39,54,93,11,1,12,18,36,24,11,13,95,104
2023,2,22300804,2/23/2024,1610612761,Toronto Raptors,0,1,1610612737,Atlanta Hawks,1,0,35,28,63,15,24,39,50,52,102,8,0,8,16,36,37,5,12,101,123
2023,2,22300892,3/5/2024,1610612742,Dallas Mavericks,1,0,1610612754,Indiana Pacers,0,1,32,22,54,13,26,39,45,48,93,17,4,21,13,38,23,3,9,100,120
2023,2,22300804,2/23/2024,1610612737,Atlanta Hawks,1,0,1610612761,Toronto Raptors,0,1,34,33,67,12,27,39,46,60,106,17,7,24,27,37,27,3,9,102,121
2023,2,22300892,3/5/2024,1610612754,Indiana Pacers,0,1,1610612742,Dallas Mavericks,1,0,32,22,54,18,21,39,50,43,93,19,5,24,12,35,34,5,9,98,137
2023,2,22300805,2/23/2024,1610612739,Cleveland Cavaliers,0,0,1610612755,Philadelphia 76ers,1,1,26,27,53,8,19,27,34,46,80,21,10,31,9,43,24,6,11,97,97
2016,2,21601064,3/22/2017,1610612739,Cleveland Cavaliers,0,0,1610612743,Denver Nuggets,1,1,28,20,48,15,22,37,43,42,85,12,2,14,8,34,22,7,10,95,113
2016,2,21601064,3/22/2017,1610612743,Denver Nuggets,1,1,1610612739,Cleveland Cavaliers,0,0,40,30,70,11,15,26,51,45,96,13,0,13,14,31,35,4,6,95,126
2019,2,21900236,11/24/2019,1610612751,Brooklyn Nets,0,1,1610612752,New York Knicks,1,0,17,22,39,14,24,38,31,46,77,27,7,34,12,38,18,6,12,94,103
2019,2,21900236,11/24/2019,1610612752,New York Knicks,1,0,1610612751,Brooklyn Nets,0,1,19,26,45,18,17,35,37,43,80,9,7,16,13,34,22,6,19,94,101
2023,2,22300780,2/14/2024,1610612738,Boston Celtics,1,1,1610612751,Brooklyn Nets,0,0,30,16,46,22,23,45,52,39,91,10,2,12,13,27,32,5,10,93,136
2021,2,22100088,10/30/2021,1610612739,Cleveland Cavaliers,0,0,1610612756,Phoenix Suns,1,1,22,25,47,14,30,44,36,55,91,6,1,7,11,45,21,12,19,101,92
2021,2,22100088,10/30/2021,1610612756,Phoenix Suns,1,1,1610612739,Cleveland Cavaliers,0,0,33,25,58,6,20,26,39,45,84,17,10,27,11,39,27,8,15,101,101
2023,2,22300780,2/14/2024,1610612751,Brooklyn Nets,0,0,1610612738,Boston Celtics,1,1,21,29,50,10,21,31,31,50,81,14,1,15,9,42,27,6,12,92,86
2023,2,22300805,2/23/2024,1610612755,Philadelphia 76ers,1,1,1610612739,Cleveland Cavaliers,0,0,28,33,61,12,17,29,40,50,90,12,3,15,12,40,20,5,10,95,104
2023,2,22300914,3/8/2024,1610612760,Oklahoma City Thunder,1,1,1610612748,Miami Heat,0,0,30,21,51,12,26,38,42,47,89,11,2,13,12,36,28,6,9,94,107
2023,2,22300913,3/8/2024,1610612737,Atlanta Hawks,0,1,1610612763,Memphis Grizzlies,1,0,22,30,52,15,20,35,37,50,87,10,5,15,23,30,21,10,16,87,99
2023,2,22300913,3/8/2024,1610612763,Memphis Grizzlies,1,0,1610612737,Atlanta Hawks,0,1,20,28,48,10,16,26,30,44,74,22,8,30,15,33,21,9,13,88,92
2023,2,22300280,12/2/2023,1610612744,Golden State Warriors,0,0,1610612746,LA Clippers,1,1,21,22,43,17,26,43,38,48,86,19,5,24,14,36,31,5,15,99,112
2023,2,22300280,12/2/2023,1610612746,LA Clippers,1,1,1610612744,Golden State Warriors,0,0,31,20,51,13,26,39,44,46,90,12,2,14,8,39,31,5,11,100,113
2023,2,22300796,2/22/2024,1610612742,Dallas Mavericks,1,1,1610612756,Phoenix Suns,0,0,24,22,46,19,25,44,43,47,90,18,3,21,15,33,24,7,10,95,123
2023,2,22300911,3/8/2024,1610612750,Minnesota Timberwolves,0,0,1610612739,Cleveland Cavaliers,1,1,31,33,64,8,22,30,39,55,94,18,4,22,18,38,25,7,14,101,104
2023,2,22300914,3/8/2024,1610612748,Miami Heat,0,0,1610612760,Oklahoma City Thunder,1,1,27,26,53,11,18,29,38,44,82,13,5,18,7,39,24,5,11,94,100
2019,2,21900235,11/24/2019,1610612742,Dallas Mavericks,0,1,1610612745,Houston Rockets,1,0,32,26,58,17,27,44,49,53,102,22,6,28,16,42,28,5,12,108,137
2019,2,21900235,11/24/2019,1610612745,Houston Rockets,1,0,1610612742,Dallas Mavericks,0,1,35,19,54,10,34,44,45,53,98,23,8,31,16,41,26,9,11,107,123
2023,2,22300911,3/8/2024,1610612739,Cleveland Cavaliers,1,1,1610612750,Minnesota Timberwolves,0,0,27,27,54,11,23,34,38,50,88,26,10,36,15,40,27,5,13,101,113
2016,2,21601063,3/22/2017,1610612737,Atlanta Hawks,0,0,1610612764,Washington Wizards,1,1,26,35,61,8,17,25,34,52,86,24,5,29,14,40,20,9,16,101,100
2016,2,21601063,3/22/2017,1610612764,Washington Wizards,1,1,1610612737,Atlanta Hawks,0,0,27,34,61,11,23,34,38,57,95,17,6,23,24,36,23,11,19,101,104
2020,2,22000827,4/13/2021,1610612748,Miami Heat,0,0,1610612756,Phoenix Suns,1,1,22,16,38,9,35,44,31,51,82,15,4,19,13,39,24,11,18,97,86
2020,2,22000827,4/13/2021,1610612756,Phoenix Suns,1,1,1610612748,Miami Heat,0,0,25,15,40,13,29,42,38,44,82,17,1,18,14,30,28,13,21,97,106
2023,2,22300809,2/23/2024,1610612764,Washington Wizards,0,0,1610612760,Oklahoma City Thunder,1,1,32,34,66,9,29,38,41,63,104,15,6,21,17,50,20,5,16,110,106
2023,2,22300893,3/5/2024,1610612756,Phoenix Suns,0,1,1610612743,Denver Nuggets,1,0,27,35,62,15,19,34,42,54,96,18,4,22,15,42,32,6,10,102,117
2023,2,22300893,3/5/2024,1610612743,Denver Nuggets,1,0,1610612756,Phoenix Suns,0,1,26,30,56,15,25,40,41,55,96,10,4,14,15,43,25,9,15,102,107
2023,2,22300796,2/22/2024,1610612756,Phoenix Suns,0,0,1610612742,Dallas Mavericks,1,1,25,22,47,15,21,36,40,43,83,18,6,24,15,31,20,10,16,96,113
2023,2,22300809,2/23/2024,1610612760,Oklahoma City Thunder,1,1,1610612764,Washington Wizards,0,0,35,17,52,20,20,40,55,37,92,17,4,21,8,31,30,10,15,108,147
2023,2,22300799,2/22/2024,1610612760,Oklahoma City Thunder,1,1,1610612746,LA Clippers,0,0,33,22,55,17,18,35,50,40,90,12,5,17,12,31,24,6,15,100,129
2021,2,22100087,10/30/2021,1610612743,Denver Nuggets,0,1,1610612750,Minnesota Timberwolves,1,0,27,24,51,9,28,37,36,52,88,12,4,16,20,33,24,8,18,96,93
2021,2,22100087,10/30/2021,1610612750,Minnesota Timberwolves,1,0,1610612743,Denver Nuggets,0,1,22,26,48,13,28,41,35,54,89,8,1,9,18,37,21,11,20,96,91
2016,2,21601062,3/22/2017,1610612755,Philadelphia 76ers,0,0,1610612760,Oklahoma City Thunder,1,1,29,33,62,8,17,25,37,50,87,15,2,17,10,41,19,7,10,95,97
2016,2,21601062,3/22/2017,1610612760,Oklahoma City Thunder,1,1,1610612755,Philadelphia 76ers,0,0,44,28,72,4,12,16,48,40,88,22,8,30,23,22,26,8,16,93,122
2019,2,21900017,10/25/2019,1610612738,Boston Celtics,1,1,1610612761,Toronto Raptors,0,0,29,42,71,13,25,38,42,67,109,15,1,16,24,44,21,2,10,102,112
2019,2,21900017,10/25/2019,1610612761,Toronto Raptors,0,0,1610612738,Boston Celtics,1,1,19,23,42,18,18,36,37,41,78,14,3,17,6,37,22,10,23,103,106
2023,2,22300799,2/22/2024,1610612746,LA Clippers,0,0,1610612760,Oklahoma City Thunder,1,1,30,31,61,12,20,32,42,51,93,11,2,13,14,38,27,9,14,100,107
2023,2,22300782,2/14/2024,1610612754,Indiana Pacers,0,1,1610612761,Toronto Raptors,1,0,30,26,56,17,24,41,47,50,97,16,7,23,11,44,32,6,8,103,127
2023,2,22300797,2/22/2024,1610612738,Boston Celtics,0,1,1610612741,Chicago Bulls,1,0,22,14,36,23,24,47,45,38,83,16,5,21,7,34,27,6,14,100,129
2023,2,22300782,2/14/2024,1610612761,Toronto Raptors,1,0,1610612754,Indiana Pacers,0,1,44,28,72,6,20,26,50,48,98,19,7,26,19,33,30,9,15,104,125
2021,2,22100086,10/30/2021,1610612744,Golden State Warriors,1,1,1610612760,Oklahoma City Thunder,0,0,18,20,38,21,33,54,39,53,92,4,4,8,12,43,30,8,16,100,103
2021,2,22100086,10/30/2021,1610612760,Oklahoma City Thunder,0,0,1610612744,Golden State Warriors,1,1,21,23,44,8,31,39,29,54,83,16,5,21,8,47,14,9,16,102,82
2016,2,21601061,3/22/2017,1610612741,Chicago Bulls,1,1,1610612765,Detroit Pistons,0,0,36,21,57,11,12,23,47,33,80,12,7,19,7,29,36,6,11,91,117
2020,2,22000826,4/13/2021,1610612760,Oklahoma City Thunder,0,0,1610612762,Utah Jazz,1,1,22,37,59,14,20,34,36,57,93,10,8,18,19,42,13,6,14,97,96
2020,2,22000826,4/13/2021,1610612762,Utah Jazz,1,1,1610612760,Oklahoma City Thunder,0,0,19,20,39,17,30,47,36,50,86,17,3,20,14,37,24,8,14,97,106
2021,2,22100085,10/30/2021,1610612749,Milwaukee Bucks,1,0,1610612759,San Antonio Spurs,0,1,26,24,50,10,29,39,36,53,89,11,5,16,10,45,20,12,21,107,93
2021,2,22100085,10/30/2021,1610612759,San Antonio Spurs,0,1,1610612749,Milwaukee Bucks,1,0,32,32,64,7,24,31,39,56,95,17,7,24,10,47,28,6,10,107,102
2016,2,21601061,3/22/2017,1610612765,Detroit Pistons,0,0,1610612741,Chicago Bulls,1,1,32,36,68,7,13,20,39,49,88,10,7,17,21,32,18,12,16,91,95
2023,2,22300807,2/23/2024,1610612746,LA Clippers,0,1,1610612763,Memphis Grizzlies,1,0,25,27,52,12,20,32,37,47,84,15,2,17,17,30,20,12,21,95,101
2023,2,22300807,2/23/2024,1610612763,Memphis Grizzlies,1,0,1610612746,LA Clippers,0,1,30,26,56,8,27,35,38,53,91,11,5,16,17,39,26,7,13,95,95
2021,2,22100084,10/30/2021,1610612748,Miami Heat,0,1,1610612763,Memphis Grizzlies,1,0,25,26,51,21,16,37,46,42,88,16,3,19,16,27,31,14,18,101,129
2021,2,22100084,10/30/2021,1610612763,Memphis Grizzlies,1,0,1610612748,Miami Heat,0,1,18,20,38,16,34,50,34,54,88,19,2,21,13,42,26,12,14,101,103
2023,2,22300797,2/22/2024,1610612741,Chicago Bulls,1,0,1610612738,Boston Celtics,0,1,34,32,66,10,18,28,44,50,94,14,2,16,17,34,30,10,13,99,112
2020,2,22000825,4/13/2021,1610612747,Los Angeles Lakers,0,1,1610612766,Charlotte Hornets,1,0,18,20,38,16,28,44,34,48,82,17,1,18,11,37,24,5,11,91,101
2020,2,22000825,4/13/2021,1610612766,Charlotte Hornets,1,0,1610612747,Los Angeles Lakers,0,1,27,21,48,9,26,35,36,47,83,12,6,18,17,34,22,9,18,89,93
2023,2,22300281,12/2/2023,1610612750,Minnesota Timberwolves,0,1,1610612766,Charlotte Hornets,1,0,32,21,53,11,20,31,43,41,84,26,4,30,14,29,26,6,11,95,123
2023,2,22300781,2/14/2024,1610612739,Cleveland Cavaliers,1,1,1610612741,Chicago Bulls,0,0,28,18,46,12,25,37,40,43,83,16,5,21,7,38,31,5,8,95,108
2021,2,22100083,10/30/2021,1610612741,Chicago Bulls,1,1,1610612762,Utah Jazz,0,0,34,36,70,5,16,21,39,52,91,24,6,30,12,42,16,5,9,102,107
2021,2,22100083,10/30/2021,1610612762,Utah Jazz,0,0,1610612741,Chicago Bulls,1,1,24,30,54,11,27,38,35,57,92,18,1,19,18,39,15,8,20,102,99
2020,2,22000824,4/13/2021,1610612737,Atlanta Hawks,0,1,1610612761,Toronto Raptors,1,0,27,27,54,13,17,30,40,44,84,15,7,22,11,36,21,7,14,99,108
2020,2,22000824,4/13/2021,1610612761,Toronto Raptors,1,0,1610612737,Atlanta Hawks,0,1,32,17,49,10,29,39,42,46,88,9,4,13,9,38,16,7,13,97,103
2014,2,21400690,1/28/2015,1610612746,LA Clippers,0,1,1610612762,Utah Jazz,1,0,25,25,50,9,17,26,34,42,76,17,8,25,14,33,13,2,8,81,94
2019,2,21900234,11/23/2019,1610612740,New Orleans Pelicans,0,0,1610612762,Utah Jazz,1,1,25,35,60,17,24,41,42,59,101,19,1,20,14,45,21,2,10,106,120
2019,2,21900234,11/23/2019,1610612762,Utah Jazz,1,1,1610612740,New Orleans Pelicans,0,0,27,19,46,15,21,36,42,40,82,29,4,33,9,32,29,7,18,106,128
2020,2,22000823,4/13/2021,1610612746,LA Clippers,0,1,1610612754,Indiana Pacers,1,0,35,26,61,13,15,28,48,41,89,17,2,19,7,34,34,9,14,106,126
2020,2,22000823,4/13/2021,1610612754,Indiana Pacers,1,0,1610612746,LA Clippers,0,1,35,21,56,9,31,40,44,52,96,18,4,22,11,44,14,10,12,107,115
2016,2,21600514,1/2/2017,1610612739,Cleveland Cavaliers,1,1,1610612740,New Orleans Pelicans,0,0,28,31,59,6,25,31,34,56,90,16,6,22,17,42,16,6,13,96,90
2016,2,21600514,1/2/2017,1610612740,New Orleans Pelicans,0,0,1610612739,Cleveland Cavaliers,1,1,21,41,62,11,15,26,32,56,88,7,3,10,11,46,26,9,13,96,82
2016,2,21600090,11/6/2016,1610612742,Dallas Mavericks,1,1,1610612749,Milwaukee Bucks,0,0,24,26,50,9,29,38,33,55,88,11,1,12,10,46,14,11,16,99,86
2016,2,21600090,11/6/2016,1610612749,Milwaukee Bucks,0,0,1610612742,Dallas Mavericks,1,1,24,29,53,6,23,29,30,52,82,9,3,12,17,36,14,12,27,101,75
2014,2,21400690,1/28/2015,1610612762,Utah Jazz,1,0,1610612746,LA Clippers,0,1,30,27,57,5,19,24,35,46,81,14,6,20,21,28,17,7,11,80,89
2018,2,21800970,3/6/2019,1610612741,Chicago Bulls,1,1,1610612755,Philadelphia 76ers,0,0,35,35,70,6,17,23,41,52,93,20,7,27,19,38,21,10,13,100,108
2018,2,21800970,3/6/2019,1610612755,Philadelphia 76ers,0,0,1610612741,Chicago Bulls,1,1,32,31,63,8,16,24,40,47,87,19,5,24,15,36,22,7,15,98,107
2018,2,21800667,1/17/2019,1610612754,Indiana Pacers,1,0,1610612755,Philadelphia 76ers,0,1,30,38,68,9,20,29,39,58,97,9,3,12,16,43,23,8,12,101,96
2018,2,21800667,1/17/2019,1610612755,Philadelphia 76ers,0,1,1610612754,Indiana Pacers,1,0,28,25,53,18,16,34,46,41,87,10,1,11,11,30,38,9,18,100,120
2018,2,21800510,12/26/2018,1610612743,Denver Nuggets,0,0,1610612759,San Antonio Spurs,1,1,17,33,50,18,22,40,35,55,90,15,8,23,15,43,29,6,13,100,103
2018,2,21800510,12/26/2018,1610612759,San Antonio Spurs,1,1,1610612743,Denver Nuggets,0,0,32,26,58,10,22,32,42,48,90,17,5,22,11,41,29,10,10,99,111
2018,2,21800437,12/16/2018,1610612739,Cleveland Cavaliers,1,0,1610612755,Philadelphia 76ers,0,1,29,29,58,12,18,30,41,47,88,11,6,17,13,38,28,5,12,97,105
2018,2,21800437,12/16/2018,1610612755,Philadelphia 76ers,0,1,1610612739,Cleveland Cavaliers,1,0,40,24,64,11,16,27,51,40,91,15,5,20,14,28,32,8,11,96,128
2018,2,21800095,10/29/2018,1610612740,New Orleans Pelicans,0,0,1610612743,Denver Nuggets,1,1,32,26,58,11,13,24,43,39,82,14,6,20,9,34,28,14,22,104,111
2018,2,21800095,10/29/2018,1610612743,Denver Nuggets,1,1,1610612740,New Orleans Pelicans,0,0,31,27,58,11,24,35,42,51,93,21,2,23,12,39,28,8,13,105,116
2021,2,22100082,10/30/2021,1610612737,Atlanta Hawks,0,0,1610612755,Philadelphia 76ers,1,1,28,45,73,8,14,22,36,59,95,14,5,19,24,38,24,11,19,99,94
2021,2,22100082,10/30/2021,1610612755,Philadelphia 76ers,1,1,1610612737,Atlanta Hawks,0,0,34,14,48,12,26,38,46,40,86,18,1,19,8,32,24,6,12,99,122
2016,2,21601060,3/22/2017,1610612738,Boston Celtics,1,1,1610612754,Indiana Pacers,0,0,32,25,57,11,16,27,43,41,84,12,2,14,14,28,27,13,17,91,109
2016,2,21601060,3/22/2017,1610612754,Indiana Pacers,0,0,1610612738,Boston Celtics,1,1,27,32,59,11,17,28,38,49,87,13,6,19,18,34,20,5,13,91,100
2016,2,21600513,1/2/2017,1610612749,Milwaukee Bucks,1,1,1610612760,Oklahoma City Thunder,0,0,31,29,60,7,12,19,38,41,79,15,9,24,12,34,21,7,12,89,98
2016,2,21600513,1/2/2017,1610612760,Oklahoma City Thunder,0,0,1610612749,Milwaukee Bucks,1,1,27,24,51,9,18,27,36,42,78,13,6,19,11,35,20,4,11,90,94
2014,2,21400689,1/28/2015,1610612759,San Antonio Spurs,1,1,1610612766,Charlotte Hornets,0,0,25,29,54,10,19,29,35,48,83,15,3,18,12,37,23,7,14,93,95
2014,2,21400689,1/28/2015,1610612766,Charlotte Hornets,0,0,1610612759,San Antonio Spurs,1,1,28,37,65,6,12,18,34,49,83,12,2,14,10,40,23,7,12,93,86
2018,2,21800436,12/16/2018,1610612737,Atlanta Hawks,0,0,1610612751,Brooklyn Nets,1,1,33,23,56,14,15,29,47,38,85,19,6,25,11,30,38,12,14,101,127
2018,2,21800436,12/16/2018,1610612751,Brooklyn Nets,1,1,1610612737,Atlanta Hawks,0,0,33,15,48,16,24,40,49,39,88,30,3,33,15,26,34,9,13,103,144
2018,2,21800197,11/12/2018,1610612758,Sacramento Kings,1,1,1610612759,San Antonio Spurs,0,0,32,30,62,11,13,24,43,43,86,7,5,12,9,37,27,5,13,97,104
2018,2,21800197,11/12/2018,1610612759,San Antonio Spurs,0,0,1610612758,Sacramento Kings,1,1,28,28,56,10,21,31,38,49,87,13,3,16,12,39,25,12,15,97,99
2018,2,21800096,10/30/2018,1610612748,Miami Heat,0,0,1610612766,Charlotte Hornets,1,1,30,29,59,11,17,28,41,46,87,20,4,24,13,36,25,7,15,97,113
2018,2,21800096,10/30/2018,1610612766,Charlotte Hornets,1,1,1610612748,Miami Heat,0,0,31,22,53,13,15,28,44,37,81,24,5,29,11,27,27,9,14,98,125
2017,2,21701229,4/11/2018,1610612757,Portland Trail Blazers,1,1,1610612762,Utah Jazz,0,0,32,33,65,9,15,24,41,48,89,11,5,16,10,42,19,5,10,96,102
2017,2,21701229,4/11/2018,1610612762,Utah Jazz,0,0,1610612757,Portland Trail Blazers,1,1,25,41,66,8,15,23,33,56,89,19,5,24,18,41,18,9,15,96,93
2017,2,21701140,3/31/2018,1610612738,Boston Celtics,1,1,1610612761,Toronto Raptors,0,0,33,38,71,7,10,17,40,48,88,23,4,27,13,39,19,1,6,93,110
2017,2,21701140,3/31/2018,1610612761,Toronto Raptors,0,0,1610612738,Boston Celtics,1,1,29,16,45,8,27,35,37,43,80,17,5,22,10,36,23,6,15,95,99
2017,2,21701105,3/26/2018,1610612743,Denver Nuggets,0,0,1610612755,Philadelphia 76ers,1,1,25,27,52,11,21,32,36,48,84,21,13,34,15,40,27,6,17,104,104
2017,2,21701105,3/26/2018,1610612755,Philadelphia 76ers,1,1,1610612743,Denver Nuggets,0,0,33,29,62,13,16,29,46,45,91,18,7,25,17,30,35,10,18,103,123
2016,2,21601059,3/22/2017,1610612753,Orlando Magic,1,0,1610612766,Charlotte Hornets,0,1,26,22,48,14,26,40,40,48,88,8,2,10,14,34,26,9,14,92,102
2016,2,21601059,3/22/2017,1610612766,Charlotte Hornets,0,1,1610612753,Orlando Magic,1,0,33,30,63,9,18,27,42,48,90,16,2,18,17,31,24,5,10,93,109
2020,2,22000822,4/12/2021,1610612745,Houston Rockets,0,0,1610612756,Phoenix Suns,1,1,27,18,45,17,25,42,44,43,87,15,4,19,14,33,32,14,21,103,120
2020,2,22000822,4/12/2021,1610612756,Phoenix Suns,1,1,1610612745,Houston Rockets,0,0,20,29,49,25,20,45,45,49,94,11,7,18,13,41,33,9,14,103,126
2018,2,21801118,3/27/2019,1610612744,Golden State Warriors,0,1,1610612763,Memphis Grizzlies,1,0,30,23,53,15,16,31,45,39,84,13,2,15,7,33,30,11,14,98,118
2018,2,21801118,3/27/2019,1610612763,Memphis Grizzlies,1,0,1610612744,Golden State Warriors,0,1,29,40,69,10,21,31,39,61,100,15,6,21,21,43,22,9,10,99,103
2018,2,21800969,3/6/2019,1610612739,Cleveland Cavaliers,0,0,1610612751,Brooklyn Nets,1,1,19,30,49,16,22,38,35,52,87,21,8,29,15,41,23,5,18,103,107
2018,2,21800969,3/6/2019,1610612751,Brooklyn Nets,1,1,1610612739,Cleveland Cavaliers,0,0,31,27,58,12,21,33,43,48,91,15,11,26,14,39,21,7,14,104,113
2018,2,21800845,2/11/2019,1610612746,LA Clippers,0,0,1610612750,Minnesota Timberwolves,1,1,25,18,43,12,17,29,37,35,72,34,5,39,9,28,24,14,21,103,120
2018,2,21800845,2/11/2019,1610612750,Minnesota Timberwolves,1,1,1610612746,LA Clippers,0,0,41,31,72,6,12,18,47,43,90,30,6,36,18,29,28,8,13,104,130
2014,2,21400688,1/28/2015,1610612752,New York Knicks,1,1,1610612760,Oklahoma City Thunder,0,0,32,42,74,8,9,17,40,51,91,12,5,17,14,39,29,7,10,96,100
2014,2,21400688,1/28/2015,1610612760,Oklahoma City Thunder,0,0,1610612752,New York Knicks,1,1,29,34,63,5,17,22,34,51,85,19,3,22,12,41,10,8,14,95,92
2022,2,22200481,12/23/2022,1610612737,Atlanta Hawks,1,1,1610612765,Detroit Pistons,0,0,37,21,58,12,22,34,49,43,92,20,4,24,10,36,30,7,8,103,130
2022,2,22200481,12/23/2022,1610612765,Detroit Pistons,0,0,1610612737,Atlanta Hawks,1,1,28,29,57,9,24,33,37,53,90,22,7,29,14,40,17,10,14,102,105
2018,2,21800590,1/6/2019,1610612756,Phoenix Suns,1,0,1610612766,Charlotte Hornets,0,1,33,25,58,10,15,25,43,40,83,17,2,19,6,35,23,9,15,101,113
2018,2,21800590,1/6/2019,1610612766,Charlotte Hornets,0,1,1610612756,Phoenix Suns,1,0,37,29,66,7,18,25,44,47,91,24,10,34,18,34,22,8,15,101,119
2018,2,21800509,12/26/2018,1610612740,New Orleans Pelicans,0,0,1610612742,Dallas Mavericks,1,1,30,33,63,12,15,27,42,48,90,23,7,30,12,39,25,3,10,101,119
2018,2,21800509,12/26/2018,1610612742,Dallas Mavericks,1,1,1610612740,New Orleans Pelicans,0,0,27,19,46,12,23,35,39,42,81,32,6,38,11,34,23,4,12,101,122
2018,2,21800367,12/6/2018,1610612745,Houston Rockets,0,0,1610612762,Utah Jazz,1,1,26,26,52,8,28,36,34,54,88,15,2,17,18,38,13,16,23,97,91
2018,2,21800367,12/6/2018,1610612762,Utah Jazz,1,1,1610612745,Houston Rockets,0,0,37,20,57,8,24,32,45,44,89,20,7,27,17,30,26,5,12,98,118
2021,2,22100081,10/30/2021,1610612754,Indiana Pacers,1,0,1610612761,Toronto Raptors,0,1,22,16,38,13,30,43,35,46,81,11,5,16,12,38,25,8,20,98,94
2021,2,22100081,10/30/2021,1610612761,Toronto Raptors,0,1,1610612754,Indiana Pacers,1,0,28,32,60,11,21,32,39,53,92,8,4,12,18,37,18,8,18,97,97
2016,2,21601058,3/21/2017,1610612746,LA Clippers,0,1,1610612747,Los Angeles Lakers,1,0,30,21,51,15,18,33,45,39,84,28,4,32,14,27,23,8,16,100,133
2016,2,21601058,3/21/2017,1610612747,Los Angeles Lakers,1,0,1610612746,LA Clippers,0,1,37,35,72,6,14,20,43,49,92,17,10,27,16,37,23,4,10,100,109
2016,2,21600512,1/1/2017,1610612747,Los Angeles Lakers,1,0,1610612761,Toronto Raptors,0,1,22,38,60,15,17,32,37,55,92,25,6,31,18,39,19,5,8,96,114
2016,2,21600512,1/1/2017,1610612761,Toronto Raptors,0,1,1610612747,Los Angeles Lakers,1,0,32,26,58,10,7,17,42,33,75,29,3,32,9,27,18,8,16,96,123
2016,2,21600089,11/6/2016,1610612758,Sacramento Kings,0,1,1610612761,Toronto Raptors,1,0,29,33,62,5,11,16,34,44,78,23,8,31,16,32,21,6,11,88,96
2016,2,21600089,11/6/2016,1610612761,Toronto Raptors,1,0,1610612758,Sacramento Kings,0,1,23,31,54,7,23,30,30,54,84,24,7,31,16,40,22,4,6,89,91
2014,2,21400687,1/28/2015,1610612740,New Orleans Pelicans,1,0,1610612743,Denver Nuggets,0,1,29,38,67,3,12,15,32,50,82,18,6,24,20,32,15,4,10,83,85
2014,2,21400687,1/28/2015,1610612743,Denver Nuggets,0,1,1610612740,New Orleans Pelicans,1,0,29,39,68,10,7,17,39,46,85,5,2,7,13,34,30,2,8,84,93
2018,2,21800748,1/28/2019,1610612737,Atlanta Hawks,0,1,1610612746,LA Clippers,1,0,34,19,53,10,24,34,44,43,87,25,4,29,19,25,28,10,19,100,123
2018,2,21800748,1/28/2019,1610612746,LA Clippers,1,0,1610612737,Atlanta Hawks,0,1,31,27,58,10,17,27,41,44,85,26,2,28,15,30,27,7,16,100,118
2018,2,21800306,11/28/2018,1610612737,Atlanta Hawks,0,0,1610612766,Charlotte Hornets,1,1,21,28,49,11,33,44,32,61,93,19,3,22,19,43,20,15,19,105,94
2018,2,21800306,11/28/2018,1610612766,Charlotte Hornets,1,1,1610612737,Atlanta Hawks,0,0,34,29,63,4,16,20,38,45,83,28,9,37,9,40,20,11,14,105,108
2018,2,21800250,11/20/2018,1610612748,Miami Heat,1,0,1610612751,Brooklyn Nets,0,1,29,39,68,7,25,32,36,64,100,13,7,20,23,43,18,6,14,100,92
2018,2,21800250,11/20/2018,1610612751,Brooklyn Nets,0,1,1610612748,Miami Heat,1,0,30,27,57,8,23,31,38,50,88,20,6,26,13,39,17,5,12,99,104
2017,2,21701182,4/6/2018,1610612753,Orlando Magic,1,0,1610612766,Charlotte Hornets,0,1,33,38,71,9,14,23,42,52,94,7,6,13,13,42,27,4,9,97,100
2017,2,21701182,4/6/2018,1610612766,Charlotte Hornets,0,1,1610612753,Orlando Magic,1,0,31,24,55,17,14,31,48,38,86,24,2,26,12,27,32,2,10,97,137
2017,2,21701141,3/31/2018,1610612748,Miami Heat,1,0,1610612751,Brooklyn Nets,0,1,36,42,78,7,10,17,43,52,95,16,5,21,13,40,19,11,18,110,109
2017,2,21701141,3/31/2018,1610612751,Brooklyn Nets,0,1,1610612748,Miami Heat,1,0,29,27,56,10,25,35,39,52,91,22,6,28,11,42,28,6,17,109,110
2016,2,21601057,3/21/2017,1610612749,Milwaukee Bucks,0,1,1610612757,Portland Trail Blazers,1,0,31,43,74,7,9,16,38,52,90,10,2,12,16,37,16,8,13,91,93
2016,2,21601057,3/21/2017,1610612757,Portland Trail Blazers,1,0,1610612749,Milwaukee Bucks,0,1,31,31,62,4,17,21,35,48,83,16,10,26,17,37,15,8,14,93,90
2019,2,21900016,10/24/2019,1610612744,Golden State Warriors,1,0,1610612746,LA Clippers,0,1,24,33,57,15,27,42,39,60,99,29,1,30,21,40,27,7,13,108,122
2019,2,21900016,10/24/2019,1610612746,LA Clippers,0,1,1610612744,Golden State Warriors,1,0,32,16,48,18,14,32,50,30,80,23,7,30,6,27,33,7,20,107,141
2020,2,22000821,4/12/2021,1610612743,Denver Nuggets,0,0,1610612744,Golden State Warriors,1,1,31,26,57,8,18,26,39,44,83,21,4,25,12,33,23,11,20,102,107
2020,2,22000821,4/12/2021,1610612744,Golden State Warriors,1,1,1610612743,Denver Nuggets,0,0,21,16,37,18,26,44,39,42,81,20,2,22,7,36,23,11,16,102,116
2018,2,21801117,3/27/2019,1610612741,Chicago Bulls,1,0,1610612757,Portland Trail Blazers,0,1,34,34,68,5,18,23,39,52,91,15,4,19,18,37,22,4,10,91,98
2018,2,21801117,3/27/2019,1610612757,Portland Trail Blazers,0,1,1610612741,Chicago Bulls,1,0,32,19,51,11,21,32,43,40,83,21,4,25,13,29,30,4,8,91,118
2014,2,21400686,1/28/2015,1610612738,Boston Celtics,0,0,1610612750,Minnesota Timberwolves,1,1,35,33,68,7,16,23,42,49,91,7,2,9,10,41,22,6,13,97,98
2014,2,21400686,1/28/2015,1610612750,Minnesota Timberwolves,1,1,1610612738,Boston Celtics,0,0,32,29,61,6,10,16,38,39,77,28,4,32,8,32,18,9,12,97,110
2018,2,21800249,11/20/2018,1610612746,LA Clippers,0,0,1610612764,Washington Wizards,1,1,35,27,62,11,16,27,46,43,89,15,3,18,10,36,20,11,19,105,118
2018,2,21800249,11/20/2018,1610612764,Washington Wizards,1,1,1610612746,LA Clippers,0,0,27,27,54,13,26,39,40,53,93,32,7,39,15,39,27,6,7,105,125
2021,2,22100080,10/30/2021,1610612740,New Orleans Pelicans,1,0,1610612752,New York Knicks,0,1,31,28,59,11,22,33,42,50,92,22,2,24,17,34,30,7,12,99,117
2021,2,22100080,10/30/2021,1610612752,New York Knicks,0,1,1610612740,New Orleans Pelicans,1,0,23,25,48,19,14,33,42,39,81,20,5,25,8,33,22,7,12,98,123
2016,2,21601056,3/21/2017,1610612750,Minnesota Timberwolves,1,0,1610612759,San Antonio Spurs,0,1,25,32,57,7,8,15,32,40,72,22,3,25,16,25,20,12,23,91,93
2016,2,21601056,3/21/2017,1610612759,San Antonio Spurs,0,1,1610612750,Minnesota Timberwolves,1,0,29,24,53,8,16,24,37,40,77,18,4,22,13,28,22,10,16,90,100
2018,2,21800844,2/11/2019,1610612742,Dallas Mavericks,0,0,1610612745,Houston Rockets,1,1,22,15,37,13,23,36,35,38,73,21,6,27,8,32,21,13,18,96,104
2018,2,21800844,2/11/2019,1610612745,Houston Rockets,1,1,1610612742,Dallas Mavericks,0,0,19,11,30,23,37,60,42,48,90,13,2,15,13,35,28,5,11,97,120
2018,2,21800665,1/17/2019,1610612752,New York Knicks,0,0,1610612764,Washington Wizards,1,1,27,31,58,12,17,29,39,48,87,10,2,12,12,37,15,9,16,98,100
2018,2,21800665,1/17/2019,1610612764,Washington Wizards,1,1,1610612752,New York Knicks,0,0,33,32,65,7,20,27,40,52,92,14,6,20,19,37,23,6,14,98,101
2018,2,21800366,12/6/2018,1610612756,Phoenix Suns,0,0,1610612757,Portland Trail Blazers,1,1,30,34,64,5,22,27,35,56,91,11,3,14,15,43,20,10,17,98,86
2018,2,21800366,12/6/2018,1610612757,Portland Trail Blazers,1,1,1610612756,Phoenix Suns,0,0,32,26,58,9,18,27,41,44,85,17,10,27,17,31,24,11,17,99,108
2018,2,21800139,11/4/2018,1610612747,Los Angeles Lakers,1,0,1610612761,Toronto Raptors,0,1,33,28,61,6,18,24,39,46,85,23,6,29,10,38,25,9,16,103,107
2018,2,21800139,11/4/2018,1610612761,Toronto Raptors,0,1,1610612747,Los Angeles Lakers,1,0,39,24,63,10,25,35,49,49,98,13,1,14,15,34,32,6,13,103,121
2023,2,22300781,2/14/2024,1610612741,Chicago Bulls,0,0,1610612739,Cleveland Cavaliers,1,1,24,26,50,14,19,33,38,45,83,15,2,17,14,32,18,6,15,93,105
2021,2,22100079,10/30/2021,1610612753,Orlando Magic,0,0,1610612765,Detroit Pistons,1,1,22,33,55,16,16,32,38,49,87,11,4,15,14,36,21,12,18,98,103
2021,2,22100079,10/30/2021,1610612765,Detroit Pistons,1,1,1610612753,Orlando Magic,0,0,22,24,46,14,29,43,36,53,89,24,6,30,22,34,26,5,16,98,110
2019,2,21900233,11/23/2019,1610612749,Milwaukee Bucks,1,1,1610612765,Detroit Pistons,0,0,28,19,47,13,24,37,41,43,84,9,9,18,13,37,25,7,21,101,104
2019,2,21900233,11/23/2019,1610612765,Detroit Pistons,0,0,1610612749,Milwaukee Bucks,1,1,27,29,56,10,25,35,37,54,91,6,4,10,11,45,22,10,16,101,90
2020,2,22000820,4/12/2021,1610612762,Utah Jazz,1,0,1610612764,Washington Wizards,0,1,26,23,49,15,21,36,41,44,85,24,7,31,12,38,21,7,14,103,121
2020,2,22000820,4/12/2021,1610612764,Washington Wizards,0,1,1610612762,Utah Jazz,1,0,38,33,71,9,10,19,47,43,90,22,6,28,9,36,29,2,8,102,125
2016,2,21600511,1/1/2017,1610612750,Minnesota Timberwolves,1,0,1610612757,Portland Trail Blazers,0,1,28,36,64,7,16,23,35,52,87,12,6,18,19,37,21,10,17,93,89
2016,2,21600511,1/1/2017,1610612757,Portland Trail Blazers,0,1,1610612750,Minnesota Timberwolves,1,0,30,21,51,6,16,22,36,37,73,17,11,28,6,36,13,11,14,92,95
2016,2,21600088,11/6/2016,1610612757,Portland Trail Blazers,0,1,1610612763,Memphis Grizzlies,1,0,18,20,38,14,19,33,32,39,71,22,5,27,8,34,19,9,15,92,100
2016,2,21600088,11/6/2016,1610612763,Memphis Grizzlies,1,0,1610612757,Portland Trail Blazers,0,1,25,30,55,6,20,26,31,50,81,26,6,32,16,35,15,7,13,93,94
2018,2,21800968,3/6/2019,1610612737,Atlanta Hawks,1,0,1610612759,San Antonio Spurs,0,1,23,26,49,13,30,43,36,56,92,19,5,24,13,47,21,4,14,104,104
2018,2,21800968,3/6/2019,1610612759,San Antonio Spurs,0,1,1610612737,Atlanta Hawks,1,0,34,22,56,10,23,33,44,45,89,13,5,18,9,39,27,8,16,103,111
2014,2,21401171,4/8/2015,1610612742,Dallas Mavericks,1,1,1610612756,Phoenix Suns,0,0,41,35,76,4,14,18,45,49,94,13,3,16,16,33,18,6,8,93,107
2018,2,21800747,1/28/2019,1610612743,Denver Nuggets,0,1,1610612763,Memphis Grizzlies,1,0,29,19,48,8,28,36,37,47,84,13,1,14,13,35,17,5,15,93,95
2018,2,21800747,1/28/2019,1610612763,Memphis Grizzlies,1,0,1610612743,Denver Nuggets,0,1,26,20,46,9,23,32,35,43,78,13,6,19,12,34,26,10,20,93,92
2018,2,21800666,1/17/2019,1610612758,Sacramento Kings,0,0,1610612766,Charlotte Hornets,1,1,28,27,55,11,22,33,39,49,88,6,7,13,14,38,28,11,18,98,95
2018,2,21800666,1/17/2019,1610612766,Charlotte Hornets,1,1,1610612758,Sacramento Kings,0,0,28,21,49,11,27,38,39,48,87,25,4,29,16,34,21,7,13,99,114
2018,2,21800589,1/6/2019,1610612754,Indiana Pacers,0,0,1610612761,Toronto Raptors,1,1,39,38,77,4,13,17,43,51,94,15,5,20,18,36,24,9,14,100,105
2018,2,21800589,1/6/2019,1610612761,Toronto Raptors,1,1,1610612754,Indiana Pacers,0,0,27,25,52,17,16,33,44,41,85,16,1,17,9,33,30,8,15,98,121
2018,2,21800508,12/26/2018,1610612739,Cleveland Cavaliers,0,0,1610612763,Memphis Grizzlies,1,1,24,40,64,9,20,29,33,60,93,12,3,15,28,33,19,7,17,92,87
2018,2,21800508,12/26/2018,1610612763,Memphis Grizzlies,1,1,1610612739,Cleveland Cavaliers,0,0,31,19,50,5,17,22,36,36,72,18,6,24,5,36,22,9,13,90,95
2018,2,21800435,12/15/2018,1610612750,Minnesota Timberwolves,0,0,1610612756,Phoenix Suns,1,1,32,29,61,7,28,35,39,57,96,14,5,19,16,43,26,6,11,99,99
2018,2,21800435,12/15/2018,1610612756,Phoenix Suns,1,1,1610612750,Minnesota Timberwolves,0,0,32,30,62,9,19,28,41,49,90,16,4,20,16,34,30,10,16,99,107
2018,2,21800305,11/27/2018,1610612754,Indiana Pacers,0,1,1610612756,Phoenix Suns,1,0,27,37,64,11,15,26,38,52,90,22,7,29,22,34,25,8,12,97,109
2018,2,21800305,11/27/2018,1610612756,Phoenix Suns,1,0,1610612754,Indiana Pacers,0,1,31,31,62,10,20,30,41,51,92,12,6,18,13,38,20,8,9,96,104
2021,2,22100078,10/30/2021,1610612738,Boston Celtics,0,0,1610612764,Washington Wizards,1,1,42,39,81,2,24,26,44,63,107,22,3,25,13,53,23,6,12,119,112
2021,2,22100078,10/30/2021,1610612764,Washington Wizards,1,1,1610612738,Boston Celtics,0,0,28,40,68,10,26,36,38,66,104,29,7,36,15,54,19,8,13,119,115
2016,2,21601055,3/21/2017,1610612742,Dallas Mavericks,1,0,1610612744,Golden State Warriors,0,1,22,36,58,11,23,34,33,59,92,10,2,12,14,45,24,10,11,94,87
2016,2,21601055,3/21/2017,1610612744,Golden State Warriors,0,1,1610612742,Dallas Mavericks,1,0,30,18,48,13,17,30,43,35,78,13,3,16,10,26,34,8,16,96,112
2014,2,21401171,4/8/2015,1610612756,Phoenix Suns,0,0,1610612742,Dallas Mavericks,1,1,32,25,57,8,17,25,40,42,82,16,3,19,9,33,22,3,12,94,104
2014,2,21400685,1/28/2015,1610612742,Dallas Mavericks,0,0,1610612745,Houston Rockets,1,1,25,32,57,10,15,25,35,47,82,14,2,16,15,32,16,14,24,98,94
2014,2,21400685,1/28/2015,1610612745,Houston Rockets,1,1,1610612742,Dallas Mavericks,0,0,22,31,53,14,21,35,36,52,88,13,2,15,14,39,21,10,16,98,99
2018,2,21801116,3/26/2019,1610612747,Los Angeles Lakers,1,1,1610612764,Washington Wizards,0,0,37,19,56,11,22,33,48,41,89,17,6,23,13,30,37,5,19,105,124
2018,2,21801116,3/26/2019,1610612764,Washington Wizards,0,0,1610612747,Los Angeles Lakers,1,1,33,25,58,6,26,32,39,51,90,22,5,27,14,39,21,9,17,106,106
2018,2,21800588,1/6/2019,1610612760,Oklahoma City Thunder,1,0,1610612764,Washington Wizards,0,1,28,35,63,10,15,25,38,50,88,12,7,19,10,44,22,8,15,100,98
2018,2,21800588,1/6/2019,1610612764,Washington Wizards,0,1,1610612760,Oklahoma City Thunder,1,0,34,30,64,10,27,37,44,57,101,18,4,22,21,39,25,8,9,100,116
2018,2,21800196,11/12/2018,1610612756,Phoenix Suns,0,0,1610612760,Oklahoma City Thunder,1,1,32,23,55,7,19,26,39,42,81,16,3,19,12,31,25,12,18,99,101
2018,2,21800196,11/12/2018,1610612760,Oklahoma City Thunder,1,1,1610612756,Phoenix Suns,0,0,30,35,65,13,14,27,43,49,92,19,1,20,20,30,23,5,14,99,118
2018,2,21800140,11/5/2018,1610612748,Miami Heat,0,1,1610612765,Detroit Pistons,1,0,32,35,67,12,19,31,44,54,98,20,11,31,16,43,24,8,17,114,120
2018,2,21800140,11/5/2018,1610612765,Detroit Pistons,1,0,1610612748,Miami Heat,0,1,32,38,70,11,24,35,43,62,105,18,10,28,24,43,27,10,19,115,115
2017,2,21701183,4/6/2018,1610612739,Cleveland Cavaliers,0,0,1610612755,Philadelphia 76ers,1,1,29,24,53,16,18,34,45,42,87,24,9,33,12,35,24,11,15,106,130
2017,2,21701183,4/6/2018,1610612755,Philadelphia 76ers,1,1,1610612739,Cleveland Cavaliers,0,0,36,26,62,14,25,39,50,51,101,18,3,21,17,36,35,6,12,105,132
2017,2,21701160,4/3/2018,1610612741,Chicago Bulls,1,1,1610612766,Charlotte Hornets,0,0,31,34,65,15,19,34,46,53,99,13,5,18,14,41,26,3,8,101,120
2017,2,21701160,4/3/2018,1610612766,Charlotte Hornets,0,0,1610612741,Chicago Bulls,1,1,27,20,47,13,21,34,40,41,81,21,7,28,13,33,24,9,20,100,114
2017,2,21701063,3/20/2018,1610612756,Phoenix Suns,1,0,1610612765,Detroit Pistons,0,1,27,29,56,7,27,34,34,56,90,13,7,20,19,40,22,12,19,99,88
2017,2,21701063,3/20/2018,1610612765,Detroit Pistons,0,1,1610612756,Phoenix Suns,1,0,28,33,61,15,21,36,43,54,97,14,2,16,14,41,22,1,8,99,115
2021,2,22100077,10/29/2021,1610612739,Cleveland Cavaliers,0,0,1610612747,Los Angeles Lakers,1,1,25,28,53,12,22,34,37,50,87,15,7,22,20,32,28,9,15,93,101
2021,2,22100077,10/29/2021,1610612747,Los Angeles Lakers,1,1,1610612739,Cleveland Cavaliers,0,0,34,23,57,12,15,27,46,38,84,9,1,10,18,21,24,10,22,93,113
2016,2,21601054,3/21/2017,1610612740,New Orleans Pelicans,1,1,1610612763,Memphis Grizzlies,0,0,26,33,59,9,20,29,35,53,88,16,3,19,16,38,16,7,13,94,95
2016,2,21601054,3/21/2017,1610612763,Memphis Grizzlies,0,0,1610612740,New Orleans Pelicans,1,1,23,21,44,9,26,35,32,47,79,9,4,13,5,42,17,8,15,93,82
2016,2,21600510,1/1/2017,1610612753,Orlando Magic,0,0,1610612754,Indiana Pacers,1,1,32,27,59,10,28,38,42,55,97,10,1,11,15,41,25,5,10,98,104
2016,2,21600510,1/1/2017,1610612754,Indiana Pacers,1,1,1610612753,Orlando Magic,0,0,34,30,64,9,13,22,43,43,86,22,2,24,11,33,28,6,11,98,117
2019,2,21900015,10/24/2019,1610612745,Houston Rockets,1,0,1610612749,Milwaukee Bucks,0,1,17,25,42,16,32,48,33,57,90,29,10,39,14,50,25,7,14,109,111
2019,2,21900015,10/24/2019,1610612749,Milwaukee Bucks,0,1,1610612745,Houston Rockets,1,0,30,23,53,16,30,46,46,53,99,9,9,18,9,49,31,6,11,108,117
2014,2,21401172,4/8/2015,1610612750,Minnesota Timberwolves,0,0,1610612757,Portland Trail Blazers,1,1,29,45,74,3,8,11,32,53,85,24,5,29,15,41,16,8,11,94,91
2014,2,21401172,4/8/2015,1610612757,Portland Trail Blazers,1,1,1610612750,Minnesota Timberwolves,0,0,30,22,52,12,21,33,42,43,85,20,3,23,18,25,25,12,15,95,116
2014,2,21400684,1/28/2015,1610612758,Sacramento Kings,0,0,1610612761,Toronto Raptors,1,1,28,28,56,7,10,17,35,38,73,25,4,29,11,28,17,12,18,95,102
2014,2,21400684,1/28/2015,1610612761,Toronto Raptors,1,1,1610612758,Sacramento Kings,0,0,26,24,50,17,17,34,43,41,84,16,3,19,14,28,29,6,17,94,119
2018,2,21800434,12/15/2018,1610612746,LA Clippers,0,0,1610612760,Oklahoma City Thunder,1,1,25,25,50,13,12,25,38,37,75,15,7,22,6,33,18,12,25,104,104
2018,2,21800434,12/15/2018,1610612760,Oklahoma City Thunder,1,1,1610612746,LA Clippers,0,0,33,35,68,9,13,22,42,48,90,17,7,24,10,41,26,8,13,103,110
2018,2,21800195,11/12/2018,1610612750,Minnesota Timberwolves,1,1,1610612751,Brooklyn Nets,0,0,32,25,57,10,13,23,42,38,80,26,5,31,15,23,26,10,23,104,120
2018,2,21800195,11/12/2018,1610612751,Brooklyn Nets,0,0,1610612750,Minnesota Timberwolves,1,1,22,29,51,18,32,50,40,61,101,15,7,22,20,44,28,8,13,103,113
2017,2,21701203,4/8/2018,1610612744,Golden State Warriors,0,1,1610612756,Phoenix Suns,1,0,34,24,58,13,19,32,47,43,90,10,5,15,7,39,27,4,11,101,117
2017,2,21701203,4/8/2018,1610612756,Phoenix Suns,1,0,1610612744,Golden State Warriors,0,1,29,28,57,10,25,35,39,53,92,12,4,16,13,42,24,9,15,100,100
2017,2,21701161,4/3/2018,1610612745,Houston Rockets,1,1,1610612764,Washington Wizards,0,0,27,11,38,16,30,46,43,41,84,18,9,27,12,33,26,6,12,96,120
2017,2,21701161,4/3/2018,1610612764,Washington Wizards,0,0,1610612745,Houston Rockets,1,1,26,21,47,12,13,25,38,34,72,16,7,23,3,36,25,13,17,96,104
2017,2,21701104,3/26/2018,1610612747,Los Angeles Lakers,0,0,1610612765,Detroit Pistons,1,1,34,28,62,6,17,23,40,45,85,20,5,25,6,41,29,4,10,99,106
2017,2,21701104,3/26/2018,1610612765,Detroit Pistons,1,1,1610612747,Los Angeles Lakers,0,0,31,36,67,13,20,33,44,56,100,11,4,15,15,43,21,3,7,100,112
2021,2,22100076,10/29/2021,1610612746,LA Clippers,0,0,1610612757,Portland Trail Blazers,1,1,19,26,45,15,27,42,34,53,87,9,7,16,7,50,17,8,13,99,92
2021,2,22100076,10/29/2021,1610612757,Portland Trail Blazers,1,1,1610612746,LA Clippers,0,0,22,35,57,19,22,41,41,57,98,10,6,16,21,40,21,7,14,99,111
2020,2,22000819,4/12/2021,1610612740,New Orleans Pelicans,1,1,1610612758,Sacramento Kings,0,0,36,22,58,6,13,19,42,35,77,27,12,39,11,31,24,14,23,106,117
2020,2,22000819,4/12/2021,1610612758,Sacramento Kings,0,0,1610612740,New Orleans Pelicans,1,1,29,26,55,10,25,35,39,51,90,22,15,37,11,45,21,8,10,106,110
2016,2,21601053,3/21/2017,1610612748,Miami Heat,1,1,1610612756,Phoenix Suns,0,0,31,38,69,11,16,27,42,54,96,17,6,23,18,36,17,5,15,103,112
2016,2,21601053,3/21/2017,1610612756,Phoenix Suns,0,0,1610612748,Miami Heat,1,1,32,34,66,4,12,16,36,46,82,21,8,29,17,34,14,13,24,104,97
2016,2,21600087,11/6/2016,1610612752,New York Knicks,1,0,1610612762,Utah Jazz,0,1,34,29,63,8,12,20,42,41,83,17,2,19,13,29,18,6,13,92,109
2016,2,21600087,11/6/2016,1610612762,Utah Jazz,0,1,1610612752,New York Knicks,1,0,30,20,50,8,17,25,38,37,75,30,5,35,11,30,21,8,11,91,114
2018,2,21800967,3/6/2019,1610612742,Dallas Mavericks,0,0,1610612764,Washington Wizards,1,1,30,22,52,15,26,41,45,48,93,18,10,28,17,35,27,3,7,98,123
2018,2,21800967,3/6/2019,1610612764,Washington Wizards,1,1,1610612742,Dallas Mavericks,0,0,38,22,60,12,21,33,50,43,93,20,5,25,20,26,30,7,13,98,132
2018,2,21800843,2/11/2019,1610612741,Chicago Bulls,1,0,1610612749,Milwaukee Bucks,0,1,28,40,68,9,19,28,37,59,96,16,2,18,15,44,24,6,14,105,99
2018,2,21800843,2/11/2019,1610612749,Milwaukee Bucks,0,1,1610612741,Chicago Bulls,1,0,26,16,42,12,26,38,38,42,80,24,5,29,7,37,24,8,17,103,112
2014,2,21400683,1/28/2015,1610612737,Atlanta Hawks,1,1,1610612751,Brooklyn Nets,0,0,26,23,49,12,21,33,38,44,82,25,1,26,18,27,29,6,13,91,113
2014,2,21400683,1/28/2015,1610612751,Brooklyn Nets,0,0,1610612737,Atlanta Hawks,1,1,30,33,63,9,15,24,39,48,87,15,3,18,14,36,26,4,10,91,102
2018,2,21800587,1/6/2019,1610612737,Atlanta Hawks,1,1,1610612748,Miami Heat,0,0,33,34,67,10,14,24,43,48,91,10,3,13,18,31,25,11,17,96,106
2018,2,21800587,1/6/2019,1610612748,Miami Heat,0,0,1610612737,Atlanta Hawks,1,1,26,27,53,5,29,34,31,56,87,15,12,27,16,47,23,7,14,95,82
2018,2,21800365,12/6/2018,1610612738,Boston Celtics,1,1,1610612752,New York Knicks,0,0,36,18,54,13,25,38,49,43,92,17,3,20,10,34,32,4,9,101,128
2018,2,21800365,12/6/2018,1610612752,New York Knicks,0,0,1610612738,Boston Celtics,1,1,24,32,56,12,23,35,36,55,91,16,4,20,15,42,21,8,17,101,100
2018,2,21800248,11/20/2018,1610612753,Orlando Magic,1,0,1610612761,Toronto Raptors,0,1,26,28,54,8,22,30,34,50,84,15,4,19,13,38,24,7,14,96,91
2018,2,21800248,11/20/2018,1610612761,Toronto Raptors,0,1,1610612753,Orlando Magic,1,0,30,23,53,9,25,34,39,48,87,6,2,8,11,39,23,5,16,96,93
2018,2,21800093,10/29/2018,1610612747,Los Angeles Lakers,0,0,1610612750,Minnesota Timberwolves,1,1,37,34,71,12,21,33,49,55,104,10,5,15,23,33,24,11,18,105,120
2018,2,21800093,10/29/2018,1610612750,Minnesota Timberwolves,1,1,1610612747,Los Angeles Lakers,0,0,28,41,69,14,15,29,42,56,98,26,4,30,23,34,26,8,15,105,124
2021,2,22100075,10/29/2021,1610612742,Dallas Mavericks,0,0,1610612743,Denver Nuggets,1,1,15,26,41,8,29,37,23,55,78,21,6,27,7,50,14,8,15,98,75
2021,2,22100075,10/29/2021,1610612743,Denver Nuggets,1,1,1610612742,Dallas Mavericks,0,0,32,15,47,11,25,36,43,40,83,9,4,13,10,32,28,8,20,99,106
2016,2,21601052,3/21/2017,1610612751,Brooklyn Nets,1,1,1610612765,Detroit Pistons,0,0,28,31,59,10,19,29,38,50,88,12,7,19,12,42,22,8,11,94,98
2016,2,21601052,3/21/2017,1610612765,Detroit Pistons,0,0,1610612751,Brooklyn Nets,1,1,35,34,69,5,18,23,40,52,92,11,5,16,14,40,17,1,7,93,96
2016,2,21600509,1/1/2017,1610612748,Miami Heat,1,0,1610612765,Detroit Pistons,0,1,21,30,51,14,12,26,35,42,77,14,4,18,5,38,25,7,12,92,98
2016,2,21600509,1/1/2017,1610612765,Detroit Pistons,0,1,1610612748,Miami Heat,1,0,33,31,64,9,13,22,42,44,86,14,8,22,16,33,16,6,13,94,107
2018,2,21800746,1/28/2019,1610612738,Boston Celtics,1,1,1610612751,Brooklyn Nets,0,0,32,28,60,13,27,40,45,55,100,9,1,10,23,33,29,10,18,101,112
2018,2,21800746,1/28/2019,1610612751,Brooklyn Nets,0,0,1610612738,Boston Celtics,1,1,26,43,69,13,21,34,39,64,103,13,3,16,26,38,20,11,17,103,104
2018,2,21800507,12/26/2018,1610612741,Chicago Bulls,1,0,1610612750,Minnesota Timberwolves,0,1,33,39,72,6,17,23,39,56,95,10,6,16,13,47,22,4,10,96,94
2018,2,21800507,12/26/2018,1610612750,Minnesota Timberwolves,0,1,1610612741,Chicago Bulls,1,0,35,26,61,11,21,32,46,47,93,16,3,19,16,33,26,6,12,97,119
2018,2,21800094,10/29/2018,1610612742,Dallas Mavericks,0,0,1610612759,San Antonio Spurs,1,1,33,24,57,10,24,34,43,48,91,12,5,17,13,38,15,17,23,111,108
2018,2,21800094,10/29/2018,1610612759,San Antonio Spurs,1,1,1610612742,Dallas Mavericks,0,0,33,38,71,9,11,20,42,49,91,20,1,21,8,41,27,9,17,111,113
2014,2,21401170,4/8/2015,1610612758,Sacramento Kings,0,0,1610612762,Utah Jazz,1,1,26,33,59,7,9,16,33,42,75,18,10,28,12,36,19,5,10,87,91
2014,2,21401170,4/8/2015,1610612762,Utah Jazz,1,1,1610612758,Sacramento Kings,0,0,23,20,43,13,18,31,36,38,74,18,7,25,15,27,23,9,16,87,103
2016,2,21600508,1/1/2017,1610612737,Atlanta Hawks,1,1,1610612759,San Antonio Spurs,0,0,28,36,64,14,14,28,42,50,92,16,11,27,15,41,25,5,12,102,114
2016,2,21600508,1/1/2017,1610612759,San Antonio Spurs,0,0,1610612737,Atlanta Hawks,1,1,33,30,63,9,18,27,42,48,90,19,3,22,13,37,27,6,12,102,112
2019,2,21900014,10/24/2019,1610612737,Atlanta Hawks,0,1,1610612765,Detroit Pistons,1,0,33,22,55,11,20,31,44,42,86,18,3,21,12,32,27,6,13,96,117
2019,2,21900014,10/24/2019,1610612765,Detroit Pistons,1,0,1610612737,Atlanta Hawks,0,1,25,23,48,10,27,37,35,50,85,20,2,22,13,38,20,9,14,96,100
2014,2,21400682,1/28/2015,1610612755,Philadelphia 76ers,1,1,1610612765,Detroit Pistons,0,0,30,27,57,7,14,21,37,41,78,8,4,12,19,25,27,12,22,87,89
2014,2,21400682,1/28/2015,1610612765,Detroit Pistons,0,0,1610612755,Philadelphia 76ers,1,1,21,34,55,2,18,20,23,52,75,21,2,23,19,35,15,11,20,86,69
2020,2,22000818,4/12/2021,1610612742,Dallas Mavericks,1,0,1610612755,Philadelphia 76ers,0,1,26,21,47,9,27,36,35,48,83,16,4,20,13,36,16,9,15,95,95
2020,2,22000818,4/12/2021,1610612755,Philadelphia 76ers,0,1,1610612742,Dallas Mavericks,1,0,27,22,49,12,19,31,39,41,80,23,10,33,10,37,24,7,9,95,113
2018,2,21801115,3/26/2019,1610612743,Denver Nuggets,1,1,1610612765,Detroit Pistons,0,0,30,30,60,7,20,27,37,50,87,14,6,20,14,40,22,5,14,97,95
2018,2,21801115,3/26/2019,1610612765,Detroit Pistons,0,0,1610612743,Denver Nuggets,1,1,25,35,60,11,31,42,36,66,102,9,4,13,18,50,19,3,6,97,92
2018,2,21800663,1/16/2019,1610612740,New Orleans Pelicans,0,0,1610612744,Golden State Warriors,1,1,28,33,61,19,18,37,47,51,98,27,6,33,9,48,36,8,10,114,140
2018,2,21800663,1/16/2019,1610612744,Golden State Warriors,1,1,1610612740,New Orleans Pelicans,0,0,25,28,53,24,25,49,49,53,102,25,6,31,13,42,33,6,10,114,147
2018,2,21800304,11/27/2018,1610612743,Denver Nuggets,1,1,1610612747,Los Angeles Lakers,0,0,38,34,72,9,16,25,47,50,97,14,1,15,18,32,28,5,12,98,117
2018,2,21800304,11/27/2018,1610612747,Los Angeles Lakers,0,0,1610612743,Denver Nuggets,1,1,29,23,52,5,30,35,34,53,87,12,6,18,10,46,19,7,12,99,85
2021,2,22100074,10/29/2021,1610612740,New Orleans Pelicans,1,0,1610612758,Sacramento Kings,0,1,33,31,64,9,25,34,42,56,98,16,9,25,19,44,18,4,10,101,109
2021,2,22100074,10/29/2021,1610612758,Sacramento Kings,0,1,1610612740,New Orleans Pelicans,1,0,31,22,53,9,18,27,40,40,80,24,1,25,5,36,19,9,14,100,113
2019,2,21900232,11/23/2019,1610612747,Los Angeles Lakers,0,1,1610612763,Memphis Grizzlies,1,0,25,20,45,13,26,39,38,46,84,20,9,29,15,36,19,12,16,100,109
2019,2,21900232,11/23/2019,1610612763,Memphis Grizzlies,1,0,1610612747,Los Angeles Lakers,0,1,29,30,59,14,16,30,43,46,89,8,5,13,17,31,28,12,22,99,108
2016,2,21601051,3/21/2017,1610612741,Chicago Bulls,0,0,1610612761,Toronto Raptors,1,1,28,25,53,14,23,37,42,48,90,22,5,27,12,39,25,6,15,106,120
2016,2,21601051,3/21/2017,1610612761,Toronto Raptors,1,1,1610612741,Chicago Bulls,0,0,39,33,72,8,15,23,47,48,95,20,7,27,19,33,18,9,17,106,122
2016,2,21600507,12/31/2016,1610612746,LA Clippers,0,0,1610612760,Oklahoma City Thunder,1,1,23,22,45,8,22,30,31,44,75,18,3,21,9,37,14,9,17,92,88
2016,2,21600507,12/31/2016,1610612760,Oklahoma City Thunder,1,1,1610612746,LA Clippers,0,0,27,22,49,10,19,29,37,41,78,30,5,35,10,36,25,4,9,91,114
2018,2,21801114,3/26/2019,1610612742,Dallas Mavericks,1,0,1610612758,Sacramento Kings,0,1,24,8,32,15,30,45,39,38,77,28,4,32,12,27,27,4,11,94,121
2018,2,21801114,3/26/2019,1610612758,Sacramento Kings,0,1,1610612742,Dallas Mavericks,1,0,34,30,64,10,13,23,44,43,87,27,5,32,16,31,27,1,7,94,125
2018,2,21800966,3/6/2019,1610612750,Minnesota Timberwolves,0,0,1610612765,Detroit Pistons,1,1,29,28,57,12,15,27,41,43,84,20,1,21,9,34,25,5,13,96,114
2018,2,21800966,3/6/2019,1610612765,Detroit Pistons,1,1,1610612750,Minnesota Timberwolves,0,0,36,24,60,14,19,33,50,43,93,17,5,22,11,33,29,3,5,95,131
2018,2,21800745,1/28/2019,1610612744,Golden State Warriors,0,1,1610612754,Indiana Pacers,1,0,40,27,67,13,18,31,53,45,98,13,3,16,18,28,39,4,14,103,132
2018,2,21800745,1/28/2019,1610612754,Indiana Pacers,1,0,1610612744,Golden State Warriors,0,1,28,36,64,12,18,30,40,54,94,8,2,10,14,41,29,9,15,101,100
2014,2,21400681,1/28/2015,1610612739,Cleveland Cavaliers,1,1,1610612757,Portland Trail Blazers,0,0,19,29,48,15,22,37,34,51,85,16,2,18,20,32,16,5,9,84,99
2014,2,21400681,1/28/2015,1610612757,Portland Trail Blazers,0,0,1610612739,Cleveland Cavaliers,1,1,25,24,49,10,21,31,35,45,80,14,3,17,13,32,18,3,8,84,94
2018,2,21800433,12/15/2018,1610612741,Chicago Bulls,0,1,1610612759,San Antonio Spurs,1,0,31,26,57,6,23,29,37,49,86,18,3,21,15,35,16,3,9,92,98
2018,2,21800433,12/15/2018,1610612759,San Antonio Spurs,1,0,1610612741,Chicago Bulls,0,1,25,27,52,7,14,21,32,41,73,22,4,26,9,33,18,12,15,92,93
2018,2,21800364,12/5/2018,1610612747,Los Angeles Lakers,1,1,1610612759,San Antonio Spurs,0,0,28,21,49,14,25,39,42,46,88,23,10,33,10,40,21,8,12,103,121
2018,2,21800364,12/5/2018,1610612759,San Antonio Spurs,0,0,1610612747,Los Angeles Lakers,1,1,36,33,69,7,20,27,43,53,96,20,0,20,15,38,18,6,11,104,113
2019,2,21900231,11/23/2019,1610612739,Cleveland Cavaliers,1,1,1610612757,Portland Trail Blazers,0,0,27,29,56,10,21,31,37,50,87,26,6,32,17,34,19,6,13,98,110
2019,2,21900231,11/23/2019,1610612757,Portland Trail Blazers,0,0,1610612739,Cleveland Cavaliers,1,1,25,22,47,14,26,40,39,48,87,12,4,16,7,44,21,9,10,97,104
2023,2,22300800,2/22/2024,1610612743,Denver Nuggets,1,1,1610612764,Washington Wizards,0,0,49,21,70,7,24,31,56,45,101,11,4,15,17,29,41,14,16,107,130
2023,2,22300798,2/22/2024,1610612740,New Orleans Pelicans,1,1,1610612745,Houston Rockets,0,0,34,21,55,16,25,41,50,46,96,11,7,18,14,37,35,6,14,104,127
2023,2,22300798,2/22/2024,1610612745,Houston Rockets,0,0,1610612740,New Orleans Pelicans,1,1,21,20,41,15,26,41,36,46,82,18,10,28,17,35,27,16,24,103,105
2023,2,22300810,2/23/2024,1610612748,Miami Heat,0,1,1610612740,New Orleans Pelicans,1,0,25,28,53,13,16,29,38,44,82,17,8,25,13,36,20,6,15,95,106
2023,2,22300810,2/23/2024,1610612740,New Orleans Pelicans,1,0,1610612748,Miami Heat,0,1,32,40,72,7,25,32,39,65,104,10,3,13,25,41,20,6,11,96,95
2023,2,22300783,2/14/2024,1610612745,Houston Rockets,0,0,1610612763,Memphis Grizzlies,1,1,31,35,66,11,25,36,42,60,102,18,10,28,25,40,20,8,9,100,113
2023,2,22300800,2/22/2024,1610612764,Washington Wizards,0,0,1610612743,Denver Nuggets,1,1,23,43,66,17,21,38,40,64,104,13,10,23,20,50,30,11,14,107,110
2023,2,22300915,3/8/2024,1610612747,Los Angeles Lakers,1,1,1610612749,Milwaukee Bucks,0,0,31,25,56,16,18,34,47,43,90,13,6,19,6,40,27,3,5,97,123
2023,2,22300806,2/23/2024,1610612756,Phoenix Suns,0,0,1610612745,Houston Rockets,1,1,31,33,64,7,24,31,38,57,95,27,8,35,20,41,23,8,10,102,110
2023,2,22300783,2/14/2024,1610612763,Memphis Grizzlies,1,1,1610612745,Houston Rockets,0,0,24,20,44,15,20,35,39,40,79,28,13,41,9,36,27,9,11,99,121
2023,2,22300915,3/8/2024,1610612749,Milwaukee Bucks,0,0,1610612747,Los Angeles Lakers,1,1,30,22,52,16,25,41,46,47,93,14,3,17,12,37,28,2,8,98,122
2023,2,22300916,3/8/2024,1610612757,Portland Trail Blazers,1,0,1610612745,Houston Rockets,0,1,21,33,54,16,19,35,37,52,89,17,8,25,22,33,22,12,17,97,107
2023,2,22300916,3/8/2024,1610612745,Houston Rockets,0,1,1610612757,Portland Trail Blazers,1,0,31,26,57,14,23,37,45,49,94,19,7,26,17,34,33,5,7,97,123
2021,2,22100073,10/29/2021,1610612748,Miami Heat,1,1,1610612766,Charlotte Hornets,0,0,34,22,56,9,26,35,43,48,91,19,0,19,21,27,23,8,18,97,114
2021,2,22100073,10/29/2021,1610612766,Charlotte Hornets,0,0,1610612748,Miami Heat,1,1,22,31,53,13,24,37,35,55,90,16,6,22,14,45,21,6,11,97,99
2016,2,21601050,3/20/2017,1610612746,LA Clippers,1,1,1610612752,New York Knicks,0,0,33,23,56,10,21,31,43,44,87,18,6,24,11,34,25,6,10,97,114
2016,2,21601050,3/20/2017,1610612752,New York Knicks,0,0,1610612746,LA Clippers,1,1,34,31,65,6,18,24,40,49,89,19,5,24,14,37,24,8,12,97,105
2020,2,22000817,4/13/2021,1610612750,Minnesota Timberwolves,1,0,1610612751,Brooklyn Nets,0,1,17,21,38,13,36,49,30,57,87,24,9,33,14,47,16,8,14,104,97
2020,2,22000817,4/13/2021,1610612751,Brooklyn Nets,0,1,1610612750,Minnesota Timberwolves,1,0,31,24,55,15,21,36,46,45,91,20,4,24,15,33,31,13,19,105,127
2016,2,21600086,11/5/2016,1610612746,LA Clippers,0,1,1610612759,San Antonio Spurs,1,0,38,30,68,9,14,23,47,44,91,13,1,14,9,35,24,5,9,94,116
2016,2,21600086,11/5/2016,1610612759,San Antonio Spurs,1,0,1610612746,LA Clippers,0,1,20,29,49,10,15,25,30,44,74,22,3,25,8,37,19,8,15,94,92
2018,2,21800664,1/16/2019,1610612746,LA Clippers,1,0,1610612762,Utah Jazz,0,1,35,41,76,10,12,22,45,53,98,9,5,14,12,43,24,9,12,104,109
2018,2,21800664,1/16/2019,1610612762,Utah Jazz,0,1,1610612746,LA Clippers,1,0,33,20,53,11,22,33,44,42,86,30,7,37,13,31,27,8,13,105,129
2014,2,21401169,4/8/2015,1610612743,Denver Nuggets,1,1,1610612747,Los Angeles Lakers,0,0,31,27,58,13,17,30,44,44,88,18,6,24,14,33,26,7,9,95,119
2014,2,21401169,4/8/2015,1610612747,Los Angeles Lakers,0,0,1610612743,Denver Nuggets,1,1,31,28,59,5,11,16,36,39,75,24,11,35,9,36,15,7,15,95,101
2017,2,21701027,3/15/2018,1610612756,Phoenix Suns,0,0,1610612762,Utah Jazz,1,1,25,42,67,7,9,16,32,51,83,17,7,24,14,42,14,12,22,104,88
2017,2,21701027,3/15/2018,1610612762,Utah Jazz,1,1,1610612756,Phoenix Suns,0,0,30,31,61,12,24,36,42,55,97,20,12,32,16,45,29,4,7,104,116
2014,2,21400680,1/27/2015,1610612747,Los Angeles Lakers,1,0,1610612764,Washington Wizards,0,1,32,35,67,5,15,20,37,50,87,13,3,16,9,43,17,8,11,97,92
2014,2,21400680,1/27/2015,1610612764,Washington Wizards,0,1,1610612747,Los Angeles Lakers,1,0,34,28,62,4,12,16,38,40,78,18,9,27,11,32,19,9,16,96,98
2017,2,21701026,3/15/2018,1610612743,Denver Nuggets,1,1,1610612765,Detroit Pistons,0,0,31,26,57,12,16,28,43,42,85,22,6,28,12,32,26,8,16,101,120
2017,2,21701026,3/15/2018,1610612765,Detroit Pistons,0,0,1610612743,Denver Nuggets,1,1,30,35,65,14,13,27,44,48,92,11,6,17,12,39,30,7,11,101,113
2017,2,21701025,3/15/2018,1610612740,New Orleans Pelicans,0,0,1610612759,San Antonio Spurs,1,1,30,44,74,6,10,16,36,54,90,15,1,16,15,39,18,10,16,98,93
2017,2,21701025,3/15/2018,1610612759,San Antonio Spurs,1,1,1610612740,New Orleans Pelicans,0,0,30,43,73,7,19,26,37,62,99,17,2,19,19,44,16,7,11,100,98
2017,2,21701024,3/15/2018,1610612741,Chicago Bulls,0,1,1610612763,Memphis Grizzlies,1,0,20,19,39,15,26,41,35,45,80,26,7,33,11,38,23,7,15,98,111
2017,2,21701024,3/15/2018,1610612763,Memphis Grizzlies,1,0,1610612741,Chicago Bulls,0,1,25,27,52,13,22,35,38,49,87,21,4,25,17,35,27,10,15,99,110
2017,2,21701023,3/15/2018,1610612745,Houston Rockets,1,1,1610612746,LA Clippers,0,0,23,26,49,12,29,41,35,55,90,19,4,23,21,36,20,3,11,93,101
2017,2,21701023,3/15/2018,1610612746,LA Clippers,0,0,1610612745,Houston Rockets,1,1,40,39,79,4,14,18,44,53,97,4,4,8,20,35,16,4,9,94,96
2017,2,21701022,3/15/2018,1610612752,New York Knicks,1,0,1610612755,Philadelphia 76ers,0,1,40,27,67,5,15,20,45,42,87,15,9,24,11,35,26,8,13,100,110
2017,2,21701022,3/15/2018,1610612755,Philadelphia 76ers,0,1,1610612752,New York Knicks,1,0,26,28,54,15,22,37,41,50,91,21,13,34,22,36,29,8,14,100,118
2017,2,21701021,3/15/2018,1610612737,Atlanta Hawks,1,0,1610612766,Charlotte Hornets,0,1,26,28,54,16,20,36,42,48,90,17,9,26,11,42,30,3,12,102,117
2017,2,21701021,3/15/2018,1610612766,Charlotte Hornets,0,1,1610612737,Atlanta Hawks,1,0,29,25,54,17,16,33,46,41,87,20,10,30,7,42,30,5,10,101,129
2017,2,21701020,3/15/2018,1610612754,Indiana Pacers,1,0,1610612761,Toronto Raptors,0,1,33,36,69,7,17,24,40,53,93,12,5,17,15,41,17,4,8,94,99
2017,2,21701020,3/15/2018,1610612761,Toronto Raptors,0,1,1610612754,Indiana Pacers,1,0,23,24,47,12,20,32,35,44,79,24,4,28,20,25,20,12,21,93,106
2017,2,21701019,3/14/2018,1610612744,Golden State Warriors,1,1,1610612747,Los Angeles Lakers,0,0,38,23,61,6,14,20,44,37,81,23,5,28,12,28,25,11,21,101,117
2017,2,21701019,3/14/2018,1610612747,Los Angeles Lakers,0,0,1610612744,Golden State Warriors,1,1,26,20,46,12,26,38,38,46,84,18,10,28,9,42,24,8,14,103,106
2017,2,21701018,3/14/2018,1610612748,Miami Heat,0,0,1610612758,Sacramento Kings,1,1,23,33,56,18,25,43,41,58,99,19,2,21,19,39,26,6,15,105,119
2017,2,21701018,3/14/2018,1610612758,Sacramento Kings,1,1,1610612748,Miami Heat,0,0,40,30,70,8,16,24,48,46,94,19,6,25,11,40,23,5,11,106,123
2017,2,21701017,3/14/2018,1610612738,Boston Celtics,1,0,1610612764,Washington Wizards,0,1,36,37,73,12,14,26,48,51,99,16,7,23,14,40,30,10,17,115,124
2017,2,21701017,3/14/2018,1610612764,Washington Wizards,0,1,1610612738,Boston Celtics,1,0,34,31,65,12,20,32,46,51,97,21,7,28,18,37,29,9,20,113,125
2016,2,21601049,3/20/2017,1610612744,Golden State Warriors,0,1,1610612760,Oklahoma City Thunder,1,0,25,25,50,15,18,33,40,43,83,16,5,21,11,32,28,10,17,99,111
2016,2,21601049,3/20/2017,1610612760,Oklahoma City Thunder,1,0,1610612744,Golden State Warriors,0,1,33,33,66,4,17,21,37,50,87,17,14,31,13,43,18,8,11,99,95
2014,2,21401168,4/8/2015,1610612745,Houston Rockets,0,0,1610612759,San Antonio Spurs,1,1,29,30,59,10,15,25,39,45,84,10,6,16,13,35,25,11,15,95,98
2017,2,21701016,3/14/2018,1610612749,Milwaukee Bucks,0,0,1610612753,Orlando Magic,1,1,39,35,74,10,14,24,49,49,98,9,3,12,14,37,28,10,11,101,117
2017,2,21701016,3/14/2018,1610612753,Orlando Magic,1,1,1610612749,Milwaukee Bucks,0,0,26,27,53,18,16,34,44,43,87,20,3,23,15,30,31,12,18,100,126
2014,2,21401168,4/8/2015,1610612759,San Antonio Spurs,1,1,1610612745,Houston Rockets,0,0,41,33,74,7,14,21,48,47,95,7,2,9,15,33,21,7,9,95,110
2014,2,21400679,1/27/2015,1610612741,Chicago Bulls,0,1,1610612744,Golden State Warriors,1,0,34,35,69,8,21,29,42,56,98,21,2,23,22,35,19,9,21,110,113
2017,2,21701015,3/13/2018,1610612743,Denver Nuggets,0,0,1610612747,Los Angeles Lakers,1,1,25,21,46,13,27,40,38,48,86,14,5,19,9,42,26,6,20,106,103
2017,2,21701015,3/13/2018,1610612747,Los Angeles Lakers,1,1,1610612743,Denver Nuggets,0,0,25,25,50,15,25,40,40,50,90,17,8,25,14,40,20,12,17,106,112
2014,2,21400679,1/27/2015,1610612744,Golden State Warriors,1,0,1610612741,Chicago Bulls,0,1,39,41,80,9,24,33,48,65,113,6,6,12,22,44,31,6,13,110,111
2016,2,21600506,12/31/2016,1610612756,Phoenix Suns,0,0,1610612762,Utah Jazz,1,1,29,41,70,7,10,17,36,51,87,7,3,10,11,41,9,3,11,89,86
2016,2,21600506,12/31/2016,1610612762,Utah Jazz,1,1,1610612756,Phoenix Suns,0,0,27,26,53,8,12,20,35,38,73,13,7,20,9,32,17,6,15,90,91
2017,2,21701014,3/13/2018,1610612739,Cleveland Cavaliers,0,1,1610612756,Phoenix Suns,1,0,26,26,52,17,18,35,43,44,87,26,4,30,8,38,25,10,20,110,129
2017,2,21701014,3/13/2018,1610612756,Phoenix Suns,1,0,1610612739,Cleveland Cavaliers,0,1,32,34,66,6,26,32,38,60,98,25,5,30,22,40,17,12,18,112,107
2017,2,21701013,3/13/2018,1610612762,Utah Jazz,1,1,1610612765,Detroit Pistons,0,0,29,13,42,13,21,34,42,34,76,13,10,23,14,25,29,14,24,95,110
2017,2,21701013,3/13/2018,1610612765,Detroit Pistons,0,0,1610612762,Utah Jazz,1,1,25,30,55,5,20,25,30,50,80,14,5,19,12,41,14,10,18,96,79
2017,2,21701012,3/13/2018,1610612753,Orlando Magic,0,0,1610612759,San Antonio Spurs,1,1,21,38,59,7,16,23,28,54,82,9,0,9,14,40,16,10,21,94,72
2017,2,21701012,3/13/2018,1610612759,San Antonio Spurs,1,1,1610612753,Orlando Magic,0,0,31,34,65,9,10,19,40,44,84,19,4,23,14,33,24,5,13,94,108
2017,2,21701011,3/13/2018,1610612740,New Orleans Pelicans,1,1,1610612766,Charlotte Hornets,0,0,43,39,82,9,13,22,52,52,104,6,2,8,16,37,33,8,12,105,119
2017,2,21701011,3/13/2018,1610612766,Charlotte Hornets,0,0,1610612740,New Orleans Pelicans,1,1,38,29,67,7,19,26,45,48,93,18,4,22,11,39,22,10,14,106,115
2017,2,21701010,3/13/2018,1610612741,Chicago Bulls,1,0,1610612746,LA Clippers,0,1,36,36,72,7,22,29,43,58,101,13,2,15,20,39,26,4,9,101,106
2017,2,21701010,3/13/2018,1610612746,LA Clippers,0,1,1610612741,Chicago Bulls,1,0,29,18,47,8,21,29,37,39,76,30,11,41,9,35,27,11,14,100,112
2017,2,21701009,3/13/2018,1610612742,Dallas Mavericks,0,1,1610612752,New York Knicks,1,0,26,28,54,14,21,35,40,49,89,16,2,18,15,36,22,9,12,95,110
2017,2,21701009,3/13/2018,1610612752,New York Knicks,1,0,1610612742,Dallas Mavericks,0,1,32,25,57,8,17,25,40,42,82,9,3,12,11,31,19,11,19,95,97
2016,2,21601048,3/20/2017,1610612743,Denver Nuggets,0,0,1610612745,Houston Rockets,1,1,32,25,57,12,17,29,44,42,86,24,2,26,12,31,26,12,21,104,124
2016,2,21601048,3/20/2017,1610612745,Houston Rockets,1,1,1610612743,Denver Nuggets,0,0,28,23,51,17,21,38,45,44,89,18,5,23,7,41,27,7,12,104,125
2014,2,21400678,1/27/2015,1610612742,Dallas Mavericks,1,0,1610612763,Memphis Grizzlies,0,1,31,21,52,7,19,26,38,40,78,7,3,10,10,31,20,6,16,91,90
2014,2,21400678,1/27/2015,1610612763,Memphis Grizzlies,0,1,1610612742,Dallas Mavericks,1,0,32,26,58,10,11,21,42,37,79,15,5,20,11,28,23,8,13,90,109
2017,2,21701008,3/13/2018,1610612751,Brooklyn Nets,1,0,1610612761,Toronto Raptors,0,1,20,30,50,15,21,36,35,51,86,17,2,19,12,40,21,7,12,94,102
2017,2,21701008,3/13/2018,1610612761,Toronto Raptors,0,1,1610612751,Brooklyn Nets,1,0,33,27,60,11,20,31,44,47,91,17,4,21,16,34,27,9,11,94,116
2017,2,21701007,3/13/2018,1610612737,Atlanta Hawks,1,0,1610612760,Oklahoma City Thunder,0,1,24,32,56,13,18,31,37,50,87,20,4,24,20,32,26,9,15,93,107
2017,2,21701007,3/13/2018,1610612760,Oklahoma City Thunder,0,1,1610612737,Atlanta Hawks,1,0,26,28,54,16,19,35,42,47,89,19,6,25,14,35,27,5,8,94,119
2017,2,21701006,3/13/2018,1610612750,Minnesota Timberwolves,0,1,1610612764,Washington Wizards,1,0,39,27,66,7,14,21,46,41,87,17,2,19,16,26,23,6,10,90,116
2017,2,21701006,3/13/2018,1610612764,Washington Wizards,1,0,1610612750,Minnesota Timberwolves,0,1,34,28,62,8,12,20,42,40,82,19,6,25,16,27,26,10,11,90,111
2017,2,21701005,3/13/2018,1610612754,Indiana Pacers,0,1,1610612755,Philadelphia 76ers,1,0,33,38,71,5,19,24,38,57,95,20,5,25,17,42,20,3,10,99,101
2017,2,21701005,3/13/2018,1610612755,Philadelphia 76ers,1,0,1610612754,Indiana Pacers,0,1,25,20,45,10,20,30,35,40,75,18,4,22,9,33,24,13,21,98,98
2017,2,21701004,3/12/2018,1610612748,Miami Heat,0,0,1610612757,Portland Trail Blazers,1,1,29,31,60,10,21,31,39,52,91,11,5,16,12,42,24,5,11,96,99
2017,2,21701004,3/12/2018,1610612757,Portland Trail Blazers,1,1,1610612748,Miami Heat,0,0,24,23,47,14,22,36,38,45,83,25,5,30,12,36,23,6,13,98,115
2017,2,21701003,3/12/2018,1610612758,Sacramento Kings,0,0,1610612760,Oklahoma City Thunder,1,1,26,34,60,12,21,33,38,55,93,13,3,16,17,40,21,5,11,94,101
2017,2,21701003,3/12/2018,1610612760,Oklahoma City Thunder,1,1,1610612758,Sacramento Kings,0,0,22,26,48,16,20,36,38,46,84,14,4,18,10,39,21,8,11,94,106
2017,2,21701002,3/12/2018,1610612749,Milwaukee Bucks,0,1,1610612763,Memphis Grizzlies,1,0,35,21,56,12,13,25,47,34,81,15,7,22,13,24,33,6,19,96,121
2017,2,21701002,3/12/2018,1610612763,Memphis Grizzlies,1,0,1610612749,Milwaukee Bucks,0,1,33,29,62,9,18,27,42,47,89,10,9,19,12,40,27,6,9,95,103
2017,2,21701001,3/12/2018,1610612745,Houston Rockets,1,1,1610612759,San Antonio Spurs,0,0,26,10,36,13,31,44,39,41,80,18,5,23,13,32,24,5,17,96,109
2017,2,21701001,3/12/2018,1610612759,San Antonio Spurs,0,0,1610612745,Houston Rockets,1,1,22,31,53,11,17,28,33,48,81,16,7,23,9,43,20,6,13,96,93
2017,2,21701000,3/11/2018,1610612739,Cleveland Cavaliers,0,0,1610612747,Los Angeles Lakers,1,1,29,28,57,12,19,31,41,47,88,19,4,23,9,39,22,9,12,103,113
2017,2,21701000,3/11/2018,1610612747,Los Angeles Lakers,1,1,1610612739,Cleveland Cavaliers,0,0,35,27,62,13,21,34,48,48,96,18,2,20,17,32,30,4,13,102,127
2016,2,21601047,3/20/2017,1610612738,Boston Celtics,1,1,1610612764,Washington Wizards,0,0,30,30,60,10,23,33,40,53,93,20,8,28,20,36,19,6,15,104,110
2016,2,21601047,3/20/2017,1610612764,Washington Wizards,0,0,1610612738,Boston Celtics,1,1,29,22,51,8,27,35,37,49,86,20,6,26,14,38,24,10,18,105,102
2017,2,21700999,3/11/2018,1610612751,Brooklyn Nets,1,0,1610612755,Philadelphia 76ers,0,1,23,34,57,10,18,28,33,52,85,21,3,24,16,38,17,12,18,98,97
2017,2,21700999,3/11/2018,1610612755,Philadelphia 76ers,0,1,1610612751,Brooklyn Nets,1,0,41,28,69,9,17,26,50,45,95,11,7,18,16,34,33,5,10,98,120
2017,2,21700998,3/11/2018,1610612738,Boston Celtics,1,0,1610612754,Indiana Pacers,0,1,22,22,44,12,25,37,34,47,81,17,4,21,14,34,26,9,16,95,97
2017,2,21700998,3/11/2018,1610612754,Indiana Pacers,0,1,1610612738,Boston Celtics,1,0,27,32,59,12,10,22,39,42,81,9,1,10,10,33,26,10,18,93,99
2014,2,21400677,1/27/2015,1610612748,Miami Heat,1,0,1610612749,Milwaukee Bucks,0,1,31,24,55,7,13,20,38,37,75,19,7,26,9,32,20,7,13,91,102
2014,2,21400677,1/27/2015,1610612749,Milwaukee Bucks,0,1,1610612748,Miami Heat,1,0,30,25,55,9,7,16,39,32,71,22,8,30,8,30,25,5,13,91,109
2017,2,21700997,3/11/2018,1610612742,Dallas Mavericks,1,0,1610612745,Houston Rockets,0,1,28,35,63,5,26,31,33,61,94,11,7,18,21,40,27,5,10,94,82
2017,2,21700997,3/11/2018,1610612745,Houston Rockets,0,1,1610612742,Dallas Mavericks,1,0,22,17,39,17,28,45,39,45,84,10,4,14,8,38,21,5,11,93,105
2016,2,21600505,12/31/2016,1610612739,Cleveland Cavaliers,0,1,1610612766,Charlotte Hornets,1,0,29,25,54,14,17,31,43,42,85,21,4,25,12,31,17,3,6,88,121
2016,2,21600505,12/31/2016,1610612766,Charlotte Hornets,1,0,1610612739,Cleveland Cavaliers,0,1,31,23,54,9,15,24,40,38,78,20,3,23,12,27,24,6,13,89,109
2017,2,21700996,3/11/2018,1610612743,Denver Nuggets,1,1,1610612758,Sacramento Kings,0,0,35,17,52,15,22,37,50,39,89,15,6,21,9,34,38,3,8,96,130
2017,2,21700996,3/11/2018,1610612758,Sacramento Kings,0,0,1610612743,Denver Nuggets,1,1,33,27,60,6,25,31,39,52,91,20,6,26,10,45,25,2,3,97,104
2016,2,21600085,11/5/2016,1610612749,Milwaukee Bucks,1,1,1610612758,Sacramento Kings,0,0,27,22,49,14,19,33,41,41,82,21,4,25,18,25,28,8,17,92,117
2016,2,21600085,11/5/2016,1610612758,Sacramento Kings,0,0,1610612749,Milwaukee Bucks,1,1,23,33,56,10,18,28,33,51,84,15,4,19,16,38,27,12,15,93,91
2017,2,21700995,3/11/2018,1610612740,New Orleans Pelicans,1,0,1610612762,Utah Jazz,0,1,35,37,72,6,15,21,41,52,93,11,2,13,12,40,28,4,13,99,99
2017,2,21700995,3/11/2018,1610612762,Utah Jazz,0,1,1610612740,New Orleans Pelicans,1,0,28,36,64,12,20,32,40,56,96,24,1,25,24,32,24,7,17,101,116
2017,2,21700994,3/11/2018,1610612744,Golden State Warriors,0,0,1610612750,Minnesota Timberwolves,1,1,27,28,55,10,26,36,37,54,91,19,2,21,17,39,22,7,13,100,103
2017,2,21700994,3/11/2018,1610612750,Minnesota Timberwolves,1,1,1610612744,Golden State Warriors,0,0,38,37,75,6,14,20,44,51,95,15,6,21,15,39,27,6,10,98,109
2017,2,21700993,3/11/2018,1610612737,Atlanta Hawks,1,0,1610612741,Chicago Bulls,0,1,23,19,42,19,21,40,42,40,82,19,3,22,7,36,32,10,16,100,122
2017,2,21700993,3/11/2018,1610612741,Chicago Bulls,0,1,1610612737,Atlanta Hawks,1,0,31,30,61,17,20,37,48,50,98,16,3,19,14,38,31,2,5,99,129
2017,2,21700992,3/11/2018,1610612752,New York Knicks,1,0,1610612761,Toronto Raptors,0,1,33,34,67,7,14,21,40,48,88,19,5,24,10,40,21,3,10,100,106
2017,2,21700992,3/11/2018,1610612761,Toronto Raptors,0,1,1610612752,New York Knicks,1,0,31,27,58,16,19,35,47,46,93,22,3,25,16,31,32,7,11,101,132
2017,2,21700991,3/10/2018,1610612746,LA Clippers,1,1,1610612753,Orlando Magic,0,0,34,26,60,7,11,18,41,37,78,24,4,28,10,30,17,12,15,97,113
2017,2,21700991,3/10/2018,1610612753,Orlando Magic,0,0,1610612746,LA Clippers,1,1,30,30,60,8,16,24,38,46,84,21,6,27,12,36,20,9,15,97,105
2017,2,21700990,3/10/2018,1610612759,San Antonio Spurs,0,0,1610612760,Oklahoma City Thunder,1,1,30,36,66,10,10,20,40,46,86,4,3,7,7,41,26,8,15,97,94
2017,2,21700990,3/10/2018,1610612760,Oklahoma City Thunder,1,1,1610612759,San Antonio Spurs,0,0,29,28,57,10,18,28,39,46,85,16,8,24,14,38,24,6,15,98,104
2017,2,21700989,3/10/2018,1610612742,Dallas Mavericks,1,1,1610612763,Memphis Grizzlies,0,0,27,21,48,10,19,29,37,40,77,30,5,35,10,33,21,4,11,95,114
2017,2,21700989,3/10/2018,1610612763,Memphis Grizzlies,0,0,1610612742,Dallas Mavericks,1,1,23,43,66,7,11,18,30,54,84,13,4,17,11,45,18,8,14,95,80
2016,2,21601046,3/20/2017,1610612754,Indiana Pacers,1,1,1610612762,Utah Jazz,0,0,28,39,67,10,10,20,38,49,87,21,2,23,14,36,21,5,8,91,107
2016,2,21601046,3/20/2017,1610612762,Utah Jazz,0,0,1610612754,Indiana Pacers,1,1,34,29,63,6,19,25,40,48,88,14,6,20,16,36,20,9,11,91,100
2017,2,21700988,3/10/2018,1610612748,Miami Heat,1,1,1610612764,Washington Wizards,0,0,42,18,60,10,18,28,52,36,88,15,6,21,7,33,27,4,10,99,129
2017,2,21700988,3/10/2018,1610612764,Washington Wizards,0,0,1610612748,Miami Heat,1,1,27,30,57,7,13,20,34,43,77,27,7,34,8,38,22,9,15,100,102
2017,2,21700987,3/10/2018,1610612756,Phoenix Suns,0,0,1610612766,Charlotte Hornets,1,1,24,27,51,18,14,32,42,41,83,13,6,19,8,37,27,11,15,99,115
2017,2,21700987,3/10/2018,1610612766,Charlotte Hornets,1,1,1610612756,Phoenix Suns,0,0,31,24,55,13,19,32,44,43,87,21,6,27,13,32,24,9,12,100,122
2017,2,21700986,3/9/2018,1610612739,Cleveland Cavaliers,0,0,1610612746,LA Clippers,1,1,27,24,51,12,24,36,39,48,87,12,6,18,9,41,22,6,13,99,102
2017,2,21700986,3/9/2018,1610612746,LA Clippers,1,1,1610612739,Cleveland Cavaliers,0,0,32,29,61,11,17,28,43,46,89,19,11,30,18,34,25,10,14,100,116
2017,2,21700985,3/9/2018,1610612753,Orlando Magic,0,0,1610612758,Sacramento Kings,1,1,24,25,49,9,20,29,33,45,78,13,3,16,6,41,17,7,14,93,88
2017,2,21700985,3/9/2018,1610612758,Sacramento Kings,1,1,1610612753,Orlando Magic,0,0,27,31,58,9,16,25,36,47,83,13,2,15,15,32,24,7,18,93,94
2017,2,21700984,3/9/2018,1610612744,Golden State Warriors,0,0,1610612757,Portland Trail Blazers,1,1,26,24,50,12,16,28,38,40,78,20,4,24,10,33,20,4,12,93,108
2017,2,21700984,3/9/2018,1610612757,Portland Trail Blazers,1,1,1610612744,Golden State Warriors,0,0,28,22,50,16,23,39,44,45,89,21,6,27,18,29,21,5,11,92,125
2017,2,21700983,3/9/2018,1610612743,Denver Nuggets,1,1,1610612747,Los Angeles Lakers,0,0,27,25,52,15,16,31,42,41,83,26,4,30,9,34,30,8,12,98,125
2017,2,21700983,3/9/2018,1610612747,Los Angeles Lakers,0,0,1610612743,Denver Nuggets,1,1,31,26,57,14,21,35,45,47,92,12,4,16,18,32,25,10,16,99,116
2017,2,21700982,3/9/2018,1610612740,New Orleans Pelicans,1,0,1610612764,Washington Wizards,0,1,32,30,62,6,14,20,38,44,82,15,3,18,4,41,23,10,15,102,97
2017,2,21700982,3/9/2018,1610612764,Washington Wizards,0,1,1610612740,New Orleans Pelicans,1,0,37,33,70,9,17,26,46,50,96,15,5,20,15,38,34,3,12,102,116
2017,2,21700981,3/9/2018,1610612749,Milwaukee Bucks,1,1,1610612752,New York Knicks,0,0,33,22,55,8,10,18,41,32,73,30,9,39,8,29,29,6,17,99,120
2017,2,21700981,3/9/2018,1610612752,New York Knicks,0,0,1610612749,Milwaukee Bucks,1,1,40,30,70,7,21,28,47,51,98,11,3,14,13,39,24,8,11,100,112
2017,2,21700980,3/9/2018,1610612762,Utah Jazz,0,1,1610612763,Memphis Grizzlies,1,0,20,22,42,13,19,32,33,41,74,16,6,22,11,31,26,4,20,93,95
2017,2,21700980,3/9/2018,1610612763,Memphis Grizzlies,1,0,1610612762,Utah Jazz,0,1,25,36,61,6,16,22,31,52,83,10,4,14,12,42,16,10,15,94,78
2014,2,21400676,1/27/2015,1610612739,Cleveland Cavaliers,0,1,1610612765,Detroit Pistons,1,0,30,29,59,9,25,34,39,54,93,16,1,17,17,38,19,4,9,94,103
2017,2,21700979,3/9/2018,1610612745,Houston Rockets,0,0,1610612761,Toronto Raptors,1,1,31,23,54,9,18,27,40,41,81,16,7,23,11,34,15,7,14,95,105
2017,2,21700979,3/9/2018,1610612761,Toronto Raptors,1,1,1610612745,Houston Rockets,0,0,26,21,47,15,23,38,41,44,85,11,3,14,15,30,22,9,17,94,108
2014,2,21400676,1/27/2015,1610612765,Detroit Pistons,1,0,1610612739,Cleveland Cavaliers,0,1,27,32,59,8,16,24,35,48,83,17,6,23,18,34,21,9,18,95,95
2017,2,21700978,3/9/2018,1610612737,Atlanta Hawks,0,0,1610612754,Indiana Pacers,1,1,24,25,49,10,23,33,34,48,82,9,1,10,9,40,21,11,19,97,87
2017,2,21700978,3/9/2018,1610612754,Indiana Pacers,1,1,1610612737,Atlanta Hawks,0,0,31,32,63,14,14,28,45,46,91,8,2,10,15,31,21,11,16,97,112
2016,2,21600084,11/5/2016,1610612737,Atlanta Hawks,1,1,1610612745,Houston Rockets,0,0,37,28,65,8,12,20,45,40,85,14,10,24,14,32,29,9,20,104,112
2017,2,21700977,3/9/2018,1610612741,Chicago Bulls,0,0,1610612765,Detroit Pistons,1,1,24,38,62,9,22,31,33,60,93,8,2,10,19,42,19,8,14,92,83
2017,2,21700977,3/9/2018,1610612765,Detroit Pistons,1,1,1610612741,Chicago Bulls,0,0,29,25,54,9,18,27,38,43,81,14,4,18,11,33,22,11,16,93,99
2016,2,21600084,11/5/2016,1610612745,Houston Rockets,0,0,1610612737,Atlanta Hawks,1,1,25,24,49,12,24,36,37,48,85,11,2,13,12,36,22,17,26,104,97
2017,2,21700976,3/8/2018,1610612744,Golden State Warriors,1,1,1610612759,San Antonio Spurs,0,0,33,32,65,8,22,30,41,54,95,20,3,23,17,39,30,7,10,100,110
2017,2,21700976,3/8/2018,1610612759,San Antonio Spurs,0,0,1610612744,Golden State Warriors,1,1,37,36,73,6,16,22,43,52,95,15,3,18,15,38,29,6,12,100,107
2017,2,21700975,3/8/2018,1610612756,Phoenix Suns,0,0,1610612760,Oklahoma City Thunder,1,1,22,33,55,9,28,37,31,61,92,16,2,18,13,50,15,6,15,104,87
2017,2,21700975,3/8/2018,1610612760,Oklahoma City Thunder,1,1,1610612756,Phoenix Suns,0,0,29,18,47,13,20,33,42,38,80,18,9,27,6,38,21,9,18,102,115
2017,2,21700974,3/8/2018,1610612738,Boston Celtics,0,1,1610612750,Minnesota Timberwolves,1,0,32,23,55,11,21,32,43,44,87,20,7,27,11,35,28,3,11,98,117
2017,2,21700974,3/8/2018,1610612750,Minnesota Timberwolves,1,0,1610612738,Boston Celtics,0,1,32,31,63,12,19,31,44,50,94,9,4,13,14,38,24,7,13,99,109
2017,2,21700973,3/8/2018,1610612748,Miami Heat,1,1,1610612755,Philadelphia 76ers,0,0,28,35,63,14,12,26,42,47,89,10,8,18,12,38,26,9,16,104,108
2017,2,21700973,3/8/2018,1610612755,Philadelphia 76ers,0,0,1610612748,Miami Heat,1,1,19,30,49,15,22,37,34,52,86,16,5,21,10,44,28,10,18,103,99
2017,2,21700972,3/8/2018,1610612751,Brooklyn Nets,0,1,1610612766,Charlotte Hornets,1,0,36,24,60,11,21,32,47,45,92,20,2,22,14,32,30,5,12,98,125
2017,2,21700972,3/8/2018,1610612766,Charlotte Hornets,1,0,1610612751,Brooklyn Nets,0,1,37,29,66,4,15,19,41,44,85,25,5,30,11,34,19,7,13,100,111
2017,2,21700971,3/7/2018,1610612747,Los Angeles Lakers,1,1,1610612753,Orlando Magic,0,0,32,23,55,11,22,33,43,45,88,11,1,12,9,37,27,5,14,99,108
2017,2,21700971,3/7/2018,1610612753,Orlando Magic,0,0,1610612747,Los Angeles Lakers,1,1,30,26,56,12,16,28,42,42,84,11,8,19,11,33,31,7,16,99,107
2017,2,21700970,3/7/2018,1610612739,Cleveland Cavaliers,0,1,1610612743,Denver Nuggets,1,0,31,27,58,13,16,29,44,43,87,12,6,18,8,38,25,7,10,96,113
2017,2,21700970,3/7/2018,1610612743,Denver Nuggets,1,0,1610612739,Cleveland Cavaliers,0,1,32,27,59,10,17,27,42,44,86,14,4,18,19,28,22,10,21,97,108
2016,2,21601045,3/20/2017,1610612753,Orlando Magic,1,1,1610612755,Philadelphia 76ers,0,0,31,40,71,4,19,23,35,59,94,38,8,46,21,42,19,15,18,112,112
2016,2,21601045,3/20/2017,1610612755,Philadelphia 76ers,0,0,1610612753,Orlando Magic,1,1,30,38,68,9,25,34,39,63,102,22,2,24,19,45,26,10,16,111,109
2017,2,21700969,3/7/2018,1610612740,New Orleans Pelicans,0,1,1610612758,Sacramento Kings,1,0,36,21,57,11,15,26,47,36,83,9,0,9,8,28,26,4,16,94,114
2017,2,21700969,3/7/2018,1610612758,Sacramento Kings,1,0,1610612740,New Orleans Pelicans,0,1,30,35,65,9,19,28,39,54,93,14,3,17,16,39,20,6,9,95,101
2014,2,21401166,4/8/2015,1610612740,New Orleans Pelicans,0,0,1610612763,Memphis Grizzlies,1,1,22,37,59,6,15,21,28,52,80,12,6,18,16,40,13,7,12,88,74
2014,2,21401166,4/8/2015,1610612763,Memphis Grizzlies,1,1,1610612740,New Orleans Pelicans,0,0,37,34,71,8,9,17,45,43,88,12,2,14,14,29,27,8,8,87,110
2014,2,21400675,1/27/2015,1610612754,Indiana Pacers,1,0,1610612761,Toronto Raptors,0,1,27,37,64,7,11,18,34,48,82,16,7,23,17,35,22,9,15,92,91
2017,2,21700968,3/7/2018,1610612745,Houston Rockets,0,1,1610612749,Milwaukee Bucks,1,0,25,17,42,14,26,40,39,43,82,18,9,27,14,34,22,9,16,96,110
2017,2,21700968,3/7/2018,1610612749,Milwaukee Bucks,1,0,1610612745,Houston Rockets,0,1,29,26,55,9,19,28,38,45,83,14,5,19,10,38,21,9,14,96,99
2017,2,21700967,3/7/2018,1610612741,Chicago Bulls,1,1,1610612763,Memphis Grizzlies,0,0,31,19,50,11,18,29,42,37,79,24,8,32,16,25,25,12,20,98,119
2017,2,21700967,3/7/2018,1610612763,Memphis Grizzlies,0,0,1610612741,Chicago Bulls,1,1,30,23,53,10,19,29,40,42,82,20,5,25,11,34,24,10,15,99,110
2016,2,21600504,12/31/2016,1610612745,Houston Rockets,1,1,1610612752,New York Knicks,0,0,21,16,37,21,34,55,42,50,92,24,5,29,14,37,30,7,13,102,129
2016,2,21600504,12/31/2016,1610612752,New York Knicks,0,0,1610612745,Houston Rockets,1,1,37,36,73,10,22,32,47,58,105,18,7,25,21,41,21,3,7,104,122
2014,2,21400675,1/27/2015,1610612761,Toronto Raptors,0,1,1610612754,Indiana Pacers,1,0,25,22,47,9,17,26,34,39,73,27,7,34,10,32,21,4,12,90,104
2017,2,21700966,3/7/2018,1610612761,Toronto Raptors,0,1,1610612765,Detroit Pistons,1,0,33,28,61,12,28,40,45,56,101,19,2,21,14,44,33,2,10,104,121
2017,2,21700966,3/7/2018,1610612765,Detroit Pistons,1,0,1610612761,Toronto Raptors,0,1,31,33,64,13,13,26,44,46,90,18,5,23,13,37,27,9,16,105,119
2017,2,21700965,3/7/2018,1610612754,Indiana Pacers,1,0,1610612762,Utah Jazz,0,1,31,34,65,3,20,23,34,54,88,13,4,17,19,37,12,9,12,90,84
2017,2,21700965,3/7/2018,1610612762,Utah Jazz,0,1,1610612754,Indiana Pacers,1,0,30,19,49,11,20,31,41,39,80,11,5,16,10,31,30,9,13,90,104
2017,2,21700964,3/6/2018,1610612740,New Orleans Pelicans,0,1,1610612746,LA Clippers,1,0,33,40,73,13,17,30,46,57,103,16,2,18,11,48,39,5,8,107,121
2017,2,21700964,3/6/2018,1610612746,LA Clippers,1,0,1610612740,New Orleans Pelicans,0,1,39,33,72,7,20,27,46,53,99,17,9,26,16,43,25,11,13,108,116
2017,2,21700963,3/6/2018,1610612744,Golden State Warriors,1,1,1610612751,Brooklyn Nets,0,0,36,24,60,11,12,23,47,36,83,9,2,11,6,30,30,7,17,98,114
2017,2,21700963,3/6/2018,1610612751,Brooklyn Nets,0,0,1610612744,Golden State Warriors,1,1,27,24,51,9,25,34,36,49,85,20,5,25,15,37,24,8,16,98,101
2017,2,21700962,3/6/2018,1610612752,New York Knicks,0,0,1610612757,Portland Trail Blazers,1,1,28,36,64,7,12,19,35,48,83,10,5,15,10,40,21,4,14,94,87
2017,2,21700962,3/6/2018,1610612757,Portland Trail Blazers,1,1,1610612752,New York Knicks,0,0,15,33,48,20,13,33,35,46,81,21,3,24,17,31,22,7,20,94,111
2017,2,21700961,3/6/2018,1610612742,Dallas Mavericks,1,1,1610612743,Denver Nuggets,0,0,28,35,63,15,12,27,43,47,90,17,6,23,12,39,24,5,16,105,118
2017,2,21700961,3/6/2018,1610612743,Denver Nuggets,0,0,1610612742,Dallas Mavericks,1,1,27,29,56,11,25,36,38,54,92,20,6,26,13,43,23,8,14,106,107
2014,2,21401165,4/8/2015,1610612752,New York Knicks,1,0,1610612754,Indiana Pacers,0,1,22,45,67,7,10,17,29,55,84,21,5,26,12,44,13,7,11,96,86
2014,2,21401165,4/8/2015,1610612754,Indiana Pacers,0,1,1610612752,New York Knicks,1,0,34,21,55,4,18,22,38,39,77,22,5,27,12,28,23,8,17,96,102
2014,2,21400674,1/26/2015,1610612743,Denver Nuggets,0,0,1610612746,LA Clippers,1,1,32,30,62,8,13,21,40,43,83,10,5,15,11,35,26,10,10,91,98
2014,2,21400674,1/26/2015,1610612746,LA Clippers,1,1,1610612743,Denver Nuggets,0,0,31,30,61,7,12,19,38,42,80,19,3,22,12,32,25,7,13,90,102
2017,2,21700960,3/6/2018,1610612745,Houston Rockets,0,1,1610612760,Oklahoma City Thunder,1,0,21,18,39,17,16,33,38,34,72,29,5,34,9,26,25,12,21,102,122
2017,2,21700960,3/6/2018,1610612760,Oklahoma City Thunder,1,0,1610612745,Houston Rockets,0,1,34,25,59,12,22,34,46,47,93,8,3,11,17,31,18,11,20,102,112
2017,2,21700959,3/6/2018,1610612748,Miami Heat,0,0,1610612764,Washington Wizards,1,1,33,28,61,9,24,33,42,52,94,20,7,27,18,37,26,7,15,103,113
2017,2,21700959,3/6/2018,1610612764,Washington Wizards,1,1,1610612748,Miami Heat,0,0,26,30,56,14,10,24,40,40,80,23,4,27,11,29,25,11,19,103,117
2017,2,21700958,3/6/2018,1610612737,Atlanta Hawks,0,0,1610612761,Toronto Raptors,1,1,28,31,59,6,15,21,34,46,80,16,5,21,15,32,22,12,22,96,90
2017,2,21700958,3/6/2018,1610612761,Toronto Raptors,1,1,1610612737,Atlanta Hawks,0,0,24,28,52,10,26,36,34,54,88,28,5,33,18,38,25,8,12,97,106
2017,2,21700957,3/6/2018,1610612755,Philadelphia 76ers,0,1,1610612766,Charlotte Hornets,1,0,34,20,54,16,17,33,50,37,87,12,3,15,12,25,35,7,14,94,128
2017,2,21700957,3/6/2018,1610612766,Charlotte Hornets,1,0,1610612755,Philadelphia 76ers,0,1,29,22,51,11,18,29,40,40,80,23,8,31,8,36,26,6,10,95,114
2016,2,21600503,12/31/2016,1610612741,Chicago Bulls,1,0,1610612749,Milwaukee Bucks,0,1,23,33,56,10,17,27,33,50,83,20,8,28,18,36,23,7,11,89,96
2016,2,21600503,12/31/2016,1610612749,Milwaukee Bucks,0,1,1610612741,Chicago Bulls,1,0,34,27,61,9,6,15,43,33,76,21,6,27,11,23,29,9,12,89,116
2017,2,21700956,3/5/2018,1610612747,Los Angeles Lakers,1,0,1610612757,Portland Trail Blazers,0,1,23,27,50,11,26,37,34,53,87,24,7,31,11,46,20,6,11,103,103
2017,2,21700956,3/5/2018,1610612757,Portland Trail Blazers,0,1,1610612747,Los Angeles Lakers,1,0,25,35,60,10,13,23,35,48,83,28,10,38,11,42,19,9,14,103,108
2017,2,21700955,3/5/2018,1610612753,Orlando Magic,0,0,1610612762,Utah Jazz,1,1,18,33,51,11,23,34,29,56,85,11,3,14,15,44,18,8,15,92,80
2017,2,21700955,3/5/2018,1610612762,Utah Jazz,1,1,1610612753,Orlando Magic,0,0,26,16,42,10,21,31,36,37,73,12,6,18,8,32,23,7,16,91,94
2017,2,21700954,3/5/2018,1610612759,San Antonio Spurs,1,1,1610612763,Memphis Grizzlies,0,0,29,25,54,6,16,22,35,41,76,24,7,31,6,37,18,8,12,97,100
2017,2,21700954,3/5/2018,1610612763,Memphis Grizzlies,0,0,1610612759,San Antonio Spurs,1,1,34,24,58,8,14,22,42,38,80,6,3,9,6,34,26,14,20,97,98
2017,2,21700953,3/5/2018,1610612738,Boston Celtics,0,1,1610612741,Chicago Bulls,1,0,29,19,48,12,24,36,41,43,84,11,1,12,13,30,25,14,20,96,105
2017,2,21700953,3/5/2018,1610612741,Chicago Bulls,1,0,1610612738,Boston Celtics,0,1,20,28,48,12,21,33,32,49,81,13,7,20,10,41,18,7,14,97,89
2017,2,21700952,3/5/2018,1610612748,Miami Heat,1,1,1610612756,Phoenix Suns,0,0,35,21,56,12,24,36,47,45,92,19,4,23,16,29,33,3,10,96,125
2017,2,21700952,3/5/2018,1610612756,Phoenix Suns,0,0,1610612748,Miami Heat,1,1,32,31,63,10,14,24,42,45,87,9,9,18,14,37,21,12,18,98,103
2017,2,21700951,3/5/2018,1610612749,Milwaukee Bucks,0,0,1610612754,Indiana Pacers,1,1,27,26,53,7,16,23,34,42,76,14,2,16,11,32,15,13,18,91,89
2017,2,21700951,3/5/2018,1610612754,Indiana Pacers,1,1,1610612749,Milwaukee Bucks,0,0,23,37,60,10,7,17,33,44,77,16,5,21,12,33,18,8,15,89,92
2016,2,21601044,3/20/2017,1610612737,Atlanta Hawks,0,0,1610612766,Charlotte Hornets,1,1,25,22,47,12,25,37,37,47,84,4,6,10,18,31,26,12,18,88,90
2016,2,21601044,3/20/2017,1610612766,Charlotte Hornets,1,1,1610612737,Atlanta Hawks,0,0,28,22,50,12,18,30,40,40,80,13,7,20,7,35,28,3,8,89,105
2014,2,21401167,4/8/2015,1610612739,Cleveland Cavaliers,0,1,1610612749,Milwaukee Bucks,1,0,25,15,40,11,23,34,36,38,74,21,5,26,14,26,23,13,18,92,104
2017,2,21700950,3/5/2018,1610612739,Cleveland Cavaliers,1,1,1610612765,Detroit Pistons,0,0,31,24,55,12,21,33,43,45,88,14,3,17,14,33,29,9,14,96,112
2017,2,21700950,3/5/2018,1610612765,Detroit Pistons,0,0,1610612739,Cleveland Cavaliers,1,1,22,31,53,12,22,34,34,53,87,10,5,15,11,45,17,8,12,97,90
2014,2,21401167,4/8/2015,1610612749,Milwaukee Bucks,1,0,1610612739,Cleveland Cavaliers,0,1,36,30,66,6,12,18,42,42,84,9,4,13,10,34,30,8,12,92,99
2017,2,21700949,3/4/2018,1610612752,New York Knicks,0,0,1610612758,Sacramento Kings,1,1,34,33,67,6,15,21,40,48,88,13,5,18,18,32,21,5,13,93,99
2017,2,21700949,3/4/2018,1610612758,Sacramento Kings,1,1,1610612752,New York Knicks,0,0,26,30,56,13,17,30,39,47,86,11,0,11,9,38,21,8,11,93,102
2016,2,21600502,12/31/2016,1610612758,Sacramento Kings,1,0,1610612763,Memphis Grizzlies,0,1,20,24,44,11,17,28,31,41,72,25,3,28,15,28,17,6,13,86,98
2016,2,21600502,12/31/2016,1610612763,Memphis Grizzlies,0,1,1610612758,Sacramento Kings,1,0,27,25,52,17,18,35,44,43,87,7,2,9,13,31,25,6,7,85,112
2017,2,21700948,3/4/2018,1610612746,LA Clippers,1,1,1610612751,Brooklyn Nets,0,0,34,23,57,10,17,27,44,40,84,25,5,30,9,32,18,8,10,99,123
2017,2,21700948,3/4/2018,1610612751,Brooklyn Nets,0,0,1610612746,LA Clippers,1,1,21,26,47,19,26,45,40,52,92,21,2,23,18,36,30,12,14,100,120
2017,2,21700947,3/4/2018,1610612749,Milwaukee Bucks,1,1,1610612755,Philadelphia 76ers,0,0,37,35,72,10,13,23,47,48,95,14,8,22,20,30,27,4,15,99,118
2017,2,21700947,3/4/2018,1610612755,Philadelphia 76ers,0,0,1610612749,Milwaukee Bucks,1,1,25,17,42,14,14,28,39,31,70,18,4,22,8,24,26,15,26,97,110
2017,2,21700946,3/4/2018,1610612740,New Orleans Pelicans,0,1,1610612742,Dallas Mavericks,1,0,37,28,65,12,14,26,49,42,91,16,5,21,10,34,27,5,12,103,126
2017,2,21700946,3/4/2018,1610612742,Dallas Mavericks,1,0,1610612740,New Orleans Pelicans,0,1,30,37,67,10,13,23,40,50,90,19,6,25,10,43,25,9,12,103,109
2017,2,21700945,3/4/2018,1610612754,Indiana Pacers,0,1,1610612764,Washington Wizards,1,0,26,26,52,8,17,25,34,43,77,22,2,24,11,33,11,9,16,93,98
2017,2,21700945,3/4/2018,1610612764,Washington Wizards,1,0,1610612754,Indiana Pacers,0,1,25,31,56,10,17,27,35,48,83,15,4,19,16,33,21,10,15,94,95
2017,2,21700944,3/4/2018,1610612761,Toronto Raptors,1,1,1610612766,Charlotte Hornets,0,0,23,19,42,12,29,41,35,48,83,21,6,27,12,40,22,7,15,97,103
2017,2,21700944,3/4/2018,1610612766,Charlotte Hornets,0,0,1610612761,Toronto Raptors,1,1,27,37,64,5,16,21,32,53,85,29,6,35,13,43,16,5,9,99,98
2017,2,21700943,3/4/2018,1610612737,Atlanta Hawks,1,1,1610612756,Phoenix Suns,0,0,26,35,61,17,16,33,43,51,94,10,2,12,14,38,23,6,16,103,113
2017,2,21700943,3/4/2018,1610612756,Phoenix Suns,0,0,1610612737,Atlanta Hawks,1,1,35,31,66,11,15,26,46,46,92,9,6,15,10,40,33,7,14,103,112
2017,2,21700942,3/3/2018,1610612758,Sacramento Kings,1,0,1610612762,Utah Jazz,0,1,25,34,59,9,21,30,34,55,89,14,3,17,15,41,15,8,12,95,91
2017,2,21700942,3/3/2018,1610612762,Utah Jazz,0,1,1610612758,Sacramento Kings,1,0,23,27,50,11,21,32,34,48,82,19,10,29,14,40,20,8,14,93,98
2017,2,21700941,3/3/2018,1610612757,Portland Trail Blazers,1,1,1610612760,Oklahoma City Thunder,0,0,28,27,55,11,22,33,39,49,88,19,4,23,17,33,20,6,15,98,108
2017,2,21700941,3/3/2018,1610612760,Oklahoma City Thunder,0,0,1610612757,Portland Trail Blazers,1,1,34,30,64,6,21,27,40,51,91,14,7,21,16,37,18,6,12,100,100
2016,2,21601043,3/19/2017,1610612739,Cleveland Cavaliers,0,1,1610612747,Los Angeles Lakers,1,0,32,17,49,13,23,36,45,40,85,22,5,27,12,30,19,5,10,95,125
2016,2,21601043,3/19/2017,1610612747,Los Angeles Lakers,1,0,1610612739,Cleveland Cavaliers,0,1,36,28,64,11,16,27,47,44,91,15,4,19,11,34,23,4,6,94,120
2017,2,21700940,3/3/2018,1610612747,Los Angeles Lakers,0,1,1610612759,San Antonio Spurs,1,0,25,33,58,15,19,34,40,52,92,21,6,27,14,41,26,10,15,108,116
2017,2,21700940,3/3/2018,1610612759,San Antonio Spurs,1,0,1610612747,Los Angeles Lakers,0,1,37,31,68,7,23,30,44,54,98,17,3,20,17,38,28,10,16,108,112
2014,2,21400673,1/26/2015,1610612738,Boston Celtics,0,1,1610612762,Utah Jazz,1,0,27,28,55,8,11,19,35,39,74,21,2,23,9,32,18,9,14,91,99
2014,2,21400673,1/26/2015,1610612762,Utah Jazz,1,0,1610612738,Boston Celtics,0,1,26,32,58,9,15,24,35,47,82,11,8,19,18,33,18,8,16,92,90
2017,2,21700939,3/3/2018,1610612738,Boston Celtics,0,0,1610612745,Houston Rockets,1,1,31,36,67,13,11,24,44,47,91,19,2,21,17,32,22,11,13,98,120
2017,2,21700939,3/3/2018,1610612745,Houston Rockets,1,1,1610612738,Boston Celtics,0,0,20,18,38,19,30,49,39,48,87,26,4,30,15,34,24,6,11,98,123
2017,2,21700938,3/3/2018,1610612748,Miami Heat,1,1,1610612765,Detroit Pistons,0,0,25,28,53,12,17,29,37,45,82,19,9,28,17,32,19,8,15,94,105
2017,2,21700938,3/3/2018,1610612765,Detroit Pistons,0,0,1610612748,Miami Heat,1,1,30,35,65,7,17,24,37,52,89,15,6,21,23,32,18,11,19,94,96
2017,2,21700937,3/3/2018,1610612739,Cleveland Cavaliers,1,0,1610612743,Denver Nuggets,0,1,37,27,64,9,15,24,46,42,88,16,5,21,13,31,25,4,9,94,117
2017,2,21700937,3/3/2018,1610612743,Denver Nuggets,0,1,1610612739,Cleveland Cavaliers,1,0,28,23,51,19,16,35,47,39,86,13,2,15,9,30,35,5,9,93,126
2017,2,21700936,3/3/2018,1610612753,Orlando Magic,1,1,1610612763,Memphis Grizzlies,0,0,28,19,47,8,17,25,36,36,72,27,6,33,5,35,19,9,14,96,107
2017,2,21700936,3/3/2018,1610612763,Memphis Grizzlies,0,0,1610612753,Orlando Magic,1,1,32,39,71,6,16,22,38,55,93,18,8,26,19,41,24,4,10,98,100
2017,2,21700935,3/2/2018,1610612746,LA Clippers,1,1,1610612752,New York Knicks,0,0,41,23,64,9,16,25,50,39,89,19,5,24,15,25,34,4,11,98,128
2017,2,21700935,3/2/2018,1610612752,New York Knicks,0,0,1610612746,LA Clippers,1,1,30,34,64,11,14,25,41,48,89,12,4,16,12,39,24,14,17,99,105
2017,2,21700934,3/2/2018,1610612750,Minnesota Timberwolves,0,0,1610612762,Utah Jazz,1,1,29,28,57,9,8,17,38,36,74,23,8,31,4,36,14,7,13,98,108
2017,2,21700934,3/2/2018,1610612762,Utah Jazz,1,1,1610612750,Minnesota Timberwolves,0,0,31,18,49,9,20,29,40,38,78,27,8,35,15,27,21,9,19,98,116
2017,2,21700933,3/2/2018,1610612756,Phoenix Suns,1,0,1610612760,Oklahoma City Thunder,0,1,35,36,71,11,14,25,46,50,96,13,5,18,19,34,26,5,15,101,116
2017,2,21700933,3/2/2018,1610612760,Oklahoma City Thunder,0,1,1610612756,Phoenix Suns,1,0,35,27,62,11,23,34,46,50,96,21,8,29,20,35,22,5,11,101,124
2017,2,21700932,3/2/2018,1610612749,Milwaukee Bucks,1,0,1610612754,Indiana Pacers,0,1,22,34,56,9,16,25,31,50,81,25,7,32,16,38,15,12,15,96,96
2017,2,21700932,3/2/2018,1610612754,Indiana Pacers,0,1,1610612749,Milwaukee Bucks,1,0,31,36,67,6,10,16,37,46,83,23,7,30,16,33,19,9,16,98,103
2017,2,21700931,3/2/2018,1610612743,Denver Nuggets,0,1,1610612763,Memphis Grizzlies,1,0,34,17,51,6,16,22,40,33,73,22,4,26,10,23,18,14,24,98,108
2017,2,21700931,3/2/2018,1610612763,Memphis Grizzlies,1,0,1610612743,Denver Nuggets,0,1,30,34,64,10,17,27,40,51,91,12,3,15,20,32,26,17,20,99,102
2017,2,21700930,3/2/2018,1610612741,Chicago Bulls,1,1,1610612742,Dallas Mavericks,0,0,32,30,62,10,17,27,42,47,89,14,6,20,16,35,24,6,13,96,108
2017,2,21700930,3/2/2018,1610612742,Dallas Mavericks,0,0,1610612741,Chicago Bulls,1,1,22,33,55,13,16,29,35,49,84,17,4,21,16,36,21,10,17,96,100
2016,2,21601042,3/19/2017,1610612758,Sacramento Kings,0,0,1610612759,San Antonio Spurs,1,1,34,39,73,7,3,10,41,42,83,13,4,17,12,32,29,9,11,91,102
2016,2,21601042,3/19/2017,1610612759,San Antonio Spurs,1,1,1610612758,Sacramento Kings,0,0,32,27,59,11,17,28,43,44,87,21,6,27,16,32,31,4,8,89,118
2017,2,21700929,3/2/2018,1610612761,Toronto Raptors,0,1,1610612764,Washington Wizards,1,0,26,19,45,10,23,33,36,42,78,20,12,32,11,34,19,2,7,88,102
2017,2,21700929,3/2/2018,1610612764,Washington Wizards,1,0,1610612761,Toronto Raptors,0,1,27,28,55,9,15,24,36,43,79,14,7,21,17,28,24,9,18,89,95
2014,2,21400672,1/26/2015,1610612750,Minnesota Timberwolves,0,0,1610612760,Oklahoma City Thunder,1,1,27,45,72,2,11,13,29,56,85,24,8,32,17,42,13,9,13,96,84
2017,2,21700928,3/2/2018,1610612737,Atlanta Hawks,1,0,1610612744,Golden State Warriors,0,1,23,28,51,15,20,35,38,48,86,18,2,20,14,35,21,12,22,104,109
2017,2,21700928,3/2/2018,1610612744,Golden State Warriors,0,1,1610612737,Atlanta Hawks,1,0,31,17,48,11,20,31,42,37,79,19,3,22,5,34,33,10,18,102,114
2014,2,21400672,1/26/2015,1610612760,Oklahoma City Thunder,1,1,1610612750,Minnesota Timberwolves,0,0,32,34,66,4,16,20,36,50,86,16,8,24,17,39,17,9,16,97,92
2017,2,21700927,3/2/2018,1610612755,Philadelphia 76ers,1,1,1610612766,Charlotte Hornets,0,0,32,25,57,9,15,24,41,40,81,19,6,25,9,35,27,7,12,96,110
2017,2,21700927,3/2/2018,1610612766,Charlotte Hornets,0,0,1610612755,Philadelphia 76ers,1,1,23,34,57,11,13,24,34,47,81,20,12,32,13,41,21,4,10,96,99
2016,2,21600501,12/30/2016,1610612742,Dallas Mavericks,0,0,1610612744,Golden State Warriors,1,1,31,30,61,8,24,32,39,54,93,13,2,15,15,40,22,5,10,97,99
2016,2,21600501,12/30/2016,1610612744,Golden State Warriors,1,1,1610612742,Dallas Mavericks,0,0,31,20,51,11,22,33,42,42,84,13,2,15,10,32,31,11,13,96,108
2017,2,21700926,3/2/2018,1610612753,Orlando Magic,1,1,1610612765,Detroit Pistons,0,0,31,19,50,13,23,36,44,42,86,14,5,19,9,35,34,9,17,103,115
2017,2,21700926,3/2/2018,1610612765,Detroit Pistons,0,0,1610612753,Orlando Magic,1,1,28,35,63,12,17,29,40,52,92,14,10,24,15,41,22,8,14,104,106
2016,2,21600083,11/5/2016,1610612741,Chicago Bulls,0,0,1610612754,Indiana Pacers,1,1,28,33,61,6,12,18,34,45,79,20,5,25,17,30,17,8,18,90,94
2016,2,21600083,11/5/2016,1610612754,Indiana Pacers,1,1,1610612741,Chicago Bulls,0,0,34,26,60,12,14,26,46,40,86,7,5,12,14,29,27,8,12,90,111
2017,2,21700925,3/1/2018,1610612750,Minnesota Timberwolves,0,0,1610612757,Portland Trail Blazers,1,1,34,31,65,4,16,20,38,47,85,19,2,21,10,39,16,9,15,99,99
2017,2,21700925,3/1/2018,1610612757,Portland Trail Blazers,1,1,1610612750,Minnesota Timberwolves,0,0,27,35,62,9,21,30,36,56,92,27,8,35,15,43,17,5,8,99,108
2017,2,21700924,3/1/2018,1610612751,Brooklyn Nets,0,0,1610612758,Sacramento Kings,1,1,23,27,50,17,29,46,40,56,96,14,3,17,19,39,27,15,22,106,111
2017,2,21700924,3/1/2018,1610612758,Sacramento Kings,1,1,1610612751,Brooklyn Nets,0,0,44,39,83,6,8,14,50,47,97,10,2,12,12,37,23,10,15,107,116
2017,2,21700923,3/1/2018,1610612739,Cleveland Cavaliers,1,0,1610612755,Philadelphia 76ers,0,1,27,28,55,9,23,32,36,51,87,16,7,23,12,44,23,4,10,96,97
2017,2,21700923,3/1/2018,1610612755,Philadelphia 76ers,0,1,1610612739,Cleveland Cavaliers,1,0,30,30,60,10,20,30,40,50,90,18,9,27,18,38,22,4,10,96,108
2017,2,21700922,3/1/2018,1610612747,Los Angeles Lakers,0,1,1610612748,Miami Heat,1,0,31,19,50,16,13,29,47,32,79,21,5,26,7,28,29,6,14,97,131
2017,2,21700922,3/1/2018,1610612748,Miami Heat,1,0,1610612747,Los Angeles Lakers,0,1,37,27,64,9,22,31,46,49,95,12,4,16,19,32,23,9,11,97,113
2017,2,21700921,2/28/2018,1610612745,Houston Rockets,0,1,1610612746,LA Clippers,1,0,23,19,42,13,30,43,36,49,85,20,4,24,13,37,21,6,10,94,105
2017,2,21700921,2/28/2018,1610612746,LA Clippers,1,0,1610612745,Houston Rockets,0,1,29,27,56,7,16,23,36,43,79,13,6,19,11,33,17,11,18,94,92
2016,2,21601041,3/19/2017,1610612748,Miami Heat,1,0,1610612757,Portland Trail Blazers,0,1,32,26,58,9,21,30,41,47,88,13,7,20,16,32,18,4,9,89,104
2016,2,21601041,3/19/2017,1610612757,Portland Trail Blazers,0,1,1610612748,Miami Heat,1,0,29,28,57,13,13,26,42,41,83,18,6,24,15,29,13,8,12,89,115
2017,2,21700920,2/28/2018,1610612740,New Orleans Pelicans,0,1,1610612759,San Antonio Spurs,1,0,41,32,73,9,17,26,50,49,99,12,3,15,16,35,26,7,12,102,121
2017,2,21700920,2/28/2018,1610612759,San Antonio Spurs,1,0,1610612740,New Orleans Pelicans,0,1,39,34,73,9,17,26,48,51,99,11,3,14,17,35,23,7,11,104,116
2017,2,21700919,2/28/2018,1610612742,Dallas Mavericks,1,0,1610612760,Oklahoma City Thunder,0,1,31,24,55,13,23,36,44,47,91,9,6,15,12,38,30,7,17,105,110
2017,2,21700919,2/28/2018,1610612760,Oklahoma City Thunder,0,1,1610612742,Dallas Mavericks,1,0,32,25,57,10,26,36,42,51,93,17,2,19,20,31,19,11,22,104,111
2017,2,21700918,2/28/2018,1610612756,Phoenix Suns,0,1,1610612763,Memphis Grizzlies,1,0,32,30,62,6,15,21,38,45,83,28,10,38,11,42,19,8,16,106,110
2017,2,21700918,2/28/2018,1610612763,Memphis Grizzlies,1,0,1610612756,Phoenix Suns,0,1,20,36,56,13,18,31,33,54,87,23,5,28,15,42,23,12,20,105,102
2017,2,21700917,2/28/2018,1610612744,Golden State Warriors,0,1,1610612764,Washington Wizards,1,0,27,21,48,10,14,24,37,35,72,25,5,30,4,33,24,6,14,98,109
2017,2,21700917,2/28/2018,1610612764,Washington Wizards,1,0,1610612744,Golden State Warriors,0,1,25,33,58,11,21,32,36,54,90,18,3,21,22,34,25,10,18,99,101
2016,2,21600082,11/5/2016,1610612743,Denver Nuggets,0,0,1610612765,Detroit Pistons,1,1,24,45,69,7,18,25,31,63,94,17,3,20,23,41,15,9,16,97,86
2016,2,21600082,11/5/2016,1610612765,Detroit Pistons,1,1,1610612743,Denver Nuggets,0,0,33,31,64,7,13,20,40,44,84,16,6,22,12,35,22,8,14,96,103
2017,2,21700916,2/28/2018,1610612738,Boston Celtics,1,1,1610612766,Charlotte Hornets,0,0,42,25,67,12,8,20,54,33,87,14,1,15,9,24,31,6,11,96,134
2017,2,21700916,2/28/2018,1610612766,Charlotte Hornets,0,0,1610612738,Boston Celtics,1,1,33,31,64,9,18,27,42,49,91,13,9,22,12,44,24,3,7,94,106
2017,2,21700915,2/28/2018,1610612737,Atlanta Hawks,1,1,1610612754,Indiana Pacers,0,0,29,29,58,9,20,29,38,49,87,22,5,27,15,37,21,13,21,104,107
2017,2,21700915,2/28/2018,1610612754,Indiana Pacers,0,0,1610612737,Atlanta Hawks,1,1,27,31,58,11,21,32,38,52,90,15,5,20,17,37,21,13,24,105,102
2017,2,21700914,2/28/2018,1610612753,Orlando Magic,1,0,1610612761,Toronto Raptors,0,1,26,26,52,13,17,30,39,43,82,13,10,23,12,35,27,9,13,94,104
2017,2,21700914,2/28/2018,1610612761,Toronto Raptors,0,1,1610612753,Orlando Magic,1,0,33,20,53,12,18,30,45,38,83,15,9,24,9,36,33,8,12,94,117
2017,2,21700913,2/28/2018,1610612749,Milwaukee Bucks,0,0,1610612765,Detroit Pistons,1,1,20,29,49,8,16,24,28,45,73,23,5,28,8,38,16,9,13,90,87
2017,2,21700913,2/28/2018,1610612765,Detroit Pistons,1,1,1610612749,Milwaukee Bucks,0,0,33,33,66,9,20,29,42,53,95,17,5,22,27,30,26,7,11,89,110
2017,2,21700912,2/27/2018,1610612743,Denver Nuggets,1,0,1610612746,LA Clippers,0,1,33,23,56,10,21,31,43,44,87,24,6,30,16,30,27,12,20,106,120
2017,2,21700912,2/27/2018,1610612746,LA Clippers,0,1,1610612743,Denver Nuggets,1,0,39,24,63,7,19,26,46,43,89,23,8,31,16,31,26,11,19,105,122
2017,2,21700911,2/27/2018,1610612757,Portland Trail Blazers,1,1,1610612758,Sacramento Kings,0,0,29,21,50,15,19,34,44,40,84,13,4,17,12,31,27,14,18,98,116
2017,2,21700911,2/27/2018,1610612758,Sacramento Kings,0,0,1610612757,Portland Trail Blazers,1,1,32,34,66,7,15,22,39,49,88,14,1,15,10,40,20,10,12,98,99
2014,2,21400671,1/26/2015,1610612740,New Orleans Pelicans,1,1,1610612755,Philadelphia 76ers,0,0,32,38,70,7,9,16,39,47,86,14,5,19,21,29,28,7,14,86,99
2014,2,21400671,1/26/2015,1610612755,Philadelphia 76ers,0,0,1610612740,New Orleans Pelicans,1,1,26,40,66,2,13,15,28,53,81,16,5,21,18,38,15,10,13,86,74
2017,2,21700910,2/27/2018,1610612749,Milwaukee Bucks,1,0,1610612764,Washington Wizards,0,1,25,26,51,10,16,26,35,42,77,24,4,28,11,31,20,9,17,97,104
2017,2,21700910,2/27/2018,1610612764,Washington Wizards,0,1,1610612749,Milwaukee Bucks,1,0,35,33,68,7,13,20,42,46,88,16,6,22,13,35,30,10,13,98,107
2017,2,21700909,2/27/2018,1610612748,Miami Heat,1,1,1610612755,Philadelphia 76ers,0,0,27,28,55,9,18,27,36,46,82,21,7,28,13,37,19,10,16,98,102
2017,2,21700909,2/27/2018,1610612755,Philadelphia 76ers,0,0,1610612748,Miami Heat,1,1,23,30,53,12,19,31,35,49,84,19,4,23,19,32,25,12,23,98,101
2017,2,21700908,2/27/2018,1610612739,Cleveland Cavaliers,1,1,1610612751,Brooklyn Nets,0,0,38,35,73,12,12,24,50,47,97,17,10,27,16,34,24,6,11,103,129
2017,2,21700908,2/27/2018,1610612751,Brooklyn Nets,0,0,1610612739,Cleveland Cavaliers,1,1,32,18,50,12,20,32,44,38,82,23,7,30,4,41,29,7,13,103,123
2017,2,21700907,2/27/2018,1610612741,Chicago Bulls,0,0,1610612766,Charlotte Hornets,1,1,30,27,57,9,15,24,39,42,81,16,5,21,13,30,26,11,21,99,103
2017,2,21700907,2/27/2018,1610612766,Charlotte Hornets,1,1,1610612741,Chicago Bulls,0,0,29,18,47,15,20,35,44,38,82,15,6,21,9,33,28,8,14,99,118
2017,2,21700906,2/26/2018,1610612750,Minnesota Timberwolves,0,1,1610612758,Sacramento Kings,1,0,32,28,60,7,9,16,39,37,76,33,3,36,12,26,22,5,12,95,118
2017,2,21700906,2/26/2018,1610612758,Sacramento Kings,1,0,1610612750,Minnesota Timberwolves,0,1,32,30,62,8,14,22,40,44,84,12,1,13,10,35,22,11,15,95,100
2017,2,21700905,2/26/2018,1610612745,Houston Rockets,0,1,1610612762,Utah Jazz,1,0,25,21,46,9,24,33,34,45,79,19,6,25,13,34,15,6,16,93,96
2017,2,21700905,2/26/2018,1610612762,Utah Jazz,1,0,1610612745,Houston Rockets,0,1,24,18,42,7,22,29,31,40,71,16,6,22,11,31,21,15,22,94,85
2017,2,21700904,2/26/2018,1610612742,Dallas Mavericks,1,1,1610612754,Indiana Pacers,0,0,26,25,51,14,23,37,40,48,88,15,3,18,8,41,20,6,10,97,109
2017,2,21700904,2/26/2018,1610612754,Indiana Pacers,0,0,1610612742,Dallas Mavericks,1,1,36,31,67,5,15,20,41,46,87,16,7,23,13,39,22,9,12,97,103
2017,2,21700903,2/26/2018,1610612753,Orlando Magic,0,0,1610612760,Oklahoma City Thunder,1,1,27,28,55,12,17,29,39,45,84,15,6,21,11,37,23,6,16,100,105
2017,2,21700903,2/26/2018,1610612760,Oklahoma City Thunder,1,1,1610612753,Orlando Magic,0,0,31,32,63,11,14,25,42,46,88,17,3,20,19,29,24,15,20,100,112
2016,2,21601040,3/19/2017,1610612754,Indiana Pacers,0,0,1610612761,Toronto Raptors,1,1,27,30,57,6,17,23,33,47,80,19,7,26,12,39,22,7,14,93,91
2016,2,21601040,3/19/2017,1610612761,Toronto Raptors,1,1,1610612754,Indiana Pacers,0,0,33,31,64,12,15,27,45,46,91,14,2,16,21,26,25,7,17,95,116
2017,2,21700902,2/26/2018,1610612740,New Orleans Pelicans,1,1,1610612756,Phoenix Suns,0,0,35,28,63,8,20,28,43,48,91,31,9,40,13,39,30,9,14,107,125
2017,2,21700902,2/26/2018,1610612756,Phoenix Suns,0,0,1610612740,New Orleans Pelicans,1,1,35,38,73,7,17,24,42,55,97,25,7,32,17,40,23,7,14,108,116
2017,2,21700901,2/26/2018,1610612761,Toronto Raptors,1,1,1610612765,Detroit Pistons,0,0,25,17,42,17,21,38,42,38,80,22,1,23,10,29,31,11,18,99,123
2017,2,21700901,2/26/2018,1610612765,Detroit Pistons,0,0,1610612761,Toronto Raptors,1,1,29,43,72,7,15,22,36,58,94,15,5,20,17,43,20,10,13,100,94
2016,2,21600500,12/30/2016,1610612743,Denver Nuggets,1,0,1610612755,Philadelphia 76ers,0,1,28,29,57,11,16,27,39,45,84,33,8,41,15,32,29,5,11,100,122
2016,2,21600500,12/30/2016,1610612755,Philadelphia 76ers,0,1,1610612743,Denver Nuggets,1,0,22,32,54,16,17,33,38,49,87,32,8,40,17,35,25,5,11,100,124
2014,2,21400670,1/26/2015,1610612753,Orlando Magic,0,0,1610612763,Memphis Grizzlies,1,1,33,33,66,4,8,12,37,41,78,16,9,25,14,32,14,11,18,94,94
2014,2,21400670,1/26/2015,1610612763,Memphis Grizzlies,1,1,1610612753,Orlando Magic,0,0,29,29,58,7,11,18,36,40,76,24,2,26,10,31,25,8,15,94,103
2017,2,21700900,2/26/2018,1610612744,Golden State Warriors,0,1,1610612752,New York Knicks,1,0,29,25,54,15,16,31,44,41,85,22,4,26,10,32,31,7,12,101,125
2017,2,21700900,2/26/2018,1610612752,New York Knicks,1,0,1610612744,Golden State Warriors,0,1,37,34,71,10,15,25,47,49,96,7,2,9,13,36,28,8,14,101,111
2017,2,21700899,2/26/2018,1610612741,Chicago Bulls,0,0,1610612751,Brooklyn Nets,1,1,27,43,70,6,17,23,33,60,93,15,8,23,19,45,17,4,14,100,87
2017,2,21700899,2/26/2018,1610612751,Brooklyn Nets,1,1,1610612741,Chicago Bulls,0,0,24,24,48,16,26,42,40,50,90,8,0,8,8,42,31,8,15,99,104
2017,2,21700898,2/26/2018,1610612738,Boston Celtics,1,1,1610612763,Memphis Grizzlies,0,0,27,22,49,12,25,37,39,47,86,19,8,27,12,40,25,4,8,95,109
2017,2,21700898,2/26/2018,1610612763,Memphis Grizzlies,0,0,1610612738,Boston Celtics,1,1,29,26,55,5,18,23,34,44,78,25,7,32,8,39,27,5,10,95,98
2017,2,21700897,2/26/2018,1610612737,Atlanta Hawks,1,0,1610612747,Los Angeles Lakers,0,1,28,32,60,8,28,36,36,60,96,24,10,34,14,50,21,8,13,111,104
2017,2,21700897,2/26/2018,1610612747,Los Angeles Lakers,0,1,1610612737,Atlanta Hawks,1,0,32,25,57,15,18,33,47,43,90,14,5,19,11,35,28,14,23,109,123
2017,2,21700896,2/25/2018,1610612743,Denver Nuggets,1,0,1610612745,Houston Rockets,0,1,34,28,62,10,19,29,44,47,91,16,8,24,18,32,33,7,13,99,114
2017,2,21700896,2/25/2018,1610612745,Houston Rockets,0,1,1610612743,Denver Nuggets,1,0,24,18,42,15,20,35,39,38,77,26,6,32,13,28,18,13,19,98,119
2017,2,21700894,2/25/2018,1610612739,Cleveland Cavaliers,1,0,1610612759,San Antonio Spurs,0,1,30,27,57,8,26,34,38,53,91,10,4,14,17,37,18,11,16,97,94
2017,2,21700894,2/25/2018,1610612759,San Antonio Spurs,0,1,1610612739,Cleveland Cavaliers,1,0,29,38,67,9,10,19,38,48,86,25,7,32,15,34,22,8,10,96,110
2016,2,21601039,3/19/2017,1610612740,New Orleans Pelicans,1,1,1610612750,Minnesota Timberwolves,0,0,35,25,60,14,16,30,49,41,90,11,4,15,15,27,31,11,16,100,123
2017,2,21700893,2/25/2018,1610612740,New Orleans Pelicans,0,1,1610612749,Milwaukee Bucks,1,0,41,36,77,10,20,30,51,56,107,11,3,14,18,38,22,10,17,114,123
2017,2,21700893,2/25/2018,1610612749,Milwaukee Bucks,1,0,1610612740,New Orleans Pelicans,0,1,37,34,71,7,18,25,44,52,96,26,3,29,11,43,21,8,14,115,121
2016,2,21601039,3/19/2017,1610612750,Minnesota Timberwolves,0,0,1610612740,New Orleans Pelicans,1,1,35,26,61,9,16,25,44,42,86,12,5,17,10,34,30,7,15,100,109
2016,2,21600499,12/30/2016,1610612757,Portland Trail Blazers,0,0,1610612759,San Antonio Spurs,1,1,29,28,57,6,14,20,35,42,77,18,3,21,6,37,19,7,11,93,94
2014,2,21401163,4/8/2015,1610612737,Atlanta Hawks,0,1,1610612751,Brooklyn Nets,1,0,32,26,58,11,17,28,43,43,86,17,8,25,11,36,35,7,11,98,114
2014,2,21401163,4/8/2015,1610612751,Brooklyn Nets,1,0,1610612737,Atlanta Hawks,0,1,34,27,61,7,19,26,41,46,87,22,3,25,16,31,27,11,13,97,111
2017,2,21700892,2/25/2018,1610612765,Detroit Pistons,0,0,1610612766,Charlotte Hornets,1,1,38,29,67,4,14,18,42,43,85,10,4,14,9,37,23,9,17,99,98
2017,2,21700892,2/25/2018,1610612766,Charlotte Hornets,1,1,1610612765,Detroit Pistons,0,0,26,27,53,16,19,35,42,46,88,14,9,23,16,34,28,4,18,101,114
2014,2,21400669,3/3/2015,1610612752,New York Knicks,1,0,1610612758,Sacramento Kings,0,1,26,34,60,4,18,22,30,52,82,22,8,30,13,42,16,9,15,99,86
2014,2,21400669,3/3/2015,1610612758,Sacramento Kings,0,1,1610612752,New York Knicks,1,0,31,34,65,10,8,18,41,42,83,32,5,37,14,30,26,8,14,100,124
2017,2,21700891,2/24/2018,1610612747,Los Angeles Lakers,0,1,1610612758,Sacramento Kings,1,0,24,29,53,17,21,38,41,50,91,14,6,20,20,34,26,5,12,94,113
2017,2,21700891,2/24/2018,1610612758,Sacramento Kings,1,0,1610612747,Los Angeles Lakers,0,1,29,40,69,13,12,25,42,52,94,11,6,17,20,35,28,5,11,93,108
2016,2,21600499,12/30/2016,1610612759,San Antonio Spurs,1,1,1610612757,Portland Trail Blazers,0,0,28,28,56,11,11,22,39,39,78,21,4,25,15,25,22,10,17,94,110
2017,2,21700890,2/24/2018,1610612742,Dallas Mavericks,0,0,1610612762,Utah Jazz,1,1,24,24,48,10,25,35,34,49,83,12,2,14,12,38,19,6,16,94,90
2017,2,21700890,2/24/2018,1610612762,Utah Jazz,1,1,1610612742,Dallas Mavericks,0,0,25,28,53,9,23,32,34,51,85,20,6,26,13,41,26,6,12,95,97
2017,2,21700889,2/24/2018,1610612756,Phoenix Suns,1,0,1610612757,Portland Trail Blazers,0,1,28,33,61,11,15,26,39,48,87,15,6,21,13,38,23,6,16,102,104
2017,2,21700889,2/24/2018,1610612757,Portland Trail Blazers,0,1,1610612756,Phoenix Suns,1,0,33,36,69,6,24,30,39,60,99,22,8,30,17,49,15,5,6,100,106
2017,2,21700888,2/24/2018,1610612741,Chicago Bulls,0,0,1610612750,Minnesota Timberwolves,1,1,36,31,67,6,17,23,42,48,90,14,6,20,9,41,21,6,15,107,104
2017,2,21700888,2/24/2018,1610612750,Minnesota Timberwolves,1,1,1610612741,Chicago Bulls,0,0,35,24,59,11,24,35,46,48,94,19,7,26,11,41,25,5,12,107,122
2017,2,21700887,2/24/2018,1610612744,Golden State Warriors,1,1,1610612760,Oklahoma City Thunder,0,0,25,26,51,17,21,38,42,47,89,11,2,13,18,30,36,8,16,94,112
2017,2,21700887,2/24/2018,1610612760,Oklahoma City Thunder,0,0,1610612744,Golden State Warriors,1,1,20,34,54,9,25,34,29,59,88,13,8,21,20,43,19,8,16,94,80
2017,2,21700886,2/24/2018,1610612738,Boston Celtics,0,1,1610612752,New York Knicks,1,0,29,31,60,13,20,33,42,51,93,24,4,28,14,39,21,10,11,104,121
2017,2,21700886,2/24/2018,1610612752,New York Knicks,1,0,1610612738,Boston Celtics,0,1,39,30,69,6,21,27,45,51,96,16,4,20,14,38,20,11,14,104,112
2017,2,21700885,2/24/2018,1610612748,Miami Heat,1,1,1610612763,Memphis Grizzlies,0,0,29,27,56,12,21,33,41,48,89,21,6,27,16,35,27,7,10,96,115
2017,2,21700885,2/24/2018,1610612763,Memphis Grizzlies,0,0,1610612748,Miami Heat,1,1,30,39,69,5,6,11,35,45,80,14,3,17,10,37,16,15,19,97,89
2017,2,21700884,2/24/2018,1610612753,Orlando Magic,0,0,1610612755,Philadelphia 76ers,1,1,25,29,54,13,18,31,38,47,85,16,3,19,9,39,27,4,12,97,105
2017,2,21700884,2/24/2018,1610612755,Philadelphia 76ers,1,1,1610612753,Orlando Magic,0,0,33,21,54,9,18,27,42,39,81,23,4,27,11,29,31,8,15,97,116
2017,2,21700883,2/23/2018,1610612742,Dallas Mavericks,0,0,1610612747,Los Angeles Lakers,1,1,18,31,49,19,23,42,37,54,91,9,2,11,6,49,25,8,11,101,102
2017,2,21700883,2/23/2018,1610612747,Los Angeles Lakers,1,1,1610612742,Dallas Mavericks,0,0,35,25,60,13,20,33,48,45,93,15,5,20,19,30,32,9,16,101,124
2014,2,21401164,4/8/2015,1610612738,Boston Celtics,0,1,1610612765,Detroit Pistons,1,0,28,24,52,8,20,28,36,44,80,33,1,34,12,32,20,7,11,95,113
2014,2,21401164,4/8/2015,1610612765,Detroit Pistons,1,0,1610612738,Boston Celtics,0,1,38,28,66,7,11,18,45,39,84,6,4,10,13,29,29,12,19,95,103
2014,2,21400668,4/6/2015,1610612751,Brooklyn Nets,1,1,1610612757,Portland Trail Blazers,0,0,35,42,77,6,8,14,41,50,91,18,5,23,15,39,25,4,7,93,106
2017,2,21700882,2/23/2018,1610612757,Portland Trail Blazers,0,1,1610612762,Utah Jazz,1,0,30,33,63,9,15,24,39,48,87,13,1,14,12,36,14,7,12,93,100
2017,2,21700882,2/23/2018,1610612762,Utah Jazz,1,0,1610612757,Portland Trail Blazers,0,1,27,26,53,6,19,25,33,45,78,9,2,11,11,35,15,11,20,92,81
2017,2,21700881,2/23/2018,1610612746,LA Clippers,0,1,1610612756,Phoenix Suns,1,0,31,24,55,14,18,32,45,42,87,24,8,32,11,34,23,12,18,110,128
2017,2,21700881,2/23/2018,1610612756,Phoenix Suns,1,0,1610612746,LA Clippers,0,1,36,36,72,9,22,31,45,58,103,18,13,31,19,47,22,5,12,110,117
2016,2,21601038,3/19/2017,1610612756,Phoenix Suns,0,0,1610612765,Detroit Pistons,1,1,29,48,77,6,16,22,35,64,99,19,11,30,14,54,16,2,4,101,95
2016,2,21601038,3/19/2017,1610612765,Detroit Pistons,1,1,1610612756,Phoenix Suns,0,0,28,39,67,12,13,25,40,52,92,20,10,30,17,41,26,10,12,102,112
2014,2,21400668,4/6/2015,1610612757,Portland Trail Blazers,0,0,1610612751,Brooklyn Nets,1,1,28,33,61,11,15,26,39,48,87,7,2,9,12,37,17,6,14,93,96
2017,2,21700880,2/23/2018,1610612743,Denver Nuggets,1,1,1610612759,San Antonio Spurs,0,0,36,29,65,12,20,32,48,49,97,14,5,19,20,31,33,4,11,97,122
2017,2,21700880,2/23/2018,1610612759,San Antonio Spurs,0,0,1610612743,Denver Nuggets,1,1,38,31,69,5,11,16,43,42,85,28,11,39,12,34,28,5,7,97,119
2016,2,21600081,11/5/2016,1610612753,Orlando Magic,1,1,1610612764,Washington Wizards,0,0,22,28,50,9,19,28,31,47,78,17,10,27,15,35,21,4,9,87,88
2016,2,21600081,11/5/2016,1610612764,Washington Wizards,0,0,1610612753,Orlando Magic,1,1,28,41,69,6,11,17,34,52,86,12,5,17,19,35,11,4,11,87,86
2017,2,21700879,2/23/2018,1610612740,New Orleans Pelicans,1,1,1610612748,Miami Heat,0,0,40,37,77,8,23,31,48,60,108,20,4,24,16,46,27,12,15,116,124
2017,2,21700879,2/23/2018,1610612748,Miami Heat,0,0,1610612740,New Orleans Pelicans,1,1,44,46,90,6,12,18,50,58,108,17,9,26,16,48,26,9,13,117,123
2017,2,21700878,2/23/2018,1610612739,Cleveland Cavaliers,0,1,1610612763,Memphis Grizzlies,1,0,29,29,58,11,18,29,40,47,87,21,1,22,12,36,26,10,18,106,112
2017,2,21700878,2/23/2018,1610612763,Memphis Grizzlies,1,0,1610612739,Cleveland Cavaliers,0,1,24,36,60,9,15,24,33,51,84,14,4,18,11,41,22,13,23,106,89
2017,2,21700877,2/23/2018,1610612745,Houston Rockets,1,1,1610612750,Minnesota Timberwolves,0,0,26,19,45,14,24,38,40,43,83,26,4,30,17,28,24,6,12,93,120
2017,2,21700877,2/23/2018,1610612750,Minnesota Timberwolves,0,0,1610612745,Houston Rockets,1,1,30,38,68,10,16,26,40,54,94,12,4,16,20,36,19,6,11,94,102
2017,2,21700876,2/23/2018,1610612749,Milwaukee Bucks,0,1,1610612761,Toronto Raptors,1,0,30,34,64,13,13,26,43,47,90,23,4,27,17,32,21,7,21,106,122
2017,2,21700876,2/23/2018,1610612761,Toronto Raptors,1,0,1610612749,Milwaukee Bucks,0,1,34,22,56,9,25,34,43,47,90,24,2,26,8,40,23,6,12,108,119
2017,2,21700875,2/23/2018,1610612764,Washington Wizards,1,0,1610612766,Charlotte Hornets,0,1,31,25,56,9,16,25,40,41,81,16,1,17,9,32,25,7,14,93,105
2017,2,21700875,2/23/2018,1610612766,Charlotte Hornets,0,1,1610612764,Washington Wizards,1,0,27,24,51,17,22,39,44,46,90,17,3,20,14,34,26,3,9,93,122
2016,2,21601037,3/19/2017,1610612738,Boston Celtics,0,0,1610612755,Philadelphia 76ers,1,1,28,27,55,6,23,29,34,50,84,25,4,29,15,36,27,9,18,101,99
2016,2,21601037,3/19/2017,1610612755,Philadelphia 76ers,1,1,1610612738,Boston Celtics,0,0,29,26,55,12,21,33,41,47,88,11,4,15,11,37,29,8,16,100,105
2016,2,21600498,12/30/2016,1610612737,Atlanta Hawks,1,1,1610612765,Detroit Pistons,0,0,31,31,62,8,18,26,39,49,88,19,6,25,16,36,29,9,15,96,105
2016,2,21600498,12/30/2016,1610612765,Detroit Pistons,0,0,1610612737,Atlanta Hawks,1,1,26,27,53,9,22,31,35,49,84,19,2,21,18,33,22,10,18,96,98
2017,2,21700874,2/23/2018,1610612737,Atlanta Hawks,0,0,1610612754,Indiana Pacers,1,1,30,21,51,7,24,31,37,45,82,12,7,19,8,42,14,17,22,104,93
2017,2,21700874,2/23/2018,1610612754,Indiana Pacers,1,1,1610612737,Atlanta Hawks,0,0,39,34,73,9,19,28,48,53,101,11,2,13,20,35,30,9,17,104,116
2017,2,21700873,2/23/2018,1610612738,Boston Celtics,0,1,1610612765,Detroit Pistons,1,0,24,22,46,17,22,39,41,44,85,11,7,18,11,36,30,4,11,93,110
2017,2,21700873,2/23/2018,1610612765,Detroit Pistons,1,0,1610612738,Boston Celtics,0,1,27,25,52,10,23,33,37,48,85,14,7,21,14,37,16,8,13,94,98
2017,2,21700872,2/22/2018,1610612744,Golden State Warriors,1,1,1610612746,LA Clippers,0,0,33,19,52,14,11,25,47,30,77,26,8,34,5,29,31,9,15,103,134
2017,2,21700872,2/22/2018,1610612746,LA Clippers,0,0,1610612744,Golden State Warriors,1,1,33,23,56,11,21,32,44,44,88,28,6,34,15,31,32,8,15,104,127
2017,2,21700871,2/22/2018,1610612758,Sacramento Kings,1,0,1610612760,Oklahoma City Thunder,0,1,30,34,64,12,15,27,42,49,91,11,4,15,12,39,23,6,9,94,107
2017,2,21700871,2/22/2018,1610612760,Oklahoma City Thunder,0,1,1610612758,Sacramento Kings,1,0,24,27,51,14,21,35,38,48,86,20,4,24,14,35,26,6,11,95,110
2017,2,21700870,2/22/2018,1610612741,Chicago Bulls,1,0,1610612755,Philadelphia 76ers,0,1,26,37,63,18,16,34,44,53,97,9,6,15,17,37,27,7,14,104,115
2017,2,21700870,2/22/2018,1610612755,Philadelphia 76ers,0,1,1610612741,Chicago Bulls,1,0,31,22,53,11,18,29,42,40,82,21,14,35,8,40,25,5,11,102,116
2017,2,21700869,2/22/2018,1610612739,Cleveland Cavaliers,1,0,1610612764,Washington Wizards,0,1,34,15,49,8,27,35,42,42,84,11,8,19,9,39,20,9,13,96,103
2017,2,21700869,2/22/2018,1610612764,Washington Wizards,0,1,1610612739,Cleveland Cavaliers,1,0,32,30,62,12,18,30,44,48,92,10,0,10,13,35,29,5,11,95,110
2017,2,21700868,2/22/2018,1610612752,New York Knicks,0,1,1610612753,Orlando Magic,1,0,41,33,74,7,18,25,48,51,99,17,4,21,19,34,28,7,9,100,120
2017,2,21700868,2/22/2018,1610612753,Orlando Magic,1,0,1610612752,New York Knicks,0,1,32,27,59,11,13,24,43,40,83,16,7,23,8,35,28,7,14,100,113
2017,2,21700867,2/22/2018,1610612751,Brooklyn Nets,0,0,1610612766,Charlotte Hornets,1,1,22,28,50,14,29,43,36,57,93,10,4,14,15,43,27,3,10,97,96
2017,2,21700867,2/22/2018,1610612766,Charlotte Hornets,1,1,1610612751,Brooklyn Nets,0,0,31,35,66,11,10,21,42,45,87,16,4,20,17,30,29,6,15,97,111
2017,2,21700866,2/15/2018,1610612747,Los Angeles Lakers,0,0,1610612750,Minnesota Timberwolves,1,1,36,27,63,7,24,31,43,51,94,18,8,26,17,39,19,5,13,102,111
2017,2,21700866,2/15/2018,1610612750,Minnesota Timberwolves,1,1,1610612747,Los Angeles Lakers,0,0,36,30,66,6,18,24,42,48,90,29,2,31,14,36,23,6,10,102,119
2017,2,21700865,2/15/2018,1610612743,Denver Nuggets,0,1,1610612749,Milwaukee Bucks,1,0,23,22,45,24,16,40,47,38,85,16,4,20,10,29,37,9,18,102,134
2017,2,21700865,2/15/2018,1610612749,Milwaukee Bucks,1,0,1610612743,Denver Nuggets,0,1,40,26,66,9,17,26,49,43,92,16,6,22,16,30,27,9,16,103,123
2016,2,21601036,3/19/2017,1610612742,Dallas Mavericks,0,1,1610612751,Brooklyn Nets,1,0,31,20,51,10,15,25,41,35,76,19,6,25,4,33,20,2,10,93,111
2017,2,21700864,2/14/2018,1610612744,Golden State Warriors,0,0,1610612757,Portland Trail Blazers,1,1,30,23,53,13,24,37,43,47,90,18,1,19,9,39,24,9,16,104,117
2017,2,21700864,2/14/2018,1610612757,Portland Trail Blazers,1,1,1610612744,Golden State Warriors,0,0,33,27,60,12,21,33,45,48,93,21,3,24,15,34,20,8,14,104,123
2017,2,21700863,2/14/2018,1610612756,Phoenix Suns,0,0,1610612762,Utah Jazz,1,1,22,28,50,12,17,29,34,45,79,17,7,24,9,41,19,6,12,93,97
2017,2,21700863,2/14/2018,1610612762,Utah Jazz,1,1,1610612756,Phoenix Suns,0,0,29,29,58,10,24,34,39,53,92,19,3,22,16,38,22,5,9,94,107
2014,2,21400667,1/25/2015,1610612745,Houston Rockets,0,1,1610612747,Los Angeles Lakers,1,0,22,21,43,13,31,44,35,52,87,16,5,21,13,42,22,4,14,97,99
2014,2,21400667,1/25/2015,1610612747,Los Angeles Lakers,1,0,1610612745,Houston Rockets,0,1,33,33,66,1,12,13,34,45,79,18,7,25,14,35,20,13,21,97,87
2017,2,21700862,2/14/2018,1610612740,New Orleans Pelicans,1,1,1610612747,Los Angeles Lakers,0,0,39,28,67,14,18,32,53,46,99,19,2,21,14,33,35,5,12,106,139
2017,2,21700862,2/14/2018,1610612747,Los Angeles Lakers,0,0,1610612740,New Orleans Pelicans,1,1,36,32,68,10,12,22,46,44,90,15,3,18,10,36,26,13,20,108,117
2016,2,21601036,3/19/2017,1610612751,Brooklyn Nets,1,0,1610612742,Dallas Mavericks,0,1,18,23,41,13,18,31,31,41,72,29,9,38,13,33,16,8,15,94,104
2017,2,21700861,2/14/2018,1610612760,Oklahoma City Thunder,0,1,1610612763,Memphis Grizzlies,1,0,23,21,44,17,20,37,40,41,81,24,11,35,11,37,26,6,9,94,121
2017,2,21700861,2/14/2018,1610612763,Memphis Grizzlies,1,0,1610612760,Oklahoma City Thunder,0,1,30,29,59,14,13,27,44,42,86,12,3,15,10,33,29,7,12,95,114
2017,2,21700859,2/14/2018,1610612741,Chicago Bulls,1,0,1610612761,Toronto Raptors,0,1,35,32,67,4,20,24,39,52,91,16,4,20,8,45,17,5,6,100,98
2017,2,21700859,2/14/2018,1610612761,Toronto Raptors,0,1,1610612741,Chicago Bulls,1,0,34,20,54,14,24,38,48,44,92,12,3,15,6,40,38,5,8,99,122
2017,2,21700860,2/14/2018,1610612745,Houston Rockets,1,1,1610612758,Sacramento Kings,0,0,19,15,34,14,35,49,33,50,83,20,2,22,8,42,19,8,14,98,100
2017,2,21700860,2/14/2018,1610612758,Sacramento Kings,0,0,1610612745,Houston Rockets,1,1,28,27,55,10,22,32,38,49,87,5,3,8,9,42,26,10,17,99,91
2017,2,21700858,2/14/2018,1610612738,Boston Celtics,1,0,1610612746,LA Clippers,0,1,27,39,66,15,16,31,42,55,97,20,1,21,15,40,24,5,8,101,119
2017,2,21700858,2/14/2018,1610612746,LA Clippers,0,1,1610612738,Boston Celtics,1,0,33,26,59,11,18,29,44,44,88,30,3,33,10,36,26,4,9,101,129
2017,2,21700857,2/14/2018,1610612752,New York Knicks,1,0,1610612764,Washington Wizards,0,1,36,42,78,9,10,19,45,52,97,14,4,18,15,41,21,7,10,99,113
2017,2,21700857,2/14/2018,1610612764,Washington Wizards,0,1,1610612752,New York Knicks,1,0,41,25,66,7,15,22,48,40,88,15,4,19,10,32,31,7,12,99,118
2017,2,21700856,2/14/2018,1610612751,Brooklyn Nets,1,0,1610612754,Indiana Pacers,0,1,22,26,48,13,22,35,35,48,83,20,7,27,14,39,24,10,14,97,103
2017,2,21700856,2/14/2018,1610612754,Indiana Pacers,0,1,1610612751,Brooklyn Nets,1,0,33,42,75,6,9,15,39,51,90,24,4,28,16,38,20,4,8,95,108
2014,2,21401162,4/8/2015,1610612755,Philadelphia 76ers,1,0,1610612764,Washington Wizards,0,1,22,40,62,9,18,27,31,58,89,19,8,27,20,41,17,4,10,91,90
2014,2,21401162,4/8/2015,1610612764,Washington Wizards,0,1,1610612755,Philadelphia 76ers,1,0,39,18,57,8,7,15,47,25,72,17,6,23,7,19,35,11,15,90,119
2017,2,21700855,2/14/2018,1610612748,Miami Heat,0,0,1610612755,Philadelphia 76ers,1,1,24,26,50,11,16,27,35,42,77,21,8,29,8,40,23,6,11,95,102
2017,2,21700855,2/14/2018,1610612755,Philadelphia 76ers,1,1,1610612748,Miami Heat,0,0,30,27,57,9,26,35,39,53,92,17,8,25,28,31,25,9,19,95,104
2014,2,21400666,1/25/2015,1610612743,Denver Nuggets,1,0,1610612764,Washington Wizards,0,1,29,43,72,12,17,29,41,60,101,21,7,28,20,43,26,5,9,105,115
2014,2,21400666,1/25/2015,1610612764,Washington Wizards,0,1,1610612743,Denver Nuggets,1,0,44,32,76,4,10,14,48,42,90,17,6,23,15,31,29,7,18,105,117
2017,2,21700854,2/14/2018,1610612753,Orlando Magic,1,0,1610612766,Charlotte Hornets,0,1,21,28,49,15,22,37,36,50,86,15,2,17,14,38,21,14,20,101,102
2017,2,21700854,2/14/2018,1610612766,Charlotte Hornets,0,1,1610612753,Orlando Magic,1,0,25,33,58,13,17,30,38,50,88,15,4,19,8,44,26,7,12,100,104
2016,2,21600497,12/30/2016,1610612749,Milwaukee Bucks,0,0,1610612750,Minnesota Timberwolves,1,1,32,24,56,8,10,18,40,34,74,11,6,17,9,27,22,8,14,87,99
2016,2,21600497,12/30/2016,1610612750,Minnesota Timberwolves,1,1,1610612749,Milwaukee Bucks,0,0,30,22,52,13,12,25,43,34,77,17,4,21,12,23,30,4,11,88,116
2017,2,21700853,2/14/2018,1610612737,Atlanta Hawks,0,0,1610612765,Detroit Pistons,1,1,32,24,56,6,27,33,38,51,89,16,3,19,10,41,25,3,11,99,98
2017,2,21700853,2/14/2018,1610612765,Detroit Pistons,1,1,1610612737,Atlanta Hawks,0,0,22,28,50,13,20,33,35,48,83,21,4,25,12,37,26,9,16,98,104
2017,2,21700852,2/13/2018,1610612743,Denver Nuggets,1,1,1610612759,San Antonio Spurs,0,0,36,25,61,10,22,32,46,47,93,15,3,18,14,34,29,6,12,99,117
2017,2,21700852,2/13/2018,1610612759,San Antonio Spurs,0,0,1610612743,Denver Nuggets,1,1,38,22,60,6,16,22,44,38,82,15,7,22,14,26,24,10,19,100,109
2017,2,21700851,2/13/2018,1610612742,Dallas Mavericks,1,0,1610612758,Sacramento Kings,0,1,23,20,43,15,25,40,38,45,83,18,5,23,9,36,29,6,9,94,109
2017,2,21700851,2/13/2018,1610612758,Sacramento Kings,0,1,1610612742,Dallas Mavericks,1,0,35,23,58,12,17,29,47,40,87,8,4,12,8,33,30,4,9,93,114
2017,2,21700850,2/13/2018,1610612739,Cleveland Cavaliers,0,1,1610612760,Oklahoma City Thunder,1,0,29,23,52,16,20,36,45,43,88,14,8,22,14,33,24,6,7,92,120
2017,2,21700850,2/13/2018,1610612760,Oklahoma City Thunder,1,0,1610612739,Cleveland Cavaliers,0,1,29,26,55,11,24,35,40,50,90,21,9,30,23,32,23,6,11,93,112
2017,2,21700849,2/13/2018,1610612745,Houston Rockets,0,1,1610612750,Minnesota Timberwolves,1,0,19,17,36,22,25,47,41,42,83,22,7,29,10,35,25,3,6,90,126
2017,2,21700849,2/13/2018,1610612750,Minnesota Timberwolves,1,0,1610612745,Houston Rockets,0,1,34,27,61,6,17,23,40,44,84,22,1,23,13,32,22,1,9,90,108
2017,2,21700848,2/13/2018,1610612737,Atlanta Hawks,0,0,1610612749,Milwaukee Bucks,1,1,21,30,51,12,23,35,33,53,86,14,6,20,19,38,21,6,14,92,92
2017,2,21700848,2/13/2018,1610612749,Milwaukee Bucks,1,1,1610612737,Atlanta Hawks,0,0,30,33,63,8,17,25,38,50,88,13,4,17,17,37,23,7,10,90,97
2016,2,21601035,3/18/2017,1610612744,Golden State Warriors,1,1,1610612749,Milwaukee Bucks,0,0,33,19,52,12,11,23,45,30,75,15,4,19,7,24,30,8,14,90,117
2017,2,21700847,2/13/2018,1610612748,Miami Heat,0,0,1610612761,Toronto Raptors,1,1,30,27,57,12,17,29,42,44,86,16,3,19,12,34,24,7,16,98,112
2017,2,21700847,2/13/2018,1610612761,Toronto Raptors,1,1,1610612748,Miami Heat,0,0,29,26,55,13,22,35,42,48,90,18,5,23,8,42,24,5,8,98,115
2017,2,21700846,2/12/2018,1610612744,Golden State Warriors,1,1,1610612756,Phoenix Suns,0,0,41,22,63,11,15,26,52,37,89,14,7,21,9,32,36,2,12,103,129
2017,2,21700846,2/12/2018,1610612756,Phoenix Suns,0,0,1610612744,Golden State Warriors,1,1,30,42,72,3,20,23,33,62,95,14,8,22,21,46,13,8,17,103,83
2016,2,21601035,3/18/2017,1610612749,Milwaukee Bucks,0,0,1610612744,Golden State Warriors,1,1,27,35,62,9,18,27,36,53,89,11,3,14,16,39,19,5,11,91,92
2014,2,21400665,1/25/2015,1610612738,Boston Celtics,0,0,1610612744,Golden State Warriors,1,1,31,36,67,10,18,28,41,54,95,19,8,27,17,41,23,9,14,103,111
2014,2,21400665,1/25/2015,1610612744,Golden State Warriors,1,1,1610612738,Boston Celtics,0,0,34,32,66,8,15,23,42,47,89,22,3,25,11,37,29,5,13,102,114
2017,2,21700845,2/12/2018,1610612759,San Antonio Spurs,0,0,1610612762,Utah Jazz,1,1,32,28,60,6,19,25,38,47,85,17,8,25,13,38,23,7,11,97,99
2017,2,21700845,2/12/2018,1610612762,Utah Jazz,1,1,1610612759,San Antonio Spurs,0,0,24,36,60,11,13,24,35,49,84,20,10,30,13,40,15,5,10,96,101
2017,2,21700844,2/12/2018,1610612741,Chicago Bulls,1,1,1610612753,Orlando Magic,0,0,31,25,56,9,23,32,40,48,88,16,5,21,14,35,25,8,11,96,105
2017,2,21700844,2/12/2018,1610612753,Orlando Magic,0,0,1610612741,Chicago Bulls,1,1,27,26,53,10,21,31,37,47,84,17,2,19,9,39,24,6,10,96,101
2017,2,21700843,2/12/2018,1610612746,LA Clippers,0,1,1610612751,Brooklyn Nets,1,0,42,27,69,6,10,16,48,37,85,12,2,14,11,28,19,10,15,93,114
2017,2,21700843,2/12/2018,1610612751,Brooklyn Nets,1,0,1610612746,LA Clippers,0,1,29,20,49,12,28,40,41,48,89,7,3,10,13,37,27,8,13,93,101
2017,2,21700842,2/12/2018,1610612752,New York Knicks,0,0,1610612755,Philadelphia 76ers,1,1,25,30,55,6,18,24,31,48,79,24,4,28,16,33,16,13,19,97,92
2017,2,21700842,2/12/2018,1610612755,Philadelphia 76ers,1,1,1610612752,New York Knicks,0,0,31,25,56,10,9,19,41,34,75,16,8,24,9,29,27,5,19,95,108
2017,2,21700841,2/12/2018,1610612740,New Orleans Pelicans,0,1,1610612765,Detroit Pistons,1,0,30,36,66,14,20,34,44,56,100,16,0,16,14,42,31,5,12,105,118
2017,2,21700841,2/12/2018,1610612765,Detroit Pistons,1,0,1610612740,New Orleans Pelicans,0,1,26,34,60,9,26,35,35,60,95,24,8,32,18,47,18,6,14,105,103
2017,2,21700840,2/11/2018,1610612757,Portland Trail Blazers,1,0,1610612762,Utah Jazz,0,1,24,32,56,9,16,25,33,48,81,21,4,25,8,43,16,8,13,96,96
2017,2,21700840,2/11/2018,1610612762,Utah Jazz,0,1,1610612757,Portland Trail Blazers,1,0,28,34,62,13,13,26,41,47,88,20,2,22,16,31,23,7,13,94,115
2017,2,21700839,2/11/2018,1610612760,Oklahoma City Thunder,1,1,1610612763,Memphis Grizzlies,0,0,18,22,40,16,21,37,34,43,77,26,14,40,14,37,21,4,10,91,110
2017,2,21700839,2/11/2018,1610612763,Memphis Grizzlies,0,0,1610612760,Oklahoma City Thunder,1,1,26,28,54,6,22,28,32,50,82,22,2,24,21,30,21,6,17,92,92
2017,2,21700838,2/11/2018,1610612750,Minnesota Timberwolves,1,1,1610612758,Sacramento Kings,0,0,28,22,50,9,15,24,37,37,74,28,4,32,9,30,29,12,17,97,111
2017,2,21700838,2/11/2018,1610612758,Sacramento Kings,0,0,1610612750,Minnesota Timberwolves,1,1,32,31,63,10,15,25,42,46,88,12,5,17,18,31,17,10,19,97,106
2017,2,21700837,2/11/2018,1610612742,Dallas Mavericks,0,0,1610612745,Houston Rockets,1,1,28,34,62,10,21,31,38,55,93,11,5,16,17,41,26,9,14,98,97
2017,2,21700837,2/11/2018,1610612745,Houston Rockets,1,1,1610612742,Dallas Mavericks,0,0,21,12,33,13,32,45,34,44,78,23,10,33,7,42,15,6,9,97,104
2014,2,21401160,4/8/2015,1610612761,Toronto Raptors,0,1,1610612766,Charlotte Hornets,1,0,21,29,50,12,15,27,33,44,77,14,5,19,15,32,20,4,10,83,92
2014,2,21401160,4/8/2015,1610612766,Charlotte Hornets,1,0,1610612761,Toronto Raptors,0,1,18,41,59,10,12,22,28,53,81,8,3,11,13,41,15,5,8,82,74
2016,2,21601034,3/18/2017,1610612743,Denver Nuggets,1,0,1610612745,Houston Rockets,0,1,28,30,58,10,21,31,38,51,89,19,11,30,15,41,28,5,14,101,105
2016,2,21601034,3/18/2017,1610612745,Houston Rockets,0,1,1610612743,Denver Nuggets,1,0,33,26,59,5,19,24,38,45,83,28,7,35,11,35,20,9,14,101,109
2017,2,21700836,2/11/2018,1610612752,New York Knicks,0,0,1610612754,Indiana Pacers,1,1,32,26,58,9,26,35,41,52,93,22,3,25,15,38,27,7,12,102,113
2017,2,21700836,2/11/2018,1610612754,Indiana Pacers,1,1,1610612752,New York Knicks,0,0,35,31,66,12,16,28,47,47,94,15,7,22,17,34,27,8,13,102,121
2014,2,21400664,1/25/2015,1610612761,Toronto Raptors,1,1,1610612765,Detroit Pistons,0,0,38,28,66,5,10,15,43,38,81,23,6,29,10,31,23,5,8,94,114
2014,2,21400664,1/25/2015,1610612765,Detroit Pistons,0,0,1610612761,Toronto Raptors,1,1,29,27,56,12,22,34,41,49,90,16,7,23,21,32,24,9,14,95,110
2017,2,21700835,2/11/2018,1610612738,Boston Celtics,1,0,1610612739,Cleveland Cavaliers,0,1,26,25,51,10,28,38,36,53,89,17,5,22,17,38,22,7,15,99,99
2017,2,21700835,2/11/2018,1610612739,Cleveland Cavaliers,0,1,1610612738,Boston Celtics,1,0,29,25,54,16,14,30,45,39,84,15,5,20,8,34,22,3,11,98,121
2017,2,21700834,2/11/2018,1610612737,Atlanta Hawks,1,1,1610612765,Detroit Pistons,0,0,28,21,49,10,19,29,38,40,78,32,5,37,10,32,27,6,13,98,118
2017,2,21700834,2/11/2018,1610612765,Detroit Pistons,0,0,1610612737,Atlanta Hawks,1,1,25,25,50,13,20,33,38,45,83,26,7,33,16,34,30,10,15,98,115
2017,2,21700833,2/11/2018,1610612761,Toronto Raptors,0,1,1610612766,Charlotte Hornets,1,0,31,19,50,18,19,37,49,38,87,7,3,10,8,32,35,5,13,97,123
2017,2,21700833,2/11/2018,1610612766,Charlotte Hornets,1,0,1610612761,Toronto Raptors,0,1,28,38,66,10,13,23,38,51,89,17,6,23,14,39,26,7,13,97,103
2017,2,21700832,2/10/2018,1610612743,Denver Nuggets,0,1,1610612756,Phoenix Suns,1,0,32,27,59,13,16,29,45,43,88,20,2,22,14,29,20,7,14,99,123
2017,2,21700832,2/10/2018,1610612756,Phoenix Suns,1,0,1610612743,Denver Nuggets,0,1,39,26,65,7,12,19,46,38,84,14,11,25,12,33,24,10,15,98,113
2016,2,21600496,12/30/2016,1610612745,Houston Rockets,1,1,1610612746,LA Clippers,0,0,31,10,41,14,26,40,45,36,81,36,7,43,10,30,29,8,13,103,140
2016,2,21600496,12/30/2016,1610612746,LA Clippers,0,0,1610612745,Houston Rockets,1,1,32,31,63,13,20,33,45,51,96,13,3,16,14,38,22,12,15,104,116
2017,2,21700831,2/10/2018,1610612744,Golden State Warriors,1,1,1610612759,San Antonio Spurs,0,0,36,22,58,12,15,27,48,37,85,14,1,15,12,25,35,8,16,97,122
2017,2,21700831,2/10/2018,1610612759,San Antonio Spurs,0,0,1610612744,Golden State Warriors,1,1,38,29,67,5,22,27,43,51,94,14,5,19,15,38,30,5,10,97,105
2016,2,21600080,11/5/2016,1610612739,Cleveland Cavaliers,0,1,1610612755,Philadelphia 76ers,1,0,23,30,53,14,24,38,37,54,91,14,4,18,12,43,23,9,16,100,102
2016,2,21600080,11/5/2016,1610612755,Philadelphia 76ers,1,0,1610612739,Cleveland Cavaliers,0,1,26,23,49,14,24,38,40,47,87,7,5,12,10,39,21,10,17,102,101
2017,2,21700830,2/10/2018,1610612742,Dallas Mavericks,1,1,1610612747,Los Angeles Lakers,0,0,36,26,62,12,15,27,48,41,89,22,5,27,13,30,32,7,11,99,130
2017,2,21700830,2/10/2018,1610612747,Los Angeles Lakers,0,0,1610612742,Dallas Mavericks,1,1,30,20,50,16,18,34,46,38,84,15,7,22,12,31,29,8,17,99,123
2017,2,21700829,2/10/2018,1610612741,Chicago Bulls,1,0,1610612764,Washington Wizards,0,1,25,23,48,9,23,32,34,46,80,13,3,16,11,36,23,8,16,94,90
2017,2,21700829,2/10/2018,1610612764,Washington Wizards,0,1,1610612741,Chicago Bulls,1,0,25,19,44,13,25,38,38,44,82,12,2,14,7,37,31,11,14,94,101
2014,2,21401161,4/8/2015,1610612741,Chicago Bulls,0,0,1610612753,Orlando Magic,1,1,22,31,53,12,14,26,34,45,79,23,8,31,16,34,25,8,17,94,103
2017,2,21700828,2/10/2018,1610612746,LA Clippers,0,0,1610612755,Philadelphia 76ers,1,1,30,26,56,8,24,32,38,50,88,14,9,23,14,40,20,12,17,102,98
2017,2,21700828,2/10/2018,1610612755,Philadelphia 76ers,1,1,1610612746,LA Clippers,0,0,30,27,57,13,20,33,43,47,90,13,4,17,7,43,32,7,12,102,112
2014,2,21401161,4/8/2015,1610612753,Orlando Magic,1,1,1610612741,Chicago Bulls,0,0,30,29,59,8,15,23,38,44,82,21,3,24,15,32,21,9,15,94,105
2017,2,21700827,2/10/2018,1610612749,Milwaukee Bucks,0,1,1610612753,Orlando Magic,1,0,34,23,57,9,16,25,43,39,82,16,4,20,9,33,28,7,12,94,111
2017,2,21700827,2/10/2018,1610612753,Orlando Magic,1,0,1610612749,Milwaukee Bucks,0,1,29,24,53,8,22,30,37,46,83,22,4,26,14,34,23,7,12,96,104
2017,2,21700826,2/10/2018,1610612740,New Orleans Pelicans,0,1,1610612751,Brooklyn Nets,1,0,43,39,82,9,15,24,52,54,106,25,14,39,17,44,23,10,15,123,138
2017,2,21700826,2/10/2018,1610612751,Brooklyn Nets,1,0,1610612740,New Orleans Pelicans,0,1,22,33,55,21,38,59,43,71,114,21,1,22,22,49,30,10,17,120,128
2017,2,21700825,2/9/2018,1610612757,Portland Trail Blazers,0,1,1610612758,Sacramento Kings,1,0,28,25,53,15,20,35,43,45,88,17,1,18,14,31,18,5,11,93,118
2017,2,21700825,2/9/2018,1610612758,Sacramento Kings,1,0,1610612757,Portland Trail Blazers,0,1,29,38,67,9,14,23,38,52,90,15,6,21,18,37,25,10,12,94,100
2017,2,21700824,2/9/2018,1610612762,Utah Jazz,1,1,1610612766,Charlotte Hornets,0,0,31,24,55,10,19,29,41,43,84,14,3,17,12,32,29,8,14,95,106
2017,2,21700824,2/9/2018,1610612766,Charlotte Hornets,0,0,1610612762,Utah Jazz,1,1,26,35,61,9,15,24,35,50,85,15,4,19,6,46,17,5,7,95,94
2017,2,21700823,2/9/2018,1610612743,Denver Nuggets,0,0,1610612745,Houston Rockets,1,1,39,21,60,3,25,28,42,46,88,17,4,21,9,39,25,5,10,98,104
2017,2,21700823,2/9/2018,1610612745,Houston Rockets,1,1,1610612743,Denver Nuggets,0,0,24,21,45,19,22,41,43,43,86,25,9,34,15,33,26,7,12,99,130
2017,2,21700822,2/9/2018,1610612741,Chicago Bulls,1,1,1610612750,Minnesota Timberwolves,0,0,32,25,57,9,17,26,41,42,83,23,7,30,9,36,22,8,11,100,114
2017,2,21700822,2/9/2018,1610612750,Minnesota Timberwolves,0,0,1610612741,Chicago Bulls,1,1,33,32,65,8,14,22,41,46,87,23,5,28,14,34,19,5,14,100,113
2017,2,21700821,2/9/2018,1610612748,Miami Heat,1,1,1610612749,Milwaukee Bucks,0,0,22,40,62,10,16,26,32,56,88,17,1,18,17,39,16,9,16,97,91
2017,2,21700821,2/9/2018,1610612749,Milwaukee Bucks,0,0,1610612748,Miami Heat,1,1,26,30,56,6,14,20,32,44,76,15,2,17,5,40,18,7,18,98,85
2017,2,21700820,2/9/2018,1610612738,Boston Celtics,1,0,1610612754,Indiana Pacers,0,1,27,35,62,7,20,27,34,55,89,16,4,20,18,41,16,6,10,90,91
2017,2,21700820,2/9/2018,1610612754,Indiana Pacers,0,1,1610612738,Boston Celtics,1,0,32,31,63,5,15,20,37,46,83,18,4,22,19,27,18,5,15,89,97
2017,2,21700819,2/9/2018,1610612737,Atlanta Hawks,1,0,1610612739,Cleveland Cavaliers,0,1,21,18,39,16,28,44,37,46,83,17,2,19,7,39,20,8,12,97,107
2017,2,21700819,2/9/2018,1610612739,Cleveland Cavaliers,0,1,1610612737,Atlanta Hawks,1,0,31,20,51,15,20,35,46,40,86,16,8,24,7,37,31,4,9,97,123
2017,2,21700818,2/9/2018,1610612740,New Orleans Pelicans,0,0,1610612755,Philadelphia 76ers,1,1,25,39,64,8,23,31,33,62,95,8,8,16,14,52,17,10,12,102,82
2017,2,21700818,2/9/2018,1610612755,Philadelphia 76ers,1,1,1610612740,New Orleans Pelicans,0,0,25,34,59,14,20,34,39,54,93,8,1,9,12,43,26,8,16,101,100
2014,2,21400663,1/25/2015,1610612749,Milwaukee Bucks,0,0,1610612759,San Antonio Spurs,1,1,31,34,65,8,9,17,39,43,82,9,4,13,15,30,29,9,21,95,95
2014,2,21400663,1/25/2015,1610612759,San Antonio Spurs,1,1,1610612749,Milwaukee Bucks,0,0,30,31,61,5,17,22,35,48,83,26,4,30,18,31,22,12,15,95,101
2017,2,21700817,2/9/2018,1610612746,LA Clippers,0,1,1610612765,Detroit Pistons,1,0,32,29,61,10,20,30,42,49,91,14,1,15,15,35,23,5,10,92,108
2017,2,21700817,2/9/2018,1610612765,Detroit Pistons,1,0,1610612746,LA Clippers,0,1,26,31,57,10,21,31,36,52,88,13,4,17,10,44,22,6,9,94,95
2017,2,21700816,2/8/2018,1610612747,Los Angeles Lakers,1,1,1610612760,Oklahoma City Thunder,0,0,32,33,65,10,21,31,42,54,96,12,1,13,17,37,28,6,8,93,106
2017,2,21700816,2/8/2018,1610612760,Oklahoma City Thunder,0,0,1610612747,Los Angeles Lakers,1,1,24,32,56,8,26,34,32,58,90,9,10,19,21,41,16,5,14,94,81
2017,2,21700815,2/8/2018,1610612742,Dallas Mavericks,0,0,1610612744,Golden State Warriors,1,1,31,24,55,9,28,37,40,52,92,14,3,17,16,36,19,6,12,95,103
2017,2,21700815,2/8/2018,1610612744,Golden State Warriors,1,1,1610612742,Dallas Mavericks,0,0,31,28,59,14,15,29,45,43,88,17,3,20,19,26,37,15,16,95,121
2017,2,21700814,2/8/2018,1610612757,Portland Trail Blazers,1,1,1610612766,Charlotte Hornets,0,0,32,27,59,9,22,31,41,49,90,18,4,22,11,40,18,10,17,106,109
2017,2,21700814,2/8/2018,1610612766,Charlotte Hornets,0,0,1610612757,Portland Trail Blazers,1,1,25,40,65,13,20,33,38,60,98,14,3,17,12,49,17,7,12,106,103
2017,2,21700813,2/8/2018,1610612738,Boston Celtics,0,1,1610612764,Washington Wizards,1,0,30,28,58,9,17,26,39,45,84,23,11,34,11,40,16,11,18,107,110
2017,2,21700813,2/8/2018,1610612764,Washington Wizards,1,0,1610612738,Boston Celtics,0,1,26,43,69,12,14,26,38,57,95,16,4,20,19,41,28,9,22,108,104
2017,2,21700812,2/8/2018,1610612752,New York Knicks,0,0,1610612761,Toronto Raptors,1,1,26,30,56,7,20,27,33,50,83,15,3,18,10,43,19,11,16,99,88
2017,2,21700812,2/8/2018,1610612761,Toronto Raptors,1,1,1610612752,New York Knicks,0,0,27,25,52,16,27,43,43,52,95,11,3,14,12,41,31,4,9,98,113
2017,2,21700811,2/8/2018,1610612737,Atlanta Hawks,0,0,1610612753,Orlando Magic,1,1,25,32,57,12,18,30,37,50,87,12,6,18,17,35,25,10,17,96,98
2017,2,21700811,2/8/2018,1610612753,Orlando Magic,1,1,1610612737,Atlanta Hawks,0,0,27,28,55,9,20,29,36,48,84,19,3,22,12,39,20,4,13,95,100
2014,2,21400662,1/25/2015,1610612753,Orlando Magic,1,0,1610612754,Indiana Pacers,0,1,32,29,61,6,11,17,38,40,78,17,6,23,4,39,22,8,12,95,99
2014,2,21400662,1/25/2015,1610612754,Indiana Pacers,0,1,1610612753,Orlando Magic,1,0,35,28,63,8,12,20,43,40,83,12,6,18,12,31,27,7,14,95,106
2017,2,21700810,2/7/2018,1610612756,Phoenix Suns,1,0,1610612759,San Antonio Spurs,0,1,30,35,65,3,29,32,33,64,97,12,6,18,16,52,15,6,11,100,81
2017,2,21700810,2/7/2018,1610612759,San Antonio Spurs,0,1,1610612756,Phoenix Suns,1,0,30,31,61,16,16,32,46,47,93,21,6,27,16,34,26,8,12,100,129
2017,2,21700809,3/21/2018,1610612740,New Orleans Pelicans,1,1,1610612754,Indiana Pacers,0,0,26,30,56,8,15,23,34,45,79,20,4,24,11,35,15,13,20,99,96
2017,2,21700809,3/21/2018,1610612754,Indiana Pacers,0,0,1610612740,New Orleans Pelicans,1,1,27,44,71,7,15,22,34,59,93,17,1,18,17,42,15,4,15,100,92
2017,2,21700808,2/7/2018,1610612762,Utah Jazz,0,1,1610612763,Memphis Grizzlies,1,0,23,24,47,6,16,22,29,40,69,28,5,33,12,29,14,12,20,92,92
2017,2,21700808,2/7/2018,1610612763,Memphis Grizzlies,1,0,1610612762,Utah Jazz,0,1,26,32,58,8,15,23,34,47,81,12,4,16,13,36,18,6,16,94,88
2017,2,21700807,2/7/2018,1610612739,Cleveland Cavaliers,1,1,1610612750,Minnesota Timberwolves,0,0,31,16,47,21,20,41,52,36,88,15,8,23,10,31,33,7,16,106,140
2017,2,21700807,2/7/2018,1610612750,Minnesota Timberwolves,0,0,1610612739,Cleveland Cavaliers,1,1,35,25,60,19,14,33,54,39,93,11,1,12,6,34,33,5,12,106,138
2017,2,21700806,2/7/2018,1610612745,Houston Rockets,0,1,1610612748,Miami Heat,1,0,26,17,43,12,19,31,38,36,74,21,5,26,8,29,16,3,10,89,109
2017,2,21700806,2/7/2018,1610612748,Miami Heat,1,0,1610612745,Houston Rockets,0,1,26,30,56,13,19,32,39,49,88,10,2,12,17,32,23,8,13,87,101
2017,2,21700805,2/7/2018,1610612751,Brooklyn Nets,0,0,1610612765,Detroit Pistons,1,1,22,17,39,17,34,51,39,51,90,11,1,12,12,40,33,10,20,102,106
2017,2,21700805,2/7/2018,1610612765,Detroit Pistons,1,1,1610612751,Brooklyn Nets,0,0,35,33,68,9,15,24,44,48,92,18,7,25,9,42,20,4,7,101,115
2017,2,21700804,2/6/2018,1610612747,Los Angeles Lakers,1,1,1610612756,Phoenix Suns,0,0,28,29,57,11,15,26,39,44,83,23,3,26,13,32,19,4,14,96,112
2017,2,21700804,2/6/2018,1610612756,Phoenix Suns,0,0,1610612747,Los Angeles Lakers,1,1,28,37,65,8,21,29,36,58,94,13,10,23,20,44,24,7,11,98,93
2017,2,21700802,2/6/2018,1610612755,Philadelphia 76ers,1,1,1610612764,Washington Wizards,0,0,31,23,54,14,14,28,45,37,82,11,3,14,14,24,27,14,17,93,115
2017,2,21700802,2/6/2018,1610612764,Washington Wizards,0,0,1610612755,Philadelphia 76ers,1,1,34,32,66,7,20,27,41,52,93,13,5,18,22,33,23,9,12,93,102
2017,2,21700803,2/6/2018,1610612744,Golden State Warriors,1,0,1610612760,Oklahoma City Thunder,0,1,29,19,48,8,20,28,37,39,76,23,8,31,13,31,27,14,25,104,105
2017,2,21700803,2/6/2018,1610612760,Oklahoma City Thunder,0,1,1610612744,Golden State Warriors,1,0,32,30,62,12,19,31,44,49,93,25,8,33,16,38,17,7,13,104,125
2014,2,21401159,4/7/2015,1610612746,LA Clippers,1,1,1610612747,Los Angeles Lakers,0,0,32,25,57,7,17,24,39,42,81,20,10,30,9,37,25,2,9,94,105
2014,2,21401159,4/7/2015,1610612747,Los Angeles Lakers,0,0,1610612746,LA Clippers,1,1,26,33,59,9,16,25,35,49,84,21,6,27,12,42,24,6,11,96,100
2014,2,21400661,1/25/2015,1610612737,Atlanta Hawks,1,1,1610612750,Minnesota Timberwolves,0,0,35,17,52,10,18,28,45,35,80,12,6,18,10,27,30,4,10,88,112
2014,2,21400661,1/25/2015,1610612750,Minnesota Timberwolves,0,0,1610612737,Atlanta Hawks,1,1,31,24,55,6,10,16,37,34,71,20,5,25,14,23,24,8,17,87,100
2017,2,21700801,2/6/2018,1610612749,Milwaukee Bucks,0,1,1610612752,New York Knicks,1,0,29,27,56,8,18,26,37,45,82,21,6,27,12,38,23,5,15,97,103
2017,2,21700801,2/6/2018,1610612752,New York Knicks,1,0,1610612749,Milwaukee Bucks,0,1,32,34,66,5,18,23,37,52,89,10,5,15,18,36,20,11,20,98,89
2017,2,21700800,2/6/2018,1610612745,Houston Rockets,0,1,1610612751,Brooklyn Nets,1,0,29,19,48,16,17,33,45,36,81,17,4,21,9,28,16,8,11,91,123
2017,2,21700800,2/6/2018,1610612751,Brooklyn Nets,1,0,1610612745,Houston Rockets,0,1,25,25,50,16,19,35,41,44,85,15,2,17,12,33,24,7,11,91,113
2017,2,21700799,2/6/2018,1610612737,Atlanta Hawks,1,1,1610612763,Memphis Grizzlies,0,0,34,24,58,8,17,25,42,41,83,16,5,21,12,32,29,7,14,94,108
2017,2,21700799,2/6/2018,1610612763,Memphis Grizzlies,0,0,1610612737,Atlanta Hawks,1,1,30,27,57,4,18,22,34,45,79,10,3,13,16,31,23,13,27,94,82
2017,2,21700798,2/6/2018,1610612738,Boston Celtics,0,0,1610612761,Toronto Raptors,1,1,23,37,60,10,13,23,33,50,83,15,5,20,16,38,21,10,17,95,91
2017,2,21700798,2/6/2018,1610612761,Toronto Raptors,1,1,1610612738,Boston Celtics,0,0,23,21,44,17,19,36,40,40,80,14,3,17,8,33,29,3,15,94,111
2017,2,21700797,2/6/2018,1610612739,Cleveland Cavaliers,0,0,1610612753,Orlando Magic,1,1,24,23,47,12,25,37,36,48,84,14,6,20,12,39,19,7,14,96,98
2017,2,21700797,2/6/2018,1610612753,Orlando Magic,1,1,1610612739,Cleveland Cavaliers,0,0,40,26,66,6,16,22,46,42,88,18,9,27,18,29,27,4,13,97,116
2017,2,21700796,2/5/2018,1610612742,Dallas Mavericks,0,0,1610612746,LA Clippers,1,1,16,22,38,17,25,42,33,47,80,18,2,20,12,37,22,10,20,98,101
2017,2,21700796,2/5/2018,1610612746,LA Clippers,1,1,1610612742,Dallas Mavericks,0,0,32,28,60,10,17,27,42,45,87,10,2,12,9,37,28,5,13,97,104
2017,2,21700795,2/5/2018,1610612741,Chicago Bulls,0,0,1610612758,Sacramento Kings,1,1,18,26,44,14,22,36,32,48,80,20,4,24,11,39,20,5,12,94,98
2017,2,21700795,2/5/2018,1610612758,Sacramento Kings,1,1,1610612741,Chicago Bulls,0,0,26,26,52,11,21,32,37,47,84,19,6,25,13,38,22,6,11,94,104
2017,2,21700794,2/5/2018,1610612743,Denver Nuggets,1,1,1610612766,Charlotte Hornets,0,0,28,19,47,18,16,34,46,35,81,11,2,13,6,31,30,7,11,91,121
2017,2,21700794,2/5/2018,1610612766,Charlotte Hornets,0,0,1610612743,Denver Nuggets,1,1,28,23,51,11,15,26,39,38,77,15,9,24,6,38,21,10,10,92,104
2017,2,21700793,2/5/2018,1610612740,New Orleans Pelicans,1,0,1610612762,Utah Jazz,0,1,39,32,71,8,14,22,47,46,93,7,6,13,11,37,24,6,14,102,109
2017,2,21700793,2/5/2018,1610612762,Utah Jazz,0,1,1610612740,New Orleans Pelicans,1,0,38,30,68,14,7,21,52,37,89,15,2,17,11,26,29,10,15,101,133
2017,2,21700792,2/5/2018,1610612748,Miami Heat,1,0,1610612753,Orlando Magic,0,1,37,33,70,3,20,23,40,53,93,26,9,35,21,38,21,8,12,97,109
2017,2,21700792,2/5/2018,1610612753,Orlando Magic,0,1,1610612748,Miami Heat,1,0,28,26,54,13,17,30,41,43,84,16,3,19,7,39,25,5,11,95,111
2017,2,21700791,2/5/2018,1610612754,Indiana Pacers,1,0,1610612764,Washington Wizards,0,1,25,26,51,12,17,29,37,43,80,16,9,25,11,38,19,8,16,96,102
2017,2,21700791,2/5/2018,1610612764,Washington Wizards,0,1,1610612754,Indiana Pacers,1,0,38,19,57,7,18,25,45,37,82,14,3,17,9,30,29,6,14,94,111
2017,2,21700790,2/5/2018,1610612757,Portland Trail Blazers,0,0,1610612765,Detroit Pistons,1,1,27,34,61,10,23,33,37,57,94,7,1,8,16,42,18,7,13,94,91
2017,2,21700790,2/5/2018,1610612765,Detroit Pistons,1,1,1610612757,Portland Trail Blazers,0,0,29,29,58,15,15,30,44,44,88,8,4,12,13,32,36,9,14,96,111
2014,2,21400660,1/25/2015,1610612740,New Orleans Pelicans,1,1,1610612742,Dallas Mavericks,0,0,32,30,62,8,9,17,40,39,79,21,4,25,17,25,27,5,10,85,109
2014,2,21400660,1/25/2015,1610612742,Dallas Mavericks,0,0,1610612740,New Orleans Pelicans,1,1,30,27,57,9,15,24,39,42,81,19,6,25,16,29,20,9,9,85,106
2017,2,21700789,2/4/2018,1610612756,Phoenix Suns,1,0,1610612766,Charlotte Hornets,0,1,26,22,48,15,14,29,41,36,77,13,0,13,5,31,24,12,19,95,110
2017,2,21700789,2/4/2018,1610612766,Charlotte Hornets,0,1,1610612756,Phoenix Suns,1,0,30,28,58,10,28,38,40,56,96,25,4,29,21,38,24,4,8,96,115
2017,2,21700788,2/4/2018,1610612747,Los Angeles Lakers,0,1,1610612760,Oklahoma City Thunder,1,0,29,27,56,13,17,30,42,44,86,11,7,18,12,37,24,13,19,102,108
2017,2,21700788,2/4/2018,1610612760,Oklahoma City Thunder,1,0,1610612747,Los Angeles Lakers,0,1,33,31,64,7,18,25,40,49,89,17,8,25,18,35,17,6,18,102,104
2017,2,21700787,2/4/2018,1610612761,Toronto Raptors,1,1,1610612763,Memphis Grizzlies,0,0,35,19,54,6,29,35,41,48,89,13,2,15,13,35,21,7,12,95,101
2017,2,21700787,2/4/2018,1610612763,Memphis Grizzlies,0,0,1610612761,Toronto Raptors,1,1,21,35,56,8,17,25,29,52,81,20,3,23,16,38,17,13,19,96,86
2017,2,21700786,2/4/2018,1610612737,Atlanta Hawks,0,1,1610612752,New York Knicks,1,0,20,34,54,15,18,33,35,52,87,14,5,19,17,36,25,10,16,95,99
2017,2,21700786,2/4/2018,1610612752,New York Knicks,1,0,1610612737,Atlanta Hawks,0,1,36,35,71,5,18,23,41,53,94,9,6,15,21,34,16,6,15,96,96
2017,2,21700785,2/4/2018,1610612749,Milwaukee Bucks,0,1,1610612751,Brooklyn Nets,1,0,34,28,62,8,11,19,42,39,81,17,4,21,15,27,19,5,14,90,109
2017,2,21700785,2/4/2018,1610612751,Brooklyn Nets,1,0,1610612749,Milwaukee Bucks,0,1,28,33,61,9,20,29,37,53,90,11,3,14,16,40,25,3,9,90,94
2017,2,21700784,2/4/2018,1610612738,Boston Celtics,1,1,1610612757,Portland Trail Blazers,0,0,20,29,49,15,21,36,35,50,85,12,5,17,15,37,24,4,11,91,97
2017,2,21700784,2/4/2018,1610612757,Portland Trail Blazers,0,0,1610612738,Boston Celtics,1,1,23,37,60,13,18,31,36,55,91,11,3,14,14,43,21,3,8,90,96
2017,2,21700783,2/3/2018,1610612742,Dallas Mavericks,0,1,1610612758,Sacramento Kings,1,0,28,14,42,13,28,41,41,42,83,11,3,14,15,28,28,11,14,91,106
2017,2,21700783,2/3/2018,1610612758,Sacramento Kings,1,0,1610612742,Dallas Mavericks,0,1,35,20,55,8,19,27,43,39,82,5,1,6,11,29,23,8,16,90,99
2017,2,21700782,2/3/2018,1610612743,Denver Nuggets,1,1,1610612744,Golden State Warriors,0,0,27,35,62,12,17,29,39,52,91,25,4,29,20,35,28,9,16,99,115
2017,2,21700782,2/3/2018,1610612744,Golden State Warriors,0,0,1610612743,Denver Nuggets,1,1,35,20,55,8,23,31,43,43,86,14,9,23,11,35,28,7,14,99,108
2017,2,21700781,2/3/2018,1610612759,San Antonio Spurs,1,0,1610612762,Utah Jazz,0,1,34,31,65,10,16,26,44,47,91,13,5,18,14,34,25,6,12,97,111
2017,2,21700781,2/3/2018,1610612762,Utah Jazz,0,1,1610612759,San Antonio Spurs,1,0,27,19,46,12,11,23,39,30,69,30,6,36,8,26,26,9,18,97,120
2014,2,21401158,4/7/2015,1610612750,Minnesota Timberwolves,0,0,1610612758,Sacramento Kings,1,1,39,35,74,6,13,19,45,48,93,15,6,21,13,36,29,5,10,98,111
2014,2,21401158,4/7/2015,1610612758,Sacramento Kings,1,1,1610612750,Minnesota Timberwolves,0,0,33,23,56,9,15,24,42,38,80,23,11,34,14,29,25,6,14,96,116
2014,2,21400659,1/25/2015,1610612746,LA Clippers,0,1,1610612756,Phoenix Suns,1,0,33,31,64,10,13,23,43,44,87,24,12,36,19,31,28,5,12,98,120
2014,2,21400659,1/25/2015,1610612756,Phoenix Suns,1,0,1610612746,LA Clippers,0,1,24,27,51,10,19,29,34,46,80,22,5,27,8,39,23,7,11,99,100
2017,2,21700780,2/3/2018,1610612740,New Orleans Pelicans,0,0,1610612750,Minnesota Timberwolves,1,1,34,34,68,8,25,33,42,59,101,15,2,17,20,41,23,9,13,102,107
2017,2,21700780,2/3/2018,1610612750,Minnesota Timberwolves,1,1,1610612740,New Orleans Pelicans,0,0,38,36,74,10,11,21,48,47,95,12,4,16,15,33,21,9,15,102,118
2017,2,21700779,2/3/2018,1610612739,Cleveland Cavaliers,1,0,1610612745,Houston Rockets,0,1,26,31,57,8,22,30,34,53,87,12,4,16,7,48,22,6,11,99,88
2017,2,21700779,2/3/2018,1610612745,Houston Rockets,0,1,1610612739,Cleveland Cavaliers,1,0,25,17,42,19,32,51,44,49,93,13,3,16,8,43,28,4,9,100,120
2017,2,21700778,2/3/2018,1610612753,Orlando Magic,1,0,1610612764,Washington Wizards,0,1,24,21,45,10,22,32,34,43,77,20,2,22,14,29,17,14,20,96,98
2017,2,21700778,2/3/2018,1610612764,Washington Wizards,0,1,1610612753,Orlando Magic,1,0,39,20,59,7,19,26,46,39,85,16,2,18,14,26,35,12,15,96,115
2017,2,21700777,2/3/2018,1610612754,Indiana Pacers,1,1,1610612755,Philadelphia 76ers,0,0,26,26,52,9,18,27,35,44,79,21,4,25,10,35,25,8,14,94,100
2017,2,21700777,2/3/2018,1610612755,Philadelphia 76ers,0,0,1610612754,Indiana Pacers,1,1,23,32,55,10,22,32,33,54,87,16,8,24,20,39,21,15,18,95,92
2017,2,21700776,2/3/2018,1610612748,Miami Heat,0,0,1610612765,Detroit Pistons,1,1,30,25,55,14,22,36,44,47,91,5,2,7,10,38,30,7,12,95,107
2017,2,21700776,2/3/2018,1610612765,Detroit Pistons,1,1,1610612748,Miami Heat,0,0,35,23,58,9,17,26,44,40,84,14,3,17,15,26,23,13,18,96,111
2017,2,21700775,2/3/2018,1610612741,Chicago Bulls,0,0,1610612746,LA Clippers,1,1,23,37,60,12,25,37,35,62,97,21,0,21,17,45,22,4,12,102,103
2017,2,21700775,2/3/2018,1610612746,LA Clippers,1,1,1610612741,Chicago Bulls,0,0,31,32,63,9,16,25,40,48,88,24,4,28,12,37,23,6,14,103,113
2017,2,21700774,2/2/2018,1610612744,Golden State Warriors,0,1,1610612758,Sacramento Kings,1,0,27,20,47,17,16,33,44,36,80,14,2,16,9,28,25,16,25,103,119
2017,2,21700774,2/2/2018,1610612758,Sacramento Kings,1,0,1610612744,Golden State Warriors,0,1,32,38,70,10,15,25,42,53,95,10,5,15,11,45,22,8,13,104,104
2017,2,21700773,2/2/2018,1610612756,Phoenix Suns,1,0,1610612762,Utah Jazz,0,1,27,27,54,9,24,33,36,51,87,16,3,19,10,43,19,7,12,98,97
2017,2,21700773,2/2/2018,1610612762,Utah Jazz,0,1,1610612756,Phoenix Suns,1,0,36,25,61,15,14,29,51,39,90,12,5,17,10,32,30,7,11,97,129
2017,2,21700772,2/2/2018,1610612740,New Orleans Pelicans,0,1,1610612760,Oklahoma City Thunder,1,0,33,33,66,13,11,24,46,44,90,9,4,13,7,39,30,6,16,103,114
2017,2,21700772,2/2/2018,1610612760,Oklahoma City Thunder,1,0,1610612740,New Orleans Pelicans,0,1,28,33,61,9,27,36,37,60,97,17,3,20,18,44,24,10,16,104,100
2017,2,21700771,2/2/2018,1610612749,Milwaukee Bucks,1,1,1610612752,New York Knicks,0,0,26,26,52,7,17,24,33,43,76,19,7,26,5,40,18,7,11,95,92
2017,2,21700771,2/2/2018,1610612752,New York Knicks,0,0,1610612749,Milwaukee Bucks,1,1,31,33,64,5,20,25,36,53,89,13,4,17,23,33,24,10,19,96,90
2017,2,21700770,2/2/2018,1610612748,Miami Heat,0,0,1610612755,Philadelphia 76ers,1,1,22,28,50,12,25,37,34,53,87,17,9,26,23,35,20,9,12,92,97
2017,2,21700770,2/2/2018,1610612755,Philadelphia 76ers,1,1,1610612748,Miami Heat,0,0,34,27,61,8,16,24,42,43,85,11,4,15,11,35,28,3,10,92,103
2017,2,21700769,2/2/2018,1610612757,Portland Trail Blazers,0,0,1610612761,Toronto Raptors,1,1,30,22,52,7,14,21,37,36,73,24,9,33,7,31,20,5,11,95,105
2017,2,21700769,2/2/2018,1610612761,Toronto Raptors,1,1,1610612757,Portland Trail Blazers,0,0,27,32,59,19,21,40,46,53,99,19,2,21,21,34,21,4,6,94,130
2016,2,21601033,3/18/2017,1610612759,San Antonio Spurs,0,0,1610612763,Memphis Grizzlies,1,1,24,23,47,9,19,28,33,42,75,21,1,22,12,30,18,7,15,89,96
2016,2,21601033,3/18/2017,1610612763,Memphis Grizzlies,1,1,1610612759,San Antonio Spurs,0,0,19,27,46,13,17,30,32,44,76,27,4,31,12,34,20,2,10,87,104
2016,2,21600079,11/5/2016,1610612750,Minnesota Timberwolves,0,0,1610612760,Oklahoma City Thunder,1,1,29,36,65,4,15,19,33,51,84,22,7,29,20,33,12,9,17,95,92
2016,2,21600079,11/5/2016,1610612760,Oklahoma City Thunder,1,1,1610612750,Minnesota Timberwolves,0,0,38,32,70,7,9,16,45,41,86,15,9,24,13,29,24,7,12,95,112
2022,2,22200534,12/30/2022,1610612740,New Orleans Pelicans,1,1,1610612755,Philadelphia 76ers,0,0,28,21,49,15,16,31,43,37,80,26,10,36,13,30,19,5,14,96,127
2022,2,22200523,12/29/2022,1610612760,Oklahoma City Thunder,0,0,1610612766,Charlotte Hornets,1,1,31,32,63,11,25,36,42,57,99,18,3,21,18,41,15,8,12,103,113
2022,2,22200523,12/29/2022,1610612766,Charlotte Hornets,1,1,1610612760,Oklahoma City Thunder,0,0,36,16,52,10,22,32,46,38,84,19,10,29,13,31,33,9,18,101,121
2022,2,22200534,12/30/2022,1610612755,Philadelphia 76ers,0,0,1610612740,New Orleans Pelicans,1,1,28,13,41,14,20,34,42,33,75,18,4,22,6,29,28,14,19,97,116
2023,2,22300806,2/23/2024,1610612745,Houston Rockets,1,1,1610612756,Phoenix Suns,0,0,22,26,48,15,30,45,37,56,93,25,9,34,22,39,25,10,14,102,114
2023,2,22300811,2/23/2024,1610612744,Golden State Warriors,1,1,1610612766,Charlotte Hornets,0,0,25,22,47,13,29,42,38,51,89,8,2,10,18,33,28,13,22,98,97
2023,2,22300812,2/23/2024,1610612743,Denver Nuggets,0,1,1610612757,Portland Trail Blazers,1,0,37,15,52,13,20,33,50,35,85,14,8,22,14,26,38,11,13,94,127
2023,2,22300811,2/23/2024,1610612766,Charlotte Hornets,0,0,1610612744,Golden State Warriors,1,1,21,28,49,11,28,39,32,56,88,9,2,11,14,42,21,7,19,97,84
2023,2,22300812,2/23/2024,1610612757,Portland Trail Blazers,1,0,1610612743,Denver Nuggets,0,1,38,38,76,8,17,25,46,55,101,12,6,18,23,36,25,8,11,95,112
2023,2,22300808,2/23/2024,1610612750,Minnesota Timberwolves,1,0,1610612749,Milwaukee Bucks,0,1,30,33,63,13,22,35,43,55,98,8,5,13,20,38,23,10,14,97,107
2023,2,22300808,2/23/2024,1610612749,Milwaukee Bucks,0,1,1610612750,Minnesota Timberwolves,1,0,28,22,50,13,24,37,41,46,87,17,8,25,13,37,24,8,10,97,112
2023,2,22300813,2/23/2024,1610612747,Los Angeles Lakers,1,1,1610612759,San Antonio Spurs,0,0,38,30,68,11,16,27,49,46,95,14,4,18,14,34,28,9,13,101,123
2023,2,22300813,2/23/2024,1610612759,San Antonio Spurs,0,0,1610612747,Los Angeles Lakers,1,1,27,31,58,15,23,38,42,54,96,19,4,23,17,39,33,7,14,102,118
2023,2,22300282,12/2/2023,1610612751,Brooklyn Nets,1,1,1610612753,Orlando Magic,0,0,32,25,57,14,20,34,46,45,91,23,8,31,16,32,31,3,11,98,129
2023,2,22300283,12/2/2023,1610612739,Cleveland Cavaliers,0,1,1610612765,Detroit Pistons,1,0,34,25,59,10,20,30,44,45,89,12,6,18,10,39,25,9,11,99,110
2023,2,22300283,12/2/2023,1610612765,Detroit Pistons,1,0,1610612739,Cleveland Cavaliers,0,1,31,22,53,8,22,30,39,44,83,15,8,23,12,38,24,11,16,99,101
2023,2,22300281,12/2/2023,1610612766,Charlotte Hornets,1,0,1610612750,Minnesota Timberwolves,0,1,32,34,66,12,13,25,44,47,91,17,2,19,15,33,29,5,8,94,117
2023,2,22300286,12/2/2023,1610612749,Milwaukee Bucks,1,1,1610612737,Atlanta Hawks,0,0,39,17,56,14,19,33,53,36,89,12,3,15,9,29,33,11,16,102,132
2023,2,22300285,12/2/2023,1610612740,New Orleans Pelicans,0,0,1610612741,Chicago Bulls,1,1,33,24,57,8,17,25,41,41,82,28,7,35,15,31,20,6,12,95,118
2023,2,22300286,12/2/2023,1610612737,Atlanta Hawks,0,0,1610612749,Milwaukee Bucks,1,1,30,33,63,15,23,38,45,56,101,16,5,21,19,39,23,5,11,104,121
2023,2,22300284,12/2/2023,1610612754,Indiana Pacers,0,1,1610612748,Miami Heat,1,0,40,13,53,16,16,32,56,29,85,16,4,20,6,25,35,3,10,98,144
2023,2,22300284,12/2/2023,1610612748,Miami Heat,1,0,1610612754,Indiana Pacers,0,1,36,28,64,12,13,25,48,41,89,21,3,24,14,29,27,4,12,97,129
2023,2,22300288,12/2/2023,1610612756,Phoenix Suns,1,1,1610612763,Memphis Grizzlies,0,0,27,30,57,9,17,26,36,47,83,35,8,43,18,33,24,9,17,102,116
2023,2,22300287,12/2/2023,1610612760,Oklahoma City Thunder,0,1,1610612742,Dallas Mavericks,1,0,24,32,56,20,24,44,44,56,100,18,4,22,21,37,24,5,13,103,126
2023,2,22300288,12/2/2023,1610612763,Memphis Grizzlies,0,0,1610612756,Phoenix Suns,1,1,30,25,55,9,22,31,39,47,86,22,2,24,14,34,14,10,17,103,109
2023,2,22300289,12/2/2023,1610612762,Utah Jazz,1,1,1610612757,Portland Trail Blazers,0,0,39,21,60,7,27,34,46,48,94,19,5,24,20,31,27,11,18,105,118
2023,2,22300289,12/2/2023,1610612757,Portland Trail Blazers,0,0,1610612762,Utah Jazz,1,1,25,30,55,13,27,40,38,57,95,24,3,27,16,42,17,5,11,103,113
2023,2,22300290,12/2/2023,1610612758,Sacramento Kings,1,1,1610612743,Denver Nuggets,0,0,32,33,65,16,18,34,48,51,99,11,4,15,11,42,33,9,11,106,123
2023,2,22300290,12/2/2023,1610612743,Denver Nuggets,0,0,1610612758,Sacramento Kings,1,1,43,31,74,6,19,25,49,50,99,13,7,20,13,41,35,7,11,107,117
2023,2,22300291,12/2/2023,1610612745,Houston Rockets,0,0,1610612747,Los Angeles Lakers,1,1,25,33,58,11,20,31,36,53,89,14,4,18,14,40,24,11,17,100,97
2023,2,22300287,12/2/2023,1610612742,Dallas Mavericks,1,0,1610612760,Oklahoma City Thunder,0,1,20,15,35,19,33,52,39,48,87,23,12,35,18,37,26,8,16,103,120
2023,2,22300291,12/2/2023,1610612747,Los Angeles Lakers,1,1,1610612745,Houston Rockets,0,0,32,30,62,8,19,27,40,49,89,19,8,27,11,44,24,5,12,103,107
2023,2,22300285,12/2/2023,1610612741,Chicago Bulls,1,1,1610612740,New Orleans Pelicans,0,0,31,17,48,17,23,40,48,40,88,11,4,15,13,29,32,10,13,95,124
2023,2,22300279,12/1/2023,1610612743,Denver Nuggets,0,1,1610612756,Phoenix Suns,1,0,38,18,56,12,20,32,50,38,88,7,5,12,6,35,38,4,9,96,119
2023,2,22300282,12/2/2023,1610612753,Orlando Magic,0,0,1610612751,Brooklyn Nets,1,1,26,33,59,9,20,29,35,53,88,22,5,27,13,44,24,4,11,100,101
2023,2,22301202,12/4/2023,1610612754,Indiana Pacers,1,1,1610612738,Boston Celtics,0,0,24,30,54,19,21,40,43,51,94,17,4,21,8,45,28,5,6,101,122
2023,2,22301202,12/4/2023,1610612738,Boston Celtics,0,0,1610612754,Indiana Pacers,1,1,34,22,56,12,29,41,46,51,97,8,4,12,20,34,27,8,18,101,112
2023,2,22301204,12/4/2023,1610612740,New Orleans Pelicans,0,1,1610612758,Sacramento Kings,1,0,33,23,56,14,17,31,47,40,87,19,4,23,14,28,29,8,14,98,127
2023,2,22301204,12/4/2023,1610612758,Sacramento Kings,1,0,1610612740,New Orleans Pelicans,0,1,24,20,44,14,27,41,38,47,85,27,6,33,17,31,29,12,14,98,117
2010,4,41000406,6/12/2011,1610612742,Dallas Mavericks,0,1,1610612748,Miami Heat,1,0,30,26,56,11,15,26,41,41,82,12,6,18,13,31,19,7,14,93,105
2010,4,41000406,6/12/2011,1610612748,Miami Heat,1,0,1610612742,Dallas Mavericks,0,1,27,22,49,7,16,23,34,38,72,20,13,33,13,31,20,11,17,92,95
2010,4,41000405,6/9/2011,1610612742,Dallas Mavericks,1,1,1610612748,Miami Heat,0,0,26,24,50,13,6,19,39,30,69,21,6,27,6,27,23,5,11,87,112
2010,4,41000405,6/9/2011,1610612748,Miami Heat,0,0,1610612742,Dallas Mavericks,1,1,29,21,50,8,12,20,37,33,70,21,5,26,13,23,25,8,18,88,103
2005,4,40500171,4/23/2006,1610612742,Dallas Mavericks,1,1,1610612763,Memphis Grizzlies,0,0,29,32,61,5,8,13,34,40,74,30,5,35,19,23,17,8,14,86,103
2010,4,41000404,6/7/2011,1610612742,Dallas Mavericks,1,1,1610612748,Miami Heat,0,0,25,29,54,4,15,19,29,44,73,24,6,30,16,30,13,8,11,83,86
2010,4,41000404,6/7/2011,1610612748,Miami Heat,0,0,1610612742,Dallas Mavericks,1,1,30,31,61,2,12,14,32,43,75,17,7,24,19,29,19,7,15,84,83
2010,4,41000403,6/5/2011,1610612742,Dallas Mavericks,1,0,1610612748,Miami Heat,0,1,20,29,49,8,13,21,28,42,70,22,5,27,13,31,18,8,14,85,86
2010,4,41000403,6/5/2011,1610612748,Miami Heat,0,1,1610612742,Dallas Mavericks,1,0,26,33,59,8,11,19,34,44,78,12,3,15,14,31,20,3,13,85,88
2005,4,40500171,4/23/2006,1610612763,Memphis Grizzlies,0,0,1610612742,Dallas Mavericks,1,1,27,21,48,6,8,14,33,29,62,21,8,29,10,26,16,12,19,86,93
2011,4,41100405,6/21/2012,1610612748,Miami Heat,1,1,1610612760,Oklahoma City Thunder,0,0,26,25,51,14,12,26,40,37,77,27,6,33,10,29,25,7,14,96,121
2011,4,41100405,6/21/2012,1610612760,Oklahoma City Thunder,0,0,1610612748,Miami Heat,1,1,25,34,59,11,17,28,36,51,87,23,3,26,18,34,19,8,13,96,106
2011,4,41100404,6/19/2012,1610612748,Miami Heat,1,1,1610612760,Oklahoma City Thunder,0,0,28,25,53,10,16,26,38,41,79,18,7,25,12,32,19,6,10,90,104
2011,4,41100404,6/19/2012,1610612760,Oklahoma City Thunder,0,0,1610612748,Miami Heat,1,1,37,29,66,3,13,16,40,42,82,15,1,16,11,32,13,8,11,90,98
2010,4,41000402,6/2/2011,1610612742,Dallas Mavericks,0,1,1610612748,Miami Heat,1,0,30,28,58,6,11,17,36,39,75,17,4,21,17,25,18,15,20,88,95
2010,4,41000402,6/2/2011,1610612748,Miami Heat,1,0,1610612742,Dallas Mavericks,0,1,25,18,43,9,21,30,34,39,73,16,8,24,10,33,13,8,12,90,93
2011,4,41100403,6/17/2012,1610612748,Miami Heat,1,1,1610612760,Oklahoma City Thunder,0,0,24,37,61,4,9,13,28,46,74,31,4,35,16,31,13,9,15,89,91
2011,4,41100403,6/17/2012,1610612760,Oklahoma City Thunder,0,0,1610612748,Miami Heat,1,1,29,30,59,4,14,18,33,44,77,15,9,24,15,33,11,6,14,89,85
2010,4,41000401,5/31/2011,1610612742,Dallas Mavericks,0,0,1610612748,Miami Heat,1,1,16,29,45,9,13,22,25,42,67,25,7,32,10,35,18,5,11,83,84
2010,4,41000401,5/31/2011,1610612748,Miami Heat,1,1,1610612742,Dallas Mavericks,0,0,20,36,56,11,13,24,31,49,80,19,7,26,21,32,20,6,12,84,92
2011,4,41100402,6/14/2012,1610612748,Miami Heat,0,1,1610612760,Oklahoma City Thunder,1,0,30,32,62,6,8,14,36,40,76,22,3,25,15,27,13,9,14,88,100
2011,4,41100402,6/14/2012,1610612760,Oklahoma City Thunder,1,0,1610612748,Miami Heat,0,1,25,28,53,9,17,26,34,45,79,19,7,26,14,33,14,5,11,88,96
2010,4,41000315,5/25/2011,1610612742,Dallas Mavericks,1,1,1610612760,Oklahoma City Thunder,0,0,27,31,58,5,15,20,32,46,78,31,5,36,16,34,19,7,12,91,100
2010,4,41000315,5/25/2011,1610612760,Oklahoma City Thunder,0,0,1610612742,Dallas Mavericks,1,1,30,36,66,5,11,16,35,47,82,21,4,25,15,33,16,8,13,92,96
2011,4,41100401,6/12/2012,1610612748,Miami Heat,0,0,1610612760,Oklahoma City Thunder,1,1,28,31,59,8,11,19,36,42,78,14,4,18,8,37,20,5,11,89,94
2011,4,41100401,6/12/2012,1610612760,Oklahoma City Thunder,1,1,1610612748,Miami Heat,0,0,35,25,60,5,12,17,40,37,77,20,7,27,11,29,22,6,10,88,105
2010,4,41000314,5/23/2011,1610612742,Dallas Mavericks,0,1,1610612760,Oklahoma City Thunder,1,0,27,29,56,8,17,25,35,46,81,34,5,39,10,37,16,9,13,104,112
2010,4,41000314,5/23/2011,1610612760,Oklahoma City Thunder,1,0,1610612742,Dallas Mavericks,0,1,40,37,77,2,11,13,42,48,90,19,6,25,23,31,23,15,26,105,105
2011,4,41100316,6/6/2012,1610612759,San Antonio Spurs,0,0,1610612760,Oklahoma City Thunder,1,1,26,32,58,11,15,26,37,47,84,14,4,18,11,38,20,6,12,92,99
2011,4,41100316,6/6/2012,1610612760,Oklahoma City Thunder,1,1,1610612759,San Antonio Spurs,0,0,26,28,54,10,8,18,36,36,72,25,6,31,9,30,18,9,15,93,107
2010,4,41000313,5/21/2011,1610612742,Dallas Mavericks,0,1,1610612760,Oklahoma City Thunder,1,0,29,32,61,7,14,21,36,46,82,14,4,18,12,37,21,8,11,91,93
2010,4,41000313,5/21/2011,1610612760,Oklahoma City Thunder,1,0,1610612742,Dallas Mavericks,0,1,26,31,57,1,16,17,27,47,74,32,4,36,16,32,11,11,15,90,87
2005,4,40500151,4/23/2006,1610612747,Los Angeles Lakers,0,0,1610612756,Phoenix Suns,1,1,33,36,69,5,16,21,38,52,90,21,6,27,22,33,13,6,11,94,102
2005,4,40500151,4/23/2006,1610612756,Phoenix Suns,1,1,1610612747,Los Angeles Lakers,0,0,24,29,53,9,11,20,33,40,73,32,3,35,6,35,19,4,10,94,107
2011,4,41100315,6/4/2012,1610612759,San Antonio Spurs,1,0,1610612760,Oklahoma City Thunder,0,1,25,25,50,9,15,24,34,40,74,26,5,31,12,31,23,12,21,97,103
2011,4,41100315,6/4/2012,1610612760,Oklahoma City Thunder,0,1,1610612759,San Antonio Spurs,1,0,32,27,59,8,13,21,40,40,80,20,3,23,9,34,22,8,17,99,108
2010,4,41000312,5/19/2011,1610612742,Dallas Mavericks,1,0,1610612760,Oklahoma City Thunder,0,1,26,27,53,9,18,27,35,45,80,21,3,24,18,29,18,5,12,88,100
2010,4,41000312,5/19/2011,1610612760,Oklahoma City Thunder,0,1,1610612742,Dallas Mavericks,1,0,32,20,52,7,11,18,39,31,70,21,5,26,10,24,17,7,15,87,106
2011,4,41100314,6/2/2012,1610612759,San Antonio Spurs,0,0,1610612760,Oklahoma City Thunder,1,1,30,29,59,11,12,23,41,41,82,10,6,16,8,36,17,5,10,91,103
2011,4,41100314,6/2/2012,1610612760,Oklahoma City Thunder,1,1,1610612759,San Antonio Spurs,0,0,39,26,65,5,8,13,44,34,78,16,5,21,9,28,27,5,13,91,109
2011,4,41100313,5/31/2012,1610612759,San Antonio Spurs,0,0,1610612760,Oklahoma City Thunder,1,1,19,31,50,11,15,26,30,46,76,11,4,15,13,35,18,14,21,89,82
2011,4,41100313,5/31/2012,1610612760,Oklahoma City Thunder,1,1,1610612759,San Antonio Spurs,0,0,34,32,66,6,16,22,40,48,88,16,1,17,15,33,23,2,8,89,102
2010,4,41000311,5/17/2011,1610612742,Dallas Mavericks,1,1,1610612760,Oklahoma City Thunder,0,0,30,20,50,9,14,23,39,34,73,34,2,36,12,24,22,7,13,91,121
2010,4,41000311,5/17/2011,1610612760,Oklahoma City Thunder,0,0,1610612742,Dallas Mavericks,1,1,27,29,56,7,9,16,34,38,72,37,6,43,14,26,19,7,13,91,112
2010,4,41000305,5/26/2011,1610612741,Chicago Bulls,1,0,1610612748,Miami Heat,0,1,22,37,59,7,15,22,29,52,81,15,6,21,15,41,18,7,10,88,80
2010,4,41000305,5/26/2011,1610612748,Miami Heat,0,1,1610612741,Chicago Bulls,1,0,20,31,51,6,9,15,26,40,66,25,8,33,9,37,12,8,17,87,83
2011,4,41100312,5/29/2012,1610612759,San Antonio Spurs,1,1,1610612760,Oklahoma City Thunder,0,0,32,20,52,11,15,26,43,35,78,23,12,35,14,27,27,10,14,97,120
2011,4,41100312,5/29/2012,1610612760,Oklahoma City Thunder,0,0,1610612759,San Antonio Spurs,1,1,29,42,71,8,9,17,37,51,88,29,7,36,19,37,19,3,10,96,111
2011,4,41100311,5/27/2012,1610612759,San Antonio Spurs,1,1,1610612760,Oklahoma City Thunder,0,0,30,29,59,8,16,24,38,45,83,17,8,25,14,36,22,11,17,98,101
2011,4,41100311,5/27/2012,1610612760,Oklahoma City Thunder,0,0,1610612759,San Antonio Spurs,1,1,26,34,60,9,14,23,35,48,83,19,4,23,10,40,18,5,13,98,98
2010,4,41000304,5/24/2011,1610612741,Chicago Bulls,0,0,1610612748,Miami Heat,1,1,29,34,63,6,18,24,35,52,87,17,5,22,21,34,20,12,22,99,93
2010,4,41000304,5/24/2011,1610612748,Miami Heat,1,1,1610612741,Chicago Bulls,0,0,27,35,62,5,8,13,32,43,75,32,6,38,11,34,12,8,16,98,101
2011,4,41100307,6/9/2012,1610612738,Boston Celtics,0,0,1610612748,Miami Heat,1,1,29,27,56,6,13,19,35,40,75,12,3,15,11,31,19,8,13,85,88
2011,4,41100307,6/9/2012,1610612748,Miami Heat,1,1,1610612738,Boston Celtics,0,0,27,17,44,9,17,26,36,34,70,20,7,27,12,27,16,10,13,86,101
2010,4,41000303,5/22/2011,1610612741,Chicago Bulls,0,0,1610612748,Miami Heat,1,1,27,38,65,5,7,12,32,45,77,16,5,21,16,31,15,6,13,85,85
2010,4,41000303,5/22/2011,1610612748,Miami Heat,1,1,1610612741,Chicago Bulls,0,0,31,27,58,3,6,9,34,33,67,25,4,29,6,30,20,5,10,84,96
2011,4,41100306,6/7/2012,1610612738,Boston Celtics,1,0,1610612748,Miami Heat,0,1,31,30,61,1,13,14,32,43,75,14,6,20,10,35,14,8,13,87,79
2011,4,41100306,6/7/2012,1610612748,Miami Heat,0,1,1610612738,Boston Celtics,1,0,30,30,60,7,9,16,37,39,76,17,5,22,12,29,15,9,12,87,98
2010,4,41000302,5/18/2011,1610612741,Chicago Bulls,1,0,1610612748,Miami Heat,0,1,25,37,62,3,17,20,28,54,82,16,10,26,20,39,15,7,10,84,75
2010,4,41000302,5/18/2011,1610612748,Miami Heat,0,1,1610612741,Chicago Bulls,1,0,29,26,55,3,10,13,32,36,68,18,6,24,12,26,18,6,15,83,85
2011,4,41100305,6/5/2012,1610612738,Boston Celtics,0,1,1610612748,Miami Heat,1,0,27,39,66,6,9,15,33,48,81,22,5,27,12,39,19,6,13,94,94
2011,4,41100305,6/5/2012,1610612748,Miami Heat,1,0,1610612738,Boston Celtics,0,1,25,31,56,7,19,26,32,50,82,19,6,25,15,35,13,13,15,94,90
2010,4,41000301,5/15/2011,1610612741,Chicago Bulls,1,1,1610612748,Miami Heat,0,0,28,38,66,10,11,21,38,49,87,17,3,20,23,28,23,7,10,83,103
2010,4,41000301,5/15/2011,1610612748,Miami Heat,0,0,1610612741,Chicago Bulls,1,1,29,31,60,3,5,8,32,36,68,15,0,15,8,28,11,11,16,83,82
2011,4,41100304,6/3/2012,1610612738,Boston Celtics,1,1,1610612748,Miami Heat,0,0,26,32,58,9,18,27,35,50,85,14,6,20,15,36,22,6,15,94,93
2011,4,41100304,6/3/2012,1610612748,Miami Heat,0,0,1610612738,Boston Celtics,1,1,28,33,61,6,13,19,34,46,80,17,7,24,15,33,20,6,17,96,91
2011,4,41100303,6/1/2012,1610612738,Boston Celtics,1,1,1610612748,Miami Heat,0,0,33,26,59,5,12,17,38,38,76,20,6,26,16,27,16,5,12,87,101
2011,4,41100303,6/1/2012,1610612748,Miami Heat,0,0,1610612738,Boston Celtics,1,1,33,27,60,5,12,17,38,39,77,10,10,20,10,33,20,4,11,86,91
2010,4,41000234,5/8/2011,1610612742,Dallas Mavericks,1,1,1610612747,Los Angeles Lakers,0,0,24,17,41,20,12,32,44,29,73,14,5,19,8,24,32,11,20,92,122
2010,4,41000234,5/8/2011,1610612747,Los Angeles Lakers,0,0,1610612742,Dallas Mavericks,1,1,26,32,58,5,19,24,31,51,82,19,7,26,18,38,16,11,16,93,86
2010,4,41000233,5/6/2011,1610612742,Dallas Mavericks,1,1,1610612747,Los Angeles Lakers,0,0,19,19,38,12,17,29,31,36,67,24,5,29,12,27,22,6,14,84,98
2010,4,41000233,5/6/2011,1610612747,Los Angeles Lakers,0,0,1610612742,Dallas Mavericks,1,1,36,33,69,3,10,13,39,43,82,11,3,14,14,32,19,4,11,84,92
2011,4,41100302,5/30/2012,1610612738,Boston Celtics,0,0,1610612748,Miami Heat,1,1,35,30,65,5,11,16,40,41,81,26,3,29,10,32,15,7,8,95,111
2011,4,41100302,5/30/2012,1610612748,Miami Heat,1,1,1610612738,Boston Celtics,0,0,27,30,57,10,16,26,37,46,83,31,16,47,17,36,24,5,8,94,115
2010,4,41000232,5/4/2011,1610612742,Dallas Mavericks,0,1,1610612747,Los Angeles Lakers,1,0,26,30,56,8,17,25,34,47,81,17,4,21,16,33,20,8,11,87,93
2010,4,41000232,5/4/2011,1610612747,Los Angeles Lakers,1,0,1610612742,Dallas Mavericks,0,1,32,31,63,2,18,20,34,49,83,11,9,20,18,35,18,4,10,86,81
2011,4,41100301,5/28/2012,1610612738,Boston Celtics,0,0,1610612748,Miami Heat,1,1,28,39,67,4,10,14,32,49,81,11,10,21,17,36,19,4,9,83,79
2011,4,41100301,5/28/2012,1610612748,Miami Heat,1,1,1610612738,Boston Celtics,0,0,31,16,47,5,20,25,36,36,72,16,7,23,14,25,17,6,14,83,93
2010,4,41000231,5/2/2011,1610612742,Dallas Mavericks,0,1,1610612747,Los Angeles Lakers,1,0,30,29,59,9,11,20,39,40,79,9,2,11,5,35,30,9,11,89,96
2010,4,41000231,5/2/2011,1610612747,Los Angeles Lakers,1,0,1610612742,Dallas Mavericks,0,1,31,34,65,5,14,19,36,48,84,17,3,20,13,36,21,8,11,91,94
2010,4,41000227,5/15/2011,1610612760,Oklahoma City Thunder,1,1,1610612763,Memphis Grizzlies,0,0,26,23,49,11,17,28,37,40,77,20,3,23,17,24,25,6,13,86,105
2010,4,41000227,5/15/2011,1610612763,Memphis Grizzlies,0,0,1610612760,Oklahoma City Thunder,1,1,30,43,73,5,10,15,35,53,88,15,4,19,23,32,13,7,10,85,90
2011,4,41100235,5/21/2012,1610612747,Los Angeles Lakers,0,0,1610612760,Oklahoma City Thunder,1,1,32,32,64,2,9,11,34,41,75,20,6,26,3,41,12,7,12,95,90
2011,4,41100235,5/21/2012,1610612760,Oklahoma City Thunder,1,1,1610612747,Los Angeles Lakers,0,0,39,38,77,3,10,13,42,48,90,19,6,25,17,33,20,6,12,95,106
2011,4,41100234,5/19/2012,1610612747,Los Angeles Lakers,1,0,1610612760,Oklahoma City Thunder,0,1,32,36,68,5,13,18,37,49,86,21,8,29,22,32,19,6,9,87,100
2011,4,41100234,5/19/2012,1610612760,Oklahoma City Thunder,0,1,1610612747,Los Angeles Lakers,1,0,32,29,61,6,10,16,38,39,77,21,4,25,11,30,16,5,7,86,103
2010,4,41000226,5/13/2011,1610612760,Oklahoma City Thunder,0,0,1610612763,Memphis Grizzlies,1,1,27,22,49,4,21,25,31,43,74,17,7,24,9,38,15,10,16,92,83
2010,4,41000226,5/13/2011,1610612763,Memphis Grizzlies,1,1,1610612760,Oklahoma City Thunder,0,0,31,36,67,5,11,16,36,47,83,18,4,22,13,36,20,4,11,93,95
2005,4,40500121,4/23/2006,1610612751,Brooklyn Nets,1,0,1610612754,Indiana Pacers,0,1,33,32,65,1,14,15,34,46,80,19,7,26,13,38,24,3,6,85,88
2005,4,40500121,4/23/2006,1610612754,Indiana Pacers,0,1,1610612751,Brooklyn Nets,1,0,25,27,52,5,7,12,30,34,64,25,5,30,12,24,19,7,19,85,90
2011,4,41100233,5/18/2012,1610612747,Los Angeles Lakers,1,1,1610612760,Oklahoma City Thunder,0,0,23,36,59,4,7,11,27,43,70,41,1,42,15,28,20,11,15,90,99
2011,4,41100233,5/18/2012,1610612760,Oklahoma City Thunder,0,0,1610612747,Los Angeles Lakers,1,1,29,37,66,4,13,17,33,50,83,26,2,28,15,35,13,7,9,91,96
2010,4,41000225,5/11/2011,1610612760,Oklahoma City Thunder,1,1,1610612763,Memphis Grizzlies,0,0,28,30,58,9,11,20,37,41,78,16,5,21,17,27,22,8,18,90,99
2010,4,41000225,5/11/2011,1610612763,Memphis Grizzlies,0,0,1610612760,Oklahoma City Thunder,1,1,26,44,70,2,6,8,28,50,78,14,9,23,16,37,15,7,15,91,72
2011,4,41100232,5/16/2012,1610612747,Los Angeles Lakers,0,0,1610612760,Oklahoma City Thunder,1,1,28,35,63,2,13,15,30,48,78,13,1,14,17,32,11,7,15,82,75
2011,4,41100232,5/16/2012,1610612760,Oklahoma City Thunder,1,1,1610612747,Los Angeles Lakers,0,0,23,29,52,6,11,17,29,40,69,13,3,16,8,34,15,9,13,83,77
2005,4,40500101,4/23/2006,1610612749,Milwaukee Bucks,0,0,1610612765,Detroit Pistons,1,1,27,47,74,4,9,13,31,56,87,8,2,10,15,42,14,7,12,88,74
2010,4,41000224,5/9/2011,1610612760,Oklahoma City Thunder,0,1,1610612763,Memphis Grizzlies,1,0,38,33,71,5,21,26,43,54,97,42,8,50,23,36,16,8,18,118,133
2010,4,41000224,5/9/2011,1610612763,Memphis Grizzlies,1,0,1610612760,Oklahoma City Thunder,0,1,34,54,88,6,15,21,40,69,109,37,3,40,31,38,24,9,19,115,123
2011,4,41100231,5/14/2012,1610612747,Los Angeles Lakers,0,0,1610612760,Oklahoma City Thunder,1,1,28,37,65,7,9,16,35,46,81,13,2,15,15,31,14,13,15,88,90
2011,4,41100231,5/14/2012,1610612760,Oklahoma City Thunder,1,1,1610612747,Los Angeles Lakers,0,0,37,29,66,7,10,17,44,39,83,24,5,29,11,31,20,1,4,90,119
2010,4,41000223,5/7/2011,1610612760,Oklahoma City Thunder,0,0,1610612763,Memphis Grizzlies,1,1,30,42,72,4,17,21,34,59,93,21,2,23,21,38,19,9,14,96,93
2010,4,41000223,5/7/2011,1610612763,Memphis Grizzlies,1,1,1610612760,Oklahoma City Thunder,0,0,31,49,80,3,7,10,34,56,90,30,14,44,24,38,17,6,9,99,101
2011,4,41100224,5/20/2012,1610612746,LA Clippers,1,0,1610612759,San Antonio Spurs,0,1,37,33,70,4,12,16,41,45,86,13,6,19,14,33,22,4,9,89,99
2011,4,41100224,5/20/2012,1610612759,San Antonio Spurs,0,1,1610612746,LA Clippers,1,0,32,25,57,6,9,15,38,34,72,20,7,27,11,26,28,10,16,89,102
2010,4,41000222,5/3/2011,1610612760,Oklahoma City Thunder,1,1,1610612763,Memphis Grizzlies,0,0,30,28,58,8,6,14,38,34,72,27,6,33,11,26,17,8,16,94,111
2010,4,41000222,5/3/2011,1610612763,Memphis Grizzlies,0,0,1610612760,Oklahoma City Thunder,1,1,31,37,68,4,7,11,35,44,79,28,6,34,17,29,19,11,16,92,102
2011,4,41100223,5/19/2012,1610612746,LA Clippers,1,0,1610612759,San Antonio Spurs,0,1,34,37,71,3,6,9,37,43,80,9,9,18,10,37,22,5,13,92,86
2011,4,41100223,5/19/2012,1610612759,San Antonio Spurs,0,1,1610612746,LA Clippers,1,0,26,28,54,9,13,22,35,41,76,17,8,25,8,39,27,11,13,94,96
2011,4,41100222,5/17/2012,1610612746,LA Clippers,0,0,1610612759,San Antonio Spurs,1,1,22,28,50,9,4,13,31,32,63,17,6,23,6,31,13,12,18,86,88
2011,4,41100222,5/17/2012,1610612759,San Antonio Spurs,1,1,1610612746,LA Clippers,0,0,32,22,54,10,15,25,42,37,79,11,6,17,11,29,23,7,11,87,105
2010,4,41000221,5/1/2011,1610612760,Oklahoma City Thunder,1,0,1610612763,Memphis Grizzlies,0,1,29,35,64,6,8,14,35,43,78,25,7,32,18,31,16,11,18,92,101
2010,4,41000221,5/1/2011,1610612763,Memphis Grizzlies,0,1,1610612760,Oklahoma City Thunder,1,0,41,40,81,3,5,8,44,45,89,23,5,28,19,28,21,6,8,92,114
2011,4,41100221,5/15/2012,1610612746,LA Clippers,0,0,1610612759,San Antonio Spurs,1,1,28,36,64,9,10,19,37,46,83,9,4,13,10,37,19,9,16,96,92
2011,4,41100221,5/15/2012,1610612759,San Antonio Spurs,1,1,1610612746,LA Clippers,0,0,26,29,55,13,12,25,39,41,80,17,4,21,13,29,29,11,18,96,108
2010,4,41000215,5/11/2011,1610612738,Boston Celtics,0,0,1610612748,Miami Heat,1,1,26,26,52,7,8,15,33,34,67,14,6,20,6,31,15,7,17,88,87
2010,4,41000215,5/11/2011,1610612748,Miami Heat,1,1,1610612738,Boston Celtics,0,0,25,25,50,7,12,19,32,37,69,26,12,38,14,27,13,5,13,86,97
2011,4,41100217,5/26/2012,1610612738,Boston Celtics,1,1,1610612755,Philadelphia 76ers,0,0,28,28,56,3,14,17,31,42,73,20,2,22,8,35,17,9,15,91,85
2011,4,41100217,5/26/2012,1610612755,Philadelphia 76ers,0,0,1610612738,Boston Celtics,1,1,23,39,62,5,13,18,28,52,80,14,6,20,14,43,15,10,15,90,75
2010,4,41000214,5/9/2011,1610612738,Boston Celtics,1,0,1610612748,Miami Heat,0,1,25,29,54,5,11,16,30,40,70,25,4,29,6,36,15,9,17,96,90
2010,4,41000214,5/9/2011,1610612748,Miami Heat,0,1,1610612738,Boston Celtics,1,0,32,34,66,3,10,13,35,44,79,25,3,28,14,31,10,10,18,96,98
2011,4,41100216,5/23/2012,1610612738,Boston Celtics,0,0,1610612755,Philadelphia 76ers,1,1,23,41,64,3,11,14,26,52,78,20,3,23,18,35,14,7,17,87,75
2011,4,41100216,5/23/2012,1610612755,Philadelphia 76ers,1,1,1610612738,Boston Celtics,0,0,31,30,61,1,8,9,32,38,70,17,11,28,9,34,22,5,12,88,82
2010,4,41000213,5/7/2011,1610612738,Boston Celtics,1,1,1610612748,Miami Heat,0,0,28,28,56,9,9,18,37,37,74,14,3,17,13,26,27,9,13,83,97
2010,4,41000213,5/7/2011,1610612748,Miami Heat,0,0,1610612738,Boston Celtics,1,1,26,24,50,5,18,23,31,42,73,14,5,19,15,30,20,7,15,82,81
2011,4,41100215,5/21/2012,1610612738,Boston Celtics,1,1,1610612755,Philadelphia 76ers,0,0,33,21,54,3,12,15,36,33,69,26,7,33,11,25,22,7,12,85,101
2011,4,41100215,5/21/2012,1610612755,Philadelphia 76ers,0,0,1610612738,Boston Celtics,1,1,33,35,68,3,6,9,36,41,77,10,6,16,16,26,20,11,15,87,85
2010,4,41000212,5/3/2011,1610612738,Boston Celtics,0,0,1610612748,Miami Heat,1,1,28,40,68,6,5,11,34,45,79,17,5,22,14,33,18,6,12,87,91
2010,4,41000212,5/3/2011,1610612748,Miami Heat,1,1,1610612738,Boston Celtics,0,0,27,32,59,7,9,16,34,41,75,27,9,36,13,32,15,7,10,87,102
2011,4,41100214,5/18/2012,1610612738,Boston Celtics,0,0,1610612755,Philadelphia 76ers,1,1,23,25,48,7,16,23,30,41,71,16,3,19,7,35,23,9,17,90,83
2011,4,41100214,5/18/2012,1610612755,Philadelphia 76ers,1,1,1610612738,Boston Celtics,0,0,26,45,71,5,6,11,31,51,82,25,11,36,21,35,18,7,11,89,92
2010,4,41000211,5/1/2011,1610612738,Boston Celtics,0,0,1610612748,Miami Heat,1,1,20,31,51,12,12,24,32,43,75,14,4,18,8,37,18,7,14,90,90
2010,4,41000211,5/1/2011,1610612748,Miami Heat,1,1,1610612738,Boston Celtics,0,0,23,26,49,9,10,19,32,36,68,26,6,32,8,32,17,7,18,90,99
2011,4,41100213,5/16/2012,1610612738,Boston Celtics,0,1,1610612755,Philadelphia 76ers,1,0,35,31,66,5,6,11,40,37,77,22,6,28,11,28,26,3,7,88,107
2011,4,41100213,5/16/2012,1610612755,Philadelphia 76ers,1,0,1610612738,Boston Celtics,0,1,25,41,66,8,7,15,33,48,81,17,5,22,12,40,22,6,9,87,91
2010,4,41000206,5/12/2011,1610612737,Atlanta Hawks,1,0,1610612741,Chicago Bulls,0,1,26,37,63,1,10,11,27,47,74,18,7,25,16,33,14,7,13,84,73
2010,4,41000206,5/12/2011,1610612741,Chicago Bulls,0,1,1610612737,Atlanta Hawks,1,0,38,26,64,3,10,13,41,36,77,8,2,10,8,29,34,8,11,85,93
2011,4,41100212,5/14/2012,1610612738,Boston Celtics,1,0,1610612755,Philadelphia 76ers,0,1,25,36,61,8,10,18,33,46,79,7,2,9,11,37,23,10,19,92,81
2011,4,41100212,5/14/2012,1610612755,Philadelphia 76ers,0,1,1610612738,Boston Celtics,1,0,26,36,62,5,9,14,31,45,76,15,6,21,14,33,17,11,18,91,82
2010,4,41000205,5/10/2011,1610612737,Atlanta Hawks,0,0,1610612741,Chicago Bulls,1,1,33,26,59,1,11,12,34,37,71,14,3,17,10,28,20,5,11,80,83
2010,4,41000205,5/10/2011,1610612741,Chicago Bulls,1,1,1610612737,Atlanta Hawks,0,0,31,27,58,4,10,14,35,37,72,21,7,28,14,27,21,2,11,81,95
2011,4,41100211,5/12/2012,1610612738,Boston Celtics,1,1,1610612755,Philadelphia 76ers,0,0,34,30,64,2,16,18,36,46,82,18,1,19,12,34,28,9,13,94,92
2011,4,41100211,5/12/2012,1610612755,Philadelphia 76ers,0,0,1610612738,Boston Celtics,1,1,31,37,68,5,9,14,36,46,82,14,6,20,11,37,19,7,11,93,91
2010,4,41000204,5/8/2011,1610612737,Atlanta Hawks,1,1,1610612741,Chicago Bulls,0,0,36,34,70,4,7,11,40,41,81,16,4,20,14,28,23,6,13,90,100
2010,4,41000204,5/8/2011,1610612741,Chicago Bulls,0,0,1610612737,Atlanta Hawks,1,1,29,33,62,3,13,16,32,46,78,21,6,27,15,32,19,5,13,88,88
2011,4,41100206,5/24/2012,1610612748,Miami Heat,0,1,1610612754,Indiana Pacers,1,0,34,22,56,7,13,20,41,35,76,16,4,20,8,28,16,3,10,87,105
2011,4,41100206,5/24/2012,1610612754,Indiana Pacers,1,0,1610612748,Miami Heat,0,1,28,25,53,6,11,17,34,36,70,19,5,24,16,22,18,9,22,86,93
2010,4,41000203,5/6/2011,1610612737,Atlanta Hawks,1,0,1610612741,Chicago Bulls,0,1,32,32,64,1,5,6,33,37,70,15,10,25,12,30,18,7,12,81,82
2010,4,41000203,5/6/2011,1610612741,Chicago Bulls,0,1,1610612737,Atlanta Hawks,1,0,27,32,59,10,10,20,37,42,79,15,3,18,19,26,18,4,12,82,99
2011,4,41100205,5/22/2012,1610612748,Miami Heat,1,1,1610612754,Indiana Pacers,0,0,34,20,54,9,7,16,43,27,70,20,9,29,9,23,20,8,13,87,115
2011,4,41100205,5/22/2012,1610612754,Indiana Pacers,0,0,1610612748,Miami Heat,1,1,24,44,68,6,15,21,30,59,89,17,6,23,21,42,15,5,10,86,83
2010,4,41000202,5/4/2011,1610612737,Atlanta Hawks,0,0,1610612741,Chicago Bulls,1,1,23,41,64,3,10,13,26,51,77,18,6,24,12,44,14,6,12,87,73
2010,4,41000202,5/4/2011,1610612741,Chicago Bulls,1,1,1610612737,Atlanta Hawks,0,0,28,34,62,5,17,22,33,51,84,15,3,18,21,31,19,10,14,88,86
2011,4,41100204,5/20/2012,1610612748,Miami Heat,0,1,1610612754,Indiana Pacers,1,0,33,35,68,5,7,12,38,42,80,20,8,28,16,30,20,7,15,93,101
2011,4,41100204,5/20/2012,1610612754,Indiana Pacers,1,0,1610612748,Miami Heat,0,1,26,31,57,7,15,22,33,46,79,20,4,24,12,35,17,8,15,93,93
2010,4,41000201,5/2/2011,1610612737,Atlanta Hawks,0,1,1610612741,Chicago Bulls,1,0,33,32,65,7,6,13,40,38,78,16,4,20,10,29,20,7,10,88,103
2010,4,41000201,5/2/2011,1610612741,Chicago Bulls,1,0,1610612737,Atlanta Hawks,0,1,29,36,65,8,10,18,37,46,83,13,3,16,15,32,21,8,11,87,95
2005,4,40500101,4/23/2006,1610612765,Detroit Pistons,1,1,1610612749,Milwaukee Bucks,0,0,25,32,57,6,12,18,31,44,75,24,10,34,14,36,17,6,11,88,92
2011,4,41100203,5/17/2012,1610612748,Miami Heat,0,0,1610612754,Indiana Pacers,1,1,25,33,58,4,16,20,29,49,78,13,5,18,13,39,9,6,14,87,75
2011,4,41100203,5/17/2012,1610612754,Indiana Pacers,1,1,1610612748,Miami Heat,0,0,25,37,62,8,6,14,33,43,76,20,3,23,16,27,20,5,14,86,94
2010,4,41000175,4/27/2011,1610612743,Denver Nuggets,0,0,1610612760,Oklahoma City Thunder,1,1,28,32,60,8,10,18,36,42,78,17,4,21,8,37,16,10,18,97,97
2010,4,41000175,4/27/2011,1610612760,Oklahoma City Thunder,1,1,1610612743,Denver Nuggets,0,0,24,34,58,6,18,24,30,52,82,34,8,42,20,37,16,8,14,98,100
2011,4,41100202,5/15/2012,1610612748,Miami Heat,1,0,1610612754,Indiana Pacers,0,1,26,36,62,1,15,16,27,51,78,20,9,29,18,38,11,8,12,87,75
2011,4,41100202,5/15/2012,1610612754,Indiana Pacers,0,1,1610612748,Miami Heat,1,0,25,34,59,3,12,15,28,46,74,19,8,27,19,31,10,10,20,87,78
2010,4,41000174,4/25/2011,1610612743,Denver Nuggets,1,1,1610612760,Oklahoma City Thunder,0,0,23,41,64,9,10,19,32,51,83,31,13,44,17,40,19,5,8,95,104
2010,4,41000174,4/25/2011,1610612760,Oklahoma City Thunder,0,0,1610612743,Denver Nuggets,1,1,28,32,60,7,12,19,35,44,79,24,7,31,15,32,17,5,15,94,101
2011,4,41100201,5/13/2012,1610612748,Miami Heat,1,1,1610612754,Indiana Pacers,0,0,33,42,75,0,6,6,33,48,81,29,9,38,20,32,16,7,13,94,95
2011,4,41100201,5/13/2012,1610612754,Indiana Pacers,0,0,1610612748,Miami Heat,1,1,27,33,60,4,13,17,31,46,77,20,8,28,13,35,18,8,15,93,86
2010,4,41000173,4/23/2011,1610612743,Denver Nuggets,1,0,1610612760,Oklahoma City Thunder,0,1,23,32,55,6,17,23,29,49,78,30,15,45,15,41,18,5,13,97,94
2010,4,41000173,4/23/2011,1610612760,Oklahoma City Thunder,0,1,1610612743,Denver Nuggets,1,0,23,36,59,6,15,21,29,51,80,33,10,43,16,39,17,4,11,96,97
2011,4,41100177,5/13/2012,1610612746,LA Clippers,0,1,1610612763,Memphis Grizzlies,1,0,26,35,61,4,13,17,30,48,78,18,5,23,17,34,12,11,17,91,82
2011,4,41100177,5/13/2012,1610612763,Memphis Grizzlies,1,0,1610612746,LA Clippers,0,1,25,39,64,0,13,13,25,52,77,22,9,31,18,38,12,10,15,90,72
2010,4,41000172,4/20/2011,1610612743,Denver Nuggets,0,0,1610612760,Oklahoma City Thunder,1,1,20,33,53,7,9,16,27,42,69,28,9,37,6,38,12,6,11,91,89
2010,4,41000172,4/20/2011,1610612760,Oklahoma City Thunder,1,1,1610612743,Denver Nuggets,0,0,26,26,52,10,20,30,36,46,82,24,4,28,20,27,19,7,17,93,106
2011,4,41100176,5/11/2012,1610612746,LA Clippers,1,0,1610612763,Memphis Grizzlies,0,1,30,34,64,4,11,15,34,45,79,16,9,25,12,37,21,5,7,86,88
2011,4,41100176,5/11/2012,1610612763,Memphis Grizzlies,0,1,1610612746,LA Clippers,1,0,32,35,67,3,7,10,35,42,77,17,10,27,24,23,20,13,22,88,90
2010,4,41000171,4/17/2011,1610612743,Denver Nuggets,0,0,1610612760,Oklahoma City Thunder,1,1,35,26,61,4,12,16,39,38,77,21,12,33,12,31,23,4,11,94,103
2010,4,41000171,4/17/2011,1610612760,Oklahoma City Thunder,1,1,1610612743,Denver Nuggets,0,0,29,29,58,9,10,19,38,39,77,22,6,28,8,32,15,9,11,92,107
2011,4,41100175,5/9/2012,1610612746,LA Clippers,0,0,1610612763,Memphis Grizzlies,1,1,19,27,46,7,17,24,26,44,70,21,8,29,13,34,11,6,14,85,80
2011,4,41100175,5/9/2012,1610612763,Memphis Grizzlies,1,1,1610612746,LA Clippers,0,0,32,34,66,0,6,6,32,40,72,28,6,34,12,30,14,7,12,85,92
2011,4,41100174,5/7/2012,1610612746,LA Clippers,1,1,1610612763,Memphis Grizzlies,0,0,29,31,60,5,11,16,34,42,76,28,12,40,15,33,18,2,12,92,101
2011,4,41100174,5/7/2012,1610612763,Memphis Grizzlies,0,0,1610612746,LA Clippers,1,1,32,38,70,4,9,13,36,47,83,21,6,27,21,28,18,8,17,92,97
2010,4,41000166,4/28/2011,1610612742,Dallas Mavericks,0,1,1610612757,Portland Trail Blazers,1,0,33,27,60,6,12,18,39,39,78,19,3,22,14,27,23,3,9,83,103
2010,4,41000166,4/28/2011,1610612757,Portland Trail Blazers,1,0,1610612742,Dallas Mavericks,0,1,30,28,58,5,16,21,35,44,79,21,5,26,15,30,16,4,7,83,96
2011,4,41100173,5/5/2012,1610612746,LA Clippers,1,1,1610612763,Memphis Grizzlies,0,0,25,28,53,8,9,17,33,37,70,13,17,30,12,33,18,10,17,89,87
2011,4,41100173,5/5/2012,1610612763,Memphis Grizzlies,0,0,1610612746,LA Clippers,1,1,22,30,52,4,9,13,26,39,65,30,9,39,12,31,19,11,17,88,86
2010,4,41000165,4/25/2011,1610612742,Dallas Mavericks,1,1,1610612757,Portland Trail Blazers,0,0,29,32,61,3,14,17,32,46,78,26,9,35,22,28,22,6,13,87,93
2010,4,41000165,4/25/2011,1610612757,Portland Trail Blazers,0,0,1610612742,Dallas Mavericks,1,1,28,30,58,4,12,16,32,42,74,14,5,19,13,30,13,8,15,87,82
2011,4,41100172,5/2/2012,1610612746,LA Clippers,0,0,1610612763,Memphis Grizzlies,1,1,29,22,51,9,7,16,38,29,67,13,5,18,8,23,15,13,21,90,98
2011,4,41100172,5/2/2012,1610612763,Memphis Grizzlies,1,1,1610612746,LA Clippers,0,0,34,29,63,2,10,12,36,39,75,31,8,39,18,25,12,8,13,90,105
2010,4,41000164,4/23/2011,1610612742,Dallas Mavericks,0,0,1610612757,Portland Trail Blazers,1,1,21,29,50,10,16,26,31,45,76,10,0,10,15,31,19,8,15,83,82
2010,4,41000164,4/23/2011,1610612757,Portland Trail Blazers,1,1,1610612742,Dallas Mavericks,0,0,25,25,50,4,15,19,29,40,69,22,1,23,9,30,13,4,10,83,84
2011,4,41100171,4/29/2012,1610612746,LA Clippers,0,1,1610612763,Memphis Grizzlies,1,0,32,26,58,6,12,18,38,38,76,17,6,23,14,28,19,3,18,90,99
2011,4,41100171,4/29/2012,1610612763,Memphis Grizzlies,1,0,1610612746,LA Clippers,0,1,27,42,69,11,5,16,38,47,85,11,7,18,16,34,19,8,12,91,98
2010,4,41000163,4/21/2011,1610612742,Dallas Mavericks,0,0,1610612757,Portland Trail Blazers,1,1,26,20,46,9,13,22,35,33,68,13,10,23,9,31,16,8,16,86,92
2010,4,41000163,4/21/2011,1610612757,Portland Trail Blazers,1,1,1610612742,Dallas Mavericks,0,0,28,33,61,8,6,14,36,39,75,17,4,21,9,32,18,4,10,86,97
2010,4,41000162,4/19/2011,1610612742,Dallas Mavericks,1,1,1610612757,Portland Trail Blazers,0,0,29,28,57,8,11,19,37,39,76,19,7,26,11,30,20,2,6,84,101
2010,4,41000162,4/19/2011,1610612757,Portland Trail Blazers,0,0,1610612742,Dallas Mavericks,1,1,25,27,52,7,7,14,32,34,66,18,9,27,9,28,20,6,13,83,89
2010,4,41000161,4/16/2011,1610612742,Dallas Mavericks,1,1,1610612757,Portland Trail Blazers,0,0,17,30,47,10,9,19,27,39,66,25,4,29,12,29,14,7,13,83,89
2010,4,41000161,4/16/2011,1610612757,Portland Trail Blazers,0,0,1610612742,Dallas Mavericks,1,1,33,27,60,2,14,16,35,41,76,9,4,13,15,29,22,5,14,82,81
2011,4,41100167,5/12/2012,1610612743,Denver Nuggets,0,0,1610612747,Los Angeles Lakers,1,1,28,35,63,7,19,26,35,54,89,10,3,13,29,27,23,10,19,85,87
2011,4,41100167,5/12/2012,1610612747,Los Angeles Lakers,1,1,1610612743,Denver Nuggets,0,0,24,41,65,11,13,24,35,54,89,15,8,23,27,33,22,5,11,85,96
2010,4,41000156,4/28/2011,1610612740,New Orleans Pelicans,1,0,1610612747,Los Angeles Lakers,0,1,27,29,56,3,11,14,30,40,70,17,1,18,8,33,20,7,15,85,80
2010,4,41000156,4/28/2011,1610612747,Los Angeles Lakers,0,1,1610612740,New Orleans Pelicans,1,0,29,31,60,5,9,14,34,40,74,25,1,26,16,24,23,7,13,85,98
2011,4,41100166,5/10/2012,1610612743,Denver Nuggets,1,1,1610612747,Los Angeles Lakers,0,0,37,34,71,10,10,20,47,44,91,9,8,17,15,33,26,6,12,95,113
2011,4,41100166,5/10/2012,1610612747,Los Angeles Lakers,0,0,1610612743,Denver Nuggets,1,1,31,38,69,4,10,14,35,48,83,22,8,30,16,38,23,6,12,94,96
2010,4,41000155,4/26/2011,1610612740,New Orleans Pelicans,0,0,1610612747,Los Angeles Lakers,1,1,23,23,46,10,11,21,33,34,67,14,7,21,8,28,21,5,19,89,90
2010,4,41000155,4/26/2011,1610612747,Los Angeles Lakers,1,1,1610612740,New Orleans Pelicans,0,0,30,27,57,7,11,18,37,38,75,25,5,30,17,23,21,9,16,88,106
2011,4,41100165,5/8/2012,1610612743,Denver Nuggets,0,1,1610612747,Los Angeles Lakers,1,0,36,30,66,3,16,19,39,46,85,21,6,27,11,37,19,6,7,95,102
2011,4,41100165,5/8/2012,1610612747,Los Angeles Lakers,1,0,1610612743,Denver Nuggets,0,1,26,40,66,9,15,24,35,55,90,20,6,26,19,40,20,7,10,95,99
2010,4,41000154,4/24/2011,1610612740,New Orleans Pelicans,1,1,1610612747,Los Angeles Lakers,0,0,29,31,60,4,10,14,33,41,74,23,4,27,16,26,25,6,10,83,93
2010,4,41000154,4/24/2011,1610612747,Los Angeles Lakers,0,0,1610612740,New Orleans Pelicans,1,1,27,27,54,4,14,18,31,41,72,22,8,30,14,30,17,6,9,83,88
2011,4,41100164,5/6/2012,1610612743,Denver Nuggets,1,0,1610612747,Los Angeles Lakers,0,1,36,31,67,3,16,19,39,47,86,7,5,12,19,30,17,4,10,86,88
2011,4,41100164,5/6/2012,1610612747,Los Angeles Lakers,0,1,1610612743,Denver Nuggets,1,0,34,35,69,5,12,17,39,47,86,9,9,18,24,28,22,9,14,84,92
2010,4,41000153,4/22/2011,1610612740,New Orleans Pelicans,1,0,1610612747,Los Angeles Lakers,0,1,31,28,59,2,11,13,33,39,72,18,6,24,14,29,17,8,14,84,86
2010,4,41000153,4/22/2011,1610612747,Los Angeles Lakers,0,1,1610612740,New Orleans Pelicans,1,0,30,30,60,7,9,16,37,39,76,19,5,24,16,27,17,7,13,84,100
2011,4,41100163,5/4/2012,1610612743,Denver Nuggets,1,1,1610612747,Los Angeles Lakers,0,0,31,46,77,6,10,16,37,56,93,19,4,23,24,35,23,1,7,89,99
2011,4,41100163,5/4/2012,1610612747,Los Angeles Lakers,0,0,1610612743,Denver Nuggets,1,1,23,30,53,6,19,25,29,49,78,20,5,25,15,38,21,9,15,89,84
2010,4,41000152,4/20/2011,1610612740,New Orleans Pelicans,0,0,1610612747,Los Angeles Lakers,1,1,23,35,58,4,7,11,27,42,69,20,12,32,13,34,14,8,16,85,78
2010,4,41000152,4/20/2011,1610612747,Los Angeles Lakers,1,1,1610612740,New Orleans Pelicans,0,0,30,35,65,4,7,11,34,42,76,15,7,22,16,30,20,6,13,84,87
2011,4,41100162,5/1/2012,1610612743,Denver Nuggets,0,0,1610612747,Los Angeles Lakers,1,1,36,36,72,4,15,19,40,51,91,16,6,22,21,32,21,8,13,94,100
2011,4,41100162,5/1/2012,1610612747,Los Angeles Lakers,1,1,1610612743,Denver Nuggets,0,0,41,40,81,2,13,15,43,53,96,16,5,21,23,34,20,7,11,93,104
2010,4,41000151,4/17/2011,1610612740,New Orleans Pelicans,0,1,1610612747,Los Angeles Lakers,1,0,37,31,68,4,7,11,41,38,79,23,10,33,7,36,24,1,3,91,109
2010,4,41000151,4/17/2011,1610612747,Los Angeles Lakers,1,0,1610612740,New Orleans Pelicans,0,1,28,33,61,6,7,13,34,40,74,26,7,33,10,32,17,8,13,91,100
2011,4,41100161,4/29/2012,1610612743,Denver Nuggets,0,0,1610612747,Los Angeles Lakers,1,1,28,48,76,4,10,14,32,58,90,20,7,27,21,42,17,6,10,92,88
2011,4,41100161,4/29/2012,1610612747,Los Angeles Lakers,1,1,1610612743,Denver Nuggets,0,0,37,32,69,6,11,17,43,43,86,11,4,15,13,33,22,6,11,92,103
2010,4,41000146,4/29/2011,1610612759,San Antonio Spurs,0,0,1610612763,Memphis Grizzlies,1,1,32,31,63,5,17,22,37,48,85,12,2,14,18,30,15,6,11,87,91
2010,4,41000146,4/29/2011,1610612763,Memphis Grizzlies,1,1,1610612759,San Antonio Spurs,0,0,37,27,64,1,8,9,38,35,73,22,8,30,16,24,12,9,14,86,99
2011,4,41100154,5/5/2012,1610612742,Dallas Mavericks,1,0,1610612760,Oklahoma City Thunder,0,1,23,37,60,10,9,19,33,46,79,21,3,24,14,34,19,7,13,88,97
2011,4,41100154,5/5/2012,1610612760,Oklahoma City Thunder,0,1,1610612742,Dallas Mavericks,1,0,30,21,51,9,15,24,39,36,75,16,4,20,8,30,22,6,13,89,103
2010,4,41000145,4/27/2011,1610612759,San Antonio Spurs,1,1,1610612763,Memphis Grizzlies,0,0,32,30,62,7,15,22,39,45,84,25,7,32,10,40,23,12,15,103,110
2010,4,41000145,4/27/2011,1610612763,Memphis Grizzlies,0,0,1610612759,San Antonio Spurs,1,1,38,40,78,3,7,10,41,47,88,18,5,23,13,36,19,9,17,103,103
2010,4,41000144,4/25/2011,1610612759,San Antonio Spurs,0,0,1610612763,Memphis Grizzlies,1,1,30,27,57,5,13,18,35,40,75,11,3,14,11,32,16,8,17,88,86
2010,4,41000144,4/25/2011,1610612763,Memphis Grizzlies,1,1,1610612759,San Antonio Spurs,0,0,36,33,69,5,7,12,41,40,81,17,4,21,13,30,22,6,9,88,104
2011,4,41100153,5/3/2012,1610612742,Dallas Mavericks,1,0,1610612760,Oklahoma City Thunder,0,1,19,35,54,7,15,22,26,50,76,20,6,26,13,39,15,11,16,91,79
2011,4,41100153,5/3/2012,1610612760,Oklahoma City Thunder,0,1,1610612742,Dallas Mavericks,1,0,24,33,57,12,16,28,36,49,85,11,6,17,10,42,18,6,8,93,95
2011,4,41100152,4/30/2012,1610612742,Dallas Mavericks,0,0,1610612760,Oklahoma City Thunder,1,1,28,28,56,5,18,23,33,46,79,28,4,32,14,34,13,9,14,94,99
2011,4,41100152,4/30/2012,1610612760,Oklahoma City Thunder,1,1,1610612742,Dallas Mavericks,0,0,25,26,51,5,11,16,30,37,67,37,2,39,8,29,13,9,16,93,102
2010,4,41000143,4/23/2011,1610612759,San Antonio Spurs,0,0,1610612763,Memphis Grizzlies,1,1,29,31,60,2,13,15,31,44,75,24,8,32,14,32,19,7,14,91,88
2010,4,41000143,4/23/2011,1610612763,Memphis Grizzlies,1,1,1610612759,San Antonio Spurs,0,0,29,38,67,4,7,11,33,45,78,21,8,29,12,37,24,4,11,91,91
2011,4,41100151,4/28/2012,1610612742,Dallas Mavericks,0,0,1610612760,Oklahoma City Thunder,1,1,24,32,56,10,12,22,34,44,78,20,5,25,13,32,15,8,15,91,98
2011,4,41100151,4/28/2012,1610612760,Oklahoma City Thunder,1,1,1610612742,Dallas Mavericks,0,0,32,31,63,6,10,16,38,41,79,17,3,20,9,34,17,11,14,92,99
2010,4,41000142,4/20/2011,1610612759,San Antonio Spurs,1,1,1610612763,Memphis Grizzlies,0,0,25,31,56,7,10,17,32,41,73,22,10,32,11,37,21,9,19,95,93
2010,4,41000142,4/20/2011,1610612763,Memphis Grizzlies,0,0,1610612759,San Antonio Spurs,1,1,32,42,74,3,11,14,35,53,88,14,6,20,17,40,17,9,15,96,87
2011,4,41100144,5/7/2012,1610612759,San Antonio Spurs,0,1,1610612762,Utah Jazz,1,0,18,34,52,10,12,22,28,46,74,21,9,30,9,43,12,6,14,91,87
2011,4,41100144,5/7/2012,1610612762,Utah Jazz,1,0,1610612759,San Antonio Spurs,0,1,32,43,75,0,13,13,32,56,88,17,9,26,22,40,16,7,12,92,81
2010,4,41000141,4/17/2011,1610612759,San Antonio Spurs,1,0,1610612763,Memphis Grizzlies,0,1,22,33,55,6,9,15,28,42,70,36,11,47,14,33,13,2,10,91,98
2010,4,41000141,4/17/2011,1610612763,Memphis Grizzlies,0,1,1610612759,San Antonio Spurs,1,0,31,26,57,6,4,10,37,30,67,21,12,33,7,30,22,7,16,90,101
2011,4,41100143,5/5/2012,1610612759,San Antonio Spurs,0,1,1610612762,Utah Jazz,1,0,32,28,60,7,13,20,39,41,80,17,5,22,10,35,21,6,11,92,102
2011,4,41100143,5/5/2012,1610612762,Utah Jazz,1,0,1610612759,San Antonio Spurs,0,1,32,44,76,4,9,13,36,53,89,14,12,26,23,33,18,2,11,91,90
2010,4,41000136,4/28/2011,1610612737,Atlanta Hawks,1,1,1610612753,Orlando Magic,0,0,23,34,57,8,14,22,31,48,79,14,1,15,20,29,18,8,16,82,84
2010,4,41000136,4/28/2011,1610612753,Orlando Magic,0,0,1610612737,Atlanta Hawks,1,1,24,24,48,5,14,19,29,38,67,18,4,22,11,27,14,8,14,82,81
2011,4,41100142,5/2/2012,1610612759,San Antonio Spurs,1,1,1610612762,Utah Jazz,0,0,37,23,60,10,12,22,47,35,82,10,0,10,6,29,28,7,12,95,114
2011,4,41100142,5/2/2012,1610612762,Utah Jazz,0,0,1610612759,San Antonio Spurs,1,1,30,54,84,1,5,6,31,59,90,20,3,23,21,41,16,10,15,95,83
2010,4,41000135,4/26/2011,1610612737,Atlanta Hawks,0,0,1610612753,Orlando Magic,1,1,21,32,53,4,12,16,25,44,69,22,10,32,9,37,15,7,13,89,76
2010,4,41000135,4/26/2011,1610612753,Orlando Magic,1,1,1610612737,Atlanta Hawks,0,0,23,34,57,11,15,26,34,49,83,22,7,29,15,39,18,3,6,88,101
2011,4,41100141,4/29/2012,1610612759,San Antonio Spurs,1,1,1610612762,Utah Jazz,0,0,34,33,67,6,11,17,40,44,84,20,8,28,14,32,25,7,10,93,106
2011,4,41100141,4/29/2012,1610612762,Utah Jazz,0,0,1610612759,San Antonio Spurs,1,1,28,35,63,4,9,13,32,44,76,23,7,30,15,32,17,10,16,93,91
2010,4,41000134,4/24/2011,1610612737,Atlanta Hawks,1,1,1610612753,Orlando Magic,0,0,29,31,60,6,9,15,35,40,75,12,8,20,10,35,21,8,16,91,88
2010,4,41000134,4/24/2011,1610612753,Orlando Magic,0,0,1610612737,Atlanta Hawks,1,1,29,27,56,2,21,23,31,48,79,21,8,29,15,38,11,7,13,92,85
2010,4,41000133,4/22/2011,1610612737,Atlanta Hawks,1,1,1610612753,Orlando Magic,0,0,28,39,67,6,8,14,34,47,81,14,5,19,14,34,20,4,8,82,88
2010,4,41000133,4/22/2011,1610612753,Orlando Magic,0,0,1610612737,Atlanta Hawks,1,1,23,22,45,8,20,28,31,42,73,14,7,21,13,31,20,4,10,82,84
2011,4,41100136,5/10/2012,1610612737,Atlanta Hawks,0,0,1610612738,Boston Celtics,1,1,25,38,63,7,8,15,32,46,78,9,1,10,12,34,22,8,13,83,80
2011,4,41100136,5/10/2012,1610612738,Boston Celtics,1,1,1610612737,Atlanta Hawks,0,0,29,35,64,2,8,10,31,43,74,19,5,24,12,31,19,6,12,84,83
2011,4,41100135,5/8/2012,1610612737,Atlanta Hawks,1,1,1610612738,Boston Celtics,0,0,27,30,57,7,9,16,34,39,73,12,2,14,13,26,20,11,19,86,87
2011,4,41100135,5/8/2012,1610612738,Boston Celtics,0,0,1610612737,Atlanta Hawks,1,1,28,35,63,6,8,14,34,43,77,12,3,15,12,31,23,6,15,88,86
2010,4,41000132,4/19/2011,1610612737,Atlanta Hawks,0,0,1610612753,Orlando Magic,1,1,25,36,61,7,13,20,32,49,81,11,6,17,17,34,15,9,15,87,82
2010,4,41000132,4/19/2011,1610612753,Orlando Magic,1,1,1610612737,Atlanta Hawks,0,0,22,33,55,5,18,23,27,51,78,29,7,36,26,28,9,7,16,87,88
2010,4,41000131,4/16/2011,1610612737,Atlanta Hawks,0,1,1610612753,Orlando Magic,1,0,32,28,60,6,8,14,38,36,74,21,8,29,11,29,19,3,10,88,103
2010,4,41000131,4/16/2011,1610612753,Orlando Magic,1,0,1610612737,Atlanta Hawks,0,1,28,25,53,6,16,22,34,41,75,19,11,30,19,27,15,8,18,88,93
2011,4,41100134,5/6/2012,1610612737,Atlanta Hawks,0,0,1610612738,Boston Celtics,1,1,27,29,56,4,16,20,31,45,76,13,4,17,12,35,18,10,18,91,79
2011,4,41100134,5/6/2012,1610612738,Boston Celtics,1,1,1610612737,Atlanta Hawks,0,0,30,24,54,11,15,26,41,39,80,8,5,13,6,35,24,3,11,90,101
2010,4,41000123,4/22/2011,1610612738,Boston Celtics,0,1,1610612752,New York Knicks,1,0,28,31,59,14,10,24,42,41,83,15,2,17,18,24,31,9,21,95,113
2010,4,41000123,4/22/2011,1610612752,New York Knicks,1,0,1610612738,Boston Celtics,0,1,24,32,56,9,11,20,33,43,76,21,7,28,16,31,18,12,20,94,96
2011,4,41100133,5/4/2012,1610612737,Atlanta Hawks,0,0,1610612738,Boston Celtics,1,1,30,40,70,4,16,20,34,56,90,12,3,15,14,44,15,10,17,99,84
2011,4,41100133,5/4/2012,1610612738,Boston Celtics,1,1,1610612737,Atlanta Hawks,0,0,28,38,66,4,9,13,32,47,79,22,3,25,10,39,18,8,16,100,90
2010,4,41000124,4/24/2011,1610612738,Boston Celtics,0,1,1610612752,New York Knicks,1,0,37,32,69,3,9,12,40,41,81,18,6,24,13,30,24,4,18,97,101
2010,4,41000124,4/24/2011,1610612752,New York Knicks,1,0,1610612738,Boston Celtics,0,1,22,39,61,8,19,27,30,58,88,21,7,28,18,44,19,6,14,96,89
2011,4,41100132,5/1/2012,1610612737,Atlanta Hawks,1,0,1610612738,Boston Celtics,0,1,23,38,61,6,16,22,29,54,83,16,4,20,14,42,14,6,12,91,80
2011,4,41100132,5/1/2012,1610612738,Boston Celtics,0,1,1610612737,Atlanta Hawks,1,0,26,28,54,3,11,14,29,39,68,26,5,31,10,32,14,7,17,92,87
2011,4,41100131,4/29/2012,1610612737,Atlanta Hawks,1,1,1610612738,Boston Celtics,0,0,24,32,56,7,13,20,31,45,76,14,7,21,13,35,16,9,13,86,83
2011,4,41100131,4/29/2012,1610612738,Boston Celtics,0,0,1610612737,Atlanta Hawks,1,1,32,39,71,0,11,11,32,50,82,10,3,13,9,41,21,3,6,86,74
2010,4,41000122,4/19/2011,1610612738,Boston Celtics,1,1,1610612752,New York Knicks,0,0,33,39,72,6,5,11,39,44,83,12,4,16,13,34,21,8,10,87,96
2010,4,41000122,4/19/2011,1610612752,New York Knicks,0,0,1610612738,Boston Celtics,1,1,24,41,65,8,17,25,32,58,90,21,6,27,28,33,14,8,13,89,93
2011,4,41100125,5/8/2012,1610612753,Orlando Magic,0,0,1610612754,Indiana Pacers,1,1,21,25,46,11,19,30,32,44,76,12,7,19,12,35,14,8,11,84,87
2011,4,41100125,5/8/2012,1610612754,Indiana Pacers,1,1,1610612753,Orlando Magic,0,0,34,31,65,9,8,17,43,39,82,10,4,14,18,25,16,8,15,85,105
2010,4,41000121,4/17/2011,1610612738,Boston Celtics,1,1,1610612752,New York Knicks,0,0,30,37,67,5,8,13,35,45,80,12,6,18,24,24,20,5,18,85,87
2010,4,41000121,4/17/2011,1610612752,New York Knicks,0,0,1610612738,Boston Celtics,1,1,25,30,55,8,15,23,33,45,78,11,5,16,16,30,16,5,14,84,85
2010,4,41000115,4/27/2011,1610612748,Miami Heat,1,1,1610612755,Philadelphia 76ers,0,0,20,30,50,12,18,30,32,48,80,21,4,25,18,33,17,4,10,84,97
2010,4,41000115,4/27/2011,1610612755,Philadelphia 76ers,0,0,1610612748,Miami Heat,1,1,37,36,73,2,8,10,39,44,83,11,6,17,14,33,20,6,8,84,91
2011,4,41100124,5/5/2012,1610612753,Orlando Magic,1,0,1610612754,Indiana Pacers,0,1,25,31,56,9,20,29,34,51,85,22,6,28,16,38,24,4,13,96,99
2011,4,41100124,5/5/2012,1610612754,Indiana Pacers,0,1,1610612753,Orlando Magic,1,0,33,30,63,6,15,21,39,45,84,17,3,20,15,33,23,7,17,95,101
2011,4,41100123,5/2/2012,1610612753,Orlando Magic,1,0,1610612754,Indiana Pacers,0,1,25,31,56,5,10,15,30,41,71,9,9,18,11,34,14,9,17,86,74
2011,4,41100123,5/2/2012,1610612754,Indiana Pacers,0,1,1610612753,Orlando Magic,1,0,29,30,59,8,12,20,37,42,79,15,5,20,15,31,16,6,13,86,97
2010,4,41000114,4/24/2011,1610612748,Miami Heat,0,0,1610612755,Philadelphia 76ers,1,1,25,30,55,5,18,23,30,48,78,17,4,21,10,41,14,7,9,87,82
2010,4,41000114,4/24/2011,1610612755,Philadelphia 76ers,1,1,1610612748,Miami Heat,0,0,24,37,61,8,10,18,32,47,79,14,2,16,16,32,18,8,14,88,86
2010,4,41000113,4/21/2011,1610612748,Miami Heat,0,1,1610612755,Philadelphia 76ers,1,0,32,35,67,4,8,12,36,43,79,24,6,30,22,24,19,7,12,83,100
2010,4,41000113,4/21/2011,1610612755,Philadelphia 76ers,1,0,1610612748,Miami Heat,0,1,27,34,61,9,12,21,36,46,82,13,6,19,18,31,24,3,9,84,94
2011,4,41100122,4/30/2012,1610612753,Orlando Magic,0,0,1610612754,Indiana Pacers,1,1,19,32,51,8,17,25,27,49,76,16,3,19,18,33,16,9,16,84,78
2011,4,41100122,4/30/2012,1610612754,Indiana Pacers,1,1,1610612753,Orlando Magic,0,0,31,26,57,2,18,20,33,44,77,25,3,28,20,25,9,6,13,85,93
2010,4,41000112,4/18/2011,1610612748,Miami Heat,1,1,1610612755,Philadelphia 76ers,0,0,31,26,57,3,12,15,34,38,72,23,6,29,11,31,16,6,12,87,94
2010,4,41000112,4/18/2011,1610612755,Philadelphia 76ers,0,0,1610612748,Miami Heat,1,1,21,44,65,6,8,14,27,52,79,13,7,20,15,40,18,7,13,86,73
2011,4,41100115,5/9/2012,1610612748,Miami Heat,1,1,1610612752,New York Knicks,0,0,25,34,59,9,10,19,34,44,78,29,5,34,16,29,20,7,10,88,106
2011,4,41100115,5/9/2012,1610612752,New York Knicks,0,0,1610612748,Miami Heat,1,1,32,31,63,4,9,13,36,40,76,18,3,21,12,30,13,7,14,88,94
2010,4,41000111,4/16/2011,1610612748,Miami Heat,1,1,1610612755,Philadelphia 76ers,0,0,27,30,57,4,13,17,31,43,74,31,8,39,20,27,15,8,14,88,97
2010,4,41000111,4/16/2011,1610612755,Philadelphia 76ers,0,0,1610612748,Miami Heat,1,1,28,38,66,7,12,19,35,50,85,12,3,15,15,37,22,3,9,87,89
2011,4,41100121,4/28/2012,1610612753,Orlando Magic,0,1,1610612754,Indiana Pacers,1,0,23,34,57,9,15,24,32,49,81,8,3,11,14,37,18,7,13,85,81
2011,4,41100121,4/28/2012,1610612754,Indiana Pacers,1,0,1610612753,Orlando Magic,0,1,26,48,74,4,9,13,30,57,87,13,9,22,25,37,17,3,12,87,77
2010,4,41000105,4/26/2011,1610612741,Chicago Bulls,1,1,1610612754,Indiana Pacers,0,0,26,26,52,14,17,31,40,43,83,22,5,27,17,28,27,4,14,93,116
2010,4,41000105,4/26/2011,1610612754,Indiana Pacers,0,0,1610612741,Chicago Bulls,1,1,22,36,58,7,9,16,29,45,74,24,2,26,14,32,14,10,21,93,89
2011,4,41100114,5/6/2012,1610612748,Miami Heat,0,0,1610612752,New York Knicks,1,1,27,27,54,3,16,19,30,43,73,24,11,35,12,35,20,6,14,92,87
2011,4,41100114,5/6/2012,1610612752,New York Knicks,1,1,1610612748,Miami Heat,0,0,27,26,53,5,17,22,32,43,75,20,9,29,14,33,16,8,18,91,89
2010,4,41000104,4/23/2011,1610612741,Chicago Bulls,0,0,1610612754,Indiana Pacers,1,1,28,34,62,3,17,20,31,51,82,19,5,24,19,32,19,6,14,88,84
2010,4,41000104,4/23/2011,1610612754,Indiana Pacers,1,1,1610612741,Chicago Bulls,0,0,26,37,63,5,11,16,31,48,79,22,12,34,21,34,12,7,14,88,89
2011,4,41100113,5/3/2012,1610612748,Miami Heat,0,1,1610612752,New York Knicks,1,0,18,21,39,11,18,29,29,39,68,18,4,22,12,28,11,6,19,86,87
2011,4,41100113,5/3/2012,1610612752,New York Knicks,1,0,1610612748,Miami Heat,0,1,18,31,49,4,16,20,22,47,69,22,7,29,18,33,8,13,20,84,70
2010,4,41000103,4/21/2011,1610612741,Chicago Bulls,0,1,1610612754,Indiana Pacers,1,0,19,33,52,9,11,20,28,44,72,23,4,27,16,30,20,10,16,86,88
2010,4,41000103,4/21/2011,1610612754,Indiana Pacers,1,0,1610612741,Chicago Bulls,0,1,32,45,77,1,9,10,33,54,87,17,1,18,21,33,11,7,11,87,84
2011,4,41100111,4/28/2012,1610612748,Miami Heat,1,1,1610612752,New York Knicks,0,0,26,23,49,8,13,21,34,36,70,24,9,33,15,27,16,8,17,86,100
2011,4,41100111,4/28/2012,1610612752,New York Knicks,0,0,1610612748,Miami Heat,1,1,18,31,49,7,14,21,25,45,70,10,1,11,18,28,11,12,27,87,67
2010,4,41000102,4/18/2011,1610612741,Chicago Bulls,1,1,1610612754,Indiana Pacers,0,0,27,42,69,5,9,14,32,51,83,27,7,34,26,28,15,13,22,95,96
2010,4,41000102,4/18/2011,1610612754,Indiana Pacers,0,0,1610612741,Chicago Bulls,1,1,26,34,60,6,11,17,32,45,77,20,7,27,11,39,22,11,18,95,90
2011,4,41100112,4/30/2012,1610612748,Miami Heat,1,1,1610612752,New York Knicks,0,0,29,23,52,9,12,21,38,35,73,19,8,27,10,30,28,3,8,83,104
2011,4,41100112,4/30/2012,1610612752,New York Knicks,0,0,1610612748,Miami Heat,1,1,33,29,62,5,10,15,38,39,77,13,6,19,15,27,15,6,13,83,94
2010,4,41000101,4/16/2011,1610612741,Chicago Bulls,1,1,1610612754,Indiana Pacers,0,0,30,32,62,6,14,20,36,46,82,26,6,32,25,23,18,8,15,90,104
2010,4,41000101,4/16/2011,1610612754,Indiana Pacers,0,0,1610612741,Chicago Bulls,1,1,29,37,66,10,8,18,39,45,84,11,6,17,15,33,21,6,12,88,99
2011,4,41100106,5/10/2012,1610612741,Chicago Bulls,0,0,1610612755,Philadelphia 76ers,1,1,28,39,67,2,11,13,30,50,80,16,5,21,22,30,19,7,14,83,78
2011,4,41100106,5/10/2012,1610612755,Philadelphia 76ers,1,1,1610612741,Chicago Bulls,0,0,23,34,57,6,10,16,29,44,73,15,5,20,7,41,19,4,7,82,79
2011,4,41100105,5/8/2012,1610612741,Chicago Bulls,1,1,1610612755,Philadelphia 76ers,0,0,29,43,72,5,5,10,34,48,82,4,7,11,11,40,22,7,15,92,77
2011,4,41100105,5/8/2012,1610612755,Philadelphia 76ers,0,0,1610612741,Chicago Bulls,1,1,23,44,67,2,9,11,25,53,78,17,7,24,12,43,14,8,14,91,69
2011,4,41100104,5/6/2012,1610612741,Chicago Bulls,0,0,1610612755,Philadelphia 76ers,1,1,31,43,74,3,8,11,34,51,85,11,3,14,16,38,21,6,14,89,82
2011,4,41100104,5/6/2012,1610612755,Philadelphia 76ers,1,1,1610612741,Chicago Bulls,0,0,26,34,60,5,14,19,31,48,79,22,9,31,14,39,16,5,9,89,89
2011,4,41100103,5/4/2012,1610612741,Chicago Bulls,0,0,1610612755,Philadelphia 76ers,1,1,24,37,61,4,10,14,28,47,75,14,9,23,19,33,22,8,17,84,74
2011,4,41100103,5/4/2012,1610612755,Philadelphia 76ers,1,1,1610612741,Chicago Bulls,0,0,25,37,62,1,13,14,26,50,76,26,7,33,16,38,13,5,9,84,79
2011,4,41100102,5/1/2012,1610612741,Chicago Bulls,1,0,1610612755,Philadelphia 76ers,0,1,32,38,70,6,8,14,38,46,84,10,8,18,17,32,23,7,8,86,92
2011,4,41100102,5/1/2012,1610612755,Philadelphia 76ers,0,1,1610612741,Chicago Bulls,1,0,41,25,66,5,7,12,46,32,78,12,3,15,8,25,23,3,9,85,109
2021,4,42100406,6/16/2022,1610612738,Boston Celtics,1,0,1610612744,Golden State Warriors,0,1,23,29,52,11,17,28,34,46,80,11,1,12,16,30,27,13,23,92,90
2021,4,42100406,6/16/2022,1610612744,Golden State Warriors,0,1,1610612738,Boston Celtics,1,0,19,27,46,19,27,46,38,54,92,8,0,8,22,32,27,8,17,94,103
2021,4,42100405,6/13/2022,1610612738,Boston Celtics,0,0,1610612744,Golden State Warriors,1,1,20,23,43,11,21,32,31,44,75,21,10,31,12,36,18,9,18,96,94
2021,4,42100405,6/13/2022,1610612744,Golden State Warriors,1,1,1610612738,Boston Celtics,0,0,32,16,48,9,31,40,41,47,88,13,2,15,5,42,23,2,7,97,104
2021,4,42100404,6/10/2022,1610612738,Boston Celtics,1,0,1610612744,Golden State Warriors,0,1,19,28,47,15,23,38,34,51,85,14,5,19,14,39,22,10,16,95,97
2021,4,42100404,6/10/2022,1610612744,Golden State Warriors,0,1,1610612738,Boston Celtics,1,0,25,23,48,15,28,43,40,51,91,12,3,15,20,32,20,8,16,95,107
2021,4,42100403,6/8/2022,1610612738,Boston Celtics,1,1,1610612744,Golden State Warriors,0,0,30,24,54,13,22,35,43,46,89,17,7,24,20,29,28,7,12,94,116
2021,4,42100403,6/8/2022,1610612744,Golden State Warriors,0,0,1610612738,Boston Celtics,1,1,21,17,38,15,25,40,36,42,78,13,2,15,8,34,22,7,17,93,100
2021,4,42100402,6/5/2022,1610612738,Boston Celtics,0,0,1610612744,Golden State Warriors,1,1,15,28,43,15,22,37,30,50,80,13,4,17,11,39,24,15,19,98,88
2021,4,42100402,6/5/2022,1610612744,Golden State Warriors,1,1,1610612738,Boston Celtics,0,0,24,25,49,15,22,37,39,47,86,14,6,20,11,38,25,5,12,98,107
2021,4,42100401,6/2/2022,1610612738,Boston Celtics,0,1,1610612744,Golden State Warriors,1,0,22,22,44,21,20,41,43,42,85,13,3,16,13,30,33,8,13,93,120
2021,4,42100401,6/2/2022,1610612744,Golden State Warriors,1,0,1610612738,Boston Celtics,0,1,20,23,43,19,26,45,39,49,88,11,4,15,18,33,24,7,14,94,108
2019,4,41900406,10/11/2020,1610612747,Los Angeles Lakers,0,1,1610612748,Miami Heat,1,0,32,22,54,11,24,35,43,46,89,9,5,14,16,34,23,4,13,94,106
2021,4,42100315,5/26/2022,1610612742,Dallas Mavericks,0,0,1610612744,Golden State Warriors,1,1,20,20,40,17,25,42,37,45,82,19,6,25,9,41,22,6,8,92,110
2021,4,42100315,5/26/2022,1610612744,Golden State Warriors,1,1,1610612742,Dallas Mavericks,0,0,31,21,52,14,22,36,45,43,88,16,0,16,15,28,36,6,11,90,120
2019,4,41900406,10/11/2020,1610612748,Miami Heat,1,0,1610612747,Los Angeles Lakers,0,1,25,26,51,10,18,28,35,44,79,13,9,22,11,37,25,5,16,93,93
2021,4,42100314,5/24/2022,1610612742,Dallas Mavericks,1,1,1610612744,Golden State Warriors,0,0,21,18,39,20,23,43,41,41,82,17,5,22,4,40,30,5,8,96,119
2021,4,42100314,5/24/2022,1610612744,Golden State Warriors,0,0,1610612742,Dallas Mavericks,1,1,31,25,56,10,18,28,41,43,84,17,9,26,8,41,26,4,8,96,109
2019,4,41900405,10/9/2020,1610612747,Los Angeles Lakers,1,0,1610612748,Miami Heat,0,1,24,20,44,14,24,38,38,44,82,18,3,21,15,30,21,7,15,93,108
2019,4,41900405,10/9/2020,1610612748,Miami Heat,0,1,1610612747,Los Angeles Lakers,1,0,24,26,50,14,19,33,38,45,83,21,1,22,12,33,26,10,13,92,111
2021,4,42100313,5/22/2022,1610612742,Dallas Mavericks,1,0,1610612744,Golden State Warriors,0,1,17,13,30,13,32,45,30,45,75,27,7,34,9,38,18,5,9,91,100
2021,4,42100313,5/22/2022,1610612744,Golden State Warriors,0,1,1610612742,Dallas Mavericks,1,0,27,22,49,11,21,32,38,43,81,22,3,25,16,29,28,4,13,89,109
2021,4,42100312,5/20/2022,1610612742,Dallas Mavericks,0,0,1610612744,Golden State Warriors,1,1,16,17,33,21,24,45,37,41,78,22,7,29,6,38,22,4,12,97,117
2021,4,42100312,5/20/2022,1610612744,Golden State Warriors,1,1,1610612742,Dallas Mavericks,0,0,32,22,54,14,14,28,46,36,82,20,5,25,11,28,33,7,16,97,126
2021,4,42100311,5/18/2022,1610612742,Dallas Mavericks,0,0,1610612744,Golden State Warriors,1,1,20,18,38,11,37,48,31,55,86,14,7,21,12,45,14,8,13,97,87
2021,4,42100311,5/18/2022,1610612744,Golden State Warriors,1,1,1610612742,Dallas Mavericks,0,0,36,17,53,10,19,29,46,36,82,10,6,16,9,30,24,7,15,97,112
2021,4,42100307,5/29/2022,1610612738,Boston Celtics,0,1,1610612748,Miami Heat,1,0,24,29,53,11,21,32,35,50,85,19,5,24,14,40,22,4,13,96,100
2021,4,42100307,5/29/2022,1610612748,Miami Heat,1,0,1610612738,Boston Celtics,0,1,31,27,58,6,24,30,37,51,88,16,8,24,12,44,16,4,10,96,96
2021,4,42100306,5/27/2022,1610612738,Boston Celtics,1,0,1610612748,Miami Heat,0,1,21,18,39,11,22,33,32,40,72,28,3,31,10,32,22,10,18,95,103
2021,4,42100306,5/27/2022,1610612748,Miami Heat,0,1,1610612738,Boston Celtics,1,0,21,22,43,15,20,35,36,42,78,24,1,25,14,28,25,10,19,94,111
2021,4,42100305,5/25/2022,1610612738,Boston Celtics,0,1,1610612748,Miami Heat,1,0,23,15,38,10,23,33,33,38,71,17,6,23,7,34,24,7,15,90,93
2021,4,42100305,5/25/2022,1610612748,Miami Heat,1,0,1610612738,Boston Celtics,0,1,23,26,49,7,38,45,30,64,94,13,1,14,23,42,14,5,12,91,80
2019,4,41900404,10/6/2020,1610612747,Los Angeles Lakers,0,1,1610612748,Miami Heat,1,0,21,19,40,14,25,39,35,44,79,18,3,21,13,32,25,8,15,91,102
2019,4,41900404,10/6/2020,1610612748,Miami Heat,1,0,1610612747,Los Angeles Lakers,0,1,21,22,43,11,21,32,32,43,75,21,5,26,10,36,18,5,15,92,96
2021,4,42100304,5/23/2022,1610612738,Boston Celtics,1,1,1610612748,Miami Heat,0,0,23,21,44,8,26,34,31,47,78,32,6,38,17,33,21,4,11,91,102
2021,4,42100304,5/23/2022,1610612748,Miami Heat,0,0,1610612738,Boston Celtics,1,1,16,38,54,14,22,36,30,60,90,8,6,14,15,49,22,4,9,91,82
2021,4,42100303,5/21/2022,1610612738,Boston Celtics,1,0,1610612748,Miami Heat,0,1,22,16,38,12,20,32,34,36,70,23,7,30,12,28,21,19,24,94,103
2021,4,42100303,5/21/2022,1610612748,Miami Heat,0,1,1610612738,Boston Celtics,1,0,32,27,59,11,22,33,43,49,92,12,2,14,12,37,22,2,9,93,109
2019,4,41900403,10/4/2020,1610612747,Los Angeles Lakers,0,0,1610612748,Miami Heat,1,1,20,17,37,14,28,42,34,45,79,22,7,29,13,35,23,8,20,99,104
2019,4,41900403,10/4/2020,1610612748,Miami Heat,1,1,1610612747,Los Angeles Lakers,0,0,29,17,46,12,22,34,41,39,80,21,2,23,6,33,25,8,13,98,115
2019,4,41900402,10/2/2020,1610612747,Los Angeles Lakers,1,1,1610612748,Miami Heat,0,0,33,17,50,16,31,47,49,48,97,10,7,17,22,32,32,2,9,92,124
2019,4,41900402,10/2/2020,1610612748,Miami Heat,0,0,1610612747,Los Angeles Lakers,1,1,25,19,44,11,16,27,36,35,71,31,3,34,7,29,29,6,10,91,114
2021,4,42100302,5/19/2022,1610612738,Boston Celtics,0,1,1610612748,Miami Heat,1,0,23,21,44,20,20,40,43,41,84,21,2,23,12,31,28,4,10,94,127
2021,4,42100302,5/19/2022,1610612748,Miami Heat,1,0,1610612738,Boston Celtics,0,1,28,24,52,10,24,34,38,48,86,16,6,22,18,34,21,8,15,94,102
2019,4,41900401,9/30/2020,1610612747,Los Angeles Lakers,1,1,1610612748,Miami Heat,0,0,23,23,46,15,23,38,38,46,84,25,2,27,14,32,26,3,11,97,116
2021,4,42100301,5/17/2022,1610612738,Boston Celtics,0,0,1610612748,Miami Heat,1,1,25,20,45,11,23,34,36,43,79,24,8,32,14,32,22,10,16,97,107
2021,4,42100301,5/17/2022,1610612748,Miami Heat,1,1,1610612738,Boston Celtics,0,0,29,21,50,10,20,30,39,41,80,30,4,34,12,32,18,8,13,97,118
2019,4,41900401,9/30/2020,1610612748,Miami Heat,0,0,1610612747,Los Angeles Lakers,1,1,27,27,54,11,24,35,38,51,89,11,3,14,7,46,23,8,9,97,98
2021,4,42100236,5/13/2022,1610612744,Golden State Warriors,1,1,1610612763,Memphis Grizzlies,0,0,21,30,51,20,33,53,41,63,104,8,3,11,29,36,24,8,19,99,110
2021,4,42100236,5/13/2022,1610612763,Memphis Grizzlies,0,0,1610612744,Golden State Warriors,1,1,19,41,60,15,21,36,34,62,96,13,7,20,14,52,21,3,7,98,96
2019,4,41900315,9/26/2020,1610612743,Denver Nuggets,0,0,1610612747,Los Angeles Lakers,1,1,30,30,60,8,22,30,38,52,90,23,3,26,14,40,23,6,11,99,107
2019,4,41900315,9/26/2020,1610612747,Los Angeles Lakers,1,1,1610612743,Denver Nuggets,0,0,33,20,53,9,15,24,42,35,77,24,5,29,6,32,24,5,14,98,117
2021,4,42100235,5/11/2022,1610612744,Golden State Warriors,0,0,1610612763,Memphis Grizzlies,1,1,22,19,41,14,25,39,36,44,80,9,4,13,7,38,22,12,22,103,95
2021,4,42100235,5/11/2022,1610612763,Memphis Grizzlies,1,1,1610612744,Golden State Warriors,0,0,29,29,58,18,23,41,47,52,99,22,8,30,21,35,37,3,10,101,134
2021,4,42100234,5/9/2022,1610612744,Golden State Warriors,1,1,1610612763,Memphis Grizzlies,0,0,27,26,53,9,28,37,36,54,90,20,2,22,14,42,25,10,16,102,101
2021,4,42100234,5/9/2022,1610612763,Memphis Grizzlies,0,0,1610612744,Golden State Warriors,1,1,31,30,61,9,26,35,40,56,96,9,6,15,13,45,25,6,12,103,98
2021,4,42100233,5/7/2022,1610612744,Golden State Warriors,1,1,1610612763,Memphis Grizzlies,0,0,36,17,53,17,15,32,53,32,85,19,2,21,9,24,34,7,16,101,142
2021,4,42100233,5/7/2022,1610612763,Memphis Grizzlies,0,0,1610612744,Golden State Warriors,1,1,24,25,49,16,27,43,40,52,92,16,5,21,12,43,21,5,12,101,112
2019,4,41900314,9/24/2020,1610612743,Denver Nuggets,1,0,1610612747,Los Angeles Lakers,0,1,29,20,49,10,18,28,39,38,77,20,3,23,10,30,22,9,11,90,108
2021,4,42100232,5/3/2022,1610612744,Golden State Warriors,0,0,1610612763,Memphis Grizzlies,1,1,33,24,57,7,31,38,40,55,95,14,4,18,20,37,27,13,18,102,101
2021,4,42100232,5/3/2022,1610612763,Memphis Grizzlies,1,1,1610612744,Golden State Warriors,0,0,22,24,46,14,31,45,36,55,91,20,1,21,15,40,17,6,15,101,106
2019,4,41900314,9/24/2020,1610612747,Los Angeles Lakers,0,1,1610612743,Denver Nuggets,1,0,28,22,50,10,20,30,38,42,80,28,7,35,19,28,23,4,11,90,114
2019,4,41900313,9/22/2020,1610612743,Denver Nuggets,1,1,1610612747,Los Angeles Lakers,0,0,29,15,44,11,18,29,40,33,73,23,6,29,12,23,26,11,20,97,114
2019,4,41900313,9/22/2020,1610612747,Los Angeles Lakers,0,0,1610612743,Denver Nuggets,1,1,37,20,57,6,20,26,43,40,83,14,8,22,10,37,27,8,16,97,106
2021,4,42100231,5/1/2022,1610612744,Golden State Warriors,0,1,1610612763,Memphis Grizzlies,1,0,31,24,55,14,24,38,45,48,93,13,7,20,18,35,31,11,18,102,117
2021,4,42100231,5/1/2022,1610612763,Memphis Grizzlies,1,0,1610612744,Golden State Warriors,0,1,25,30,55,16,24,40,41,54,95,18,6,24,19,39,26,10,16,102,116
2019,4,41900312,9/20/2020,1610612743,Denver Nuggets,0,0,1610612747,Los Angeles Lakers,1,1,27,23,50,8,16,24,35,39,74,25,8,33,13,32,22,9,21,98,103
2019,4,41900312,9/20/2020,1610612747,Los Angeles Lakers,1,1,1610612743,Denver Nuggets,0,0,24,23,47,13,23,36,37,46,83,18,1,19,18,29,23,12,24,98,105
2021,4,42100227,5/15/2022,1610612742,Dallas Mavericks,0,1,1610612756,Phoenix Suns,1,0,27,15,42,19,20,39,46,35,81,12,0,12,8,27,14,8,12,92,123
2021,4,42100227,5/15/2022,1610612756,Phoenix Suns,1,0,1610612742,Dallas Mavericks,0,1,21,32,53,12,22,34,33,54,87,12,6,18,17,40,22,9,12,91,90
2019,4,41900311,9/18/2020,1610612743,Denver Nuggets,0,0,1610612747,Los Angeles Lakers,1,1,32,25,57,9,17,26,41,42,83,23,5,28,15,29,23,10,16,100,114
2019,4,41900311,9/18/2020,1610612747,Los Angeles Lakers,1,1,1610612743,Denver Nuggets,0,0,33,24,57,11,15,26,44,39,83,27,10,37,14,30,33,3,12,99,126
2021,4,42100226,5/12/2022,1610612742,Dallas Mavericks,1,1,1610612756,Phoenix Suns,0,0,19,19,38,16,23,39,35,42,77,27,9,36,9,35,18,3,7,93,113
2021,4,42100226,5/12/2022,1610612756,Phoenix Suns,0,0,1610612742,Dallas Mavericks,1,1,25,35,60,6,12,18,31,47,78,18,3,21,17,32,18,16,22,94,86
2021,4,42100225,5/10/2022,1610612742,Dallas Mavericks,0,0,1610612756,Phoenix Suns,1,1,19,20,39,8,24,32,27,44,71,18,9,27,9,39,9,10,18,93,80
2021,4,42100225,5/10/2022,1610612756,Phoenix Suns,1,1,1610612742,Dallas Mavericks,0,0,31,24,55,12,20,32,43,44,87,12,4,16,14,32,28,7,12,93,110
2021,4,42100224,5/8/2022,1610612742,Dallas Mavericks,1,1,1610612756,Phoenix Suns,0,0,18,23,41,20,24,44,38,47,85,15,4,19,14,34,22,4,11,92,111
2021,4,42100224,5/8/2022,1610612756,Phoenix Suns,0,0,1610612742,Dallas Mavericks,1,1,30,29,59,9,16,25,39,45,84,14,4,18,15,31,27,5,17,93,101
2021,4,42100223,5/6/2022,1610612742,Dallas Mavericks,1,1,1610612756,Phoenix Suns,0,0,27,24,51,13,26,39,40,50,90,10,3,13,15,37,25,5,8,88,103
2021,4,42100223,5/6/2022,1610612756,Phoenix Suns,0,0,1610612742,Dallas Mavericks,1,1,21,27,48,13,15,28,34,42,76,13,2,15,12,30,23,12,17,90,94
2021,4,42100222,5/4/2022,1610612742,Dallas Mavericks,0,0,1610612756,Phoenix Suns,1,1,19,19,38,17,24,41,36,43,79,20,4,24,13,32,19,6,17,96,109
2021,4,42100222,5/4/2022,1610612756,Phoenix Suns,1,1,1610612742,Dallas Mavericks,0,0,36,15,51,13,12,25,49,27,76,18,3,21,8,20,28,7,17,96,129
2021,4,42100221,5/2/2022,1610612742,Dallas Mavericks,0,0,1610612756,Phoenix Suns,1,1,24,22,46,16,23,39,40,45,85,18,7,25,12,38,16,3,9,94,114
2021,4,42100221,5/2/2022,1610612756,Phoenix Suns,1,1,1610612742,Dallas Mavericks,0,0,35,28,63,11,17,28,46,45,91,18,0,18,16,29,27,5,10,93,121
2019,4,41900306,9/27/2020,1610612738,Boston Celtics,0,0,1610612748,Miami Heat,1,1,28,25,53,15,31,46,43,56,99,12,3,15,16,42,26,6,10,100,113
2019,4,41900306,9/27/2020,1610612748,Miami Heat,1,1,1610612738,Boston Celtics,0,0,32,21,53,13,14,27,45,35,80,22,4,26,5,31,30,7,12,102,125
2021,4,42100217,5/15/2022,1610612738,Boston Celtics,1,1,1610612749,Milwaukee Bucks,0,0,15,18,33,22,33,55,37,51,88,13,5,18,10,45,29,5,14,99,109
2021,4,42100217,5/15/2022,1610612749,Milwaukee Bucks,0,0,1610612738,Boston Celtics,1,1,29,28,57,4,29,33,33,57,90,11,5,16,14,45,20,5,13,99,81
2021,4,42100216,5/13/2022,1610612738,Boston Celtics,0,1,1610612749,Milwaukee Bucks,1,0,21,23,44,17,26,43,38,49,87,15,8,23,11,43,22,5,8,94,108
2021,4,42100216,5/13/2022,1610612749,Milwaukee Bucks,1,0,1610612738,Boston Celtics,0,1,29,30,59,7,22,29,36,52,88,16,2,18,13,40,15,5,11,94,95
2021,4,42100215,5/11/2022,1610612738,Boston Celtics,1,0,1610612749,Milwaukee Bucks,0,1,32,19,51,10,21,31,42,40,82,13,2,15,7,34,25,5,10,92,107
2021,4,42100215,5/11/2022,1610612749,Milwaukee Bucks,0,1,1610612738,Boston Celtics,1,0,27,36,63,13,16,29,40,52,92,17,4,21,23,32,22,6,13,93,110
2021,4,42100214,5/9/2022,1610612738,Boston Celtics,0,1,1610612749,Milwaukee Bucks,1,0,28,19,47,14,23,37,42,42,84,18,2,20,7,36,25,6,11,98,116
2021,4,42100214,5/9/2022,1610612749,Milwaukee Bucks,1,0,1610612738,Boston Celtics,0,1,30,37,67,9,18,27,39,55,94,21,6,27,18,40,18,2,8,98,108
2021,4,42100213,5/7/2022,1610612738,Boston Celtics,0,0,1610612749,Milwaukee Bucks,1,1,23,31,54,9,24,33,32,55,87,28,6,34,14,43,23,8,12,102,101
2021,4,42100213,5/7/2022,1610612749,Milwaukee Bucks,1,1,1610612738,Boston Celtics,0,0,31,34,65,9,25,34,40,59,99,14,3,17,18,42,20,5,12,101,103
2021,4,42100212,5/3/2022,1610612738,Boston Celtics,1,1,1610612749,Milwaukee Bucks,0,0,18,19,37,20,23,43,38,42,80,13,2,15,10,34,28,4,16,93,109
2021,4,42100212,5/3/2022,1610612749,Milwaukee Bucks,0,0,1610612738,Boston Celtics,1,1,31,24,55,3,15,18,34,39,73,15,8,23,9,34,16,10,17,93,86
2021,4,42100211,5/1/2022,1610612738,Boston Celtics,1,0,1610612749,Milwaukee Bucks,0,1,10,24,34,18,32,50,28,56,84,15,5,20,13,46,21,11,18,100,89
2021,4,42100211,5/1/2022,1610612749,Milwaukee Bucks,0,1,1610612738,Boston Celtics,1,0,25,31,56,12,22,34,37,53,90,15,6,21,16,39,22,8,14,100,101
2021,4,42100206,5/12/2022,1610612748,Miami Heat,0,1,1610612755,Philadelphia 76ers,1,0,35,24,59,7,21,28,42,45,87,8,3,11,18,29,19,8,16,89,99
2021,4,42100206,5/12/2022,1610612755,Philadelphia 76ers,1,0,1610612748,Miami Heat,0,1,24,26,50,12,25,37,36,51,87,6,1,7,13,39,21,7,13,90,90
2021,4,42100205,5/10/2022,1610612748,Miami Heat,1,1,1610612755,Philadelphia 76ers,0,0,32,19,51,13,20,33,45,39,84,17,6,23,14,30,26,8,11,93,120
2021,4,42100205,5/10/2022,1610612755,Philadelphia 76ers,0,0,1610612748,Miami Heat,1,1,22,31,53,9,23,32,31,54,85,14,1,15,15,39,14,8,16,93,85
2020,4,42000406,7/20/2021,1610612749,Milwaukee Bucks,1,1,1610612756,Phoenix Suns,0,0,31,24,55,6,21,27,37,45,82,25,4,29,15,32,20,11,19,101,105
2020,4,42000406,7/20/2021,1610612756,Phoenix Suns,0,0,1610612749,Milwaukee Bucks,1,1,32,29,61,6,19,25,38,48,86,16,3,19,7,42,14,10,15,101,98
2021,4,42100204,5/8/2022,1610612748,Miami Heat,0,0,1610612755,Philadelphia 76ers,1,1,31,16,47,7,28,35,38,44,82,25,3,28,13,32,24,5,13,98,108
2021,4,42100204,5/8/2022,1610612755,Philadelphia 76ers,1,1,1610612748,Miami Heat,0,0,21,14,35,16,17,33,37,31,68,26,8,34,5,30,25,9,17,96,116
2021,4,42100203,5/6/2022,1610612748,Miami Heat,0,0,1610612755,Philadelphia 76ers,1,1,20,27,47,7,23,30,27,50,77,18,6,24,14,38,14,7,13,87,79
2021,4,42100203,5/6/2022,1610612755,Philadelphia 76ers,1,1,1610612748,Miami Heat,0,0,16,18,34,16,17,33,32,35,67,19,3,22,10,26,22,11,19,88,99
2019,4,41900305,9/25/2020,1610612738,Boston Celtics,1,1,1610612748,Miami Heat,0,0,30,25,55,12,26,38,42,51,93,25,4,29,18,35,29,3,11,101,121
2019,4,41900305,9/25/2020,1610612748,Miami Heat,0,0,1610612738,Boston Celtics,1,1,32,18,50,7,29,36,39,47,86,23,6,29,10,40,27,7,13,100,108
2020,4,42000405,7/17/2021,1610612749,Milwaukee Bucks,0,1,1610612756,Phoenix Suns,1,0,36,23,59,14,14,28,50,37,87,9,8,17,15,27,26,9,12,90,123
2020,4,42000405,7/17/2021,1610612756,Phoenix Suns,1,0,1610612749,Milwaukee Bucks,0,1,35,33,68,13,6,19,48,39,87,10,1,11,12,28,23,7,9,91,119
2021,4,42100202,5/4/2022,1610612748,Miami Heat,1,1,1610612755,Philadelphia 76ers,0,0,26,23,49,14,15,29,40,38,78,25,6,31,12,30,25,10,14,93,119
2021,4,42100202,5/4/2022,1610612755,Philadelphia 76ers,0,0,1610612748,Miami Heat,1,1,30,24,54,8,22,30,38,46,84,19,3,22,9,40,17,5,10,94,103
2019,4,41900304,9/23/2020,1610612738,Boston Celtics,0,0,1610612748,Miami Heat,1,1,25,17,42,14,26,40,39,43,82,17,4,21,15,31,28,9,19,94,109
2019,4,41900304,9/23/2020,1610612748,Miami Heat,1,1,1610612738,Boston Celtics,0,0,29,25,54,10,27,37,39,52,91,24,3,27,17,37,20,3,8,95,112
2021,4,42100201,5/2/2022,1610612748,Miami Heat,1,1,1610612755,Philadelphia 76ers,0,0,31,25,56,9,27,36,40,52,92,17,1,18,21,32,21,4,13,93,106
2021,4,42100201,5/2/2022,1610612755,Philadelphia 76ers,0,0,1610612748,Miami Heat,1,1,28,17,45,6,28,34,34,45,79,18,2,20,12,35,18,5,15,92,92
2019,4,41900303,9/19/2020,1610612738,Boston Celtics,0,1,1610612748,Miami Heat,1,0,32,27,59,9,17,26,41,44,85,26,4,30,14,31,27,5,14,101,117
2019,4,41900303,9/19/2020,1610612748,Miami Heat,1,0,1610612738,Boston Celtics,0,1,21,20,41,12,32,44,33,52,85,28,6,34,14,42,21,8,13,101,106
2021,4,42100176,4/28/2022,1610612742,Dallas Mavericks,0,1,1610612762,Utah Jazz,1,0,19,18,37,17,26,43,36,44,80,9,2,11,5,39,22,5,10,90,98
2021,4,42100176,4/28/2022,1610612762,Utah Jazz,1,0,1610612742,Dallas Mavericks,0,1,27,22,49,9,26,35,36,48,84,15,5,20,15,37,20,6,11,92,96
2021,4,42100175,4/25/2022,1610612742,Dallas Mavericks,1,1,1610612762,Utah Jazz,0,0,25,17,42,12,31,43,37,48,85,16,5,21,15,35,16,8,11,91,102
2021,4,42100175,4/25/2022,1610612762,Utah Jazz,0,0,1610612742,Dallas Mavericks,1,1,26,21,47,3,27,30,29,48,77,16,5,21,9,40,12,6,13,90,77
2019,4,41900302,9/17/2020,1610612738,Boston Celtics,1,0,1610612748,Miami Heat,0,1,26,18,44,10,18,28,36,36,72,19,5,24,10,28,19,11,20,94,101
2019,4,41900302,9/17/2020,1610612748,Miami Heat,0,1,1610612738,Boston Celtics,1,0,26,21,47,14,29,43,40,50,90,12,2,14,14,38,27,5,11,93,106
2020,4,42000404,7/14/2021,1610612749,Milwaukee Bucks,1,1,1610612756,Phoenix Suns,0,0,32,36,68,7,22,29,39,58,97,24,5,29,21,40,22,3,5,95,109
2020,4,42000404,7/14/2021,1610612756,Phoenix Suns,0,0,1610612749,Milwaukee Bucks,1,1,33,22,55,7,16,23,40,38,78,16,3,19,8,31,18,11,17,97,103
2021,4,42100174,4/23/2022,1610612742,Dallas Mavericks,0,0,1610612762,Utah Jazz,1,1,18,15,33,15,29,44,33,44,77,18,5,23,11,37,15,4,12,91,99
2021,4,42100174,4/23/2022,1610612762,Utah Jazz,1,1,1610612742,Dallas Mavericks,0,0,22,22,44,10,25,35,32,47,79,26,16,42,19,37,17,4,8,90,100
2022,4,42200403,6/7/2023,1610612748,Miami Heat,1,0,1610612743,Denver Nuggets,0,1,23,34,57,11,24,35,34,58,92,15,4,19,14,45,20,3,4,92,94
2022,4,42200201,4/30/2023,1610612748,Miami Heat,0,1,1610612752,New York Knicks,1,0,23,23,46,13,26,39,36,49,85,23,6,29,14,38,26,6,9,95,108
2019,4,41900301,9/15/2020,1610612738,Boston Celtics,1,0,1610612748,Miami Heat,0,1,24,22,46,15,27,42,39,49,88,21,2,23,12,37,24,6,11,99,114
2019,4,41900301,9/15/2020,1610612748,Miami Heat,0,1,1610612738,Boston Celtics,1,0,24,25,49,16,20,36,40,45,85,21,7,28,13,34,32,9,13,98,117
2021,4,42100173,4/21/2022,1610612742,Dallas Mavericks,0,1,1610612762,Utah Jazz,1,0,23,18,41,18,24,42,41,42,83,26,5,31,10,33,24,2,9,93,126
2021,4,42100173,4/21/2022,1610612762,Utah Jazz,1,0,1610612742,Dallas Mavericks,0,1,30,11,41,9,19,28,39,30,69,31,2,33,4,28,20,10,14,93,118
2022,4,42200403,6/7/2023,1610612743,Denver Nuggets,0,1,1610612748,Miami Heat,1,0,36,26,62,5,13,18,41,39,80,22,5,27,17,24,28,7,14,91,109
2022,4,42200201,4/30/2023,1610612752,New York Knicks,1,0,1610612748,Miami Heat,0,1,34,18,52,7,27,34,41,45,86,12,8,20,16,33,20,8,13,95,101
2019,4,41900237,9/15/2020,1610612743,Denver Nuggets,0,1,1610612746,LA Clippers,1,0,25,15,40,13,24,37,38,39,77,15,1,16,14,25,22,7,19,93,104
2021,4,42100172,4/18/2022,1610612742,Dallas Mavericks,1,1,1610612762,Utah Jazz,0,0,17,19,36,22,25,47,39,44,83,10,3,13,5,40,22,2,3,88,110
2021,4,42100172,4/18/2022,1610612762,Utah Jazz,0,0,1610612742,Dallas Mavericks,1,1,27,26,53,11,18,29,38,44,82,17,3,20,14,31,19,5,10,87,104
2020,4,42000403,7/11/2021,1610612749,Milwaukee Bucks,1,1,1610612756,Phoenix Suns,0,0,29,25,54,14,22,36,43,47,90,20,6,26,15,36,28,3,9,97,120
2020,4,42000403,7/11/2021,1610612756,Phoenix Suns,0,0,1610612749,Milwaukee Bucks,1,1,31,21,52,9,22,31,40,43,83,11,5,16,9,35,21,8,15,97,100
2019,4,41900237,9/15/2020,1610612746,LA Clippers,1,0,1610612743,Denver Nuggets,0,1,25,30,55,9,26,35,34,56,90,12,4,16,16,43,21,5,11,92,89
2021,4,42100171,4/16/2022,1610612742,Dallas Mavericks,1,0,1610612762,Utah Jazz,0,1,20,24,44,9,23,32,29,47,76,26,8,34,9,42,17,3,7,88,93
2021,4,42100171,4/16/2022,1610612762,Utah Jazz,0,1,1610612742,Dallas Mavericks,1,0,29,32,61,7,15,22,36,47,83,20,3,23,19,29,15,8,15,89,99
2020,4,42000402,7/8/2021,1610612749,Milwaukee Bucks,0,0,1610612756,Phoenix Suns,1,1,33,29,62,9,22,31,42,51,93,15,8,23,20,34,21,7,9,94,108
2020,4,42000402,7/8/2021,1610612756,Phoenix Suns,1,1,1610612749,Milwaukee Bucks,0,0,23,25,48,20,20,40,43,45,88,12,2,14,15,31,26,8,13,93,118
2022,4,42200301,5/17/2023,1610612748,Miami Heat,0,1,1610612738,Boston Celtics,1,0,30,24,54,16,15,31,46,39,85,15,4,19,13,27,20,6,15,96,123
2021,4,42100165,4/27/2022,1610612743,Denver Nuggets,0,0,1610612744,Golden State Warriors,1,1,30,22,52,6,23,29,36,45,81,20,9,29,16,32,26,10,15,94,98
2021,4,42100165,4/27/2022,1610612744,Golden State Warriors,1,1,1610612743,Denver Nuggets,0,0,24,27,51,13,18,31,37,45,82,15,6,21,9,38,28,5,10,92,102
2021,4,42100164,4/24/2022,1610612743,Denver Nuggets,1,1,1610612744,Golden State Warriors,0,0,26,16,42,15,16,31,41,32,73,29,7,36,9,28,28,15,20,101,126
2019,4,41900236,9/13/2020,1610612743,Denver Nuggets,1,1,1610612746,LA Clippers,0,0,28,21,49,12,13,25,40,34,74,19,8,27,7,29,26,10,15,95,111
2019,4,41900236,9/13/2020,1610612746,LA Clippers,0,0,1610612743,Denver Nuggets,1,1,22,29,51,10,17,27,32,46,78,24,3,27,11,36,20,8,16,95,98
2019,4,41900235,9/11/2020,1610612743,Denver Nuggets,0,1,1610612746,LA Clippers,1,0,27,27,54,12,15,27,39,42,81,21,4,25,11,34,20,6,11,94,111
2019,4,41900235,9/11/2020,1610612746,LA Clippers,1,0,1610612743,Denver Nuggets,0,1,21,25,46,16,26,42,37,51,88,15,2,17,13,40,22,7,11,94,105
2021,4,42100164,4/24/2022,1610612744,Golden State Warriors,0,0,1610612743,Denver Nuggets,1,1,31,21,52,12,22,34,43,43,86,23,9,32,15,31,26,9,17,101,121
2019,4,41900234,9/9/2020,1610612743,Denver Nuggets,1,0,1610612746,LA Clippers,0,1,18,23,41,9,18,27,27,41,68,22,4,26,8,34,19,7,17,91,85
2019,4,41900234,9/9/2020,1610612746,LA Clippers,0,1,1610612743,Denver Nuggets,1,0,25,26,51,8,20,28,33,46,79,22,8,30,15,35,19,4,11,93,96
2022,4,42200301,5/17/2023,1610612738,Boston Celtics,1,0,1610612748,Miami Heat,0,1,32,20,52,10,19,29,42,39,81,22,7,29,13,30,22,12,15,96,116
2019,4,41900233,9/7/2020,1610612743,Denver Nuggets,1,0,1610612746,LA Clippers,0,1,33,27,60,11,23,34,44,50,94,8,2,10,12,39,32,7,12,100,107
2019,4,41900233,9/7/2020,1610612746,LA Clippers,0,1,1610612743,Denver Nuggets,1,0,30,14,44,11,20,31,41,34,75,20,6,26,6,30,23,10,17,101,113
2021,4,42100163,4/21/2022,1610612743,Denver Nuggets,1,0,1610612744,Golden State Warriors,0,1,29,25,54,11,15,26,40,40,80,22,5,27,14,28,25,7,18,99,113
2021,4,42100163,4/21/2022,1610612744,Golden State Warriors,0,1,1610612743,Denver Nuggets,1,0,23,11,34,18,22,40,41,33,74,18,10,28,5,34,29,9,16,98,118
2019,4,41900232,9/5/2020,1610612743,Denver Nuggets,0,1,1610612746,LA Clippers,1,0,26,25,51,15,25,40,41,50,91,13,4,17,16,36,18,9,12,95,110
2019,4,41900232,9/5/2020,1610612746,LA Clippers,1,0,1610612743,Denver Nuggets,0,1,27,29,56,9,23,32,36,52,88,20,9,29,24,32,20,9,17,94,101
2019,4,41900231,9/3/2020,1610612743,Denver Nuggets,0,0,1610612746,LA Clippers,1,1,26,21,47,9,27,36,35,48,83,18,9,27,14,38,20,7,15,97,97
2019,4,41900231,9/3/2020,1610612746,LA Clippers,1,1,1610612743,Denver Nuggets,0,0,38,22,60,10,14,24,48,36,84,14,3,17,10,28,23,9,15,97,120
2021,4,42100162,4/18/2022,1610612743,Denver Nuggets,0,0,1610612744,Golden State Warriors,1,1,24,27,51,13,23,36,37,50,87,19,2,21,22,30,20,10,18,95,106
2021,4,42100162,4/18/2022,1610612744,Golden State Warriors,1,1,1610612743,Denver Nuggets,0,0,29,15,44,17,23,40,46,38,84,17,7,24,10,33,27,4,9,95,126
2021,4,42100161,4/16/2022,1610612743,Denver Nuggets,0,0,1610612744,Golden State Warriors,1,1,32,26,58,11,24,35,43,50,93,10,3,13,17,34,26,5,11,94,107
2021,4,42100161,4/16/2022,1610612744,Golden State Warriors,1,1,1610612743,Denver Nuggets,0,0,27,20,47,16,19,35,43,39,82,21,8,29,14,27,33,8,13,92,123
2020,4,42000401,7/6/2021,1610612749,Milwaukee Bucks,0,0,1610612756,Phoenix Suns,1,1,24,28,52,16,20,36,40,48,88,9,7,16,10,39,21,9,14,100,105
2020,4,42000401,7/6/2021,1610612756,Phoenix Suns,1,1,1610612749,Milwaukee Bucks,0,0,30,24,54,11,23,34,41,47,88,25,1,26,9,39,18,4,9,101,118
2019,4,41900225,9/12/2020,1610612745,Houston Rockets,0,0,1610612747,Los Angeles Lakers,1,1,20,20,40,13,36,49,33,56,89,17,7,24,13,45,18,5,12,101,96
2019,4,41900225,9/12/2020,1610612747,Los Angeles Lakers,1,1,1610612745,Houston Rockets,0,0,20,17,37,19,18,37,39,35,74,22,7,29,10,27,25,6,20,101,119
2020,4,42000316,6/30/2021,1610612746,LA Clippers,1,0,1610612756,Phoenix Suns,0,1,21,19,40,12,27,39,33,46,79,25,7,32,11,39,18,5,10,96,103
2020,4,42000316,6/30/2021,1610612756,Phoenix Suns,0,1,1610612746,LA Clippers,1,0,36,27,63,17,14,31,53,41,94,7,4,11,16,26,27,5,10,96,130
2019,4,41900224,9/10/2020,1610612745,Houston Rockets,1,0,1610612747,Los Angeles Lakers,0,1,14,18,32,14,19,33,28,37,65,30,9,39,2,42,24,9,17,99,100
2019,4,41900224,9/10/2020,1610612747,Los Angeles Lakers,0,1,1610612745,Houston Rockets,1,0,34,24,58,9,21,30,43,45,88,15,1,16,16,29,30,10,18,99,110
2021,4,42100156,4/29/2022,1610612750,Minnesota Timberwolves,1,0,1610612763,Memphis Grizzlies,0,1,26,27,53,12,19,31,38,46,84,18,8,26,9,43,22,7,11,100,106
2021,4,42100156,4/29/2022,1610612763,Memphis Grizzlies,0,1,1610612750,Minnesota Timberwolves,1,0,25,29,54,15,17,32,40,46,86,19,5,24,17,32,24,12,19,99,114
2019,4,41900223,9/8/2020,1610612745,Houston Rockets,1,0,1610612747,Los Angeles Lakers,0,1,26,25,51,12,18,30,38,43,81,14,0,14,8,35,23,6,10,90,102
2019,4,41900223,9/8/2020,1610612747,Los Angeles Lakers,0,1,1610612745,Houston Rockets,1,0,33,15,48,10,20,30,43,35,78,16,7,23,13,25,25,8,15,90,112
2019,4,41900222,9/6/2020,1610612745,Houston Rockets,0,0,1610612747,Los Angeles Lakers,1,1,13,12,25,22,31,53,35,43,78,17,6,23,11,34,22,11,17,96,109
2019,4,41900222,9/6/2020,1610612747,Los Angeles Lakers,1,1,1610612745,Houston Rockets,0,0,35,21,56,12,15,27,47,36,83,11,7,18,11,28,30,7,16,95,117
2021,4,42100155,4/26/2022,1610612750,Minnesota Timberwolves,0,0,1610612763,Memphis Grizzlies,1,1,23,27,50,14,19,33,37,46,83,21,3,24,11,36,23,10,23,109,109
2021,4,42100155,4/26/2022,1610612763,Memphis Grizzlies,1,1,1610612750,Minnesota Timberwolves,0,0,32,34,66,7,21,28,39,55,94,26,13,39,20,40,24,9,16,108,111
2019,4,41900221,9/4/2020,1610612745,Houston Rockets,0,1,1610612747,Los Angeles Lakers,1,0,25,17,42,14,25,39,39,42,81,20,7,27,12,34,19,8,16,97,112
2019,4,41900221,9/4/2020,1610612747,Los Angeles Lakers,1,0,1610612745,Houston Rockets,0,1,24,21,45,11,27,38,35,48,83,16,3,19,11,38,18,13,17,97,97
2021,4,42100154,4/23/2022,1610612750,Minnesota Timberwolves,1,1,1610612763,Memphis Grizzlies,0,0,17,21,38,18,18,36,35,39,74,31,9,40,8,35,23,9,16,103,119
2021,4,42100154,4/23/2022,1610612763,Memphis Grizzlies,0,0,1610612750,Minnesota Timberwolves,1,1,27,27,54,15,17,32,42,44,86,19,6,25,12,33,31,7,19,104,118
2021,4,42100153,4/21/2022,1610612750,Minnesota Timberwolves,1,0,1610612763,Memphis Grizzlies,0,1,21,29,50,12,23,35,33,52,85,17,6,23,16,39,21,7,17,97,95
2021,4,42100153,4/21/2022,1610612763,Memphis Grizzlies,0,1,1610612750,Minnesota Timberwolves,1,0,21,25,46,14,23,37,35,48,83,20,11,31,20,34,22,11,18,96,104
2022,4,42200221,4/29/2023,1610612756,Phoenix Suns,0,0,1610612743,Denver Nuggets,1,1,36,25,61,7,16,23,43,41,84,14,3,17,9,34,20,14,16,96,107
2021,4,42100152,4/19/2022,1610612750,Minnesota Timberwolves,0,0,1610612763,Memphis Grizzlies,1,1,19,19,38,11,27,38,30,46,76,25,3,28,9,38,16,9,20,102,96
2021,4,42100152,4/19/2022,1610612763,Memphis Grizzlies,1,1,1610612750,Minnesota Timberwolves,0,0,33,25,58,11,23,34,44,48,92,25,7,32,16,38,29,5,12,101,124
2020,4,42000315,6/28/2021,1610612746,LA Clippers,0,1,1610612756,Phoenix Suns,1,0,36,18,54,10,20,30,46,38,84,14,1,15,4,34,20,6,10,95,116
2020,4,42000315,6/28/2021,1610612756,Phoenix Suns,1,0,1610612746,LA Clippers,0,1,29,29,58,9,17,26,38,46,84,17,3,20,8,40,22,8,14,96,102
2019,4,41900217,9/11/2020,1610612738,Boston Celtics,0,1,1610612761,Toronto Raptors,1,0,26,22,48,9,29,38,35,51,86,13,10,23,17,40,19,1,12,92,92
2019,4,41900217,9/11/2020,1610612761,Toronto Raptors,1,0,1610612738,Boston Celtics,0,1,23,24,47,8,20,28,31,44,75,17,2,19,11,34,17,12,18,93,87
2022,4,42200134,4/23/2023,1610612739,Cleveland Cavaliers,0,0,1610612752,New York Knicks,1,1,30,24,54,6,17,23,36,41,77,15,4,19,10,33,24,5,13,88,93
2022,4,42200221,4/29/2023,1610612743,Denver Nuggets,1,1,1610612756,Phoenix Suns,0,0,32,32,64,16,21,37,48,53,101,13,2,15,23,31,22,4,10,98,125
2022,4,42200204,5/8/2023,1610612748,Miami Heat,1,1,1610612752,New York Knicks,0,0,27,19,46,13,26,39,40,45,85,16,6,22,18,29,28,5,13,91,109
2022,4,42200134,4/23/2023,1610612752,New York Knicks,1,1,1610612739,Cleveland Cavaliers,0,0,30,25,55,8,21,29,38,46,84,18,10,28,22,30,15,3,14,89,102
2022,4,42200204,5/8/2023,1610612752,New York Knicks,0,0,1610612748,Miami Heat,1,1,28,20,48,9,19,28,37,39,76,18,6,24,11,32,21,7,17,91,101
2021,4,42100151,4/16/2022,1610612750,Minnesota Timberwolves,0,1,1610612763,Memphis Grizzlies,1,0,29,20,49,16,25,41,45,45,90,24,3,27,15,31,32,7,19,105,130
2021,4,42100151,4/16/2022,1610612763,Memphis Grizzlies,1,0,1610612750,Minnesota Timberwolves,0,1,32,27,59,7,20,27,39,47,86,32,11,43,12,39,25,5,12,106,117
2019,4,41900216,9/9/2020,1610612738,Boston Celtics,1,0,1610612761,Toronto Raptors,0,1,25,29,54,19,27,46,44,56,100,15,3,18,15,42,32,10,16,109,122
2019,4,41900216,9/9/2020,1610612761,Toronto Raptors,0,1,1610612738,Boston Celtics,1,0,25,29,54,19,28,47,44,57,101,18,7,25,13,49,22,5,13,111,125
2021,4,42100146,4/28/2022,1610612740,New Orleans Pelicans,1,0,1610612756,Phoenix Suns,0,1,34,25,59,8,16,24,42,41,83,17,2,19,15,27,25,8,17,94,109
2021,4,42100146,4/28/2022,1610612756,Phoenix Suns,0,1,1610612740,New Orleans Pelicans,1,0,37,18,55,8,12,20,45,30,75,17,1,18,5,25,23,9,14,92,115
2019,4,41900215,9/7/2020,1610612738,Boston Celtics,0,1,1610612761,Toronto Raptors,1,0,27,16,43,11,23,34,38,39,77,24,3,27,7,32,23,8,13,96,111
2019,4,41900215,9/7/2020,1610612761,Toronto Raptors,1,0,1610612738,Boston Celtics,0,1,21,24,45,12,28,40,33,52,85,11,2,13,11,43,19,5,14,95,89
2020,4,42000314,6/26/2021,1610612746,LA Clippers,1,0,1610612756,Phoenix Suns,0,1,22,30,52,5,26,31,27,56,83,21,11,32,19,45,13,4,12,94,80
2020,4,42000314,6/26/2021,1610612756,Phoenix Suns,0,1,1610612746,LA Clippers,1,0,27,39,66,4,16,20,31,55,86,18,3,21,18,39,16,4,14,94,84
2019,4,41900214,9/5/2020,1610612738,Boston Celtics,1,0,1610612761,Toronto Raptors,0,1,26,14,40,7,28,35,33,42,75,20,7,27,8,36,18,4,14,93,93
2019,4,41900214,9/5/2020,1610612761,Toronto Raptors,0,1,1610612738,Boston Celtics,1,0,17,25,42,17,27,44,34,52,86,15,4,19,14,40,23,6,12,95,100
2021,4,42100145,4/26/2022,1610612740,New Orleans Pelicans,0,0,1610612756,Phoenix Suns,1,1,27,28,55,5,20,25,32,48,80,28,7,35,17,35,14,10,15,96,97
2021,4,42100145,4/26/2022,1610612756,Phoenix Suns,1,1,1610612740,New Orleans Pelicans,0,0,33,26,59,10,17,27,43,43,86,16,4,20,10,35,28,6,10,95,112
2022,4,42200404,6/9/2023,1610612743,Denver Nuggets,0,1,1610612748,Miami Heat,1,0,25,26,51,14,14,28,39,40,79,16,5,21,7,33,26,2,8,89,108
2022,4,42200404,6/9/2023,1610612748,Miami Heat,1,0,1610612743,Denver Nuggets,0,1,27,26,53,8,17,25,35,43,78,17,3,20,12,33,23,11,15,91,95
2022,4,42200167,4/30/2023,1610612758,Sacramento Kings,1,0,1610612744,Golden State Warriors,0,1,24,25,49,12,35,47,36,60,96,16,11,27,21,42,21,4,8,98,100
2022,4,42200167,4/30/2023,1610612744,Golden State Warriors,0,1,1610612758,Sacramento Kings,1,0,28,26,54,15,31,46,43,57,100,19,11,30,24,39,25,3,7,96,120
2019,4,41900213,9/3/2020,1610612738,Boston Celtics,1,0,1610612761,Toronto Raptors,0,1,30,24,54,9,20,29,39,44,83,16,5,21,11,35,21,7,15,94,103
2019,4,41900213,9/3/2020,1610612761,Toronto Raptors,0,1,1610612738,Boston Celtics,1,0,28,20,48,13,27,40,41,47,88,9,7,16,13,39,23,6,13,95,104
2021,4,42100144,4/24/2022,1610612740,New Orleans Pelicans,1,1,1610612756,Phoenix Suns,0,0,34,27,61,6,18,24,40,45,85,32,10,42,22,28,20,6,9,90,118
2021,4,42100144,4/24/2022,1610612756,Phoenix Suns,0,0,1610612740,New Orleans Pelicans,1,1,36,22,58,7,20,27,43,42,85,10,5,15,14,31,33,8,13,90,103
2020,4,42000313,6/24/2021,1610612746,LA Clippers,1,1,1610612756,Phoenix Suns,0,0,25,23,48,12,22,34,37,45,82,20,4,24,12,33,20,5,12,93,106
2020,4,42000313,6/24/2021,1610612756,Phoenix Suns,0,0,1610612746,LA Clippers,1,1,25,33,58,10,22,32,35,55,90,12,1,13,14,42,24,8,11,94,92
2019,4,41900212,9/1/2020,1610612738,Boston Celtics,0,1,1610612761,Toronto Raptors,1,0,17,21,38,15,23,38,32,44,76,23,2,25,8,37,18,10,17,97,102
2019,4,41900212,9/1/2020,1610612761,Toronto Raptors,1,0,1610612738,Boston Celtics,0,1,25,25,50,11,29,40,36,54,90,16,3,19,13,43,25,6,12,98,99
2021,4,42100143,4/22/2022,1610612740,New Orleans Pelicans,1,0,1610612756,Phoenix Suns,0,1,27,20,47,11,21,32,38,41,79,24,7,31,15,30,17,8,15,95,111
2021,4,42100143,4/22/2022,1610612756,Phoenix Suns,0,1,1610612740,New Orleans Pelicans,1,0,40,21,61,4,22,26,44,43,87,22,5,27,11,35,26,4,6,95,114
2020,4,42000312,6/22/2021,1610612746,LA Clippers,0,0,1610612756,Phoenix Suns,1,1,23,23,46,13,21,34,36,44,80,18,6,24,13,34,18,5,10,91,103
2020,4,42000312,6/22/2021,1610612756,Phoenix Suns,1,1,1610612746,LA Clippers,0,0,35,21,56,6,20,26,41,41,82,16,2,18,8,34,24,3,9,91,104
2021,4,42100142,4/19/2022,1610612740,New Orleans Pelicans,0,1,1610612756,Phoenix Suns,1,0,29,25,54,17,13,30,46,38,84,16,4,20,15,25,32,9,17,96,125
2021,4,42100142,4/19/2022,1610612756,Phoenix Suns,1,0,1610612740,New Orleans Pelicans,0,1,30,21,51,13,22,35,43,43,86,15,3,18,10,33,26,7,13,97,114
2021,4,42100141,4/17/2022,1610612740,New Orleans Pelicans,0,0,1610612756,Phoenix Suns,1,1,27,45,72,9,14,23,36,59,95,18,8,26,29,34,20,6,14,91,99
2021,4,42100141,4/17/2022,1610612756,Phoenix Suns,1,1,1610612740,New Orleans Pelicans,0,0,32,18,50,10,18,28,42,36,78,16,5,21,7,32,25,4,10,92,110
2019,4,41900211,8/30/2020,1610612738,Boston Celtics,0,1,1610612761,Toronto Raptors,1,0,22,22,44,17,22,39,39,44,83,17,4,21,9,37,25,10,23,105,112
2019,4,41900211,8/30/2020,1610612761,Toronto Raptors,1,0,1610612738,Boston Celtics,0,1,21,23,44,10,30,40,31,53,84,22,7,29,8,48,22,8,14,104,94
2021,4,42100136,4/28/2022,1610612755,Philadelphia 76ers,0,1,1610612761,Toronto Raptors,1,0,31,10,41,16,24,40,47,34,81,22,1,23,11,23,32,6,11,93,132
2021,4,42100136,4/28/2022,1610612761,Toronto Raptors,1,0,1610612755,Philadelphia 76ers,0,1,28,26,54,7,28,35,35,54,89,20,5,25,18,39,15,4,10,92,97
2021,4,42100135,4/25/2022,1610612755,Philadelphia 76ers,1,0,1610612761,Toronto Raptors,0,1,21,23,44,10,27,37,31,50,81,16,4,20,13,40,21,8,16,93,88
2019,4,41900205,9/8/2020,1610612748,Miami Heat,0,1,1610612749,Milwaukee Bucks,1,0,24,18,42,11,20,31,35,38,73,22,2,24,8,30,21,7,22,99,103
2019,4,41900205,9/8/2020,1610612749,Milwaukee Bucks,1,0,1610612748,Miami Heat,0,1,24,34,58,9,24,33,33,58,91,19,7,26,17,47,20,6,11,99,94
2021,4,42100135,4/25/2022,1610612761,Toronto Raptors,0,1,1610612755,Philadelphia 76ers,1,0,34,17,51,8,23,31,42,40,82,11,2,13,5,35,24,7,9,93,103
2021,4,42100134,4/23/2022,1610612755,Philadelphia 76ers,0,0,1610612761,Toronto Raptors,1,1,21,28,49,13,18,31,34,46,80,21,4,25,10,37,24,9,16,98,102
2021,4,42100134,4/23/2022,1610612761,Toronto Raptors,1,1,1610612755,Philadelphia 76ers,0,0,29,25,54,8,26,34,37,51,88,28,7,35,16,37,19,4,11,99,110
2022,4,42200112,4/18/2023,1610612737,Atlanta Hawks,0,0,1610612738,Boston Celtics,1,1,27,26,53,16,32,48,43,58,101,4,4,8,19,41,21,10,16,101,106
2021,4,42100133,4/20/2022,1610612755,Philadelphia 76ers,0,1,1610612761,Toronto Raptors,1,0,25,18,43,13,18,31,38,36,74,15,5,20,13,24,18,9,24,93,104
2021,4,42100133,4/20/2022,1610612761,Toronto Raptors,1,0,1610612755,Philadelphia 76ers,0,1,25,26,51,13,22,35,38,48,86,12,6,18,13,39,23,5,11,93,101
2019,4,41900204,9/6/2020,1610612748,Miami Heat,1,0,1610612749,Milwaukee Bucks,0,1,23,20,43,17,30,47,40,50,90,18,2,20,14,37,33,10,16,102,115
2019,4,41900204,9/6/2020,1610612749,Milwaukee Bucks,0,1,1610612748,Miami Heat,1,0,34,23,57,11,24,35,45,47,92,17,5,22,11,39,25,8,12,102,118
2021,4,42100132,4/18/2022,1610612755,Philadelphia 76ers,1,1,1610612761,Toronto Raptors,0,0,22,17,39,14,16,30,36,33,69,26,4,30,11,23,20,7,16,87,112
2021,4,42100132,4/18/2022,1610612761,Toronto Raptors,0,0,1610612755,Philadelphia 76ers,1,1,27,30,57,11,21,32,38,51,89,10,2,12,17,36,16,5,11,88,97
2020,4,42000311,6/20/2021,1610612746,LA Clippers,0,0,1610612756,Phoenix Suns,1,1,20,21,41,20,27,47,40,48,88,14,3,17,12,37,23,5,9,95,114
2020,4,42000311,6/20/2021,1610612756,Phoenix Suns,1,1,1610612746,LA Clippers,0,0,36,21,57,13,19,32,49,40,89,9,0,9,9,31,31,6,7,94,120
2022,4,42200112,4/18/2023,1610612738,Boston Celtics,1,1,1610612737,Atlanta Hawks,0,0,33,20,53,15,18,33,48,38,86,8,2,10,7,33,28,10,16,100,119
2019,4,41900203,9/4/2020,1610612748,Miami Heat,1,1,1610612749,Milwaukee Bucks,0,0,17,14,31,18,29,47,35,43,78,27,7,34,10,37,27,8,12,96,115
2019,4,41900203,9/4/2020,1610612749,Milwaukee Bucks,0,0,1610612748,Miami Heat,1,1,26,25,51,11,26,37,37,51,88,15,6,21,10,44,23,3,10,98,100
2021,4,42100131,4/16/2022,1610612755,Philadelphia 76ers,1,1,1610612761,Toronto Raptors,0,0,27,25,52,16,16,32,43,41,84,29,5,34,13,30,29,1,4,89,131
2021,4,42100131,4/16/2022,1610612761,Toronto Raptors,0,0,1610612755,Philadelphia 76ers,1,1,28,24,52,12,18,30,40,42,82,19,4,23,12,31,27,6,8,91,111
2021,4,42100125,4/27/2022,1610612741,Chicago Bulls,0,0,1610612749,Milwaukee Bucks,1,1,24,16,40,15,37,52,39,53,92,7,4,11,9,47,24,10,16,105,100
2021,4,42100125,4/27/2022,1610612749,Milwaukee Bucks,1,1,1610612741,Chicago Bulls,0,0,29,22,51,14,22,36,43,44,87,16,4,20,9,35,23,12,16,104,116
2019,4,41900202,9/2/2020,1610612748,Miami Heat,0,1,1610612749,Milwaukee Bucks,1,0,20,16,36,17,28,45,37,44,81,25,7,32,10,36,22,6,10,97,116
2019,4,41900202,9/2/2020,1610612749,Milwaukee Bucks,1,0,1610612748,Miami Heat,0,1,30,30,60,7,18,25,37,48,85,33,6,39,18,34,16,12,14,96,114
2021,4,42100124,4/24/2022,1610612741,Chicago Bulls,1,0,1610612749,Milwaukee Bucks,0,1,26,28,54,9,27,36,35,55,90,16,1,17,10,46,27,6,12,99,95
2021,4,42100124,4/24/2022,1610612749,Milwaukee Bucks,0,1,1610612741,Chicago Bulls,1,0,28,25,53,17,16,33,45,41,86,12,6,18,7,37,21,5,15,101,119
2019,4,41900201,8/31/2020,1610612748,Miami Heat,0,1,1610612749,Milwaukee Bucks,1,0,27,26,53,12,19,31,39,45,84,25,2,27,15,30,21,6,16,99,115
2019,4,41900201,8/31/2020,1610612749,Milwaukee Bucks,1,0,1610612748,Miami Heat,0,1,21,19,40,16,19,35,37,38,75,14,12,26,7,36,22,8,19,98,104
2019,4,41900177,9/2/2020,1610612745,Houston Rockets,1,1,1610612760,Oklahoma City Thunder,0,0,18,21,39,17,32,49,35,53,88,17,2,19,13,41,18,6,12,97,104
2019,4,41900177,9/2/2020,1610612760,Oklahoma City Thunder,0,0,1610612745,Houston Rockets,1,1,19,23,42,16,18,34,35,41,76,16,5,21,10,34,24,11,22,98,102
2021,4,42100123,4/22/2022,1610612741,Chicago Bulls,1,0,1610612749,Milwaukee Bucks,0,1,24,26,50,9,25,34,33,51,84,6,4,10,5,48,22,8,13,96,81
2021,4,42100123,4/22/2022,1610612749,Milwaukee Bucks,0,1,1610612741,Chicago Bulls,1,0,28,22,50,15,26,41,43,48,91,10,4,14,10,42,27,5,10,97,111
2018,4,41800201,4/28/2019,1610612738,Boston Celtics,0,1,1610612749,Milwaukee Bucks,1,0,34,22,56,13,18,31,47,40,87,5,3,8,6,37,25,6,13,100,112
2021,4,42100122,4/20/2022,1610612741,Chicago Bulls,0,1,1610612749,Milwaukee Bucks,1,0,32,32,64,12,13,25,44,45,89,14,1,15,10,36,25,4,13,100,114
2021,4,42100122,4/20/2022,1610612749,Milwaukee Bucks,1,0,1610612741,Chicago Bulls,0,1,24,22,46,14,22,36,38,44,82,20,11,31,12,38,27,7,15,100,110
2018,4,41800201,4/28/2019,1610612749,Milwaukee Bucks,1,0,1610612738,Boston Celtics,0,1,18,32,50,13,26,39,31,58,89,15,9,24,13,49,19,5,11,98,90
2021,4,42100121,4/17/2022,1610612741,Chicago Bulls,0,0,1610612749,Milwaukee Bucks,1,1,24,35,59,7,30,37,31,65,96,17,2,19,17,48,17,4,11,99,86
2021,4,42100121,4/17/2022,1610612749,Milwaukee Bucks,1,1,1610612741,Chicago Bulls,0,0,24,22,46,10,28,38,34,50,84,15,8,23,17,38,19,10,21,100,93
2021,4,42100114,4/25/2022,1610612738,Boston Celtics,0,1,1610612751,Brooklyn Nets,1,0,28,26,54,14,21,35,42,47,89,18,4,22,18,31,26,5,13,96,116
2021,4,42100114,4/25/2022,1610612751,Brooklyn Nets,1,0,1610612738,Boston Celtics,0,1,28,18,46,13,22,35,41,40,81,17,12,29,10,37,28,3,10,94,112
2021,4,42100113,4/23/2022,1610612738,Boston Celtics,0,1,1610612751,Brooklyn Nets,1,0,30,15,45,12,27,39,42,42,84,13,1,14,16,26,26,7,14,89,109
2021,4,42100113,4/23/2022,1610612751,Brooklyn Nets,1,0,1610612738,Boston Celtics,0,1,27,21,48,12,17,29,39,38,77,13,3,16,18,21,25,13,21,90,103
2019,4,41900176,8/31/2020,1610612745,Houston Rockets,0,0,1610612760,Oklahoma City Thunder,1,1,23,17,40,15,29,44,38,46,84,9,3,12,6,42,19,10,22,105,100
2019,4,41900176,8/31/2020,1610612760,Oklahoma City Thunder,1,1,1610612745,Houston Rockets,0,0,26,27,53,12,24,36,38,51,89,16,2,18,14,39,17,14,19,104,104
2021,4,42100112,4/20/2022,1610612738,Boston Celtics,1,1,1610612751,Brooklyn Nets,0,0,28,16,44,11,20,31,39,36,75,25,6,31,10,30,27,8,14,93,114
2021,4,42100112,4/20/2022,1610612751,Brooklyn Nets,0,0,1610612738,Boston Celtics,1,1,25,30,55,10,11,21,35,41,76,27,7,34,13,32,16,7,14,95,107
2019,4,41900175,8/29/2020,1610612745,Houston Rockets,1,1,1610612760,Oklahoma City Thunder,0,0,24,28,52,19,29,48,43,57,100,9,5,14,14,46,28,3,11,105,114
2019,4,41900175,8/29/2020,1610612760,Oklahoma City Thunder,0,0,1610612745,Houston Rockets,1,1,22,24,46,7,39,46,29,63,92,15,8,23,18,49,11,12,18,105,80
2019,4,41900174,8/24/2020,1610612745,Houston Rockets,0,0,1610612760,Oklahoma City Thunder,1,1,18,15,33,23,35,58,41,50,91,9,1,10,9,41,25,6,14,99,114
2019,4,41900174,8/24/2020,1610612760,Oklahoma City Thunder,1,1,1610612745,Houston Rockets,0,0,31,23,54,11,21,32,42,44,86,22,6,28,13,35,16,7,15,100,117
2022,4,42200312,5/18/2023,1610612743,Denver Nuggets,1,1,1610612747,Los Angeles Lakers,0,0,25,26,51,14,24,38,39,50,89,16,2,18,13,39,27,10,17,101,108
2019,4,41900173,8/22/2020,1610612745,Houston Rockets,0,0,1610612760,Oklahoma City Thunder,1,1,23,19,42,15,35,50,38,54,92,16,7,23,6,52,14,8,16,112,107
2019,4,41900173,8/22/2020,1610612760,Oklahoma City Thunder,1,1,1610612745,Houston Rockets,0,0,27,24,51,14,27,41,41,51,92,23,11,34,13,46,20,9,18,114,119
2022,4,42200312,5/18/2023,1610612747,Los Angeles Lakers,0,0,1610612743,Denver Nuggets,1,1,28,24,52,8,22,30,36,46,82,23,3,26,7,40,26,8,12,101,103
2019,4,41900172,8/20/2020,1610612745,Houston Rockets,1,1,1610612760,Oklahoma City Thunder,0,0,19,16,35,19,37,56,38,53,91,16,2,18,14,41,21,2,7,93,111
2019,4,41900172,8/20/2020,1610612760,Oklahoma City Thunder,0,0,1610612745,Houston Rockets,1,1,24,23,47,11,21,32,35,44,79,17,2,19,10,34,15,8,14,93,98
2021,4,42100111,4/17/2022,1610612738,Boston Celtics,1,1,1610612751,Brooklyn Nets,0,0,30,26,56,12,21,33,42,47,89,19,5,24,20,28,24,12,15,98,115
2019,4,41900171,8/18/2020,1610612745,Houston Rockets,1,1,1610612760,Oklahoma City Thunder,0,0,23,14,37,20,32,52,43,46,89,17,2,19,6,42,25,2,7,96,123
2019,4,41900171,8/18/2020,1610612760,Oklahoma City Thunder,0,0,1610612745,Houston Rockets,1,1,24,25,49,13,22,35,37,47,84,21,4,25,14,35,22,4,13,99,108
2019,4,41900167,9/1/2020,1610612743,Denver Nuggets,1,1,1610612762,Utah Jazz,0,0,23,29,52,8,23,31,31,52,83,10,3,13,13,41,21,6,11,88,80
2019,4,41900167,9/1/2020,1610612762,Utah Jazz,0,0,1610612743,Denver Nuggets,1,1,22,23,45,8,26,34,30,49,79,10,5,15,13,40,16,7,14,89,78
2021,4,42100111,4/17/2022,1610612751,Brooklyn Nets,0,0,1610612738,Boston Celtics,1,1,31,23,54,11,13,24,42,36,78,19,5,24,8,30,20,12,16,97,114
2019,4,41900166,8/30/2020,1610612743,Denver Nuggets,0,1,1610612762,Utah Jazz,1,0,21,14,35,18,18,36,39,32,71,23,3,26,8,25,22,8,16,92,119
2019,4,41900166,8/30/2020,1610612762,Utah Jazz,1,0,1610612743,Denver Nuggets,0,1,16,23,39,18,18,36,34,41,75,21,9,30,7,39,20,8,10,93,107
2021,4,42100105,4/26/2022,1610612737,Atlanta Hawks,0,0,1610612748,Miami Heat,1,1,23,26,49,8,17,25,31,43,74,24,4,28,15,30,15,12,19,90,94
2019,4,41900165,8/25/2020,1610612743,Denver Nuggets,1,1,1610612762,Utah Jazz,0,0,27,23,50,16,19,35,43,42,85,15,1,16,9,33,22,7,10,96,117
2019,4,41900165,8/25/2020,1610612762,Utah Jazz,0,0,1610612743,Denver Nuggets,1,1,23,21,44,16,18,34,39,39,78,13,3,16,6,35,23,4,15,94,107
2019,4,41900164,8/23/2020,1610612743,Denver Nuggets,0,0,1610612762,Utah Jazz,1,1,32,24,56,17,27,44,49,51,100,12,1,13,20,32,25,2,6,93,127
2019,4,41900164,8/23/2020,1610612762,Utah Jazz,1,1,1610612743,Denver Nuggets,0,0,28,16,44,14,15,29,42,31,73,31,5,36,8,24,14,2,10,92,129
2021,4,42100105,4/26/2022,1610612748,Miami Heat,1,1,1610612737,Atlanta Hawks,0,0,30,21,51,7,24,31,37,45,82,16,5,21,15,33,19,8,14,90,97
2019,4,41900163,8/21/2020,1610612743,Denver Nuggets,0,0,1610612762,Utah Jazz,1,1,21,29,50,12,26,38,33,55,88,9,2,11,18,37,20,9,17,93,87
2019,4,41900163,8/21/2020,1610612762,Utah Jazz,1,1,1610612743,Denver Nuggets,0,0,25,22,47,18,19,37,43,41,84,20,6,26,15,30,27,2,11,93,124
2019,4,41900162,8/19/2020,1610612743,Denver Nuggets,1,0,1610612762,Utah Jazz,0,1,24,30,54,13,14,27,37,44,81,18,5,23,16,30,22,5,12,88,105
2019,4,41900162,8/19/2020,1610612762,Utah Jazz,0,1,1610612743,Denver Nuggets,1,0,25,18,43,20,24,44,45,42,87,14,3,17,14,30,32,1,8,88,124
2019,4,41900161,8/17/2020,1610612743,Denver Nuggets,1,1,1610612762,Utah Jazz,0,0,27,27,54,22,19,41,49,46,95,15,3,18,11,37,23,6,12,106,135
2019,4,41900161,8/17/2020,1610612762,Utah Jazz,0,0,1610612743,Denver Nuggets,1,1,30,20,50,16,31,47,46,51,97,17,6,23,19,35,18,10,16,106,125
2021,4,42100104,4/24/2022,1610612737,Atlanta Hawks,1,0,1610612748,Miami Heat,0,1,15,18,33,15,27,42,30,45,75,11,9,20,13,37,18,8,15,89,86
2021,4,42100104,4/24/2022,1610612748,Miami Heat,0,1,1610612737,Atlanta Hawks,1,0,27,23,50,13,29,42,40,52,92,17,4,21,20,34,22,2,7,88,110
2020,4,42000306,7/3/2021,1610612737,Atlanta Hawks,1,0,1610612749,Milwaukee Bucks,0,1,26,34,60,12,20,32,38,54,92,19,4,23,19,36,22,11,16,100,107
2020,4,42000306,7/3/2021,1610612749,Milwaukee Bucks,0,1,1610612737,Atlanta Hawks,1,0,24,20,44,17,28,45,41,48,89,19,2,21,15,34,24,11,15,100,118
2022,4,42200234,5/8/2023,1610612744,Golden State Warriors,0,0,1610612747,Los Angeles Lakers,1,1,28,17,45,12,29,41,40,46,86,9,3,12,11,37,29,8,16,97,101
2019,4,41900156,8/30/2020,1610612742,Dallas Mavericks,1,0,1610612746,LA Clippers,0,1,27,26,53,11,26,37,38,52,90,10,7,17,11,44,20,8,12,97,97
2019,4,41900156,8/30/2020,1610612746,LA Clippers,0,1,1610612742,Dallas Mavericks,1,0,33,29,62,11,18,29,44,47,91,12,1,13,10,38,22,5,13,98,111
2022,4,42200234,5/8/2023,1610612747,Los Angeles Lakers,1,1,1610612744,Golden State Warriors,0,0,33,28,61,6,19,25,39,47,86,20,0,20,14,33,21,9,14,97,104
2022,4,42200132,4/18/2023,1610612752,New York Knicks,0,0,1610612739,Cleveland Cavaliers,1,1,22,28,50,7,22,29,29,50,79,25,5,30,19,35,16,10,18,91,90
2022,4,42200211,5/1/2023,1610612755,Philadelphia 76ers,0,1,1610612738,Boston Celtics,1,0,28,23,51,17,21,38,45,44,89,12,0,12,14,30,17,3,8,89,119
2021,4,42100103,4/22/2022,1610612737,Atlanta Hawks,1,1,1610612748,Miami Heat,0,0,29,19,48,12,20,32,41,39,80,17,4,21,6,35,23,6,11,93,111
2021,4,42100103,4/22/2022,1610612748,Miami Heat,0,0,1610612737,Atlanta Hawks,1,1,27,21,48,14,31,45,41,52,93,14,3,17,22,31,30,5,15,95,110
2022,4,42200132,4/18/2023,1610612739,Cleveland Cavaliers,1,1,1610612752,New York Knicks,0,0,24,20,44,14,19,33,38,39,77,17,4,21,15,24,26,14,18,91,107
2022,4,42200211,5/1/2023,1610612738,Boston Celtics,1,0,1610612755,Philadelphia 76ers,0,1,34,15,49,10,16,26,44,31,75,17,1,18,10,22,26,10,16,90,115
2019,4,41900155,8/25/2020,1610612742,Dallas Mavericks,0,0,1610612746,LA Clippers,1,1,26,22,48,12,25,37,38,47,85,23,10,33,11,42,19,5,13,106,111
2019,4,41900155,8/25/2020,1610612746,LA Clippers,1,1,1610612742,Dallas Mavericks,0,0,31,18,49,22,13,35,53,31,84,26,8,34,9,25,28,8,16,105,154
2021,4,42100102,4/19/2022,1610612737,Atlanta Hawks,0,0,1610612748,Miami Heat,1,1,29,18,47,12,28,40,41,46,87,11,3,14,13,34,21,9,19,99,105
2021,4,42100102,4/19/2022,1610612748,Miami Heat,1,1,1610612737,Atlanta Hawks,0,0,24,19,43,14,22,36,38,41,79,25,4,29,8,34,21,6,15,98,115
2019,4,41900154,8/23/2020,1610612742,Dallas Mavericks,1,1,1610612746,LA Clippers,0,0,39,29,68,13,23,36,52,52,104,18,6,24,18,35,20,7,12,112,135
2019,4,41900154,8/23/2020,1610612746,LA Clippers,0,0,1610612742,Dallas Mavericks,1,1,31,28,59,14,24,38,45,52,97,29,3,32,10,45,19,7,9,111,133
2019,4,41900153,8/21/2020,1610612742,Dallas Mavericks,1,0,1610612746,LA Clippers,0,1,27,17,44,17,26,43,44,43,87,17,7,24,7,39,27,7,9,100,122
2019,4,41900153,8/21/2020,1610612746,LA Clippers,0,1,1610612742,Dallas Mavericks,1,0,33,23,56,14,20,34,47,43,90,22,5,27,10,37,24,5,7,101,130
2021,4,42100101,4/17/2022,1610612737,Atlanta Hawks,0,0,1610612748,Miami Heat,1,1,19,20,39,10,26,36,29,46,75,23,4,27,10,39,16,12,18,97,91
2021,4,42100101,4/17/2022,1610612748,Miami Heat,1,1,1610612737,Atlanta Hawks,0,0,25,19,44,18,20,38,43,39,82,11,7,18,8,34,35,8,15,96,115
2022,4,42200215,5/9/2023,1610612755,Philadelphia 76ers,0,1,1610612738,Boston Celtics,1,0,28,21,49,12,18,30,40,39,79,23,4,27,11,29,20,4,13,94,115
2019,4,41900152,8/19/2020,1610612742,Dallas Mavericks,0,1,1610612746,LA Clippers,1,0,31,28,59,13,16,29,44,44,88,26,11,37,9,40,25,4,9,107,127
2019,4,41900152,8/19/2020,1610612746,LA Clippers,1,0,1610612742,Dallas Mavericks,0,1,27,23,50,10,24,34,37,47,84,30,9,39,11,43,16,5,15,106,114
2019,4,41900151,8/17/2020,1610612742,Dallas Mavericks,0,0,1610612746,LA Clippers,1,1,22,16,38,15,28,43,37,44,81,21,3,24,9,36,18,12,21,104,110
2019,4,41900151,8/17/2020,1610612746,LA Clippers,1,1,1610612742,Dallas Mavericks,0,0,32,25,57,13,25,38,45,50,95,15,5,20,14,38,18,9,12,103,118
2019,4,41900145,8/29/2020,1610612747,Los Angeles Lakers,1,1,1610612757,Portland Trail Blazers,0,0,34,18,52,14,22,36,48,40,88,21,5,26,8,35,27,12,18,109,131
2019,4,41900145,8/29/2020,1610612757,Portland Trail Blazers,0,0,1610612747,Los Angeles Lakers,1,1,31,35,66,13,14,27,44,49,93,21,5,26,15,36,20,11,19,108,122
2022,4,42200172,4/18/2023,1610612746,LA Clippers,0,0,1610612756,Phoenix Suns,1,1,24,26,50,11,19,30,35,45,80,28,3,31,17,29,17,6,15,92,109
2020,4,42000305,7/1/2021,1610612737,Atlanta Hawks,0,0,1610612749,Milwaukee Bucks,1,1,26,26,52,15,23,38,41,49,90,15,4,19,18,33,24,11,14,94,112
2020,4,42000305,7/1/2021,1610612749,Milwaukee Bucks,1,1,1610612737,Atlanta Hawks,0,0,39,27,66,9,20,29,48,47,95,18,7,25,22,30,28,6,9,96,123
2019,4,41900144,8/24/2020,1610612747,Los Angeles Lakers,0,1,1610612757,Portland Trail Blazers,1,0,32,16,48,17,22,39,49,38,87,20,10,30,15,28,29,9,15,101,135
2019,4,41900144,8/24/2020,1610612757,Portland Trail Blazers,1,0,1610612747,Los Angeles Lakers,0,1,28,33,61,12,16,28,40,49,89,23,8,31,22,32,20,7,17,101,115
2022,4,42200405,6/12/2023,1610612748,Miami Heat,0,0,1610612743,Denver Nuggets,1,1,24,37,61,9,26,35,33,63,96,14,2,16,16,48,18,6,8,95,89
2022,4,42200164,4/23/2023,1610612744,Golden State Warriors,1,1,1610612758,Sacramento Kings,0,0,31,25,56,14,20,34,45,45,90,22,2,24,10,36,31,5,12,104,126
2019,4,41900143,8/22/2020,1610612747,Los Angeles Lakers,0,1,1610612757,Portland Trail Blazers,1,0,29,19,48,10,20,30,39,39,78,28,15,43,14,32,26,7,18,103,116
2019,4,41900143,8/22/2020,1610612757,Portland Trail Blazers,1,0,1610612747,Los Angeles Lakers,0,1,27,33,60,12,23,35,39,56,95,18,1,19,11,45,17,6,11,103,108
2022,4,42200164,4/23/2023,1610612758,Sacramento Kings,0,0,1610612744,Golden State Warriors,1,1,34,33,67,14,21,35,48,54,102,15,3,18,17,40,25,8,10,103,125
2022,4,42200172,4/18/2023,1610612756,Phoenix Suns,1,1,1610612746,LA Clippers,0,0,40,21,61,10,14,24,50,35,85,13,1,14,11,24,30,7,11,92,123
2020,4,42000304,6/29/2021,1610612737,Atlanta Hawks,1,1,1610612749,Milwaukee Bucks,0,0,30,17,47,13,25,38,43,42,85,11,2,13,12,32,26,6,12,93,110
2022,4,42200215,5/9/2023,1610612738,Boston Celtics,1,0,1610612755,Philadelphia 76ers,0,1,21,24,45,12,26,38,33,50,83,25,9,34,13,42,21,4,8,95,103
2020,4,42000304,6/29/2021,1610612749,Milwaukee Bucks,0,0,1610612737,Atlanta Hawks,1,1,25,20,45,8,31,39,33,51,84,14,5,19,15,40,19,11,15,92,88
2019,4,41900142,8/20/2020,1610612747,Los Angeles Lakers,1,1,1610612757,Portland Trail Blazers,0,0,30,24,54,14,24,38,44,48,92,9,1,10,16,33,26,6,14,95,111
2019,4,41900142,8/20/2020,1610612757,Portland Trail Blazers,0,0,1610612747,Los Angeles Lakers,1,1,26,30,56,8,21,29,34,51,85,12,4,16,14,39,14,9,17,96,88
2022,4,42200405,6/12/2023,1610612743,Denver Nuggets,1,1,1610612748,Miami Heat,0,0,33,23,56,5,23,28,38,46,84,13,10,23,17,33,21,9,15,95,94
2019,4,41900141,8/18/2020,1610612747,Los Angeles Lakers,1,0,1610612757,Portland Trail Blazers,0,1,29,36,65,5,27,32,34,63,97,20,11,31,21,48,22,3,10,101,93
2019,4,41900141,8/18/2020,1610612757,Portland Trail Blazers,0,1,1610612747,Los Angeles Lakers,1,0,18,27,45,13,21,34,31,48,79,25,8,33,11,39,18,11,16,102,100
2019,4,41900134,8/24/2020,1610612748,Miami Heat,1,1,1610612754,Indiana Pacers,0,0,32,29,61,8,22,30,40,51,91,11,3,14,20,31,24,8,14,94,99
2019,4,41900134,8/24/2020,1610612754,Indiana Pacers,0,0,1610612748,Miami Heat,1,1,19,24,43,14,23,37,33,47,80,7,4,11,6,43,20,8,15,93,87
2019,4,41900133,8/22/2020,1610612748,Miami Heat,1,1,1610612754,Indiana Pacers,0,0,21,21,42,13,20,33,34,41,75,43,9,52,12,31,23,10,17,104,124
2019,4,41900133,8/22/2020,1610612754,Indiana Pacers,0,0,1610612748,Miami Heat,1,1,29,22,51,12,21,33,41,43,84,21,7,28,7,41,23,10,14,105,115
2019,4,41900132,8/20/2020,1610612748,Miami Heat,0,1,1610612754,Indiana Pacers,1,0,18,23,41,18,17,35,36,40,76,19,9,28,10,35,27,12,17,98,109
2019,4,41900132,8/20/2020,1610612754,Indiana Pacers,1,0,1610612748,Miami Heat,0,1,24,23,47,12,22,34,36,45,81,16,4,20,11,35,25,9,17,97,100
2019,4,41900131,8/18/2020,1610612748,Miami Heat,0,1,1610612754,Indiana Pacers,1,0,27,19,46,13,22,35,40,41,81,20,5,25,11,33,22,7,9,94,113
2019,4,41900131,8/18/2020,1610612754,Indiana Pacers,1,0,1610612748,Miami Heat,0,1,26,26,52,10,14,24,36,40,76,19,3,22,10,31,22,8,15,92,101
2019,4,41900124,8/23/2020,1610612738,Boston Celtics,0,1,1610612755,Philadelphia 76ers,1,0,26,21,47,12,23,35,38,44,82,22,7,29,15,33,19,7,15,95,110
2019,4,41900124,8/23/2020,1610612755,Philadelphia 76ers,1,0,1610612738,Boston Celtics,0,1,26,22,48,9,25,34,35,47,82,27,7,34,14,37,12,4,8,96,106
2019,4,41900123,8/21/2020,1610612738,Boston Celtics,0,1,1610612755,Philadelphia 76ers,1,0,28,28,56,8,23,31,36,51,87,22,2,24,9,42,15,6,13,100,102
2019,4,41900123,8/21/2020,1610612755,Philadelphia 76ers,1,0,1610612738,Boston Celtics,0,1,19,37,56,9,30,39,28,67,95,29,5,34,24,45,14,7,13,101,94
2019,4,41900122,8/19/2020,1610612738,Boston Celtics,1,1,1610612755,Philadelphia 76ers,0,0,25,18,43,19,24,43,44,42,86,21,8,29,12,34,20,2,7,95,128
2019,4,41900122,8/19/2020,1610612755,Philadelphia 76ers,0,0,1610612738,Boston Celtics,1,1,28,30,58,5,16,21,33,46,79,30,7,37,12,37,21,4,9,95,101
2019,4,41900121,8/17/2020,1610612738,Boston Celtics,1,1,1610612755,Philadelphia 76ers,0,0,28,31,59,10,21,31,38,52,90,23,3,26,18,36,22,5,7,91,109
2019,4,41900121,8/17/2020,1610612755,Philadelphia 76ers,0,0,1610612738,Boston Celtics,1,1,28,25,53,9,18,27,37,43,80,18,5,23,18,28,23,12,18,91,101
2020,4,42000303,6/27/2021,1610612737,Atlanta Hawks,1,0,1610612749,Milwaukee Bucks,0,1,24,23,47,15,22,37,39,45,84,9,7,16,12,36,20,8,12,91,102
2020,4,42000303,6/27/2021,1610612749,Milwaukee Bucks,0,1,1610612737,Atlanta Hawks,1,0,34,25,59,11,18,29,45,43,88,12,9,21,19,29,27,8,12,93,113
2019,4,41900114,8/23/2020,1610612751,Brooklyn Nets,1,0,1610612761,Toronto Raptors,0,1,20,28,48,19,31,50,39,59,98,25,8,33,17,47,21,9,14,109,122
2019,4,41900114,8/23/2020,1610612761,Toronto Raptors,0,1,1610612751,Brooklyn Nets,1,0,34,20,54,22,25,47,56,45,101,16,6,22,14,34,39,5,11,109,150
2019,4,41900113,8/21/2020,1610612751,Brooklyn Nets,1,0,1610612761,Toronto Raptors,0,1,14,25,39,16,35,51,30,60,90,16,6,22,15,48,24,8,13,102,92
2019,4,41900113,8/21/2020,1610612761,Toronto Raptors,0,1,1610612751,Brooklyn Nets,1,0,28,25,53,18,20,38,46,45,91,7,4,11,10,35,35,8,16,101,117
2022,4,42200225,5/9/2023,1610612743,Denver Nuggets,1,1,1610612756,Phoenix Suns,0,0,29,29,58,13,14,27,42,43,85,21,7,28,11,36,32,6,10,98,118
2019,4,41900112,8/19/2020,1610612751,Brooklyn Nets,0,0,1610612761,Toronto Raptors,1,1,19,25,44,14,27,41,33,52,85,19,8,27,16,39,25,7,17,99,99
2019,4,41900112,8/19/2020,1610612761,Toronto Raptors,1,1,1610612751,Brooklyn Nets,0,0,29,23,52,9,26,35,38,49,87,19,9,28,11,41,22,3,9,99,104
2022,4,42200225,5/9/2023,1610612756,Phoenix Suns,0,0,1610612743,Denver Nuggets,1,1,29,32,61,9,18,27,38,50,88,17,7,24,12,40,22,6,10,99,102
2019,4,41900111,8/17/2020,1610612751,Brooklyn Nets,0,0,1610612761,Toronto Raptors,1,1,30,20,50,13,29,42,43,49,92,11,5,16,13,39,33,4,14,101,110
2019,4,41900111,8/17/2020,1610612761,Toronto Raptors,1,1,1610612751,Brooklyn Nets,0,0,18,23,41,22,22,44,40,45,85,32,1,33,10,36,26,4,12,100,134
2022,4,42200232,5/4/2023,1610612744,Golden State Warriors,1,1,1610612747,Los Angeles Lakers,0,0,27,26,53,21,21,42,48,47,95,10,6,16,17,33,38,9,16,101,127
2022,4,42200232,5/4/2023,1610612747,Los Angeles Lakers,0,0,1610612744,Golden State Warriors,1,1,30,30,60,10,24,34,40,54,94,10,7,17,11,45,27,2,9,100,100
2019,4,41900105,8/29/2020,1610612749,Milwaukee Bucks,1,1,1610612753,Orlando Magic,0,0,24,19,43,16,29,45,40,48,88,22,5,27,10,40,27,3,15,105,118
2019,4,41900105,8/29/2020,1610612753,Orlando Magic,0,0,1610612749,Milwaukee Bucks,1,1,22,31,53,15,26,41,37,57,94,15,6,21,10,50,22,5,11,106,104
2022,4,42200114,4/23/2023,1610612737,Atlanta Hawks,1,0,1610612738,Boston Celtics,0,1,29,32,61,14,23,37,43,55,98,21,3,24,16,40,25,4,13,105,121
2022,4,42200114,4/23/2023,1610612738,Boston Celtics,0,1,1610612737,Atlanta Hawks,1,0,30,19,49,16,24,40,46,43,89,21,4,25,11,34,25,8,15,105,129
2019,4,41900104,8/24/2020,1610612749,Milwaukee Bucks,0,1,1610612753,Orlando Magic,1,0,28,22,50,17,24,41,45,46,91,14,7,21,12,39,29,7,12,102,121
2019,4,41900104,8/24/2020,1610612753,Orlando Magic,1,0,1610612749,Milwaukee Bucks,0,1,18,24,42,18,27,45,36,51,87,16,4,20,9,43,26,7,16,101,106
2020,4,42000302,6/25/2021,1610612737,Atlanta Hawks,0,0,1610612749,Milwaukee Bucks,1,1,25,21,46,9,27,36,34,48,82,14,3,17,12,36,13,14,20,100,91
2020,4,42000302,6/25/2021,1610612749,Milwaukee Bucks,1,1,1610612737,Atlanta Hawks,0,0,35,20,55,15,26,41,50,46,96,10,6,16,19,30,29,8,16,99,125
2019,4,41900103,8/22/2020,1610612749,Milwaukee Bucks,0,1,1610612753,Orlando Magic,1,0,29,16,45,17,20,37,46,36,82,12,5,17,5,33,27,9,19,103,121
2019,4,41900103,8/22/2020,1610612753,Orlando Magic,1,0,1610612749,Milwaukee Bucks,0,1,19,26,45,19,20,39,38,46,84,12,2,14,7,41,24,12,19,104,107
2022,4,42200222,5/1/2023,1610612756,Phoenix Suns,0,0,1610612743,Denver Nuggets,1,1,32,32,64,6,25,31,38,57,95,5,0,5,16,41,23,5,10,92,87
2020,4,42000301,6/23/2021,1610612737,Atlanta Hawks,0,1,1610612749,Milwaukee Bucks,1,0,39,24,63,8,24,32,47,48,95,14,2,16,14,34,19,6,13,101,116
2020,4,42000301,6/23/2021,1610612749,Milwaukee Bucks,1,0,1610612737,Atlanta Hawks,0,1,39,27,66,8,28,36,47,55,102,11,3,14,16,42,27,5,8,101,113
2019,4,41900102,8/20/2020,1610612749,Milwaukee Bucks,1,1,1610612753,Orlando Magic,0,0,27,21,48,15,26,41,42,47,89,12,4,16,14,34,26,9,21,104,111
2019,4,41900102,8/20/2020,1610612753,Orlando Magic,0,0,1610612749,Milwaukee Bucks,1,1,24,32,56,7,26,33,31,58,89,27,4,31,13,48,18,5,12,104,96
2022,4,42200222,5/1/2023,1610612743,Denver Nuggets,1,1,1610612756,Phoenix Suns,0,0,29,20,49,7,20,27,36,40,76,18,3,21,8,33,19,2,13,92,97
2019,4,41900101,8/18/2020,1610612749,Milwaukee Bucks,1,0,1610612753,Orlando Magic,0,1,25,23,48,14,28,42,39,51,90,18,10,28,13,46,28,6,16,105,110
2019,4,41900101,8/18/2020,1610612753,Orlando Magic,0,1,1610612749,Milwaukee Bucks,1,0,28,20,48,16,25,41,44,45,89,18,1,19,7,39,29,6,15,105,122
2022,4,42200302,5/19/2023,1610612738,Boston Celtics,1,0,1610612748,Miami Heat,0,1,27,17,44,10,25,35,37,42,79,21,3,24,10,35,22,9,15,96,105
2022,4,42200152,4/19/2023,1610612747,Los Angeles Lakers,0,0,1610612763,Memphis Grizzlies,1,1,28,31,59,7,19,26,35,50,85,16,5,21,14,40,21,4,13,95,93
2022,4,42200302,5/19/2023,1610612748,Miami Heat,0,1,1610612738,Boston Celtics,1,0,33,33,66,9,17,26,42,50,92,18,1,19,18,32,23,2,11,95,111
2022,4,42200313,5/20/2023,1610612743,Denver Nuggets,0,1,1610612747,Los Angeles Lakers,1,0,27,20,47,17,24,41,44,44,88,14,5,19,8,37,30,3,6,96,119
2022,4,42200313,5/20/2023,1610612747,Los Angeles Lakers,1,0,1610612743,Denver Nuggets,0,1,28,24,52,10,22,32,38,46,84,22,7,29,15,36,27,7,12,96,108
2020,4,42000234,6/13/2021,1610612743,Denver Nuggets,1,0,1610612756,Phoenix Suns,0,1,31,30,61,14,23,37,45,53,98,14,7,21,11,45,22,6,9,106,118
2020,4,42000234,6/13/2021,1610612756,Phoenix Suns,0,1,1610612743,Denver Nuggets,1,0,36,27,63,8,14,22,44,41,85,29,2,31,10,32,18,6,14,105,125
2022,4,42200231,5/2/2023,1610612744,Golden State Warriors,1,0,1610612747,Los Angeles Lakers,0,1,22,31,53,21,32,53,43,63,106,5,1,6,18,46,30,4,8,99,112
2022,4,42200152,4/19/2023,1610612763,Memphis Grizzlies,1,1,1610612747,Los Angeles Lakers,0,0,27,26,53,11,25,36,38,51,89,16,5,21,15,39,24,5,10,95,103
2020,4,42000233,6/11/2021,1610612743,Denver Nuggets,1,0,1610612756,Phoenix Suns,0,1,25,29,54,14,27,41,39,56,95,10,6,16,21,38,21,10,14,95,102
2020,4,42000233,6/11/2021,1610612756,Phoenix Suns,0,1,1610612743,Denver Nuggets,1,0,31,24,55,12,14,26,43,38,81,18,2,20,8,30,26,4,12,94,116
2022,4,42200231,5/2/2023,1610612747,Los Angeles Lakers,0,1,1610612744,Golden State Warriors,1,0,37,30,67,6,19,25,43,49,92,25,4,29,14,36,24,5,8,99,117
2022,4,42200303,5/21/2023,1610612738,Boston Celtics,0,0,1610612748,Miami Heat,1,1,28,28,56,11,31,42,39,59,98,13,4,17,23,40,25,7,15,96,102
2022,4,42200303,5/21/2023,1610612748,Miami Heat,1,1,1610612738,Boston Celtics,0,0,27,19,46,19,16,35,46,35,81,17,4,21,2,36,25,3,10,97,128
2022,4,42200144,4/23/2023,1610612750,Minnesota Timberwolves,1,1,1610612743,Denver Nuggets,0,0,29,30,59,13,21,34,42,51,93,17,5,22,16,38,23,6,12,100,114
2022,4,42200144,4/23/2023,1610612743,Denver Nuggets,0,0,1610612750,Minnesota Timberwolves,1,1,30,30,60,12,23,35,42,53,95,12,6,18,17,38,21,6,12,101,108
2022,4,42200205,5/10/2023,1610612752,New York Knicks,1,1,1610612748,Miami Heat,0,0,22,15,37,13,21,34,35,36,71,29,11,40,18,27,23,11,19,92,112
2022,4,42200212,5/3/2023,1610612738,Boston Celtics,1,1,1610612755,Philadelphia 76ers,0,0,23,18,41,20,31,51,43,49,92,15,1,16,13,36,26,2,7,95,121
2022,4,42200212,5/3/2023,1610612755,Philadelphia 76ers,0,0,1610612738,Boston Celtics,1,1,25,24,49,6,24,30,31,48,79,19,4,23,10,40,13,6,13,93,87
2022,4,42200202,5/2/2023,1610612752,New York Knicks,1,1,1610612748,Miami Heat,0,0,21,21,42,16,24,40,37,45,82,21,9,30,19,30,23,1,11,88,111
2022,4,42200202,5/2/2023,1610612748,Miami Heat,0,0,1610612752,New York Knicks,1,1,21,15,36,17,32,49,38,47,85,12,5,17,11,39,24,4,7,89,105
2022,4,42200205,5/10/2023,1610612748,Miami Heat,0,0,1610612752,New York Knicks,1,1,24,21,45,13,30,43,37,51,88,16,3,19,15,37,27,6,12,92,103
2022,4,42200314,5/22/2023,1610612743,Denver Nuggets,0,1,1610612747,Los Angeles Lakers,1,0,29,23,52,12,21,33,41,44,85,19,3,22,15,32,25,5,11,89,113
2022,4,42200314,5/22/2023,1610612747,Los Angeles Lakers,1,0,1610612743,Denver Nuggets,0,1,32,34,66,8,12,20,40,46,86,23,3,26,16,31,20,3,6,88,111
2020,4,42000232,6/9/2021,1610612743,Denver Nuggets,0,0,1610612756,Phoenix Suns,1,1,22,25,47,14,29,43,36,54,90,12,8,20,13,45,24,3,11,99,98
2020,4,42000232,6/9/2021,1610612756,Phoenix Suns,1,1,1610612743,Denver Nuggets,0,0,27,29,56,18,20,38,45,49,94,15,2,17,12,37,27,4,7,97,123
2020,4,42000231,6/7/2021,1610612743,Denver Nuggets,0,0,1610612756,Phoenix Suns,1,1,29,23,52,14,26,40,43,49,92,5,1,6,13,37,26,8,12,93,105
2020,4,42000231,6/7/2021,1610612756,Phoenix Suns,1,1,1610612743,Denver Nuggets,0,0,33,18,51,13,21,34,46,39,85,17,3,20,10,30,30,10,10,93,122
2020,4,42000226,6/18/2021,1610612746,LA Clippers,1,1,1610612762,Utah Jazz,0,0,28,18,46,20,19,39,48,37,85,15,2,17,10,28,27,4,8,91,131
2020,4,42000226,6/18/2021,1610612762,Utah Jazz,0,0,1610612746,LA Clippers,1,1,21,21,42,21,23,44,42,44,86,14,5,19,20,25,19,13,16,92,119
2022,4,42200123,4/20/2023,1610612751,Brooklyn Nets,1,0,1610612755,Philadelphia 76ers,0,1,24,25,49,10,20,30,34,45,79,19,3,22,9,39,22,5,10,90,97
2022,4,42200123,4/20/2023,1610612755,Philadelphia 76ers,0,1,1610612751,Brooklyn Nets,1,0,27,24,51,13,18,31,40,42,82,9,4,13,16,27,15,5,15,89,102
2004,4,40400407,6/23/2005,1610612759,San Antonio Spurs,1,1,1610612765,Detroit Pistons,0,0,22,35,57,7,4,11,29,39,68,16,3,19,13,27,14,8,13,76,81
2004,4,40400407,6/23/2005,1610612765,Detroit Pistons,0,0,1610612759,San Antonio Spurs,1,1,29,31,60,2,12,14,31,43,74,10,4,14,14,33,17,4,9,77,74
2004,4,40400406,6/21/2005,1610612759,San Antonio Spurs,1,0,1610612765,Detroit Pistons,0,1,23,24,47,8,20,28,31,44,75,16,10,26,18,29,15,6,12,80,86
2004,4,40400406,6/21/2005,1610612765,Detroit Pistons,0,1,1610612759,San Antonio Spurs,1,0,29,33,62,8,9,17,37,42,79,13,6,19,14,32,19,3,5,80,95
2004,4,40400404,6/16/2005,1610612759,San Antonio Spurs,0,0,1610612765,Detroit Pistons,1,1,21,34,55,5,10,15,26,44,70,14,10,24,14,35,15,13,18,87,71
2004,4,40400404,6/16/2005,1610612765,Detroit Pistons,1,1,1610612759,San Antonio Spurs,0,0,39,42,81,2,7,9,41,49,90,18,5,23,18,35,23,1,4,86,102
2022,4,42200213,5/5/2023,1610612738,Boston Celtics,0,1,1610612755,Philadelphia 76ers,1,0,22,19,41,16,29,45,38,48,86,22,1,23,13,36,25,7,12,95,114
2004,4,40400405,6/19/2005,1610612759,San Antonio Spurs,0,1,1610612765,Detroit Pistons,1,0,30,32,62,8,12,20,38,44,82,12,9,21,21,28,20,7,17,87,96
2004,4,40400405,6/19/2005,1610612765,Detroit Pistons,1,0,1610612759,San Antonio Spurs,0,1,35,40,75,2,7,9,37,47,84,19,4,23,21,27,17,3,12,87,95
2004,4,40400402,6/12/2005,1610612759,San Antonio Spurs,1,1,1610612765,Detroit Pistons,0,0,18,20,38,11,13,24,29,33,62,28,6,34,9,28,23,5,16,83,97
2004,4,40400402,6/12/2005,1610612765,Detroit Pistons,0,0,1610612759,San Antonio Spurs,1,1,33,43,76,0,6,6,33,49,82,10,6,16,21,30,17,11,14,84,76
2004,4,40400403,6/14/2005,1610612759,San Antonio Spurs,0,0,1610612765,Detroit Pistons,1,1,21,29,50,8,9,17,29,38,67,13,7,20,13,28,16,12,18,82,79
2004,4,40400403,6/14/2005,1610612765,Detroit Pistons,1,1,1610612759,San Antonio Spurs,0,0,37,34,71,3,11,14,40,45,85,13,4,17,21,28,22,7,12,82,96
2004,4,40400401,6/9/2005,1610612759,San Antonio Spurs,1,1,1610612765,Detroit Pistons,0,0,30,36,66,4,9,13,34,45,79,12,3,15,19,26,12,12,16,83,84
2004,4,40400401,6/9/2005,1610612765,Detroit Pistons,0,0,1610612759,San Antonio Spurs,1,1,28,43,71,1,5,6,29,48,77,10,4,14,15,36,15,3,13,84,69
2004,4,40400315,6/1/2005,1610612756,Phoenix Suns,1,0,1610612759,San Antonio Spurs,0,1,33,37,70,5,12,17,38,49,87,14,3,17,16,34,16,7,12,91,95
2004,4,40400315,6/1/2005,1610612759,San Antonio Spurs,0,1,1610612756,Phoenix Suns,1,0,31,35,66,9,12,21,40,47,87,12,4,16,17,33,21,8,14,93,101
2022,4,42200213,5/5/2023,1610612755,Philadelphia 76ers,1,0,1610612738,Boston Celtics,0,1,15,26,41,16,21,37,31,47,78,24,3,27,11,37,21,9,14,94,102
2004,4,40400314,5/30/2005,1610612756,Phoenix Suns,0,1,1610612759,San Antonio Spurs,1,0,35,24,59,9,9,18,44,33,77,14,2,16,8,26,23,9,14,91,111
2004,4,40400314,5/30/2005,1610612759,San Antonio Spurs,1,0,1610612756,Phoenix Suns,0,1,31,39,70,11,14,25,42,53,95,11,12,23,28,31,22,5,12,92,106
2004,4,40400313,5/28/2005,1610612756,Phoenix Suns,0,0,1610612759,San Antonio Spurs,1,1,33,40,73,5,8,13,38,48,86,11,4,15,16,34,10,9,12,89,92
2004,4,40400313,5/28/2005,1610612759,San Antonio Spurs,1,1,1610612756,Phoenix Suns,0,0,29,27,56,6,14,20,35,41,76,26,4,30,16,27,19,8,15,89,102
2004,4,40400311,5/22/2005,1610612756,Phoenix Suns,1,0,1610612759,San Antonio Spurs,0,1,36,35,71,6,9,15,42,44,86,24,5,29,15,33,19,9,12,98,114
2004,4,40400311,5/22/2005,1610612759,San Antonio Spurs,0,1,1610612756,Phoenix Suns,1,0,35,29,64,10,13,23,45,42,87,21,10,31,16,30,18,5,11,99,121
2004,4,40400312,5/24/2005,1610612756,Phoenix Suns,1,0,1610612759,San Antonio Spurs,0,1,38,29,67,6,6,12,44,35,79,14,3,17,13,24,20,8,17,91,108
2004,4,40400312,5/24/2005,1610612759,San Antonio Spurs,0,1,1610612756,Phoenix Suns,1,0,36,32,68,8,10,18,44,42,86,15,6,21,16,27,21,5,12,91,111
2004,4,40400307,6/6/2005,1610612748,Miami Heat,1,0,1610612765,Detroit Pistons,0,1,30,28,58,2,9,11,32,37,69,16,8,24,11,30,12,7,15,85,82
2004,4,40400307,6/6/2005,1610612765,Detroit Pistons,0,1,1610612748,Miami Heat,1,0,31,35,66,5,8,13,36,43,79,11,4,15,16,28,21,9,14,85,88
2004,4,40400306,6/4/2005,1610612748,Miami Heat,0,0,1610612765,Detroit Pistons,1,1,23,28,51,3,10,13,26,38,64,11,7,18,8,34,15,11,19,84,66
2004,4,40400306,6/4/2005,1610612765,Detroit Pistons,1,1,1610612748,Miami Heat,0,0,29,40,69,7,10,17,36,50,86,12,7,19,17,37,24,1,6,83,91
2004,4,40400305,6/2/2005,1610612748,Miami Heat,1,1,1610612765,Detroit Pistons,0,0,33,28,61,3,5,8,36,33,69,13,10,23,8,29,17,6,15,87,88
2004,4,40400305,6/2/2005,1610612765,Detroit Pistons,0,0,1610612748,Miami Heat,1,1,27,40,67,3,8,11,30,48,78,13,7,20,16,35,16,6,15,87,76
2004,4,40400303,5/29/2005,1610612748,Miami Heat,0,1,1610612765,Detroit Pistons,1,0,27,24,51,7,7,14,34,31,65,38,16,54,7,30,22,4,9,94,113
2004,4,40400303,5/29/2005,1610612765,Detroit Pistons,1,0,1610612748,Miami Heat,0,1,32,37,69,4,9,13,36,46,82,28,15,43,15,37,22,3,9,93,104
2004,4,40400304,5/31/2005,1610612748,Miami Heat,0,0,1610612765,Detroit Pistons,1,1,29,29,58,3,11,14,32,40,72,29,10,39,13,32,17,5,12,89,96
2004,4,40400304,5/31/2005,1610612765,Detroit Pistons,1,1,1610612748,Miami Heat,0,0,33,36,69,4,4,8,37,40,77,28,11,39,13,34,27,2,6,90,106
2004,4,40400302,5/25/2005,1610612748,Miami Heat,1,1,1610612765,Detroit Pistons,0,0,33,34,67,3,8,11,36,42,78,17,6,23,12,34,14,9,17,95,92
2004,4,40400302,5/25/2005,1610612765,Detroit Pistons,0,0,1610612748,Miami Heat,1,1,22,36,58,9,14,23,31,50,81,15,8,23,14,40,17,6,15,94,86
2004,4,40400236,5/19/2005,1610612759,San Antonio Spurs,0,1,1610612760,Oklahoma City Thunder,1,0,27,28,55,6,11,17,33,39,72,26,8,34,15,30,21,6,15,88,98
2004,4,40400236,5/19/2005,1610612760,Oklahoma City Thunder,1,0,1610612759,San Antonio Spurs,0,1,32,32,64,4,7,11,36,39,75,20,6,26,15,27,13,4,14,87,96
2004,4,40400301,5/23/2005,1610612748,Miami Heat,1,0,1610612765,Detroit Pistons,0,1,32,34,66,4,7,11,36,41,77,5,5,10,10,33,17,3,10,83,81
2004,4,40400301,5/23/2005,1610612765,Detroit Pistons,0,1,1610612748,Miami Heat,1,0,31,39,70,6,5,11,37,44,81,10,2,12,13,31,20,6,9,82,90
2004,4,40400235,5/17/2005,1610612759,San Antonio Spurs,1,1,1610612760,Oklahoma City Thunder,0,0,30,31,61,6,11,17,36,42,78,25,9,34,19,28,15,4,9,83,103
2004,4,40400235,5/17/2005,1610612760,Oklahoma City Thunder,0,0,1610612759,San Antonio Spurs,1,1,31,30,61,3,10,13,34,40,74,19,7,26,15,27,12,3,13,83,90
2020,4,42000225,6/16/2021,1610612746,LA Clippers,0,1,1610612762,Utah Jazz,1,0,25,15,40,16,24,40,41,39,80,21,4,25,10,29,17,7,14,95,119
2020,4,42000225,6/16/2021,1610612762,Utah Jazz,1,0,1610612746,LA Clippers,0,1,16,10,26,20,34,54,36,44,80,19,8,27,13,34,15,11,14,95,111
2004,4,40400233,5/12/2005,1610612759,San Antonio Spurs,0,0,1610612760,Oklahoma City Thunder,1,1,24,30,54,8,11,19,32,41,73,19,15,34,11,35,19,6,12,89,91
2004,4,40400233,5/12/2005,1610612760,Oklahoma City Thunder,1,1,1610612759,San Antonio Spurs,0,0,29,31,60,2,14,16,31,45,76,28,5,33,15,33,15,5,11,88,92
2004,4,40400234,5/15/2005,1610612759,San Antonio Spurs,0,0,1610612760,Oklahoma City Thunder,1,1,25,31,56,5,11,16,30,42,72,24,6,30,20,25,16,11,23,90,89
2004,4,40400234,5/15/2005,1610612760,Oklahoma City Thunder,1,1,1610612759,San Antonio Spurs,0,0,33,32,65,6,7,13,39,39,78,17,10,27,17,26,16,6,14,90,101
2004,4,40400231,5/8/2005,1610612759,San Antonio Spurs,1,1,1610612760,Oklahoma City Thunder,0,0,31,25,56,4,9,13,35,34,69,29,6,35,13,23,17,9,19,89,103
2004,4,40400231,5/8/2005,1610612760,Oklahoma City Thunder,0,0,1610612759,San Antonio Spurs,1,1,31,36,67,2,8,10,33,44,77,13,5,18,11,37,10,4,14,89,81
2004,4,40400232,5/10/2005,1610612759,San Antonio Spurs,1,1,1610612760,Oklahoma City Thunder,0,0,33,26,59,5,8,13,38,34,72,27,8,35,12,25,20,7,11,88,108
2004,4,40400232,5/10/2005,1610612760,Oklahoma City Thunder,0,0,1610612759,San Antonio Spurs,1,1,29,34,63,4,11,15,33,45,78,21,3,24,19,27,12,7,17,87,91
2004,4,40400226,5/20/2005,1610612742,Dallas Mavericks,1,0,1610612756,Phoenix Suns,0,1,35,41,76,7,13,20,42,54,96,35,8,43,16,42,13,4,9,111,126
2004,4,40400226,5/20/2005,1610612756,Phoenix Suns,0,1,1610612742,Dallas Mavericks,1,0,35,36,71,13,14,27,48,50,98,21,9,30,17,39,18,8,15,111,130
2004,4,40400225,5/18/2005,1610612742,Dallas Mavericks,0,0,1610612756,Phoenix Suns,1,1,33,39,72,8,14,22,41,53,94,18,6,24,14,41,19,5,8,99,108
2004,4,40400225,5/18/2005,1610612756,Phoenix Suns,1,1,1610612742,Dallas Mavericks,0,0,38,39,77,5,14,19,43,53,96,23,5,28,22,32,19,9,13,99,114
2004,4,40400224,5/15/2005,1610612742,Dallas Mavericks,1,1,1610612756,Phoenix Suns,0,0,40,29,69,6,8,14,46,37,83,21,8,29,16,26,21,7,15,94,119
2004,4,40400224,5/15/2005,1610612756,Phoenix Suns,0,0,1610612742,Dallas Mavericks,1,1,34,27,61,8,13,21,42,40,82,17,6,23,14,29,16,8,15,95,109
2004,4,40400223,5/13/2005,1610612742,Dallas Mavericks,1,0,1610612756,Phoenix Suns,0,1,38,44,82,1,17,18,39,61,100,23,4,27,27,35,18,8,14,99,102
2004,4,40400223,5/13/2005,1610612756,Phoenix Suns,0,1,1610612742,Dallas Mavericks,1,0,35,32,67,11,11,22,46,43,89,16,6,22,15,31,25,11,14,100,119
2004,4,40400222,5/11/2005,1610612742,Dallas Mavericks,0,1,1610612756,Phoenix Suns,1,0,37,37,74,6,7,13,43,44,87,16,8,24,14,37,18,7,15,98,108
2004,4,40400222,5/11/2005,1610612756,Phoenix Suns,1,0,1610612742,Dallas Mavericks,0,1,30,41,71,7,11,18,37,52,89,25,9,34,20,36,21,5,13,98,106
2004,4,40400216,5/19/2005,1610612754,Indiana Pacers,1,0,1610612765,Detroit Pistons,0,1,31,25,56,5,14,19,36,39,75,2,5,7,11,30,27,7,11,78,79
2004,4,40400216,5/19/2005,1610612765,Detroit Pistons,0,1,1610612754,Indiana Pacers,1,0,27,31,58,4,9,13,31,40,71,22,2,24,13,29,17,3,10,80,88
2004,4,40400221,5/9/2005,1610612742,Dallas Mavericks,0,0,1610612756,Phoenix Suns,1,1,39,41,80,5,13,18,44,54,98,9,3,12,22,35,18,10,17,100,102
2004,4,40400221,5/9/2005,1610612756,Phoenix Suns,1,1,1610612742,Dallas Mavericks,0,0,34,32,66,12,10,22,46,42,88,23,5,28,13,33,25,4,12,98,127
2004,4,40400214,5/15/2005,1610612754,Indiana Pacers,1,0,1610612765,Detroit Pistons,0,1,23,28,51,3,16,19,26,44,70,21,7,28,13,34,14,7,19,88,76
2004,4,40400214,5/15/2005,1610612765,Detroit Pistons,0,1,1610612754,Indiana Pacers,1,0,31,40,71,3,10,13,34,50,84,18,2,20,20,32,22,8,15,89,89
2004,4,40400215,5/17/2005,1610612754,Indiana Pacers,0,0,1610612765,Detroit Pistons,1,1,21,29,50,3,12,15,24,41,65,16,3,19,12,30,14,9,14,76,67
2004,4,40400215,5/17/2005,1610612765,Detroit Pistons,1,1,1610612754,Indiana Pacers,0,0,31,38,69,5,10,15,36,48,84,9,5,14,28,23,23,5,12,78,86
2004,4,40400213,5/13/2005,1610612754,Indiana Pacers,1,1,1610612765,Detroit Pistons,0,0,22,33,55,4,13,17,26,46,72,23,4,27,14,34,15,7,14,85,79
2004,4,40400213,5/13/2005,1610612765,Detroit Pistons,0,0,1610612754,Indiana Pacers,1,1,21,28,49,3,13,16,24,41,65,23,5,28,10,33,17,8,18,85,74
2004,4,40400211,5/9/2005,1610612754,Indiana Pacers,0,0,1610612765,Detroit Pistons,1,1,27,37,64,3,9,12,30,46,76,18,6,24,14,37,11,10,18,88,81
2004,4,40400211,5/9/2005,1610612765,Detroit Pistons,1,1,1610612754,Indiana Pacers,0,0,30,31,61,4,8,12,34,39,73,24,16,40,12,37,20,7,10,90,96
2004,4,40400212,5/11/2005,1610612754,Indiana Pacers,0,1,1610612765,Detroit Pistons,1,0,30,41,71,7,17,24,37,58,95,11,3,14,24,35,21,2,10,89,92
2004,4,40400212,5/11/2005,1610612765,Detroit Pistons,1,0,1610612754,Indiana Pacers,0,1,26,34,60,6,11,17,32,45,77,13,6,19,14,35,23,11,15,89,83
2004,4,40400204,5/14/2005,1610612748,Miami Heat,0,1,1610612764,Washington Wizards,1,0,23,29,52,9,15,24,32,44,76,26,5,31,14,30,18,8,19,95,99
2004,4,40400204,5/14/2005,1610612764,Washington Wizards,1,0,1610612748,Miami Heat,0,1,24,38,62,6,14,20,30,52,82,29,10,39,16,39,12,7,10,94,95
2004,4,40400202,5/10/2005,1610612748,Miami Heat,1,1,1610612764,Washington Wizards,0,0,28,15,43,10,13,23,38,28,66,22,18,40,11,24,21,11,20,95,108
2004,4,40400202,5/10/2005,1610612764,Washington Wizards,0,0,1610612748,Miami Heat,1,1,30,38,68,7,15,22,37,53,90,21,10,31,22,37,13,7,13,94,102
2004,4,40400203,5/12/2005,1610612748,Miami Heat,0,1,1610612764,Washington Wizards,1,0,34,29,63,6,9,15,40,38,78,16,3,19,17,23,22,4,15,86,102
2004,4,40400203,5/12/2005,1610612764,Washington Wizards,1,0,1610612748,Miami Heat,0,1,30,29,59,8,16,24,38,45,83,11,5,16,15,33,23,3,12,86,95
2004,4,40400177,5/7/2005,1610612742,Dallas Mavericks,1,1,1610612745,Houston Rockets,0,0,33,31,64,8,8,16,41,39,80,26,2,28,18,22,21,5,14,87,116
2004,4,40400177,5/7/2005,1610612745,Houston Rockets,0,0,1610612742,Dallas Mavericks,1,1,26,38,64,3,15,18,29,53,82,15,3,18,17,38,16,7,13,89,76
2004,4,40400201,5/8/2005,1610612748,Miami Heat,1,1,1610612764,Washington Wizards,0,0,36,26,62,7,13,20,43,39,82,12,11,23,14,31,23,11,16,96,105
2004,4,40400201,5/8/2005,1610612764,Washington Wizards,0,0,1610612748,Miami Heat,1,1,24,36,60,4,12,16,28,48,76,26,10,36,14,39,9,8,17,96,86
2020,4,42000224,6/14/2021,1610612746,LA Clippers,1,1,1610612762,Utah Jazz,0,0,21,19,40,15,22,37,36,41,77,31,7,38,12,31,19,4,11,94,118
2020,4,42000224,6/14/2021,1610612762,Utah Jazz,0,0,1610612746,LA Clippers,1,1,16,19,35,17,25,42,33,44,77,21,5,26,9,36,19,8,11,93,104
2004,4,40400176,5/5/2005,1610612742,Dallas Mavericks,0,0,1610612745,Houston Rockets,1,1,24,36,60,7,19,26,31,55,86,14,3,17,17,39,14,5,12,91,83
2004,4,40400176,5/5/2005,1610612745,Houston Rockets,1,1,1610612742,Dallas Mavericks,0,0,27,30,57,9,8,17,36,38,74,20,5,25,10,29,21,9,16,90,101
2004,4,40400175,5/2/2005,1610612742,Dallas Mavericks,1,1,1610612745,Houston Rockets,0,0,31,33,64,6,9,15,37,42,79,23,11,34,17,31,17,8,11,89,103
2004,4,40400175,5/2/2005,1610612745,Houston Rockets,0,0,1610612742,Dallas Mavericks,1,1,28,26,54,5,8,13,33,34,67,29,11,40,11,29,15,8,14,89,100
2004,4,40400174,4/30/2005,1610612742,Dallas Mavericks,0,1,1610612745,Houston Rockets,1,0,24,28,52,9,11,20,33,39,72,22,5,27,13,28,17,9,17,88,97
2004,4,40400174,4/30/2005,1610612745,Houston Rockets,1,0,1610612742,Dallas Mavericks,0,1,29,26,55,5,12,17,34,38,72,20,6,26,15,25,15,8,18,88,93
2004,4,40400173,4/28/2005,1610612742,Dallas Mavericks,0,1,1610612745,Houston Rockets,1,0,25,26,51,8,9,17,33,35,68,32,5,37,9,30,21,2,12,89,106
2004,4,40400173,4/28/2005,1610612745,Houston Rockets,1,0,1610612742,Dallas Mavericks,0,1,23,32,55,13,12,25,36,44,80,17,8,25,19,29,22,7,15,91,102
2004,4,40400172,4/25/2005,1610612742,Dallas Mavericks,1,0,1610612745,Houston Rockets,0,1,31,36,67,10,5,15,41,41,82,19,7,26,20,25,18,12,14,91,111
2004,4,40400172,4/25/2005,1610612745,Houston Rockets,0,1,1610612742,Dallas Mavericks,1,0,31,24,55,9,9,18,40,33,73,24,3,27,7,27,22,6,12,89,113
2004,4,40400171,4/23/2005,1610612742,Dallas Mavericks,1,0,1610612745,Houston Rockets,0,1,19,36,55,5,8,13,24,44,68,33,9,42,19,28,12,10,13,83,86
2004,4,40400171,4/23/2005,1610612745,Houston Rockets,0,1,1610612742,Dallas Mavericks,1,0,31,31,62,6,10,16,37,41,78,18,2,20,16,28,15,4,12,84,98
2004,4,40400164,5/1/2005,1610612758,Sacramento Kings,1,0,1610612760,Oklahoma City Thunder,0,1,31,36,67,6,15,21,37,51,88,22,8,30,21,34,15,6,13,95,102
2004,4,40400164,5/1/2005,1610612760,Oklahoma City Thunder,0,1,1610612758,Sacramento Kings,1,0,30,18,48,9,16,25,39,34,73,28,2,30,9,26,23,10,16,95,115
2004,4,40400165,5/3/2005,1610612758,Sacramento Kings,0,0,1610612760,Oklahoma City Thunder,1,1,35,25,60,9,17,26,44,42,86,21,6,27,12,33,31,4,7,94,118
2004,4,40400165,5/3/2005,1610612760,Oklahoma City Thunder,1,1,1610612758,Sacramento Kings,0,0,34,24,58,8,9,17,42,33,75,30,8,38,14,20,25,8,14,93,122
2004,4,40400162,4/26/2005,1610612758,Sacramento Kings,0,0,1610612760,Oklahoma City Thunder,1,1,34,39,73,4,13,17,38,52,90,13,2,15,15,37,24,7,12,94,93
2004,4,40400162,4/26/2005,1610612760,Oklahoma City Thunder,1,1,1610612758,Sacramento Kings,0,0,33,32,65,5,10,15,38,42,80,24,6,30,12,35,21,3,12,93,105
2004,4,40400163,4/29/2005,1610612758,Sacramento Kings,1,1,1610612760,Oklahoma City Thunder,0,0,34,29,63,5,11,16,39,40,79,33,3,36,14,27,14,3,10,93,116
2004,4,40400163,4/29/2005,1610612760,Oklahoma City Thunder,0,0,1610612758,Sacramento Kings,1,1,28,30,58,6,17,23,34,47,81,30,4,34,20,28,15,6,16,92,104
2004,4,40400161,4/23/2005,1610612758,Sacramento Kings,0,0,1610612760,Oklahoma City Thunder,1,1,29,35,64,5,19,24,34,54,88,9,6,15,26,32,17,9,14,82,82
2004,4,40400161,4/23/2005,1610612760,Oklahoma City Thunder,1,1,1610612758,Sacramento Kings,0,0,27,43,70,4,11,15,31,54,85,21,7,28,28,28,16,4,11,81,87
2004,4,40400155,5/4/2005,1610612743,Denver Nuggets,0,0,1610612759,San Antonio Spurs,1,1,35,37,72,1,9,10,36,46,82,16,4,20,15,33,17,5,13,88,89
2004,4,40400155,5/4/2005,1610612759,San Antonio Spurs,1,1,1610612743,Denver Nuggets,0,0,24,25,49,9,15,24,33,40,73,24,9,33,17,27,23,6,17,89,99
2004,4,40400153,4/30/2005,1610612743,Denver Nuggets,1,0,1610612759,San Antonio Spurs,0,1,26,35,61,3,7,10,29,42,71,17,13,30,13,34,17,4,15,89,78
2004,4,40400153,4/30/2005,1610612759,San Antonio Spurs,0,1,1610612743,Denver Nuggets,1,0,25,38,63,6,12,18,31,50,81,18,10,28,21,31,19,7,15,89,86
2004,4,40400154,5/2/2005,1610612743,Denver Nuggets,1,0,1610612759,San Antonio Spurs,0,1,37,38,75,1,7,8,38,45,83,38,8,46,14,36,19,4,12,101,115
2004,4,40400154,5/2/2005,1610612759,San Antonio Spurs,0,1,1610612743,Denver Nuggets,1,0,33,31,64,7,12,19,40,43,83,39,6,45,16,32,19,4,12,102,126
2004,4,40400152,4/27/2005,1610612743,Denver Nuggets,0,0,1610612759,San Antonio Spurs,1,1,24,43,67,3,5,8,27,48,75,19,7,26,11,41,17,6,13,90,76
2004,4,40400152,4/27/2005,1610612759,San Antonio Spurs,1,1,1610612743,Denver Nuggets,0,0,24,29,53,10,8,18,34,37,71,26,12,38,8,34,16,6,9,90,104
2014,4,41400404,6/11/2015,1610612739,Cleveland Cavaliers,1,0,1610612744,Golden State Warriors,0,1,25,36,61,4,23,27,29,59,88,20,8,28,22,40,16,5,9,91,82
2014,4,41400404,6/11/2015,1610612744,Golden State Warriors,0,1,1610612739,Cleveland Cavaliers,1,0,24,23,47,12,18,30,36,41,77,19,8,27,8,36,24,2,7,90,103
2004,4,40400151,4/24/2005,1610612743,Denver Nuggets,0,1,1610612759,San Antonio Spurs,1,0,31,45,76,3,3,6,34,48,82,22,8,30,16,36,12,6,13,94,93
2004,4,40400151,4/24/2005,1610612759,San Antonio Spurs,1,0,1610612743,Denver Nuggets,0,1,31,37,68,3,10,13,34,47,81,16,3,19,14,33,22,9,17,92,87
2004,4,40400144,5/1/2005,1610612756,Phoenix Suns,0,1,1610612763,Memphis Grizzlies,1,0,27,12,39,11,13,24,38,25,63,36,13,49,8,21,26,9,20,97,123
2004,4,40400144,5/1/2005,1610612763,Memphis Grizzlies,1,0,1610612756,Phoenix Suns,0,1,32,33,65,13,11,24,45,44,89,12,4,16,12,33,26,6,11,96,115
2004,4,40400143,4/29/2005,1610612756,Phoenix Suns,0,1,1610612763,Memphis Grizzlies,1,0,32,31,63,11,8,19,43,39,82,13,8,21,14,30,22,2,5,84,110
2004,4,40400143,4/29/2005,1610612763,Memphis Grizzlies,1,0,1610612756,Phoenix Suns,0,1,34,30,64,3,13,16,37,43,80,13,5,18,17,29,18,4,11,84,90
2004,4,40400141,4/24/2005,1610612756,Phoenix Suns,1,1,1610612763,Memphis Grizzlies,0,0,27,34,61,15,17,32,42,51,93,15,3,18,17,36,28,5,9,94,114
2004,4,40400141,4/24/2005,1610612763,Memphis Grizzlies,0,0,1610612756,Phoenix Suns,1,1,32,35,67,9,12,21,41,47,88,12,3,15,14,36,23,5,13,93,103
2004,4,40400142,4/27/2005,1610612756,Phoenix Suns,1,1,1610612763,Memphis Grizzlies,0,0,31,30,61,5,12,17,36,42,78,31,9,40,15,31,19,7,10,93,108
2004,4,40400142,4/27/2005,1610612763,Memphis Grizzlies,0,0,1610612756,Phoenix Suns,1,1,37,39,76,6,12,18,43,51,94,11,8,19,18,37,17,4,8,94,103
2014,4,41400405,6/14/2015,1610612739,Cleveland Cavaliers,0,0,1610612744,Golden State Warriors,1,1,20,26,46,12,23,35,32,49,81,15,6,21,17,35,17,7,14,89,91
2014,4,41400405,6/14/2015,1610612744,Golden State Warriors,1,1,1610612739,Cleveland Cavaliers,0,0,24,25,49,12,14,26,36,39,75,20,14,34,18,28,25,10,17,89,104
2004,4,40400136,5/6/2005,1610612741,Chicago Bulls,0,0,1610612764,Washington Wizards,1,1,22,35,57,9,11,20,31,46,77,20,6,26,15,33,19,7,16,91,91
2004,4,40400136,5/6/2005,1610612764,Washington Wizards,1,1,1610612741,Chicago Bulls,0,0,27,41,68,7,10,17,34,51,85,19,10,29,16,38,17,4,11,91,94
2004,4,40400135,5/4/2005,1610612741,Chicago Bulls,1,0,1610612764,Washington Wizards,0,1,27,35,62,13,10,23,40,45,85,17,13,30,15,39,24,9,15,98,110
2004,4,40400135,5/4/2005,1610612764,Washington Wizards,0,1,1610612741,Chicago Bulls,1,0,44,26,70,2,10,12,46,36,82,18,12,30,15,25,24,5,16,98,112
2004,4,40400134,5/2/2005,1610612741,Chicago Bulls,0,0,1610612764,Washington Wizards,1,1,19,34,53,10,23,33,29,57,86,31,11,42,21,41,18,8,15,98,99
2004,4,40400134,5/2/2005,1610612764,Washington Wizards,1,1,1610612741,Chicago Bulls,0,0,29,34,63,5,8,13,34,42,76,33,6,39,16,28,18,9,18,99,106
2014,4,41400406,6/16/2015,1610612739,Cleveland Cavaliers,1,0,1610612744,Golden State Warriors,0,1,26,30,56,6,20,26,32,50,82,27,12,39,22,33,14,11,19,98,97
2014,4,41400406,6/16/2015,1610612744,Golden State Warriors,0,1,1610612739,Cleveland Cavaliers,1,0,24,27,51,13,21,34,37,48,85,18,11,29,10,43,28,3,9,98,105
2004,4,40400133,4/30/2005,1610612741,Chicago Bulls,0,0,1610612764,Washington Wizards,1,1,26,32,58,7,19,26,33,51,84,26,8,34,25,31,19,9,19,93,99
2004,4,40400133,4/30/2005,1610612764,Washington Wizards,1,1,1610612741,Chicago Bulls,0,0,33,33,66,4,16,20,37,49,86,39,10,49,26,28,21,5,10,94,117
2022,4,42200304,5/23/2023,1610612738,Boston Celtics,0,1,1610612748,Miami Heat,1,0,25,14,39,18,27,45,43,41,84,12,6,18,10,33,28,5,10,94,116
2004,4,40400132,4/27/2005,1610612741,Chicago Bulls,1,1,1610612764,Washington Wizards,0,0,32,35,67,8,7,15,40,42,82,25,4,29,12,33,23,11,17,101,113
2004,4,40400132,4/27/2005,1610612764,Washington Wizards,0,0,1610612741,Chicago Bulls,1,1,26,29,55,8,17,25,34,46,80,27,9,36,13,38,19,9,18,100,103
2004,4,40400131,4/24/2005,1610612741,Chicago Bulls,1,1,1610612764,Washington Wizards,0,0,33,39,72,7,15,22,40,54,94,16,10,26,21,37,27,4,9,96,103
2004,4,40400131,4/24/2005,1610612764,Washington Wizards,0,0,1610612741,Chicago Bulls,1,1,28,39,67,5,14,19,33,53,86,23,10,33,18,39,16,6,12,96,94
2004,4,40400127,5/7/2005,1610612738,Boston Celtics,1,0,1610612754,Indiana Pacers,0,1,23,32,55,4,14,18,27,46,73,12,4,16,13,34,14,11,14,82,70
2004,4,40400127,5/7/2005,1610612754,Indiana Pacers,0,1,1610612738,Boston Celtics,1,0,22,30,52,10,7,17,32,37,69,23,7,30,14,25,23,8,13,82,97
2004,4,40400126,5/5/2005,1610612738,Boston Celtics,0,1,1610612754,Indiana Pacers,1,0,34,40,74,3,13,16,37,53,90,15,4,19,21,34,16,6,17,97,92
2004,4,40400126,5/5/2005,1610612754,Indiana Pacers,1,0,1610612738,Boston Celtics,0,1,21,29,50,6,19,25,27,48,75,29,8,37,13,40,15,10,16,96,89
2004,4,40400125,5/3/2005,1610612738,Boston Celtics,1,0,1610612754,Indiana Pacers,0,1,25,25,50,4,10,14,29,35,64,23,7,30,9,27,15,16,22,91,85
2004,4,40400125,5/3/2005,1610612754,Indiana Pacers,0,1,1610612738,Boston Celtics,1,0,26,29,55,6,9,15,32,38,70,20,6,26,11,30,21,8,18,91,90
2004,4,40400123,4/28/2005,1610612738,Boston Celtics,0,0,1610612754,Indiana Pacers,1,1,28,38,66,3,9,12,31,47,78,11,6,17,15,34,13,6,14,84,76
2004,4,40400123,4/28/2005,1610612754,Indiana Pacers,1,1,1610612738,Boston Celtics,0,0,26,26,52,6,10,16,32,36,68,29,9,38,15,24,23,8,14,86,99
2004,4,40400124,4/30/2005,1610612738,Boston Celtics,0,1,1610612754,Indiana Pacers,1,0,35,26,61,7,6,13,42,32,74,19,4,23,6,28,17,8,13,90,110
2004,4,40400124,4/30/2005,1610612754,Indiana Pacers,1,0,1610612738,Boston Celtics,0,1,15,42,57,6,15,21,21,57,78,31,8,39,21,39,15,7,15,90,79
2004,4,40400121,4/23/2005,1610612738,Boston Celtics,1,1,1610612754,Indiana Pacers,0,0,28,28,56,10,8,18,38,36,74,16,9,25,7,33,24,6,11,90,102
2004,4,40400121,4/23/2005,1610612754,Indiana Pacers,0,0,1610612738,Boston Celtics,1,1,17,37,54,6,6,12,23,43,66,30,6,36,14,31,15,14,22,90,82
2004,4,40400122,4/25/2005,1610612738,Boston Celtics,1,0,1610612754,Indiana Pacers,0,1,23,31,54,3,10,13,26,41,67,24,5,29,17,26,17,10,16,80,79
2004,4,40400122,4/25/2005,1610612754,Indiana Pacers,0,1,1610612738,Boston Celtics,1,0,21,30,51,8,11,19,29,41,70,16,2,18,9,33,20,4,12,80,82
2004,4,40400114,5/1/2005,1610612755,Philadelphia 76ers,1,0,1610612765,Detroit Pistons,0,1,28,33,61,8,15,23,36,48,84,12,4,16,14,35,20,9,16,95,92
2004,4,40400114,5/1/2005,1610612765,Detroit Pistons,0,1,1610612755,Philadelphia 76ers,1,0,25,34,59,9,11,20,34,45,79,20,4,24,15,32,20,9,20,95,97
2004,4,40400115,5/3/2005,1610612755,Philadelphia 76ers,0,0,1610612765,Detroit Pistons,1,1,29,27,56,3,13,16,32,40,72,11,9,20,9,35,15,5,14,85,78
2004,4,40400115,5/3/2005,1610612765,Detroit Pistons,1,1,1610612755,Philadelphia 76ers,0,0,30,35,65,2,13,15,32,48,80,22,5,27,22,28,20,3,14,87,88
2004,4,40400113,4/29/2005,1610612755,Philadelphia 76ers,1,1,1610612765,Detroit Pistons,0,0,32,26,58,11,9,20,43,35,78,18,7,25,13,26,24,3,7,85,115
2004,4,40400113,4/29/2005,1610612765,Detroit Pistons,0,0,1610612755,Philadelphia 76ers,1,1,28,23,51,9,13,22,37,36,73,21,4,25,14,23,27,10,15,85,104
2004,4,40400112,4/26/2005,1610612755,Philadelphia 76ers,0,0,1610612765,Detroit Pistons,1,1,28,41,69,4,14,18,32,55,87,16,5,21,15,43,21,7,12,93,84
2004,4,40400112,4/26/2005,1610612765,Detroit Pistons,1,1,1610612755,Philadelphia 76ers,0,0,30,25,55,6,11,17,36,36,72,21,2,23,8,29,22,12,18,94,99
2004,4,40400111,4/23/2005,1610612755,Philadelphia 76ers,0,0,1610612765,Detroit Pistons,1,1,24,33,57,7,13,20,31,46,77,16,4,20,10,37,19,9,15,92,85
2004,4,40400111,4/23/2005,1610612765,Detroit Pistons,1,1,1610612755,Philadelphia 76ers,0,0,36,29,65,6,10,16,42,39,81,16,8,24,16,27,24,9,15,93,106
2004,4,40400104,5/1/2005,1610612748,Miami Heat,0,1,1610612751,Brooklyn Nets,1,0,30,23,53,9,9,18,39,32,71,23,11,34,8,30,24,7,20,98,110
2004,4,40400104,5/1/2005,1610612751,Brooklyn Nets,1,0,1610612748,Miami Heat,0,1,24,33,57,6,13,19,30,46,76,31,6,37,11,36,19,5,15,97,97
2022,4,42200102,4/19/2023,1610612748,Miami Heat,0,0,1610612749,Milwaukee Bucks,1,1,29,19,48,16,20,36,45,39,84,16,7,23,7,37,26,9,17,101,122
2004,4,40400103,4/28/2005,1610612748,Miami Heat,0,1,1610612751,Brooklyn Nets,1,0,28,34,62,10,12,22,38,46,84,22,16,38,10,42,22,10,18,111,108
2004,4,40400103,4/28/2005,1610612751,Brooklyn Nets,1,0,1610612748,Miami Heat,0,1,39,45,84,3,20,23,42,65,107,18,9,27,23,47,27,9,15,112,105
2020,4,42000223,6/12/2021,1610612746,LA Clippers,1,1,1610612762,Utah Jazz,0,0,31,22,53,19,17,36,50,39,89,13,3,16,11,29,21,7,9,93,132
2020,4,42000223,6/12/2021,1610612762,Utah Jazz,0,0,1610612746,LA Clippers,1,1,17,23,40,19,25,44,36,48,84,15,2,17,16,32,15,6,16,93,106
2004,4,40400101,4/24/2005,1610612748,Miami Heat,1,1,1610612751,Brooklyn Nets,0,0,33,23,56,9,6,15,42,29,71,23,12,35,9,28,21,5,10,88,116
2004,4,40400101,4/24/2005,1610612751,Brooklyn Nets,0,0,1610612748,Miami Heat,1,1,24,32,56,10,12,22,34,44,78,20,6,26,12,35,22,4,8,88,98
2014,4,41400401,6/4/2015,1610612739,Cleveland Cavaliers,0,0,1610612744,Golden State Warriors,1,1,30,33,63,9,22,31,39,55,94,13,6,19,17,41,19,8,12,99,100
2004,4,40400102,4/26/2005,1610612748,Miami Heat,1,1,1610612751,Brooklyn Nets,0,0,31,31,62,5,8,13,36,39,75,27,11,38,17,27,19,8,15,91,104
2004,4,40400102,4/26/2005,1610612751,Brooklyn Nets,0,0,1610612748,Miami Heat,1,1,22,34,56,6,16,22,28,50,78,25,10,35,19,35,17,6,14,91,87
2014,4,41400401,6/4/2015,1610612744,Golden State Warriors,1,1,1610612739,Cleveland Cavaliers,0,0,29,32,61,10,17,27,39,49,88,20,2,22,13,36,24,10,12,99,108
2022,4,42200102,4/19/2023,1610612749,Milwaukee Bucks,1,1,1610612748,Miami Heat,0,0,28,22,50,25,24,49,53,46,99,7,1,8,12,35,35,10,11,103,138
2014,4,41400403,6/9/2015,1610612739,Cleveland Cavaliers,1,1,1610612744,Golden State Warriors,0,0,26,29,55,9,12,21,35,41,76,17,7,24,12,32,15,6,16,91,96
2014,4,41400403,6/9/2015,1610612744,Golden State Warriors,0,0,1610612739,Cleveland Cavaliers,1,1,24,32,56,12,22,34,36,54,90,7,5,12,19,39,21,9,14,92,91
2014,4,41400402,6/7/2015,1610612739,Cleveland Cavaliers,0,1,1610612744,Golden State Warriors,1,0,20,43,63,9,18,27,29,61,90,28,12,40,26,40,14,11,17,102,95
2014,4,41400402,6/7/2015,1610612744,Golden State Warriors,1,0,1610612739,Cleveland Cavaliers,0,1,25,23,48,8,27,35,33,50,83,19,6,25,11,42,16,11,19,103,93
2020,4,42000222,6/10/2021,1610612746,LA Clippers,0,0,1610612762,Utah Jazz,1,1,29,26,55,11,19,30,40,45,85,20,3,23,8,38,19,4,12,97,111
2020,4,42000222,6/10/2021,1610612762,Utah Jazz,1,1,1610612746,LA Clippers,0,0,22,15,37,20,19,39,42,34,76,13,8,21,7,30,15,6,16,96,117
2014,4,41400315,5/27/2015,1610612744,Golden State Warriors,1,1,1610612745,Houston Rockets,0,0,28,34,62,9,20,29,37,54,91,21,10,31,24,35,25,12,18,101,104
2014,4,41400315,5/27/2015,1610612745,Houston Rockets,0,0,1610612744,Golden State Warriors,1,1,21,29,50,5,19,24,26,48,74,33,11,44,14,43,16,10,20,99,90
2022,4,42200104,4/24/2023,1610612748,Miami Heat,1,1,1610612749,Milwaukee Bucks,0,0,30,25,55,13,19,32,43,44,87,20,5,25,12,35,21,10,16,103,119
2022,4,42200104,4/24/2023,1610612749,Milwaukee Bucks,0,0,1610612748,Miami Heat,1,1,29,28,57,13,27,40,42,55,97,17,3,20,17,40,28,9,14,102,114
2014,4,41400314,5/25/2015,1610612744,Golden State Warriors,0,0,1610612745,Houston Rockets,1,1,24,27,51,20,26,46,44,53,97,7,6,13,10,46,26,8,15,107,115
2014,4,41400314,5/25/2015,1610612745,Houston Rockets,1,1,1610612744,Golden State Warriors,0,0,26,18,44,17,15,32,43,33,76,25,18,43,6,37,22,9,17,107,128
2022,4,42200304,5/23/2023,1610612748,Miami Heat,1,0,1610612738,Boston Celtics,0,1,26,20,46,8,24,32,34,44,78,23,5,28,14,32,18,8,16,93,99
2014,4,41400313,5/23/2015,1610612744,Golden State Warriors,0,1,1610612745,Houston Rockets,1,0,33,36,69,11,17,28,44,53,97,16,4,20,24,31,26,7,14,99,115
2014,4,41400313,5/23/2015,1610612745,Houston Rockets,1,0,1610612744,Golden State Warriors,0,1,23,35,58,5,20,25,28,55,83,19,12,31,16,44,15,9,15,99,80
2022,4,42200235,5/10/2023,1610612744,Golden State Warriors,1,1,1610612747,Los Angeles Lakers,0,0,34,23,57,13,22,35,47,45,92,14,1,15,14,32,29,6,16,100,121
2014,4,41400304,5/26/2015,1610612737,Atlanta Hawks,0,0,1610612739,Cleveland Cavaliers,1,1,31,22,53,5,27,32,36,49,85,11,7,18,8,44,22,5,8,93,88
2014,4,41400304,5/26/2015,1610612739,Cleveland Cavaliers,1,1,1610612737,Atlanta Hawks,0,0,30,26,56,13,18,31,43,44,87,19,11,30,17,34,23,4,10,95,118
2022,4,42200235,5/10/2023,1610612747,Los Angeles Lakers,0,0,1610612744,Golden State Warriors,1,1,32,28,60,10,17,27,42,45,87,12,3,15,8,39,24,8,14,100,106
2014,4,41400311,5/19/2015,1610612744,Golden State Warriors,1,1,1610612745,Houston Rockets,0,0,33,30,63,10,19,29,43,49,92,14,8,22,18,34,27,8,13,97,110
2014,4,41400311,5/19/2015,1610612745,Houston Rockets,0,0,1610612744,Golden State Warriors,1,1,32,32,64,8,14,22,40,46,86,18,10,28,19,30,27,9,16,98,106
2014,4,41400312,5/21/2015,1610612744,Golden State Warriors,1,1,1610612745,Houston Rockets,0,0,33,20,53,8,16,24,41,36,77,9,4,13,9,29,31,10,17,91,99
2014,4,41400312,5/21/2015,1610612745,Houston Rockets,0,0,1610612744,Golden State Warriors,1,1,32,29,61,7,16,23,39,45,84,13,6,19,13,34,20,7,11,91,98
2022,4,42200216,5/11/2023,1610612738,Boston Celtics,0,1,1610612755,Philadelphia 76ers,1,0,18,25,43,15,20,35,33,45,78,14,2,16,10,35,22,14,18,95,95
2014,4,41400302,5/22/2015,1610612737,Atlanta Hawks,1,0,1610612739,Cleveland Cavaliers,0,1,27,26,53,6,20,26,33,46,79,10,3,13,8,38,15,6,11,89,82
2014,4,41400302,5/22/2015,1610612739,Cleveland Cavaliers,0,1,1610612737,Atlanta Hawks,1,0,21,25,46,12,18,30,33,43,76,16,10,26,13,35,17,7,13,87,94
2022,4,42200216,5/11/2023,1610612755,Philadelphia 76ers,1,0,1610612738,Boston Celtics,0,1,22,27,49,8,26,34,30,53,83,18,1,19,9,44,18,7,12,95,86
2014,4,41400303,5/24/2015,1610612737,Atlanta Hawks,0,0,1610612739,Cleveland Cavaliers,1,1,25,33,58,11,19,30,36,52,88,28,4,32,11,43,20,3,7,102,111
2014,4,41400303,5/24/2015,1610612739,Cleveland Cavaliers,1,1,1610612737,Atlanta Hawks,0,0,26,35,61,14,22,36,40,57,97,20,9,29,21,41,24,9,13,102,114
2014,4,41400301,5/20/2015,1610612737,Atlanta Hawks,1,0,1610612739,Cleveland Cavaliers,0,1,30,24,54,4,19,23,34,43,77,17,6,23,10,37,19,4,12,91,89
2014,4,41400301,5/20/2015,1610612739,Cleveland Cavaliers,0,1,1610612737,Atlanta Hawks,1,0,27,31,58,10,16,26,37,47,84,13,7,20,18,31,20,6,15,90,97
2014,4,41400237,5/17/2015,1610612745,Houston Rockets,1,1,1610612746,LA Clippers,0,0,23,25,48,12,18,30,35,43,78,31,10,41,12,36,22,10,17,103,113
2014,4,41400237,5/17/2015,1610612746,LA Clippers,0,0,1610612745,Houston Rockets,1,1,34,30,64,7,21,28,41,51,92,11,6,17,15,39,23,11,18,103,100
2014,4,41400235,5/12/2015,1610612745,Houston Rockets,1,1,1610612746,LA Clippers,0,0,37,19,56,9,20,29,46,39,85,23,14,37,16,30,29,6,11,98,124
2014,4,41400235,5/12/2015,1610612746,LA Clippers,0,0,1610612745,Houston Rockets,1,1,29,27,56,9,26,35,38,53,91,18,13,31,15,45,22,5,7,99,103
2014,4,41400236,5/14/2015,1610612745,Houston Rockets,0,1,1610612746,LA Clippers,1,0,24,31,55,13,19,32,37,50,87,32,15,47,18,37,19,8,10,104,119
2014,4,41400236,5/14/2015,1610612746,LA Clippers,1,0,1610612745,Houston Rockets,0,1,31,30,61,7,23,30,38,53,91,24,8,32,10,46,19,8,8,105,107
2022,4,42200163,4/20/2023,1610612744,Golden State Warriors,1,1,1610612758,Sacramento Kings,0,0,24,26,50,16,34,50,40,60,100,18,5,23,21,41,31,6,12,102,114
2020,4,42000221,6/8/2021,1610612746,LA Clippers,0,0,1610612762,Utah Jazz,1,1,20,23,43,16,26,42,36,49,85,21,3,24,13,38,22,5,9,92,109
2020,4,42000221,6/8/2021,1610612762,Utah Jazz,1,1,1610612746,LA Clippers,0,0,20,21,41,17,33,50,37,54,91,21,5,26,17,40,18,3,7,92,112
2022,4,42200121,4/15/2023,1610612751,Brooklyn Nets,0,0,1610612755,Philadelphia 76ers,1,1,26,15,41,13,16,29,39,31,70,10,5,15,7,27,23,14,20,89,101
2014,4,41400231,5/4/2015,1610612745,Houston Rockets,1,0,1610612746,LA Clippers,0,1,27,24,51,11,22,33,38,46,84,14,10,24,15,36,24,14,24,104,101
2014,4,41400231,5/4/2015,1610612746,LA Clippers,0,1,1610612745,Houston Rockets,1,0,28,25,53,13,18,31,41,43,84,22,8,30,17,29,31,14,23,104,117
2014,4,41400234,5/10/2015,1610612745,Houston Rockets,0,0,1610612746,LA Clippers,1,1,22,33,55,12,16,28,34,49,83,15,15,30,13,43,20,9,21,106,95
2014,4,41400234,5/10/2015,1610612746,LA Clippers,1,1,1610612745,Houston Rockets,0,0,26,22,48,13,18,31,39,40,79,37,26,63,13,39,27,6,11,107,128
2014,4,41400232,5/6/2015,1610612745,Houston Rockets,1,1,1610612746,LA Clippers,0,0,29,25,54,5,21,26,34,46,80,42,22,64,21,37,20,9,14,105,115
2014,4,41400232,5/6/2015,1610612746,LA Clippers,0,0,1610612745,Houston Rockets,1,1,33,28,61,6,19,25,39,47,86,25,7,32,10,42,20,6,12,105,109
2014,4,41400233,5/8/2015,1610612745,Houston Rockets,0,0,1610612746,LA Clippers,1,1,24,31,55,11,22,33,35,53,88,18,13,31,20,39,21,12,15,99,99
2014,4,41400233,5/8/2015,1610612746,LA Clippers,1,1,1610612745,Houston Rockets,0,0,33,21,54,13,16,29,46,37,83,19,4,23,12,27,26,8,18,98,124
2022,4,42200121,4/15/2023,1610612755,Philadelphia 76ers,1,1,1610612751,Brooklyn Nets,0,0,21,25,46,21,22,43,42,47,89,16,0,16,16,31,32,3,9,90,121
2014,4,41400224,5/11/2015,1610612744,Golden State Warriors,0,1,1610612763,Memphis Grizzlies,1,0,24,23,47,14,19,33,38,42,80,11,5,16,13,33,22,8,21,95,101
2014,4,41400224,5/11/2015,1610612763,Memphis Grizzlies,1,0,1610612744,Golden State Warriors,0,1,29,41,70,4,14,18,33,55,88,14,4,18,18,38,24,11,16,94,84
2014,4,41400225,5/13/2015,1610612744,Golden State Warriors,1,1,1610612763,Memphis Grizzlies,0,0,24,27,51,14,16,30,38,43,81,8,2,10,14,30,28,8,17,87,98
2014,4,41400225,5/13/2015,1610612763,Memphis Grizzlies,0,0,1610612744,Golden State Warriors,1,1,29,39,68,4,11,15,33,50,83,8,2,10,17,34,21,9,16,87,78
2022,4,42200142,4/19/2023,1610612750,Minnesota Timberwolves,0,0,1610612743,Denver Nuggets,1,1,26,22,48,14,17,31,40,39,79,19,4,23,10,30,24,6,13,94,113
2014,4,41400226,5/15/2015,1610612744,Golden State Warriors,0,1,1610612763,Memphis Grizzlies,1,0,26,23,49,15,17,32,41,40,81,11,3,14,8,33,27,7,12,91,108
2014,4,41400226,5/15/2015,1610612763,Memphis Grizzlies,1,0,1610612744,Golden State Warriors,0,1,30,45,75,4,12,16,34,57,91,23,7,30,16,45,21,1,3,92,95
2022,4,42200142,4/19/2023,1610612743,Denver Nuggets,1,1,1610612750,Minnesota Timberwolves,0,0,36,27,63,10,12,22,46,39,85,20,5,25,14,27,26,4,10,95,122
2022,4,42200223,5/5/2023,1610612756,Phoenix Suns,1,1,1610612743,Denver Nuggets,0,0,39,28,67,9,19,28,48,47,95,16,2,18,11,36,24,6,9,101,121
2014,4,41400216,5/14/2015,1610612739,Cleveland Cavaliers,0,1,1610612741,Chicago Bulls,1,0,21,31,52,12,15,27,33,46,79,16,4,20,20,26,20,5,14,81,94
2014,4,41400216,5/14/2015,1610612741,Chicago Bulls,1,0,1610612739,Cleveland Cavaliers,0,1,26,34,60,4,16,20,30,50,80,9,1,10,13,38,17,3,7,82,73
2014,4,41400223,5/9/2015,1610612744,Golden State Warriors,0,0,1610612763,Memphis Grizzlies,1,1,26,22,48,6,20,26,32,42,74,19,9,28,11,36,20,10,17,94,89
2014,4,41400223,5/9/2015,1610612763,Memphis Grizzlies,1,1,1610612744,Golden State Warriors,0,0,32,34,66,5,11,16,37,45,82,20,3,23,15,31,21,7,15,94,99
2014,4,41400221,5/3/2015,1610612744,Golden State Warriors,1,1,1610612763,Memphis Grizzlies,0,0,26,23,49,13,15,28,39,38,77,10,5,15,9,32,26,13,16,92,101
2014,4,41400221,5/3/2015,1610612763,Memphis Grizzlies,0,0,1610612744,Golden State Warriors,1,1,30,31,61,3,9,12,33,40,73,17,5,22,8,34,24,13,16,92,86
2014,4,41400222,5/5/2015,1610612744,Golden State Warriors,1,0,1610612763,Memphis Grizzlies,0,1,25,23,48,6,20,26,31,43,74,22,6,28,12,34,16,13,20,97,90
2014,4,41400222,5/5/2015,1610612763,Memphis Grizzlies,0,1,1610612744,Golden State Warriors,1,0,32,36,68,5,10,15,37,46,83,18,2,20,10,37,19,6,14,96,97
2022,4,42200223,5/5/2023,1610612743,Denver Nuggets,0,0,1610612756,Phoenix Suns,1,1,33,34,67,10,20,30,43,54,97,18,3,21,19,36,27,5,13,101,114
2022,4,42200163,4/20/2023,1610612758,Sacramento Kings,0,0,1610612744,Golden State Warriors,1,1,24,21,45,11,36,47,35,57,92,16,7,23,17,45,21,12,15,101,97
2014,4,41400212,5/6/2015,1610612739,Cleveland Cavaliers,1,1,1610612741,Chicago Bulls,0,0,25,32,57,12,14,26,37,46,83,20,9,29,20,30,19,7,10,87,106
2014,4,41400212,5/6/2015,1610612741,Chicago Bulls,0,0,1610612739,Cleveland Cavaliers,1,1,25,32,57,7,15,22,32,47,79,20,5,25,15,34,20,8,12,88,91
2014,4,41400213,5/8/2015,1610612739,Cleveland Cavaliers,0,0,1610612741,Chicago Bulls,1,1,18,30,48,14,20,34,32,50,82,18,1,19,12,39,23,9,12,90,96
2014,4,41400213,5/8/2015,1610612741,Chicago Bulls,1,1,1610612739,Cleveland Cavaliers,0,0,28,41,69,6,15,21,34,56,90,25,4,29,24,33,17,6,11,92,99
2014,4,41400214,5/10/2015,1610612739,Cleveland Cavaliers,0,1,1610612741,Chicago Bulls,1,0,24,26,50,5,20,25,29,46,75,23,1,24,12,34,16,7,15,91,86
2014,4,41400214,5/10/2015,1610612741,Chicago Bulls,1,0,1610612739,Cleveland Cavaliers,0,1,23,45,68,9,12,21,32,57,89,11,1,12,18,41,12,4,12,90,84
2014,4,41400215,5/12/2015,1610612739,Cleveland Cavaliers,1,1,1610612741,Chicago Bulls,0,0,32,23,55,8,16,24,40,39,79,18,7,25,13,29,19,5,11,86,106
2014,4,41400215,5/12/2015,1610612741,Chicago Bulls,0,0,1610612739,Cleveland Cavaliers,1,1,27,34,61,7,18,25,34,52,86,26,2,28,24,30,20,5,11,86,101
2020,4,42000217,6/19/2021,1610612749,Milwaukee Bucks,0,1,1610612751,Brooklyn Nets,1,0,28,34,62,15,21,36,43,55,98,14,7,21,22,36,20,4,8,95,115
2020,4,42000217,6/19/2021,1610612751,Brooklyn Nets,1,0,1610612749,Milwaukee Bucks,0,1,27,18,45,12,27,39,39,45,84,21,4,25,14,32,23,9,13,94,111
2022,4,42200305,5/25/2023,1610612738,Boston Celtics,1,1,1610612748,Miami Heat,0,0,24,16,40,16,23,39,40,39,79,14,5,19,12,27,23,6,10,85,110
2014,4,41400205,5/13/2015,1610612737,Atlanta Hawks,1,1,1610612764,Washington Wizards,0,0,29,32,61,5,17,22,34,49,83,9,2,11,16,34,21,15,25,97,82
2014,4,41400205,5/13/2015,1610612764,Washington Wizards,0,0,1610612737,Atlanta Hawks,1,1,29,42,71,4,13,17,33,55,88,11,5,16,17,42,20,11,19,98,81
2022,4,42200203,5/6/2023,1610612748,Miami Heat,1,1,1610612752,New York Knicks,0,0,28,30,58,7,25,32,35,55,90,28,3,31,22,36,17,4,14,97,105
2022,4,42200173,4/20/2023,1610612756,Phoenix Suns,0,1,1610612746,LA Clippers,1,0,32,29,61,10,17,27,42,46,88,35,11,46,19,34,20,9,13,103,129
2014,4,41400211,5/4/2015,1610612739,Cleveland Cavaliers,1,0,1610612741,Chicago Bulls,0,1,27,28,55,7,19,26,34,47,81,17,2,19,15,33,17,7,9,84,92
2014,4,41400211,5/4/2015,1610612741,Chicago Bulls,0,1,1610612739,Cleveland Cavaliers,1,0,30,32,62,10,8,18,40,40,80,9,7,16,14,29,23,6,10,83,99
2022,4,42200173,4/20/2023,1610612746,LA Clippers,1,0,1610612756,Phoenix Suns,0,1,30,18,48,15,20,35,45,38,83,19,6,25,9,32,26,12,18,103,124
2014,4,41400206,5/15/2015,1610612737,Atlanta Hawks,0,1,1610612764,Washington Wizards,1,0,28,29,57,8,19,27,36,48,84,14,5,19,13,39,20,7,15,94,94
2014,4,41400206,5/15/2015,1610612764,Washington Wizards,1,0,1610612737,Atlanta Hawks,0,1,30,45,75,4,14,18,34,59,93,19,6,25,24,39,19,8,12,94,91
2020,4,42000216,6/17/2021,1610612749,Milwaukee Bucks,1,1,1610612751,Brooklyn Nets,0,0,30,19,49,7,26,33,37,45,82,23,5,28,16,32,14,11,15,92,104
2020,4,42000216,6/17/2021,1610612751,Brooklyn Nets,0,0,1610612749,Milwaukee Bucks,1,1,27,24,51,9,21,30,36,45,81,8,6,14,11,37,14,12,16,92,89
2022,4,42200203,5/6/2023,1610612752,New York Knicks,0,0,1610612748,Miami Heat,1,1,23,28,51,8,32,40,31,60,91,16,6,22,18,45,15,3,13,97,86
2014,4,41400201,5/3/2015,1610612737,Atlanta Hawks,1,0,1610612764,Washington Wizards,0,1,24,36,60,13,25,38,37,61,98,11,3,14,22,42,27,4,11,93,98
2014,4,41400201,5/3/2015,1610612764,Washington Wizards,0,1,1610612737,Atlanta Hawks,1,0,29,37,66,9,16,25,38,53,91,19,3,22,18,36,18,3,8,93,104
2022,4,42200305,5/25/2023,1610612748,Miami Heat,0,0,1610612738,Boston Celtics,1,1,31,24,55,9,14,23,40,38,78,8,2,10,12,26,20,13,16,86,97
2014,4,41400204,5/11/2015,1610612737,Atlanta Hawks,0,1,1610612764,Washington Wizards,1,0,32,36,68,9,10,19,41,46,87,15,4,19,13,35,30,5,13,95,106
2014,4,41400204,5/11/2015,1610612764,Washington Wizards,1,0,1610612737,Atlanta Hawks,0,1,26,33,59,12,14,26,38,47,85,13,4,17,15,33,21,8,17,96,101
2014,4,41400202,5/5/2015,1610612737,Atlanta Hawks,1,1,1610612764,Washington Wizards,0,0,27,29,56,10,19,29,37,48,85,22,3,25,15,35,30,9,10,93,106
2014,4,41400202,5/5/2015,1610612764,Washington Wizards,0,0,1610612737,Atlanta Hawks,1,1,23,37,60,12,10,22,35,47,82,8,6,14,11,38,21,10,16,93,90
2014,4,41400203,5/9/2015,1610612737,Atlanta Hawks,0,0,1610612764,Washington Wizards,1,1,29,29,58,7,16,23,36,45,81,22,7,29,14,35,23,5,11,94,101
2014,4,41400203,5/9/2015,1610612764,Washington Wizards,1,1,1610612737,Atlanta Hawks,0,0,27,23,50,10,18,28,37,41,78,19,10,29,13,32,27,10,15,94,103
2020,4,42000215,6/15/2021,1610612749,Milwaukee Bucks,0,0,1610612751,Brooklyn Nets,1,1,28,23,51,13,19,32,41,42,83,13,4,17,7,37,18,4,12,96,108
2020,4,42000215,6/15/2021,1610612751,Brooklyn Nets,1,1,1610612749,Milwaukee Bucks,0,0,22,12,34,16,27,43,38,39,77,22,3,25,4,36,27,6,10,96,114
2020,4,42000214,6/13/2021,1610612749,Milwaukee Bucks,1,1,1610612751,Brooklyn Nets,0,0,23,18,41,16,31,47,39,49,88,13,7,20,9,43,27,7,14,101,107
2020,4,42000214,6/13/2021,1610612751,Brooklyn Nets,0,0,1610612749,Milwaukee Bucks,1,1,26,24,50,10,23,33,36,47,83,14,4,18,8,40,20,10,17,103,96
2014,4,41400173,4/25/2015,1610612757,Portland Trail Blazers,1,0,1610612763,Memphis Grizzlies,0,1,25,25,50,11,16,27,36,41,77,26,5,31,7,36,23,3,9,94,109
2014,4,41400173,4/25/2015,1610612763,Memphis Grizzlies,0,1,1610612757,Portland Trail Blazers,1,0,32,36,68,4,5,9,36,41,77,39,4,43,11,32,18,2,7,92,115
2014,4,41400174,4/27/2015,1610612757,Portland Trail Blazers,1,1,1610612763,Memphis Grizzlies,0,0,28,34,62,8,17,25,36,51,87,19,2,21,17,35,18,6,9,90,99
2014,4,41400174,4/27/2015,1610612763,Memphis Grizzlies,0,0,1610612757,Portland Trail Blazers,1,1,29,39,68,7,7,14,36,46,82,13,1,14,10,37,19,5,9,89,92
2014,4,41400175,4/29/2015,1610612757,Portland Trail Blazers,0,0,1610612763,Memphis Grizzlies,1,1,20,29,49,13,20,33,33,49,82,14,5,19,8,42,13,10,13,95,93
2014,4,41400175,4/29/2015,1610612763,Memphis Grizzlies,1,1,1610612757,Portland Trail Blazers,0,0,36,39,75,1,13,14,37,52,89,24,6,30,21,34,17,1,11,94,99
2020,4,42000213,6/10/2021,1610612749,Milwaukee Bucks,1,1,1610612751,Brooklyn Nets,0,0,28,31,59,6,25,31,34,56,90,12,7,19,14,47,12,8,11,95,86
2020,4,42000213,6/10/2021,1610612751,Brooklyn Nets,0,0,1610612749,Milwaukee Bucks,1,1,26,36,62,8,24,32,34,60,94,7,1,8,12,49,15,3,8,96,83
2020,4,42000212,6/7/2021,1610612749,Milwaukee Bucks,0,0,1610612751,Brooklyn Nets,1,1,29,28,57,8,19,27,37,47,84,4,5,9,13,36,14,8,16,93,86
2020,4,42000212,6/7/2021,1610612751,Brooklyn Nets,1,1,1610612749,Milwaukee Bucks,0,0,28,24,52,21,21,42,49,45,94,6,1,7,12,34,27,2,9,93,125
2014,4,41400171,4/19/2015,1610612757,Portland Trail Blazers,0,0,1610612763,Memphis Grizzlies,1,1,24,45,69,8,18,26,32,63,95,14,5,19,21,45,18,8,13,96,86
2014,4,41400171,4/19/2015,1610612763,Memphis Grizzlies,1,1,1610612757,Portland Trail Blazers,0,0,36,43,79,3,6,9,39,49,88,19,7,26,11,42,21,5,8,95,100
2014,4,41400172,4/22/2015,1610612757,Portland Trail Blazers,0,0,1610612763,Memphis Grizzlies,1,1,24,33,57,6,14,20,30,47,77,16,2,18,17,30,11,9,14,86,82
2014,4,41400172,4/22/2015,1610612763,Memphis Grizzlies,1,1,1610612757,Portland Trail Blazers,0,0,30,43,73,8,8,16,38,51,89,13,1,14,17,34,19,4,6,84,97
2014,4,41400167,5/2/2015,1610612746,LA Clippers,1,1,1610612759,San Antonio Spurs,0,0,26,23,49,14,13,27,40,36,76,17,8,25,9,33,26,7,12,90,111
2014,4,41400167,5/2/2015,1610612759,San Antonio Spurs,0,0,1610612746,LA Clippers,1,1,33,31,64,10,15,25,43,46,89,13,7,20,16,36,26,6,10,90,109
2022,4,42200154,4/24/2023,1610612763,Memphis Grizzlies,0,0,1610612747,Los Angeles Lakers,1,1,33,31,64,9,33,42,42,64,106,18,3,21,20,45,26,5,12,107,111
2022,4,42200154,4/24/2023,1610612747,Los Angeles Lakers,1,1,1610612763,Memphis Grizzlies,0,0,31,27,58,10,26,36,41,53,94,25,6,31,17,38,22,7,16,108,117
2020,4,42000211,6/5/2021,1610612749,Milwaukee Bucks,0,0,1610612751,Brooklyn Nets,1,1,39,32,71,6,24,30,45,56,101,11,8,19,18,43,21,7,14,104,107
2020,4,42000211,6/5/2021,1610612751,Brooklyn Nets,1,1,1610612749,Milwaukee Bucks,0,0,31,28,59,15,24,39,46,52,98,8,1,9,9,44,25,4,9,103,115
2022,4,42200111,4/15/2023,1610612737,Atlanta Hawks,0,0,1610612738,Boston Celtics,1,1,33,36,69,5,24,29,38,60,98,18,4,22,17,47,23,6,11,102,99
2022,4,42200226,5/11/2023,1610612743,Denver Nuggets,0,1,1610612756,Phoenix Suns,1,0,36,24,60,8,14,22,44,38,82,29,2,31,11,28,24,3,11,97,125
2014,4,41400163,4/24/2015,1610612746,LA Clippers,0,0,1610612759,San Antonio Spurs,1,1,23,39,62,6,17,23,29,56,85,9,3,12,16,42,14,9,14,89,73
2014,4,41400163,4/24/2015,1610612759,San Antonio Spurs,1,1,1610612746,LA Clippers,0,0,30,22,52,10,14,24,40,36,76,10,3,13,8,29,25,7,13,87,100
2022,4,42200111,4/15/2023,1610612738,Boston Celtics,1,1,1610612737,Atlanta Hawks,0,0,29,26,55,13,20,33,42,46,88,15,3,18,12,35,25,13,17,101,112
2022,4,42200226,5/11/2023,1610612756,Phoenix Suns,1,0,1610612743,Denver Nuggets,0,1,27,24,51,11,17,28,38,41,79,13,7,20,6,40,20,10,14,97,100
2014,4,41400162,4/22/2015,1610612746,LA Clippers,1,0,1610612759,San Antonio Spurs,0,1,30,33,63,9,20,29,39,53,92,20,17,37,23,40,23,8,12,103,107
2014,4,41400162,4/22/2015,1610612759,San Antonio Spurs,0,1,1610612746,LA Clippers,1,0,34,32,66,8,17,25,42,49,91,19,7,26,12,41,26,5,9,101,111
2014,4,41400164,4/26/2015,1610612746,LA Clippers,0,1,1610612759,San Antonio Spurs,1,0,40,26,66,5,13,18,45,39,84,19,7,26,9,34,24,3,10,96,114
2014,4,41400164,4/26/2015,1610612759,San Antonio Spurs,1,0,1610612746,LA Clippers,0,1,31,28,59,6,19,25,37,47,84,25,10,35,14,38,20,7,8,96,105
2020,4,42000207,6/20/2021,1610612737,Atlanta Hawks,0,1,1610612755,Philadelphia 76ers,1,0,29,25,54,7,20,27,36,45,81,24,8,32,8,41,22,7,10,100,103
2020,4,42000207,6/20/2021,1610612755,Philadelphia 76ers,1,0,1610612737,Atlanta Hawks,0,1,25,27,52,9,19,28,34,46,80,19,6,25,10,39,26,9,17,99,96
2014,4,41400165,4/28/2015,1610612746,LA Clippers,1,0,1610612759,San Antonio Spurs,0,1,39,33,72,1,13,14,40,46,86,26,16,42,18,37,22,4,14,105,107
2014,4,41400165,4/28/2015,1610612759,San Antonio Spurs,0,1,1610612746,LA Clippers,1,0,25,33,58,11,12,23,36,45,81,28,9,37,12,38,21,11,16,103,111
2014,4,41400166,4/30/2015,1610612746,LA Clippers,0,1,1610612759,San Antonio Spurs,1,0,34,28,62,4,14,18,38,42,80,22,9,31,13,34,22,3,10,92,102
2014,4,41400166,4/30/2015,1610612759,San Antonio Spurs,1,0,1610612746,LA Clippers,0,1,24,31,55,12,16,28,36,47,83,12,9,21,17,34,26,7,14,92,96
2022,4,42200306,5/27/2023,1610612748,Miami Heat,1,0,1610612738,Boston Celtics,0,1,19,44,63,14,16,30,33,60,93,23,6,29,24,39,22,4,5,89,103
2022,4,42200306,5/27/2023,1610612738,Boston Celtics,0,1,1610612748,Miami Heat,1,0,27,16,43,7,28,35,34,44,78,29,5,34,15,30,18,5,12,90,104
2022,4,42200307,5/29/2023,1610612738,Boston Celtics,1,0,1610612748,Miami Heat,0,1,23,17,40,9,33,42,32,50,82,11,2,13,12,39,18,7,15,92,84
2020,4,42000206,6/18/2021,1610612737,Atlanta Hawks,1,0,1610612755,Philadelphia 76ers,0,1,28,33,61,10,21,31,38,54,92,13,11,24,17,42,19,7,12,98,99
2020,4,42000206,6/18/2021,1610612755,Philadelphia 76ers,0,1,1610612737,Atlanta Hawks,1,0,26,38,64,12,17,29,38,55,93,16,7,23,17,43,15,6,11,99,104
2014,4,41400152,4/21/2015,1610612742,Dallas Mavericks,0,0,1610612745,Houston Rockets,1,1,27,40,67,6,16,22,33,56,89,27,1,28,17,39,14,5,10,96,99
2014,4,41400152,4/21/2015,1610612745,Houston Rockets,1,1,1610612742,Dallas Mavericks,0,0,33,35,68,6,14,20,39,49,88,27,8,35,19,35,25,4,12,95,111
2014,4,41400153,4/24/2015,1610612742,Dallas Mavericks,1,0,1610612745,Houston Rockets,0,1,34,23,57,11,18,29,45,41,86,27,8,35,16,29,27,4,10,98,128
2014,4,41400153,4/24/2015,1610612745,Houston Rockets,0,1,1610612742,Dallas Mavericks,1,0,35,34,69,13,11,24,48,45,93,21,7,28,21,30,23,9,14,98,130
2014,4,41400154,4/26/2015,1610612742,Dallas Mavericks,1,1,1610612745,Houston Rockets,0,0,41,25,66,10,18,28,51,43,94,9,12,21,17,32,25,10,15,103,121
2014,4,41400154,4/26/2015,1610612745,Houston Rockets,0,0,1610612742,Dallas Mavericks,1,1,31,19,50,7,24,31,38,43,81,26,14,40,10,37,21,3,12,103,109
2020,4,42000205,6/16/2021,1610612737,Atlanta Hawks,0,1,1610612755,Philadelphia 76ers,1,0,30,29,59,9,17,26,39,46,85,22,6,28,11,39,14,7,11,97,109
2020,4,42000205,6/16/2021,1610612755,Philadelphia 76ers,1,0,1610612737,Atlanta Hawks,0,1,22,23,45,13,17,30,35,40,75,23,15,38,12,34,20,10,16,97,106
2014,4,41400155,4/28/2015,1610612742,Dallas Mavericks,0,0,1610612745,Houston Rockets,1,1,30,36,66,5,21,26,35,57,92,19,6,25,14,45,21,9,19,108,94
2014,4,41400155,4/28/2015,1610612745,Houston Rockets,1,1,1610612742,Dallas Mavericks,0,0,27,24,51,10,21,31,37,45,82,19,17,36,13,41,22,14,21,106,103
2014,4,41400161,4/19/2015,1610612746,LA Clippers,1,1,1610612759,San Antonio Spurs,0,0,30,30,60,10,8,18,40,38,78,17,11,28,8,34,16,9,15,98,107
2014,4,41400161,4/19/2015,1610612759,San Antonio Spurs,0,0,1610612746,LA Clippers,1,1,24,36,60,10,23,33,34,59,93,14,12,26,22,43,25,9,15,100,92
2022,4,42200307,5/29/2023,1610612748,Miami Heat,0,1,1610612738,Boston Celtics,1,0,28,30,58,14,14,28,42,44,86,5,1,6,13,31,26,6,14,92,103
2020,4,42000204,6/14/2021,1610612737,Atlanta Hawks,1,1,1610612755,Philadelphia 76ers,0,0,25,36,61,12,28,40,37,64,101,17,4,21,18,48,24,2,4,98,103
2020,4,42000204,6/14/2021,1610612755,Philadelphia 76ers,0,0,1610612737,Atlanta Hawks,1,1,26,32,58,11,16,27,37,48,85,15,6,21,9,41,23,5,12,97,100
2022,4,42200143,4/21/2023,1610612743,Denver Nuggets,0,1,1610612750,Minnesota Timberwolves,1,0,35,17,52,13,19,32,48,36,84,11,2,13,6,31,32,8,15,99,120
2022,4,42200143,4/21/2023,1610612750,Minnesota Timberwolves,1,0,1610612743,Denver Nuggets,0,1,26,26,52,10,17,27,36,43,79,29,6,35,9,37,24,8,13,100,111
2014,4,41400142,4/20/2015,1610612740,New Orleans Pelicans,0,0,1610612744,Golden State Warriors,1,1,24,37,61,7,13,20,31,50,81,18,6,24,14,38,21,8,13,92,87
2014,4,41400142,4/20/2015,1610612744,Golden State Warriors,1,1,1610612740,New Orleans Pelicans,0,0,29,27,56,9,21,30,38,48,86,12,7,19,17,34,27,10,14,91,97
2020,4,42000203,6/11/2021,1610612737,Atlanta Hawks,1,0,1610612755,Philadelphia 76ers,0,1,33,26,59,6,17,23,39,43,82,27,5,32,13,30,15,8,11,95,111
2020,4,42000203,6/11/2021,1610612755,Philadelphia 76ers,0,1,1610612737,Atlanta Hawks,1,0,36,22,58,10,11,21,46,33,79,25,14,39,12,28,28,6,11,96,127
2014,4,41400143,4/23/2015,1610612740,New Orleans Pelicans,1,0,1610612744,Golden State Warriors,0,1,40,29,69,6,15,21,46,44,90,21,5,26,16,29,25,4,15,103,119
2014,4,41400143,4/23/2015,1610612744,Golden State Warriors,0,1,1610612740,New Orleans Pelicans,1,0,28,35,63,14,27,41,42,62,104,25,5,30,23,41,24,7,10,104,123
2014,4,41400144,4/25/2015,1610612740,New Orleans Pelicans,1,0,1610612744,Golden State Warriors,0,1,35,26,61,5,17,22,40,43,83,13,1,14,11,32,23,6,12,89,98
2014,4,41400144,4/25/2015,1610612744,Golden State Warriors,0,1,1610612740,New Orleans Pelicans,1,0,27,28,55,13,11,24,40,39,79,16,7,23,11,30,28,5,10,89,109
2014,4,41400151,4/18/2015,1610612742,Dallas Mavericks,0,0,1610612745,Houston Rockets,1,1,38,44,82,6,11,17,44,55,99,14,3,17,18,38,19,11,17,109,108
2014,4,41400151,4/18/2015,1610612745,Houston Rockets,1,1,1610612742,Dallas Mavericks,0,0,28,32,60,10,15,25,38,47,85,32,13,45,12,40,26,5,13,107,118
2022,4,42200131,4/15/2023,1610612739,Cleveland Cavaliers,1,0,1610612752,New York Knicks,0,1,26,26,52,10,21,31,36,47,83,15,6,21,14,36,20,11,14,95,97
2022,4,42200115,4/25/2023,1610612737,Atlanta Hawks,0,1,1610612738,Boston Celtics,1,0,26,29,55,19,22,41,45,51,96,10,0,10,14,37,26,1,9,95,119
2020,4,42000202,6/8/2021,1610612737,Atlanta Hawks,0,0,1610612755,Philadelphia 76ers,1,1,27,26,53,11,19,30,38,45,83,15,3,18,14,32,20,10,18,96,102
2020,4,42000202,6/8/2021,1610612755,Philadelphia 76ers,1,1,1610612737,Atlanta Hawks,0,0,34,27,61,12,14,26,46,41,87,14,8,22,10,35,29,2,9,97,118
2022,4,42200115,4/25/2023,1610612738,Boston Celtics,1,0,1610612737,Atlanta Hawks,0,1,37,17,54,12,26,38,49,43,92,7,6,13,13,34,31,5,9,96,117
2022,4,42200214,5/7/2023,1610612738,Boston Celtics,0,0,1610612755,Philadelphia 76ers,1,1,24,19,43,17,27,44,41,46,87,16,6,22,15,33,25,9,10,93,115
2022,4,42200131,4/15/2023,1610612752,New York Knicks,0,1,1610612739,Cleveland Cavaliers,1,0,29,30,59,8,21,29,37,51,88,19,3,22,22,30,18,9,16,93,101
2022,4,42200214,5/7/2023,1610612755,Philadelphia 76ers,1,1,1610612738,Boston Celtics,0,0,29,28,57,13,21,34,42,49,91,19,3,22,17,33,19,3,9,95,116
2020,4,42000201,6/6/2021,1610612737,Atlanta Hawks,0,1,1610612755,Philadelphia 76ers,1,0,24,15,39,20,27,47,44,42,86,20,1,21,7,35,23,12,17,105,128
2020,4,42000201,6/6/2021,1610612755,Philadelphia 76ers,1,0,1610612737,Atlanta Hawks,0,1,35,18,53,10,19,29,45,37,82,24,11,35,11,34,25,10,19,106,124
2022,4,42200224,5/7/2023,1610612756,Phoenix Suns,1,1,1610612743,Denver Nuggets,0,0,33,19,52,13,16,29,46,35,81,24,5,29,12,26,28,6,13,94,129
2014,4,41400131,4/18/2015,1610612761,Toronto Raptors,1,0,1610612764,Washington Wizards,0,1,29,34,63,6,23,29,35,57,92,10,4,14,15,46,21,6,12,98,86
2014,4,41400131,4/18/2015,1610612764,Washington Wizards,0,1,1610612761,Toronto Raptors,1,0,33,45,78,6,15,21,39,60,99,9,6,15,21,41,22,5,11,96,93
2022,4,42200224,5/7/2023,1610612743,Denver Nuggets,0,0,1610612756,Phoenix Suns,1,1,43,24,67,7,15,22,50,39,89,17,6,23,15,25,28,6,9,95,124
2014,4,41400132,4/21/2015,1610612761,Toronto Raptors,1,0,1610612764,Washington Wizards,0,1,32,30,62,7,11,18,39,41,80,21,11,32,11,36,19,6,11,98,106
2014,4,41400132,4/21/2015,1610612764,Washington Wizards,0,1,1610612761,Toronto Raptors,1,0,32,26,58,10,11,21,42,37,79,23,11,34,13,27,26,8,16,97,117
2020,4,42000177,6/6/2021,1610612742,Dallas Mavericks,0,0,1610612746,LA Clippers,1,1,35,20,55,10,26,36,45,46,91,11,6,17,19,31,22,11,14,93,111
2020,4,42000177,6/6/2021,1610612746,LA Clippers,1,1,1610612742,Dallas Mavericks,0,0,21,18,39,20,23,43,41,41,82,24,0,24,9,32,30,4,9,93,126
2014,4,41400133,4/24/2015,1610612761,Toronto Raptors,0,0,1610612764,Washington Wizards,1,1,27,44,71,10,18,28,37,62,99,15,4,19,20,43,21,4,9,99,99
2014,4,41400133,4/24/2015,1610612764,Washington Wizards,1,1,1610612761,Toronto Raptors,0,0,24,23,47,12,17,29,36,40,76,22,9,31,10,35,27,12,17,99,106
2014,4,41400141,4/18/2015,1610612740,New Orleans Pelicans,0,0,1610612744,Golden State Warriors,1,1,26,35,61,9,13,22,35,48,83,20,5,25,10,42,24,11,14,100,99
2014,4,41400141,4/18/2015,1610612744,Golden State Warriors,1,1,1610612740,New Orleans Pelicans,0,0,26,26,52,11,18,29,37,44,81,21,13,34,12,38,24,8,15,100,106
2022,4,42200113,4/21/2023,1610612737,Atlanta Hawks,1,1,1610612738,Boston Celtics,0,0,36,21,57,15,19,34,51,40,91,13,3,16,16,27,24,11,19,101,130
2022,4,42200101,4/16/2023,1610612748,Miami Heat,0,1,1610612749,Milwaukee Bucks,1,0,35,24,59,15,10,25,50,34,84,15,6,21,6,30,32,3,16,100,130
2014,4,41400134,4/26/2015,1610612761,Toronto Raptors,0,0,1610612764,Washington Wizards,1,1,29,28,57,7,18,25,36,46,82,15,5,20,13,36,17,10,16,96,94
2014,4,41400134,4/26/2015,1610612764,Washington Wizards,1,1,1610612761,Toronto Raptors,0,0,26,22,48,15,11,26,41,33,74,28,6,34,8,30,30,5,14,95,125
2020,4,42000176,6/4/2021,1610612742,Dallas Mavericks,1,0,1610612746,LA Clippers,0,1,26,29,55,11,23,34,37,52,89,12,2,14,12,41,23,7,12,97,97
2020,4,42000176,6/4/2021,1610612746,LA Clippers,0,1,1610612742,Dallas Mavericks,1,0,26,17,43,10,24,34,36,41,77,22,6,28,9,35,18,9,14,97,104
2022,4,42200101,4/16/2023,1610612749,Milwaukee Bucks,1,0,1610612748,Miami Heat,0,1,34,12,46,11,34,45,45,46,91,16,6,22,13,37,29,6,13,102,117
2022,4,42200113,4/21/2023,1610612738,Boston Celtics,0,0,1610612737,Atlanta Hawks,1,1,24,20,44,21,27,48,45,47,92,11,5,16,9,41,31,5,12,103,122
2022,4,42200124,4/22/2023,1610612755,Philadelphia 76ers,0,1,1610612751,Brooklyn Nets,1,0,27,40,67,9,15,24,36,55,91,15,1,16,21,34,19,3,10,88,96
2022,4,42200124,4/22/2023,1610612751,Brooklyn Nets,1,0,1610612755,Philadelphia 76ers,0,1,24,19,43,9,28,37,33,47,80,13,6,19,9,41,20,7,10,89,88
2022,4,42200151,4/16/2023,1610612763,Memphis Grizzlies,1,0,1610612747,Los Angeles Lakers,0,1,29,24,53,13,23,36,42,47,89,15,1,16,10,37,24,7,12,100,112
2022,4,42200233,5/6/2023,1610612744,Golden State Warriors,0,0,1610612747,Los Angeles Lakers,1,1,23,24,47,13,31,44,36,55,91,12,5,17,18,38,26,10,19,100,97
2022,4,42200233,5/6/2023,1610612747,Los Angeles Lakers,1,1,1610612744,Golden State Warriors,0,0,27,22,49,15,16,31,42,38,80,28,9,37,10,33,27,5,13,99,127
2022,4,42200151,4/16/2023,1610612747,Los Angeles Lakers,0,1,1610612763,Memphis Grizzlies,1,0,33,22,55,16,21,37,49,43,92,14,2,16,16,29,25,6,16,99,128
2014,4,41400124,4/25/2015,1610612741,Chicago Bulls,0,0,1610612749,Milwaukee Bucks,1,1,23,27,50,10,8,18,33,35,68,14,6,20,11,25,23,20,28,94,90
2014,4,41400124,4/25/2015,1610612749,Milwaukee Bucks,1,1,1610612741,Chicago Bulls,0,0,25,40,65,9,13,22,34,53,87,15,7,22,18,39,25,10,15,95,92
2020,4,42000175,6/2/2021,1610612742,Dallas Mavericks,0,1,1610612746,LA Clippers,1,0,23,30,53,14,22,36,37,52,89,17,2,19,14,39,21,5,9,92,105
2020,4,42000175,6/2/2021,1610612746,LA Clippers,1,0,1610612742,Dallas Mavericks,0,1,19,23,42,14,24,38,33,47,80,20,5,25,14,36,25,9,12,92,100
2014,4,41400125,4/27/2015,1610612741,Chicago Bulls,1,0,1610612749,Milwaukee Bucks,0,1,27,41,68,4,18,22,31,59,90,22,7,29,26,37,22,10,13,93,88
2014,4,41400125,4/27/2015,1610612749,Milwaukee Bucks,0,1,1610612741,Chicago Bulls,1,0,30,39,69,6,10,16,36,49,85,16,0,16,17,33,21,8,17,91,94
2022,4,42200145,4/25/2023,1610612750,Minnesota Timberwolves,0,0,1610612743,Denver Nuggets,1,1,33,15,48,8,25,33,41,40,81,19,6,25,12,31,24,10,14,95,109
2022,4,42200122,4/17/2023,1610612751,Brooklyn Nets,0,0,1610612755,Philadelphia 76ers,1,1,17,21,38,13,29,42,30,50,80,11,6,17,7,46,24,8,9,90,84
2020,4,42000174,5/30/2021,1610612742,Dallas Mavericks,1,0,1610612746,LA Clippers,0,1,26,33,59,5,25,30,31,58,89,14,8,22,16,47,15,7,8,92,81
2020,4,42000174,5/30/2021,1610612746,LA Clippers,0,1,1610612742,Dallas Mavericks,1,0,24,20,44,13,20,33,37,40,77,19,6,25,9,35,16,3,12,92,106
2014,4,41400126,4/30/2015,1610612741,Chicago Bulls,0,1,1610612749,Milwaukee Bucks,1,0,31,29,60,15,15,30,46,44,90,13,3,16,13,32,31,3,12,96,120
2014,4,41400126,4/30/2015,1610612749,Milwaukee Bucks,1,0,1610612741,Chicago Bulls,0,1,21,36,57,4,15,19,25,51,76,12,7,19,9,44,17,7,18,96,66
2022,4,42200122,4/17/2023,1610612755,Philadelphia 76ers,1,1,1610612751,Brooklyn Nets,0,0,25,20,45,11,24,35,36,44,80,13,3,16,17,28,21,10,19,90,96
2020,4,42000173,5/28/2021,1610612742,Dallas Mavericks,1,0,1610612746,LA Clippers,0,1,18,29,47,20,19,39,38,48,86,12,6,18,18,33,17,4,10,85,108
2020,4,42000173,5/28/2021,1610612746,LA Clippers,0,1,1610612742,Dallas Mavericks,1,0,31,14,45,13,18,31,44,32,76,17,1,18,10,22,24,4,11,86,118
2022,4,42200145,4/25/2023,1610612743,Denver Nuggets,1,1,1610612750,Minnesota Timberwolves,0,0,22,29,51,12,22,34,34,51,85,32,4,36,20,33,22,9,12,94,112
2020,4,42000172,5/25/2021,1610612742,Dallas Mavericks,0,1,1610612746,LA Clippers,1,0,30,18,48,18,16,34,48,34,82,13,11,24,8,31,25,7,11,97,127
2020,4,42000172,5/25/2021,1610612746,LA Clippers,1,0,1610612742,Dallas Mavericks,0,1,32,19,51,13,20,33,45,39,84,18,2,20,9,31,23,8,14,97,121
2020,4,42000171,5/22/2021,1610612742,Dallas Mavericks,0,1,1610612746,LA Clippers,1,0,21,19,40,17,19,36,38,38,76,20,6,26,15,28,22,7,13,87,113
2020,4,42000171,5/22/2021,1610612746,LA Clippers,1,0,1610612742,Dallas Mavericks,0,1,26,18,44,11,29,40,37,47,84,18,6,24,14,35,22,2,5,86,103
2022,4,42200236,5/12/2023,1610612744,Golden State Warriors,0,0,1610612747,Los Angeles Lakers,1,1,26,29,55,13,35,48,39,64,103,10,4,14,24,42,25,6,11,95,101
2022,4,42200236,5/12/2023,1610612747,Los Angeles Lakers,1,1,1610612744,Golden State Warriors,0,0,26,23,49,13,13,26,39,36,75,31,11,42,7,34,25,3,7,95,122
2020,4,42000166,6/3/2021,1610612743,Denver Nuggets,0,1,1610612757,Portland Trail Blazers,1,0,29,23,52,15,19,34,44,42,86,23,4,27,14,32,28,7,12,94,126
2020,4,42000166,6/3/2021,1610612757,Portland Trail Blazers,1,0,1610612743,Denver Nuggets,0,1,25,18,43,15,21,36,40,39,79,20,2,22,11,29,24,8,17,95,115
2014,4,41400114,4/26/2015,1610612738,Boston Celtics,1,0,1610612739,Cleveland Cavaliers,0,1,30,32,62,3,20,23,33,52,85,24,13,37,17,41,17,9,14,96,93
2014,4,41400114,4/26/2015,1610612739,Cleveland Cavaliers,0,1,1610612738,Boston Celtics,1,0,24,21,45,7,26,33,31,47,78,32,11,43,12,40,13,2,8,95,101
2014,4,41400121,4/18/2015,1610612741,Chicago Bulls,1,1,1610612749,Milwaukee Bucks,0,0,26,25,51,12,20,32,38,45,83,15,7,22,17,32,30,11,19,98,103
2014,4,41400121,4/18/2015,1610612749,Milwaukee Bucks,0,0,1610612741,Chicago Bulls,1,1,31,42,73,4,12,16,35,54,89,17,9,26,16,44,22,8,13,97,91
2014,4,41400122,4/20/2015,1610612741,Chicago Bulls,1,1,1610612749,Milwaukee Bucks,0,0,19,29,48,12,21,33,31,50,81,17,10,27,16,40,26,10,15,91,91
2014,4,41400122,4/20/2015,1610612749,Milwaukee Bucks,0,0,1610612741,Chicago Bulls,1,1,28,45,73,4,13,17,32,58,90,14,3,17,10,51,13,2,4,92,82
2014,4,41400123,4/23/2015,1610612741,Chicago Bulls,0,1,1610612749,Milwaukee Bucks,1,0,26,30,56,14,19,33,40,49,89,19,5,24,15,36,25,11,18,104,113
2014,4,41400123,4/23/2015,1610612749,Milwaukee Bucks,1,0,1610612741,Chicago Bulls,0,1,37,46,83,6,13,19,43,59,102,14,11,25,22,42,24,11,12,106,106
2022,4,42200175,4/25/2023,1610612756,Phoenix Suns,1,1,1610612746,LA Clippers,0,0,38,30,68,13,13,26,51,43,94,21,3,24,13,30,31,4,9,98,136
2022,4,42200175,4/25/2023,1610612746,LA Clippers,0,0,1610612756,Phoenix Suns,1,1,30,29,59,13,23,36,43,52,95,31,6,37,22,33,23,7,10,100,130
2022,4,42200206,5/12/2023,1610612748,Miami Heat,1,1,1610612752,New York Knicks,0,0,26,29,55,7,20,27,33,49,82,23,2,25,14,35,25,2,7,89,96
2022,4,42200206,5/12/2023,1610612752,New York Knicks,0,0,1610612748,Miami Heat,1,1,17,19,36,10,25,35,27,44,71,28,4,32,10,38,13,8,12,88,92
2020,4,42000165,6/1/2021,1610612743,Denver Nuggets,1,1,1610612757,Portland Trail Blazers,0,0,30,30,60,20,24,44,50,54,104,27,5,32,19,38,33,6,11,114,147
2020,4,42000165,6/1/2021,1610612757,Portland Trail Blazers,0,0,1610612743,Denver Nuggets,1,1,26,29,55,21,27,48,47,56,103,25,4,29,17,42,25,5,14,114,140
2014,4,41400111,4/19/2015,1610612738,Boston Celtics,0,0,1610612739,Cleveland Cavaliers,1,1,29,28,57,8,14,22,37,42,79,18,4,22,12,33,24,6,14,91,100
2014,4,41400111,4/19/2015,1610612739,Cleveland Cavaliers,1,1,1610612738,Boston Celtics,0,0,24,27,51,13,18,31,37,45,82,26,7,33,19,28,19,7,13,92,113
2014,4,41400113,4/23/2015,1610612738,Boston Celtics,1,0,1610612739,Cleveland Cavaliers,0,1,31,32,63,5,14,19,36,46,82,18,3,21,10,37,20,9,15,95,95
2014,4,41400113,4/23/2015,1610612739,Cleveland Cavaliers,0,1,1610612738,Boston Celtics,1,0,26,29,55,12,17,29,38,46,84,15,9,24,12,38,17,6,11,95,103
2014,4,41400112,4/21/2015,1610612738,Boston Celtics,0,0,1610612739,Cleveland Cavaliers,1,1,27,36,63,6,16,22,33,52,85,19,3,22,14,40,19,7,11,93,91
2014,4,41400112,4/21/2015,1610612739,Cleveland Cavaliers,1,1,1610612738,Boston Celtics,0,0,27,20,47,7,22,29,34,42,76,24,2,26,15,27,18,6,18,92,99
2014,4,41400106,5/1/2015,1610612737,Atlanta Hawks,0,1,1610612751,Brooklyn Nets,1,0,30,23,53,13,19,32,43,42,85,12,3,15,7,37,34,5,12,96,111
2014,4,41400106,5/1/2015,1610612751,Brooklyn Nets,1,0,1610612737,Atlanta Hawks,0,1,24,38,62,7,16,23,31,54,85,18,6,24,14,44,20,11,15,98,87
2020,4,42000164,5/29/2021,1610612743,Denver Nuggets,0,0,1610612757,Portland Trail Blazers,1,1,19,31,50,13,31,44,32,62,94,18,4,22,21,42,20,6,9,94,95
2020,4,42000164,5/29/2021,1610612757,Portland Trail Blazers,1,1,1610612743,Denver Nuggets,0,0,30,21,51,12,21,33,42,42,84,19,6,25,10,35,24,5,6,93,115
2020,4,42000163,5/27/2021,1610612743,Denver Nuggets,0,1,1610612757,Portland Trail Blazers,1,0,19,27,46,20,18,38,39,45,84,22,5,27,14,34,24,6,13,96,120
2020,4,42000163,5/27/2021,1610612757,Portland Trail Blazers,1,0,1610612743,Denver Nuggets,0,1,31,24,55,14,31,45,45,55,100,11,2,13,19,37,20,4,8,96,115
2022,4,42200162,4/17/2023,1610612758,Sacramento Kings,1,1,1610612744,Golden State Warriors,0,0,33,21,54,9,29,38,42,50,92,21,8,29,17,34,22,6,14,102,114
2014,4,41400101,4/19/2015,1610612737,Atlanta Hawks,1,1,1610612751,Brooklyn Nets,0,0,24,25,49,10,20,30,34,45,79,21,1,22,10,36,19,8,14,93,99
2014,4,41400101,4/19/2015,1610612751,Brooklyn Nets,0,0,1610612737,Atlanta Hawks,1,1,31,28,59,5,15,20,36,43,79,15,7,22,13,34,18,11,17,93,92
2020,4,42000162,5/24/2021,1610612743,Denver Nuggets,1,1,1610612757,Portland Trail Blazers,0,0,34,24,58,12,16,28,46,40,86,24,6,30,14,31,29,3,13,97,128
2020,4,42000162,5/24/2021,1610612757,Portland Trail Blazers,0,0,1610612743,Denver Nuggets,1,1,19,21,40,16,17,33,35,38,73,23,5,28,11,29,15,12,21,97,109
2014,4,41400102,4/22/2015,1610612737,Atlanta Hawks,1,1,1610612751,Brooklyn Nets,0,0,23,36,59,12,19,31,35,55,90,14,5,19,17,42,27,6,9,93,96
2014,4,41400102,4/22/2015,1610612751,Brooklyn Nets,0,0,1610612737,Atlanta Hawks,1,1,27,25,52,8,18,26,35,43,78,13,5,18,11,34,23,11,16,91,91
2014,4,41400103,4/25/2015,1610612737,Atlanta Hawks,0,0,1610612751,Brooklyn Nets,1,1,26,34,60,6,24,30,32,58,90,13,4,17,17,41,22,8,16,97,83
2014,4,41400103,4/25/2015,1610612751,Brooklyn Nets,1,1,1610612737,Atlanta Hawks,0,0,25,36,61,7,15,22,32,51,83,20,5,25,14,40,24,11,15,97,91
2020,4,42000161,5/22/2021,1610612743,Denver Nuggets,1,0,1610612757,Portland Trail Blazers,0,1,36,21,57,11,25,36,47,46,93,4,4,8,16,31,22,3,8,91,109
2014,4,41400105,4/29/2015,1610612737,Atlanta Hawks,1,1,1610612751,Brooklyn Nets,0,0,27,23,50,13,20,33,40,43,83,14,6,20,14,31,25,5,11,92,107
2014,4,41400105,4/29/2015,1610612751,Brooklyn Nets,0,0,1610612737,Atlanta Hawks,1,1,27,29,56,10,12,22,37,41,78,13,2,15,6,37,20,9,13,91,97
2020,4,42000161,5/22/2021,1610612757,Portland Trail Blazers,0,1,1610612743,Denver Nuggets,1,0,24,27,51,19,21,40,43,48,91,18,1,19,12,37,29,3,6,91,123
2014,4,41400104,4/27/2015,1610612737,Atlanta Hawks,0,0,1610612751,Brooklyn Nets,1,1,33,29,62,13,20,33,46,49,95,10,5,15,20,32,27,13,18,101,115
2014,4,41400104,4/27/2015,1610612751,Brooklyn Nets,1,1,1610612737,Atlanta Hawks,0,0,32,33,65,14,17,31,46,50,96,14,7,21,15,40,25,7,10,101,120
2022,4,42200161,4/15/2023,1610612744,Golden State Warriors,0,0,1610612758,Sacramento Kings,1,1,27,13,40,16,34,50,43,47,90,21,6,27,14,35,31,10,15,105,123
2022,4,42200171,4/16/2023,1610612756,Phoenix Suns,1,0,1610612746,LA Clippers,0,1,33,30,63,6,13,19,39,43,82,26,7,33,8,36,27,6,10,101,110
2022,4,42200161,4/15/2023,1610612758,Sacramento Kings,1,1,1610612744,Golden State Warriors,0,0,32,34,66,12,20,32,44,54,98,26,6,32,23,34,18,7,13,104,126
2022,4,42200171,4/16/2023,1610612746,LA Clippers,0,1,1610612756,Phoenix Suns,1,0,31,31,62,10,21,31,41,52,93,23,6,29,18,38,23,8,14,102,115
2022,4,42200162,4/17/2023,1610612744,Golden State Warriors,0,0,1610612758,Sacramento Kings,1,1,26,16,42,13,27,40,39,43,82,15,3,18,12,34,18,11,22,102,106
2020,4,42000156,6/3/2021,1610612747,Los Angeles Lakers,1,0,1610612756,Phoenix Suns,0,1,28,28,56,10,25,35,38,53,91,14,2,16,16,37,21,5,7,90,100
2020,4,42000156,6/3/2021,1610612756,Phoenix Suns,0,1,1610612747,Los Angeles Lakers,1,0,19,19,38,18,17,35,37,36,73,21,1,22,8,28,24,5,14,89,113
2020,4,42000155,6/1/2021,1610612747,Los Angeles Lakers,0,0,1610612756,Phoenix Suns,1,1,17,32,49,12,23,35,29,55,84,15,6,21,11,47,14,7,17,98,85
2020,4,42000155,6/1/2021,1610612756,Phoenix Suns,1,1,1610612747,Los Angeles Lakers,0,0,29,23,52,14,28,42,43,51,94,15,6,21,9,45,29,3,4,98,115
2020,4,42000154,5/30/2021,1610612747,Los Angeles Lakers,1,0,1610612756,Phoenix Suns,0,1,19,22,41,13,27,40,32,49,81,15,6,21,11,41,19,12,16,96,92
2020,4,42000154,5/30/2021,1610612756,Phoenix Suns,0,1,1610612747,Los Angeles Lakers,1,0,27,23,50,10,25,35,37,48,85,16,5,21,9,44,24,3,10,95,100
2022,4,42200133,4/21/2023,1610612739,Cleveland Cavaliers,0,0,1610612752,New York Knicks,1,1,24,23,47,7,26,33,31,49,80,10,7,17,16,36,16,14,21,94,79
2022,4,42200133,4/21/2023,1610612752,New York Knicks,1,1,1610612739,Cleveland Cavaliers,0,0,29,21,50,10,23,33,39,44,83,11,7,18,13,33,21,7,14,93,99
2013,4,41300402,6/8/2014,1610612748,Miami Heat,0,1,1610612759,San Antonio Spurs,1,0,29,22,51,8,11,19,37,33,70,16,5,21,9,26,16,7,16,87,98
2013,4,41300402,6/8/2014,1610612759,San Antonio Spurs,1,0,1610612748,Miami Heat,0,1,24,32,56,12,14,26,36,46,82,12,8,20,13,37,26,6,11,88,96
2013,4,41300403,6/10/2014,1610612748,Miami Heat,1,0,1610612759,San Antonio Spurs,0,1,22,19,41,10,11,21,32,30,62,18,6,24,8,27,17,12,20,85,92
2013,4,41300403,6/10/2014,1610612759,San Antonio Spurs,0,1,1610612748,Miami Heat,1,0,29,15,44,9,11,20,38,26,64,26,6,32,8,22,21,8,13,85,111
2022,4,42200135,4/26/2023,1610612752,New York Knicks,0,1,1610612739,Cleveland Cavaliers,1,0,28,28,56,9,20,29,37,48,85,23,6,29,24,26,21,5,14,90,106
2022,4,42200174,4/22/2023,1610612746,LA Clippers,1,0,1610612756,Phoenix Suns,0,1,28,27,55,12,25,37,40,52,92,8,2,10,15,38,19,10,13,96,100
2013,4,41300404,6/12/2014,1610612748,Miami Heat,1,0,1610612759,San Antonio Spurs,0,1,23,26,49,9,13,22,32,39,71,13,7,20,12,32,13,8,13,84,86
2013,4,41300404,6/12/2014,1610612759,San Antonio Spurs,0,1,1610612748,Miami Heat,1,0,31,18,49,9,12,21,40,30,70,18,7,25,13,21,25,7,14,83,107
2013,4,41300405,6/15/2014,1610612748,Miami Heat,0,0,1610612759,San Antonio Spurs,1,1,23,27,50,7,18,25,30,45,75,20,7,27,12,36,14,5,12,89,87
2013,4,41300405,6/15/2014,1610612759,San Antonio Spurs,1,1,1610612748,Miami Heat,0,0,25,27,52,12,14,26,37,41,78,18,5,23,8,37,25,5,8,88,104
2022,4,42200174,4/22/2023,1610612756,Phoenix Suns,0,1,1610612746,LA Clippers,1,0,32,30,62,9,13,22,41,43,84,21,6,27,19,26,25,7,18,96,112
2022,4,42200155,4/26/2023,1610612763,Memphis Grizzlies,1,1,1610612747,Los Angeles Lakers,0,0,30,29,59,14,26,40,44,55,99,14,3,17,17,41,24,8,11,100,116
2022,4,42200155,4/26/2023,1610612747,Los Angeles Lakers,0,0,1610612763,Memphis Grizzlies,1,1,27,26,53,10,29,39,37,55,92,15,5,20,16,39,28,6,13,100,99
2022,4,42200135,4/26/2023,1610612739,Cleveland Cavaliers,1,0,1610612752,New York Knicks,0,1,22,20,42,13,20,33,35,40,75,12,3,15,7,34,24,6,13,89,95
2013,4,41300315,5/29/2014,1610612759,San Antonio Spurs,1,1,1610612760,Oklahoma City Thunder,0,0,26,24,50,13,13,26,39,37,76,26,4,30,10,30,23,6,12,91,117
2013,4,41300315,5/29/2014,1610612760,Oklahoma City Thunder,0,0,1610612759,San Antonio Spurs,1,1,29,28,57,6,18,24,35,46,81,13,7,20,9,41,19,6,11,93,89
2013,4,41300401,6/5/2014,1610612748,Miami Heat,0,0,1610612759,San Antonio Spurs,1,1,25,24,49,12,17,29,37,41,78,9,2,11,8,35,16,8,18,93,95
2013,4,41300401,6/5/2014,1610612759,San Antonio Spurs,1,1,1610612748,Miami Heat,0,0,27,16,43,13,12,25,40,28,68,17,5,22,8,23,30,14,23,95,110
2013,4,41300316,5/31/2014,1610612759,San Antonio Spurs,0,1,1610612760,Oklahoma City Thunder,1,0,27,32,59,11,24,35,38,56,94,25,9,34,18,41,20,9,14,107,112
2013,4,41300316,5/31/2014,1610612760,Oklahoma City Thunder,1,0,1610612759,San Antonio Spurs,0,1,27,28,55,8,19,27,35,47,82,29,4,33,10,39,19,15,20,108,107
2020,4,42000153,5/27/2021,1610612747,Los Angeles Lakers,1,1,1610612756,Phoenix Suns,0,0,31,27,58,7,21,28,38,48,86,26,4,30,21,30,19,8,20,98,109
2020,4,42000153,5/27/2021,1610612756,Phoenix Suns,0,0,1610612747,Los Angeles Lakers,1,1,24,29,53,11,18,29,35,47,82,14,4,18,10,38,24,10,18,99,95
2013,4,41300313,5/25/2014,1610612759,San Antonio Spurs,0,0,1610612760,Oklahoma City Thunder,1,1,26,39,65,10,16,26,36,55,91,15,1,16,16,39,22,7,16,98,97
2013,4,41300313,5/25/2014,1610612760,Oklahoma City Thunder,1,1,1610612759,San Antonio Spurs,0,0,31,28,59,6,16,22,37,44,81,26,5,31,16,31,17,6,18,98,106
2013,4,41300312,5/21/2014,1610612759,San Antonio Spurs,1,1,1610612760,Oklahoma City Thunder,0,0,32,27,59,9,14,23,41,41,82,21,2,23,13,30,27,6,12,93,112
2013,4,41300312,5/21/2014,1610612760,Oklahoma City Thunder,0,0,1610612759,San Antonio Spurs,1,1,33,36,69,2,18,20,35,54,89,5,5,10,15,42,18,8,14,94,77
2013,4,41300314,5/27/2014,1610612759,San Antonio Spurs,0,0,1610612760,Oklahoma City Thunder,1,1,24,32,56,9,18,27,33,50,83,17,5,22,14,40,17,12,13,93,92
2013,4,41300314,5/27/2014,1610612760,Oklahoma City Thunder,1,1,1610612759,San Antonio Spurs,0,0,30,30,60,7,9,16,37,39,76,24,7,31,7,36,22,4,7,92,105
2022,4,42200401,6/1/2023,1610612743,Denver Nuggets,1,1,1610612748,Miami Heat,0,0,32,20,52,8,19,27,40,39,79,16,4,20,7,34,29,5,10,91,104
2022,4,42200401,6/1/2023,1610612748,Miami Heat,0,0,1610612743,Denver Nuggets,1,1,26,31,57,13,26,39,39,57,96,2,0,2,14,43,26,4,8,93,93
2020,4,42000152,5/25/2021,1610612747,Los Angeles Lakers,0,1,1610612756,Phoenix Suns,1,0,26,21,47,10,23,33,36,44,80,27,4,31,14,32,24,4,9,90,109
2020,4,42000152,5/25/2021,1610612756,Phoenix Suns,1,0,1610612747,Los Angeles Lakers,0,1,25,20,45,8,18,26,33,38,71,28,2,30,6,34,21,9,13,90,102
2013,4,41300305,5/28/2014,1610612748,Miami Heat,0,0,1610612754,Indiana Pacers,1,1,19,25,44,15,16,31,34,41,75,7,1,8,11,30,22,12,17,84,90
2013,4,41300305,5/28/2014,1610612754,Indiana Pacers,1,1,1610612748,Miami Heat,0,0,31,26,57,6,15,21,37,41,78,13,9,22,19,28,13,6,13,85,93
2013,4,41300306,5/30/2014,1610612748,Miami Heat,1,1,1610612754,Indiana Pacers,0,0,33,17,50,11,15,26,44,32,76,18,3,21,10,25,24,5,11,86,117
2013,4,41300306,5/30/2014,1610612754,Indiana Pacers,0,0,1610612748,Miami Heat,1,1,22,22,44,10,15,25,32,37,69,18,6,24,5,35,14,7,12,87,92
2013,4,41300311,5/19/2014,1610612759,San Antonio Spurs,1,1,1610612760,Oklahoma City Thunder,0,0,41,29,70,9,8,17,50,37,87,13,4,17,9,29,28,4,10,95,122
2013,4,41300311,5/19/2014,1610612760,Oklahoma City Thunder,0,0,1610612759,San Antonio Spurs,1,1,25,28,53,12,15,27,37,43,80,19,4,23,11,32,19,8,16,95,105
2022,4,42200402,6/4/2023,1610612743,Denver Nuggets,1,0,1610612748,Miami Heat,0,1,28,19,47,11,17,28,39,36,75,19,3,22,14,24,23,5,14,87,108
2022,4,42200156,4/28/2023,1610612747,Los Angeles Lakers,1,1,1610612763,Memphis Grizzlies,0,0,34,13,47,15,29,44,49,42,91,12,3,15,12,32,33,10,16,103,125
2020,4,42000151,5/23/2021,1610612747,Los Angeles Lakers,0,0,1610612756,Phoenix Suns,1,1,26,24,50,7,19,26,33,43,76,17,11,28,12,35,19,7,14,91,90
2020,4,42000151,5/23/2021,1610612756,Phoenix Suns,1,1,1610612747,Los Angeles Lakers,0,0,31,27,58,9,19,28,40,46,86,10,2,12,19,29,24,10,16,91,99
2022,4,42200156,4/28/2023,1610612763,Memphis Grizzlies,0,0,1610612747,Los Angeles Lakers,1,1,17,41,58,12,26,38,29,67,96,15,5,20,18,50,19,6,14,102,85
2022,4,42200217,5/14/2023,1610612755,Philadelphia 76ers,0,0,1610612738,Boston Celtics,1,1,23,23,46,8,29,37,31,52,83,18,1,19,14,38,15,7,14,91,88
2022,4,42200402,6/4/2023,1610612748,Miami Heat,0,1,1610612743,Denver Nuggets,1,0,21,22,43,17,18,35,38,40,78,18,2,20,10,31,28,7,11,85,111
2022,4,42200141,4/16/2023,1610612750,Minnesota Timberwolves,0,0,1610612743,Denver Nuggets,1,1,19,26,45,11,25,36,30,51,81,9,7,16,7,46,18,6,12,93,80
2022,4,42200103,4/22/2023,1610612748,Miami Heat,1,1,1610612749,Milwaukee Bucks,0,0,29,22,51,16,17,33,45,39,84,15,2,17,9,31,22,7,14,97,121
2022,4,42200217,5/14/2023,1610612738,Boston Celtics,1,1,1610612755,Philadelphia 76ers,0,0,26,28,54,15,18,33,41,46,87,15,3,18,13,33,18,4,8,91,112
2013,4,41300302,5/20/2014,1610612748,Miami Heat,0,1,1610612754,Indiana Pacers,1,0,26,21,47,8,12,20,34,33,67,11,7,18,10,26,19,6,13,80,87
2013,4,41300302,5/20/2014,1610612754,Indiana Pacers,1,0,1610612748,Miami Heat,0,1,23,38,61,9,10,19,32,48,80,10,5,15,18,33,19,7,11,81,83
2022,4,42200141,4/16/2023,1610612743,Denver Nuggets,1,1,1610612750,Minnesota Timberwolves,0,0,25,26,51,16,23,39,41,49,90,11,6,17,16,36,24,6,11,94,109
2013,4,41300304,5/26/2014,1610612748,Miami Heat,1,1,1610612754,Indiana Pacers,0,0,24,21,45,8,16,24,32,37,69,30,4,34,9,30,16,1,7,83,102
2013,4,41300304,5/26/2014,1610612754,Indiana Pacers,0,0,1610612748,Miami Heat,1,1,26,24,50,9,12,21,35,36,71,11,6,17,10,28,18,7,14,82,90
2013,4,41300303,5/24/2014,1610612748,Miami Heat,1,1,1610612754,Indiana Pacers,0,0,27,23,50,10,8,18,37,31,68,15,5,20,8,24,17,7,15,84,99
2013,4,41300303,5/24/2014,1610612754,Indiana Pacers,0,0,1610612748,Miami Heat,1,1,25,19,44,6,15,21,31,34,65,19,6,25,11,24,17,9,19,86,87
2009,4,40900407,6/17/2010,1610612738,Boston Celtics,0,0,1610612747,Los Angeles Lakers,1,1,23,32,55,6,10,16,29,42,71,15,2,17,10,34,18,0,15,85,79
2009,4,40900407,6/17/2010,1610612747,Los Angeles Lakers,1,1,1610612738,Boston Celtics,0,0,23,40,63,4,16,20,27,56,83,25,12,37,27,34,11,0,11,86,83
2009,4,40900406,6/15/2010,1610612738,Boston Celtics,0,0,1610612747,Los Angeles Lakers,1,1,23,38,61,5,18,23,28,56,84,6,4,10,16,42,17,13,14,87,67
2009,4,40900406,6/15/2010,1610612747,Los Angeles Lakers,1,1,1610612738,Boston Celtics,0,0,27,33,60,6,13,19,33,46,79,17,2,19,15,31,17,8,13,86,89
2009,4,40900405,6/13/2010,1610612738,Boston Celtics,1,1,1610612747,Los Angeles Lakers,0,0,37,22,59,3,9,12,40,31,71,9,4,13,12,21,21,9,17,84,92
2009,4,40900405,6/13/2010,1610612747,Los Angeles Lakers,0,0,1610612738,Boston Celtics,1,1,24,35,59,7,12,19,31,47,78,17,9,26,18,34,12,8,14,84,86
2009,4,40900404,6/10/2010,1610612738,Boston Celtics,1,1,1610612747,Los Angeles Lakers,0,0,34,37,71,3,9,12,37,46,83,19,4,23,19,28,15,6,12,85,96
2009,4,40900404,6/10/2010,1610612747,Los Angeles Lakers,0,0,1610612738,Boston Celtics,1,1,25,26,51,7,13,20,32,39,71,18,4,22,12,28,13,12,16,85,89
2022,4,42200103,4/22/2023,1610612749,Milwaukee Bucks,0,0,1610612748,Miami Heat,1,1,23,23,46,15,24,39,38,47,85,8,4,12,12,36,22,13,18,98,99
2009,4,40900403,6/8/2010,1610612738,Boston Celtics,1,0,1610612747,Los Angeles Lakers,0,1,28,27,55,4,14,18,32,41,73,16,8,24,13,34,20,2,10,83,84
2009,4,40900403,6/8/2010,1610612747,Los Angeles Lakers,0,1,1610612738,Boston Celtics,1,0,32,29,61,2,13,15,34,42,76,21,3,24,12,31,13,4,9,83,91
2009,4,40900402,6/6/2010,1610612738,Boston Celtics,0,1,1610612747,Los Angeles Lakers,1,0,25,43,68,11,5,16,36,48,84,20,6,26,20,31,28,8,14,93,103
2009,4,40900402,6/6/2010,1610612747,Los Angeles Lakers,1,0,1610612738,Boston Celtics,0,1,24,25,49,5,17,22,29,42,71,31,10,41,14,33,18,6,15,93,94
2022,4,42200153,4/22/2023,1610612763,Memphis Grizzlies,0,0,1610612747,Los Angeles Lakers,1,1,22,32,54,13,26,39,35,58,93,18,2,20,19,41,23,11,18,101,101
2009,4,40900401,6/3/2010,1610612738,Boston Celtics,0,0,1610612747,Los Angeles Lakers,1,1,28,29,57,1,9,10,29,38,67,30,6,36,9,31,19,6,14,90,89
2009,4,40900401,6/3/2010,1610612747,Los Angeles Lakers,1,1,1610612738,Boston Celtics,0,0,33,33,66,4,6,10,37,39,76,24,7,31,17,25,18,5,15,90,102
2009,4,40900316,5/29/2010,1610612747,Los Angeles Lakers,0,1,1610612756,Phoenix Suns,1,0,29,30,59,10,14,24,39,44,83,23,5,28,17,29,18,4,10,90,111
2009,4,40900316,5/29/2010,1610612756,Phoenix Suns,1,0,1610612747,Los Angeles Lakers,0,1,26,23,49,9,17,26,35,40,75,24,5,29,10,32,19,6,12,90,103
2022,4,42200153,4/22/2023,1610612747,Los Angeles Lakers,1,1,1610612763,Memphis Grizzlies,0,0,34,28,62,7,21,28,41,49,90,22,5,27,18,35,19,7,16,103,111
2009,4,40900314,5/25/2010,1610612747,Los Angeles Lakers,0,0,1610612756,Phoenix Suns,1,1,36,27,63,9,19,28,45,46,91,7,6,13,17,35,25,3,7,87,106
2009,4,40900314,5/25/2010,1610612756,Phoenix Suns,1,1,1610612747,Los Angeles Lakers,0,0,30,24,54,11,19,30,41,43,84,22,10,32,22,25,23,4,8,86,115
2009,4,40900315,5/27/2010,1610612747,Los Angeles Lakers,1,1,1610612756,Phoenix Suns,0,0,31,36,67,7,17,24,38,53,91,20,3,23,24,31,28,7,11,90,103
2009,4,40900315,5/27/2010,1610612756,Phoenix Suns,0,0,1610612747,Los Angeles Lakers,1,1,27,23,50,9,18,27,36,41,77,20,9,29,14,32,19,7,15,89,101
2009,4,40900313,5/23/2010,1610612747,Los Angeles Lakers,0,0,1610612756,Phoenix Suns,1,1,33,22,55,9,23,32,42,45,87,16,4,20,18,30,20,10,17,98,109
2009,4,40900313,5/23/2010,1610612756,Phoenix Suns,1,1,1610612747,Los Angeles Lakers,0,0,33,29,62,5,15,20,38,44,82,37,5,42,11,35,19,4,7,96,118
2009,4,40900312,5/19/2010,1610612747,Los Angeles Lakers,1,1,1610612756,Phoenix Suns,0,0,36,26,62,9,7,16,45,33,78,25,9,34,13,27,32,0,14,97,124
2009,4,40900312,5/19/2010,1610612756,Phoenix Suns,0,0,1610612747,Los Angeles Lakers,1,1,31,28,59,10,14,24,41,42,83,20,6,26,15,28,29,0,17,96,112
2009,4,40900311,5/17/2010,1610612747,Los Angeles Lakers,1,1,1610612756,Phoenix Suns,0,0,43,28,71,8,9,17,51,37,88,18,4,22,13,25,26,6,9,93,128
2009,4,40900311,5/17/2010,1610612756,Phoenix Suns,0,0,1610612747,Los Angeles Lakers,1,1,34,23,57,5,17,22,39,40,79,24,8,32,13,31,25,8,12,94,107
2009,4,40900306,5/28/2010,1610612738,Boston Celtics,1,1,1610612753,Orlando Magic,0,0,22,31,53,10,12,22,32,43,75,22,5,27,17,28,19,8,17,88,96
2009,4,40900306,5/28/2010,1610612753,Orlando Magic,0,0,1610612738,Boston Celtics,1,1,25,25,50,6,16,22,31,41,72,16,11,27,10,36,14,7,12,87,84
2009,4,40900305,5/26/2010,1610612738,Boston Celtics,0,0,1610612753,Orlando Magic,1,1,24,32,56,7,9,16,31,41,72,23,7,30,9,35,19,6,10,88,92
2009,4,40900305,5/26/2010,1610612753,Orlando Magic,1,1,1610612738,Boston Celtics,0,0,23,21,44,13,12,25,36,33,69,28,7,35,13,23,16,5,14,87,113
2009,4,40900304,5/24/2010,1610612738,Boston Celtics,1,0,1610612753,Orlando Magic,0,1,27,31,58,5,13,18,32,44,76,23,7,30,11,36,19,5,17,95,92
2009,4,40900304,5/24/2010,1610612753,Orlando Magic,0,1,1610612738,Boston Celtics,1,0,23,23,46,10,18,28,33,41,74,20,13,33,11,39,19,10,18,95,96
2009,4,40900303,5/22/2010,1610612738,Boston Celtics,1,1,1610612753,Orlando Magic,0,0,28,34,62,6,5,11,34,39,73,20,8,28,9,34,23,5,9,87,94
2009,4,40900303,5/22/2010,1610612753,Orlando Magic,0,0,1610612738,Boston Celtics,1,1,16,19,35,8,22,30,24,41,65,15,3,18,6,37,10,12,17,87,71
2009,4,40900301,5/16/2010,1610612738,Boston Celtics,0,1,1610612753,Orlando Magic,1,0,27,33,60,6,8,14,33,41,74,20,6,26,12,33,21,6,16,90,92
2009,4,40900301,5/16/2010,1610612753,Orlando Magic,1,0,1610612738,Boston Celtics,0,1,27,28,55,5,17,22,32,45,77,19,7,26,18,31,10,8,18,90,88
2009,4,40900302,5/18/2010,1610612738,Boston Celtics,0,1,1610612753,Orlando Magic,1,0,29,30,59,5,10,15,34,40,74,22,6,28,14,29,20,9,15,88,95
2009,4,40900302,5/18/2010,1610612753,Orlando Magic,1,0,1610612738,Boston Celtics,0,1,21,32,53,7,11,18,28,43,71,29,9,38,16,30,18,7,14,89,92
2009,4,40900234,5/10/2010,1610612747,Los Angeles Lakers,0,1,1610612762,Utah Jazz,1,0,32,34,66,6,11,17,38,45,83,29,7,36,16,33,14,4,6,92,111
2009,4,40900234,5/10/2010,1610612762,Utah Jazz,1,0,1610612747,Los Angeles Lakers,0,1,33,32,65,4,12,16,37,44,81,18,9,27,16,32,16,7,13,91,96
2009,4,40900233,5/8/2010,1610612747,Los Angeles Lakers,0,1,1610612762,Utah Jazz,1,0,28,30,58,13,16,29,41,46,87,16,3,19,17,31,18,4,8,88,111
2009,4,40900233,5/8/2010,1610612762,Utah Jazz,1,0,1610612747,Los Angeles Lakers,0,1,27,28,55,10,12,22,37,40,77,26,5,31,16,26,23,5,11,88,110
2009,4,40900232,5/4/2010,1610612747,Los Angeles Lakers,1,1,1610612762,Utah Jazz,0,0,36,26,62,4,13,17,40,39,79,27,9,36,21,22,26,10,20,97,111
2009,4,40900232,5/4/2010,1610612762,Utah Jazz,0,0,1610612747,Los Angeles Lakers,1,1,30,47,77,8,11,19,38,58,96,19,9,28,22,40,27,6,10,96,103
2022,4,42200116,4/27/2023,1610612737,Atlanta Hawks,1,0,1610612738,Boston Celtics,0,1,29,30,59,15,20,35,44,50,94,17,5,22,15,38,28,7,10,96,120
2009,4,40900231,5/2/2010,1610612747,Los Angeles Lakers,1,1,1610612762,Utah Jazz,0,0,39,26,65,2,10,12,41,36,77,20,7,27,11,30,18,8,14,93,104
2009,4,40900231,5/2/2010,1610612762,Utah Jazz,0,0,1610612747,Los Angeles Lakers,1,1,33,34,67,5,13,18,38,47,85,18,3,21,14,33,24,8,11,93,99
2009,4,40900223,5/7/2010,1610612756,Phoenix Suns,0,1,1610612759,San Antonio Spurs,1,0,27,26,53,15,11,26,42,37,79,11,6,17,9,32,16,6,12,90,110
2009,4,40900223,5/7/2010,1610612759,San Antonio Spurs,1,0,1610612756,Phoenix Suns,0,1,28,36,64,8,8,16,36,44,80,16,12,28,14,34,17,7,12,91,96
2009,4,40900224,5/9/2010,1610612756,Phoenix Suns,0,1,1610612759,San Antonio Spurs,1,0,27,30,57,10,14,24,37,44,81,23,5,28,11,35,22,9,12,94,107
2009,4,40900224,5/9/2010,1610612759,San Antonio Spurs,1,0,1610612756,Phoenix Suns,0,1,31,33,64,4,7,11,35,40,75,27,9,36,11,32,20,9,16,96,101
2009,4,40900222,5/5/2010,1610612756,Phoenix Suns,1,1,1610612759,San Antonio Spurs,0,0,27,39,66,9,10,19,36,49,85,29,8,37,22,33,19,0,14,94,110
2009,4,40900222,5/5/2010,1610612759,San Antonio Spurs,0,0,1610612756,Phoenix Suns,1,1,33,28,61,7,11,18,40,39,79,15,7,22,9,33,28,0,12,95,102
2009,4,40900214,5/10/2010,1610612737,Atlanta Hawks,1,0,1610612753,Orlando Magic,0,1,27,35,62,3,9,12,30,44,74,21,8,29,12,36,17,4,8,82,84
2009,4,40900214,5/10/2010,1610612753,Orlando Magic,0,1,1610612737,Atlanta Hawks,1,0,20,8,28,16,21,37,36,29,65,10,9,19,9,23,27,6,16,84,98
2009,4,40900221,5/3/2010,1610612756,Phoenix Suns,1,1,1610612759,San Antonio Spurs,0,0,34,25,59,7,13,20,41,38,79,22,7,29,10,32,16,8,16,99,111
2009,4,40900221,5/3/2010,1610612759,San Antonio Spurs,0,0,1610612756,Phoenix Suns,1,1,34,30,64,4,15,19,38,45,83,22,9,31,11,38,18,4,12,99,102
2009,4,40900212,5/6/2010,1610612737,Atlanta Hawks,0,0,1610612753,Orlando Magic,1,1,25,39,64,6,5,11,31,44,75,30,1,31,18,27,16,5,12,85,98
2009,4,40900212,5/6/2010,1610612753,Orlando Magic,1,1,1610612737,Atlanta Hawks,0,0,29,16,45,9,14,23,38,30,68,27,12,39,11,27,16,4,9,85,112
2009,4,40900213,5/8/2010,1610612737,Atlanta Hawks,1,0,1610612753,Orlando Magic,0,1,25,43,68,4,11,15,29,54,83,13,6,19,15,41,9,5,8,83,75
2009,4,40900213,5/8/2010,1610612753,Orlando Magic,0,1,1610612737,Atlanta Hawks,1,0,26,16,42,10,19,29,36,35,71,23,11,34,14,25,21,6,9,84,105
2009,4,40900211,5/4/2010,1610612737,Atlanta Hawks,0,0,1610612753,Orlando Magic,1,1,26,42,68,2,11,13,28,53,81,13,5,18,15,40,12,6,16,92,71
2009,4,40900211,5/4/2010,1610612753,Orlando Magic,1,1,1610612737,Atlanta Hawks,0,0,35,26,61,9,14,23,44,40,84,17,7,24,17,26,23,9,13,92,114
2009,4,40900205,5/11/2010,1610612738,Boston Celtics,0,1,1610612739,Cleveland Cavaliers,1,0,36,29,65,8,7,15,44,36,80,24,10,34,15,25,25,5,10,92,120
2009,4,40900205,5/11/2010,1610612739,Cleveland Cavaliers,1,0,1610612738,Boston Celtics,0,1,23,30,53,5,10,15,28,40,68,27,7,34,9,33,20,6,17,90,88
2009,4,40900206,5/13/2010,1610612738,Boston Celtics,1,1,1610612739,Cleveland Cavaliers,0,0,29,31,60,5,12,17,34,43,77,21,12,33,11,37,24,10,13,97,94
2009,4,40900206,5/13/2010,1610612739,Cleveland Cavaliers,0,0,1610612738,Boston Celtics,1,1,23,33,56,5,12,17,28,45,73,24,10,34,16,33,17,13,24,96,85
2009,4,40900204,5/9/2010,1610612738,Boston Celtics,1,1,1610612739,Cleveland Cavaliers,0,0,33,29,62,1,13,14,34,42,76,28,12,40,13,34,19,6,12,97,97
2009,4,40900204,5/9/2010,1610612739,Cleveland Cavaliers,0,0,1610612738,Boston Celtics,1,1,23,23,46,4,17,21,27,40,67,29,10,39,4,40,19,10,17,96,87
2009,4,40900203,5/7/2010,1610612738,Boston Celtics,1,0,1610612739,Cleveland Cavaliers,0,1,31,34,65,4,13,17,35,47,82,21,8,29,14,37,20,3,7,87,95
2009,4,40900203,5/7/2010,1610612739,Cleveland Cavaliers,0,1,1610612738,Boston Celtics,1,0,39,23,62,5,7,12,44,30,74,31,3,34,15,16,25,3,12,89,124
2013,4,41300235,5/13/2014,1610612746,LA Clippers,0,0,1610612760,Oklahoma City Thunder,1,1,26,35,61,12,15,27,38,50,88,16,4,20,16,38,21,9,17,95,104
2013,4,41300235,5/13/2014,1610612760,Oklahoma City Thunder,1,1,1610612746,LA Clippers,0,0,26,34,60,7,10,17,33,44,77,32,4,36,10,35,14,7,13,95,105
2009,4,40900202,5/3/2010,1610612738,Boston Celtics,0,1,1610612739,Cleveland Cavaliers,1,0,31,28,59,9,10,19,40,38,78,15,3,18,11,28,30,9,19,95,104
2009,4,40900202,5/3/2010,1610612739,Cleveland Cavaliers,1,0,1610612738,Boston Celtics,0,1,24,25,49,4,17,21,28,42,70,26,12,38,8,38,17,8,15,93,86
2009,4,40900201,5/1/2010,1610612738,Boston Celtics,0,0,1610612739,Cleveland Cavaliers,1,1,32,33,65,4,12,16,36,45,81,17,4,21,15,33,20,8,16,92,93
2009,4,40900201,5/1/2010,1610612739,Cleveland Cavaliers,1,1,1610612738,Boston Celtics,0,0,34,32,66,4,8,12,38,40,78,21,10,31,12,33,18,6,11,92,101
2009,4,40900176,4/30/2010,1610612743,Denver Nuggets,0,0,1610612762,Utah Jazz,1,1,31,35,66,5,12,17,36,47,83,27,13,40,14,39,19,0,10,99,104
2009,4,40900176,4/30/2010,1610612762,Utah Jazz,1,1,1610612743,Denver Nuggets,0,0,30,24,54,6,9,15,36,33,69,34,17,51,11,31,26,0,19,99,112
2009,4,40900175,4/28/2010,1610612743,Denver Nuggets,1,1,1610612762,Utah Jazz,0,0,28,28,56,9,8,17,37,36,73,33,9,42,13,28,20,0,13,96,116
2009,4,40900175,4/28/2010,1610612762,Utah Jazz,0,0,1610612743,Denver Nuggets,1,1,31,35,66,7,11,18,38,46,84,19,6,25,18,32,19,0,16,95,102
2009,4,40900174,4/25/2010,1610612743,Denver Nuggets,0,0,1610612762,Utah Jazz,1,1,31,37,68,6,10,16,37,47,84,26,9,35,21,30,13,6,18,97,106
2009,4,40900174,4/25/2010,1610612762,Utah Jazz,1,1,1610612743,Denver Nuggets,0,0,36,23,59,5,13,18,41,36,77,30,12,42,15,27,24,12,15,97,117
2013,4,41300236,5/15/2014,1610612746,LA Clippers,1,0,1610612760,Oklahoma City Thunder,0,1,34,40,74,6,15,21,40,55,95,12,8,20,19,39,26,5,9,96,98
2009,4,40900173,4/23/2010,1610612743,Denver Nuggets,0,0,1610612762,Utah Jazz,1,1,27,30,57,4,11,15,31,41,72,27,8,35,9,33,12,10,14,94,93
2009,4,40900173,4/23/2010,1610612762,Utah Jazz,1,1,1610612743,Denver Nuggets,0,0,32,33,65,7,11,18,39,44,83,20,11,31,13,35,27,4,9,95,105
2013,4,41300236,5/15/2014,1610612760,Oklahoma City Thunder,0,1,1610612746,LA Clippers,1,0,24,23,47,9,16,25,33,39,72,29,4,33,9,32,25,9,15,96,104
2009,4,40900171,4/17/2010,1610612743,Denver Nuggets,1,1,1610612762,Utah Jazz,0,0,37,21,58,11,15,26,48,36,84,19,6,25,13,28,29,4,8,94,126
2009,4,40900171,4/17/2010,1610612762,Utah Jazz,0,0,1610612743,Denver Nuggets,1,1,34,24,58,7,10,17,41,34,75,24,8,32,5,33,26,6,10,93,113
2009,4,40900172,4/19/2010,1610612743,Denver Nuggets,1,0,1610612762,Utah Jazz,0,1,31,26,57,4,14,18,35,40,75,37,7,44,13,29,22,7,19,102,111
2009,4,40900172,4/19/2010,1610612762,Utah Jazz,0,1,1610612743,Denver Nuggets,1,0,30,25,55,6,7,13,36,32,68,36,11,47,8,28,26,9,18,100,114
2009,4,40900166,4/29/2010,1610612756,Phoenix Suns,0,1,1610612757,Portland Trail Blazers,1,0,23,28,51,12,11,23,35,39,74,17,9,26,16,28,21,7,17,88,99
2009,4,40900166,4/29/2010,1610612757,Portland Trail Blazers,1,0,1610612756,Phoenix Suns,0,1,19,37,56,11,12,23,30,49,79,19,5,24,14,36,22,7,10,88,90
2013,4,41300301,5/18/2014,1610612748,Miami Heat,0,0,1610612754,Indiana Pacers,1,1,34,21,55,6,17,23,40,38,78,10,5,15,8,32,23,4,11,88,96
2013,4,41300301,5/18/2014,1610612754,Indiana Pacers,1,1,1610612748,Miami Heat,0,0,27,22,49,8,11,19,35,33,68,29,8,37,8,28,23,7,12,88,107
2009,4,40900164,4/24/2010,1610612756,Phoenix Suns,0,0,1610612757,Portland Trail Blazers,1,1,27,26,53,6,17,23,33,43,76,15,6,21,13,34,17,0,12,84,87
2009,4,40900164,4/24/2010,1610612757,Portland Trail Blazers,1,1,1610612756,Phoenix Suns,0,0,30,35,65,5,9,14,35,44,79,21,7,28,15,35,26,0,7,85,96
2009,4,40900165,4/26/2010,1610612756,Phoenix Suns,1,1,1610612757,Portland Trail Blazers,0,0,24,22,46,10,17,27,34,39,73,29,3,32,18,22,21,8,13,84,107
2009,4,40900165,4/26/2010,1610612757,Portland Trail Blazers,0,0,1610612756,Phoenix Suns,1,1,25,26,51,7,11,18,32,37,69,17,7,24,14,29,21,8,15,85,88
2022,4,42200116,4/27/2023,1610612738,Boston Celtics,0,1,1610612737,Atlanta Hawks,1,0,29,23,52,18,24,42,47,47,94,16,1,17,13,34,24,5,7,97,128
2009,4,40900163,4/22/2010,1610612756,Phoenix Suns,0,1,1610612757,Portland Trail Blazers,1,0,24,18,42,13,15,28,37,33,70,21,9,30,12,25,21,9,15,89,108
2009,4,40900163,4/22/2010,1610612757,Portland Trail Blazers,1,0,1610612756,Phoenix Suns,0,1,29,32,61,5,11,16,34,43,77,16,12,28,16,31,20,7,13,88,89
2009,4,40900162,4/20/2010,1610612756,Phoenix Suns,1,1,1610612757,Portland Trail Blazers,0,0,37,29,66,8,12,20,45,41,86,21,3,24,19,23,26,3,7,87,119
2009,4,40900162,4/20/2010,1610612757,Portland Trail Blazers,0,0,1610612756,Phoenix Suns,1,1,25,39,64,4,8,12,29,47,76,28,5,33,16,34,12,4,10,87,90
2009,4,40900161,4/18/2010,1610612756,Phoenix Suns,1,0,1610612757,Portland Trail Blazers,0,1,27,32,59,11,21,32,38,53,91,13,3,16,19,36,20,5,12,92,100
2009,4,40900161,4/18/2010,1610612757,Portland Trail Blazers,0,1,1610612756,Phoenix Suns,1,0,32,32,64,6,11,17,38,43,81,23,8,31,17,31,16,1,11,92,105
2022,4,42200166,4/28/2023,1610612758,Sacramento Kings,0,1,1610612744,Golden State Warriors,1,0,23,31,54,17,28,45,40,59,99,21,4,25,24,36,25,14,20,108,118
2009,4,40900156,4/29/2010,1610612742,Dallas Mavericks,0,0,1610612759,San Antonio Spurs,1,1,30,30,60,5,15,20,35,45,80,12,3,15,15,32,15,7,13,86,87
2009,4,40900156,4/29/2010,1610612759,San Antonio Spurs,1,1,1610612742,Dallas Mavericks,0,0,33,33,66,4,8,12,37,41,78,19,12,31,15,32,23,4,8,86,97
2009,4,40900155,4/27/2010,1610612742,Dallas Mavericks,1,1,1610612759,San Antonio Spurs,0,0,31,29,60,6,18,24,37,47,84,23,10,33,16,36,20,5,12,98,103
2009,4,40900155,4/27/2010,1610612759,San Antonio Spurs,0,0,1610612742,Dallas Mavericks,1,1,25,37,62,3,13,16,28,50,78,22,6,28,11,39,11,14,18,97,81
2009,4,40900154,4/25/2010,1610612742,Dallas Mavericks,0,0,1610612759,San Antonio Spurs,1,1,25,33,58,7,12,19,32,45,77,18,5,23,14,34,17,8,15,88,89
2009,4,40900154,4/25/2010,1610612759,San Antonio Spurs,1,1,1610612742,Dallas Mavericks,0,0,28,30,58,6,11,17,34,41,75,18,10,28,10,38,19,5,12,89,92
2009,4,40900153,4/23/2010,1610612742,Dallas Mavericks,0,0,1610612759,San Antonio Spurs,1,1,26,30,56,8,12,20,34,42,76,14,1,15,15,28,17,5,16,85,90
2009,4,40900153,4/23/2010,1610612759,San Antonio Spurs,1,1,1610612742,Dallas Mavericks,0,0,37,32,69,0,7,7,37,39,76,20,6,26,14,29,19,5,11,83,94
2009,4,40900152,4/21/2010,1610612742,Dallas Mavericks,1,0,1610612759,San Antonio Spurs,0,1,24,42,66,7,12,19,31,54,85,19,1,20,18,36,19,5,7,86,88
2009,4,40900152,4/21/2010,1610612759,San Antonio Spurs,0,1,1610612742,Dallas Mavericks,1,0,32,36,68,8,7,15,40,43,83,14,8,22,18,29,18,7,9,84,102
2009,4,40900151,4/18/2010,1610612742,Dallas Mavericks,1,1,1610612759,San Antonio Spurs,0,0,30,30,60,5,9,14,35,39,74,25,9,34,14,29,23,7,15,92,100
2009,4,40900151,4/18/2010,1610612759,San Antonio Spurs,0,0,1610612742,Dallas Mavericks,1,1,35,32,67,4,7,11,39,39,78,12,2,14,9,33,19,10,17,91,94
2009,4,40900146,4/30/2010,1610612747,Los Angeles Lakers,0,1,1610612760,Oklahoma City Thunder,1,0,25,30,55,12,12,24,37,42,79,9,5,14,15,30,23,7,16,87,95
2009,4,40900146,4/30/2010,1610612760,Oklahoma City Thunder,1,0,1610612747,Los Angeles Lakers,0,1,26,40,66,5,14,19,31,54,85,27,4,31,20,35,21,4,7,88,94
2009,4,40900144,4/24/2010,1610612747,Los Angeles Lakers,0,0,1610612760,Oklahoma City Thunder,1,1,30,30,60,4,18,22,34,48,82,17,11,28,15,38,19,8,11,93,89
2009,4,40900144,4/24/2010,1610612760,Oklahoma City Thunder,1,1,1610612747,Los Angeles Lakers,0,0,25,33,58,6,12,18,31,45,76,42,6,48,16,33,15,4,10,93,110
2009,4,40900145,4/27/2010,1610612747,Los Angeles Lakers,1,1,1610612760,Oklahoma City Thunder,0,0,37,27,64,5,9,14,42,36,78,22,9,31,13,29,27,6,13,94,111
2009,4,40900145,4/27/2010,1610612760,Oklahoma City Thunder,0,0,1610612747,Los Angeles Lakers,1,1,24,40,64,7,13,20,31,53,84,18,6,24,19,39,18,10,17,93,87
2009,4,40900142,4/20/2010,1610612747,Los Angeles Lakers,1,1,1610612760,Oklahoma City Thunder,0,0,27,39,66,6,16,22,33,55,88,23,9,32,24,32,20,9,16,96,95
2009,4,40900142,4/20/2010,1610612760,Oklahoma City Thunder,0,0,1610612747,Los Angeles Lakers,1,1,24,31,55,5,14,19,29,45,74,29,4,33,11,35,13,9,17,96,92
2022,4,42200166,4/28/2023,1610612744,Golden State Warriors,1,0,1610612758,Sacramento Kings,0,1,22,32,54,10,22,32,32,54,86,25,10,35,16,40,20,10,18,108,99
2009,4,40900143,4/22/2010,1610612747,Los Angeles Lakers,0,0,1610612760,Oklahoma City Thunder,1,1,28,25,53,10,21,31,38,46,84,10,2,12,8,39,22,3,8,90,96
2009,4,40900143,4/22/2010,1610612760,Oklahoma City Thunder,1,1,1610612747,Los Angeles Lakers,0,0,25,36,61,8,11,19,33,47,80,27,7,34,14,36,16,4,9,90,101
2009,4,40900141,4/18/2010,1610612747,Los Angeles Lakers,1,1,1610612760,Oklahoma City Thunder,0,0,24,32,56,8,14,22,32,46,78,15,7,22,18,32,14,0,14,86,87
2009,4,40900141,4/18/2010,1610612760,Oklahoma City Thunder,0,0,1610612747,Los Angeles Lakers,1,1,27,29,56,2,14,16,29,43,72,19,5,24,13,32,14,0,15,86,79
2009,4,40900135,4/27/2010,1610612738,Boston Celtics,1,1,1610612748,Miami Heat,0,0,28,32,60,7,5,12,35,37,72,19,3,22,8,31,28,6,16,90,96
2009,4,40900135,4/27/2010,1610612748,Miami Heat,0,0,1610612738,Boston Celtics,1,1,26,33,59,5,15,20,31,48,79,19,3,22,17,31,18,11,20,91,86
2009,4,40900134,4/25/2010,1610612738,Boston Celtics,0,0,1610612748,Miami Heat,1,1,26,22,48,8,13,21,34,35,69,16,11,27,6,34,19,9,16,91,92
2009,4,40900134,4/25/2010,1610612748,Miami Heat,1,1,1610612738,Boston Celtics,0,0,28,30,58,10,8,18,38,38,76,15,10,25,13,32,16,10,16,91,101
2009,4,40900132,4/20/2010,1610612738,Boston Celtics,1,1,1610612748,Miami Heat,0,0,24,31,55,12,8,20,36,39,75,22,5,27,14,27,26,4,14,90,106
2009,4,40900132,4/20/2010,1610612748,Miami Heat,0,0,1610612738,Boston Celtics,1,1,20,38,58,9,9,18,29,47,76,10,6,16,8,42,16,7,13,90,77
2013,4,41300231,5/5/2014,1610612746,LA Clippers,0,1,1610612760,Oklahoma City Thunder,1,0,30,23,53,15,14,29,45,37,82,17,13,30,9,33,26,5,9,95,122
2013,4,41300231,5/5/2014,1610612760,Oklahoma City Thunder,1,0,1610612746,LA Clippers,0,1,30,27,57,9,19,28,39,46,85,18,5,23,18,30,17,8,18,96,105
2009,4,40900133,4/23/2010,1610612738,Boston Celtics,0,1,1610612748,Miami Heat,1,0,29,27,56,8,15,23,37,42,79,18,5,23,13,29,19,7,15,91,100
2009,4,40900133,4/23/2010,1610612748,Miami Heat,1,0,1610612738,Boston Celtics,0,1,33,26,59,6,12,18,39,38,77,14,3,17,13,27,20,9,18,92,98
2009,4,40900131,4/17/2010,1610612738,Boston Celtics,1,1,1610612748,Miami Heat,0,0,30,34,64,1,5,6,31,39,70,22,6,28,10,31,18,9,17,91,85
2009,4,40900131,4/17/2010,1610612748,Miami Heat,0,0,1610612738,Boston Celtics,1,1,27,34,61,4,13,17,31,47,78,10,3,13,16,33,18,11,22,89,76
2009,4,40900126,4/30/2010,1610612737,Atlanta Hawks,0,1,1610612749,Milwaukee Bucks,1,0,26,39,65,5,11,16,31,50,81,16,6,22,19,35,15,4,12,87,83
2009,4,40900126,4/30/2010,1610612749,Milwaukee Bucks,1,0,1610612737,Atlanta Hawks,0,1,18,32,50,7,19,26,25,51,76,12,0,12,10,41,14,5,14,86,69
2013,4,41300232,5/7/2014,1610612746,LA Clippers,0,0,1610612760,Oklahoma City Thunder,1,1,28,28,56,9,18,27,37,46,83,18,5,23,10,40,23,8,14,96,101
2009,4,40900127,5/2/2010,1610612737,Atlanta Hawks,1,1,1610612749,Milwaukee Bucks,0,0,30,30,60,6,10,16,36,40,76,17,4,21,19,23,21,5,12,79,95
2009,4,40900127,5/2/2010,1610612749,Milwaukee Bucks,0,0,1610612737,Atlanta Hawks,1,1,24,43,67,4,15,19,28,58,86,14,5,19,20,42,15,1,5,80,74
2009,4,40900125,4/28/2010,1610612737,Atlanta Hawks,1,0,1610612749,Milwaukee Bucks,0,1,34,38,72,2,9,11,36,47,83,13,4,17,17,32,16,10,14,86,87
2009,4,40900125,4/28/2010,1610612749,Milwaukee Bucks,0,1,1610612737,Atlanta Hawks,1,0,22,33,55,8,11,19,30,44,74,23,6,29,15,32,16,6,12,86,91
2013,4,41300232,5/7/2014,1610612760,Oklahoma City Thunder,1,1,1610612746,LA Clippers,0,0,36,28,64,8,15,23,44,43,87,16,6,22,17,30,23,11,16,97,112
2009,4,40900123,4/24/2010,1610612737,Atlanta Hawks,0,0,1610612749,Milwaukee Bucks,1,1,31,41,72,3,12,15,34,53,87,18,7,25,24,33,16,7,12,88,89
2009,4,40900123,4/24/2010,1610612749,Milwaukee Bucks,1,1,1610612737,Atlanta Hawks,0,0,31,26,57,10,13,23,41,39,80,15,1,16,14,26,23,11,14,87,107
2009,4,40900124,4/26/2010,1610612737,Atlanta Hawks,0,0,1610612749,Milwaukee Bucks,1,1,28,33,61,10,9,19,38,42,80,18,3,21,14,29,14,2,12,88,104
2009,4,40900124,4/26/2010,1610612749,Milwaukee Bucks,1,1,1610612737,Atlanta Hawks,0,0,31,20,51,7,11,18,38,31,69,28,4,32,11,22,17,5,15,89,111
2020,4,42000145,6/2/2021,1610612762,Utah Jazz,1,1,1610612763,Memphis Grizzlies,0,0,32,19,51,17,27,44,49,46,95,11,1,12,13,34,27,7,15,102,126
2020,4,42000145,6/2/2021,1610612763,Memphis Grizzlies,0,0,1610612762,Utah Jazz,1,1,30,26,56,14,25,39,44,51,95,8,1,9,10,42,23,10,14,101,110
2009,4,40900122,4/20/2010,1610612737,Atlanta Hawks,1,1,1610612749,Milwaukee Bucks,0,0,35,34,69,3,8,11,38,42,80,17,3,20,12,31,26,5,10,88,96
2009,4,40900122,4/20/2010,1610612749,Milwaukee Bucks,0,0,1610612737,Atlanta Hawks,1,1,33,33,66,4,20,24,37,53,90,8,6,14,23,33,18,9,13,86,86
2013,4,41300234,5/11/2014,1610612746,LA Clippers,1,1,1610612760,Oklahoma City Thunder,0,0,36,36,72,3,18,21,39,54,93,20,9,29,20,40,23,6,9,94,101
2013,4,41300234,5/11/2014,1610612760,Oklahoma City Thunder,0,0,1610612746,LA Clippers,1,1,26,25,51,7,17,24,33,42,75,26,8,34,13,32,17,11,16,95,99
2009,4,40900121,4/17/2010,1610612737,Atlanta Hawks,1,1,1610612749,Milwaukee Bucks,0,0,35,30,65,6,5,11,41,35,76,14,5,19,12,25,18,11,13,88,102
2009,4,40900121,4/17/2010,1610612749,Milwaukee Bucks,0,0,1610612737,Atlanta Hawks,1,1,31,31,62,6,14,20,37,45,82,12,5,17,18,29,11,8,14,87,92
2009,4,40900114,4/26/2010,1610612753,Orlando Magic,0,1,1610612766,Charlotte Hornets,1,0,15,19,34,13,20,33,28,39,67,30,12,42,10,33,18,2,7,84,99
2009,4,40900114,4/26/2010,1610612766,Charlotte Hornets,1,0,1610612753,Orlando Magic,0,1,27,25,52,5,14,19,32,39,71,21,12,33,12,32,27,7,10,84,90
2009,4,40900113,4/24/2010,1610612753,Orlando Magic,0,1,1610612766,Charlotte Hornets,1,0,22,18,40,9,21,30,31,39,70,19,6,25,13,30,14,10,21,90,90
2009,4,40900113,4/24/2010,1610612766,Charlotte Hornets,1,0,1610612753,Orlando Magic,0,1,26,25,51,5,18,23,31,43,74,19,4,23,10,34,17,7,15,90,86
2009,4,40900111,4/18/2010,1610612753,Orlando Magic,1,1,1610612766,Charlotte Hornets,0,0,20,24,44,13,17,30,33,41,74,19,8,27,13,31,13,3,9,85,98
2009,4,40900111,4/18/2010,1610612766,Charlotte Hornets,0,0,1610612753,Orlando Magic,1,1,30,29,59,3,9,12,33,38,71,20,8,28,16,28,19,6,16,84,89
2022,4,42200311,5/16/2023,1610612747,Los Angeles Lakers,0,0,1610612743,Denver Nuggets,1,1,35,25,60,11,13,24,46,38,84,23,3,26,7,33,30,5,7,96,126
2013,4,41300233,5/9/2014,1610612746,LA Clippers,1,0,1610612760,Oklahoma City Thunder,0,1,35,32,67,7,19,26,42,51,93,21,4,25,17,36,25,1,6,94,112
2013,4,41300233,5/9/2014,1610612760,Oklahoma City Thunder,0,1,1610612746,LA Clippers,1,0,38,24,62,6,11,17,44,35,79,24,4,28,14,23,26,5,14,93,118
2009,4,40900112,4/21/2010,1610612753,Orlando Magic,1,1,1610612766,Charlotte Hornets,0,0,19,18,37,10,17,27,29,35,64,24,11,35,13,28,17,7,14,82,92
2009,4,40900112,4/21/2010,1610612766,Charlotte Hornets,0,0,1610612753,Orlando Magic,1,1,23,29,52,6,8,14,29,37,66,13,5,18,13,25,18,11,21,83,77
2009,4,40900104,4/25/2010,1610612739,Cleveland Cavaliers,0,1,1610612741,Chicago Bulls,1,0,30,24,54,12,13,25,42,37,79,25,9,34,5,35,21,2,11,100,121
2009,4,40900104,4/25/2010,1610612741,Chicago Bulls,1,0,1610612739,Cleveland Cavaliers,0,1,30,49,79,4,8,12,34,57,91,26,6,32,21,39,14,6,14,99,98
2009,4,40900105,4/27/2010,1610612739,Cleveland Cavaliers,1,1,1610612741,Chicago Bulls,0,0,24,23,47,10,16,26,34,39,73,18,10,28,11,33,23,7,14,89,96
2009,4,40900105,4/27/2010,1610612741,Chicago Bulls,0,0,1610612739,Cleveland Cavaliers,1,1,33,33,66,2,8,10,35,41,76,22,7,29,11,30,15,6,10,89,94
2009,4,40900103,4/22/2010,1610612739,Cleveland Cavaliers,0,0,1610612741,Chicago Bulls,1,1,22,25,47,14,21,35,36,46,82,20,11,31,16,39,21,0,13,94,106
2009,4,40900103,4/22/2010,1610612741,Chicago Bulls,1,1,1610612739,Cleveland Cavaliers,0,0,37,35,72,5,7,12,42,42,84,19,6,25,11,33,22,0,8,94,108
2022,4,42200311,5/16/2023,1610612743,Denver Nuggets,1,1,1610612747,Los Angeles Lakers,0,0,35,24,59,15,17,32,50,41,91,17,5,22,16,28,29,6,11,96,132
2009,4,40900102,4/19/2010,1610612739,Cleveland Cavaliers,1,1,1610612741,Chicago Bulls,0,0,30,21,51,10,10,20,40,31,71,22,2,24,6,26,24,3,12,88,112
2009,4,40900102,4/19/2010,1610612741,Chicago Bulls,0,0,1610612739,Cleveland Cavaliers,1,1,37,43,80,4,9,13,41,52,93,16,1,17,16,36,25,2,4,89,102
2009,4,40900101,4/17/2010,1610612739,Cleveland Cavaliers,1,1,1610612741,Chicago Bulls,0,0,33,28,61,6,17,23,39,45,84,12,5,17,14,32,27,12,18,95,96
2009,4,40900101,4/17/2010,1610612741,Chicago Bulls,0,0,1610612739,Cleveland Cavaliers,1,1,36,44,80,1,6,7,37,50,87,8,3,11,11,41,19,7,14,95,83
2020,4,42000144,5/31/2021,1610612762,Utah Jazz,0,1,1610612763,Memphis Grizzlies,1,0,22,29,51,17,17,34,39,46,85,25,3,28,9,39,23,8,11,102,120
2020,4,42000144,5/31/2021,1610612763,Memphis Grizzlies,1,0,1610612762,Utah Jazz,0,1,33,24,57,10,25,35,43,49,92,17,3,20,11,39,26,7,9,102,113
2013,4,41300222,5/8/2014,1610612757,Portland Trail Blazers,0,0,1610612759,San Antonio Spurs,1,1,33,42,75,7,11,18,40,53,93,10,0,10,22,31,15,7,15,93,97
2013,4,41300222,5/8/2014,1610612759,San Antonio Spurs,1,1,1610612757,Portland Trail Blazers,0,0,36,34,70,12,8,20,48,42,90,6,8,14,14,32,27,3,9,91,114
2013,4,41300221,5/6/2014,1610612757,Portland Trail Blazers,0,0,1610612759,San Antonio Spurs,1,1,27,39,66,4,12,16,31,51,82,26,5,31,18,36,9,12,20,97,92
2013,4,41300221,5/6/2014,1610612759,San Antonio Spurs,1,1,1610612757,Portland Trail Blazers,0,0,37,34,71,7,9,16,44,43,87,21,4,25,14,33,21,6,12,95,116
2020,4,42000143,5/29/2021,1610612762,Utah Jazz,0,1,1610612763,Memphis Grizzlies,1,0,21,17,38,19,24,43,40,41,81,22,5,27,9,35,17,7,13,96,121
2020,4,42000143,5/29/2021,1610612763,Memphis Grizzlies,1,0,1610612762,Utah Jazz,0,1,30,29,59,13,28,41,43,57,100,12,2,14,21,37,23,4,9,97,111
2013,4,41300223,5/10/2014,1610612757,Portland Trail Blazers,1,0,1610612759,San Antonio Spurs,0,1,28,33,61,8,15,23,36,48,84,23,8,31,17,35,23,10,15,96,103
2013,4,41300223,5/10/2014,1610612759,San Antonio Spurs,0,1,1610612757,Portland Trail Blazers,1,0,36,32,68,7,14,21,43,46,89,25,0,25,11,35,23,5,7,97,118
2013,4,41300224,5/12/2014,1610612757,Portland Trail Blazers,1,1,1610612759,San Antonio Spurs,0,0,36,41,77,7,14,21,43,55,98,10,3,13,19,39,17,8,13,97,103
2013,4,41300224,5/12/2014,1610612759,San Antonio Spurs,0,0,1610612757,Portland Trail Blazers,1,1,36,34,70,3,15,18,39,49,88,11,8,19,10,42,13,4,11,98,92
2022,4,42200105,4/26/2023,1610612748,Miami Heat,0,1,1610612749,Milwaukee Bucks,1,0,33,32,65,17,28,45,50,60,110,11,6,17,15,48,25,4,11,115,128
2013,4,41300225,5/14/2014,1610612757,Portland Trail Blazers,0,0,1610612759,San Antonio Spurs,1,1,28,34,62,5,14,19,33,48,81,11,6,17,12,40,18,13,18,95,82
2013,4,41300225,5/14/2014,1610612759,San Antonio Spurs,1,1,1610612757,Portland Trail Blazers,0,0,33,35,68,9,12,21,42,47,89,11,5,16,10,39,24,3,8,96,104
2020,4,42000142,5/26/2021,1610612762,Utah Jazz,1,1,1610612763,Memphis Grizzlies,0,0,30,21,51,19,20,39,49,41,90,24,7,31,16,27,28,6,13,100,141
2020,4,42000142,5/26/2021,1610612763,Memphis Grizzlies,0,0,1610612762,Utah Jazz,1,1,38,24,62,8,15,23,46,39,85,29,9,38,12,31,20,2,11,101,129
2022,4,42200105,4/26/2023,1610612749,Milwaukee Bucks,1,0,1610612748,Miami Heat,0,1,28,30,58,14,19,33,42,49,91,28,17,45,16,38,20,6,16,112,126
2022,4,42200165,4/26/2023,1610612744,Golden State Warriors,0,1,1610612758,Sacramento Kings,1,0,39,19,58,11,27,38,50,46,96,12,7,19,15,36,33,9,15,105,123
2020,4,42000141,5/23/2021,1610612762,Utah Jazz,1,0,1610612763,Memphis Grizzlies,0,1,22,12,34,12,35,47,34,47,81,29,4,33,15,32,20,12,16,97,109
2020,4,42000141,5/23/2021,1610612763,Memphis Grizzlies,0,1,1610612762,Utah Jazz,1,0,38,42,80,7,13,20,45,55,100,15,6,21,19,40,18,3,9,98,112
2022,4,42200165,4/26/2023,1610612758,Sacramento Kings,1,0,1610612744,Golden State Warriors,0,1,32,24,56,10,24,34,42,48,90,22,4,26,17,34,22,11,19,104,116
2013,4,41300212,5/8/2014,1610612748,Miami Heat,1,1,1610612751,Brooklyn Nets,0,0,25,22,47,10,14,24,35,36,71,14,4,18,6,31,17,5,8,82,94
2013,4,41300212,5/8/2014,1610612751,Brooklyn Nets,0,0,1610612748,Miami Heat,1,1,25,29,54,8,16,24,33,45,78,8,6,14,15,31,19,10,14,84,82
2020,4,42000135,6/2/2021,1610612737,Atlanta Hawks,0,1,1610612752,New York Knicks,1,0,28,25,53,9,25,34,37,50,87,20,6,26,19,33,17,5,11,92,103
2020,4,42000135,6/2/2021,1610612752,New York Knicks,1,0,1610612737,Atlanta Hawks,0,1,19,33,52,12,18,30,31,51,82,15,3,18,18,35,19,7,17,90,89
2013,4,41300213,5/10/2014,1610612748,Miami Heat,0,0,1610612751,Brooklyn Nets,1,1,23,21,44,8,16,24,31,37,68,20,5,25,5,35,13,6,10,83,90
2013,4,41300213,5/10/2014,1610612751,Brooklyn Nets,1,1,1610612748,Miami Heat,0,0,23,24,47,15,10,25,38,34,72,13,4,17,13,23,26,8,15,84,104
2013,4,41300214,5/12/2014,1610612748,Miami Heat,0,1,1610612751,Brooklyn Nets,1,0,29,17,46,8,16,24,37,33,70,20,7,27,8,27,14,4,10,84,102
2013,4,41300214,5/12/2014,1610612751,Brooklyn Nets,1,0,1610612748,Miami Heat,0,1,29,27,56,5,17,22,34,44,78,23,5,28,18,28,22,8,11,83,96
2013,4,41300215,5/14/2014,1610612748,Miami Heat,1,1,1610612751,Brooklyn Nets,0,0,20,18,38,9,20,29,29,38,67,29,2,31,9,30,18,4,10,84,96
2013,4,41300215,5/14/2014,1610612751,Brooklyn Nets,0,0,1610612748,Miami Heat,1,1,29,27,56,8,14,22,37,41,78,12,3,15,14,27,14,5,12,83,94
2020,4,42000134,5/30/2021,1610612737,Atlanta Hawks,1,1,1610612752,New York Knicks,0,0,21,22,43,15,24,39,36,46,82,26,2,28,10,37,24,7,10,94,113
2020,4,42000134,5/30/2021,1610612752,New York Knicks,0,0,1610612737,Atlanta Hawks,1,1,25,27,52,9,20,29,34,47,81,19,4,23,8,40,24,4,10,94,96
2020,4,42000133,5/28/2021,1610612737,Atlanta Hawks,1,1,1610612752,New York Knicks,0,0,26,28,54,16,11,27,42,39,81,5,3,8,5,35,28,6,12,92,105
2020,4,42000133,5/28/2021,1610612752,New York Knicks,0,0,1610612737,Atlanta Hawks,1,1,20,31,51,9,21,30,29,52,81,27,3,30,14,41,14,2,13,93,94
2013,4,41300206,5/15/2014,1610612754,Indiana Pacers,0,1,1610612764,Washington Wizards,1,0,35,27,62,2,8,10,37,35,72,17,8,25,8,31,18,4,11,86,93
2013,4,41300206,5/15/2014,1610612764,Washington Wizards,1,0,1610612754,Indiana Pacers,0,1,29,32,61,2,16,18,31,48,79,16,4,20,13,36,17,6,11,87,80
2013,4,41300211,5/6/2014,1610612748,Miami Heat,1,1,1610612751,Brooklyn Nets,0,0,33,18,51,9,14,23,42,32,74,14,2,16,7,27,22,5,10,84,107
2013,4,41300211,5/6/2014,1610612751,Brooklyn Nets,0,0,1610612748,Miami Heat,1,1,23,23,46,10,14,24,33,37,70,10,7,17,7,35,11,4,13,84,86
2020,4,42000132,5/26/2021,1610612737,Atlanta Hawks,0,0,1610612752,New York Knicks,1,1,19,21,40,12,32,44,31,53,84,18,4,22,9,45,17,8,14,100,92
2020,4,42000132,5/26/2021,1610612752,New York Knicks,1,1,1610612737,Atlanta Hawks,0,0,24,37,61,12,21,33,36,58,94,17,6,23,18,41,15,5,11,99,101
2013,4,41300205,5/13/2014,1610612754,Indiana Pacers,1,0,1610612764,Washington Wizards,0,1,24,38,62,6,9,15,30,47,77,13,9,22,6,46,19,8,11,91,79
2013,4,41300205,5/13/2014,1610612764,Washington Wizards,0,1,1610612754,Indiana Pacers,1,0,36,28,64,5,13,18,41,41,82,15,4,19,20,23,21,8,19,90,102
2020,4,42000131,5/23/2021,1610612737,Atlanta Hawks,0,1,1610612752,New York Knicks,1,0,30,26,56,12,22,34,42,48,90,11,1,12,9,39,17,3,6,93,107
2020,4,42000131,5/23/2021,1610612752,New York Knicks,1,0,1610612737,Atlanta Hawks,0,1,32,32,64,10,20,30,42,52,94,11,4,15,20,35,21,6,11,93,105
2013,4,41300202,5/7/2014,1610612754,Indiana Pacers,1,1,1610612764,Washington Wizards,0,0,28,32,60,4,8,12,32,40,72,18,3,21,6,35,17,5,8,83,86
2013,4,41300202,5/7/2014,1610612764,Washington Wizards,0,0,1610612754,Indiana Pacers,1,1,31,28,59,5,16,21,36,44,80,5,7,12,12,36,20,8,10,84,82
2020,4,42000124,5/29/2021,1610612748,Miami Heat,1,0,1610612749,Milwaukee Bucks,0,1,29,29,58,11,22,33,40,51,91,12,2,14,10,42,25,5,12,101,103
2020,4,42000124,5/29/2021,1610612749,Milwaukee Bucks,0,1,1610612748,Miami Heat,1,0,33,24,57,13,29,42,46,53,99,15,3,18,19,35,29,6,11,100,120
2013,4,41300204,5/11/2014,1610612754,Indiana Pacers,0,1,1610612764,Washington Wizards,1,0,23,28,51,10,12,22,33,40,73,19,10,29,17,30,20,11,20,91,95
2013,4,41300204,5/11/2014,1610612764,Washington Wizards,1,0,1610612754,Indiana Pacers,0,1,31,33,64,5,10,15,36,43,79,15,4,19,11,35,22,6,14,91,92
2020,4,42000123,5/27/2021,1610612748,Miami Heat,1,0,1610612749,Milwaukee Bucks,0,1,23,30,53,9,23,32,32,53,85,11,2,13,7,46,19,6,16,99,84
2020,4,42000123,5/27/2021,1610612749,Milwaukee Bucks,0,1,1610612748,Miami Heat,1,0,30,23,53,13,23,36,43,46,89,14,4,18,11,37,25,9,15,100,113
2013,4,41300203,5/9/2014,1610612754,Indiana Pacers,0,1,1610612764,Washington Wizards,1,0,24,35,59,7,8,15,31,43,74,16,5,21,8,39,20,6,10,88,85
2013,4,41300203,5/9/2014,1610612764,Washington Wizards,1,0,1610612754,Indiana Pacers,0,1,20,37,57,4,12,16,24,49,73,11,10,21,12,42,10,9,18,88,63
2020,4,42000122,5/24/2021,1610612748,Miami Heat,0,0,1610612749,Milwaukee Bucks,1,1,25,29,54,8,20,28,33,49,82,24,11,35,15,40,20,8,11,97,98
2020,4,42000122,5/24/2021,1610612749,Milwaukee Bucks,1,1,1610612748,Miami Heat,0,0,24,17,41,22,31,53,46,48,94,18,2,20,22,27,34,6,17,99,132
2013,4,41300175,4/30/2014,1610612745,Houston Rockets,1,1,1610612757,Portland Trail Blazers,0,0,35,31,66,8,17,25,43,48,91,14,4,18,23,27,23,8,13,90,108
2013,4,41300175,4/30/2014,1610612757,Portland Trail Blazers,0,0,1610612745,Houston Rockets,1,1,27,31,58,9,16,25,36,47,83,17,6,23,14,37,14,7,11,90,98
2013,4,41300201,5/5/2014,1610612754,Indiana Pacers,1,0,1610612764,Washington Wizards,0,1,25,39,64,8,9,17,33,48,81,22,5,27,11,40,16,7,13,97,96
2013,4,41300201,5/5/2014,1610612764,Washington Wizards,0,1,1610612754,Indiana Pacers,1,0,25,43,68,10,6,16,35,49,84,22,9,31,21,32,23,6,17,97,102
2013,4,41300176,5/2/2014,1610612745,Houston Rockets,0,0,1610612757,Portland Trail Blazers,1,1,27,29,56,7,12,19,34,41,75,23,8,31,21,23,19,9,17,89,98
2013,4,41300176,5/2/2014,1610612757,Portland Trail Blazers,1,1,1610612745,Houston Rockets,0,0,26,32,58,9,15,24,35,47,82,20,2,22,15,32,14,8,12,88,99
2020,4,42000121,5/22/2021,1610612748,Miami Heat,0,0,1610612749,Milwaukee Bucks,1,1,16,33,49,20,30,50,36,63,99,15,4,19,16,50,22,11,17,109,107
2020,4,42000121,5/22/2021,1610612749,Milwaukee Bucks,1,1,1610612748,Miami Heat,0,0,37,28,65,5,26,31,42,54,96,20,13,33,19,41,19,8,17,111,109
2020,4,42000115,6/1/2021,1610612738,Boston Celtics,0,0,1610612751,Brooklyn Nets,1,1,29,23,52,11,29,40,40,52,92,18,5,23,20,34,18,6,11,95,109
2020,4,42000115,6/1/2021,1610612751,Brooklyn Nets,1,1,1610612738,Boston Celtics,0,0,28,24,52,15,17,32,43,41,84,22,3,25,10,32,26,3,9,94,123
2013,4,41300173,4/25/2014,1610612745,Houston Rockets,0,1,1610612757,Portland Trail Blazers,1,0,33,41,74,12,19,31,45,60,105,19,3,22,26,35,20,5,9,99,121
2013,4,41300173,4/25/2014,1610612757,Portland Trail Blazers,1,0,1610612745,Houston Rockets,0,1,31,32,63,10,17,27,41,49,90,24,4,28,16,34,21,4,11,98,116
2013,4,41300172,4/23/2014,1610612745,Houston Rockets,1,0,1610612757,Portland Trail Blazers,0,1,36,38,74,3,13,16,39,51,90,24,6,30,20,34,16,5,15,99,105
2013,4,41300172,4/23/2014,1610612757,Portland Trail Blazers,0,1,1610612745,Houston Rockets,1,0,32,29,61,8,15,23,40,44,84,24,3,27,14,31,23,7,14,98,112
2020,4,42000114,5/30/2021,1610612738,Boston Celtics,1,0,1610612751,Brooklyn Nets,0,1,23,21,44,14,26,40,37,47,84,38,4,42,18,32,24,8,11,98,126
2020,4,42000114,5/30/2021,1610612751,Brooklyn Nets,0,1,1610612738,Boston Celtics,1,0,32,24,56,16,11,27,48,35,83,29,1,30,11,25,29,8,10,97,141
2013,4,41300174,4/27/2014,1610612745,Houston Rockets,0,0,1610612757,Portland Trail Blazers,1,1,30,26,56,11,17,28,41,43,84,27,11,38,15,34,16,10,16,104,120
2013,4,41300174,4/27/2014,1610612757,Portland Trail Blazers,1,1,1610612745,Houston Rockets,0,0,34,29,63,11,17,28,45,46,91,22,8,30,15,36,25,5,11,105,123
2020,4,42000113,5/28/2021,1610612738,Boston Celtics,1,1,1610612751,Brooklyn Nets,0,0,29,21,50,16,23,39,45,44,89,19,4,23,18,27,21,8,14,95,125
2020,4,42000113,5/28/2021,1610612751,Brooklyn Nets,0,0,1610612738,Boston Celtics,1,1,22,24,46,16,22,38,38,46,84,27,4,31,13,34,16,5,10,95,119
2020,4,42000112,5/25/2021,1610612738,Boston Celtics,0,0,1610612751,Brooklyn Nets,1,1,27,31,58,12,22,34,39,53,92,18,5,23,20,35,23,7,17,101,108
2020,4,42000112,5/25/2021,1610612751,Brooklyn Nets,1,1,1610612738,Boston Celtics,0,0,29,21,50,17,21,38,46,42,88,21,1,22,14,29,31,10,17,101,130
2013,4,41300171,4/20/2014,1610612745,Houston Rockets,1,0,1610612757,Portland Trail Blazers,0,1,35,35,70,8,27,35,43,62,105,26,14,40,32,38,16,7,13,107,120
2013,4,41300171,4/20/2014,1610612757,Portland Trail Blazers,0,1,1610612745,Houston Rockets,1,0,33,37,70,9,18,27,42,55,97,29,10,39,22,37,14,5,12,105,122
2020,4,42000111,5/22/2021,1610612738,Boston Celtics,0,0,1610612751,Brooklyn Nets,1,1,20,34,54,11,19,30,31,53,84,20,6,26,16,39,19,7,12,92,93
2020,4,42000111,5/22/2021,1610612751,Brooklyn Nets,1,1,1610612738,Boston Celtics,0,0,27,23,50,8,26,34,35,49,84,26,3,29,18,33,18,6,11,92,104
2013,4,41300167,5/3/2014,1610612744,Golden State Warriors,0,0,1610612746,LA Clippers,1,1,25,29,54,14,11,25,39,40,79,29,6,35,11,32,25,14,18,102,121
2013,4,41300167,5/3/2014,1610612746,LA Clippers,1,1,1610612744,Golden State Warriors,0,0,38,21,59,8,16,24,46,37,83,26,7,33,10,30,26,9,14,103,126
2013,4,41300163,4/24/2014,1610612744,Golden State Warriors,1,0,1610612746,LA Clippers,0,1,31,27,58,6,25,31,37,52,89,16,8,24,22,36,26,11,17,93,96
2020,4,42000105,6/2/2021,1610612755,Philadelphia 76ers,1,1,1610612764,Washington Wizards,0,0,34,23,57,9,18,27,43,41,84,34,9,43,13,33,28,4,9,102,129
2020,4,42000105,6/2/2021,1610612764,Washington Wizards,0,0,1610612755,Philadelphia 76ers,1,1,31,28,59,8,12,20,39,40,79,26,7,33,9,35,22,9,15,101,112
2013,4,41300163,4/24/2014,1610612746,LA Clippers,0,1,1610612744,Golden State Warriors,1,0,32,26,58,8,20,28,40,46,86,10,13,23,17,36,25,6,13,94,98
2013,4,41300166,5/1/2014,1610612744,Golden State Warriors,1,1,1610612746,LA Clippers,0,0,28,37,65,7,17,24,35,54,89,23,14,37,22,40,20,3,8,93,100
2013,4,41300166,5/1/2014,1610612746,LA Clippers,0,0,1610612744,Golden State Warriors,1,1,21,31,52,11,23,34,32,54,86,24,9,33,21,37,22,7,12,93,99
2020,4,42000104,5/31/2021,1610612755,Philadelphia 76ers,0,0,1610612764,Washington Wizards,1,1,28,30,58,12,26,38,40,56,96,22,12,34,14,49,21,8,11,108,114
2020,4,42000104,5/31/2021,1610612764,Washington Wizards,1,1,1610612755,Philadelphia 76ers,0,0,31,33,64,9,15,24,40,48,88,33,9,42,17,38,24,7,14,109,122
2013,4,41300164,4/27/2014,1610612744,Golden State Warriors,1,1,1610612746,LA Clippers,0,0,26,16,42,15,17,32,41,33,74,21,7,28,8,27,32,5,15,95,118
2013,4,41300164,4/27/2014,1610612746,LA Clippers,0,0,1610612744,Golden State Warriors,1,1,23,23,46,10,21,31,33,44,77,21,3,24,12,32,20,8,19,95,97
2013,4,41300165,4/29/2014,1610612744,Golden State Warriors,0,0,1610612746,LA Clippers,1,1,30,29,59,10,16,26,40,45,85,13,6,19,17,31,24,10,14,92,103
2013,4,41300165,4/29/2014,1610612746,LA Clippers,1,1,1610612744,Golden State Warriors,0,0,29,27,56,8,12,20,37,39,76,31,10,41,14,31,20,6,12,92,113
2020,4,42000103,5/29/2021,1610612755,Philadelphia 76ers,0,1,1610612764,Washington Wizards,1,0,34,20,54,17,16,33,51,36,87,13,7,20,11,29,31,5,16,101,132
2020,4,42000103,5/29/2021,1610612764,Washington Wizards,1,0,1610612755,Philadelphia 76ers,0,1,30,31,61,8,27,35,38,58,96,19,6,25,16,45,18,7,8,100,103
2020,4,42000102,5/26/2021,1610612755,Philadelphia 76ers,1,1,1610612764,Washington Wizards,0,0,40,27,67,9,12,21,49,39,88,13,6,19,13,29,26,3,12,97,120
2020,4,42000102,5/26/2021,1610612764,Washington Wizards,0,0,1610612755,Philadelphia 76ers,1,1,35,35,70,2,20,22,37,55,92,19,11,30,22,40,22,10,14,98,95
2013,4,41300157,5/3/2014,1610612760,Oklahoma City Thunder,1,1,1610612763,Memphis Grizzlies,0,0,31,19,50,11,8,19,42,27,69,25,5,30,9,20,22,13,20,94,120
2013,4,41300157,5/3/2014,1610612763,Memphis Grizzlies,0,0,1610612760,Oklahoma City Thunder,1,1,32,34,66,5,12,17,37,46,83,30,4,34,15,33,22,7,14,96,109
2013,4,41300162,4/21/2014,1610612744,Golden State Warriors,0,0,1610612746,LA Clippers,1,1,32,25,57,4,15,19,36,40,76,22,5,27,18,25,18,15,26,96,98
2013,4,41300162,4/21/2014,1610612746,LA Clippers,1,1,1610612744,Golden State Warriors,0,0,35,23,58,12,13,25,47,36,83,32,3,35,14,24,29,8,13,96,138
2020,4,42000101,5/23/2021,1610612755,Philadelphia 76ers,1,1,1610612764,Washington Wizards,0,0,36,25,61,10,22,32,46,47,93,23,10,33,18,35,27,4,11,101,125
2020,4,42000101,5/23/2021,1610612764,Washington Wizards,0,0,1610612755,Philadelphia 76ers,1,1,41,27,68,8,12,20,49,39,88,12,3,15,12,28,26,10,16,100,118
2013,4,41300161,4/19/2014,1610612744,Golden State Warriors,0,1,1610612746,LA Clippers,1,0,29,34,63,11,16,27,40,50,90,18,7,25,26,26,26,13,23,100,109
2013,4,41300161,4/19/2014,1610612746,LA Clippers,1,0,1610612744,Golden State Warriors,0,1,26,37,63,10,12,22,36,49,85,23,12,35,18,37,24,5,17,100,105
2013,4,41300156,5/1/2014,1610612760,Oklahoma City Thunder,0,1,1610612763,Memphis Grizzlies,1,0,30,24,54,7,14,21,37,38,75,23,2,25,10,28,15,5,13,90,104
2013,4,41300156,5/1/2014,1610612763,Memphis Grizzlies,1,0,1610612760,Oklahoma City Thunder,0,1,28,41,69,3,11,14,31,52,83,19,9,28,15,40,19,7,10,92,84
2013,4,41300155,4/29/2014,1610612760,Oklahoma City Thunder,1,0,1610612763,Memphis Grizzlies,0,1,24,37,61,12,19,31,36,56,92,15,4,19,21,39,24,11,17,97,99
2013,4,41300155,4/29/2014,1610612763,Memphis Grizzlies,0,1,1610612760,Oklahoma City Thunder,1,0,30,38,68,7,12,19,37,50,87,19,7,26,14,40,21,2,10,95,100
2013,4,41300154,4/26/2014,1610612760,Oklahoma City Thunder,0,1,1610612763,Memphis Grizzlies,1,0,25,37,62,8,20,28,33,57,90,18,2,20,25,34,14,13,21,99,92
2013,4,41300154,4/26/2014,1610612763,Memphis Grizzlies,1,0,1610612760,Oklahoma City Thunder,0,1,29,45,74,6,14,20,35,59,94,13,10,23,22,41,19,8,14,98,89
2013,4,41300152,4/21/2014,1610612760,Oklahoma City Thunder,1,0,1610612763,Memphis Grizzlies,0,1,28,35,63,9,21,30,37,56,93,22,3,25,20,37,20,5,9,96,105
2013,4,41300152,4/21/2014,1610612763,Memphis Grizzlies,0,1,1610612760,Oklahoma City Thunder,1,0,39,38,77,4,6,10,43,44,87,21,3,24,12,33,30,6,9,94,111
2013,4,41300153,4/24/2014,1610612760,Oklahoma City Thunder,0,0,1610612763,Memphis Grizzlies,1,1,29,30,59,5,23,28,34,53,87,22,8,30,19,37,13,9,16,100,95
2013,4,41300153,4/24/2014,1610612763,Memphis Grizzlies,1,1,1610612760,Oklahoma City Thunder,0,0,37,39,76,4,12,16,41,51,92,12,3,15,17,35,21,9,15,98,98
2013,4,41300146,5/2/2014,1610612742,Dallas Mavericks,1,1,1610612759,San Antonio Spurs,0,0,37,32,69,8,10,18,45,42,87,15,9,24,15,35,18,9,16,97,113
2013,4,41300146,5/2/2014,1610612759,San Antonio Spurs,0,0,1610612742,Dallas Mavericks,1,1,33,26,59,7,9,16,40,35,75,24,4,28,7,29,21,8,14,98,111
2013,4,41300147,5/4/2014,1610612742,Dallas Mavericks,0,0,1610612759,San Antonio Spurs,1,1,27,36,63,9,16,25,36,52,88,15,2,17,16,37,21,10,14,95,96
2013,4,41300147,5/4/2014,1610612759,San Antonio Spurs,1,1,1610612742,Dallas Mavericks,0,0,32,18,50,10,14,24,42,32,74,25,8,33,6,29,21,6,12,93,119
2013,4,41300151,4/19/2014,1610612760,Oklahoma City Thunder,1,1,1610612763,Memphis Grizzlies,0,0,30,30,60,4,12,16,34,42,76,28,4,32,8,36,22,7,13,95,100
2013,4,41300151,4/19/2014,1610612763,Memphis Grizzlies,0,0,1610612760,Oklahoma City Thunder,1,1,31,49,80,2,9,11,33,58,91,18,13,31,17,48,20,3,6,94,86
2013,4,41300143,4/26/2014,1610612742,Dallas Mavericks,1,1,1610612759,San Antonio Spurs,0,0,33,26,59,9,14,23,42,40,82,16,3,19,15,26,25,14,17,95,109
2013,4,41300143,4/26/2014,1610612759,San Antonio Spurs,0,0,1610612742,Dallas Mavericks,1,1,38,25,63,6,12,18,44,37,81,14,3,17,11,27,26,4,15,93,108
2013,4,41300144,4/28/2014,1610612742,Dallas Mavericks,1,0,1610612759,San Antonio Spurs,0,1,25,35,60,7,17,24,32,52,84,18,10,28,17,42,18,4,9,90,89
2013,4,41300144,4/28/2014,1610612759,San Antonio Spurs,0,1,1610612742,Dallas Mavericks,1,0,31,32,63,5,12,17,36,44,80,16,6,22,13,34,16,8,15,91,93
2013,4,41300145,4/30/2014,1610612742,Dallas Mavericks,0,0,1610612759,San Antonio Spurs,1,1,27,34,61,12,16,28,39,50,89,13,2,15,13,38,18,6,8,93,103
2013,4,41300145,4/30/2014,1610612759,San Antonio Spurs,1,1,1610612742,Dallas Mavericks,0,0,33,39,72,8,8,16,41,47,88,19,8,27,15,38,24,2,6,91,109
2015,4,41500407,6/19/2016,1610612739,Cleveland Cavaliers,0,1,1610612744,Golden State Warriors,1,0,27,30,57,6,19,25,33,49,82,21,4,25,16,36,17,7,11,89,93
2015,4,41500407,6/19/2016,1610612744,Golden State Warriors,1,0,1610612739,Cleveland Cavaliers,0,1,17,25,42,15,26,41,32,51,83,10,3,13,11,42,22,7,10,89,89
2013,4,41300142,4/23/2014,1610612742,Dallas Mavericks,0,1,1610612759,San Antonio Spurs,1,0,37,34,71,8,13,21,45,47,92,15,1,16,20,28,19,1,8,89,113
2013,4,41300142,4/23/2014,1610612759,San Antonio Spurs,1,0,1610612742,Dallas Mavericks,0,1,22,22,44,10,10,20,32,32,64,18,11,29,12,22,17,13,24,89,92
2013,4,41300141,4/20/2014,1610612742,Dallas Mavericks,0,0,1610612759,San Antonio Spurs,1,1,29,38,67,6,12,18,35,50,85,9,4,13,9,45,15,6,8,90,85
2013,4,41300141,4/20/2014,1610612759,San Antonio Spurs,1,1,1610612742,Dallas Mavericks,0,0,32,32,64,3,14,17,35,46,81,17,5,22,13,35,14,5,10,91,90
2015,4,41500406,6/16/2016,1610612739,Cleveland Cavaliers,1,1,1610612744,Golden State Warriors,0,0,30,20,50,10,17,27,40,37,77,25,7,32,10,30,24,5,12,97,115
2015,4,41500406,6/16/2016,1610612744,Golden State Warriors,0,0,1610612739,Cleveland Cavaliers,1,1,18,25,43,15,24,39,33,49,82,20,9,29,13,40,19,12,14,95,101
2013,4,41300135,4/29/2014,1610612741,Chicago Bulls,1,0,1610612764,Washington Wizards,0,1,19,40,59,6,10,16,25,50,75,13,4,17,12,39,19,9,11,82,69
2013,4,41300135,4/29/2014,1610612764,Washington Wizards,0,1,1610612741,Chicago Bulls,1,0,28,37,65,2,7,9,30,44,74,13,6,19,15,33,16,4,13,84,75
2015,4,41500405,6/13/2016,1610612739,Cleveland Cavaliers,0,1,1610612744,Golden State Warriors,1,0,34,25,59,10,14,24,44,39,83,14,9,23,12,33,15,6,16,98,112
2015,4,41500405,6/13/2016,1610612744,Golden State Warriors,1,0,1610612739,Cleveland Cavaliers,0,1,18,27,45,14,29,43,32,56,88,19,7,26,21,37,18,11,17,98,97
2015,4,41500404,6/10/2016,1610612739,Cleveland Cavaliers,1,0,1610612744,Golden State Warriors,0,1,32,24,56,6,19,25,38,43,81,15,11,26,19,30,15,7,11,85,97
2015,4,41500404,6/10/2016,1610612744,Golden State Warriors,0,1,1610612739,Cleveland Cavaliers,1,0,16,29,45,17,19,36,33,48,81,25,6,31,22,30,23,5,9,86,108
2015,4,41500403,6/8/2016,1610612739,Cleveland Cavaliers,1,1,1610612744,Golden State Warriors,0,0,36,30,66,12,13,25,48,43,91,12,5,17,19,27,23,5,14,95,120
2015,4,41500403,6/8/2016,1610612744,Golden State Warriors,0,0,1610612739,Cleveland Cavaliers,1,1,23,20,43,9,24,33,32,44,76,17,9,26,10,39,21,8,18,95,90
2013,4,41300134,4/27/2014,1610612741,Chicago Bulls,0,0,1610612764,Washington Wizards,1,1,31,28,59,4,15,19,35,43,78,15,2,17,17,27,22,8,16,84,89
2013,4,41300134,4/27/2014,1610612764,Washington Wizards,1,1,1610612741,Chicago Bulls,0,0,27,40,67,8,11,19,35,51,86,20,5,25,18,35,22,2,6,85,98
2015,4,41500402,6/5/2016,1610612739,Cleveland Cavaliers,0,0,1610612744,Golden State Warriors,1,1,23,33,56,5,18,23,28,51,79,16,8,24,16,39,15,7,18,94,77
2015,4,41500402,6/5/2016,1610612744,Golden State Warriors,1,1,1610612739,Cleveland Cavaliers,0,0,29,19,48,15,18,33,44,37,81,7,3,10,13,27,26,15,21,93,110
2015,4,41500401,6/2/2016,1610612739,Cleveland Cavaliers,0,0,1610612744,Golden State Warriors,1,1,25,38,63,7,14,21,32,52,84,18,2,20,20,33,17,9,17,92,89
2015,4,41500401,6/2/2016,1610612744,Golden State Warriors,1,1,1610612739,Cleveland Cavaliers,0,0,34,26,60,9,18,27,43,44,87,9,1,10,10,35,29,7,9,91,104
2015,4,41500317,5/30/2016,1610612744,Golden State Warriors,1,1,1610612760,Oklahoma City Thunder,0,0,20,28,48,17,20,37,37,48,85,5,3,8,15,34,20,3,11,86,96
2015,4,41500317,5/30/2016,1610612760,Oklahoma City Thunder,0,0,1610612744,Golden State Warriors,1,1,27,35,62,7,20,27,34,55,89,13,4,17,18,39,20,4,7,85,88
2013,4,41300133,4/25/2014,1610612741,Chicago Bulls,0,1,1610612764,Washington Wizards,1,0,22,25,47,12,12,24,34,37,71,20,10,30,12,29,24,9,17,89,100
2015,4,41500316,5/28/2016,1610612744,Golden State Warriors,0,1,1610612760,Oklahoma City Thunder,1,0,15,28,43,21,24,45,36,52,88,15,9,24,20,36,23,9,15,96,108
2015,4,41500316,5/28/2016,1610612760,Oklahoma City Thunder,1,0,1610612744,Golden State Warriors,0,1,35,32,67,3,20,23,38,52,90,22,10,32,23,34,16,11,15,96,101
2013,4,41300133,4/25/2014,1610612764,Washington Wizards,1,0,1610612741,Chicago Bulls,0,1,29,38,67,8,11,19,37,49,86,15,6,21,16,37,20,8,11,91,97
2015,4,41500315,5/26/2016,1610612744,Golden State Warriors,1,1,1610612760,Oklahoma City Thunder,0,0,31,30,61,9,15,24,40,45,85,31,3,34,13,33,25,8,16,103,120
2015,4,41500315,5/26/2016,1610612760,Oklahoma City Thunder,0,0,1610612744,Golden State Warriors,1,1,26,35,61,13,17,30,39,52,91,20,4,24,16,39,23,13,17,104,111
2013,4,41300132,4/22/2014,1610612741,Chicago Bulls,1,0,1610612764,Washington Wizards,0,1,33,38,71,5,12,17,38,50,88,18,6,24,19,35,23,10,14,94,99
2013,4,41300132,4/22/2014,1610612764,Washington Wizards,0,1,1610612741,Chicago Bulls,1,0,29,28,57,9,14,23,38,42,80,16,12,28,13,36,23,6,12,95,101
2015,4,41500314,5/24/2016,1610612744,Golden State Warriors,0,0,1610612760,Oklahoma City Thunder,1,1,24,26,50,9,21,30,33,47,80,19,10,29,10,42,15,16,21,106,94
2015,4,41500314,5/24/2016,1610612760,Oklahoma City Thunder,1,1,1610612744,Golden State Warriors,0,0,30,34,64,9,17,26,39,51,90,31,9,40,22,34,23,11,18,107,118
2015,4,41500313,5/22/2016,1610612744,Golden State Warriors,0,0,1610612760,Oklahoma City Thunder,1,1,28,32,60,10,22,32,38,54,92,19,6,25,14,43,19,6,14,105,105
2015,4,41500313,5/22/2016,1610612760,Oklahoma City Thunder,1,1,1610612744,Golden State Warriors,0,0,38,29,67,8,17,25,46,46,92,33,4,37,17,31,21,9,12,105,133
2013,4,41300131,4/20/2014,1610612741,Chicago Bulls,1,0,1610612764,Washington Wizards,0,1,29,32,61,5,15,20,34,47,81,20,6,26,14,36,13,5,8,88,93
2013,4,41300131,4/20/2014,1610612764,Washington Wizards,0,1,1610612741,Chicago Bulls,1,0,32,31,63,4,7,11,36,38,74,26,9,35,13,29,21,5,10,87,102
2015,4,41500312,5/18/2016,1610612744,Golden State Warriors,1,1,1610612760,Oklahoma City Thunder,0,0,30,27,57,13,15,28,43,42,85,19,9,28,20,29,26,9,12,88,118
2015,4,41500312,5/18/2016,1610612760,Oklahoma City Thunder,0,0,1610612744,Golden State Warriors,1,1,28,27,55,7,16,23,35,43,78,14,5,19,14,32,22,9,16,90,91
2013,4,41300126,5/2/2014,1610612751,Brooklyn Nets,1,1,1610612761,Toronto Raptors,0,0,30,26,56,6,15,21,36,41,77,19,6,25,10,35,17,9,12,91,97
2013,4,41300126,5/2/2014,1610612761,Toronto Raptors,0,0,1610612751,Brooklyn Nets,1,1,23,31,54,7,17,24,30,48,78,16,4,20,10,39,16,10,14,92,83
2013,4,41300127,5/4/2014,1610612751,Brooklyn Nets,0,1,1610612761,Toronto Raptors,1,0,29,29,58,8,15,23,37,44,81,22,8,30,19,29,16,4,8,86,104
2013,4,41300127,5/4/2014,1610612761,Toronto Raptors,1,0,1610612751,Brooklyn Nets,0,1,31,29,60,4,9,13,35,38,73,29,4,33,12,28,13,5,9,87,103
2015,4,41500311,5/16/2016,1610612744,Golden State Warriors,1,0,1610612760,Oklahoma City Thunder,0,1,29,32,61,11,19,30,40,51,91,11,6,17,9,43,26,12,14,104,102
2015,4,41500311,5/16/2016,1610612760,Oklahoma City Thunder,0,1,1610612744,Golden State Warriors,1,0,31,41,72,8,9,17,39,50,89,22,9,31,13,41,22,8,12,103,108
2015,4,41500306,5/27/2016,1610612739,Cleveland Cavaliers,0,1,1610612761,Toronto Raptors,1,0,23,20,43,17,14,31,40,34,74,16,5,21,5,30,22,6,11,89,113
2015,4,41500306,5/27/2016,1610612761,Toronto Raptors,1,0,1610612739,Cleveland Cavaliers,0,1,25,29,54,8,17,25,33,46,79,13,4,17,12,35,10,6,13,90,87
2015,4,41500305,5/25/2016,1610612739,Cleveland Cavaliers,1,1,1610612761,Toronto Raptors,0,0,34,22,56,10,11,21,44,33,77,18,6,24,12,23,23,9,17,94,116
2015,4,41500305,5/25/2016,1610612761,Toronto Raptors,0,0,1610612739,Cleveland Cavaliers,1,1,24,28,52,3,14,17,27,42,69,21,14,35,11,41,19,11,19,94,78
2015,4,41500304,5/23/2016,1610612739,Cleveland Cavaliers,0,0,1610612761,Toronto Raptors,1,1,26,16,42,13,28,41,39,44,83,8,1,9,14,31,23,8,11,87,99
2015,4,41500304,5/23/2016,1610612761,Toronto Raptors,1,1,1610612739,Cleveland Cavaliers,0,0,35,21,56,7,15,22,42,36,78,14,5,19,9,31,17,5,9,86,105
2013,4,41300124,4/27/2014,1610612751,Brooklyn Nets,1,0,1610612761,Toronto Raptors,0,1,24,24,48,4,16,20,28,40,68,19,10,29,12,35,17,9,16,86,79
2013,4,41300124,4/27/2014,1610612761,Toronto Raptors,0,1,1610612751,Brooklyn Nets,1,0,25,27,52,6,17,23,31,44,75,19,4,23,10,36,15,6,12,86,87
2015,4,41500303,5/21/2016,1610612739,Cleveland Cavaliers,0,0,1610612761,Toronto Raptors,1,1,14,24,38,14,27,41,28,51,79,14,2,16,10,42,15,1,9,85,84
2015,4,41500303,5/21/2016,1610612761,Toronto Raptors,1,1,1610612739,Cleveland Cavaliers,0,0,26,26,52,12,19,31,38,45,83,11,2,13,15,32,15,7,10,86,99
2015,4,41500302,5/19/2016,1610612739,Cleveland Cavaliers,1,1,1610612761,Toronto Raptors,0,0,31,24,55,7,14,21,38,38,76,25,12,37,10,33,24,6,11,94,108
2015,4,41500302,5/19/2016,1610612761,Toronto Raptors,0,0,1610612739,Cleveland Cavaliers,1,1,24,25,49,9,24,33,33,49,82,14,4,18,8,42,17,5,12,95,89
2015,4,41500301,5/17/2016,1610612739,Cleveland Cavaliers,1,1,1610612761,Toronto Raptors,0,0,34,20,54,7,13,20,41,33,74,26,7,33,12,24,22,8,17,94,115
2013,4,41300125,4/30/2014,1610612751,Brooklyn Nets,0,0,1610612761,Toronto Raptors,1,1,29,23,52,11,12,23,40,35,75,22,8,30,10,29,22,6,15,93,113
2015,4,41500301,5/17/2016,1610612761,Toronto Raptors,0,0,1610612739,Cleveland Cavaliers,1,1,27,25,52,5,19,24,32,44,76,15,5,20,7,38,19,9,14,95,84
2013,4,41300125,4/30/2014,1610612761,Toronto Raptors,1,1,1610612751,Brooklyn Nets,0,0,25,26,51,12,14,26,37,40,77,29,7,36,14,29,21,8,13,94,115
2015,4,41500236,5/12/2016,1610612759,San Antonio Spurs,0,0,1610612760,Oklahoma City Thunder,1,1,34,42,76,6,11,17,40,53,93,13,3,16,14,39,19,7,10,97,99
2015,4,41500236,5/12/2016,1610612760,Oklahoma City Thunder,1,1,1610612759,San Antonio Spurs,0,0,34,29,63,6,16,22,40,45,85,27,4,31,16,31,21,7,12,96,113
2015,4,41500235,5/10/2016,1610612759,San Antonio Spurs,1,0,1610612760,Oklahoma City Thunder,0,1,27,43,70,8,10,18,35,53,88,13,4,17,14,41,19,6,8,91,91
2015,4,41500235,5/10/2016,1610612760,Oklahoma City Thunder,0,1,1610612759,San Antonio Spurs,1,0,27,31,58,7,13,20,34,44,78,20,6,26,18,28,18,11,20,92,95
2013,4,41300121,4/19/2014,1610612751,Brooklyn Nets,0,1,1610612761,Toronto Raptors,1,0,30,26,56,4,20,24,34,46,80,22,5,27,11,39,16,3,9,91,94
2013,4,41300121,4/19/2014,1610612761,Toronto Raptors,1,0,1610612751,Brooklyn Nets,0,1,20,28,48,8,15,23,28,43,71,23,2,25,12,32,22,9,19,93,87
2015,4,41500234,5/8/2016,1610612759,San Antonio Spurs,0,0,1610612760,Oklahoma City Thunder,1,1,38,35,73,2,10,12,40,45,85,15,1,16,14,30,12,6,14,94,97
2015,4,41500234,5/8/2016,1610612760,Oklahoma City Thunder,1,1,1610612759,San Antonio Spurs,0,0,31,25,56,9,14,23,40,39,79,22,7,29,15,27,23,11,14,94,111
2013,4,41300122,4/22/2014,1610612751,Brooklyn Nets,0,0,1610612761,Toronto Raptors,1,1,27,26,53,7,17,24,34,43,77,20,8,28,13,33,19,3,10,88,95
2013,4,41300122,4/22/2014,1610612761,Toronto Raptors,1,1,1610612751,Brooklyn Nets,0,0,35,27,62,2,14,16,37,41,78,24,5,29,25,21,19,14,21,87,100
2015,4,41500233,5/6/2016,1610612759,San Antonio Spurs,0,1,1610612760,Oklahoma City Thunder,1,0,23,34,57,10,9,19,33,43,76,24,10,34,15,32,19,5,10,91,100
2015,4,41500233,5/6/2016,1610612760,Oklahoma City Thunder,1,0,1610612759,San Antonio Spurs,0,1,24,28,52,10,20,30,34,48,82,18,2,20,15,34,14,8,14,90,96
2013,4,41300123,4/25/2014,1610612751,Brooklyn Nets,1,1,1610612761,Toronto Raptors,0,0,26,21,47,7,13,20,33,34,67,29,8,37,4,33,21,5,12,93,102
2013,4,41300123,4/25/2014,1610612761,Toronto Raptors,0,0,1610612751,Brooklyn Nets,1,1,24,21,45,7,15,22,31,36,67,29,8,37,12,30,18,7,19,92,98
2015,4,41500232,5/2/2016,1610612759,San Antonio Spurs,1,0,1610612760,Oklahoma City Thunder,0,1,34,37,71,6,17,23,40,54,94,11,2,13,14,41,19,8,10,97,97
2015,4,41500232,5/2/2016,1610612760,Oklahoma City Thunder,0,1,1610612759,San Antonio Spurs,1,0,33,27,60,5,14,19,38,41,79,17,4,21,12,30,16,10,18,97,98
2015,4,41500231,4/30/2016,1610612759,San Antonio Spurs,1,1,1610612760,Oklahoma City Thunder,0,0,42,27,69,9,6,15,51,33,84,13,5,18,8,28,39,6,9,93,124
2015,4,41500231,4/30/2016,1610612760,Oklahoma City Thunder,0,0,1610612759,San Antonio Spurs,1,1,29,33,62,6,17,23,35,50,85,16,5,21,13,38,23,5,10,92,92
2015,4,41500225,5/11/2016,1610612744,Golden State Warriors,1,1,1610612757,Portland Trail Blazers,0,0,29,23,52,14,18,32,43,41,84,25,4,29,9,35,28,9,16,105,125
2015,4,41500225,5/11/2016,1610612757,Portland Trail Blazers,0,0,1610612744,Golden State Warriors,1,1,22,34,56,16,20,36,38,54,92,29,10,39,17,39,20,5,11,105,121
2015,4,41500224,5/9/2016,1610612744,Golden State Warriors,0,1,1610612757,Portland Trail Blazers,1,0,27,28,55,17,23,40,44,51,95,27,6,33,14,42,22,8,14,115,132
2015,4,41500224,5/9/2016,1610612757,Portland Trail Blazers,1,0,1610612744,Golden State Warriors,0,1,28,39,67,15,24,39,43,63,106,24,9,33,26,42,22,13,18,114,125
2013,4,41300112,4/23/2014,1610612748,Miami Heat,1,1,1610612766,Charlotte Hornets,0,0,26,18,44,9,14,23,35,32,67,22,7,29,5,29,19,5,17,92,101
2013,4,41300112,4/23/2014,1610612766,Charlotte Hornets,0,0,1610612748,Miami Heat,1,1,28,39,67,9,12,21,37,51,88,14,5,19,19,33,18,9,15,93,97
2013,4,41300113,4/26/2014,1610612748,Miami Heat,0,1,1610612766,Charlotte Hornets,1,0,27,38,65,9,9,18,36,47,83,17,3,20,12,38,26,3,7,89,98
2013,4,41300113,4/26/2014,1610612766,Charlotte Hornets,1,0,1610612748,Miami Heat,0,1,20,27,47,7,11,18,27,38,65,24,9,33,6,36,21,8,14,88,85
2015,4,41500223,5/7/2016,1610612744,Golden State Warriors,0,0,1610612757,Portland Trail Blazers,1,1,28,31,59,14,15,29,42,46,88,10,7,17,14,33,29,5,12,97,108
2015,4,41500223,5/7/2016,1610612757,Portland Trail Blazers,1,1,1610612744,Golden State Warriors,0,0,23,33,56,17,13,30,40,46,86,23,6,29,14,35,19,4,10,96,120
2013,4,41300114,4/28/2014,1610612748,Miami Heat,0,1,1610612766,Charlotte Hornets,1,0,30,24,54,9,15,24,39,39,78,22,7,29,9,34,25,4,9,91,109
2013,4,41300114,4/28/2014,1610612766,Charlotte Hornets,1,0,1610612748,Miami Heat,0,1,28,16,44,7,18,25,35,34,69,21,9,30,9,30,22,7,16,89,98
2015,4,41500222,5/3/2016,1610612744,Golden State Warriors,1,1,1610612757,Portland Trail Blazers,0,0,34,33,67,8,16,24,42,49,91,18,2,20,12,38,21,5,10,101,110
2015,4,41500222,5/3/2016,1610612757,Portland Trail Blazers,0,0,1610612744,Golden State Warriors,1,1,23,28,51,13,17,30,36,45,81,14,7,21,9,39,22,4,17,101,99
2015,4,41500221,5/1/2016,1610612744,Golden State Warriors,1,1,1610612757,Portland Trail Blazers,0,0,32,28,60,11,20,31,43,48,91,21,3,24,17,32,27,7,12,97,118
2015,4,41500221,5/1/2016,1610612757,Portland Trail Blazers,0,0,1610612744,Golden State Warriors,1,1,29,37,66,10,21,31,39,58,97,18,3,21,18,42,26,8,9,98,106
2013,4,41300107,5/3/2014,1610612737,Atlanta Hawks,0,0,1610612754,Indiana Pacers,1,1,17,31,48,11,33,44,28,64,92,13,3,16,20,46,16,6,10,91,80
2015,4,41500217,5/15/2016,1610612748,Miami Heat,0,0,1610612761,Toronto Raptors,1,1,25,22,47,7,18,25,32,40,72,18,5,23,9,32,16,8,14,89,89
2015,4,41500217,5/15/2016,1610612761,Toronto Raptors,1,1,1610612748,Miami Heat,0,0,30,35,65,9,11,20,39,46,85,29,14,43,25,28,17,6,11,90,116
2013,4,41300107,5/3/2014,1610612754,Indiana Pacers,1,1,1610612737,Atlanta Hawks,0,0,30,22,52,3,15,18,33,37,70,23,6,29,14,26,17,9,18,89,92
2015,4,41500216,5/13/2016,1610612748,Miami Heat,1,1,1610612761,Toronto Raptors,0,0,33,30,63,7,14,21,40,44,84,16,4,20,11,36,15,4,7,92,103
2015,4,41500216,5/13/2016,1610612761,Toronto Raptors,0,0,1610612748,Miami Heat,1,1,30,36,66,4,12,16,34,48,82,19,6,25,12,39,10,2,10,91,91
2015,4,41500215,5/11/2016,1610612748,Miami Heat,0,0,1610612761,Toronto Raptors,1,1,25,31,56,6,15,21,31,46,77,23,5,28,17,31,12,10,15,88,91
2015,4,41500215,5/11/2016,1610612761,Toronto Raptors,1,1,1610612748,Miami Heat,0,0,28,36,64,7,10,17,35,46,81,22,4,26,15,32,16,4,9,89,99
2015,4,41500214,5/9/2016,1610612748,Miami Heat,1,1,1610612761,Toronto Raptors,0,0,35,30,65,1,14,15,36,44,80,21,4,25,10,37,15,7,12,95,94
2015,4,41500214,5/9/2016,1610612761,Toronto Raptors,0,0,1610612748,Miami Heat,1,1,27,37,64,6,14,20,33,51,84,15,4,19,16,36,12,9,18,96,87
2013,4,41300111,4/20/2014,1610612748,Miami Heat,1,1,1610612766,Charlotte Hornets,0,0,24,29,53,11,12,23,35,41,76,18,8,26,9,36,14,5,9,88,99
2013,4,41300111,4/20/2014,1610612766,Charlotte Hornets,0,0,1610612748,Miami Heat,1,1,28,30,58,8,13,21,36,43,79,8,4,12,11,33,18,5,15,88,88
2015,4,41500213,5/7/2016,1610612748,Miami Heat,1,0,1610612761,Toronto Raptors,0,1,29,30,59,4,14,18,33,44,77,21,3,24,11,35,11,5,10,88,91
2015,4,41500213,5/7/2016,1610612761,Toronto Raptors,0,1,1610612748,Miami Heat,1,0,25,27,52,8,10,18,33,37,70,21,7,28,9,32,16,8,13,89,95
2015,4,41500212,5/5/2016,1610612748,Miami Heat,0,0,1610612761,Toronto Raptors,1,1,34,31,65,5,9,14,39,40,79,9,4,13,12,29,14,15,21,95,92
2015,4,41500212,5/5/2016,1610612761,Toronto Raptors,1,1,1610612748,Miami Heat,0,0,35,40,75,4,14,18,39,54,93,14,12,26,21,38,14,6,10,96,96
2015,4,41500211,5/3/2016,1610612748,Miami Heat,0,1,1610612761,Toronto Raptors,1,0,32,46,78,8,3,11,40,49,89,14,7,21,15,38,12,10,20,103,102
2015,4,41500211,5/3/2016,1610612761,Toronto Raptors,1,0,1610612748,Miami Heat,0,1,35,33,68,5,16,21,40,49,89,11,4,15,8,44,19,12,15,103,96
2015,4,41500204,5/8/2016,1610612737,Atlanta Hawks,1,0,1610612739,Cleveland Cavaliers,0,1,31,21,52,9,22,31,40,43,83,10,4,14,13,31,22,6,13,91,99
2015,4,41500204,5/8/2016,1610612739,Cleveland Cavaliers,0,1,1610612737,Atlanta Hawks,1,0,22,29,51,16,21,37,38,50,88,8,5,13,18,35,23,10,15,91,100
2015,4,41500203,5/6/2016,1610612737,Atlanta Hawks,1,0,1610612739,Cleveland Cavaliers,0,1,25,25,50,16,18,34,41,43,84,10,2,12,7,37,29,9,14,97,108
2015,4,41500203,5/6/2016,1610612739,Cleveland Cavaliers,0,1,1610612737,Atlanta Hawks,1,0,21,25,46,21,18,39,42,43,85,16,11,27,21,26,26,8,20,97,121
2015,4,41500202,5/4/2016,1610612737,Atlanta Hawks,0,0,1610612739,Cleveland Cavaliers,1,1,19,25,44,11,16,27,30,41,71,27,3,30,9,32,18,8,16,94,98
2015,4,41500202,5/4/2016,1610612739,Cleveland Cavaliers,1,1,1610612737,Atlanta Hawks,0,0,16,26,42,25,20,45,41,46,87,16,7,23,16,34,27,3,10,93,123
2013,4,41300104,4/26/2014,1610612737,Atlanta Hawks,1,0,1610612754,Indiana Pacers,0,1,19,34,53,11,20,31,30,54,84,17,0,17,17,37,22,7,14,89,88
2013,4,41300104,4/26/2014,1610612754,Indiana Pacers,0,1,1610612737,Atlanta Hawks,1,0,28,26,54,9,14,23,37,40,77,8,6,14,10,34,22,8,13,87,91
2015,4,41500201,5/2/2016,1610612737,Atlanta Hawks,0,0,1610612739,Cleveland Cavaliers,1,1,22,31,53,11,23,34,33,54,87,16,5,21,19,37,21,9,12,90,93
2013,4,41300106,5/1/2014,1610612737,Atlanta Hawks,1,0,1610612754,Indiana Pacers,0,1,20,26,46,9,26,35,29,52,81,21,3,24,14,40,14,7,14,92,88
2013,4,41300106,5/1/2014,1610612754,Indiana Pacers,0,1,1610612737,Atlanta Hawks,1,0,27,30,57,6,14,20,33,44,77,23,4,27,11,35,15,7,13,91,95
2013,4,41300105,4/28/2014,1610612737,Atlanta Hawks,0,1,1610612754,Indiana Pacers,1,0,18,21,39,15,12,27,33,33,66,26,7,33,8,28,19,11,18,91,107
2013,4,41300105,4/28/2014,1610612754,Indiana Pacers,1,0,1610612737,Atlanta Hawks,0,1,22,26,48,14,16,30,36,42,78,11,7,18,11,34,24,5,13,90,97
2015,4,41500201,5/2/2016,1610612739,Cleveland Cavaliers,1,1,1610612737,Atlanta Hawks,0,0,22,30,52,15,16,31,37,46,83,15,6,21,12,36,27,6,8,90,104
2015,4,41500176,4/29/2016,1610612746,LA Clippers,0,0,1610612757,Portland Trail Blazers,1,1,35,36,71,4,12,16,39,48,87,21,10,31,22,31,15,4,9,91,103
2015,4,41500176,4/29/2016,1610612757,Portland Trail Blazers,1,1,1610612746,LA Clippers,0,0,24,30,54,14,18,32,38,48,86,16,8,24,21,31,21,8,13,89,106
2015,4,41500175,4/27/2016,1610612746,LA Clippers,1,0,1610612757,Portland Trail Blazers,0,1,30,36,66,6,14,20,36,50,86,20,10,30,10,46,20,8,10,101,98
2015,4,41500175,4/27/2016,1610612757,Portland Trail Blazers,0,1,1610612746,LA Clippers,1,0,25,24,49,12,22,34,37,46,83,22,12,34,10,41,22,8,10,99,108
2013,4,41300101,4/19/2014,1610612737,Atlanta Hawks,0,1,1610612754,Indiana Pacers,1,0,22,24,46,11,19,30,33,43,76,24,5,29,10,34,13,8,12,91,101
2013,4,41300101,4/19/2014,1610612754,Indiana Pacers,1,0,1610612737,Atlanta Hawks,0,1,25,35,60,9,12,21,34,47,81,16,7,23,18,34,19,6,17,90,93
2013,4,41300102,4/22/2014,1610612737,Atlanta Hawks,0,0,1610612754,Indiana Pacers,1,1,21,29,50,10,19,29,31,48,79,13,5,18,12,37,13,8,13,89,85
2013,4,41300102,4/22/2014,1610612754,Indiana Pacers,1,1,1610612737,Atlanta Hawks,0,0,28,23,51,8,9,17,36,32,68,21,6,27,10,24,25,7,17,90,101
2013,4,41300103,4/24/2014,1610612737,Atlanta Hawks,1,1,1610612754,Indiana Pacers,0,0,16,23,39,12,22,34,28,45,73,30,7,37,7,42,21,9,14,96,98
2013,4,41300103,4/24/2014,1610612754,Indiana Pacers,0,0,1610612737,Atlanta Hawks,1,1,27,38,65,5,15,20,32,53,85,16,5,21,13,44,21,4,13,96,85
2015,4,41500174,4/25/2016,1610612746,LA Clippers,0,0,1610612757,Portland Trail Blazers,1,1,23,36,59,7,18,25,30,54,84,17,11,28,12,47,16,5,9,94,84
2015,4,41500174,4/25/2016,1610612757,Portland Trail Blazers,1,1,1610612746,LA Clippers,0,0,23,34,57,13,18,31,36,52,88,13,2,15,20,33,27,10,17,94,98
2015,4,41500173,4/23/2016,1610612746,LA Clippers,0,0,1610612757,Portland Trail Blazers,1,1,33,37,70,3,15,18,36,52,88,13,10,23,14,43,15,5,10,96,88
2015,4,41500173,4/23/2016,1610612757,Portland Trail Blazers,1,1,1610612746,LA Clippers,0,0,31,31,62,6,19,25,37,50,87,16,7,23,17,37,15,11,16,97,96
2015,4,41500172,4/20/2016,1610612746,LA Clippers,1,1,1610612757,Portland Trail Blazers,0,0,32,34,66,8,13,21,40,47,87,14,11,25,14,39,20,6,10,94,102
2015,4,41500172,4/20/2016,1610612757,Portland Trail Blazers,0,0,1610612746,LA Clippers,1,1,26,39,65,5,21,26,31,60,91,14,2,16,17,44,20,7,11,94,81
2012,4,41200406,6/18/2013,1610612748,Miami Heat,1,1,1610612759,San Antonio Spurs,0,0,27,35,62,11,8,19,38,43,81,16,5,21,12,33,23,8,15,95,103
2012,4,41200406,6/18/2013,1610612759,San Antonio Spurs,0,0,1610612748,Miami Heat,1,1,32,35,67,5,13,18,37,48,85,21,7,28,18,30,13,10,15,96,100
2015,4,41500171,4/17/2016,1610612746,LA Clippers,1,1,1610612757,Portland Trail Blazers,0,0,36,25,61,6,11,17,42,36,78,25,14,39,14,32,23,6,10,95,115
2015,4,41500171,4/17/2016,1610612757,Portland Trail Blazers,0,0,1610612746,LA Clippers,1,1,23,30,53,10,20,30,33,50,83,19,7,26,14,38,23,7,12,95,95
2012,4,41200407,6/20/2013,1610612748,Miami Heat,1,1,1610612759,San Antonio Spurs,0,0,24,26,50,12,20,32,36,46,82,11,5,16,15,33,14,12,16,92,95
2012,4,41200407,6/20/2013,1610612759,San Antonio Spurs,0,0,1610612748,Miami Heat,1,1,25,38,63,6,13,19,31,51,82,20,2,22,16,36,13,8,15,91,88
2015,4,41500165,4/25/2016,1610612742,Dallas Mavericks,0,0,1610612760,Oklahoma City Thunder,1,1,30,27,57,8,16,24,38,43,81,20,4,24,15,30,24,6,9,86,104
2015,4,41500165,4/25/2016,1610612760,Oklahoma City Thunder,1,1,1610612742,Dallas Mavericks,0,0,31,20,51,10,20,30,41,40,81,26,6,32,18,26,19,5,9,88,118
2015,4,41500164,4/23/2016,1610612742,Dallas Mavericks,1,0,1610612760,Oklahoma City Thunder,0,1,35,25,60,8,15,23,43,40,83,14,3,17,9,32,25,6,12,93,108
2015,4,41500164,4/23/2016,1610612760,Oklahoma City Thunder,0,1,1610612742,Dallas Mavericks,1,0,37,30,67,7,9,16,44,39,83,24,10,34,14,29,26,3,9,93,119
2008,4,40800405,6/14/2009,1610612747,Los Angeles Lakers,0,1,1610612753,Orlando Magic,1,0,27,37,64,8,8,16,35,45,80,21,7,28,17,31,13,6,12,88,99
2008,4,40800405,6/14/2009,1610612753,Orlando Magic,1,0,1610612747,Los Angeles Lakers,0,1,26,29,55,8,19,27,34,48,82,10,6,16,16,35,20,6,13,90,86
2015,4,41500163,4/21/2016,1610612742,Dallas Mavericks,1,0,1610612760,Oklahoma City Thunder,0,1,30,23,53,6,17,23,36,40,76,24,11,35,9,36,24,10,12,96,102
2015,4,41500163,4/21/2016,1610612760,Oklahoma City Thunder,0,1,1610612742,Dallas Mavericks,1,0,30,21,51,15,12,27,45,33,78,26,9,35,12,27,28,9,14,97,131
2008,4,40800404,6/11/2009,1610612747,Los Angeles Lakers,0,1,1610612753,Orlando Magic,1,0,30,38,68,8,15,23,38,53,91,15,5,20,13,40,15,4,8,94,99
2008,4,40800404,6/11/2009,1610612753,Orlando Magic,1,0,1610612747,Los Angeles Lakers,0,1,24,29,53,7,14,21,31,43,74,22,15,37,16,35,17,8,19,96,91
2008,4,40800403,6/9/2009,1610612747,Los Angeles Lakers,0,0,1610612753,Orlando Magic,1,1,32,23,55,8,15,23,40,38,78,16,10,26,16,26,16,7,13,87,104
2008,4,40800403,6/9/2009,1610612753,Orlando Magic,1,1,1610612747,Los Angeles Lakers,0,0,35,15,50,5,9,14,40,24,64,23,7,30,6,20,23,6,13,86,108
2012,4,41200403,6/11/2013,1610612748,Miami Heat,0,0,1610612759,San Antonio Spurs,1,1,23,35,58,8,10,18,31,45,76,7,3,10,11,36,21,10,16,86,77
2012,4,41200403,6/11/2013,1610612759,San Antonio Spurs,1,1,1610612748,Miami Heat,0,0,27,29,56,16,16,32,43,45,88,11,8,19,21,28,29,9,13,88,113
2008,4,40800402,6/7/2009,1610612747,Los Angeles Lakers,1,1,1610612753,Orlando Magic,0,0,31,32,63,5,10,15,36,42,78,24,4,28,6,36,20,5,12,100,101
2008,4,40800402,6/7/2009,1610612753,Orlando Magic,0,0,1610612747,Los Angeles Lakers,1,1,23,26,49,10,20,30,33,46,79,20,7,27,14,34,22,12,20,100,96
2008,4,40800401,6/4/2009,1610612747,Los Angeles Lakers,1,1,1610612753,Orlando Magic,0,0,38,42,80,3,6,9,41,48,89,15,3,18,19,31,18,8,9,88,100
2008,4,40800401,6/4/2009,1610612753,Orlando Magic,0,0,1610612747,Los Angeles Lakers,1,1,15,39,54,8,15,23,23,54,77,21,8,29,13,44,10,4,8,87,75
2015,4,41500162,4/18/2016,1610612742,Dallas Mavericks,0,1,1610612760,Oklahoma City Thunder,1,0,30,33,63,5,14,19,35,47,82,10,9,19,13,37,14,9,13,92,85
2015,4,41500162,4/18/2016,1610612760,Oklahoma City Thunder,1,0,1610612742,Dallas Mavericks,0,1,24,36,60,7,25,32,31,61,92,15,3,18,25,39,11,8,15,93,84
2008,4,40800315,5/27/2009,1610612743,Denver Nuggets,0,0,1610612747,Los Angeles Lakers,1,1,25,34,59,7,17,24,32,51,83,23,7,30,21,34,17,5,16,93,94
2008,4,40800315,5/27/2009,1610612747,Los Angeles Lakers,1,1,1610612743,Denver Nuggets,0,0,34,26,60,3,13,16,37,39,76,26,9,35,13,31,25,11,16,92,103
2008,4,40800316,5/29/2009,1610612743,Denver Nuggets,1,0,1610612747,Los Angeles Lakers,0,1,24,30,54,8,11,19,32,41,73,20,5,25,11,32,14,6,13,90,92
2012,4,41200405,6/16/2013,1610612748,Miami Heat,0,0,1610612759,San Antonio Spurs,1,1,26,37,63,11,12,23,37,49,86,19,4,23,15,34,25,5,15,96,104
2012,4,41200405,6/16/2013,1610612759,San Antonio Spurs,1,1,1610612748,Miami Heat,0,0,33,15,48,9,13,22,42,28,70,21,5,26,6,23,21,8,19,96,114
2008,4,40800316,5/29/2009,1610612747,Los Angeles Lakers,0,1,1610612743,Denver Nuggets,1,0,34,25,59,9,7,16,43,32,75,24,0,24,10,22,28,7,14,89,119
2008,4,40800314,5/25/2009,1610612743,Denver Nuggets,1,1,1610612747,Los Angeles Lakers,0,0,31,31,62,7,17,24,38,48,86,37,12,49,22,33,23,4,6,92,120
2008,4,40800314,5/25/2009,1610612747,Los Angeles Lakers,0,0,1610612743,Denver Nuggets,1,1,25,26,51,9,22,31,34,48,82,24,11,35,14,41,19,6,10,93,101
2008,4,40800313,5/23/2009,1610612743,Denver Nuggets,1,0,1610612747,Los Angeles Lakers,0,1,28,29,57,5,22,27,33,51,84,26,5,31,15,38,21,7,11,96,97
2008,4,40800313,5/23/2009,1610612747,Los Angeles Lakers,0,1,1610612743,Denver Nuggets,1,0,27,26,53,6,13,19,33,39,72,31,14,45,11,35,15,10,13,94,103
2012,4,41200404,6/13/2013,1610612748,Miami Heat,0,1,1610612759,San Antonio Spurs,1,0,41,32,73,4,8,12,45,40,85,15,2,17,8,32,23,5,9,94,109
2012,4,41200404,6/13/2013,1610612759,San Antonio Spurs,1,0,1610612748,Miami Heat,0,1,23,31,54,8,8,16,31,39,70,23,8,31,10,35,21,13,19,94,93
2008,4,40800312,5/21/2009,1610612743,Denver Nuggets,0,1,1610612747,Los Angeles Lakers,1,0,28,30,58,7,14,21,35,44,79,29,8,37,17,30,20,9,14,93,106
2008,4,40800312,5/21/2009,1610612747,Los Angeles Lakers,1,0,1610612743,Denver Nuggets,0,1,29,33,62,6,9,15,35,42,77,27,8,35,16,30,21,9,16,94,103
2008,4,40800306,5/30/2009,1610612739,Cleveland Cavaliers,0,0,1610612753,Orlando Magic,1,1,26,33,59,9,11,20,35,44,79,11,11,22,10,39,17,6,10,89,90
2008,4,40800306,5/30/2009,1610612753,Orlando Magic,1,1,1610612739,Cleveland Cavaliers,0,0,25,26,51,12,17,29,37,43,80,17,4,21,14,31,19,6,12,88,103
2008,4,40800311,5/19/2009,1610612743,Denver Nuggets,0,0,1610612747,Los Angeles Lakers,1,1,28,27,55,8,11,19,36,38,74,23,12,35,10,31,24,7,15,96,103
2008,4,40800311,5/19/2009,1610612747,Los Angeles Lakers,1,1,1610612743,Denver Nuggets,0,0,26,39,65,11,14,25,37,53,90,20,4,24,21,36,25,9,16,96,105
2015,4,41500161,4/16/2016,1610612742,Dallas Mavericks,0,0,1610612760,Oklahoma City Thunder,1,1,21,45,66,4,14,18,25,59,84,16,10,26,18,44,16,7,13,92,70
2015,4,41500161,4/16/2016,1610612760,Oklahoma City Thunder,1,1,1610612742,Dallas Mavericks,0,0,24,21,45,12,23,35,36,44,80,24,4,28,19,27,23,5,18,93,108
2008,4,40800305,5/28/2009,1610612739,Cleveland Cavaliers,1,1,1610612753,Orlando Magic,0,0,29,29,58,9,9,18,38,38,76,27,7,34,10,32,21,11,12,91,112
2008,4,40800305,5/28/2009,1610612753,Orlando Magic,0,0,1610612739,Cleveland Cavaliers,1,1,25,22,47,8,17,25,33,39,72,28,13,41,12,35,12,4,12,90,102
2008,4,40800303,5/24/2009,1610612739,Cleveland Cavaliers,0,0,1610612753,Orlando Magic,1,1,24,28,52,5,21,26,29,49,78,26,9,35,18,36,17,9,15,91,89
2008,4,40800303,5/24/2009,1610612753,Orlando Magic,1,1,1610612739,Cleveland Cavaliers,0,0,21,25,46,6,11,17,27,36,63,39,12,51,10,33,16,7,13,91,99
2015,4,41500154,4/24/2016,1610612759,San Antonio Spurs,0,1,1610612763,Memphis Grizzlies,1,0,30,29,59,10,12,22,40,41,81,26,5,31,17,27,21,6,12,93,116
2015,4,41500154,4/24/2016,1610612763,Memphis Grizzlies,1,0,1610612759,San Antonio Spurs,0,1,30,35,65,5,8,13,35,43,78,20,7,27,16,31,18,8,17,91,95
2008,4,40800302,5/22/2009,1610612739,Cleveland Cavaliers,1,1,1610612753,Orlando Magic,0,0,30,28,58,5,14,19,35,42,77,21,5,26,15,30,17,6,14,88,96
2008,4,40800302,5/22/2009,1610612753,Orlando Magic,0,0,1610612739,Cleveland Cavaliers,1,1,24,24,48,10,13,23,34,37,71,17,8,25,9,32,16,5,12,87,95
2008,4,40800301,5/20/2009,1610612739,Cleveland Cavaliers,1,0,1610612753,Orlando Magic,0,1,35,28,63,8,17,25,43,45,88,12,5,17,16,31,23,5,8,87,106
2008,4,40800301,5/20/2009,1610612753,Orlando Magic,0,1,1610612739,Cleveland Cavaliers,1,0,34,24,58,9,11,20,43,35,78,12,2,14,10,26,32,8,13,87,107
2012,4,41200402,6/9/2013,1610612748,Miami Heat,1,1,1610612759,San Antonio Spurs,0,0,31,33,64,10,9,19,41,42,83,11,3,14,13,30,22,3,6,82,103
2012,4,41200402,6/9/2013,1610612759,San Antonio Spurs,0,0,1610612748,Miami Heat,1,1,22,36,58,10,10,20,32,46,78,10,4,14,20,29,16,9,17,82,84
2008,4,40800235,5/13/2009,1610612742,Dallas Mavericks,0,0,1610612743,Denver Nuggets,1,1,26,14,40,12,22,34,38,36,74,22,7,29,11,28,23,8,14,90,110
2008,4,40800235,5/13/2009,1610612743,Denver Nuggets,1,1,1610612742,Dallas Mavericks,0,0,37,19,56,11,15,26,48,34,82,17,5,22,15,22,31,5,13,91,124
2012,4,41200401,6/6/2013,1610612748,Miami Heat,1,0,1610612759,San Antonio Spurs,0,1,26,27,53,8,17,25,34,44,78,12,5,17,11,34,20,6,9,86,88
2008,4,40800233,5/9/2009,1610612742,Dallas Mavericks,1,0,1610612743,Denver Nuggets,0,1,25,35,60,5,10,15,30,45,75,40,9,49,16,31,15,7,10,92,105
2008,4,40800233,5/9/2009,1610612743,Denver Nuggets,0,1,1610612742,Dallas Mavericks,1,0,28,38,66,6,9,15,34,47,81,32,8,40,14,37,15,1,7,92,106
2012,4,41200401,6/6/2013,1610612759,San Antonio Spurs,0,1,1610612748,Miami Heat,1,0,28,33,61,7,16,23,35,49,84,15,3,18,11,39,16,4,4,86,92
2008,4,40800234,5/11/2009,1610612742,Dallas Mavericks,1,1,1610612743,Denver Nuggets,0,0,37,28,65,3,11,14,40,39,79,36,7,43,12,32,17,9,15,99,119
2008,4,40800234,5/11/2009,1610612743,Denver Nuggets,0,0,1610612742,Dallas Mavericks,1,1,29,29,58,9,12,21,38,41,79,32,12,44,8,42,16,9,11,99,117
2008,4,40800232,5/5/2009,1610612742,Dallas Mavericks,0,0,1610612743,Denver Nuggets,1,1,29,26,55,8,15,23,37,41,78,23,7,30,12,31,23,9,13,94,105
2008,4,40800232,5/5/2009,1610612743,Denver Nuggets,1,1,1610612742,Dallas Mavericks,0,0,31,19,50,8,20,28,39,39,78,31,9,40,14,31,28,4,10,94,117
2008,4,40800231,5/3/2009,1610612742,Dallas Mavericks,0,0,1610612743,Denver Nuggets,1,1,34,30,64,6,12,18,40,42,82,9,4,13,14,29,17,15,20,96,95
2008,4,40800231,5/3/2009,1610612743,Denver Nuggets,1,1,1610612742,Dallas Mavericks,0,0,36,25,61,4,8,12,40,33,73,25,11,36,8,30,28,10,15,96,109
2008,4,40800227,5/17/2009,1610612745,Houston Rockets,0,0,1610612747,Los Angeles Lakers,1,1,23,33,56,5,15,20,28,48,76,9,5,14,9,42,17,8,16,90,70
2008,4,40800227,5/17/2009,1610612747,Los Angeles Lakers,1,1,1610612745,Houston Rockets,0,0,30,30,60,5,10,15,35,40,75,14,4,18,14,29,16,13,19,90,89
2008,4,40800225,5/12/2009,1610612745,Houston Rockets,0,0,1610612747,Los Angeles Lakers,1,1,24,36,60,5,24,29,29,60,89,15,1,16,20,40,15,12,18,95,78
2008,4,40800225,5/12/2009,1610612747,Los Angeles Lakers,1,1,1610612745,Houston Rockets,0,0,36,33,69,6,7,13,42,40,82,28,8,36,15,28,20,4,13,97,118
2008,4,40800226,5/14/2009,1610612745,Houston Rockets,1,1,1610612747,Los Angeles Lakers,0,0,29,24,53,7,11,18,36,35,71,16,6,22,9,31,19,6,12,85,95
2008,4,40800226,5/14/2009,1610612747,Los Angeles Lakers,0,0,1610612745,Houston Rockets,1,1,25,36,61,5,18,23,30,54,84,15,5,20,21,36,11,6,10,85,80
2008,4,40800224,5/10/2009,1610612745,Houston Rockets,1,1,1610612747,Los Angeles Lakers,0,0,26,25,51,10,19,29,36,44,80,17,3,20,14,32,18,7,11,86,99
2008,4,40800224,5/10/2009,1610612747,Los Angeles Lakers,0,0,1610612745,Houston Rockets,1,1,26,32,58,8,10,18,34,42,76,11,7,18,10,36,14,7,11,86,87
2015,4,41500152,4/19/2016,1610612759,San Antonio Spurs,1,1,1610612763,Memphis Grizzlies,0,0,22,27,49,9,8,17,31,35,66,23,5,28,7,30,19,14,19,92,94
2015,4,41500152,4/19/2016,1610612763,Memphis Grizzlies,0,0,1610612759,San Antonio Spurs,1,1,26,45,71,2,13,15,28,58,86,10,8,18,18,45,14,8,14,91,68
2008,4,40800222,5/6/2009,1610612745,Houston Rockets,0,0,1610612747,Los Angeles Lakers,1,1,25,25,50,9,15,24,34,40,74,21,8,29,16,30,16,10,20,92,98
2008,4,40800222,5/6/2009,1610612747,Los Angeles Lakers,1,1,1610612745,Houston Rockets,0,0,37,32,69,6,11,17,43,43,86,19,7,26,17,28,23,6,11,92,111
2008,4,40800221,5/4/2009,1610612745,Houston Rockets,0,1,1610612747,Los Angeles Lakers,1,0,30,25,55,5,13,18,35,38,73,25,4,29,11,28,16,11,18,98,100
2008,4,40800221,5/4/2009,1610612747,Los Angeles Lakers,1,0,1610612745,Houston Rockets,0,1,37,33,70,2,16,18,39,49,88,12,7,19,14,38,18,8,13,96,92
2008,4,40800223,5/8/2009,1610612745,Houston Rockets,1,0,1610612747,Los Angeles Lakers,0,1,29,36,65,6,13,19,35,49,84,18,7,25,21,33,16,11,17,91,94
2008,4,40800223,5/8/2009,1610612747,Los Angeles Lakers,0,1,1610612745,Houston Rockets,1,0,25,37,62,11,9,20,36,46,82,25,8,33,12,37,17,2,6,92,108
2008,4,40800217,5/17/2009,1610612738,Boston Celtics,1,0,1610612753,Orlando Magic,0,1,25,33,58,4,12,16,29,45,74,20,5,25,11,36,21,4,13,89,82
2008,4,40800217,5/17/2009,1610612753,Orlando Magic,0,1,1610612738,Boston Celtics,1,0,23,26,49,13,8,21,36,34,70,16,4,20,7,30,26,6,16,89,101
2015,4,41500151,4/17/2016,1610612759,San Antonio Spurs,1,1,1610612763,Memphis Grizzlies,0,0,32,27,59,10,12,22,42,39,81,12,1,13,11,28,22,7,13,90,106
2015,4,41500151,4/17/2016,1610612763,Memphis Grizzlies,0,0,1610612759,San Antonio Spurs,1,1,23,38,61,8,10,18,31,48,79,4,2,6,11,37,17,13,17,90,74
2008,4,40800215,5/12/2009,1610612738,Boston Celtics,1,1,1610612753,Orlando Magic,0,0,28,34,62,5,11,16,33,45,78,21,0,21,13,32,23,5,8,84,92
2008,4,40800215,5/12/2009,1610612753,Orlando Magic,0,0,1610612738,Boston Celtics,1,1,30,26,56,6,18,24,36,44,80,10,2,12,12,34,23,7,10,83,88
2008,4,40800216,5/14/2009,1610612738,Boston Celtics,0,0,1610612753,Orlando Magic,1,1,29,30,59,3,15,18,32,45,77,8,5,13,19,28,18,9,22,86,75
2008,4,40800216,5/14/2009,1610612753,Orlando Magic,1,1,1610612738,Boston Celtics,0,0,24,32,56,6,20,26,30,52,82,17,14,31,22,37,13,7,10,87,83
2012,4,41200314,5/27/2013,1610612759,San Antonio Spurs,0,1,1610612763,Memphis Grizzlies,1,0,36,27,63,3,10,13,39,37,76,12,1,13,10,27,23,7,16,88,93
2012,4,41200314,5/27/2013,1610612763,Memphis Grizzlies,1,0,1610612759,San Antonio Spurs,0,1,27,45,72,5,9,14,32,54,86,17,7,24,21,37,19,10,13,89,86
2008,4,40800214,5/10/2009,1610612738,Boston Celtics,0,1,1610612753,Orlando Magic,1,0,37,25,62,1,9,10,38,34,72,18,9,27,11,27,16,5,13,88,95
2008,4,40800214,5/10/2009,1610612753,Orlando Magic,1,0,1610612738,Boston Celtics,0,1,29,29,58,5,22,27,34,51,85,21,7,28,17,38,20,3,8,88,94
2008,4,40800213,5/8/2009,1610612738,Boston Celtics,0,0,1610612753,Orlando Magic,1,1,29,32,61,5,13,18,34,45,79,23,3,26,10,36,24,11,15,97,96
2008,4,40800213,5/8/2009,1610612753,Orlando Magic,1,1,1610612738,Boston Celtics,0,0,30,18,48,9,9,18,39,27,66,30,6,36,5,27,16,11,19,97,117
2008,4,40800212,5/6/2009,1610612738,Boston Celtics,1,1,1610612753,Orlando Magic,0,0,32,28,60,9,11,20,41,39,80,21,4,25,11,29,34,3,10,93,112
2008,4,40800212,5/6/2009,1610612753,Orlando Magic,0,0,1610612738,Boston Celtics,1,1,23,28,51,8,11,19,31,39,70,24,13,37,9,35,19,6,13,92,94
2008,4,40800211,5/4/2009,1610612738,Boston Celtics,1,0,1610612753,Orlando Magic,0,1,22,33,55,8,15,23,30,48,78,22,4,26,13,36,23,10,15,94,90
2008,4,40800211,5/4/2009,1610612753,Orlando Magic,0,1,1610612738,Boston Celtics,1,0,26,28,54,9,18,27,35,46,81,16,5,21,9,40,20,8,13,94,95
2008,4,40800204,5/11/2009,1610612737,Atlanta Hawks,1,0,1610612739,Cleveland Cavaliers,0,1,21,39,60,2,11,13,23,50,73,26,4,30,11,39,13,6,8,83,74
2008,4,40800204,5/11/2009,1610612739,Cleveland Cavaliers,0,1,1610612737,Atlanta Hawks,1,0,20,32,52,10,8,18,30,40,70,14,12,26,18,27,22,7,18,83,84
2015,4,41500144,4/24/2016,1610612744,Golden State Warriors,0,1,1610612745,Houston Rockets,1,0,25,24,49,21,19,40,46,43,89,8,8,16,11,36,38,11,16,103,121
2008,4,40800203,5/9/2009,1610612737,Atlanta Hawks,1,0,1610612739,Cleveland Cavaliers,0,1,27,31,58,7,11,18,34,42,76,7,4,11,12,34,19,3,9,80,82
2008,4,40800203,5/9/2009,1610612739,Cleveland Cavaliers,0,1,1610612737,Atlanta Hawks,1,0,29,18,47,6,16,22,35,34,69,21,8,29,17,19,15,7,13,79,97
2008,4,40800202,5/7/2009,1610612737,Atlanta Hawks,0,0,1610612739,Cleveland Cavaliers,1,1,21,44,65,8,10,18,29,54,83,19,5,24,20,37,17,7,14,88,85
2008,4,40800202,5/7/2009,1610612739,Cleveland Cavaliers,1,1,1610612737,Atlanta Hawks,0,0,32,20,52,6,13,19,38,33,71,23,7,30,16,19,19,9,18,88,105
2008,4,40800201,5/5/2009,1610612737,Atlanta Hawks,0,0,1610612739,Cleveland Cavaliers,1,1,21,25,46,7,11,18,28,36,64,9,9,18,10,29,19,12,17,81,72
2008,4,40800201,5/5/2009,1610612739,Cleveland Cavaliers,1,1,1610612737,Atlanta Hawks,0,0,29,30,59,8,12,20,37,42,79,17,7,24,18,28,16,5,7,81,99
2015,4,41500144,4/24/2016,1610612745,Houston Rockets,1,0,1610612744,Golden State Warriors,0,1,28,23,51,5,22,27,33,45,78,23,15,38,12,40,18,10,18,103,94
2008,4,40800176,4/30/2009,1610612745,Houston Rockets,1,1,1610612757,Portland Trail Blazers,0,0,27,27,54,9,15,24,36,42,78,11,3,14,14,29,14,3,8,83,92
2008,4,40800176,4/30/2009,1610612757,Portland Trail Blazers,0,0,1610612745,Houston Rockets,1,1,26,34,60,4,7,11,30,41,71,12,4,16,13,31,14,9,15,81,76
2008,4,40800174,4/26/2009,1610612745,Houston Rockets,1,1,1610612757,Portland Trail Blazers,0,0,24,43,67,9,7,16,33,50,83,14,8,22,22,33,24,7,9,80,89
2008,4,40800174,4/26/2009,1610612757,Portland Trail Blazers,0,0,1610612745,Houston Rockets,1,1,25,30,55,7,8,15,32,38,70,17,0,17,11,27,18,7,13,80,88
2015,4,41500143,4/21/2016,1610612744,Golden State Warriors,0,0,1610612745,Houston Rockets,1,1,28,26,54,6,19,25,34,45,79,22,7,29,10,39,23,9,14,99,96
2015,4,41500143,4/21/2016,1610612745,Houston Rockets,1,1,1610612744,Golden State Warriors,0,0,25,31,56,11,25,36,36,56,92,14,9,23,23,38,18,6,16,98,97
2008,4,40800175,4/28/2009,1610612745,Houston Rockets,0,0,1610612757,Portland Trail Blazers,1,1,30,28,58,3,12,15,33,40,73,8,2,10,8,33,17,10,17,87,77
2008,4,40800175,4/28/2009,1610612757,Portland Trail Blazers,1,1,1610612745,Houston Rockets,0,0,27,31,58,6,8,14,33,39,72,16,7,23,9,35,14,5,12,88,88
2008,4,40800173,4/24/2009,1610612745,Houston Rockets,1,1,1610612757,Portland Trail Blazers,0,0,29,31,60,3,6,9,32,37,69,19,5,24,12,28,21,7,14,83,86
2008,4,40800173,4/24/2009,1610612757,Portland Trail Blazers,0,0,1610612745,Houston Rockets,1,1,22,31,53,10,13,23,32,44,76,9,1,10,12,33,19,7,13,82,83
2008,4,40800172,4/21/2009,1610612745,Houston Rockets,0,0,1610612757,Portland Trail Blazers,1,1,30,24,54,7,13,20,37,37,74,22,10,32,9,34,12,5,10,90,103
2008,4,40800172,4/21/2009,1610612757,Portland Trail Blazers,1,1,1610612745,Houston Rockets,0,0,33,30,63,5,6,11,38,36,74,26,10,36,8,33,11,1,6,90,107
2008,4,40800171,4/18/2009,1610612745,Houston Rockets,0,1,1610612757,Portland Trail Blazers,1,0,30,14,44,8,13,21,38,27,65,24,4,28,10,19,16,4,15,83,108
2008,4,40800171,4/18/2009,1610612757,Portland Trail Blazers,1,0,1610612745,Houston Rockets,0,1,34,39,73,1,10,11,35,49,84,10,6,16,17,38,12,5,9,83,81
2015,4,41500142,4/18/2016,1610612744,Golden State Warriors,1,1,1610612745,Houston Rockets,0,0,32,26,58,8,15,23,40,41,81,27,11,38,17,28,27,4,13,97,115
2008,4,40800163,4/23/2009,1610612742,Dallas Mavericks,1,1,1610612759,San Antonio Spurs,0,0,26,24,50,8,14,22,34,38,72,12,4,16,5,35,20,7,13,88,88
2008,4,40800163,4/23/2009,1610612759,San Antonio Spurs,0,0,1610612742,Dallas Mavericks,1,1,23,38,61,2,15,17,25,53,78,15,6,21,10,47,10,8,11,90,67
2015,4,41500142,4/18/2016,1610612745,Houston Rockets,0,0,1610612744,Golden State Warriors,1,1,25,29,54,10,15,25,35,44,79,26,7,33,16,32,21,10,19,97,106
2008,4,40800165,4/28/2009,1610612742,Dallas Mavericks,0,1,1610612759,San Antonio Spurs,1,0,28,26,54,10,10,20,38,36,74,20,5,25,12,26,20,5,11,86,106
2008,4,40800165,4/28/2009,1610612759,San Antonio Spurs,1,0,1610612742,Dallas Mavericks,0,1,36,23,59,3,13,16,39,36,75,12,7,19,10,30,19,8,11,86,93
2012,4,41200313,5/25/2013,1610612759,San Antonio Spurs,0,1,1610612763,Memphis Grizzlies,1,0,35,29,64,6,12,18,41,41,82,16,6,22,14,30,20,10,17,94,104
2008,4,40800164,4/25/2009,1610612742,Dallas Mavericks,1,1,1610612759,San Antonio Spurs,0,0,18,30,48,10,15,25,28,45,73,33,6,39,17,31,15,9,15,90,99
2008,4,40800164,4/25/2009,1610612759,San Antonio Spurs,0,0,1610612742,Dallas Mavericks,1,1,25,22,47,6,17,23,31,39,70,22,12,34,9,34,14,6,11,89,90
2012,4,41200313,5/25/2013,1610612763,Memphis Grizzlies,1,0,1610612759,San Antonio Spurs,0,1,31,46,77,7,13,20,38,59,97,10,8,18,23,40,18,6,10,93,93
2008,4,40800161,4/18/2009,1610612742,Dallas Mavericks,0,1,1610612759,San Antonio Spurs,1,0,37,24,61,5,12,17,42,36,78,16,1,17,11,25,14,2,7,83,105
2008,4,40800161,4/18/2009,1610612759,San Antonio Spurs,1,0,1610612742,Dallas Mavericks,0,1,27,40,67,11,3,14,38,43,81,10,2,12,14,29,18,5,9,81,97
2015,4,41500141,4/16/2016,1610612744,Golden State Warriors,1,1,1610612745,Houston Rockets,0,0,29,37,66,10,15,25,39,52,91,16,8,24,17,39,26,10,18,104,104
2012,4,41200312,5/21/2013,1610612759,San Antonio Spurs,1,1,1610612763,Memphis Grizzlies,0,0,27,31,58,9,16,25,36,47,83,12,5,17,6,42,29,9,13,99,93
2012,4,41200312,5/21/2013,1610612763,Memphis Grizzlies,0,0,1610612759,San Antonio Spurs,1,1,28,52,80,5,12,17,33,64,97,18,8,26,22,45,19,5,12,99,89
2008,4,40800155,4/29/2009,1610612740,New Orleans Pelicans,0,0,1610612743,Denver Nuggets,1,1,26,30,56,3,17,20,29,47,76,25,5,30,13,37,16,9,15,91,86
2008,4,40800155,4/29/2009,1610612743,Denver Nuggets,1,1,1610612740,New Orleans Pelicans,0,0,27,22,49,10,13,23,37,35,72,23,4,27,9,27,26,8,15,91,107
2008,4,40800162,4/20/2009,1610612742,Dallas Mavericks,0,0,1610612759,San Antonio Spurs,1,1,23,31,54,6,12,18,29,43,72,20,3,23,7,37,17,5,12,87,84
2008,4,40800162,4/20/2009,1610612759,San Antonio Spurs,1,1,1610612742,Dallas Mavericks,0,0,35,26,61,7,11,18,42,37,79,14,3,17,11,27,19,9,13,87,105
2008,4,40800154,4/27/2009,1610612740,New Orleans Pelicans,1,0,1610612743,Denver Nuggets,0,1,15,24,39,2,13,15,17,37,54,27,5,32,9,32,10,15,27,90,63
2008,4,40800154,4/27/2009,1610612743,Denver Nuggets,0,1,1610612740,New Orleans Pelicans,1,0,33,23,56,10,10,20,43,33,76,25,5,30,10,27,29,10,11,90,121
2008,4,40800153,4/25/2009,1610612740,New Orleans Pelicans,1,1,1610612743,Denver Nuggets,0,0,23,26,49,7,13,20,30,39,69,28,7,35,9,35,16,7,16,90,95
2008,4,40800153,4/25/2009,1610612743,Denver Nuggets,0,0,1610612740,New Orleans Pelicans,1,1,21,32,53,9,12,21,30,44,74,24,11,35,13,36,19,6,14,90,93
2015,4,41500141,4/16/2016,1610612745,Houston Rockets,0,0,1610612744,Golden State Warriors,1,1,24,38,62,6,16,22,30,54,84,12,12,24,15,45,16,10,24,104,78
2008,4,40800152,4/22/2009,1610612740,New Orleans Pelicans,0,0,1610612743,Denver Nuggets,1,1,25,33,58,9,7,16,34,40,74,16,4,20,15,26,18,8,17,87,93
2008,4,40800152,4/22/2009,1610612743,Denver Nuggets,1,1,1610612740,New Orleans Pelicans,0,0,34,36,70,9,7,16,43,43,86,13,8,21,15,32,26,1,6,87,108
2008,4,40800151,4/19/2009,1610612740,New Orleans Pelicans,0,0,1610612743,Denver Nuggets,1,1,20,38,58,9,12,21,29,50,79,17,6,23,13,40,19,8,17,92,84
2008,4,40800151,4/19/2009,1610612743,Denver Nuggets,1,1,1610612740,New Orleans Pelicans,0,0,27,26,53,11,10,21,38,36,74,26,7,33,16,25,25,8,17,93,113
2008,4,40800145,4/27/2009,1610612747,Los Angeles Lakers,1,1,1610612762,Utah Jazz,0,0,27,32,59,9,12,21,36,44,80,26,9,35,19,31,23,9,16,95,107
2008,4,40800145,4/27/2009,1610612762,Utah Jazz,0,0,1610612747,Los Angeles Lakers,1,1,29,40,69,6,12,18,35,52,87,20,7,27,17,38,24,8,10,94,96
2008,4,40800143,4/23/2009,1610612747,Los Angeles Lakers,0,0,1610612762,Utah Jazz,1,1,26,44,70,6,11,17,32,55,87,16,10,26,19,43,15,5,9,91,86
2008,4,40800143,4/23/2009,1610612762,Utah Jazz,1,1,1610612747,Los Angeles Lakers,0,0,29,33,62,4,9,13,33,42,75,18,10,28,16,29,23,7,16,90,88
2008,4,40800144,4/25/2009,1610612747,Los Angeles Lakers,0,1,1610612762,Utah Jazz,1,0,32,26,58,8,11,19,40,37,77,20,8,28,12,29,19,12,15,94,108
2008,4,40800144,4/25/2009,1610612762,Utah Jazz,1,0,1610612747,Los Angeles Lakers,0,1,30,37,67,4,6,10,34,43,77,22,10,32,11,39,27,11,13,94,94
2008,4,40800142,4/21/2009,1610612747,Los Angeles Lakers,1,1,1610612762,Utah Jazz,0,0,34,21,55,11,9,20,45,30,75,18,6,24,8,24,33,13,21,98,119
2008,4,40800142,4/21/2009,1610612762,Utah Jazz,0,0,1610612747,Los Angeles Lakers,1,1,31,29,60,8,11,19,39,40,79,23,6,29,15,27,25,8,20,98,109
2015,4,41500136,4/28/2016,1610612737,Atlanta Hawks,0,1,1610612738,Boston Celtics,1,0,30,20,50,8,16,24,38,36,74,20,7,27,5,33,26,5,20,102,104
2015,4,41500136,4/28/2016,1610612738,Boston Celtics,1,0,1610612737,Atlanta Hawks,0,1,27,35,62,7,25,32,34,60,94,17,1,18,14,47,16,6,12,102,92
2008,4,40800141,4/19/2009,1610612747,Los Angeles Lakers,1,1,1610612762,Utah Jazz,0,0,33,24,57,7,8,15,40,32,72,26,6,32,8,29,22,10,17,95,113
2008,4,40800141,4/19/2009,1610612762,Utah Jazz,0,0,1610612747,Los Angeles Lakers,1,1,31,43,74,3,10,13,34,53,87,29,6,35,22,35,28,8,14,95,100
2008,4,40800137,5/3/2009,1610612737,Atlanta Hawks,1,1,1610612748,Miami Heat,0,0,18,30,48,11,12,23,29,42,71,22,3,25,11,33,18,5,9,82,91
2008,4,40800137,5/3/2009,1610612748,Miami Heat,0,0,1610612737,Atlanta Hawks,1,1,22,22,44,4,15,19,26,37,63,22,3,25,13,25,12,11,19,81,78
2008,4,40800135,4/29/2009,1610612737,Atlanta Hawks,1,1,1610612748,Miami Heat,0,0,29,22,51,5,14,19,34,36,70,33,8,41,14,26,23,2,6,81,106
2008,4,40800135,4/29/2009,1610612748,Miami Heat,0,0,1610612737,Atlanta Hawks,1,1,27,26,53,4,8,12,31,34,65,25,7,32,7,28,17,5,7,81,91
2008,4,40800136,5/1/2009,1610612737,Atlanta Hawks,0,0,1610612748,Miami Heat,1,1,20,32,52,7,14,21,27,46,73,11,7,18,16,35,8,5,16,82,72
2008,4,40800136,5/1/2009,1610612748,Miami Heat,1,1,1610612737,Atlanta Hawks,0,0,28,25,53,7,14,21,35,39,74,21,3,24,15,26,12,7,12,82,98
2015,4,41500135,4/26/2016,1610612737,Atlanta Hawks,1,1,1610612738,Boston Celtics,0,0,28,33,61,14,21,35,42,54,96,12,4,16,17,39,30,5,12,99,110
2015,4,41500135,4/26/2016,1610612738,Boston Celtics,0,0,1610612737,Atlanta Hawks,1,1,22,26,48,7,22,29,29,48,77,18,7,25,12,40,19,13,20,99,83
2008,4,40800134,4/27/2009,1610612737,Atlanta Hawks,0,1,1610612748,Miami Heat,1,0,23,29,52,5,9,14,28,38,66,20,6,26,15,27,15,7,15,79,81
2008,4,40800134,4/27/2009,1610612748,Miami Heat,1,0,1610612737,Atlanta Hawks,0,1,19,26,45,4,12,16,23,38,61,21,7,28,9,32,11,7,14,78,71
2008,4,40800133,4/25/2009,1610612737,Atlanta Hawks,0,0,1610612748,Miami Heat,1,1,24,40,64,5,10,15,29,50,79,15,4,19,15,38,13,8,10,85,78
2008,4,40800133,4/25/2009,1610612748,Miami Heat,1,1,1610612737,Atlanta Hawks,0,0,26,32,58,12,11,23,38,43,81,19,0,19,15,28,18,3,9,85,107
2008,4,40800132,4/22/2009,1610612737,Atlanta Hawks,1,0,1610612748,Miami Heat,0,1,28,29,57,6,14,20,34,43,77,19,11,30,14,34,18,6,11,86,93
2008,4,40800132,4/22/2009,1610612748,Miami Heat,0,1,1610612737,Atlanta Hawks,1,0,25,21,46,15,11,26,40,32,72,13,5,18,11,23,23,5,14,86,108
2015,4,41500134,4/24/2016,1610612737,Atlanta Hawks,0,0,1610612738,Boston Celtics,1,1,25,32,57,12,30,42,37,62,99,9,4,13,17,45,18,7,15,102,95
2015,4,41500134,4/24/2016,1610612738,Boston Celtics,1,1,1610612737,Atlanta Hawks,0,0,29,32,61,11,22,33,40,54,94,13,6,19,16,41,25,8,14,101,104
2008,4,40800126,4/30/2009,1610612753,Orlando Magic,0,1,1610612755,Philadelphia 76ers,1,0,32,24,56,12,14,26,44,38,82,14,6,20,14,25,31,4,14,91,114
2008,4,40800126,4/30/2009,1610612755,Philadelphia 76ers,1,0,1610612753,Orlando Magic,0,1,24,32,56,7,13,20,31,45,76,20,5,25,14,33,17,10,17,90,89
2008,4,40800131,4/19/2009,1610612737,Atlanta Hawks,1,1,1610612748,Miami Heat,0,0,32,32,64,4,10,14,36,42,78,14,6,20,16,30,23,10,18,90,90
2008,4,40800131,4/19/2009,1610612748,Miami Heat,0,0,1610612737,Atlanta Hawks,1,1,22,26,48,4,19,23,26,45,71,8,4,12,8,40,12,10,19,92,64
2008,4,40800125,4/28/2009,1610612753,Orlando Magic,1,1,1610612755,Philadelphia 76ers,0,0,25,28,53,8,15,23,33,43,76,17,7,24,17,30,14,7,14,86,91
2008,4,40800125,4/28/2009,1610612755,Philadelphia 76ers,0,0,1610612753,Orlando Magic,1,1,25,25,50,4,14,18,29,39,68,16,4,20,7,34,17,7,16,86,78
2015,4,41500133,4/22/2016,1610612737,Atlanta Hawks,0,0,1610612738,Boston Celtics,1,1,29,21,50,9,27,36,38,48,86,18,3,21,11,38,19,10,14,98,103
2015,4,41500133,4/22/2016,1610612738,Boston Celtics,1,1,1610612737,Atlanta Hawks,0,0,27,23,50,11,21,32,38,44,82,24,9,33,13,35,23,10,16,97,111
2008,4,40800124,4/26/2009,1610612753,Orlando Magic,0,1,1610612755,Philadelphia 76ers,1,0,27,23,50,6,14,20,33,37,70,12,8,20,5,38,13,8,11,86,84
2008,4,40800124,4/26/2009,1610612755,Philadelphia 76ers,1,0,1610612753,Orlando Magic,0,1,23,38,61,8,11,19,31,49,80,11,4,15,14,36,19,6,11,87,81
2008,4,40800123,4/24/2009,1610612753,Orlando Magic,0,0,1610612755,Philadelphia 76ers,1,1,23,30,53,8,12,20,31,42,73,24,5,29,12,33,18,6,14,90,94
2008,4,40800123,4/24/2009,1610612755,Philadelphia 76ers,1,1,1610612753,Orlando Magic,0,0,33,28,61,4,6,10,37,34,71,18,8,26,11,26,16,8,17,90,96
2008,4,40800122,4/22/2009,1610612753,Orlando Magic,1,1,1610612755,Philadelphia 76ers,0,0,28,28,56,6,17,23,34,45,79,22,8,30,17,32,14,8,14,92,96
2008,4,40800122,4/22/2009,1610612755,Philadelphia 76ers,0,0,1610612753,Orlando Magic,1,1,30,29,59,5,11,16,35,40,75,12,6,18,10,32,18,9,17,91,87
2008,4,40800121,4/19/2009,1610612753,Orlando Magic,1,0,1610612755,Philadelphia 76ers,0,1,32,26,58,5,13,18,37,39,76,19,6,25,10,31,18,4,10,88,98
2008,4,40800121,4/19/2009,1610612755,Philadelphia 76ers,0,1,1610612753,Orlando Magic,1,0,34,34,68,7,5,12,41,39,80,11,9,20,12,33,20,3,10,88,100
2012,4,41200307,6/3/2013,1610612748,Miami Heat,1,1,1610612754,Indiana Pacers,0,0,24,37,61,6,10,16,30,47,77,33,5,38,19,30,14,3,11,87,99
2012,4,41200307,6/3/2013,1610612754,Indiana Pacers,0,0,1610612748,Miami Heat,1,1,22,27,49,6,14,20,28,41,69,14,6,20,12,33,14,11,21,86,76
2015,4,41500132,4/19/2016,1610612737,Atlanta Hawks,1,1,1610612738,Boston Celtics,0,0,21,32,53,11,18,29,32,50,82,14,2,16,12,38,20,5,16,96,89
2008,4,40800117,5/2/2009,1610612738,Boston Celtics,1,1,1610612741,Chicago Bulls,0,0,26,35,61,9,8,17,35,43,78,30,9,39,12,35,25,10,12,97,109
2008,4,40800117,5/2/2009,1610612741,Chicago Bulls,0,0,1610612738,Boston Celtics,1,1,23,30,53,7,17,24,30,47,77,32,4,36,12,37,17,7,15,97,99
2008,4,40800116,4/30/2009,1610612738,Boston Celtics,0,0,1610612741,Chicago Bulls,1,1,35,41,76,11,20,31,46,61,107,24,6,30,22,42,29,4,13,112,127
2008,4,40800116,4/30/2009,1610612741,Chicago Bulls,1,1,1610612738,Boston Celtics,0,0,40,41,81,9,8,17,49,49,98,21,7,28,15,37,27,6,17,111,128
2008,4,40800115,4/28/2009,1610612738,Boston Celtics,1,1,1610612741,Chicago Bulls,0,0,36,34,70,6,10,16,42,44,86,16,8,24,9,40,24,7,10,98,106
2008,4,40800115,4/28/2009,1610612741,Chicago Bulls,0,0,1610612738,Boston Celtics,1,1,25,37,62,9,14,23,34,51,85,27,5,32,17,37,18,5,13,99,104
2015,4,41500132,4/19/2016,1610612738,Boston Celtics,0,0,1610612737,Atlanta Hawks,1,1,23,37,60,5,23,28,28,60,88,11,1,12,16,46,16,7,16,95,72
2008,4,40800114,4/26/2009,1610612738,Boston Celtics,0,0,1610612741,Chicago Bulls,1,1,30,42,72,10,13,23,40,55,95,28,4,32,17,41,19,9,21,114,118
2008,4,40800114,4/26/2009,1610612741,Chicago Bulls,1,1,1610612738,Boston Celtics,0,0,40,41,81,5,7,12,45,48,93,26,9,35,14,36,23,10,16,114,121
2012,4,41200311,5/19/2013,1610612759,San Antonio Spurs,1,1,1610612763,Memphis Grizzlies,0,0,26,21,47,14,15,29,40,36,76,11,3,14,9,28,28,5,11,85,105
2012,4,41200311,5/19/2013,1610612763,Memphis Grizzlies,0,0,1610612759,San Antonio Spurs,1,1,27,35,62,5,7,12,32,42,74,14,6,20,12,32,20,5,12,84,83
2008,4,40800113,4/23/2009,1610612738,Boston Celtics,0,1,1610612741,Chicago Bulls,1,0,26,32,58,12,9,21,38,41,79,19,5,24,11,30,23,5,14,94,107
2008,4,40800113,4/23/2009,1610612741,Chicago Bulls,1,0,1610612738,Boston Celtics,0,1,21,37,58,9,13,22,30,50,80,17,10,27,21,32,14,16,22,94,86
2008,4,40800112,4/20/2009,1610612738,Boston Celtics,1,1,1610612741,Chicago Bulls,0,0,40,40,80,7,9,16,47,49,96,17,8,25,25,28,26,7,12,93,118
2008,4,40800112,4/20/2009,1610612741,Chicago Bulls,0,0,1610612738,Boston Celtics,1,1,31,29,60,9,11,20,40,40,80,26,3,29,13,29,20,9,13,94,115
2015,4,41500131,4/16/2016,1610612737,Atlanta Hawks,1,1,1610612738,Boston Celtics,0,0,30,30,60,5,21,26,35,51,86,27,8,35,16,36,23,6,12,99,102
2008,4,40800111,4/18/2009,1610612738,Boston Celtics,1,0,1610612741,Chicago Bulls,0,1,35,48,83,4,12,16,39,60,99,21,6,27,17,48,16,5,13,108,103
2008,4,40800111,4/18/2009,1610612741,Chicago Bulls,0,1,1610612738,Boston Celtics,1,0,38,41,79,3,14,17,41,55,96,20,2,22,16,39,20,8,17,109,105
2008,4,40800103,4/24/2009,1610612739,Cleveland Cavaliers,0,1,1610612765,Detroit Pistons,1,0,24,22,46,4,18,22,28,40,68,19,11,30,12,35,20,4,15,83,79
2008,4,40800103,4/24/2009,1610612765,Detroit Pistons,1,0,1610612739,Cleveland Cavaliers,0,1,23,36,59,4,8,12,27,44,71,10,2,12,8,36,17,8,15,84,68
2015,4,41500131,4/16/2016,1610612738,Boston Celtics,0,0,1610612737,Atlanta Hawks,1,1,26,41,67,11,24,35,37,65,102,16,3,19,22,44,27,4,10,100,101
2008,4,40800104,4/26/2009,1610612739,Cleveland Cavaliers,0,1,1610612765,Detroit Pistons,1,0,29,32,61,6,7,13,35,39,74,23,1,24,14,26,19,4,10,81,99
2008,4,40800104,4/26/2009,1610612765,Detroit Pistons,1,0,1610612739,Cleveland Cavaliers,0,1,30,38,68,1,9,10,31,47,78,15,3,18,14,35,17,8,10,81,78
2012,4,41200306,6/1/2013,1610612748,Miami Heat,0,0,1610612754,Indiana Pacers,1,1,16,38,54,10,8,18,26,46,72,15,4,19,10,39,10,5,14,87,77
2008,4,40800101,4/18/2009,1610612739,Cleveland Cavaliers,1,1,1610612765,Detroit Pistons,0,0,32,23,55,5,10,15,37,33,70,23,4,27,10,24,24,2,5,79,102
2008,4,40800101,4/18/2009,1610612765,Detroit Pistons,0,0,1610612739,Cleveland Cavaliers,1,1,34,32,66,2,10,12,36,42,78,10,2,12,13,29,15,4,7,79,84
2012,4,41200306,6/1/2013,1610612754,Indiana Pacers,1,1,1610612748,Miami Heat,0,0,31,32,63,6,5,11,37,37,74,11,7,18,17,25,19,10,21,87,91
2008,4,40800102,4/21/2009,1610612739,Cleveland Cavaliers,1,1,1610612765,Detroit Pistons,0,0,22,26,48,6,12,18,28,38,66,32,11,43,16,26,21,7,14,85,94
2008,4,40800102,4/21/2009,1610612765,Detroit Pistons,0,0,1610612739,Cleveland Cavaliers,1,1,27,39,66,5,10,15,32,49,81,13,3,16,18,31,17,5,13,86,82
2007,4,40700406,6/17/2008,1610612738,Boston Celtics,1,1,1610612747,Los Angeles Lakers,0,0,30,31,61,13,13,26,43,44,87,32,5,37,16,29,33,4,8,96,131
2007,4,40700406,6/17/2008,1610612747,Los Angeles Lakers,0,0,1610612738,Boston Celtics,1,1,17,20,37,10,17,27,27,37,64,28,10,38,6,36,16,18,19,96,92
2012,4,41200305,5/30/2013,1610612748,Miami Heat,1,1,1610612754,Indiana Pacers,0,0,31,26,57,7,11,18,38,37,75,7,5,12,10,31,19,6,10,83,90
2012,4,41200305,5/30/2013,1610612754,Indiana Pacers,0,0,1610612748,Miami Heat,1,1,26,30,56,5,8,13,31,38,69,12,3,15,11,27,11,6,18,84,79
2015,4,41500127,5/1/2016,1610612748,Miami Heat,1,1,1610612766,Charlotte Hornets,0,0,34,31,65,9,15,24,43,46,89,11,5,16,13,35,24,4,9,94,106
2007,4,40700405,6/15/2008,1610612738,Boston Celtics,0,0,1610612747,Los Angeles Lakers,1,1,25,30,55,8,14,22,33,44,77,24,7,31,17,30,20,11,18,93,98
2007,4,40700405,6/15/2008,1610612747,Los Angeles Lakers,1,1,1610612738,Boston Celtics,0,0,28,24,52,8,19,27,36,43,79,23,8,31,17,30,19,6,17,94,103
2007,4,40700404,6/12/2008,1610612738,Boston Celtics,0,1,1610612747,Los Angeles Lakers,1,0,25,26,51,8,14,22,33,40,73,23,5,28,10,32,15,6,11,88,97
2007,4,40700404,6/12/2008,1610612747,Los Angeles Lakers,1,0,1610612738,Boston Celtics,0,1,26,30,56,6,15,21,32,45,77,21,8,29,15,34,23,7,12,89,91
2007,4,40700402,6/8/2008,1610612738,Boston Celtics,1,1,1610612747,Los Angeles Lakers,0,0,27,27,54,9,5,14,36,32,68,27,11,38,11,26,31,8,15,90,108
2007,4,40700402,6/8/2008,1610612747,Los Angeles Lakers,0,0,1610612738,Boston Celtics,1,1,31,31,62,10,11,21,41,42,83,10,0,10,13,29,20,7,14,91,102
2007,4,40700403,6/10/2008,1610612738,Boston Celtics,0,0,1610612747,Los Angeles Lakers,1,1,21,44,65,8,10,18,29,54,83,15,7,22,18,38,19,4,13,89,81
2007,4,40700403,6/10/2008,1610612747,Los Angeles Lakers,1,1,1610612738,Boston Celtics,0,0,24,31,55,6,8,14,30,39,69,21,13,34,12,33,17,8,13,87,87
2015,4,41500127,5/1/2016,1610612766,Charlotte Hornets,0,0,1610612748,Miami Heat,1,1,20,42,62,7,15,22,27,57,84,12,0,12,7,50,14,2,10,92,73
2007,4,40700401,6/5/2008,1610612738,Boston Celtics,1,1,1610612747,Los Angeles Lakers,0,0,26,31,57,6,13,19,32,44,76,28,7,35,16,30,20,8,14,93,98
2007,4,40700401,6/5/2008,1610612747,Los Angeles Lakers,0,0,1610612738,Boston Celtics,1,1,29,34,63,3,11,14,32,45,77,21,7,28,7,40,21,6,8,91,88
2007,4,40700314,5/27/2008,1610612747,Los Angeles Lakers,0,1,1610612759,San Antonio Spurs,1,0,35,36,71,3,11,14,38,47,85,14,5,19,18,33,17,7,14,89,93
2007,4,40700314,5/27/2008,1610612759,San Antonio Spurs,1,0,1610612747,Los Angeles Lakers,0,1,23,28,51,7,17,24,30,45,75,24,2,26,9,37,22,5,9,88,91
2007,4,40700315,5/29/2008,1610612747,Los Angeles Lakers,1,1,1610612759,San Antonio Spurs,0,0,30,34,64,8,13,21,38,47,85,16,2,18,13,36,16,5,9,90,100
2007,4,40700315,5/29/2008,1610612759,San Antonio Spurs,0,0,1610612747,Los Angeles Lakers,1,1,29,30,59,7,8,15,36,38,74,13,5,18,7,33,22,9,14,90,92
2012,4,41200304,5/28/2013,1610612748,Miami Heat,0,0,1610612754,Indiana Pacers,1,1,22,32,54,8,15,23,30,47,77,24,3,27,13,35,15,3,6,83,92
2012,4,41200304,5/28/2013,1610612754,Indiana Pacers,1,1,1610612748,Miami Heat,0,0,32,24,56,3,11,14,35,35,70,26,7,33,15,23,18,7,13,82,99
2007,4,40700312,5/23/2008,1610612747,Los Angeles Lakers,1,1,1610612759,San Antonio Spurs,0,0,34,19,53,5,13,18,39,32,71,18,2,20,3,30,20,7,14,91,101
2007,4,40700312,5/23/2008,1610612759,San Antonio Spurs,0,0,1610612747,Los Angeles Lakers,1,1,24,40,64,6,17,23,30,57,87,5,5,10,14,45,20,8,15,93,71
2015,4,41500126,4/29/2016,1610612748,Miami Heat,0,1,1610612766,Charlotte Hornets,1,0,30,37,67,8,8,16,38,45,83,13,2,15,15,31,14,8,13,89,97
2007,4,40700313,5/25/2008,1610612747,Los Angeles Lakers,0,0,1610612759,San Antonio Spurs,1,1,29,36,65,6,11,17,35,47,82,8,9,17,15,37,13,4,14,90,84
2007,4,40700313,5/25/2008,1610612759,San Antonio Spurs,1,1,1610612747,Los Angeles Lakers,0,0,28,28,56,10,8,18,38,36,74,17,6,23,5,34,22,5,12,90,103
2015,4,41500126,4/29/2016,1610612766,Charlotte Hornets,1,0,1610612748,Miami Heat,0,1,27,32,59,5,12,17,32,44,76,21,4,25,11,36,12,4,11,90,90
2007,4,40700311,5/21/2008,1610612747,Los Angeles Lakers,1,1,1610612759,San Antonio Spurs,0,0,31,40,71,4,6,10,35,46,81,15,3,18,9,38,18,7,10,92,89
2007,4,40700311,5/21/2008,1610612759,San Antonio Spurs,0,0,1610612747,Los Angeles Lakers,1,1,29,35,64,5,15,20,34,50,84,12,5,17,12,41,16,7,12,92,85
2007,4,40700306,5/30/2008,1610612738,Boston Celtics,0,1,1610612765,Detroit Pistons,1,0,27,27,54,5,13,18,32,40,72,20,7,27,16,27,14,3,12,84,89
2007,4,40700306,5/30/2008,1610612765,Detroit Pistons,1,0,1610612738,Boston Celtics,0,1,23,25,48,6,15,21,29,40,69,17,4,21,12,30,19,8,16,82,81
2007,4,40700305,5/28/2008,1610612738,Boston Celtics,1,1,1610612765,Detroit Pistons,0,0,29,29,58,8,7,15,37,36,73,24,6,30,14,23,25,8,17,91,106
2007,4,40700305,5/28/2008,1610612765,Detroit Pistons,0,0,1610612738,Boston Celtics,1,1,20,26,46,11,10,21,31,36,67,29,9,38,10,31,23,8,17,91,102
2015,4,41500125,4/27/2016,1610612748,Miami Heat,1,0,1610612766,Charlotte Hornets,0,1,29,34,63,5,13,18,34,47,81,15,4,19,8,41,17,8,14,96,88
2015,4,41500125,4/27/2016,1610612766,Charlotte Hornets,0,1,1610612748,Miami Heat,1,0,21,39,60,12,12,24,33,51,84,12,3,15,7,45,21,7,12,98,90
2007,4,40700304,5/26/2008,1610612738,Boston Celtics,0,0,1610612765,Detroit Pistons,1,1,20,37,57,1,8,9,21,45,66,32,7,39,18,30,12,7,14,82,75
2007,4,40700304,5/26/2008,1610612765,Detroit Pistons,1,1,1610612738,Boston Celtics,0,0,34,27,61,2,7,9,36,34,70,20,6,26,11,29,27,3,9,81,94
2007,4,40700303,5/24/2008,1610612738,Boston Celtics,0,1,1610612765,Detroit Pistons,1,0,27,28,55,5,9,14,32,37,69,25,5,30,17,21,20,11,16,83,94
2007,4,40700303,5/24/2008,1610612765,Detroit Pistons,1,0,1610612738,Boston Celtics,0,1,27,33,60,1,12,13,28,45,73,23,3,26,13,33,15,6,11,84,80
2007,4,40700302,5/22/2008,1610612738,Boston Celtics,1,0,1610612765,Detroit Pistons,0,1,30,23,53,5,14,19,35,37,72,22,3,25,15,24,19,9,13,84,97
2007,4,40700302,5/22/2008,1610612765,Detroit Pistons,0,1,1610612738,Boston Celtics,1,0,30,31,61,5,5,10,35,36,71,28,4,32,13,26,21,5,11,84,103
2015,4,41500124,4/25/2016,1610612748,Miami Heat,0,0,1610612766,Charlotte Hornets,1,1,19,28,47,11,18,29,30,46,76,14,7,21,15,34,20,7,17,90,85
2007,4,40700301,5/20/2008,1610612738,Boston Celtics,1,1,1610612765,Detroit Pistons,0,0,34,26,60,2,7,9,36,33,69,14,7,21,7,29,27,7,11,83,88
2007,4,40700301,5/20/2008,1610612765,Detroit Pistons,0,0,1610612738,Boston Celtics,1,1,24,31,55,4,7,11,28,38,66,19,8,27,9,34,15,10,13,83,79
2015,4,41500124,4/25/2016,1610612766,Charlotte Hornets,1,1,1610612748,Miami Heat,0,0,26,33,59,4,12,16,30,45,75,25,5,30,9,38,10,2,10,89,89
2012,4,41200303,5/26/2013,1610612748,Miami Heat,0,1,1610612754,Indiana Pacers,1,0,36,27,63,6,8,14,42,35,77,24,4,28,9,28,21,1,5,86,114
2007,4,40700237,5/19/2008,1610612740,New Orleans Pelicans,1,0,1610612759,San Antonio Spurs,0,1,29,36,65,4,13,17,33,49,82,12,5,17,13,39,18,5,9,86,82
2007,4,40700237,5/19/2008,1610612759,San Antonio Spurs,0,1,1610612740,New Orleans Pelicans,1,0,18,30,48,12,16,28,30,46,76,19,2,21,13,35,19,10,14,87,91
2012,4,41200303,5/26/2013,1610612754,Indiana Pacers,1,0,1610612748,Miami Heat,0,1,21,38,59,8,6,14,29,44,73,30,14,44,19,33,16,6,11,86,96
2007,4,40700236,5/15/2008,1610612740,New Orleans Pelicans,0,0,1610612759,San Antonio Spurs,1,1,31,40,71,2,7,9,33,47,80,12,1,13,8,40,13,4,9,87,80
2007,4,40700236,5/15/2008,1610612759,San Antonio Spurs,1,1,1610612740,New Orleans Pelicans,0,0,27,29,56,11,10,21,38,39,77,12,6,18,9,34,28,7,12,88,99
2007,4,40700235,5/13/2008,1610612740,New Orleans Pelicans,1,1,1610612759,San Antonio Spurs,0,0,26,35,61,8,7,15,34,42,76,25,8,33,14,32,24,1,6,83,101
2007,4,40700235,5/13/2008,1610612759,San Antonio Spurs,0,0,1610612740,New Orleans Pelicans,1,1,20,34,54,9,14,23,29,48,77,12,6,18,13,40,20,8,11,85,79
2015,4,41500123,4/23/2016,1610612748,Miami Heat,0,0,1610612766,Charlotte Hornets,1,1,20,37,57,7,15,22,27,52,79,19,11,30,17,40,13,5,15,92,80
2015,4,41500123,4/23/2016,1610612766,Charlotte Hornets,1,1,1610612748,Miami Heat,0,0,30,42,72,5,13,18,35,55,90,21,1,22,13,42,18,1,4,92,96
2007,4,40700234,5/11/2008,1610612740,New Orleans Pelicans,0,0,1610612759,San Antonio Spurs,1,1,28,39,67,5,10,15,33,49,82,9,3,12,14,37,12,8,13,88,80
2007,4,40700234,5/11/2008,1610612759,San Antonio Spurs,1,1,1610612740,New Orleans Pelicans,0,0,31,19,50,8,18,26,39,37,76,14,6,20,13,26,27,11,15,88,100
2007,4,40700232,5/5/2008,1610612740,New Orleans Pelicans,1,1,1610612759,San Antonio Spurs,0,0,26,32,58,10,7,17,36,39,75,20,4,24,9,33,22,3,9,88,102
2007,4,40700232,5/5/2008,1610612759,San Antonio Spurs,0,0,1610612740,New Orleans Pelicans,1,1,23,23,46,8,19,27,31,42,73,14,5,19,9,35,24,6,15,88,84
2007,4,40700233,5/8/2008,1610612740,New Orleans Pelicans,0,0,1610612759,San Antonio Spurs,1,1,39,33,72,2,9,11,41,42,83,15,6,21,14,32,15,3,10,89,99
2007,4,40700233,5/8/2008,1610612759,San Antonio Spurs,1,1,1610612740,New Orleans Pelicans,0,0,30,30,60,11,14,25,41,44,85,17,4,21,15,32,28,4,10,90,110
2015,4,41500122,4/20/2016,1610612748,Miami Heat,1,1,1610612766,Charlotte Hornets,0,0,35,25,60,9,7,16,44,32,76,18,4,22,5,28,19,3,11,92,115
2015,4,41500122,4/20/2016,1610612766,Charlotte Hornets,0,0,1610612748,Miami Heat,1,1,37,36,73,1,15,16,38,51,89,26,7,33,21,34,9,6,8,92,103
2007,4,40700231,5/3/2008,1610612740,New Orleans Pelicans,1,1,1610612759,San Antonio Spurs,0,0,39,37,76,4,6,10,43,43,86,11,4,15,18,28,23,6,8,83,101
2007,4,40700231,5/3/2008,1610612759,San Antonio Spurs,0,0,1610612740,New Orleans Pelicans,1,1,17,23,40,12,19,31,29,42,71,12,9,21,10,36,19,11,13,82,82
2007,4,40700225,5/14/2008,1610612747,Los Angeles Lakers,1,1,1610612762,Utah Jazz,0,0,28,26,54,7,13,20,35,39,74,34,8,42,14,28,24,9,14,94,111
2007,4,40700225,5/14/2008,1610612762,Utah Jazz,0,0,1610612747,Los Angeles Lakers,1,1,31,33,64,6,11,17,37,44,81,24,4,28,21,25,23,9,19,95,104
2012,4,41200302,5/24/2013,1610612748,Miami Heat,1,0,1610612754,Indiana Pacers,0,1,27,24,51,7,15,22,34,39,73,18,8,26,10,30,14,6,15,87,93
2007,4,40700226,5/16/2008,1610612747,Los Angeles Lakers,0,1,1610612762,Utah Jazz,1,0,28,31,59,7,4,11,35,35,70,31,7,38,6,34,19,8,14,95,108
2007,4,40700226,5/16/2008,1610612762,Utah Jazz,1,0,1610612747,Los Angeles Lakers,0,1,28,45,73,9,15,24,37,60,97,22,3,25,26,35,22,6,11,97,105
2012,4,41200302,5/24/2013,1610612754,Indiana Pacers,0,1,1610612748,Miami Heat,1,0,28,26,54,5,7,12,33,33,66,26,6,32,13,22,18,4,17,86,97
2007,4,40700223,5/9/2008,1610612747,Los Angeles Lakers,0,0,1610612762,Utah Jazz,1,1,27,16,43,5,18,23,32,34,66,30,8,38,13,24,14,7,18,88,99
2007,4,40700223,5/9/2008,1610612762,Utah Jazz,1,1,1610612747,Los Angeles Lakers,0,0,33,29,62,6,10,16,39,39,78,20,7,27,17,26,21,8,12,88,104
2007,4,40700224,5/11/2008,1610612747,Los Angeles Lakers,0,0,1610612762,Utah Jazz,1,1,37,34,71,9,17,26,46,51,97,14,11,25,18,38,20,7,12,100,115
2007,4,40700224,5/11/2008,1610612762,Utah Jazz,1,1,1610612747,Los Angeles Lakers,0,0,34,25,59,6,11,17,40,36,76,37,8,45,11,29,32,8,14,101,123
2015,4,41500121,4/17/2016,1610612748,Miami Heat,1,1,1610612766,Charlotte Hornets,0,0,40,27,67,9,9,18,49,36,85,16,5,21,16,23,27,5,6,85,123
2015,4,41500121,4/17/2016,1610612766,Charlotte Hornets,0,0,1610612748,Miami Heat,1,1,22,26,48,6,11,17,28,37,65,29,8,37,10,31,11,7,11,84,91
2007,4,40700222,5/7/2008,1610612747,Los Angeles Lakers,1,1,1610612762,Utah Jazz,0,0,32,25,57,7,4,11,39,29,68,35,8,43,8,26,23,9,16,98,120
2007,4,40700222,5/7/2008,1610612762,Utah Jazz,0,0,1610612747,Los Angeles Lakers,1,1,38,45,83,7,11,18,45,56,101,13,3,16,22,36,27,6,12,98,110
2007,4,40700215,5/13/2008,1610612753,Orlando Magic,0,0,1610612765,Detroit Pistons,1,1,23,19,42,8,14,22,31,33,64,16,12,28,12,26,14,12,21,86,86
2007,4,40700215,5/13/2008,1610612765,Detroit Pistons,1,1,1610612753,Orlando Magic,0,0,27,42,69,3,11,14,30,53,83,28,4,32,17,39,16,1,3,87,91
2007,4,40700221,5/4/2008,1610612747,Los Angeles Lakers,1,1,1610612762,Utah Jazz,0,0,28,35,63,5,5,10,33,40,73,38,8,46,12,34,24,5,13,98,109
2007,4,40700221,5/4/2008,1610612762,Utah Jazz,0,0,1610612747,Los Angeles Lakers,1,1,32,44,76,4,15,19,36,59,95,22,8,30,26,37,21,11,13,97,98
2007,4,40700214,5/10/2008,1610612753,Orlando Magic,1,0,1610612765,Detroit Pistons,0,1,24,31,55,10,8,18,34,39,73,11,6,17,12,29,13,9,12,80,89
2007,4,40700214,5/10/2008,1610612765,Detroit Pistons,0,1,1610612753,Orlando Magic,1,0,32,34,66,4,9,13,36,43,79,14,1,15,16,27,18,6,10,80,90
2015,4,41500117,5/1/2016,1610612754,Indiana Pacers,0,0,1610612761,Toronto Raptors,1,1,25,29,54,9,10,19,34,39,73,7,1,8,8,31,12,7,15,85,84
2015,4,41500117,5/1/2016,1610612761,Toronto Raptors,1,1,1610612754,Indiana Pacers,0,0,26,39,65,8,16,24,34,55,89,13,4,17,22,34,21,5,9,85,89
2007,4,40700213,5/7/2008,1610612753,Orlando Magic,1,1,1610612765,Detroit Pistons,0,0,31,23,54,11,13,24,42,36,78,16,7,23,11,28,18,7,11,91,111
2007,4,40700213,5/7/2008,1610612765,Detroit Pistons,0,0,1610612753,Orlando Magic,1,1,29,38,67,2,8,10,31,46,77,22,6,28,11,37,12,6,11,90,86
2007,4,40700212,5/5/2008,1610612753,Orlando Magic,0,0,1610612765,Detroit Pistons,1,1,21,26,47,11,15,26,32,41,73,18,5,23,17,27,16,9,19,88,93
2007,4,40700212,5/5/2008,1610612765,Detroit Pistons,1,1,1610612753,Orlando Magic,0,0,32,32,64,4,8,12,36,40,76,24,4,28,11,30,23,3,10,88,100
2007,4,40700211,5/3/2008,1610612753,Orlando Magic,0,0,1610612765,Detroit Pistons,1,1,28,31,59,2,13,15,30,44,74,10,10,20,11,38,15,5,13,85,72
2007,4,40700211,5/3/2008,1610612765,Detroit Pistons,1,1,1610612753,Orlando Magic,0,0,33,43,76,3,5,8,36,48,84,16,2,18,14,35,21,5,6,86,91
2007,4,40700207,5/18/2008,1610612738,Boston Celtics,1,1,1610612739,Cleveland Cavaliers,0,0,27,28,55,5,7,12,32,35,67,28,6,34,14,23,20,3,11,83,97
2007,4,40700207,5/18/2008,1610612739,Cleveland Cavaliers,0,0,1610612738,Boston Celtics,1,1,23,22,45,7,15,22,30,37,67,25,10,35,13,30,13,7,14,83,92
2007,4,40700206,5/16/2008,1610612738,Boston Celtics,0,0,1610612739,Cleveland Cavaliers,1,1,23,29,52,4,12,16,27,41,68,11,2,13,9,32,19,5,17,82,69
2007,4,40700206,5/16/2008,1610612739,Cleveland Cavaliers,1,1,1610612738,Boston Celtics,0,0,19,38,57,5,11,16,24,49,73,21,4,25,19,32,10,8,16,83,74
2007,4,40700204,5/12/2008,1610612738,Boston Celtics,0,0,1610612739,Cleveland Cavaliers,1,1,24,32,56,3,11,14,27,43,70,20,6,26,9,36,16,5,8,83,77
2007,4,40700204,5/12/2008,1610612739,Cleveland Cavaliers,1,1,1610612738,Boston Celtics,0,0,29,31,60,6,11,17,35,42,77,12,6,18,10,34,24,3,7,82,88
2007,4,40700205,5/14/2008,1610612738,Boston Celtics,1,1,1610612739,Cleveland Cavaliers,0,0,32,30,62,5,10,15,37,40,77,17,6,23,15,27,25,8,14,88,96
2007,4,40700205,5/14/2008,1610612739,Cleveland Cavaliers,0,0,1610612738,Boston Celtics,1,1,26,23,49,3,13,16,29,36,65,28,13,41,13,28,11,7,16,88,89
2007,4,40700202,5/8/2008,1610612738,Boston Celtics,1,1,1610612739,Cleveland Cavaliers,0,0,26,32,58,3,11,14,29,43,72,28,10,38,14,33,20,4,12,87,89
2007,4,40700202,5/8/2008,1610612739,Cleveland Cavaliers,0,0,1610612738,Boston Celtics,1,1,24,36,60,2,11,13,26,47,73,19,8,27,15,36,18,11,15,87,73
2015,4,41500116,4/29/2016,1610612754,Indiana Pacers,1,1,1610612761,Toronto Raptors,0,0,27,27,54,8,14,22,35,41,76,23,3,26,15,27,21,9,14,90,101
2015,4,41500116,4/29/2016,1610612761,Toronto Raptors,0,0,1610612754,Indiana Pacers,1,1,20,30,50,9,20,29,29,50,79,16,9,25,20,33,14,12,17,89,83
2007,4,40700203,5/10/2008,1610612738,Boston Celtics,0,0,1610612739,Cleveland Cavaliers,1,1,25,33,58,5,11,16,30,44,74,19,5,24,16,29,18,6,12,83,84
2007,4,40700203,5/10/2008,1610612739,Cleveland Cavaliers,1,1,1610612738,Boston Celtics,0,0,27,23,50,10,9,19,37,32,69,24,9,33,14,21,29,5,12,83,108
2007,4,40700201,5/6/2008,1610612738,Boston Celtics,1,1,1610612739,Cleveland Cavaliers,0,0,25,29,54,4,10,14,29,39,68,14,4,18,10,31,18,12,23,91,76
2007,4,40700201,5/6/2008,1610612739,Cleveland Cavaliers,0,0,1610612738,Boston Celtics,1,1,19,38,57,4,14,18,23,52,75,22,4,26,14,38,19,5,18,90,72
2007,4,40700176,5/2/2008,1610612745,Houston Rockets,0,0,1610612762,Utah Jazz,1,1,24,30,54,6,17,23,30,47,77,25,11,36,15,35,10,5,9,87,91
2007,4,40700176,5/2/2008,1610612762,Utah Jazz,1,1,1610612745,Houston Rockets,0,0,31,35,66,10,12,22,41,47,88,21,4,25,19,30,19,4,5,86,113
2007,4,40700175,4/29/2008,1610612745,Houston Rockets,1,1,1610612762,Utah Jazz,0,0,31,30,61,6,12,18,37,42,79,15,4,19,15,28,19,8,13,87,95
2007,4,40700175,4/29/2008,1610612762,Utah Jazz,0,0,1610612745,Houston Rockets,1,1,25,40,65,2,7,9,27,47,74,13,10,23,15,37,15,10,18,87,69
2015,4,41500115,4/26/2016,1610612754,Indiana Pacers,0,0,1610612761,Toronto Raptors,1,1,20,24,44,13,16,29,33,40,73,20,3,23,10,32,22,9,16,90,99
2015,4,41500115,4/26/2016,1610612761,Toronto Raptors,1,1,1610612754,Indiana Pacers,0,0,27,29,56,6,20,26,33,49,82,30,5,35,17,34,12,5,8,91,102
2007,4,40700174,4/26/2008,1610612745,Houston Rockets,0,0,1610612762,Utah Jazz,1,1,22,35,57,7,15,22,29,50,79,17,8,25,12,40,14,7,10,89,82
2007,4,40700174,4/26/2008,1610612762,Utah Jazz,1,1,1610612745,Houston Rockets,0,0,31,27,58,0,14,14,31,41,72,24,7,31,11,32,16,7,12,90,86
2007,4,40700173,4/24/2008,1610612745,Houston Rockets,0,1,1610612762,Utah Jazz,1,0,30,35,65,6,10,16,36,45,81,16,6,22,20,27,20,3,9,83,94
2007,4,40700173,4/24/2008,1610612762,Utah Jazz,1,0,1610612745,Houston Rockets,0,1,24,29,53,8,9,17,32,38,70,20,13,33,16,28,20,7,12,81,92
2007,4,40700172,4/21/2008,1610612745,Houston Rockets,1,0,1610612762,Utah Jazz,0,1,28,30,58,4,15,19,32,45,77,16,10,26,15,37,15,6,10,86,84
2007,4,40700172,4/21/2008,1610612762,Utah Jazz,0,1,1610612745,Houston Rockets,1,0,27,33,60,7,10,17,34,43,77,15,6,21,13,33,19,5,13,86,90
2007,4,40700171,4/19/2008,1610612745,Houston Rockets,1,0,1610612762,Utah Jazz,0,1,23,34,57,6,16,22,29,50,79,18,11,29,26,31,15,4,14,83,82
2007,4,40700171,4/19/2008,1610612762,Utah Jazz,0,1,1610612745,Houston Rockets,1,0,33,30,63,5,5,10,38,35,73,12,7,19,15,23,22,8,14,82,93
2015,4,41500114,4/23/2016,1610612754,Indiana Pacers,1,1,1610612761,Toronto Raptors,0,0,34,35,69,6,10,16,40,45,85,14,4,18,15,31,24,8,13,91,100
2015,4,41500114,4/23/2016,1610612761,Toronto Raptors,0,0,1610612754,Indiana Pacers,1,1,19,25,44,8,22,30,27,47,74,21,9,30,18,31,12,10,19,91,83
2007,4,40700165,4/29/2008,1610612756,Phoenix Suns,0,0,1610612759,San Antonio Spurs,1,1,26,29,55,5,14,19,31,43,74,20,17,37,12,40,14,6,14,93,87
2007,4,40700165,4/29/2008,1610612759,San Antonio Spurs,1,1,1610612756,Phoenix Suns,0,0,31,47,78,2,4,6,33,51,84,24,6,30,15,37,14,6,10,92,92
2007,4,40700164,4/27/2008,1610612756,Phoenix Suns,1,1,1610612759,San Antonio Spurs,0,0,29,40,69,9,11,20,38,51,89,20,7,27,17,37,20,1,8,94,105
2007,4,40700164,4/27/2008,1610612759,San Antonio Spurs,0,0,1610612756,Phoenix Suns,1,1,28,43,71,4,7,11,32,50,82,18,6,24,14,39,12,6,15,93,86
2007,4,40700163,4/25/2008,1610612756,Phoenix Suns,1,0,1610612759,San Antonio Spurs,0,1,38,37,75,2,4,6,40,41,81,17,12,29,12,34,20,6,9,92,99
2007,4,40700163,4/25/2008,1610612759,San Antonio Spurs,0,1,1610612756,Phoenix Suns,1,0,40,27,67,6,9,15,46,36,82,17,2,19,8,29,21,3,11,93,115
2007,4,40700162,4/22/2008,1610612756,Phoenix Suns,0,0,1610612759,San Antonio Spurs,1,1,33,34,67,4,9,13,37,43,80,18,11,29,10,37,16,8,13,98,96
2007,4,40700162,4/22/2008,1610612759,San Antonio Spurs,1,1,1610612756,Phoenix Suns,0,0,36,36,72,4,7,11,40,43,83,18,7,25,10,36,17,5,12,97,102
2007,4,40700155,4/29/2008,1610612740,New Orleans Pelicans,1,1,1610612742,Dallas Mavericks,0,0,30,34,64,8,6,14,38,40,78,15,5,20,14,27,23,2,8,81,99
2007,4,40700155,4/29/2008,1610612742,Dallas Mavericks,0,0,1610612740,New Orleans Pelicans,1,1,26,30,56,9,17,26,35,47,82,15,4,19,18,31,25,6,8,82,94
2015,4,41500113,4/21/2016,1610612754,Indiana Pacers,1,0,1610612761,Toronto Raptors,0,1,20,26,46,6,16,22,26,42,68,27,6,33,12,31,16,6,17,89,85
2015,4,41500113,4/21/2016,1610612761,Toronto Raptors,0,1,1610612754,Indiana Pacers,1,0,29,34,63,10,21,31,39,55,94,13,3,16,23,34,18,3,11,90,101
2007,4,40700161,4/19/2008,1610612756,Phoenix Suns,0,0,1610612759,San Antonio Spurs,1,1,39,34,73,5,11,16,44,45,89,22,8,30,13,35,24,9,18,108,115
2007,4,40700161,4/19/2008,1610612759,San Antonio Spurs,1,1,1610612756,Phoenix Suns,0,0,42,35,77,6,11,17,48,46,94,15,8,23,17,32,15,6,17,106,117
2007,4,40700154,4/27/2008,1610612740,New Orleans Pelicans,0,1,1610612742,Dallas Mavericks,1,0,34,32,66,4,6,10,38,38,76,17,4,21,7,32,12,2,9,88,97
2007,4,40700154,4/27/2008,1610612742,Dallas Mavericks,1,0,1610612740,New Orleans Pelicans,0,1,24,40,64,8,17,25,32,57,89,12,4,16,21,38,12,5,11,87,84
2007,4,40700153,4/25/2008,1610612740,New Orleans Pelicans,0,0,1610612742,Dallas Mavericks,1,1,25,46,71,8,8,16,33,54,87,13,0,13,15,39,18,6,10,87,87
2007,4,40700153,4/25/2008,1610612742,Dallas Mavericks,1,1,1610612740,New Orleans Pelicans,0,0,27,31,58,5,12,17,32,43,75,28,10,38,15,33,20,2,8,87,97
2007,4,40700152,4/22/2008,1610612740,New Orleans Pelicans,1,1,1610612742,Dallas Mavericks,0,0,38,23,61,10,8,18,48,31,79,21,7,28,7,29,30,6,7,92,127
2007,4,40700152,4/22/2008,1610612742,Dallas Mavericks,0,0,1610612740,New Orleans Pelicans,1,1,26,30,56,7,7,14,33,37,70,30,9,39,12,28,21,9,16,92,103
2015,4,41500112,4/18/2016,1610612754,Indiana Pacers,0,0,1610612761,Toronto Raptors,1,1,25,25,50,4,16,20,29,41,70,25,5,30,9,36,13,8,13,90,87
2015,4,41500112,4/18/2016,1610612761,Toronto Raptors,1,1,1610612754,Indiana Pacers,0,0,30,32,62,5,13,18,35,45,80,23,2,25,16,30,19,7,13,90,98
2007,4,40700151,4/19/2008,1610612740,New Orleans Pelicans,1,1,1610612742,Dallas Mavericks,0,0,37,35,72,4,12,16,41,47,88,18,8,26,17,33,21,4,8,91,104
2007,4,40700151,4/19/2008,1610612742,Dallas Mavericks,0,0,1610612740,New Orleans Pelicans,1,1,19,37,56,7,15,22,26,52,78,33,5,38,21,33,19,8,15,92,92
2007,4,40700144,4/28/2008,1610612743,Denver Nuggets,1,0,1610612747,Los Angeles Lakers,0,1,35,32,67,4,17,21,39,49,88,19,5,24,18,34,20,7,16,95,101
2007,4,40700144,4/28/2008,1610612747,Los Angeles Lakers,0,1,1610612743,Denver Nuggets,1,0,32,33,65,8,14,22,40,47,87,19,11,30,17,35,20,8,12,96,107
2007,4,40700143,4/26/2008,1610612743,Denver Nuggets,1,0,1610612747,Los Angeles Lakers,0,1,27,39,66,5,15,20,32,54,86,15,4,19,16,40,22,9,16,97,84
2007,4,40700143,4/26/2008,1610612747,Los Angeles Lakers,0,1,1610612743,Denver Nuggets,1,0,29,28,57,8,15,23,37,43,80,20,13,33,8,40,26,3,11,96,102
2007,4,40700142,4/23/2008,1610612743,Denver Nuggets,0,0,1610612747,Los Angeles Lakers,1,1,33,32,65,4,15,19,37,47,84,29,7,36,17,33,12,5,14,100,107
2007,4,40700142,4/23/2008,1610612747,Los Angeles Lakers,1,1,1610612743,Denver Nuggets,0,0,34,29,63,12,16,28,46,45,91,18,6,24,14,35,33,7,12,100,122
2007,4,40700141,4/20/2008,1610612743,Denver Nuggets,0,0,1610612747,Los Angeles Lakers,1,1,38,46,84,5,7,12,43,53,96,23,14,37,22,35,20,7,12,102,114
2007,4,40700141,4/20/2008,1610612747,Los Angeles Lakers,1,1,1610612743,Denver Nuggets,0,0,37,35,72,9,11,20,46,46,92,27,5,32,17,31,33,7,13,103,128
2015,4,41500111,4/16/2016,1610612754,Indiana Pacers,0,1,1610612761,Toronto Raptors,1,0,23,35,58,11,10,21,34,45,79,21,8,29,13,36,19,6,13,95,100
2015,4,41500111,4/16/2016,1610612761,Toronto Raptors,1,0,1610612754,Indiana Pacers,0,1,26,34,60,4,15,19,30,49,79,26,12,38,24,32,17,11,20,95,90
2007,4,40700136,5/2/2008,1610612739,Cleveland Cavaliers,0,1,1610612764,Washington Wizards,1,0,29,28,57,11,13,24,40,41,81,14,3,17,14,28,29,4,7,83,105
2007,4,40700136,5/2/2008,1610612764,Washington Wizards,1,0,1610612739,Cleveland Cavaliers,0,1,26,31,57,5,16,21,31,47,78,21,5,26,17,34,11,4,9,81,88
2007,4,40700134,4/27/2008,1610612739,Cleveland Cavaliers,0,1,1610612764,Washington Wizards,1,0,19,31,50,13,15,28,32,46,78,23,10,33,22,28,23,10,19,89,100
2007,4,40700134,4/27/2008,1610612764,Washington Wizards,1,0,1610612739,Cleveland Cavaliers,0,1,25,26,51,7,12,19,32,38,70,26,7,33,10,33,18,10,13,89,97
2007,4,40700135,4/30/2008,1610612739,Cleveland Cavaliers,1,0,1610612764,Washington Wizards,0,1,18,32,50,9,16,25,27,48,75,24,8,32,19,33,18,6,14,87,87
2007,4,40700135,4/30/2008,1610612764,Washington Wizards,0,1,1610612739,Cleveland Cavaliers,1,0,24,33,57,7,12,19,31,45,76,19,6,25,16,30,13,5,14,87,88
2007,4,40700133,4/24/2008,1610612739,Cleveland Cavaliers,0,0,1610612764,Washington Wizards,1,1,27,30,57,2,14,16,29,44,73,12,11,23,17,34,17,13,23,90,72
2007,4,40700133,4/24/2008,1610612764,Washington Wizards,1,1,1610612739,Cleveland Cavaliers,0,0,30,24,54,8,11,19,38,35,73,24,9,33,11,29,20,4,11,91,108
2015,4,41500104,4/24/2016,1610612739,Cleveland Cavaliers,0,1,1610612765,Detroit Pistons,1,0,23,27,50,13,23,36,36,50,86,15,2,17,15,37,16,3,6,85,100
2015,4,41500104,4/24/2016,1610612765,Detroit Pistons,1,0,1610612739,Cleveland Cavaliers,0,1,27,25,52,10,14,24,37,39,76,14,7,21,10,32,22,6,9,85,98
2007,4,40700132,4/21/2008,1610612739,Cleveland Cavaliers,1,1,1610612764,Washington Wizards,0,0,32,30,62,10,9,19,42,39,81,22,11,33,15,27,27,6,11,90,116
2007,4,40700132,4/21/2008,1610612764,Washington Wizards,0,0,1610612739,Cleveland Cavaliers,1,1,24,32,56,3,13,16,27,45,72,29,11,40,15,36,16,6,14,91,86
2007,4,40700131,4/19/2008,1610612739,Cleveland Cavaliers,1,1,1610612764,Washington Wizards,0,0,25,32,57,5,14,19,30,46,76,28,9,37,12,39,24,4,8,93,93
2007,4,40700131,4/19/2008,1610612764,Washington Wizards,0,0,1610612739,Cleveland Cavaliers,1,1,27,31,58,6,18,24,33,49,82,14,3,17,11,38,16,6,13,92,86
2007,4,40700125,4/28/2008,1610612753,Orlando Magic,1,1,1610612761,Toronto Raptors,0,0,26,20,46,9,23,32,35,43,78,23,5,28,18,29,21,9,13,88,102
2007,4,40700125,4/28/2008,1610612761,Toronto Raptors,0,0,1610612753,Orlando Magic,1,1,27,36,63,8,14,22,35,50,85,14,3,17,12,41,20,3,6,88,92
2007,4,40700124,4/26/2008,1610612753,Orlando Magic,0,1,1610612761,Toronto Raptors,1,0,26,20,46,11,18,29,37,38,75,21,10,31,15,31,22,9,18,93,106
2007,4,40700124,4/26/2008,1610612761,Toronto Raptors,1,0,1610612753,Orlando Magic,0,1,38,39,77,2,13,15,40,52,92,12,5,17,15,39,24,6,9,94,94
2015,4,41500103,4/22/2016,1610612739,Cleveland Cavaliers,0,1,1610612765,Detroit Pistons,1,0,27,24,51,12,17,29,39,41,80,11,4,15,14,29,24,7,10,85,101
2015,4,41500103,4/22/2016,1610612765,Detroit Pistons,1,0,1610612739,Cleveland Cavaliers,0,1,30,21,51,6,17,23,36,38,74,13,6,19,8,35,22,3,8,83,91
2012,4,41200236,5/16/2013,1610612744,Golden State Warriors,1,0,1610612759,San Antonio Spurs,0,1,29,40,69,4,12,16,33,52,85,12,7,19,15,43,18,6,12,91,82
2012,4,41200236,5/16/2013,1610612759,San Antonio Spurs,0,1,1610612744,Golden State Warriors,1,0,26,28,54,7,12,19,33,40,73,21,4,25,9,32,27,7,14,91,94
2007,4,40700123,4/24/2008,1610612753,Orlando Magic,0,0,1610612761,Toronto Raptors,1,1,28,18,46,6,21,27,34,39,73,20,7,27,12,31,15,7,14,88,94
2007,4,40700123,4/24/2008,1610612761,Toronto Raptors,1,1,1610612753,Orlando Magic,0,0,30,21,51,12,22,34,42,43,85,12,2,14,17,26,31,5,12,89,108
2007,4,40700122,4/22/2008,1610612753,Orlando Magic,1,1,1610612761,Toronto Raptors,0,0,29,29,58,9,22,31,38,51,89,19,4,23,20,34,19,4,13,94,104
2007,4,40700122,4/22/2008,1610612761,Toronto Raptors,0,0,1610612753,Orlando Magic,1,1,26,26,52,11,18,29,37,44,81,18,2,20,10,34,21,10,15,94,103
2015,4,41500102,4/20/2016,1610612739,Cleveland Cavaliers,1,1,1610612765,Detroit Pistons,0,0,20,22,42,20,18,38,40,40,80,7,7,14,10,32,23,7,13,93,107
2015,4,41500102,4/20/2016,1610612765,Detroit Pistons,0,0,1610612739,Cleveland Cavaliers,1,1,30,31,61,4,13,17,34,44,78,18,14,32,17,34,19,7,13,92,90
2007,4,40700121,4/20/2008,1610612753,Orlando Magic,1,1,1610612761,Toronto Raptors,0,0,28,20,48,13,16,29,41,36,77,19,4,23,11,27,21,7,11,88,114
2007,4,40700121,4/20/2008,1610612761,Toronto Raptors,0,0,1610612753,Orlando Magic,1,1,23,42,65,9,11,20,32,53,85,27,1,28,18,35,24,3,8,89,100
2007,4,40700115,4/29/2008,1610612755,Philadelphia 76ers,0,0,1610612765,Detroit Pistons,1,1,28,36,64,2,5,7,30,41,71,19,5,24,15,28,13,8,18,86,81
2007,4,40700115,4/29/2008,1610612765,Detroit Pistons,1,1,1610612755,Philadelphia 76ers,0,0,37,24,61,6,7,13,43,31,74,6,6,12,11,25,27,12,17,86,98
2007,4,40700116,5/1/2008,1610612755,Philadelphia 76ers,1,0,1610612765,Detroit Pistons,0,1,22,39,61,3,10,13,25,49,74,24,12,36,20,34,12,4,11,85,77
2007,4,40700116,5/1/2008,1610612765,Detroit Pistons,0,1,1610612755,Philadelphia 76ers,1,0,30,21,51,9,7,16,39,28,67,13,3,16,8,21,28,11,18,85,100
2007,4,40700114,4/27/2008,1610612755,Philadelphia 76ers,1,0,1610612765,Detroit Pistons,0,1,28,30,58,3,6,9,31,36,67,19,8,27,13,26,21,10,19,89,84
2007,4,40700114,4/27/2008,1610612765,Detroit Pistons,0,1,1610612755,Philadelphia 76ers,1,0,28,36,64,6,10,16,34,46,80,19,3,22,18,30,24,4,15,88,93
2012,4,41200301,5/22/2013,1610612748,Miami Heat,1,1,1610612754,Indiana Pacers,0,0,36,32,68,5,13,18,41,45,86,16,9,25,21,27,24,10,21,99,103
2012,4,41200301,5/22/2013,1610612754,Indiana Pacers,0,0,1610612748,Miami Heat,1,1,33,36,69,4,10,14,37,46,83,24,8,32,21,28,18,9,20,98,102
2007,4,40700113,4/25/2008,1610612755,Philadelphia 76ers,1,1,1610612765,Detroit Pistons,0,0,33,34,67,1,6,7,34,40,74,26,5,31,14,28,21,6,17,94,95
2007,4,40700113,4/25/2008,1610612765,Detroit Pistons,0,0,1610612755,Philadelphia 76ers,1,1,24,27,51,3,12,15,27,39,66,18,8,26,11,33,18,15,25,93,75
2015,4,41500101,4/17/2016,1610612739,Cleveland Cavaliers,1,1,1610612765,Detroit Pistons,0,0,27,26,53,12,23,35,39,49,88,16,5,21,17,33,25,4,5,85,106
2015,4,41500101,4/17/2016,1610612765,Detroit Pistons,0,0,1610612739,Cleveland Cavaliers,1,1,22,22,44,15,14,29,37,36,73,12,4,16,7,30,24,7,12,86,101
2007,4,40700112,4/23/2008,1610612755,Philadelphia 76ers,0,0,1610612765,Detroit Pistons,1,1,31,44,75,1,5,6,32,49,81,23,12,35,25,31,12,3,10,84,88
2007,4,40700112,4/23/2008,1610612765,Detroit Pistons,1,1,1610612755,Philadelphia 76ers,0,0,41,29,70,4,8,12,45,37,82,11,4,15,20,19,26,5,15,84,105
2007,4,40700111,4/20/2008,1610612755,Philadelphia 76ers,0,1,1610612765,Detroit Pistons,1,0,34,42,76,1,4,5,35,46,81,19,8,27,24,26,16,7,14,85,90
2007,4,40700111,4/20/2008,1610612765,Detroit Pistons,1,0,1610612755,Philadelphia 76ers,0,1,28,42,70,4,8,12,32,50,82,18,5,23,21,32,16,6,13,85,86
2012,4,41200235,5/14/2013,1610612744,Golden State Warriors,0,0,1610612759,San Antonio Spurs,1,1,29,30,59,6,10,16,35,40,75,15,8,23,11,33,18,12,14,91,91
2012,4,41200235,5/14/2013,1610612759,San Antonio Spurs,1,1,1610612744,Golden State Warriors,0,0,30,26,56,10,11,21,40,37,77,19,6,25,9,30,30,8,10,90,109
2007,4,40700107,5/4/2008,1610612737,Atlanta Hawks,0,0,1610612738,Boston Celtics,1,1,18,52,70,6,6,12,24,58,82,11,5,16,25,34,11,11,17,85,65
2007,4,40700107,5/4/2008,1610612738,Boston Celtics,1,1,1610612737,Atlanta Hawks,0,0,37,29,66,3,15,18,40,44,84,16,3,19,16,30,20,2,8,83,99
2007,4,40700106,5/2/2008,1610612737,Atlanta Hawks,1,1,1610612738,Boston Celtics,0,0,32,30,62,1,6,7,33,36,69,36,11,47,18,22,25,5,13,86,103
2007,4,40700106,5/2/2008,1610612738,Boston Celtics,0,0,1610612737,Atlanta Hawks,1,1,34,29,63,4,15,19,38,44,82,20,5,25,19,25,25,4,9,86,100
2007,4,40700105,4/30/2008,1610612737,Atlanta Hawks,0,0,1610612738,Boston Celtics,1,1,24,32,56,4,9,13,28,41,69,25,4,29,14,29,16,5,14,85,85
2007,4,40700105,4/30/2008,1610612738,Boston Celtics,1,1,1610612737,Atlanta Hawks,0,0,36,28,64,9,11,20,45,39,84,11,4,15,17,23,28,6,11,85,110
2007,4,40700104,4/28/2008,1610612737,Atlanta Hawks,1,1,1610612738,Boston Celtics,0,0,28,21,49,4,14,18,32,35,67,29,4,33,13,26,16,11,18,88,97
2007,4,40700104,4/28/2008,1610612738,Boston Celtics,0,0,1610612737,Atlanta Hawks,1,1,23,39,62,12,11,23,35,50,85,10,8,18,19,33,26,4,11,88,92
2007,4,40700102,4/23/2008,1610612737,Atlanta Hawks,0,0,1610612738,Boston Celtics,1,1,23,32,55,0,5,5,23,37,60,31,9,40,7,33,10,15,22,92,77
2007,4,40700102,4/23/2008,1610612738,Boston Celtics,1,1,1610612737,Atlanta Hawks,0,0,28,38,66,7,11,18,35,49,84,19,7,26,20,32,23,4,14,93,96
2007,4,40700103,4/26/2008,1610612737,Atlanta Hawks,1,1,1610612738,Boston Celtics,0,0,26,32,58,10,8,18,36,40,76,20,7,27,16,27,28,7,12,85,102
2007,4,40700103,4/26/2008,1610612738,Boston Celtics,0,0,1610612737,Atlanta Hawks,1,1,26,29,55,6,11,17,32,40,72,23,2,25,11,31,24,6,11,84,93
2007,4,40700101,4/20/2008,1610612737,Atlanta Hawks,0,0,1610612738,Boston Celtics,1,1,26,36,62,3,11,14,29,47,76,20,8,28,18,32,16,6,15,87,81
2007,4,40700101,4/20/2008,1610612738,Boston Celtics,1,1,1610612737,Atlanta Hawks,0,0,29,36,65,9,7,16,38,43,81,19,5,24,16,29,22,4,10,88,104
2012,4,41200234,5/12/2013,1610612744,Golden State Warriors,1,1,1610612759,San Antonio Spurs,0,0,28,46,74,7,11,18,35,57,92,20,5,25,23,36,19,11,18,99,97
2012,4,41200234,5/12/2013,1610612759,San Antonio Spurs,0,0,1610612744,Golden State Warriors,1,1,26,40,66,7,20,27,33,60,93,14,11,25,16,48,17,6,12,99,87
2006,4,40600403,6/12/2007,1610612739,Cleveland Cavaliers,1,0,1610612759,San Antonio Spurs,0,1,26,34,60,3,16,19,29,50,79,11,4,15,17,36,19,7,13,82,72
2006,4,40600403,6/12/2007,1610612759,San Antonio Spurs,0,1,1610612739,Cleveland Cavaliers,1,0,18,31,49,10,9,19,28,40,68,9,7,16,8,34,15,7,14,82,75
2006,4,40600404,6/14/2007,1610612739,Cleveland Cavaliers,1,0,1610612759,San Antonio Spurs,0,1,25,37,62,7,15,22,32,52,84,11,5,16,15,39,23,5,10,87,82
2006,4,40600404,6/14/2007,1610612759,San Antonio Spurs,0,1,1610612739,Cleveland Cavaliers,1,0,24,25,49,5,14,19,29,39,68,20,14,34,12,35,13,5,14,87,83
2006,4,40600401,6/7/2007,1610612739,Cleveland Cavaliers,0,0,1610612759,San Antonio Spurs,1,1,25,30,55,5,10,15,30,40,70,11,4,15,11,32,9,6,12,78,76
2006,4,40600401,6/7/2007,1610612759,San Antonio Spurs,1,1,1610612739,Cleveland Cavaliers,0,0,28,31,59,6,10,16,34,41,75,11,5,16,17,27,18,8,14,80,85
2006,4,40600402,6/10/2007,1610612739,Cleveland Cavaliers,0,0,1610612759,San Antonio Spurs,1,1,26,36,62,7,12,19,33,48,81,19,10,29,18,35,15,6,12,86,92
2006,4,40600402,6/10/2007,1610612759,San Antonio Spurs,1,1,1610612739,Cleveland Cavaliers,0,0,29,24,53,8,16,24,37,40,77,21,5,26,13,31,21,5,10,86,103
2006,4,40600315,5/30/2007,1610612759,San Antonio Spurs,1,1,1610612762,Utah Jazz,0,0,32,29,61,7,8,15,39,37,76,24,8,32,11,30,22,4,7,90,109
2006,4,40600315,5/30/2007,1610612762,Utah Jazz,0,0,1610612759,San Antonio Spurs,1,1,24,36,60,2,6,8,26,42,68,30,13,43,14,34,13,5,13,89,84
2006,4,40600314,5/28/2007,1610612759,San Antonio Spurs,0,1,1610612762,Utah Jazz,1,0,23,31,54,5,10,15,28,41,69,30,11,41,15,31,11,10,13,87,91
2006,4,40600314,5/28/2007,1610612762,Utah Jazz,1,0,1610612759,San Antonio Spurs,0,1,31,30,61,1,6,7,32,36,68,14,6,20,8,30,18,8,17,86,79
2006,4,40600313,5/26/2007,1610612759,San Antonio Spurs,0,0,1610612762,Utah Jazz,1,1,21,22,43,7,14,21,28,36,64,20,5,25,7,30,17,12,20,89,83
2006,4,40600313,5/26/2007,1610612762,Utah Jazz,1,1,1610612759,San Antonio Spurs,0,0,35,33,68,6,3,9,41,36,77,21,11,32,16,25,26,6,12,89,109
2006,4,40600311,5/20/2007,1610612759,San Antonio Spurs,1,1,1610612762,Utah Jazz,0,0,33,26,59,5,6,11,38,32,70,27,13,40,12,27,26,4,13,89,108
2006,4,40600311,5/20/2007,1610612762,Utah Jazz,0,0,1610612759,San Antonio Spurs,1,1,31,41,72,5,9,14,36,50,86,23,4,27,25,27,16,6,14,90,100
2012,4,41200233,5/10/2013,1610612744,Golden State Warriors,1,0,1610612759,San Antonio Spurs,0,1,29,41,70,6,13,19,35,54,89,16,4,20,18,38,20,4,11,91,92
2012,4,41200233,5/10/2013,1610612759,San Antonio Spurs,0,1,1610612744,Golden State Warriors,1,0,34,25,59,6,14,20,40,39,79,16,7,23,10,32,21,3,11,92,102
2006,4,40600312,5/22/2007,1610612759,San Antonio Spurs,1,1,1610612762,Utah Jazz,0,0,27,19,46,13,13,26,40,32,72,12,6,18,11,24,28,14,24,95,105
2006,4,40600312,5/22/2007,1610612762,Utah Jazz,0,0,1610612759,San Antonio Spurs,1,1,33,38,71,3,8,11,36,46,82,21,8,29,18,35,21,10,17,95,96
2006,4,40600306,6/2/2007,1610612739,Cleveland Cavaliers,1,1,1610612765,Detroit Pistons,0,0,19,32,51,9,12,21,28,44,72,33,13,46,21,25,19,11,18,89,98
2006,4,40600306,6/2/2007,1610612765,Detroit Pistons,0,0,1610612739,Cleveland Cavaliers,1,1,25,39,64,3,11,14,28,50,78,23,4,27,14,38,16,7,12,88,82
2006,4,40600305,5/31/2007,1610612739,Cleveland Cavaliers,0,1,1610612765,Detroit Pistons,1,0,30,37,67,7,8,15,37,45,82,28,11,39,15,36,13,7,14,98,109
2006,4,40600305,5/31/2007,1610612765,Detroit Pistons,1,0,1610612739,Cleveland Cavaliers,0,1,30,36,66,4,10,14,34,46,80,35,8,43,18,30,18,8,14,98,107
2006,4,40600304,5/29/2007,1610612739,Cleveland Cavaliers,1,1,1610612765,Detroit Pistons,0,0,26,28,54,4,10,14,30,38,68,27,6,33,8,32,16,7,13,89,91
2006,4,40600304,5/29/2007,1610612765,Detroit Pistons,0,0,1610612739,Cleveland Cavaliers,1,1,28,30,58,3,14,17,31,44,75,22,7,29,12,34,16,8,13,88,87
2006,4,40600303,5/27/2007,1610612739,Cleveland Cavaliers,1,1,1610612765,Detroit Pistons,0,0,27,27,54,6,7,13,33,34,67,16,5,21,8,30,20,6,11,80,88
2006,4,40600303,5/27/2007,1610612765,Detroit Pistons,0,0,1610612739,Cleveland Cavaliers,1,1,25,27,52,5,10,15,30,37,67,17,3,20,11,29,15,6,15,82,82
2006,4,40600302,5/24/2007,1610612739,Cleveland Cavaliers,0,0,1610612765,Detroit Pistons,1,1,24,32,56,6,13,19,30,45,75,10,5,15,17,29,17,7,15,83,76
2006,4,40600302,5/24/2007,1610612765,Detroit Pistons,1,1,1610612739,Cleveland Cavaliers,0,0,26,35,61,6,5,11,32,40,72,9,10,19,17,30,23,11,18,82,79
2006,4,40600301,5/21/2007,1610612739,Cleveland Cavaliers,0,0,1610612765,Detroit Pistons,1,1,31,45,76,1,9,10,32,54,86,11,6,17,22,33,16,3,8,82,76
2006,4,40600301,5/21/2007,1610612765,Detroit Pistons,1,1,1610612739,Cleveland Cavaliers,0,0,26,32,58,5,9,14,31,41,72,12,5,17,12,33,25,11,16,82,79
2006,4,40600236,5/18/2007,1610612756,Phoenix Suns,0,0,1610612759,San Antonio Spurs,1,1,35,34,69,6,10,16,41,44,85,18,6,24,19,28,22,9,18,96,106
2006,4,40600236,5/18/2007,1610612759,San Antonio Spurs,1,1,1610612756,Phoenix Suns,0,0,36,30,66,7,15,22,43,45,88,21,9,30,17,32,22,5,12,97,114
2012,4,41200232,5/8/2013,1610612744,Golden State Warriors,0,1,1610612759,San Antonio Spurs,1,0,27,34,61,11,12,23,38,46,84,13,7,20,15,33,19,7,10,90,100
2012,4,41200232,5/8/2013,1610612759,San Antonio Spurs,1,0,1610612744,Golden State Warriors,0,1,30,38,68,5,16,21,35,54,89,16,8,24,20,39,14,6,10,89,91
2006,4,40600235,5/16/2007,1610612756,Phoenix Suns,1,0,1610612759,San Antonio Spurs,0,1,24,35,59,7,11,18,31,46,77,16,1,17,13,34,18,8,16,89,85
2006,4,40600235,5/16/2007,1610612759,San Antonio Spurs,0,1,1610612756,Phoenix Suns,1,0,21,28,49,8,15,23,29,43,72,22,6,28,10,35,15,3,13,89,88
2006,4,40600234,5/14/2007,1610612756,Phoenix Suns,0,1,1610612759,San Antonio Spurs,1,0,33,32,65,5,9,14,38,41,79,23,6,29,14,28,19,9,17,96,104
2006,4,40600234,5/14/2007,1610612759,San Antonio Spurs,1,0,1610612756,Phoenix Suns,0,1,29,28,57,9,14,23,38,42,80,13,1,14,7,35,23,6,17,95,98
2006,4,40600232,5/8/2007,1610612756,Phoenix Suns,1,1,1610612759,San Antonio Spurs,0,0,36,30,66,4,6,10,40,36,76,17,2,19,9,29,25,9,16,91,101
2006,4,40600232,5/8/2007,1610612759,San Antonio Spurs,0,0,1610612756,Phoenix Suns,1,1,27,32,59,6,12,18,33,44,77,9,7,16,13,34,14,10,20,92,81
2006,4,40600233,5/12/2007,1610612756,Phoenix Suns,0,0,1610612759,San Antonio Spurs,1,1,28,31,59,9,8,17,37,39,76,18,9,27,8,37,20,9,16,97,101
2006,4,40600233,5/12/2007,1610612759,San Antonio Spurs,1,1,1610612756,Phoenix Suns,0,0,29,33,62,7,13,20,36,46,82,29,7,36,13,38,19,4,11,96,108
2006,4,40600231,5/6/2007,1610612756,Phoenix Suns,1,0,1610612759,San Antonio Spurs,0,1,33,37,70,6,8,14,39,45,84,22,5,27,11,38,18,3,7,93,106
2006,4,40600231,5/6/2007,1610612759,San Antonio Spurs,0,1,1610612756,Phoenix Suns,1,0,34,32,66,7,9,16,41,41,82,22,11,33,19,28,18,4,15,93,111
2006,4,40600225,5/15/2007,1610612744,Golden State Warriors,0,0,1610612762,Utah Jazz,1,1,22,25,47,6,24,30,28,49,77,25,4,29,9,41,14,5,16,100,87
2006,4,40600225,5/15/2007,1610612762,Utah Jazz,1,1,1610612744,Golden State Warriors,0,0,32,34,66,5,12,17,37,46,83,21,12,33,22,30,19,16,25,100,100
2006,4,40600224,5/13/2007,1610612744,Golden State Warriors,1,0,1610612762,Utah Jazz,0,1,22,23,45,12,27,39,34,50,84,21,13,34,16,43,14,7,15,100,101
2006,4,40600224,5/13/2007,1610612762,Utah Jazz,0,1,1610612744,Golden State Warriors,1,0,33,31,64,4,4,8,37,35,72,37,6,43,13,25,25,9,21,99,115
2006,4,40600223,5/11/2007,1610612744,Golden State Warriors,1,1,1610612762,Utah Jazz,0,0,26,20,46,15,17,32,41,37,78,28,7,35,9,31,22,5,14,99,125
2006,4,40600223,5/11/2007,1610612762,Utah Jazz,0,0,1610612744,Golden State Warriors,1,1,31,33,64,6,8,14,37,41,78,25,8,33,19,25,24,12,25,98,105
2006,4,40600222,5/9/2007,1610612744,Golden State Warriors,0,0,1610612762,Utah Jazz,1,1,23,27,50,15,25,40,38,52,90,26,11,37,17,42,15,6,12,105,117
2006,4,40600222,5/9/2007,1610612762,Utah Jazz,1,1,1610612744,Golden State Warriors,0,0,39,32,71,7,9,16,46,41,87,28,5,33,22,21,31,13,23,103,127
2006,4,40600216,5/18/2007,1610612739,Cleveland Cavaliers,0,1,1610612751,Brooklyn Nets,1,0,22,27,49,11,16,27,33,43,76,11,7,18,11,37,18,6,12,86,88
2006,4,40600216,5/18/2007,1610612751,Brooklyn Nets,1,0,1610612739,Cleveland Cavaliers,0,1,23,30,53,3,13,16,26,43,69,17,8,25,11,37,17,9,16,86,72
2012,4,41200231,5/6/2013,1610612744,Golden State Warriors,0,0,1610612759,San Antonio Spurs,1,1,40,30,70,11,19,30,51,49,100,14,10,24,17,38,23,9,21,119,127
2012,4,41200231,5/6/2013,1610612759,San Antonio Spurs,1,1,1610612744,Golden State Warriors,0,0,33,46,79,13,13,26,46,59,105,24,4,28,16,44,26,8,14,117,129
2006,4,40600221,5/7/2007,1610612744,Golden State Warriors,0,0,1610612762,Utah Jazz,1,1,29,30,59,12,19,31,41,49,90,18,7,25,15,37,20,9,16,102,112
2006,4,40600221,5/7/2007,1610612762,Utah Jazz,1,1,1610612744,Golden State Warriors,0,0,34,31,65,8,15,23,42,46,88,24,8,32,23,26,24,14,21,102,116
2006,4,40600215,5/16/2007,1610612739,Cleveland Cavaliers,1,0,1610612751,Brooklyn Nets,0,1,20,37,57,4,11,15,24,48,72,20,9,29,16,36,13,9,18,86,72
2006,4,40600215,5/16/2007,1610612751,Brooklyn Nets,0,1,1610612739,Cleveland Cavaliers,1,0,25,23,48,8,13,21,33,36,69,9,11,20,11,31,21,7,19,87,83
2006,4,40600214,5/14/2007,1610612739,Cleveland Cavaliers,0,1,1610612751,Brooklyn Nets,1,0,22,29,51,5,9,14,27,38,65,28,9,37,6,34,17,4,13,90,87
2006,4,40600214,5/14/2007,1610612751,Brooklyn Nets,1,0,1610612739,Cleveland Cavaliers,0,1,22,34,56,5,14,19,27,48,75,26,6,32,12,39,21,6,13,91,85
2006,4,40600213,5/12/2007,1610612739,Cleveland Cavaliers,0,0,1610612751,Brooklyn Nets,1,1,24,33,57,5,8,13,29,41,70,22,4,26,6,37,16,6,13,90,85
2006,4,40600213,5/12/2007,1610612751,Brooklyn Nets,1,1,1610612739,Cleveland Cavaliers,0,0,26,28,54,8,10,18,34,38,72,20,7,27,13,31,27,7,18,91,96
2006,4,40600212,5/8/2007,1610612739,Cleveland Cavaliers,1,1,1610612751,Brooklyn Nets,0,0,32,30,62,6,17,23,38,47,85,20,13,33,21,31,19,4,9,87,102
2006,4,40600212,5/8/2007,1610612751,Brooklyn Nets,0,0,1610612739,Cleveland Cavaliers,1,1,26,25,51,8,6,14,34,31,65,16,9,25,6,31,22,10,17,88,92
2006,4,40600211,5/6/2007,1610612739,Cleveland Cavaliers,1,1,1610612751,Brooklyn Nets,0,0,30,40,70,5,12,17,35,52,87,6,5,11,23,30,21,6,16,86,81
2006,4,40600211,5/6/2007,1610612751,Brooklyn Nets,0,0,1610612739,Cleveland Cavaliers,1,1,24,34,58,5,15,20,29,49,78,14,2,16,16,34,20,8,15,87,77
2006,4,40600206,5/17/2007,1610612741,Chicago Bulls,1,0,1610612765,Detroit Pistons,0,1,23,34,57,5,13,18,28,47,75,24,11,35,16,36,23,4,11,86,85
2006,4,40600206,5/17/2007,1610612765,Detroit Pistons,0,1,1610612741,Chicago Bulls,1,0,27,31,58,5,13,18,32,44,76,26,5,31,15,32,17,5,11,87,95
2012,4,41200225,5/15/2013,1610612760,Oklahoma City Thunder,1,0,1610612763,Memphis Grizzlies,0,1,25,35,60,6,19,25,31,54,85,16,5,21,17,41,19,8,13,90,84
2012,4,41200225,5/15/2013,1610612763,Memphis Grizzlies,0,1,1610612760,Oklahoma City Thunder,1,0,27,40,67,3,11,14,30,51,81,25,4,29,15,37,18,3,10,89,88
2006,4,40600205,5/15/2007,1610612741,Chicago Bulls,0,1,1610612765,Detroit Pistons,1,0,33,26,59,10,6,16,43,32,75,12,7,19,14,22,28,7,15,85,108
2006,4,40600205,5/15/2007,1610612765,Detroit Pistons,1,0,1610612741,Chicago Bulls,0,1,28,31,59,5,14,19,33,45,78,21,4,25,20,27,17,10,13,85,92
2006,4,40600204,5/13/2007,1610612741,Chicago Bulls,1,1,1610612765,Detroit Pistons,0,0,30,29,59,5,7,12,35,36,71,27,8,35,16,22,18,9,20,91,102
2006,4,40600204,5/13/2007,1610612765,Detroit Pistons,0,0,1610612741,Chicago Bulls,1,1,25,33,58,6,19,25,31,52,83,19,8,27,17,39,23,5,12,92,87
2006,4,40600203,5/10/2007,1610612741,Chicago Bulls,1,0,1610612765,Detroit Pistons,0,1,26,44,70,2,11,13,28,55,83,16,10,26,24,36,12,7,14,85,74
2006,4,40600203,5/10/2007,1610612765,Detroit Pistons,0,1,1610612741,Chicago Bulls,1,0,26,34,60,6,15,21,32,49,81,11,6,17,14,39,20,3,9,87,81
2006,4,40600202,5/7/2007,1610612741,Chicago Bulls,0,0,1610612765,Detroit Pistons,1,1,19,28,47,4,16,20,23,44,67,37,15,52,11,40,19,4,13,95,87
2006,4,40600202,5/7/2007,1610612765,Detroit Pistons,1,1,1610612741,Chicago Bulls,0,0,31,28,59,10,9,19,41,37,78,16,7,23,16,24,25,9,22,94,108
2006,4,40600177,5/5/2007,1610612745,Houston Rockets,1,0,1610612762,Utah Jazz,0,1,27,25,52,7,14,21,34,39,73,24,9,33,14,30,22,4,9,86,99
2006,4,40600177,5/5/2007,1610612762,Utah Jazz,0,1,1610612745,Houston Rockets,1,0,35,32,67,5,6,11,40,38,78,18,6,24,15,24,28,7,10,85,103
2006,4,40600201,5/5/2007,1610612741,Chicago Bulls,0,0,1610612765,Detroit Pistons,1,1,18,35,53,5,12,17,23,47,70,18,10,28,16,37,13,12,22,91,69
2006,4,40600201,5/5/2007,1610612765,Detroit Pistons,1,1,1610612741,Chicago Bulls,0,0,28,36,64,8,10,18,36,46,82,15,3,18,16,30,24,7,16,91,95
2012,4,41200224,5/13/2013,1610612760,Oklahoma City Thunder,0,0,1610612763,Memphis Grizzlies,1,1,25,34,59,9,11,20,34,45,79,20,2,22,11,36,19,8,15,94,97
2012,4,41200224,5/13/2013,1610612763,Memphis Grizzlies,1,1,1610612760,Oklahoma City Thunder,0,0,30,42,72,6,11,17,36,53,89,25,4,29,17,39,18,4,7,94,103
2006,4,40600176,5/3/2007,1610612745,Houston Rockets,0,0,1610612762,Utah Jazz,1,1,23,23,46,6,15,21,29,38,67,18,5,23,8,35,16,8,19,89,82
2006,4,40600176,5/3/2007,1610612762,Utah Jazz,1,1,1610612745,Houston Rockets,0,0,28,29,57,7,8,15,35,37,72,17,2,19,6,31,23,4,13,89,94
2006,4,40600175,4/30/2007,1610612745,Houston Rockets,1,1,1610612762,Utah Jazz,0,0,23,28,51,12,12,24,35,40,75,14,4,18,11,32,25,6,16,90,96
2006,4,40600175,4/30/2007,1610612762,Utah Jazz,0,0,1610612745,Houston Rockets,1,1,32,35,67,5,7,12,37,42,79,13,5,18,13,33,27,12,14,90,92
2006,4,40600174,4/28/2007,1610612745,Houston Rockets,0,0,1610612762,Utah Jazz,1,1,26,30,56,6,14,20,32,44,76,15,5,20,15,31,19,7,16,88,85
2006,4,40600174,4/28/2007,1610612762,Utah Jazz,1,1,1610612745,Houston Rockets,0,0,33,35,68,2,6,8,35,41,76,26,7,33,15,31,22,6,11,88,98
2006,4,40600173,4/26/2007,1610612745,Houston Rockets,0,0,1610612762,Utah Jazz,1,1,15,30,45,6,13,19,21,43,64,19,7,26,11,33,11,12,19,87,67
2006,4,40600173,4/26/2007,1610612762,Utah Jazz,1,1,1610612745,Houston Rockets,0,0,31,39,70,2,13,15,33,52,85,13,5,18,18,35,19,6,11,87,81
2006,4,40600172,4/23/2007,1610612745,Houston Rockets,1,1,1610612762,Utah Jazz,0,0,26,33,59,4,20,24,30,53,83,34,4,38,19,36,15,4,10,92,98
2006,4,40600172,4/23/2007,1610612762,Utah Jazz,0,0,1610612745,Houston Rockets,1,1,37,38,75,1,8,9,38,46,84,13,4,17,13,35,26,6,13,92,90
2006,4,40600171,4/21/2007,1610612745,Houston Rockets,1,1,1610612762,Utah Jazz,0,0,18,24,42,9,18,27,27,42,69,21,5,26,9,34,19,8,15,88,84
2006,4,40600171,4/21/2007,1610612762,Utah Jazz,0,0,1610612745,Houston Rockets,1,1,27,43,70,4,13,17,31,56,87,9,8,17,19,40,15,8,12,89,75
2006,4,40600165,5/2/2007,1610612743,Denver Nuggets,0,0,1610612759,San Antonio Spurs,1,1,22,40,62,7,8,15,29,48,77,13,4,17,18,32,16,7,16,82,78
2006,4,40600165,5/2/2007,1610612759,San Antonio Spurs,1,1,1610612743,Denver Nuggets,0,0,28,31,59,10,11,21,38,42,80,7,7,14,15,31,25,5,10,82,93
2006,4,40600164,4/30/2007,1610612743,Denver Nuggets,1,0,1610612759,San Antonio Spurs,0,1,35,27,62,2,14,16,37,41,78,13,3,16,10,34,23,10,16,90,89
2006,4,40600164,4/30/2007,1610612759,San Antonio Spurs,0,1,1610612743,Denver Nuggets,1,0,29,27,56,8,17,25,37,44,81,14,6,20,11,35,25,5,11,91,96
2006,4,40600163,4/28/2007,1610612743,Denver Nuggets,1,0,1610612759,San Antonio Spurs,0,1,30,35,65,3,9,12,33,44,77,22,8,30,18,30,19,7,14,89,91
2006,4,40600163,4/28/2007,1610612759,San Antonio Spurs,0,1,1610612743,Denver Nuggets,1,0,28,37,65,9,12,21,37,49,86,13,1,14,15,34,23,3,12,88,96
2006,4,40600161,4/22/2007,1610612743,Denver Nuggets,0,1,1610612759,San Antonio Spurs,1,0,31,33,64,4,9,13,35,42,77,21,4,25,20,24,13,6,18,88,95
2006,4,40600161,4/22/2007,1610612759,San Antonio Spurs,1,0,1610612743,Denver Nuggets,0,1,29,35,64,8,16,24,37,51,88,7,3,10,20,33,22,8,15,89,89
2006,4,40600162,4/25/2007,1610612743,Denver Nuggets,0,0,1610612759,San Antonio Spurs,1,1,27,45,72,7,9,16,34,54,88,13,4,17,17,39,17,5,12,91,88
2006,4,40600162,4/25/2007,1610612759,San Antonio Spurs,1,1,1610612743,Denver Nuggets,0,0,29,37,66,6,8,14,35,45,80,21,2,23,14,32,20,7,13,92,97
2006,4,40600155,5/2/2007,1610612747,Los Angeles Lakers,0,0,1610612756,Phoenix Suns,1,1,39,34,73,4,13,17,43,47,90,20,8,28,17,35,7,10,16,101,110
2006,4,40600155,5/2/2007,1610612756,Phoenix Suns,1,1,1610612747,Los Angeles Lakers,0,0,32,31,63,8,15,23,40,46,86,31,8,39,17,32,23,9,14,102,119
2012,4,41200223,5/11/2013,1610612760,Oklahoma City Thunder,0,0,1610612763,Memphis Grizzlies,1,1,27,43,70,5,13,18,32,56,88,12,7,19,19,40,10,5,14,94,81
2006,4,40600154,4/29/2007,1610612747,Los Angeles Lakers,1,0,1610612756,Phoenix Suns,0,1,30,31,61,9,18,27,39,49,88,13,4,17,16,36,21,12,20,101,100
2006,4,40600154,4/29/2007,1610612756,Phoenix Suns,0,1,1610612747,Los Angeles Lakers,1,0,34,29,63,7,16,23,41,45,86,24,7,31,14,34,34,6,15,100,113
2012,4,41200223,5/11/2013,1610612763,Memphis Grizzlies,1,1,1610612760,Oklahoma City Thunder,0,0,26,34,60,4,10,14,30,44,74,23,5,28,5,42,16,7,12,93,87
2006,4,40600153,4/26/2007,1610612747,Los Angeles Lakers,1,1,1610612756,Phoenix Suns,0,0,29,37,66,5,10,15,34,47,81,22,6,28,19,30,15,2,12,85,95
2006,4,40600153,4/26/2007,1610612756,Phoenix Suns,0,0,1610612747,Los Angeles Lakers,1,1,27,26,53,9,13,22,36,39,75,8,4,12,11,28,30,4,16,85,89
2006,4,40600152,4/24/2007,1610612747,Los Angeles Lakers,0,0,1610612756,Phoenix Suns,1,1,27,36,63,9,15,24,36,51,87,17,7,24,19,36,16,8,15,94,98
2006,4,40600152,4/24/2007,1610612756,Phoenix Suns,1,1,1610612747,Los Angeles Lakers,0,0,39,27,66,11,15,26,50,42,92,15,4,19,17,27,30,6,9,95,126
2006,4,40600151,4/22/2007,1610612747,Los Angeles Lakers,0,0,1610612756,Phoenix Suns,1,1,33,35,68,5,11,16,38,46,84,6,5,11,12,35,13,6,13,91,87
2006,4,40600151,4/22/2007,1610612756,Phoenix Suns,1,1,1610612747,Los Angeles Lakers,0,0,30,31,61,6,17,23,36,48,84,17,7,24,13,38,18,4,8,92,95
2006,4,40600146,5/3/2007,1610612742,Dallas Mavericks,0,0,1610612744,Golden State Warriors,1,1,20,28,48,12,25,37,32,53,85,10,3,13,15,40,20,11,15,92,86
2006,4,40600146,5/3/2007,1610612744,Golden State Warriors,1,1,1610612742,Dallas Mavericks,0,0,23,26,49,14,16,30,37,42,79,23,7,30,16,31,24,4,13,91,111
2006,4,40600145,5/1/2007,1610612742,Dallas Mavericks,1,1,1610612744,Golden State Warriors,0,0,30,28,58,10,11,21,40,39,79,28,8,36,15,30,22,8,15,97,118
2006,4,40600145,5/1/2007,1610612744,Golden State Warriors,0,0,1610612742,Dallas Mavericks,1,1,23,25,48,16,19,35,39,44,83,18,8,26,13,37,23,7,15,96,112
2006,4,40600144,4/29/2007,1610612742,Dallas Mavericks,0,0,1610612744,Golden State Warriors,1,1,26,29,55,9,16,25,35,45,80,20,6,26,20,28,18,8,19,91,99
2006,4,40600144,4/29/2007,1610612744,Golden State Warriors,1,1,1610612742,Dallas Mavericks,0,0,22,21,43,12,19,31,34,40,74,23,14,37,11,36,16,6,10,91,103
2006,4,40600143,4/27/2007,1610612742,Dallas Mavericks,0,0,1610612744,Golden State Warriors,1,1,27,38,65,4,11,15,31,49,80,25,12,37,20,35,16,8,16,95,91
2006,4,40600143,4/27/2007,1610612744,Golden State Warriors,1,1,1610612742,Dallas Mavericks,0,0,33,25,58,6,17,23,39,42,81,25,9,34,16,29,16,9,15,94,109
2012,4,41200222,5/7/2013,1610612760,Oklahoma City Thunder,1,0,1610612763,Memphis Grizzlies,0,1,21,25,46,9,15,24,30,40,70,24,3,27,13,28,17,13,21,89,93
2012,4,41200222,5/7/2013,1610612763,Memphis Grizzlies,0,1,1610612760,Oklahoma City Thunder,1,0,32,39,71,4,11,15,36,50,86,23,9,32,22,32,22,3,11,89,99
2006,4,40600142,4/25/2007,1610612742,Dallas Mavericks,1,1,1610612744,Golden State Warriors,0,0,36,24,60,1,15,16,37,39,76,37,6,43,12,27,15,7,18,101,112
2006,4,40600142,4/25/2007,1610612744,Golden State Warriors,0,0,1610612742,Dallas Mavericks,1,1,32,24,56,4,16,20,36,40,76,23,4,27,12,29,9,14,24,100,99
2006,4,40600141,4/22/2007,1610612742,Dallas Mavericks,1,0,1610612744,Golden State Warriors,0,1,24,42,66,6,13,19,30,55,85,19,6,25,23,35,16,7,15,90,85
2006,4,40600141,4/22/2007,1610612744,Golden State Warriors,0,1,1610612742,Dallas Mavericks,1,0,25,26,51,10,20,30,35,46,81,17,5,22,17,32,16,10,14,90,97
2006,4,40600133,4/27/2007,1610612741,Chicago Bulls,0,1,1610612748,Miami Heat,1,0,30,26,56,5,10,15,35,36,71,29,8,37,16,22,20,9,21,94,104
2006,4,40600133,4/27/2007,1610612748,Miami Heat,1,0,1610612741,Chicago Bulls,0,1,31,35,66,6,9,15,37,44,81,16,19,35,13,39,15,5,9,93,96
2006,4,40600134,4/29/2007,1610612741,Chicago Bulls,0,1,1610612748,Miami Heat,1,0,23,40,63,9,12,21,32,52,84,19,5,24,13,41,18,2,5,87,92
2006,4,40600134,4/29/2007,1610612748,Miami Heat,1,0,1610612741,Chicago Bulls,0,1,27,28,55,4,13,17,31,41,72,13,14,27,13,36,18,11,17,89,79
2006,4,40600126,5/4/2007,1610612751,Brooklyn Nets,1,1,1610612761,Toronto Raptors,0,0,22,24,46,10,9,19,32,33,65,24,5,29,8,27,24,10,19,90,98
2006,4,40600126,5/4/2007,1610612761,Toronto Raptors,0,0,1610612751,Brooklyn Nets,1,1,30,34,64,6,4,10,36,38,74,19,6,25,5,36,20,6,11,91,97
2006,4,40600132,4/24/2007,1610612741,Chicago Bulls,1,1,1610612748,Miami Heat,0,0,32,29,61,11,6,17,43,35,78,10,2,12,11,25,28,9,19,92,107
2006,4,40600132,4/24/2007,1610612748,Miami Heat,0,0,1610612741,Chicago Bulls,1,1,29,28,57,5,11,16,34,39,73,16,4,20,10,30,21,11,21,92,89
2006,4,40600131,4/21/2007,1610612741,Chicago Bulls,1,1,1610612748,Miami Heat,0,0,32,33,65,3,14,17,35,47,82,23,4,27,16,32,27,5,13,92,96
2006,4,40600131,4/21/2007,1610612748,Miami Heat,0,0,1610612741,Chicago Bulls,1,1,24,29,53,7,13,20,31,42,73,22,5,27,7,37,17,4,12,91,91
2006,4,40600125,5/1/2007,1610612751,Brooklyn Nets,0,0,1610612761,Toronto Raptors,1,1,23,23,46,9,17,26,32,40,72,23,6,29,11,33,21,3,13,87,96
2006,4,40600125,5/1/2007,1610612761,Toronto Raptors,1,1,1610612751,Brooklyn Nets,0,0,29,28,57,5,7,12,34,35,69,25,4,29,7,30,12,5,10,86,98
2006,4,40600123,4/27/2007,1610612751,Brooklyn Nets,1,1,1610612761,Toronto Raptors,0,0,35,18,53,6,19,25,41,37,78,14,1,15,9,29,31,10,16,90,102
2006,4,40600123,4/27/2007,1610612761,Toronto Raptors,0,0,1610612751,Brooklyn Nets,1,1,28,29,57,5,13,18,33,42,75,18,3,21,14,29,15,8,18,91,89
2006,4,40600124,4/29/2007,1610612751,Brooklyn Nets,1,1,1610612761,Toronto Raptors,0,0,22,27,49,14,13,27,36,40,76,16,6,22,11,34,29,8,18,95,102
2006,4,40600124,4/29/2007,1610612761,Toronto Raptors,0,0,1610612751,Brooklyn Nets,1,1,25,29,54,3,10,13,28,39,67,22,6,28,10,34,19,9,23,95,81
2006,4,40600122,4/24/2007,1610612751,Brooklyn Nets,0,0,1610612761,Toronto Raptors,1,1,21,32,53,10,13,23,31,45,76,11,3,14,12,33,18,9,16,87,83
2006,4,40600122,4/24/2007,1610612761,Toronto Raptors,1,1,1610612751,Brooklyn Nets,0,0,25,36,61,6,9,15,31,45,76,21,4,25,12,35,12,5,11,88,89
2006,4,40600114,4/30/2007,1610612739,Cleveland Cavaliers,0,1,1610612764,Washington Wizards,1,0,27,32,59,5,11,16,32,43,75,28,3,31,11,34,19,4,10,91,97
2006,4,40600114,4/30/2007,1610612764,Washington Wizards,1,0,1610612739,Cleveland Cavaliers,0,1,28,33,61,6,13,19,34,46,80,16,2,18,10,38,20,9,12,90,90
2006,4,40600121,4/21/2007,1610612751,Brooklyn Nets,0,1,1610612761,Toronto Raptors,1,0,30,33,63,6,16,22,36,49,85,18,8,26,18,34,25,6,13,93,96
2006,4,40600121,4/21/2007,1610612761,Toronto Raptors,1,0,1610612751,Brooklyn Nets,0,1,26,35,61,7,12,19,33,47,80,18,7,25,12,39,19,8,15,94,91
2006,4,40600113,4/28/2007,1610612739,Cleveland Cavaliers,0,1,1610612764,Washington Wizards,1,0,32,31,63,6,7,13,38,38,76,16,2,18,18,22,24,6,16,82,98
2006,4,40600113,4/28/2007,1610612764,Washington Wizards,1,0,1610612739,Cleveland Cavaliers,0,1,29,32,61,7,15,22,36,47,83,13,3,16,14,35,18,3,7,83,92
2006,4,40600112,4/25/2007,1610612739,Cleveland Cavaliers,1,1,1610612764,Washington Wizards,0,0,37,35,72,3,9,12,40,44,84,26,7,33,21,28,20,7,14,93,109
2006,4,40600112,4/25/2007,1610612764,Washington Wizards,0,0,1610612739,Cleveland Cavaliers,1,1,32,36,68,6,16,22,38,52,90,20,8,28,13,41,20,2,5,93,102
2006,4,40600111,4/22/2007,1610612739,Cleveland Cavaliers,1,1,1610612764,Washington Wizards,0,0,29,29,58,3,11,14,32,40,72,30,9,39,14,30,16,5,13,91,97
2006,4,40600111,4/22/2007,1610612764,Washington Wizards,0,0,1610612739,Cleveland Cavaliers,1,1,23,37,60,6,13,19,29,50,79,18,7,25,12,41,17,7,11,89,82
2006,4,40600104,4/28/2007,1610612753,Orlando Magic,1,0,1610612765,Detroit Pistons,0,1,34,35,69,2,6,8,36,41,77,19,12,31,19,28,19,11,16,86,93
2006,4,40600104,4/28/2007,1610612765,Detroit Pistons,0,1,1610612753,Orlando Magic,1,0,24,26,50,6,9,15,30,35,65,31,7,38,12,26,17,7,16,88,97
2006,4,40600103,4/26/2007,1610612753,Orlando Magic,1,0,1610612765,Detroit Pistons,0,1,28,38,66,3,5,8,31,43,74,12,9,21,11,36,16,8,13,85,77
2006,4,40600103,4/26/2007,1610612765,Detroit Pistons,0,1,1610612753,Orlando Magic,1,0,26,39,65,8,5,13,34,44,78,17,6,23,13,34,15,3,9,86,93
2006,4,40600102,4/23/2007,1610612753,Orlando Magic,0,0,1610612765,Detroit Pistons,1,1,32,36,68,3,5,8,35,41,76,17,9,26,16,30,19,4,9,80,90
2006,4,40600102,4/23/2007,1610612765,Detroit Pistons,1,1,1610612753,Orlando Magic,0,0,24,35,59,8,11,19,32,46,78,26,7,33,19,32,22,1,6,80,98
2006,4,40600101,4/21/2007,1610612753,Orlando Magic,0,0,1610612765,Detroit Pistons,1,1,34,23,57,2,3,5,36,26,62,18,18,36,10,27,18,6,21,88,92
2006,4,40600101,4/21/2007,1610612765,Detroit Pistons,1,1,1610612753,Orlando Magic,0,0,31,28,59,5,9,14,36,37,73,23,8,31,11,32,29,6,11,89,100
2005,4,40500406,6/20/2006,1610612742,Dallas Mavericks,1,0,1610612748,Miami Heat,0,1,29,41,70,5,17,22,34,58,92,19,4,23,17,45,16,9,13,98,92
2005,4,40500406,6/20/2006,1610612748,Miami Heat,0,1,1610612742,Dallas Mavericks,1,0,33,27,60,2,16,18,35,43,78,23,14,37,17,34,18,12,19,98,95
2005,4,40500405,6/18/2006,1610612742,Dallas Mavericks,0,0,1610612748,Miami Heat,1,1,32,30,62,5,14,19,37,44,81,21,4,25,17,29,13,7,16,94,100
2005,4,40500405,6/18/2006,1610612748,Miami Heat,1,1,1610612742,Dallas Mavericks,0,0,24,28,52,7,10,17,31,38,69,32,17,49,12,35,14,3,12,92,101
2005,4,40500403,6/13/2006,1610612742,Dallas Mavericks,0,0,1610612748,Miami Heat,1,1,30,29,59,6,10,16,36,39,75,18,8,26,8,36,15,9,16,94,96
2005,4,40500403,6/13/2006,1610612748,Miami Heat,1,1,1610612742,Dallas Mavericks,0,0,33,29,62,4,10,14,37,39,76,20,14,34,19,27,13,9,20,95,98
2005,4,40500404,6/15/2006,1610612742,Dallas Mavericks,0,0,1610612748,Miami Heat,1,1,22,35,57,3,19,22,25,54,79,21,6,27,12,43,10,7,14,91,74
2005,4,40500404,6/15/2006,1610612748,Miami Heat,1,1,1610612742,Dallas Mavericks,0,0,27,20,47,7,12,19,34,32,66,23,13,36,10,29,19,6,18,91,98
2012,4,41200221,5/5/2013,1610612760,Oklahoma City Thunder,1,1,1610612763,Memphis Grizzlies,0,0,28,37,65,5,10,15,33,47,80,22,3,25,8,40,13,5,10,92,93
2012,4,41200221,5/5/2013,1610612763,Memphis Grizzlies,0,0,1610612760,Oklahoma City Thunder,1,1,28,35,63,7,12,19,35,47,82,14,10,24,11,40,13,2,12,92,91
2005,4,40500401,6/8/2006,1610612742,Dallas Mavericks,1,1,1610612748,Miami Heat,0,0,26,28,54,6,12,18,32,40,72,20,6,26,8,36,18,10,14,93,90
2005,4,40500401,6/8/2006,1610612748,Miami Heat,0,0,1610612742,Dallas Mavericks,1,1,29,29,58,5,15,20,34,44,78,7,12,19,12,37,20,9,16,92,80
2005,4,40500402,6/11/2006,1610612742,Dallas Mavericks,1,1,1610612748,Miami Heat,0,0,26,25,51,8,11,19,34,36,70,23,5,28,13,27,23,5,19,87,99
2005,4,40500402,6/11/2006,1610612748,Miami Heat,0,0,1610612742,Dallas Mavericks,1,1,22,31,53,7,10,17,29,41,70,20,12,32,10,37,16,5,13,87,85
2005,4,40500316,6/3/2006,1610612742,Dallas Mavericks,0,1,1610612756,Phoenix Suns,1,0,34,24,58,3,17,20,37,41,78,25,6,31,14,31,10,5,14,93,102
2005,4,40500316,6/3/2006,1610612756,Phoenix Suns,1,0,1610612742,Dallas Mavericks,0,1,30,25,55,6,11,17,36,36,72,15,5,20,8,30,18,11,18,91,93
2005,4,40500315,6/1/2006,1610612742,Dallas Mavericks,1,1,1610612756,Phoenix Suns,0,0,33,39,72,9,8,17,42,47,89,24,4,28,18,30,24,3,9,92,117
2005,4,40500315,6/1/2006,1610612756,Phoenix Suns,0,0,1610612742,Dallas Mavericks,1,1,26,29,55,10,14,24,36,43,79,19,1,20,9,35,21,5,13,91,101
2005,4,40500314,5/30/2006,1610612742,Dallas Mavericks,0,0,1610612756,Phoenix Suns,1,1,29,37,66,4,9,13,33,46,79,16,6,22,17,31,11,5,14,86,86
2005,4,40500314,5/30/2006,1610612756,Phoenix Suns,1,1,1610612742,Dallas Mavericks,0,0,36,28,64,7,8,15,43,36,79,13,8,21,10,30,21,5,7,86,106
2005,4,40500313,5/28/2006,1610612742,Dallas Mavericks,0,1,1610612756,Phoenix Suns,1,0,35,45,80,4,11,15,39,56,95,13,4,17,23,34,16,0,6,86,95
2005,4,40500313,5/28/2006,1610612756,Phoenix Suns,1,0,1610612742,Dallas Mavericks,0,1,28,35,63,7,12,19,35,47,82,11,2,13,16,32,13,8,13,86,88
2005,4,40500312,5/26/2006,1610612742,Dallas Mavericks,1,1,1610612756,Phoenix Suns,0,0,34,35,69,4,7,11,38,42,80,25,11,36,14,34,17,6,8,92,105
2005,4,40500312,5/26/2006,1610612756,Phoenix Suns,0,0,1610612742,Dallas Mavericks,1,1,30,36,66,10,13,23,40,49,89,8,3,11,10,40,23,4,9,92,98
2005,4,40500311,5/24/2006,1610612742,Dallas Mavericks,1,0,1610612756,Phoenix Suns,0,1,44,33,77,3,13,16,47,46,93,21,2,23,19,28,13,7,16,98,118
2005,4,40500311,5/24/2006,1610612756,Phoenix Suns,0,1,1610612742,Dallas Mavericks,1,0,42,28,70,5,10,15,47,38,85,22,7,29,14,30,24,9,15,99,121
2005,4,40500306,6/2/2006,1610612748,Miami Heat,1,1,1610612765,Detroit Pistons,0,0,33,21,54,6,10,16,39,31,70,11,6,17,7,28,22,5,12,84,95
2005,4,40500306,6/2/2006,1610612765,Detroit Pistons,0,0,1610612748,Miami Heat,1,1,21,39,60,6,15,21,27,54,81,18,6,24,14,43,15,3,7,84,78
2005,4,40500305,5/31/2006,1610612748,Miami Heat,0,0,1610612765,Detroit Pistons,1,1,30,28,58,4,15,19,34,43,77,6,14,20,18,31,21,8,16,84,78
2005,4,40500305,5/31/2006,1610612765,Detroit Pistons,1,1,1610612748,Miami Heat,0,0,31,31,62,2,13,15,33,44,77,23,3,26,16,31,19,4,13,84,91
2005,4,40500304,5/29/2006,1610612748,Miami Heat,1,1,1610612765,Detroit Pistons,0,0,23,13,36,5,10,15,28,23,51,28,19,47,6,26,17,4,15,81,89
2005,4,40500304,5/29/2006,1610612765,Detroit Pistons,0,0,1610612748,Miami Heat,1,1,24,37,61,6,10,16,30,47,77,12,10,22,19,32,14,7,11,81,78
2012,4,41200216,5/18/2013,1610612752,New York Knicks,0,0,1610612754,Indiana Pacers,1,1,21,34,55,13,17,30,34,51,85,18,0,18,17,34,19,4,9,86,99
2012,4,41200216,5/18/2013,1610612754,Indiana Pacers,1,1,1610612752,New York Knicks,0,0,30,22,52,4,11,15,34,33,67,34,12,46,12,28,17,3,9,85,106
2005,4,40500303,5/27/2006,1610612748,Miami Heat,1,1,1610612765,Detroit Pistons,0,0,37,21,58,2,7,9,39,28,67,18,7,25,12,19,11,5,18,85,98
2005,4,40500303,5/27/2006,1610612765,Detroit Pistons,0,0,1610612748,Miami Heat,1,1,20,28,48,7,9,16,27,37,64,22,11,33,11,30,11,8,16,86,83
2005,4,40500302,5/25/2006,1610612748,Miami Heat,0,0,1610612765,Detroit Pistons,1,1,25,26,51,6,16,22,31,42,73,20,3,23,12,31,16,10,19,92,88
2005,4,40500302,5/25/2006,1610612765,Detroit Pistons,1,1,1610612748,Miami Heat,0,0,27,26,53,6,16,22,33,42,75,20,7,27,13,33,20,8,19,93,92
2005,4,40500301,5/23/2006,1610612748,Miami Heat,0,1,1610612765,Detroit Pistons,1,0,31,19,50,5,9,14,36,28,64,14,7,21,8,25,13,7,16,84,91
2005,4,40500301,5/23/2006,1610612765,Detroit Pistons,1,0,1610612748,Miami Heat,0,1,26,35,61,5,16,21,31,51,82,19,3,22,14,39,16,5,6,84,86
2005,4,40500237,5/22/2006,1610612746,LA Clippers,0,0,1610612756,Phoenix Suns,1,1,41,33,74,0,4,4,41,37,78,25,1,26,12,25,11,5,12,92,107
2005,4,40500237,5/22/2006,1610612756,Phoenix Suns,1,1,1610612746,LA Clippers,0,0,33,20,53,15,12,27,48,32,80,16,3,19,10,23,32,7,13,92,127
2005,4,40500236,5/18/2006,1610612746,LA Clippers,1,1,1610612756,Phoenix Suns,0,0,46,27,73,2,3,5,48,30,78,20,3,23,10,20,28,10,19,98,118
2005,4,40500236,5/18/2006,1610612756,Phoenix Suns,0,0,1610612746,LA Clippers,1,1,25,31,56,13,18,31,38,49,87,17,6,23,10,43,26,1,10,97,106
2005,4,40500235,5/16/2006,1610612746,LA Clippers,0,0,1610612756,Phoenix Suns,1,1,33,49,82,9,11,20,42,60,102,25,7,32,22,40,14,7,17,112,118
2005,4,40500235,5/16/2006,1610612756,Phoenix Suns,1,1,1610612746,LA Clippers,0,0,38,41,79,11,18,29,49,59,108,16,5,21,20,41,29,6,13,113,125
2012,4,41200215,5/16/2013,1610612752,New York Knicks,1,1,1610612754,Indiana Pacers,0,0,25,35,60,7,11,18,32,46,78,14,3,17,13,34,12,6,11,85,85
2005,4,40500234,5/14/2006,1610612746,LA Clippers,1,1,1610612756,Phoenix Suns,0,0,37,33,70,5,11,16,42,44,86,25,4,29,18,28,26,5,9,92,114
2005,4,40500234,5/14/2006,1610612756,Phoenix Suns,0,0,1610612746,LA Clippers,1,1,30,22,52,10,26,36,40,48,88,17,5,22,12,41,30,2,5,91,107
2012,4,41200215,5/16/2013,1610612754,Indiana Pacers,0,0,1610612752,New York Knicks,1,1,19,31,50,6,13,19,25,44,69,19,13,32,19,32,12,12,19,86,75
2005,4,40500233,5/12/2006,1610612746,LA Clippers,1,0,1610612756,Phoenix Suns,0,1,28,42,70,7,6,13,35,48,83,14,6,20,9,42,23,8,15,98,91
2005,4,40500233,5/12/2006,1610612756,Phoenix Suns,0,1,1610612746,LA Clippers,1,0,25,34,59,7,20,27,32,54,86,23,3,26,13,43,25,6,12,98,94
2005,4,40500232,5/10/2006,1610612746,LA Clippers,0,1,1610612756,Phoenix Suns,1,0,45,36,81,4,5,9,49,41,90,20,5,25,21,23,15,4,12,92,122
2005,4,40500232,5/10/2006,1610612756,Phoenix Suns,1,0,1610612746,LA Clippers,0,1,27,26,53,9,17,26,36,43,79,16,7,23,8,39,24,6,10,93,97
2005,4,40500231,5/8/2006,1610612746,LA Clippers,0,0,1610612756,Phoenix Suns,1,1,44,25,69,4,8,12,48,33,81,23,6,29,10,28,20,6,15,98,123
2005,4,40500231,5/8/2006,1610612756,Phoenix Suns,1,1,1610612746,LA Clippers,0,0,35,24,59,12,15,27,47,39,86,24,1,25,10,30,26,4,11,100,130
2005,4,40500226,5/19/2006,1610612742,Dallas Mavericks,1,0,1610612759,San Antonio Spurs,0,1,27,42,69,5,9,14,32,51,83,17,3,20,14,39,15,7,15,94,86
2005,4,40500226,5/19/2006,1610612759,San Antonio Spurs,0,1,1610612742,Dallas Mavericks,1,0,25,32,57,4,6,10,29,38,67,29,5,34,5,34,11,7,17,93,91
2005,4,40500227,5/22/2006,1610612742,Dallas Mavericks,0,1,1610612759,San Antonio Spurs,1,0,35,30,65,7,10,17,42,40,82,28,3,31,13,28,15,6,12,96,119
2005,4,40500227,5/22/2006,1610612759,San Antonio Spurs,1,0,1610612742,Dallas Mavericks,0,1,30,26,56,6,13,19,36,39,75,33,6,39,6,36,16,3,10,97,111
2012,4,41200214,5/14/2013,1610612752,New York Knicks,0,0,1610612754,Indiana Pacers,1,1,23,36,59,8,20,28,31,56,87,12,2,14,17,39,14,4,10,86,82
2012,4,41200214,5/14/2013,1610612754,Indiana Pacers,1,1,1610612752,New York Knicks,0,0,23,28,51,8,17,25,31,45,76,23,7,30,21,28,17,7,16,86,93
2005,4,40500224,5/15/2006,1610612742,Dallas Mavericks,1,1,1610612759,San Antonio Spurs,0,0,40,38,78,5,7,12,45,45,90,28,4,32,17,31,18,10,12,100,123
2005,4,40500224,5/15/2006,1610612759,San Antonio Spurs,0,0,1610612742,Dallas Mavericks,1,1,34,31,65,8,6,14,42,37,79,26,6,32,11,27,16,2,16,99,118
2005,4,40500225,5/17/2006,1610612742,Dallas Mavericks,0,0,1610612759,San Antonio Spurs,1,1,36,29,65,3,9,12,39,38,77,16,3,19,13,26,12,6,13,88,97
2005,4,40500225,5/17/2006,1610612759,San Antonio Spurs,1,1,1610612742,Dallas Mavericks,0,0,35,25,60,2,7,9,37,32,69,22,9,31,7,31,18,5,12,87,98
2005,4,40500223,5/13/2006,1610612742,Dallas Mavericks,1,1,1610612759,San Antonio Spurs,0,0,31,30,61,1,4,5,32,34,66,39,11,50,13,27,12,8,14,90,104
2005,4,40500223,5/13/2006,1610612759,San Antonio Spurs,0,0,1610612742,Dallas Mavericks,1,1,36,36,72,3,7,10,39,43,82,22,10,32,19,28,12,3,12,91,103
2012,4,41200213,5/11/2013,1610612752,New York Knicks,0,0,1610612754,Indiana Pacers,1,1,22,38,60,3,8,11,25,46,71,18,7,25,12,38,11,7,15,85,71
2012,4,41200213,5/11/2013,1610612754,Indiana Pacers,1,1,1610612752,New York Knicks,0,0,18,29,47,10,23,33,28,52,80,16,7,23,23,32,14,7,17,85,82
2005,4,40500222,5/9/2006,1610612742,Dallas Mavericks,0,1,1610612759,San Antonio Spurs,1,0,30,35,65,6,7,13,36,42,78,35,8,43,14,32,12,4,6,89,113
2005,4,40500222,5/9/2006,1610612759,San Antonio Spurs,1,0,1610612742,Dallas Mavericks,0,1,26,27,53,4,9,13,30,36,66,27,10,37,10,31,11,10,14,89,91
2005,4,40500221,5/7/2006,1610612742,Dallas Mavericks,0,0,1610612759,San Antonio Spurs,1,1,30,40,70,2,5,7,32,45,77,19,10,29,16,31,8,8,13,89,85
2005,4,40500221,5/7/2006,1610612759,San Antonio Spurs,1,1,1610612742,Dallas Mavericks,0,0,28,34,62,3,10,13,31,44,75,22,7,29,12,37,11,9,12,89,87
2005,4,40500215,5/16/2006,1610612748,Miami Heat,1,1,1610612751,Brooklyn Nets,0,0,35,24,59,7,9,16,42,33,75,15,14,29,9,31,15,9,14,93,106
2005,4,40500215,5/16/2006,1610612751,Brooklyn Nets,0,0,1610612748,Miami Heat,1,1,33,22,55,7,12,19,40,34,74,18,8,26,4,34,21,6,14,95,105
2005,4,40500214,5/14/2006,1610612748,Miami Heat,0,1,1610612751,Brooklyn Nets,1,0,29,22,51,8,11,19,37,33,70,20,11,31,7,33,19,1,10,88,102
2005,4,40500214,5/14/2006,1610612751,Brooklyn Nets,1,0,1610612748,Miami Heat,0,1,32,32,64,4,16,20,36,48,84,16,8,24,18,36,21,8,10,89,92
2005,4,40500213,5/12/2006,1610612748,Miami Heat,0,1,1610612751,Brooklyn Nets,1,0,21,23,44,9,14,23,30,37,67,34,6,40,9,32,19,3,15,92,103
2005,4,40500213,5/12/2006,1610612751,Brooklyn Nets,1,0,1610612748,Miami Heat,0,1,31,36,67,6,12,18,37,48,85,12,8,20,17,36,26,9,14,93,92
2005,4,40500211,5/8/2006,1610612748,Miami Heat,1,0,1610612751,Brooklyn Nets,0,1,23,24,47,4,18,22,27,42,69,30,13,43,13,38,11,12,17,95,88
2005,4,40500211,5/8/2006,1610612751,Brooklyn Nets,0,1,1610612748,Miami Heat,1,0,25,23,48,9,13,22,34,36,70,23,7,30,8,32,20,10,18,94,100
2012,4,41200212,5/7/2013,1610612752,New York Knicks,1,1,1610612754,Indiana Pacers,0,0,34,25,59,10,20,30,44,45,89,7,3,10,17,29,20,4,7,84,105
2012,4,41200212,5/7/2013,1610612754,Indiana Pacers,0,0,1610612752,New York Knicks,1,1,22,19,41,8,17,25,30,36,66,11,7,18,11,28,19,11,21,85,79
2005,4,40500212,5/10/2006,1610612748,Miami Heat,1,1,1610612751,Brooklyn Nets,0,0,28,26,54,11,9,20,39,35,74,22,9,31,13,26,22,8,12,87,111
2005,4,40500212,5/10/2006,1610612751,Brooklyn Nets,0,0,1610612748,Miami Heat,1,1,23,31,54,5,11,16,28,42,70,28,7,35,13,32,15,5,13,87,89
2005,4,40500207,5/21/2006,1610612739,Cleveland Cavaliers,0,0,1610612765,Detroit Pistons,1,1,19,34,53,1,11,12,20,45,65,20,7,27,12,37,9,4,12,79,61
2005,4,40500207,5/21/2006,1610612765,Detroit Pistons,1,1,1610612739,Cleveland Cavaliers,0,0,26,29,55,3,10,13,29,39,68,18,14,32,18,29,11,6,11,78,79
2005,4,40500206,5/19/2006,1610612739,Cleveland Cavaliers,1,0,1610612765,Detroit Pistons,0,1,28,27,55,2,10,12,30,37,67,20,4,24,15,25,17,9,14,79,82
2005,4,40500206,5/19/2006,1610612765,Detroit Pistons,0,1,1610612739,Cleveland Cavaliers,1,0,25,29,54,6,8,14,31,37,68,16,12,28,12,33,17,4,10,79,84
2005,4,40500205,5/17/2006,1610612739,Cleveland Cavaliers,0,1,1610612765,Detroit Pistons,1,0,26,42,68,5,8,13,31,50,81,19,7,26,21,34,15,4,12,83,86
2005,4,40500205,5/17/2006,1610612765,Detroit Pistons,1,0,1610612739,Cleveland Cavaliers,0,1,30,35,65,2,8,10,32,43,75,18,10,28,20,27,16,9,17,83,84
2012,4,41200211,5/5/2013,1610612752,New York Knicks,1,0,1610612754,Indiana Pacers,0,1,28,34,62,7,12,19,35,46,81,18,5,23,12,36,15,3,10,90,95
2005,4,40500204,5/15/2006,1610612739,Cleveland Cavaliers,1,1,1610612765,Detroit Pistons,0,0,24,33,57,5,6,11,29,39,68,11,6,17,13,27,13,9,19,82,74
2005,4,40500204,5/15/2006,1610612765,Detroit Pistons,0,0,1610612739,Cleveland Cavaliers,1,1,21,39,60,4,11,15,25,50,75,18,5,23,18,33,12,7,16,82,72
2012,4,41200211,5/5/2013,1610612754,Indiana Pacers,0,1,1610612752,New York Knicks,1,0,29,24,53,8,15,23,37,39,76,20,6,26,15,27,21,4,16,91,102
2005,4,40500203,5/13/2006,1610612739,Cleveland Cavaliers,1,1,1610612765,Detroit Pistons,0,0,31,23,54,3,11,14,34,34,68,15,1,16,9,26,21,8,13,80,86
2005,4,40500203,5/13/2006,1610612765,Detroit Pistons,0,0,1610612739,Cleveland Cavaliers,1,1,21,32,53,7,11,18,28,43,71,14,2,16,15,29,21,8,17,80,77
2005,4,40500202,5/9/2006,1610612739,Cleveland Cavaliers,0,0,1610612765,Detroit Pistons,1,1,29,36,65,6,8,14,35,44,79,15,7,22,14,35,18,8,14,88,91
2005,4,40500202,5/9/2006,1610612765,Detroit Pistons,1,1,1610612739,Cleveland Cavaliers,0,0,18,25,43,10,15,25,28,40,68,31,11,42,7,38,20,2,8,88,97
2005,4,40500201,5/7/2006,1610612739,Cleveland Cavaliers,0,0,1610612765,Detroit Pistons,1,1,31,41,72,3,7,10,34,48,82,15,3,18,18,31,14,4,11,85,86
2005,4,40500201,5/7/2006,1610612765,Detroit Pistons,1,1,1610612739,Cleveland Cavaliers,0,0,27,32,59,15,7,22,42,39,81,14,4,18,16,25,23,3,10,84,113
2005,4,40500174,5/1/2006,1610612742,Dallas Mavericks,0,1,1610612763,Memphis Grizzlies,1,0,32,35,67,7,5,12,39,40,79,17,0,17,14,27,21,5,12,86,102
2005,4,40500174,5/1/2006,1610612763,Memphis Grizzlies,1,0,1610612742,Dallas Mavericks,0,1,28,32,60,0,7,7,28,39,67,20,8,28,10,33,9,6,14,85,76
2005,4,40500172,4/26/2006,1610612742,Dallas Mavericks,1,1,1610612763,Memphis Grizzlies,0,0,27,28,55,4,10,14,31,38,69,28,8,36,16,28,18,1,13,84,94
2005,4,40500172,4/26/2006,1610612763,Memphis Grizzlies,0,0,1610612742,Dallas Mavericks,1,1,23,24,47,5,9,14,28,33,61,18,8,26,9,27,15,5,20,83,79
2005,4,40500173,4/29/2006,1610612742,Dallas Mavericks,0,1,1610612763,Memphis Grizzlies,1,0,30,35,65,5,15,20,35,50,85,19,3,22,19,33,17,5,12,89,94
2005,4,40500173,4/29/2006,1610612763,Memphis Grizzlies,1,0,1610612742,Dallas Mavericks,0,1,27,36,63,4,9,13,31,45,76,23,7,30,12,37,16,4,11,88,89
2005,4,40500164,4/29/2006,1610612743,Denver Nuggets,1,0,1610612746,LA Clippers,0,1,31,32,63,5,17,22,36,49,85,9,3,12,12,37,25,8,15,94,86
2005,4,40500164,4/29/2006,1610612746,LA Clippers,0,1,1610612743,Denver Nuggets,1,0,32,35,67,5,4,9,37,39,76,21,3,24,10,30,26,5,18,93,100
2005,4,40500165,5/1/2006,1610612743,Denver Nuggets,0,0,1610612746,LA Clippers,1,1,30,50,80,4,8,12,34,58,92,11,4,15,17,43,20,3,10,93,83
2005,4,40500165,5/1/2006,1610612746,LA Clippers,1,1,1610612743,Denver Nuggets,0,0,34,28,62,3,9,12,37,37,74,24,3,27,12,27,25,10,18,92,101
2005,4,40500163,4/27/2006,1610612743,Denver Nuggets,1,1,1610612746,LA Clippers,0,0,31,40,71,0,11,11,31,51,82,32,14,46,18,40,21,8,15,101,94
2005,4,40500163,4/27/2006,1610612746,LA Clippers,0,0,1610612743,Denver Nuggets,1,1,24,34,58,5,9,14,29,43,72,24,7,31,12,34,14,8,25,101,87
2005,4,40500162,4/24/2006,1610612743,Denver Nuggets,0,0,1610612746,LA Clippers,1,1,22,40,62,5,12,17,27,52,79,28,9,37,19,37,17,6,12,91,87
2005,4,40500162,4/24/2006,1610612746,LA Clippers,1,1,1610612743,Denver Nuggets,0,0,34,29,63,4,13,17,38,42,80,18,7,25,11,36,25,2,11,92,98
2005,4,40500161,4/22/2006,1610612743,Denver Nuggets,0,0,1610612746,LA Clippers,1,1,34,51,85,1,5,6,35,56,91,16,6,22,25,33,16,3,7,85,87
2005,4,40500161,4/22/2006,1610612746,LA Clippers,1,1,1610612743,Denver Nuggets,0,0,24,32,56,6,6,12,30,38,68,23,7,30,13,28,22,9,15,84,89
2005,4,40500157,5/6/2006,1610612747,Los Angeles Lakers,0,0,1610612756,Phoenix Suns,1,1,24,40,64,8,19,27,32,59,91,18,1,19,16,43,10,5,10,94,90
2005,4,40500157,5/6/2006,1610612756,Phoenix Suns,1,1,1610612747,Los Angeles Lakers,0,0,37,19,56,10,11,21,47,30,77,17,1,18,3,27,24,6,10,94,121
2012,4,41200205,5/15/2013,1610612741,Chicago Bulls,0,0,1610612748,Miami Heat,1,1,25,31,56,8,11,19,33,42,75,17,7,24,19,28,14,10,16,83,91
2012,4,41200205,5/15/2013,1610612748,Miami Heat,1,1,1610612741,Chicago Bulls,0,0,26,23,49,6,15,21,32,38,70,24,9,33,11,28,20,5,10,83,94
2005,4,40500156,5/4/2006,1610612747,Los Angeles Lakers,1,0,1610612756,Phoenix Suns,0,1,38,24,62,9,14,23,47,38,85,15,7,22,14,27,23,8,20,102,118
2005,4,40500156,5/4/2006,1610612756,Phoenix Suns,0,1,1610612747,Los Angeles Lakers,1,0,37,24,61,9,11,20,46,35,81,25,4,29,8,29,26,8,14,101,126
2005,4,40500155,5/2/2006,1610612747,Los Angeles Lakers,0,0,1610612756,Phoenix Suns,1,1,29,20,49,7,14,21,36,34,70,18,6,24,9,25,16,6,20,91,97
2005,4,40500155,5/2/2006,1610612756,Phoenix Suns,1,1,1610612747,Los Angeles Lakers,0,0,34,29,63,8,15,23,42,44,86,22,4,26,14,32,18,5,8,91,114
2005,4,40500153,4/28/2006,1610612747,Los Angeles Lakers,1,1,1610612756,Phoenix Suns,0,0,34,39,73,5,16,21,39,55,94,16,7,23,22,37,17,8,10,93,99
2005,4,40500153,4/28/2006,1610612756,Phoenix Suns,0,0,1610612747,Los Angeles Lakers,1,1,24,31,55,10,13,23,34,44,78,14,3,17,6,40,25,9,14,92,92
2005,4,40500154,4/30/2006,1610612747,Los Angeles Lakers,1,1,1610612756,Phoenix Suns,0,0,27,28,55,7,14,21,34,42,76,24,7,31,11,34,21,5,17,97,99
2005,4,40500154,4/30/2006,1610612756,Phoenix Suns,0,0,1610612747,Los Angeles Lakers,1,1,32,38,70,7,13,20,39,51,90,13,2,15,13,38,25,5,12,97,98
2005,4,40500152,4/26/2006,1610612747,Los Angeles Lakers,0,1,1610612756,Phoenix Suns,1,0,29,30,59,9,7,16,38,37,75,14,5,19,8,33,20,4,17,93,99
2005,4,40500152,4/26/2006,1610612756,Phoenix Suns,1,0,1610612747,Los Angeles Lakers,0,1,24,27,51,9,18,27,33,45,78,18,0,18,8,37,19,8,14,93,93
2005,4,40500145,5/2/2006,1610612758,Sacramento Kings,0,0,1610612759,San Antonio Spurs,1,1,24,31,55,10,12,22,34,43,77,20,5,25,12,35,17,3,9,87,98
2005,4,40500145,5/2/2006,1610612759,San Antonio Spurs,1,1,1610612758,Sacramento Kings,0,0,32,20,52,7,9,16,39,29,68,24,3,27,9,22,27,11,14,87,109
2005,4,40500146,5/5/2006,1610612758,Sacramento Kings,1,0,1610612759,San Antonio Spurs,0,1,24,28,52,4,12,16,28,40,68,23,7,30,13,30,14,8,20,91,83
2005,4,40500146,5/5/2006,1610612759,San Antonio Spurs,0,1,1610612758,Sacramento Kings,1,0,30,28,58,9,10,19,39,38,77,18,6,24,9,32,20,9,13,91,105
2005,4,40500143,4/28/2006,1610612758,Sacramento Kings,1,1,1610612759,San Antonio Spurs,0,0,30,33,63,3,11,14,33,44,77,25,8,33,16,33,16,6,13,89,94
2005,4,40500143,4/28/2006,1610612759,San Antonio Spurs,0,0,1610612758,Sacramento Kings,1,1,29,27,56,6,14,20,35,41,76,17,6,23,12,31,18,7,15,91,93
2005,4,40500144,4/30/2006,1610612758,Sacramento Kings,1,1,1610612759,San Antonio Spurs,0,0,32,26,58,6,12,18,38,38,76,20,7,27,14,27,16,7,11,87,102
2005,4,40500144,4/30/2006,1610612759,San Antonio Spurs,0,0,1610612758,Sacramento Kings,1,1,29,29,58,3,10,13,32,39,71,17,10,27,12,31,13,7,15,86,84
2005,4,40500142,4/25/2006,1610612758,Sacramento Kings,0,0,1610612759,San Antonio Spurs,1,1,39,38,77,3,7,10,42,45,87,32,6,38,19,28,15,7,16,102,119
2005,4,40500142,4/25/2006,1610612759,San Antonio Spurs,1,1,1610612758,Sacramento Kings,0,0,31,27,58,12,14,26,43,41,84,30,6,36,8,37,29,4,11,104,128
2005,4,40500141,4/22/2006,1610612758,Sacramento Kings,0,0,1610612759,San Antonio Spurs,1,1,28,42,70,5,9,14,33,51,84,17,3,20,15,39,14,5,9,87,88
2005,4,40500141,4/22/2006,1610612759,San Antonio Spurs,1,1,1610612758,Sacramento Kings,0,0,31,25,56,11,6,17,42,31,73,27,5,32,14,19,25,7,12,89,122
2005,4,40500136,5/5/2006,1610612739,Cleveland Cavaliers,0,1,1610612764,Washington Wizards,1,0,36,30,66,7,12,19,43,42,85,21,5,26,13,30,24,7,17,100,114
2005,4,40500136,5/5/2006,1610612764,Washington Wizards,1,0,1610612739,Cleveland Cavaliers,0,1,34,36,70,7,13,20,41,49,90,24,9,33,19,36,27,10,14,100,113
2005,4,40500135,5/3/2006,1610612739,Cleveland Cavaliers,1,1,1610612764,Washington Wizards,0,0,43,33,76,1,4,5,44,37,81,32,11,43,19,25,15,6,13,96,121
2005,4,40500135,5/3/2006,1610612764,Washington Wizards,0,0,1610612739,Cleveland Cavaliers,1,1,35,29,64,9,11,20,44,40,84,23,6,29,13,32,23,5,11,95,120
2005,4,40500134,4/30/2006,1610612739,Cleveland Cavaliers,0,0,1610612764,Washington Wizards,1,1,25,21,46,9,13,22,34,34,68,19,6,25,11,26,15,7,23,91,96
2005,4,40500134,4/30/2006,1610612764,Washington Wizards,1,1,1610612739,Cleveland Cavaliers,0,0,25,33,58,8,12,20,33,45,78,32,8,40,17,33,16,6,11,92,106
2005,4,40500133,4/28/2006,1610612739,Cleveland Cavaliers,0,1,1610612764,Washington Wizards,1,0,30,41,71,5,9,14,35,50,85,22,5,27,17,36,14,5,12,91,97
2005,4,40500133,4/28/2006,1610612764,Washington Wizards,1,0,1610612739,Cleveland Cavaliers,0,1,32,26,58,2,11,13,34,37,71,26,7,33,10,30,11,10,18,92,96
2005,4,40500132,4/25/2006,1610612739,Cleveland Cavaliers,1,0,1610612764,Washington Wizards,0,1,27,44,71,3,9,12,30,53,83,21,8,29,23,34,14,10,17,90,84
2005,4,40500132,4/25/2006,1610612764,Washington Wizards,0,1,1610612739,Cleveland Cavaliers,1,0,23,35,58,8,12,20,31,47,78,19,10,29,15,37,13,8,12,91,89
2005,4,40500131,4/22/2006,1610612739,Cleveland Cavaliers,1,1,1610612764,Washington Wizards,0,0,33,40,73,5,9,14,38,49,87,16,6,22,23,29,21,7,12,85,97
2005,4,40500131,4/22/2006,1610612764,Washington Wizards,0,0,1610612739,Cleveland Cavaliers,1,1,26,23,49,3,19,22,29,42,71,25,11,36,13,34,15,6,10,85,86
2005,4,40500125,5/2/2006,1610612751,Brooklyn Nets,1,1,1610612754,Indiana Pacers,0,0,32,30,62,4,12,16,36,42,78,16,4,20,13,32,32,11,16,91,92
2005,4,40500125,5/2/2006,1610612754,Indiana Pacers,0,0,1610612751,Brooklyn Nets,1,1,27,29,56,7,18,25,34,47,81,11,6,17,9,41,19,4,11,91,86
2005,4,40500126,5/4/2006,1610612751,Brooklyn Nets,0,1,1610612754,Indiana Pacers,1,0,23,26,49,10,12,22,33,38,71,20,3,23,14,26,24,7,16,84,96
2005,4,40500126,5/4/2006,1610612754,Indiana Pacers,1,0,1610612751,Brooklyn Nets,0,1,26,25,51,7,12,19,33,37,70,17,8,25,8,34,12,7,12,85,90
2005,4,40500124,4/29/2006,1610612751,Brooklyn Nets,0,1,1610612754,Indiana Pacers,1,0,33,30,63,4,9,13,37,39,76,19,6,25,10,31,21,4,11,89,97
2005,4,40500124,4/29/2006,1610612754,Indiana Pacers,1,0,1610612751,Brooklyn Nets,0,1,18,24,42,10,11,21,28,35,63,22,10,32,12,28,21,12,23,88,88
2012,4,41200203,5/10/2013,1610612741,Chicago Bulls,1,0,1610612748,Miami Heat,0,1,28,27,55,7,15,22,35,42,77,17,8,25,14,32,21,4,11,87,94
2012,4,41200203,5/10/2013,1610612748,Miami Heat,0,1,1610612741,Chicago Bulls,1,0,27,23,50,8,12,20,35,35,70,26,4,30,11,27,21,7,12,87,104
2005,4,40500123,4/27/2006,1610612751,Brooklyn Nets,0,0,1610612754,Indiana Pacers,1,1,22,37,59,7,9,16,29,46,75,30,6,36,14,36,17,7,8,87,95
2005,4,40500123,4/27/2006,1610612754,Indiana Pacers,1,1,1610612751,Brooklyn Nets,0,0,30,20,50,4,11,15,34,31,65,35,7,42,13,20,18,9,15,87,107
2005,4,40500122,4/25/2006,1610612751,Brooklyn Nets,1,1,1610612754,Indiana Pacers,0,0,31,25,56,2,13,15,33,38,71,22,6,28,13,29,22,4,14,86,90
2005,4,40500122,4/25/2006,1610612754,Indiana Pacers,0,0,1610612751,Brooklyn Nets,1,1,21,33,54,7,18,25,28,51,79,12,5,17,17,35,18,4,15,86,75
2005,4,40500116,5/4/2006,1610612741,Chicago Bulls,1,0,1610612748,Miami Heat,0,1,21,24,45,10,20,30,31,44,75,24,8,32,10,38,19,6,12,92,96
2005,4,40500116,5/4/2006,1610612748,Miami Heat,0,1,1610612741,Chicago Bulls,1,0,27,25,52,11,14,25,38,39,77,26,8,34,16,28,21,4,14,90,113
2005,4,40500115,5/2/2006,1610612741,Chicago Bulls,0,0,1610612748,Miami Heat,1,1,21,35,56,4,12,16,25,47,72,24,6,30,13,37,10,4,20,93,78
2005,4,40500115,5/2/2006,1610612748,Miami Heat,1,1,1610612741,Chicago Bulls,0,0,29,21,50,4,19,23,33,40,73,22,19,41,12,40,19,3,12,95,92
2005,4,40500114,4/30/2006,1610612741,Chicago Bulls,1,1,1610612748,Miami Heat,0,0,24,27,51,7,10,17,31,37,68,24,7,31,11,28,18,7,17,90,93
2005,4,40500114,4/30/2006,1610612748,Miami Heat,0,0,1610612741,Chicago Bulls,1,1,28,35,63,9,17,26,37,52,89,4,1,5,22,31,23,9,19,91,87
2005,4,40500113,4/27/2006,1610612741,Chicago Bulls,1,1,1610612748,Miami Heat,0,0,31,31,62,5,11,16,36,42,78,32,14,46,13,35,23,4,11,94,109
2005,4,40500113,4/27/2006,1610612748,Miami Heat,0,0,1610612741,Chicago Bulls,1,1,21,29,50,9,13,22,30,42,72,21,12,33,14,34,16,7,19,95,90
2005,4,40500112,4/24/2006,1610612741,Chicago Bulls,0,0,1610612748,Miami Heat,1,1,33,30,63,8,6,14,41,36,77,18,8,26,10,32,20,9,19,97,108
2005,4,40500112,4/24/2006,1610612748,Miami Heat,1,1,1610612741,Chicago Bulls,0,0,35,25,60,9,15,24,44,40,84,18,7,25,13,30,19,6,14,98,115
2005,4,40500111,4/22/2006,1610612741,Chicago Bulls,0,0,1610612748,Miami Heat,1,1,27,35,62,13,13,26,40,48,88,13,4,17,11,39,20,11,16,100,106
2005,4,40500111,4/22/2006,1610612748,Miami Heat,1,1,1610612741,Chicago Bulls,0,0,32,26,58,5,14,19,37,40,77,32,7,39,12,32,18,5,17,101,111
2005,4,40500104,5/1/2006,1610612749,Milwaukee Bucks,1,0,1610612765,Detroit Pistons,0,1,34,25,59,4,6,10,38,31,69,19,9,28,14,24,23,7,18,86,99
2005,4,40500104,5/1/2006,1610612765,Detroit Pistons,0,1,1610612749,Milwaukee Bucks,1,0,27,30,57,8,9,17,35,39,74,31,10,41,17,26,22,3,7,86,109
2012,4,41200204,5/13/2013,1610612741,Chicago Bulls,1,0,1610612748,Miami Heat,0,1,17,40,57,2,15,17,19,55,74,25,7,32,22,35,12,9,17,85,65
2005,4,40500105,5/3/2006,1610612749,Milwaukee Bucks,0,0,1610612765,Detroit Pistons,1,1,35,37,72,1,9,10,36,46,82,20,3,23,10,37,18,4,11,93,93
2005,4,40500105,5/3/2006,1610612765,Detroit Pistons,1,1,1610612749,Milwaukee Bucks,0,0,30,27,57,10,7,17,40,34,74,32,7,39,15,21,30,9,14,93,122
2012,4,41200204,5/13/2013,1610612748,Miami Heat,0,1,1610612741,Chicago Bulls,1,0,27,23,50,6,12,18,33,35,68,16,5,21,10,27,24,10,17,85,88
2005,4,40500102,4/26/2006,1610612749,Milwaukee Bucks,0,0,1610612765,Detroit Pistons,1,1,31,42,73,6,6,12,37,48,85,18,6,24,18,32,16,6,13,92,98
2005,4,40500102,4/26/2006,1610612765,Detroit Pistons,1,1,1610612749,Milwaukee Bucks,0,0,32,26,58,10,15,25,42,41,83,15,4,19,12,32,30,5,10,91,109
2005,4,40500103,4/29/2006,1610612749,Milwaukee Bucks,1,1,1610612765,Detroit Pistons,0,0,36,25,61,11,6,17,47,31,78,19,3,22,10,24,34,7,12,89,124
2005,4,40500103,4/29/2006,1610612765,Detroit Pistons,0,0,1610612749,Milwaukee Bucks,1,1,23,19,42,11,17,28,34,36,70,25,12,37,12,29,22,7,11,88,104
2012,4,41200202,5/8/2013,1610612741,Chicago Bulls,0,0,1610612748,Miami Heat,1,1,18,35,53,9,14,23,27,49,76,15,6,21,16,36,17,9,19,88,78
2012,4,41200202,5/8/2013,1610612748,Miami Heat,1,1,1610612741,Chicago Bulls,0,0,33,19,52,9,9,18,42,28,70,22,7,29,12,18,29,8,17,89,115
2012,4,41200201,5/6/2013,1610612741,Chicago Bulls,0,1,1610612748,Miami Heat,1,0,24,29,53,7,11,18,31,40,71,24,5,29,13,29,20,8,16,87,93
2012,4,41200201,5/6/2013,1610612748,Miami Heat,1,0,1610612741,Chicago Bulls,0,1,24,30,54,7,17,24,31,47,78,17,8,25,10,41,20,5,9,87,86
2012,4,41200176,5/3/2013,1610612746,LA Clippers,0,0,1610612763,Memphis Grizzlies,1,1,34,24,58,7,13,20,41,37,78,16,8,24,11,30,19,7,13,94,105
2012,4,41200176,5/3/2013,1610612763,Memphis Grizzlies,1,1,1610612746,LA Clippers,0,0,28,24,52,8,11,19,36,35,71,38,9,47,12,27,27,3,12,95,118
2012,4,41200174,4/27/2013,1610612746,LA Clippers,0,0,1610612763,Memphis Grizzlies,1,1,28,29,57,4,17,21,32,46,78,15,2,17,8,39,17,3,10,87,83
2012,4,41200174,4/27/2013,1610612763,Memphis Grizzlies,1,1,1610612746,LA Clippers,0,0,35,30,65,4,8,12,39,38,77,22,7,29,16,25,25,8,13,87,104
2012,4,41200175,4/30/2013,1610612746,LA Clippers,1,0,1610612763,Memphis Grizzlies,0,1,28,32,60,6,11,17,34,43,77,19,6,25,14,32,19,7,13,87,93
2012,4,41200175,4/30/2013,1610612763,Memphis Grizzlies,0,1,1610612746,LA Clippers,1,0,34,41,75,3,7,10,37,48,85,26,7,33,19,32,19,6,7,88,103
2012,4,41200172,4/22/2013,1610612746,LA Clippers,1,1,1610612763,Memphis Grizzlies,0,0,35,28,63,2,13,15,37,41,78,17,5,22,11,32,19,8,13,91,93
2012,4,41200172,4/22/2013,1610612763,Memphis Grizzlies,0,0,1610612746,LA Clippers,1,1,31,31,62,2,9,11,33,40,73,23,11,34,12,33,16,5,13,91,91
2012,4,41200171,4/20/2013,1610612746,LA Clippers,1,1,1610612763,Memphis Grizzlies,0,0,34,21,55,7,12,19,41,33,74,23,8,31,19,19,20,3,13,82,112
2012,4,41200171,4/20/2013,1610612763,Memphis Grizzlies,0,0,1610612746,LA Clippers,1,1,28,31,59,5,7,12,33,38,71,20,5,25,8,34,22,4,7,83,91
2012,4,41200173,4/25/2013,1610612746,LA Clippers,0,0,1610612763,Memphis Grizzlies,1,1,17,27,44,9,14,23,26,41,67,21,2,23,11,32,14,11,18,84,82
2012,4,41200173,4/25/2013,1610612763,Memphis Grizzlies,1,1,1610612746,LA Clippers,0,0,27,37,64,4,12,16,31,49,80,28,10,38,24,31,18,5,10,83,94
2012,4,41200166,5/2/2013,1610612743,Denver Nuggets,0,0,1610612744,Golden State Warriors,1,1,27,43,70,7,21,28,34,64,98,13,8,21,24,44,18,3,7,93,88
2012,4,41200166,5/2/2013,1610612744,Golden State Warriors,1,1,1610612743,Denver Nuggets,0,0,24,28,52,7,18,25,31,46,77,23,1,24,17,29,17,10,21,93,92
2012,4,41200165,4/30/2013,1610612743,Denver Nuggets,1,1,1610612744,Golden State Warriors,0,0,28,34,62,10,17,27,38,51,89,21,6,27,20,35,26,5,13,94,107
2012,4,41200165,4/30/2013,1610612744,Golden State Warriors,0,0,1610612743,Denver Nuggets,1,1,24,29,53,11,17,28,35,46,81,19,6,25,17,32,20,12,17,95,100
2012,4,41200164,4/28/2013,1610612743,Denver Nuggets,0,0,1610612744,Golden State Warriors,1,1,27,24,51,6,14,20,33,38,71,29,9,38,14,27,14,13,23,100,101
2012,4,41200164,4/28/2013,1610612744,Golden State Warriors,1,1,1610612743,Denver Nuggets,0,0,33,20,53,11,15,26,44,35,79,16,7,23,8,29,27,6,16,99,115
2012,4,41200163,4/26/2013,1610612743,Denver Nuggets,0,0,1610612744,Golden State Warriors,1,1,33,35,68,7,11,18,40,46,86,21,6,27,16,32,26,7,18,100,108
2012,4,41200163,4/26/2013,1610612744,Golden State Warriors,1,1,1610612743,Denver Nuggets,0,0,34,26,60,8,12,20,42,38,80,18,5,23,15,24,26,11,23,98,110
2012,4,41200154,4/28/2013,1610612747,Los Angeles Lakers,1,0,1610612759,San Antonio Spurs,0,1,31,28,59,5,12,17,36,40,76,5,7,12,13,32,22,13,22,94,82
2012,4,41200154,4/28/2013,1610612759,San Antonio Spurs,0,1,1610612747,Los Angeles Lakers,1,0,34,34,68,5,11,16,39,45,84,20,3,23,12,36,24,2,8,94,103
2012,4,41200161,4/20/2013,1610612743,Denver Nuggets,1,1,1610612744,Golden State Warriors,0,0,35,34,69,3,13,16,38,47,85,18,10,28,8,44,16,4,11,102,97
2012,4,41200161,4/20/2013,1610612744,Golden State Warriors,0,0,1610612743,Denver Nuggets,1,1,30,40,70,8,14,22,38,54,92,11,4,15,17,38,27,9,18,101,95
2012,4,41200162,4/23/2013,1610612743,Denver Nuggets,1,0,1610612744,Golden State Warriors,0,1,31,23,54,9,17,26,40,40,80,28,9,37,13,31,27,7,15,100,117
2012,4,41200162,4/23/2013,1610612744,Golden State Warriors,0,1,1610612743,Denver Nuggets,1,0,37,17,54,14,11,25,51,28,79,15,5,20,8,23,26,6,17,98,131
2018,4,41800406,6/13/2019,1610612744,Golden State Warriors,1,0,1610612761,Toronto Raptors,0,1,28,21,49,11,20,31,39,41,80,21,9,30,16,30,28,8,17,97,110
2018,4,41800406,6/13/2019,1610612761,Toronto Raptors,0,1,1610612744,Golden State Warriors,1,0,26,23,49,13,20,33,39,43,82,23,6,29,11,34,25,9,12,96,114
2012,4,41200151,4/21/2013,1610612747,Los Angeles Lakers,0,0,1610612759,San Antonio Spurs,1,1,27,31,58,3,12,15,30,43,73,16,8,24,10,37,15,12,18,94,79
2012,4,41200151,4/21/2013,1610612759,San Antonio Spurs,1,1,1610612747,Los Angeles Lakers,0,0,25,38,63,7,15,22,32,53,85,20,5,25,13,41,20,8,9,94,91
2018,4,41800405,6/10/2019,1610612744,Golden State Warriors,0,1,1610612761,Toronto Raptors,1,0,18,22,40,20,22,42,38,44,82,10,4,14,11,34,27,6,16,93,106
2018,4,41800405,6/10/2019,1610612761,Toronto Raptors,1,0,1610612744,Golden State Warriors,0,1,30,23,53,8,24,32,38,47,85,21,6,27,18,33,19,5,13,94,105
2012,4,41200152,4/24/2013,1610612747,Los Angeles Lakers,0,0,1610612759,San Antonio Spurs,1,1,29,31,60,8,14,22,37,45,82,9,4,13,15,34,18,7,13,86,91
2012,4,41200152,4/24/2013,1610612759,San Antonio Spurs,1,1,1610612747,Los Angeles Lakers,0,0,35,33,68,7,7,14,42,40,82,11,3,14,13,28,21,5,9,85,102
2012,4,41200153,4/26/2013,1610612747,Los Angeles Lakers,1,0,1610612759,San Antonio Spurs,0,1,31,30,61,4,16,20,35,46,81,15,10,25,10,42,19,9,13,94,89
2012,4,41200153,4/26/2013,1610612759,San Antonio Spurs,0,1,1610612747,Los Angeles Lakers,1,0,47,22,69,5,11,16,52,33,85,11,4,15,11,26,30,8,14,96,120
2018,4,41800404,6/7/2019,1610612744,Golden State Warriors,1,0,1610612761,Toronto Raptors,0,1,27,24,51,8,19,27,35,43,78,14,7,21,14,33,26,12,19,93,92
2018,4,41800404,6/7/2019,1610612761,Toronto Raptors,0,1,1610612744,Golden State Warriors,1,0,26,28,54,10,22,32,36,50,86,23,1,24,14,37,22,6,11,94,105
2012,4,41200146,5/3/2013,1610612745,Houston Rockets,1,0,1610612760,Oklahoma City Thunder,0,1,16,25,41,14,18,32,30,43,73,20,11,31,15,33,16,9,16,89,94
2012,4,41200146,5/3/2013,1610612760,Oklahoma City Thunder,0,1,1610612745,Houston Rockets,1,0,27,29,56,11,16,27,38,45,83,16,0,16,12,33,21,5,10,89,103
2012,4,41200145,5/1/2013,1610612745,Houston Rockets,0,1,1610612760,Oklahoma City Thunder,1,0,20,17,37,14,21,35,34,38,72,25,12,37,10,33,15,5,15,95,107
2012,4,41200145,5/1/2013,1610612760,Oklahoma City Thunder,1,0,1610612745,Houston Rockets,0,1,28,25,53,8,25,33,36,50,86,20,8,28,13,41,20,4,9,96,100
2018,4,41800403,6/5/2019,1610612744,Golden State Warriors,1,0,1610612761,Toronto Raptors,0,1,24,31,55,12,24,36,36,55,91,25,5,30,22,38,25,9,15,98,109
2018,4,41800403,6/5/2019,1610612761,Toronto Raptors,0,1,1610612744,Golden State Warriors,1,0,26,18,44,17,21,38,43,39,82,20,1,21,11,28,30,8,16,97,123
2012,4,41200144,4/29/2013,1610612745,Houston Rockets,1,1,1610612760,Oklahoma City Thunder,0,0,25,24,49,12,15,27,37,39,76,19,5,24,14,28,21,9,22,94,105
2012,4,41200144,4/29/2013,1610612760,Oklahoma City Thunder,0,0,1610612745,Houston Rockets,1,1,24,23,47,11,14,25,35,37,72,22,3,25,13,25,18,10,22,96,103
2018,4,41800402,6/2/2019,1610612744,Golden State Warriors,0,1,1610612761,Toronto Raptors,1,0,25,23,48,13,21,34,38,44,82,20,3,23,10,36,34,8,16,100,109
2018,4,41800402,6/2/2019,1610612761,Toronto Raptors,1,0,1610612744,Golden State Warriors,0,1,24,32,56,11,27,38,35,59,94,23,3,26,20,40,17,7,15,100,104
2018,4,41800401,5/30/2019,1610612744,Golden State Warriors,0,0,1610612761,Toronto Raptors,1,1,22,25,47,12,19,31,34,44,78,29,2,31,14,31,29,6,17,97,109
2018,4,41800401,5/30/2019,1610612761,Toronto Raptors,1,1,1610612744,Golden State Warriors,0,0,26,18,44,13,20,33,39,38,77,27,5,32,7,32,25,6,10,95,118
2012,4,41200142,4/24/2013,1610612745,Houston Rockets,0,0,1610612760,Oklahoma City Thunder,1,1,26,30,56,10,25,35,36,55,91,20,5,25,21,35,16,8,16,97,102
2012,4,41200142,4/24/2013,1610612760,Oklahoma City Thunder,1,1,1610612745,Houston Rockets,0,0,26,24,50,11,24,35,37,48,85,20,4,24,11,40,20,4,12,96,105
2012,4,41200143,4/27/2013,1610612745,Houston Rockets,1,0,1610612760,Oklahoma City Thunder,0,1,24,22,46,12,25,37,36,47,83,17,8,25,11,41,23,7,11,95,101
2012,4,41200143,4/27/2013,1610612760,Oklahoma City Thunder,0,1,1610612745,Houston Rockets,1,0,23,38,61,10,16,26,33,54,87,28,2,30,18,38,14,6,11,95,104
2018,4,41800314,5/20/2019,1610612744,Golden State Warriors,0,1,1610612757,Portland Trail Blazers,1,0,34,26,60,12,27,39,46,53,99,15,4,19,18,35,30,5,15,105,119
2018,4,41800314,5/20/2019,1610612757,Portland Trail Blazers,1,0,1610612744,Golden State Warriors,0,1,31,26,57,16,25,41,47,51,98,7,3,10,9,45,31,10,13,106,117
2018,4,41800313,5/18/2019,1610612744,Golden State Warriors,0,1,1610612757,Portland Trail Blazers,1,0,33,25,58,8,18,26,41,43,84,20,3,23,11,34,27,9,14,98,110
2018,4,41800313,5/18/2019,1610612757,Portland Trail Blazers,1,0,1610612744,Golden State Warriors,0,1,23,27,50,11,24,35,34,51,85,20,13,33,12,46,22,9,11,98,99
2012,4,41200137,5/4/2013,1610612741,Chicago Bulls,0,1,1610612751,Brooklyn Nets,1,0,33,28,61,7,14,21,40,42,82,12,1,13,16,27,20,6,9,82,99
2012,4,41200137,5/4/2013,1610612751,Brooklyn Nets,1,0,1610612741,Chicago Bulls,0,1,27,34,61,8,17,25,35,51,86,15,5,20,21,32,21,6,9,81,93
2012,4,41200141,4/21/2013,1610612745,Houston Rockets,0,0,1610612760,Oklahoma City Thunder,1,1,25,30,55,8,28,36,33,58,91,17,7,24,17,44,17,9,15,99,91
2012,4,41200141,4/21/2013,1610612760,Oklahoma City Thunder,1,1,1610612745,Houston Rockets,0,0,34,25,59,10,14,24,44,39,83,22,6,28,10,31,28,6,13,99,120
2012,4,41200136,5/2/2013,1610612741,Chicago Bulls,1,0,1610612751,Brooklyn Nets,0,1,29,42,71,7,11,18,36,53,89,13,5,18,21,34,23,5,16,93,92
2012,4,41200136,5/2/2013,1610612751,Brooklyn Nets,0,1,1610612741,Chicago Bulls,1,0,29,36,65,5,9,14,34,45,79,22,11,33,12,35,21,4,10,93,95
2012,4,41200135,4/29/2013,1610612741,Chicago Bulls,0,0,1610612751,Brooklyn Nets,1,1,33,30,63,4,8,12,37,38,75,13,5,18,14,27,20,7,13,84,91
2012,4,41200135,4/29/2013,1610612751,Brooklyn Nets,1,1,1610612741,Chicago Bulls,0,0,36,31,67,6,11,17,42,42,84,20,3,23,21,23,19,8,11,83,110
2018,4,41800306,5/25/2019,1610612749,Milwaukee Bucks,0,0,1610612761,Toronto Raptors,1,1,18,23,41,12,22,34,30,45,75,22,9,31,16,34,19,7,11,86,94
2018,4,41800306,5/25/2019,1610612761,Toronto Raptors,1,1,1610612749,Milwaukee Bucks,0,0,24,23,47,12,15,27,36,38,74,16,6,22,9,31,20,7,11,86,100
2018,4,41800312,5/16/2019,1610612744,Golden State Warriors,1,1,1610612757,Portland Trail Blazers,0,0,33,20,53,9,20,29,42,40,82,21,6,27,14,28,30,8,17,96,114
2018,4,41800312,5/16/2019,1610612757,Portland Trail Blazers,0,0,1610612744,Golden State Warriors,1,1,20,27,47,18,21,39,38,48,86,17,1,18,11,38,23,4,12,96,111
2018,4,41800311,5/14/2019,1610612744,Golden State Warriors,1,1,1610612757,Portland Trail Blazers,0,0,25,26,51,17,16,33,42,42,84,15,3,18,11,32,30,5,14,95,116
2018,4,41800311,5/14/2019,1610612757,Portland Trail Blazers,0,0,1610612744,Golden State Warriors,1,1,23,32,55,7,21,28,30,53,83,27,4,31,21,34,21,13,21,97,94
2012,4,41200134,4/27/2013,1610612741,Chicago Bulls,1,1,1610612751,Brooklyn Nets,0,0,52,38,90,6,13,19,58,51,109,20,9,29,18,37,34,7,15,120,142
2012,4,41200134,4/27/2013,1610612751,Brooklyn Nets,0,0,1610612741,Chicago Bulls,1,1,39,34,73,9,15,24,48,49,97,29,16,45,16,42,23,8,20,120,134
2018,4,41800305,5/23/2019,1610612749,Milwaukee Bucks,1,0,1610612761,Toronto Raptors,0,1,28,25,53,10,21,31,38,46,84,13,5,18,10,38,26,6,11,93,99
2018,4,41800305,5/23/2019,1610612761,Toronto Raptors,0,1,1610612749,Milwaukee Bucks,1,0,13,28,41,18,25,43,31,53,84,25,6,31,12,45,19,2,6,95,105
2012,4,41200133,4/25/2013,1610612741,Chicago Bulls,1,1,1610612751,Brooklyn Nets,0,0,28,35,63,3,12,15,31,47,78,14,7,21,13,37,17,5,15,90,79
2012,4,41200133,4/25/2013,1610612751,Brooklyn Nets,0,0,1610612741,Chicago Bulls,1,1,23,37,60,5,16,21,28,53,81,15,2,17,12,43,15,6,11,92,76
2018,4,41800304,5/21/2019,1610612749,Milwaukee Bucks,0,0,1610612761,Toronto Raptors,1,1,26,19,45,11,24,35,37,43,80,17,9,26,11,35,30,9,13,95,102
2018,4,41800304,5/21/2019,1610612761,Toronto Raptors,1,1,1610612749,Milwaukee Bucks,0,0,27,19,46,14,27,41,41,46,87,24,3,27,15,33,32,8,11,95,120
2012,4,41200132,4/22/2013,1610612741,Chicago Bulls,0,1,1610612751,Brooklyn Nets,1,0,34,31,65,3,9,12,37,40,77,13,10,23,11,32,21,8,14,90,90
2012,4,41200132,4/22/2013,1610612751,Brooklyn Nets,1,0,1610612741,Chicago Bulls,0,1,25,36,61,4,17,21,29,53,82,20,3,23,16,38,22,6,12,92,82
2018,4,41800303,5/19/2019,1610612749,Milwaukee Bucks,0,0,1610612761,Toronto Raptors,1,1,24,34,58,14,30,44,38,64,102,22,11,33,18,52,22,11,20,119,112
2018,4,41800303,5/19/2019,1610612761,Toronto Raptors,1,1,1610612749,Milwaukee Bucks,0,0,23,34,57,17,28,45,40,62,102,21,5,26,14,51,28,14,17,119,118
2018,4,41800302,5/17/2019,1610612749,Milwaukee Bucks,1,1,1610612761,Toronto Raptors,0,0,30,21,51,13,28,41,43,49,92,26,9,35,15,38,27,3,7,101,125
2018,4,41800302,5/17/2019,1610612761,Toronto Raptors,0,0,1610612749,Milwaukee Bucks,1,1,27,28,55,10,22,32,37,50,87,19,6,25,9,44,19,6,14,102,103
2018,4,41800301,5/15/2019,1610612749,Milwaukee Bucks,1,1,1610612761,Toronto Raptors,0,0,26,23,49,11,33,44,37,56,93,23,4,27,19,39,21,9,13,101,108
2018,4,41800301,5/15/2019,1610612761,Toronto Raptors,0,0,1610612749,Milwaukee Bucks,1,1,19,31,50,15,27,42,34,58,92,17,3,20,13,47,17,8,12,101,100
2018,4,41800237,5/12/2019,1610612743,Denver Nuggets,1,0,1610612757,Portland Trail Blazers,0,1,31,39,70,2,17,19,33,56,89,28,11,39,17,45,15,5,5,93,96
2018,4,41800237,5/12/2019,1610612757,Portland Trail Blazers,0,1,1610612743,Denver Nuggets,1,0,34,33,67,4,22,26,38,55,93,20,4,24,16,42,16,1,4,94,100
2018,4,41800236,5/9/2019,1610612743,Denver Nuggets,0,0,1610612757,Portland Trail Blazers,1,1,21,33,54,12,20,32,33,53,86,30,2,32,18,36,22,4,7,92,108
2018,4,41800236,5/9/2019,1610612757,Portland Trail Blazers,1,1,1610612743,Denver Nuggets,0,0,26,30,56,15,18,33,41,48,89,22,8,30,22,28,18,7,9,91,119
2018,4,41800235,5/7/2019,1610612743,Denver Nuggets,1,1,1610612757,Portland Trail Blazers,0,0,36,29,65,8,16,24,44,45,89,28,3,31,13,32,26,6,8,97,124
2018,4,41800235,5/7/2019,1610612757,Portland Trail Blazers,0,0,1610612743,Denver Nuggets,1,1,26,35,61,10,27,37,36,62,98,16,14,30,18,54,19,4,6,97,98
2018,4,41800234,5/5/2019,1610612743,Denver Nuggets,0,1,1610612757,Portland Trail Blazers,1,0,29,38,67,11,14,25,40,52,92,25,3,28,22,32,21,4,10,95,116
2018,4,41800234,5/5/2019,1610612757,Portland Trail Blazers,1,0,1610612743,Denver Nuggets,0,1,27,27,54,12,16,28,39,43,82,22,6,28,16,29,18,7,14,95,112
2018,4,41800233,5/3/2019,1610612743,Denver Nuggets,0,0,1610612757,Portland Trail Blazers,1,1,39,38,77,15,27,42,54,65,119,14,6,20,28,39,28,13,21,122,137
2018,4,41800233,5/3/2019,1610612757,Portland Trail Blazers,1,1,1610612743,Denver Nuggets,0,0,40,42,82,12,30,42,52,72,124,24,4,28,31,44,23,11,14,123,140
2012,4,41200131,4/20/2013,1610612741,Chicago Bulls,0,0,1610612751,Brooklyn Nets,1,1,34,34,68,2,6,8,36,40,76,15,7,22,10,34,15,6,10,86,89
2012,4,41200131,4/20/2013,1610612751,Brooklyn Nets,1,1,1610612741,Chicago Bulls,0,0,37,26,63,6,8,14,43,34,77,14,3,17,6,29,18,4,8,86,106
2012,4,41200126,5/3/2013,1610612737,Atlanta Hawks,1,0,1610612754,Indiana Pacers,0,1,23,36,59,3,16,19,26,52,78,18,2,20,5,49,12,7,10,93,73
2012,4,41200126,5/3/2013,1610612754,Indiana Pacers,0,1,1610612737,Atlanta Hawks,1,0,29,32,61,3,12,15,32,44,76,14,7,21,10,38,17,5,16,93,81
2012,4,41200125,5/1/2013,1610612737,Atlanta Hawks,0,0,1610612754,Indiana Pacers,1,1,22,39,61,3,11,14,25,50,75,30,7,37,9,44,14,2,6,93,83
2012,4,41200125,5/1/2013,1610612754,Indiana Pacers,1,1,1610612737,Atlanta Hawks,0,0,28,22,50,7,12,19,35,34,69,29,6,35,10,26,24,6,17,92,106
2012,4,41200124,4/29/2013,1610612737,Atlanta Hawks,1,1,1610612754,Indiana Pacers,0,0,22,28,50,11,13,24,33,41,74,25,13,38,13,32,24,8,13,94,102
2012,4,41200124,4/29/2013,1610612754,Indiana Pacers,0,0,1610612737,Atlanta Hawks,1,1,25,36,61,7,16,23,32,52,84,20,5,25,17,36,22,10,14,94,91
2018,4,41800232,5/1/2019,1610612743,Denver Nuggets,1,0,1610612757,Portland Trail Blazers,0,1,28,41,69,6,23,29,34,64,98,16,10,26,27,43,20,5,9,92,90
2018,4,41800232,5/1/2019,1610612757,Portland Trail Blazers,0,1,1610612743,Denver Nuggets,1,0,27,29,56,9,20,29,36,49,85,16,4,20,14,38,18,6,11,93,97
2018,4,41800231,4/29/2019,1610612743,Denver Nuggets,1,1,1610612757,Portland Trail Blazers,0,0,29,23,52,12,17,29,41,40,81,27,4,31,10,32,22,6,13,98,121
2018,4,41800231,4/29/2019,1610612757,Portland Trail Blazers,0,0,1610612743,Denver Nuggets,1,1,30,20,50,11,18,29,41,38,79,20,7,27,11,30,20,12,18,98,113
2018,4,41800226,5/10/2019,1610612744,Golden State Warriors,0,1,1610612745,Houston Rockets,1,0,26,21,47,16,22,38,42,43,85,18,5,23,17,28,25,9,17,97,118
2018,4,41800226,5/10/2019,1610612745,Houston Rockets,1,0,1610612744,Golden State Warriors,0,1,25,25,50,17,22,39,42,47,89,12,5,17,18,30,21,9,17,97,113
2012,4,41200123,4/27/2013,1610612737,Atlanta Hawks,1,1,1610612754,Indiana Pacers,0,0,31,36,67,4,11,15,35,47,82,16,12,28,14,38,17,6,14,95,90
2012,4,41200123,4/27/2013,1610612754,Indiana Pacers,0,0,1610612737,Atlanta Hawks,1,1,18,38,56,4,21,25,22,59,81,21,7,28,23,37,10,11,22,95,69
2012,4,41200121,4/21/2013,1610612737,Atlanta Hawks,0,0,1610612754,Indiana Pacers,1,1,31,28,59,7,10,17,38,38,76,7,7,14,8,34,23,8,16,90,90
2012,4,41200121,4/21/2013,1610612754,Indiana Pacers,1,1,1610612737,Atlanta Hawks,0,0,28,31,59,7,12,19,35,43,78,30,4,34,18,29,23,5,14,91,107
2012,4,41200122,4/24/2013,1610612737,Atlanta Hawks,0,0,1610612754,Indiana Pacers,1,1,30,26,56,9,14,23,39,40,79,11,9,20,11,33,25,10,14,91,98
2012,4,41200122,4/24/2013,1610612754,Indiana Pacers,1,1,1610612737,Atlanta Hawks,0,0,31,31,62,10,15,25,41,46,87,21,8,29,17,32,22,7,10,92,113
2016,4,41600405,6/12/2017,1610612739,Cleveland Cavaliers,0,0,1610612744,Golden State Warriors,1,1,36,28,64,11,13,24,47,41,88,15,8,23,14,33,22,8,15,98,120
2016,4,41600405,6/12/2017,1610612744,Golden State Warriors,1,1,1610612739,Cleveland Cavaliers,0,0,32,20,52,14,24,38,46,44,90,23,5,28,18,29,27,6,13,98,129
2016,4,41600404,6/9/2017,1610612739,Cleveland Cavaliers,1,1,1610612744,Golden State Warriors,0,0,22,20,42,24,21,45,46,41,87,21,10,31,17,27,27,5,11,96,137
2016,4,41600404,6/9/2017,1610612744,Golden State Warriors,0,0,1610612739,Cleveland Cavaliers,1,1,28,20,48,11,28,39,39,48,87,27,9,36,20,33,26,6,12,98,116
2016,4,41600403,6/7/2017,1610612739,Cleveland Cavaliers,1,0,1610612744,Golden State Warriors,0,1,28,18,46,12,32,44,40,50,90,21,4,25,14,39,17,8,12,100,113
2016,4,41600403,6/7/2017,1610612744,Golden State Warriors,0,1,1610612739,Cleveland Cavaliers,1,0,24,26,50,16,17,33,40,43,83,22,2,24,14,30,29,9,18,98,118
2016,4,41600402,6/4/2017,1610612739,Cleveland Cavaliers,0,0,1610612744,Golden State Warriors,1,1,37,34,71,8,21,29,45,55,100,15,4,19,11,46,27,5,9,106,113
2016,4,41600402,6/4/2017,1610612744,Golden State Warriors,1,1,1610612739,Cleveland Cavaliers,0,0,28,18,46,18,25,43,46,43,89,22,2,24,12,32,34,15,20,107,132
2016,4,41600401,6/1/2017,1610612739,Cleveland Cavaliers,0,0,1610612744,Golden State Warriors,1,1,19,36,55,11,20,31,30,56,86,20,5,25,18,40,15,12,20,100,91
2016,4,41600401,6/1/2017,1610612744,Golden State Warriors,1,1,1610612739,Cleveland Cavaliers,0,0,33,40,73,12,21,33,45,61,106,11,5,16,18,46,31,0,4,101,113
2012,4,41200115,5/1/2013,1610612738,Boston Celtics,0,1,1610612752,New York Knicks,1,0,21,27,48,11,11,22,32,38,70,17,0,17,7,31,20,8,17,89,92
2012,4,41200115,5/1/2013,1610612752,New York Knicks,1,0,1610612738,Boston Celtics,0,1,27,32,59,5,17,22,32,49,81,17,3,20,12,40,13,3,9,90,86
2016,4,41600314,5/22/2017,1610612744,Golden State Warriors,0,1,1610612759,San Antonio Spurs,1,0,34,13,47,14,25,39,48,38,86,19,6,25,8,31,30,14,17,107,129
2016,4,41600314,5/22/2017,1610612759,San Antonio Spurs,1,0,1610612744,Golden State Warriors,0,1,33,40,73,8,17,25,41,57,98,25,7,32,13,49,33,7,8,107,115
2016,4,41600313,5/20/2017,1610612744,Golden State Warriors,0,1,1610612759,San Antonio Spurs,1,0,35,22,57,11,16,27,46,38,84,17,5,22,10,31,23,10,21,104,120
2016,4,41600313,5/20/2017,1610612759,San Antonio Spurs,1,0,1610612744,Golden State Warriors,0,1,39,33,72,5,16,21,44,49,93,15,10,25,18,37,22,12,16,104,108
2012,4,41200114,4/28/2013,1610612738,Boston Celtics,1,1,1610612752,New York Knicks,0,0,26,28,54,8,14,22,34,42,76,21,3,24,4,40,22,10,16,101,97
2012,4,41200114,4/28/2013,1610612752,New York Knicks,0,0,1610612738,Boston Celtics,1,1,24,36,60,7,23,30,31,59,90,21,7,28,20,41,10,7,16,99,90
2016,4,41600312,5/16/2017,1610612744,Golden State Warriors,1,1,1610612759,San Antonio Spurs,0,0,32,20,52,18,19,37,50,39,89,18,1,19,12,28,39,11,16,102,136
2016,4,41600312,5/16/2017,1610612759,San Antonio Spurs,0,0,1610612744,Golden State Warriors,1,1,29,48,77,8,15,23,37,63,100,18,3,21,27,39,21,16,19,102,100
2016,4,41600311,5/14/2017,1610612744,Golden State Warriors,1,1,1610612759,San Antonio Spurs,0,0,28,23,51,11,19,30,39,42,81,24,9,33,20,26,22,13,19,98,113
2016,4,41600311,5/14/2017,1610612759,San Antonio Spurs,0,0,1610612744,Golden State Warriors,1,1,33,29,62,7,15,22,40,44,84,24,4,28,17,30,19,13,19,98,111
2012,4,41200116,5/3/2013,1610612738,Boston Celtics,1,0,1610612752,New York Knicks,0,1,18,23,41,6,16,22,24,39,63,26,7,33,12,29,13,10,20,89,80
2012,4,41200116,5/3/2013,1610612752,New York Knicks,0,1,1610612738,Boston Celtics,1,0,24,34,58,9,12,21,33,46,79,13,3,16,15,31,18,9,17,87,88
2016,4,41600305,5/25/2017,1610612738,Boston Celtics,1,0,1610612739,Cleveland Cavaliers,0,1,26,30,56,11,19,30,37,49,86,17,6,23,17,34,20,13,18,98,102
2016,4,41600305,5/25/2017,1610612739,Cleveland Cavaliers,0,1,1610612738,Boston Celtics,1,0,29,15,44,19,22,41,48,37,85,20,4,24,8,31,24,7,11,96,135
2016,4,41600304,5/23/2017,1610612738,Boston Celtics,0,0,1610612739,Cleveland Cavaliers,1,1,25,23,48,10,21,31,35,44,79,19,1,20,10,34,26,5,12,91,99
2016,4,41600304,5/23/2017,1610612739,Cleveland Cavaliers,1,1,1610612738,Boston Celtics,0,0,34,18,52,10,12,22,44,30,74,14,3,17,7,25,23,7,15,92,112
2016,4,41600303,5/21/2017,1610612738,Boston Celtics,0,1,1610612739,Cleveland Cavaliers,1,0,24,27,51,18,22,40,42,49,91,9,3,12,13,37,28,5,9,92,111
2016,4,41600303,5/21/2017,1610612739,Cleveland Cavaliers,1,0,1610612738,Boston Celtics,0,1,16,15,31,16,23,39,32,38,70,28,8,36,13,30,21,10,16,91,108
2016,4,41600302,5/19/2017,1610612738,Boston Celtics,1,0,1610612739,Cleveland Cavaliers,0,1,24,35,59,8,19,27,32,54,86,14,1,15,17,38,23,10,21,98,86
2016,4,41600302,5/19/2017,1610612739,Cleveland Cavaliers,0,1,1610612738,Boston Celtics,1,0,29,17,46,19,20,39,48,37,85,15,8,23,10,31,28,7,12,98,130
2016,4,41600301,5/17/2017,1610612738,Boston Celtics,1,0,1610612739,Cleveland Cavaliers,0,1,29,21,50,12,26,38,41,47,88,10,8,18,17,36,33,9,14,92,104
2016,4,41600301,5/17/2017,1610612739,Cleveland Cavaliers,0,1,1610612738,Boston Celtics,1,0,28,22,50,11,20,31,39,42,81,28,7,35,14,32,21,4,8,91,117
2016,4,41600236,5/11/2017,1610612745,Houston Rockets,1,0,1610612759,San Antonio Spurs,0,1,9,28,37,13,27,40,22,55,77,18,7,25,11,48,14,8,14,92,75
2016,4,41600236,5/11/2017,1610612759,San Antonio Spurs,0,1,1610612745,Houston Rockets,1,0,46,28,74,5,17,22,51,45,96,7,6,13,18,30,32,5,8,94,114
2012,4,41200113,4/26/2013,1610612738,Boston Celtics,1,0,1610612752,New York Knicks,0,1,22,29,51,6,13,19,28,42,70,14,4,18,15,31,14,14,18,82,76
2012,4,41200113,4/26/2013,1610612752,New York Knicks,0,1,1610612738,Boston Celtics,1,0,27,22,49,11,16,27,38,38,76,3,5,8,8,32,22,6,11,82,90
2016,4,41600235,5/9/2017,1610612745,Houston Rockets,0,0,1610612759,San Antonio Spurs,1,1,22,16,38,16,32,48,38,48,86,15,6,21,16,36,21,7,16,98,107
2016,4,41600235,5/9/2017,1610612759,San Antonio Spurs,1,1,1610612745,Houston Rockets,0,0,31,39,70,11,22,33,42,61,103,15,8,23,24,40,24,4,8,97,110
2016,4,41600234,5/7/2017,1610612745,Houston Rockets,1,1,1610612759,San Antonio Spurs,0,0,31,14,45,19,24,43,50,38,88,6,4,10,13,35,28,8,9,97,125
2016,4,41600234,5/7/2017,1610612759,San Antonio Spurs,0,0,1610612745,Houston Rockets,1,1,37,27,64,7,16,23,44,43,87,9,9,18,14,36,23,7,14,96,104
2012,4,41200112,4/23/2013,1610612738,Boston Celtics,0,0,1610612752,New York Knicks,1,1,21,30,51,5,14,19,26,44,70,14,4,18,6,39,14,5,12,84,71
2012,4,41200112,4/23/2013,1610612752,New York Knicks,1,1,1610612738,Boston Celtics,0,0,25,32,57,7,12,19,32,44,76,16,6,22,13,35,14,3,11,85,87
2016,4,41600233,5/5/2017,1610612745,Houston Rockets,1,0,1610612759,San Antonio Spurs,0,1,20,29,49,12,27,39,32,56,88,16,2,18,17,41,17,7,15,96,92
2016,4,41600233,5/5/2017,1610612759,San Antonio Spurs,0,1,1610612745,Houston Rockets,1,0,30,31,61,9,16,25,39,47,86,16,4,20,20,28,23,12,21,97,103
2016,4,41600232,5/3/2017,1610612745,Houston Rockets,0,0,1610612759,San Antonio Spurs,1,1,26,23,49,11,23,34,37,46,83,11,4,15,13,35,22,5,11,87,96
2016,4,41600232,5/3/2017,1610612759,San Antonio Spurs,1,1,1610612745,Houston Rockets,0,0,39,26,65,9,15,24,48,41,89,16,2,18,17,24,27,7,8,89,121
2016,4,41600231,5/1/2017,1610612745,Houston Rockets,0,1,1610612759,San Antonio Spurs,1,0,18,19,37,22,28,50,40,47,87,24,3,27,10,37,30,10,15,104,126
2016,4,41600231,5/1/2017,1610612759,San Antonio Spurs,1,0,1610612745,Houston Rockets,0,1,22,33,55,9,20,29,31,53,84,28,8,36,13,43,19,13,15,104,99
2016,4,41600224,5/8/2017,1610612744,Golden State Warriors,0,1,1610612762,Utah Jazz,1,0,32,26,58,11,15,26,43,41,84,24,3,27,9,33,28,7,11,99,121
2016,4,41600224,5/8/2017,1610612762,Utah Jazz,1,0,1610612744,Golden State Warriors,0,1,25,37,62,8,19,27,33,56,89,21,7,28,14,47,13,8,10,99,95
2016,4,41600223,5/6/2017,1610612744,Golden State Warriors,0,1,1610612762,Utah Jazz,1,0,28,26,54,9,21,30,37,47,84,19,4,23,10,40,17,6,7,94,102
2016,4,41600223,5/6/2017,1610612762,Utah Jazz,1,0,1610612744,Golden State Warriors,0,1,23,32,55,7,15,22,30,47,77,24,10,34,8,45,19,3,9,93,91
2012,4,41200111,4/20/2013,1610612738,Boston Celtics,0,0,1610612752,New York Knicks,1,1,22,23,45,5,15,20,27,38,65,19,0,19,6,32,18,15,21,89,78
2012,4,41200111,4/20/2013,1610612752,New York Knicks,1,1,1610612738,Boston Celtics,0,0,23,31,54,9,16,25,32,47,79,12,3,15,10,38,13,5,13,88,85
2016,4,41600222,5/4/2017,1610612744,Golden State Warriors,1,1,1610612762,Utah Jazz,0,0,28,26,54,14,17,31,42,43,85,17,3,20,10,36,33,9,17,101,115
2016,4,41600222,5/4/2017,1610612762,Utah Jazz,0,0,1610612744,Golden State Warriors,1,1,26,26,52,12,20,32,38,46,84,16,4,20,7,40,19,11,15,101,104
2016,4,41600221,5/2/2017,1610612744,Golden State Warriors,1,1,1610612762,Utah Jazz,0,0,33,20,53,7,22,29,40,42,82,19,2,21,7,36,32,7,7,91,106
2016,4,41600221,5/2/2017,1610612762,Utah Jazz,0,0,1610612744,Golden State Warriors,1,1,29,24,53,9,20,29,38,44,82,9,3,12,11,34,25,7,14,90,94
2016,4,41600214,5/7/2017,1610612739,Cleveland Cavaliers,0,1,1610612761,Toronto Raptors,1,0,23,14,37,16,25,41,39,39,78,15,1,16,10,33,24,7,11,92,109
2016,4,41600214,5/7/2017,1610612761,Toronto Raptors,1,0,1610612739,Cleveland Cavaliers,0,1,30,24,54,10,19,29,40,43,83,12,3,15,12,34,28,8,12,92,102
2016,4,41600213,5/5/2017,1610612739,Cleveland Cavaliers,0,1,1610612761,Toronto Raptors,1,0,26,27,53,13,10,23,39,37,76,24,4,28,11,27,15,9,16,95,115
2016,4,41600213,5/5/2017,1610612761,Toronto Raptors,1,0,1610612739,Cleveland Cavaliers,0,1,36,33,69,2,16,18,38,49,87,16,1,17,6,44,17,2,6,94,94
2016,4,41600212,5/3/2017,1610612739,Cleveland Cavaliers,1,1,1610612761,Toronto Raptors,0,0,23,19,42,18,15,33,41,34,75,25,9,34,9,31,28,8,16,96,125
2016,4,41600212,5/3/2017,1610612761,Toronto Raptors,0,0,1610612739,Cleveland Cavaliers,1,1,37,36,73,5,12,17,42,48,90,14,5,19,14,35,21,9,13,98,103
2016,4,41600211,5/1/2017,1610612739,Cleveland Cavaliers,1,1,1610612761,Toronto Raptors,0,0,25,26,51,14,20,34,39,46,85,24,5,29,10,38,26,5,12,99,116
2016,4,41600211,5/1/2017,1610612761,Toronto Raptors,0,0,1610612739,Cleveland Cavaliers,1,1,29,34,63,10,16,26,39,50,89,17,3,20,10,40,22,8,12,100,105
2016,4,41600207,5/15/2017,1610612738,Boston Celtics,1,1,1610612764,Washington Wizards,0,0,31,24,55,11,13,24,42,37,79,20,5,25,5,35,27,6,8,93,115
2016,4,41600207,5/15/2017,1610612764,Washington Wizards,0,0,1610612738,Boston Celtics,1,1,26,25,51,10,19,29,36,44,80,23,6,29,15,32,18,7,15,93,105
2016,4,41600206,5/12/2017,1610612738,Boston Celtics,0,0,1610612764,Washington Wizards,1,1,21,23,44,11,24,35,32,47,79,16,2,18,9,38,25,4,11,91,91
2016,4,41600206,5/12/2017,1610612764,Washington Wizards,1,1,1610612738,Boston Celtics,0,0,32,30,62,5,19,24,37,49,86,13,8,21,17,36,20,5,12,91,92
2016,4,41600205,5/10/2017,1610612738,Boston Celtics,1,1,1610612764,Washington Wizards,0,0,30,24,54,16,17,33,46,41,87,15,6,21,13,33,33,5,12,96,123
2016,4,41600205,5/10/2017,1610612764,Washington Wizards,0,0,1610612738,Boston Celtics,1,1,28,34,62,7,22,29,35,56,91,24,5,29,21,39,21,7,13,96,101
2016,4,41600204,5/7/2017,1610612738,Boston Celtics,0,0,1610612764,Washington Wizards,1,1,21,27,48,14,17,31,35,44,79,18,6,24,11,36,28,13,20,100,102
2016,4,41600204,5/7/2017,1610612764,Washington Wizards,1,1,1610612738,Boston Celtics,0,0,35,28,63,9,12,21,44,40,84,24,3,27,16,25,29,13,20,100,121
2016,4,41600203,5/4/2017,1610612738,Boston Celtics,0,0,1610612764,Washington Wizards,1,1,17,28,45,10,22,32,27,50,77,25,8,33,12,40,20,7,16,95,89
2016,4,41600203,5/4/2017,1610612764,Washington Wizards,1,1,1610612738,Boston Celtics,0,0,35,32,67,8,17,25,43,49,92,22,3,25,17,32,26,4,10,97,116
2016,4,41600202,5/2/2017,1610612738,Boston Celtics,1,1,1610612764,Washington Wizards,0,0,32,20,52,13,23,36,45,43,88,26,8,34,14,34,26,7,16,105,129
2016,4,41600202,5/2/2017,1610612764,Washington Wizards,0,0,1610612738,Boston Celtics,1,1,36,29,65,10,24,34,46,53,99,17,5,22,21,36,28,11,18,108,119
2016,4,41600201,4/30/2017,1610612738,Boston Celtics,1,1,1610612764,Washington Wizards,0,0,27,24,51,19,20,39,46,44,90,12,3,15,15,32,32,6,11,93,123
2016,4,41600201,4/30/2017,1610612764,Washington Wizards,0,0,1610612738,Boston Celtics,1,1,34,30,64,10,13,23,44,43,87,13,9,22,19,28,27,8,13,93,111
2016,4,41600177,4/30/2017,1610612746,LA Clippers,1,0,1610612762,Utah Jazz,0,1,29,26,55,6,19,25,35,45,80,15,11,26,13,39,17,7,11,89,91
2016,4,41600177,4/30/2017,1610612762,Utah Jazz,0,1,1610612746,LA Clippers,1,0,34,32,66,6,7,13,40,39,79,18,5,23,11,31,22,4,13,88,104
2016,4,41600176,4/28/2017,1610612746,LA Clippers,0,1,1610612762,Utah Jazz,1,0,28,26,54,9,12,21,37,38,75,15,11,26,13,31,17,8,16,89,98
2016,4,41600176,4/28/2017,1610612762,Utah Jazz,1,0,1610612746,LA Clippers,0,1,25,27,52,7,19,26,32,46,78,22,11,33,14,37,18,5,8,89,93
2016,4,41600175,4/25/2017,1610612746,LA Clippers,1,0,1610612762,Utah Jazz,0,1,19,27,46,10,13,23,29,40,69,24,5,29,6,36,16,10,14,91,92
2016,4,41600175,4/25/2017,1610612762,Utah Jazz,0,1,1610612746,LA Clippers,1,0,22,23,45,13,23,36,35,46,81,13,3,16,11,35,25,7,14,92,96
2016,4,41600174,4/23/2017,1610612746,LA Clippers,0,0,1610612762,Utah Jazz,1,1,22,21,43,11,21,32,33,42,75,21,8,29,9,37,17,7,9,91,98
2016,4,41600174,4/23/2017,1610612762,Utah Jazz,1,1,1610612746,LA Clippers,0,0,30,22,52,10,12,22,40,34,74,15,6,21,8,27,24,8,13,89,105
2016,4,41600173,4/21/2017,1610612746,LA Clippers,0,1,1610612762,Utah Jazz,1,0,34,22,56,7,12,19,41,34,75,22,11,33,11,27,16,5,8,89,111
2016,4,41600173,4/21/2017,1610612762,Utah Jazz,1,0,1610612746,LA Clippers,0,1,22,13,35,14,20,34,36,33,69,20,9,29,4,32,16,8,11,89,106
2016,4,41600172,4/18/2017,1610612746,LA Clippers,1,1,1610612762,Utah Jazz,0,0,38,24,62,6,13,19,44,37,81,5,3,8,11,31,26,7,11,89,99
2016,4,41600172,4/18/2017,1610612762,Utah Jazz,0,0,1610612746,LA Clippers,1,1,22,23,45,10,14,24,32,37,69,17,5,22,5,35,15,7,14,88,91
2016,4,41600171,4/15/2017,1610612746,LA Clippers,1,0,1610612762,Utah Jazz,0,1,28,29,57,8,16,24,36,45,81,15,2,17,15,31,20,7,15,89,95
2016,4,41600171,4/15/2017,1610612762,Utah Jazz,0,1,1610612746,LA Clippers,1,0,30,30,60,8,11,19,38,41,79,13,6,19,11,33,21,6,13,89,97
2016,4,41600165,4/25/2017,1610612745,Houston Rockets,1,1,1610612760,Oklahoma City Thunder,0,0,27,18,45,6,31,37,33,49,82,33,6,39,17,34,13,7,14,98,105
2016,4,41600165,4/25/2017,1610612760,Oklahoma City Thunder,0,0,1610612745,Houston Rockets,1,1,25,28,53,10,28,38,35,56,91,19,10,29,22,39,16,7,14,98,99
2016,4,41600164,4/23/2017,1610612745,Houston Rockets,0,1,1610612760,Oklahoma City Thunder,1,0,26,24,50,11,24,35,37,48,85,28,5,33,17,33,19,10,20,103,113
2016,4,41600164,4/23/2017,1610612760,Oklahoma City Thunder,1,0,1610612745,Houston Rockets,0,1,35,31,66,7,12,19,42,43,85,18,14,32,15,36,20,13,17,102,109
2016,4,41600163,4/21/2017,1610612745,Houston Rockets,0,0,1610612760,Oklahoma City Thunder,1,1,28,20,48,10,25,35,38,45,83,27,6,33,16,34,10,8,16,97,113
2016,4,41600163,4/21/2017,1610612760,Oklahoma City Thunder,1,1,1610612745,Houston Rockets,0,0,37,27,64,9,10,19,46,37,83,14,9,23,9,32,24,4,11,96,115
2016,4,41600162,4/19/2017,1610612745,Houston Rockets,1,1,1610612760,Oklahoma City Thunder,0,0,27,22,49,11,18,29,38,40,78,28,9,37,11,33,20,9,13,98,115
2016,4,41600162,4/19/2017,1610612760,Oklahoma City Thunder,0,0,1610612745,Houston Rockets,1,1,33,34,67,7,23,30,40,57,97,24,4,28,22,37,20,5,7,98,111
2016,4,41600161,4/16/2017,1610612745,Houston Rockets,1,1,1610612760,Oklahoma City Thunder,0,0,35,23,58,10,23,33,45,46,91,18,8,26,16,35,21,8,11,96,118
2016,4,41600161,4/16/2017,1610612760,Oklahoma City Thunder,0,0,1610612745,Houston Rockets,1,1,21,31,52,9,20,29,30,51,81,18,5,23,10,43,19,8,15,97,87
2016,4,41600156,4/27/2017,1610612759,San Antonio Spurs,0,1,1610612763,Memphis Grizzlies,1,0,30,27,57,7,13,20,37,40,77,22,3,25,18,24,13,4,12,82,103
2016,4,41600156,4/27/2017,1610612763,Memphis Grizzlies,1,0,1610612759,San Antonio Spurs,0,1,20,24,44,12,15,27,32,39,71,20,4,24,9,32,15,4,11,83,96
2016,4,41600155,4/25/2017,1610612759,San Antonio Spurs,1,1,1610612763,Memphis Grizzlies,0,0,28,24,52,14,14,28,42,38,80,18,4,22,15,24,23,7,8,82,116
2016,4,41600155,4/25/2017,1610612763,Memphis Grizzlies,0,0,1610612759,San Antonio Spurs,1,1,28,22,50,9,13,22,37,35,72,20,2,22,10,25,22,7,10,80,103
2016,4,41600154,4/22/2017,1610612759,San Antonio Spurs,0,0,1610612763,Memphis Grizzlies,1,1,32,35,67,9,21,30,41,56,97,17,0,17,11,45,16,3,10,103,108
2016,4,41600154,4/22/2017,1610612763,Memphis Grizzlies,1,1,1610612759,San Antonio Spurs,0,0,26,29,55,12,15,27,38,44,82,22,2,24,12,33,19,11,23,104,110
2012,4,41200104,4/28/2013,1610612748,Miami Heat,0,1,1610612749,Milwaukee Bucks,1,0,27,20,47,7,19,26,34,39,73,13,6,19,14,26,24,7,16,84,88
2016,4,41600153,4/20/2017,1610612759,San Antonio Spurs,0,0,1610612763,Memphis Grizzlies,1,1,24,24,48,10,14,24,34,38,72,16,12,28,14,29,16,2,12,83,94
2016,4,41600153,4/20/2017,1610612763,Memphis Grizzlies,1,1,1610612759,San Antonio Spurs,0,0,30,25,55,9,13,22,39,38,77,18,2,20,8,32,21,1,5,83,105
2016,4,41600152,4/17/2017,1610612759,San Antonio Spurs,1,1,1610612763,Memphis Grizzlies,0,0,19,19,38,9,14,23,28,33,61,31,1,32,7,26,14,8,16,84,96
2016,4,41600152,4/17/2017,1610612763,Memphis Grizzlies,0,0,1610612759,San Antonio Spurs,1,1,24,31,55,7,20,27,31,51,82,13,2,15,15,36,19,4,10,84,82
2016,4,41600151,4/15/2017,1610612759,San Antonio Spurs,1,1,1610612763,Memphis Grizzlies,0,0,31,26,57,10,9,19,41,35,76,19,6,25,12,28,16,7,10,86,111
2016,4,41600151,4/15/2017,1610612763,Memphis Grizzlies,0,0,1610612759,San Antonio Spurs,1,1,24,35,59,7,13,20,31,48,79,13,4,17,10,38,17,4,9,87,82
2016,4,41600144,4/24/2017,1610612744,Golden State Warriors,0,1,1610612757,Portland Trail Blazers,1,0,29,24,53,17,10,27,46,34,80,19,8,27,9,35,27,7,10,100,128
2016,4,41600144,4/24/2017,1610612757,Portland Trail Blazers,1,0,1610612744,Golden State Warriors,0,1,20,22,42,13,25,38,33,47,80,24,5,29,11,43,14,7,11,100,103
2016,4,41600143,4/22/2017,1610612744,Golden State Warriors,0,1,1610612757,Portland Trail Blazers,1,0,28,27,55,12,24,36,40,51,91,27,8,35,12,44,25,5,7,103,119
2016,4,41600143,4/22/2017,1610612757,Portland Trail Blazers,1,0,1610612744,Golden State Warriors,0,1,26,31,57,13,20,33,39,51,90,22,5,27,16,37,17,11,16,103,113
2016,4,41600142,4/19/2017,1610612744,Golden State Warriors,1,1,1610612757,Portland Trail Blazers,0,0,30,28,58,10,22,32,40,50,90,20,4,24,18,36,31,9,17,102,110
2016,4,41600142,4/19/2017,1610612757,Portland Trail Blazers,0,0,1610612744,Golden State Warriors,1,1,23,32,55,7,27,34,30,59,89,14,5,19,16,47,17,8,19,101,81
2016,4,41600141,4/16/2017,1610612744,Golden State Warriors,1,1,1610612757,Portland Trail Blazers,0,0,32,22,54,11,16,27,43,38,81,24,4,28,12,28,26,8,16,98,121
2016,4,41600141,4/16/2017,1610612757,Portland Trail Blazers,0,0,1610612744,Golden State Warriors,1,1,29,34,63,11,19,30,40,53,93,18,4,22,17,39,15,7,15,100,109
2016,4,41600136,4/28/2017,1610612737,Atlanta Hawks,1,0,1610612764,Washington Wizards,0,1,28,18,46,9,23,32,37,41,78,16,3,19,15,27,26,16,22,95,99
2016,4,41600136,4/28/2017,1610612764,Washington Wizards,0,1,1610612737,Atlanta Hawks,1,0,32,22,54,10,14,24,42,36,78,21,4,25,12,27,21,9,17,95,115
2016,4,41600135,4/26/2017,1610612737,Atlanta Hawks,0,0,1610612764,Washington Wizards,1,1,29,33,62,9,22,31,38,55,93,14,7,21,22,35,23,8,11,93,99
2016,4,41600135,4/26/2017,1610612764,Washington Wizards,1,1,1610612737,Atlanta Hawks,0,0,30,28,58,7,17,24,37,45,82,22,5,27,11,35,21,3,7,91,103
2016,4,41600134,4/24/2017,1610612737,Atlanta Hawks,1,1,1610612764,Washington Wizards,0,0,28,31,59,12,19,31,40,50,90,19,6,25,15,38,24,7,12,96,111
2016,4,41600134,4/24/2017,1610612764,Washington Wizards,0,0,1610612737,Atlanta Hawks,1,1,25,28,53,11,21,32,36,49,85,18,5,23,12,40,19,7,15,98,101
2016,4,41600133,4/22/2017,1610612737,Atlanta Hawks,1,1,1610612764,Washington Wizards,0,0,35,29,64,9,16,25,44,45,89,19,13,32,11,39,26,6,12,103,116
2016,4,41600133,4/22/2017,1610612764,Washington Wizards,0,0,1610612737,Atlanta Hawks,1,1,30,30,60,7,22,29,37,52,89,17,3,20,10,43,16,6,16,105,98
2016,4,41600132,4/19/2017,1610612737,Atlanta Hawks,0,0,1610612764,Washington Wizards,1,1,28,31,59,4,16,20,32,47,79,33,5,38,15,36,17,10,18,99,101
2016,4,41600132,4/19/2017,1610612764,Washington Wizards,1,1,1610612737,Atlanta Hawks,0,0,32,32,64,7,15,22,39,47,86,24,9,33,15,36,22,6,11,99,109
2016,4,41600131,4/16/2017,1610612737,Atlanta Hawks,0,0,1610612764,Washington Wizards,1,1,27,26,53,7,18,25,34,44,78,32,7,39,19,27,18,8,21,99,107
2016,4,41600131,4/16/2017,1610612764,Washington Wizards,1,1,1610612737,Atlanta Hawks,0,0,37,35,72,8,20,28,45,55,100,16,1,17,20,36,28,5,12,98,114
2016,4,41600126,4/27/2017,1610612749,Milwaukee Bucks,1,0,1610612761,Toronto Raptors,0,1,25,32,57,7,11,18,32,43,75,18,10,28,17,33,18,9,14,85,89
2016,4,41600126,4/27/2017,1610612761,Toronto Raptors,0,1,1610612749,Milwaukee Bucks,1,0,23,25,48,9,13,22,32,38,70,19,4,23,13,28,14,11,15,83,92
2016,4,41600125,4/24/2017,1610612749,Milwaukee Bucks,0,0,1610612761,Toronto Raptors,1,1,24,17,41,10,11,21,34,28,62,15,11,26,4,36,22,10,15,91,93
2016,4,41600125,4/24/2017,1610612761,Toronto Raptors,1,1,1610612749,Milwaukee Bucks,0,0,29,11,40,12,13,25,41,24,65,24,2,26,9,21,28,13,18,91,118
2012,4,41200104,4/28/2013,1610612749,Milwaukee Bucks,1,0,1610612748,Miami Heat,0,1,24,35,59,6,16,22,30,51,81,11,4,15,19,34,19,8,16,84,77
2016,4,41600124,4/22/2017,1610612749,Milwaukee Bucks,1,0,1610612761,Toronto Raptors,0,1,25,35,60,5,16,21,30,51,81,11,7,18,15,39,16,11,21,95,76
2016,4,41600124,4/22/2017,1610612761,Toronto Raptors,0,1,1610612749,Milwaukee Bucks,1,0,28,30,58,5,17,22,33,47,80,16,1,17,8,39,16,8,13,96,87
2016,4,41600123,4/20/2017,1610612749,Milwaukee Bucks,1,1,1610612761,Toronto Raptors,0,0,27,24,51,12,11,23,39,35,74,14,5,19,7,31,29,6,13,91,104
2016,4,41600123,4/20/2017,1610612761,Toronto Raptors,0,0,1610612749,Milwaukee Bucks,1,1,18,31,49,6,16,22,24,47,71,23,7,30,13,36,11,6,16,89,77
2016,4,41600122,4/18/2017,1610612749,Milwaukee Bucks,0,0,1610612761,Toronto Raptors,1,1,25,24,49,11,11,22,36,35,71,17,2,19,16,36,20,6,12,92,100
2016,4,41600122,4/18/2017,1610612761,Toronto Raptors,1,1,1610612749,Milwaukee Bucks,0,0,23,21,44,14,15,29,37,36,73,18,7,25,10,32,24,6,13,91,106
2016,4,41600121,4/15/2017,1610612749,Milwaukee Bucks,0,1,1610612761,Toronto Raptors,1,0,29,33,62,9,14,23,38,47,85,12,3,15,10,40,22,3,5,86,97
2016,4,41600121,4/15/2017,1610612761,Toronto Raptors,1,0,1610612749,Milwaukee Bucks,0,1,22,30,52,5,18,23,27,48,75,24,9,33,15,38,15,5,11,88,83
2016,4,41600114,4/23/2017,1610612739,Cleveland Cavaliers,0,1,1610612754,Indiana Pacers,1,0,28,31,59,9,22,31,37,53,90,23,4,27,19,36,11,8,13,96,106
2016,4,41600114,4/23/2017,1610612754,Indiana Pacers,1,0,1610612739,Cleveland Cavaliers,0,1,31,27,58,10,20,30,41,47,88,10,7,17,15,37,21,9,15,95,102
2016,4,41600113,4/20/2017,1610612739,Cleveland Cavaliers,0,1,1610612754,Indiana Pacers,1,0,18,25,43,21,23,44,39,48,87,20,10,30,15,39,23,4,8,92,119
2016,4,41600113,4/20/2017,1610612754,Indiana Pacers,1,0,1610612739,Cleveland Cavaliers,0,1,22,32,54,16,25,41,38,57,95,22,4,26,25,35,25,6,11,94,114
2016,4,41600112,4/17/2017,1610612739,Cleveland Cavaliers,1,1,1610612754,Indiana Pacers,0,0,29,16,45,13,18,31,42,34,76,20,3,23,9,26,19,14,19,97,117
2016,4,41600112,4/17/2017,1610612754,Indiana Pacers,0,0,1610612739,Cleveland Cavaliers,1,1,35,29,64,8,12,20,43,41,84,17,6,23,12,33,23,6,14,96,111
2016,4,41600111,4/15/2017,1610612739,Cleveland Cavaliers,1,1,1610612754,Indiana Pacers,0,0,31,19,50,11,17,28,42,36,78,14,13,27,11,32,26,6,11,90,109
2016,4,41600111,4/15/2017,1610612754,Indiana Pacers,0,0,1610612739,Cleveland Cavaliers,1,1,29,28,57,11,13,24,40,41,81,17,3,20,15,26,21,7,13,90,108
2016,4,41600106,4/28/2017,1610612738,Boston Celtics,0,1,1610612741,Chicago Bulls,1,0,23,18,41,16,23,39,39,41,80,11,7,18,7,37,28,5,10,92,105
2016,4,41600106,4/28/2017,1610612741,Chicago Bulls,1,0,1610612738,Boston Celtics,0,1,28,34,62,4,15,19,32,49,81,15,2,17,12,39,13,7,15,91,83
2016,4,41600105,4/26/2017,1610612738,Boston Celtics,1,1,1610612741,Chicago Bulls,0,0,29,19,48,9,31,40,38,50,88,23,0,23,11,39,27,4,6,92,108
2016,4,41600105,4/26/2017,1610612741,Chicago Bulls,0,0,1610612738,Boston Celtics,1,1,28,20,48,9,17,26,37,37,74,14,3,17,5,34,24,9,16,93,97
2016,4,41600104,4/23/2017,1610612738,Boston Celtics,0,1,1610612741,Chicago Bulls,1,0,28,17,45,10,27,37,38,44,82,18,4,22,14,33,22,5,13,90,104
2016,4,41600104,4/23/2017,1610612741,Chicago Bulls,1,0,1610612738,Boston Celtics,0,1,27,25,52,5,19,24,32,44,76,26,7,33,14,34,19,7,12,90,95
2016,4,41600103,4/21/2017,1610612738,Boston Celtics,0,1,1610612741,Chicago Bulls,1,0,24,25,49,17,20,37,41,45,86,5,2,7,10,37,34,7,13,92,104
2016,4,41600103,4/21/2017,1610612741,Chicago Bulls,1,0,1610612738,Boston Celtics,0,1,27,36,63,6,15,21,33,51,84,15,0,15,18,33,14,11,18,93,87
2016,4,41600102,4/18/2017,1610612738,Boston Celtics,1,0,1610612741,Chicago Bulls,0,1,28,21,49,10,23,33,38,44,82,11,8,19,15,34,26,12,16,96,97
2016,4,41600102,4/18/2017,1610612741,Chicago Bulls,0,1,1610612738,Boston Celtics,1,0,35,25,60,10,15,25,45,40,85,11,3,14,14,30,28,6,12,94,111
2016,4,41600101,4/16/2017,1610612738,Boston Celtics,1,0,1610612741,Chicago Bulls,0,1,23,25,48,14,24,38,37,49,86,14,5,19,16,35,27,10,16,95,102
2016,4,41600101,4/16/2017,1610612741,Chicago Bulls,0,1,1610612738,Boston Celtics,1,0,31,34,65,8,18,26,39,52,91,20,3,23,27,25,22,9,19,94,106
2015,4,41500153,4/22/2016,1610612759,San Antonio Spurs,0,1,1610612763,Memphis Grizzlies,1,0,23,28,51,12,14,26,35,42,77,14,5,19,9,35,24,4,11,87,96
2015,4,41500153,4/22/2016,1610612763,Memphis Grizzlies,1,0,1610612759,San Antonio Spurs,0,1,30,34,64,4,14,18,34,48,82,15,4,19,18,32,17,10,14,87,87
2015,4,41500145,4/27/2016,1610612744,Golden State Warriors,1,1,1610612745,Houston Rockets,0,0,32,19,51,13,18,31,45,37,82,11,8,19,6,33,30,8,10,93,114
2015,4,41500145,4/27/2016,1610612745,Houston Rockets,0,0,1610612744,Golden State Warriors,1,1,25,38,63,6,26,32,31,64,95,13,6,19,30,38,17,10,18,95,81
2012,4,41200103,4/25/2013,1610612748,Miami Heat,0,1,1610612749,Milwaukee Bucks,1,0,33,27,60,8,11,19,41,38,79,14,11,25,16,29,31,14,19,92,104
2012,4,41200103,4/25/2013,1610612749,Milwaukee Bucks,1,0,1610612748,Miami Heat,0,1,26,20,46,7,19,26,33,39,72,18,11,29,13,32,23,11,20,93,91
2018,4,41800225,5/8/2019,1610612744,Golden State Warriors,1,1,1610612745,Houston Rockets,0,0,26,22,48,13,24,37,39,46,85,13,5,18,16,34,28,10,15,94,104
2018,4,41800225,5/8/2019,1610612745,Houston Rockets,0,0,1610612744,Golden State Warriors,1,1,21,17,38,12,29,41,33,46,79,21,3,24,15,33,19,6,17,95,99
2012,4,41200101,4/21/2013,1610612748,Miami Heat,1,1,1610612749,Milwaukee Bucks,0,0,31,14,45,7,16,23,38,30,68,27,6,33,11,23,22,10,19,89,110
2012,4,41200101,4/21/2013,1610612749,Milwaukee Bucks,0,0,1610612748,Miami Heat,1,1,27,29,56,7,19,26,34,48,82,12,8,20,13,40,14,8,12,91,87
2012,4,41200102,4/23/2013,1610612748,Miami Heat,1,1,1610612749,Milwaukee Bucks,0,0,29,30,59,6,13,19,35,43,78,22,4,26,14,31,17,9,14,91,98
2012,4,41200102,4/23/2013,1610612749,Milwaukee Bucks,0,0,1610612748,Miami Heat,1,1,32,22,54,4,14,18,36,36,72,10,7,17,7,32,23,10,17,90,86
2018,4,41800224,5/6/2019,1610612744,Golden State Warriors,0,0,1610612745,Houston Rockets,1,1,34,23,57,8,25,33,42,48,90,16,7,23,15,38,24,6,11,99,108
2018,4,41800224,5/6/2019,1610612745,Houston Rockets,1,1,1610612744,Golden State Warriors,0,0,22,17,39,17,33,50,39,50,89,17,7,24,16,38,18,6,14,97,112
2018,4,41800223,5/4/2019,1610612744,Golden State Warriors,0,0,1610612745,Houston Rockets,1,1,28,34,62,14,19,33,42,53,95,23,6,29,15,41,27,4,8,102,121
2018,4,41800223,5/4/2019,1610612745,Houston Rockets,1,1,1610612744,Golden State Warriors,0,0,27,24,51,18,24,42,45,48,93,18,8,26,21,30,20,6,16,101,126
2018,4,41800222,4/30/2019,1610612744,Golden State Warriors,1,1,1610612745,Houston Rockets,0,0,31,24,55,11,25,36,42,49,91,20,4,24,21,31,24,5,12,94,115
2018,4,41800222,4/30/2019,1610612745,Houston Rockets,0,0,1610612744,Golden State Warriors,1,1,19,18,37,17,23,40,36,41,77,20,5,25,13,30,17,10,18,94,109
2018,4,41800221,4/28/2019,1610612744,Golden State Warriors,1,1,1610612745,Houston Rockets,0,0,31,22,53,7,15,22,38,37,75,21,6,27,10,28,24,14,20,97,104
2018,4,41800221,4/28/2019,1610612745,Houston Rockets,0,0,1610612744,Golden State Warriors,1,1,17,10,27,14,33,47,31,43,74,24,5,29,7,37,14,7,16,98,100
2018,4,41800217,5/12/2019,1610612755,Philadelphia 76ers,0,0,1610612761,Toronto Raptors,1,1,19,19,38,9,18,27,28,37,65,25,5,30,6,34,16,10,17,89,90
2018,4,41800217,5/12/2019,1610612761,Toronto Raptors,1,1,1610612755,Philadelphia 76ers,0,0,27,32,59,7,23,30,34,55,89,17,2,19,18,39,15,4,10,90,92
2018,4,41800216,5/9/2019,1610612755,Philadelphia 76ers,1,1,1610612761,Toronto Raptors,0,0,31,30,61,10,18,28,41,48,89,20,6,26,23,27,27,9,18,97,112
2018,4,41800216,5/9/2019,1610612761,Toronto Raptors,0,0,1610612755,Philadelphia 76ers,1,1,26,19,45,9,27,36,35,46,81,22,7,29,10,37,25,5,12,97,101
2018,4,41800215,5/7/2019,1610612755,Philadelphia 76ers,0,0,1610612761,Toronto Raptors,1,1,27,28,55,6,18,24,33,46,79,17,3,20,9,38,19,12,19,99,89
2018,4,41800215,5/7/2019,1610612761,Toronto Raptors,1,1,1610612755,Philadelphia 76ers,0,0,24,18,42,16,24,40,40,42,82,29,4,33,13,32,22,6,13,99,125
2018,4,41800214,5/5/2019,1610612755,Philadelphia 76ers,1,0,1610612761,Toronto Raptors,0,1,21,23,44,12,26,38,33,49,82,18,7,25,16,36,22,6,13,92,96
2018,4,41800214,5/5/2019,1610612761,Toronto Raptors,0,1,1610612755,Philadelphia 76ers,1,0,25,20,45,10,21,31,35,41,76,21,5,26,11,33,19,8,14,92,101
2018,4,41800213,5/2/2019,1610612755,Philadelphia 76ers,1,1,1610612761,Toronto Raptors,0,0,33,28,61,10,13,23,43,41,84,20,3,23,13,29,29,7,13,94,116
2018,4,41800213,5/2/2019,1610612761,Toronto Raptors,0,0,1610612755,Philadelphia 76ers,1,1,28,28,56,7,20,27,35,48,83,18,5,23,9,40,15,4,9,95,95
2018,4,41800212,4/29/2019,1610612755,Philadelphia 76ers,0,1,1610612761,Toronto Raptors,1,0,20,21,41,10,25,35,30,46,76,24,2,26,13,34,22,10,20,95,94
2018,4,41800212,4/29/2019,1610612761,Toronto Raptors,1,0,1610612755,Philadelphia 76ers,0,1,23,30,53,10,27,37,33,57,90,13,2,15,15,43,20,5,13,95,89
2018,4,41800211,4/27/2019,1610612755,Philadelphia 76ers,0,0,1610612761,Toronto Raptors,1,1,24,33,57,11,21,32,35,54,89,14,7,21,17,41,23,3,16,97,95
2018,4,41800211,4/27/2019,1610612761,Toronto Raptors,1,1,1610612755,Philadelphia 76ers,0,0,32,20,52,9,18,27,41,38,79,17,7,24,5,36,21,5,10,96,108
2018,4,41800205,5/8/2019,1610612738,Boston Celtics,0,0,1610612749,Milwaukee Bucks,1,1,22,32,54,7,32,39,29,64,93,26,8,34,17,49,19,8,14,109,91
2018,4,41800205,5/8/2019,1610612749,Milwaukee Bucks,1,1,1610612738,Boston Celtics,0,0,27,20,47,15,32,47,42,52,94,17,5,22,15,38,27,9,17,108,116
2017,4,41700303,5/19/2018,1610612738,Boston Celtics,0,0,1610612739,Cleveland Cavaliers,1,1,23,29,52,6,16,22,29,45,74,22,6,28,9,38,16,9,15,95,86
2017,4,41700303,5/19/2018,1610612739,Cleveland Cavaliers,1,1,1610612738,Boston Celtics,0,0,20,22,42,17,17,34,37,39,76,25,5,30,13,29,23,4,15,94,116
2017,4,41700134,4/22/2018,1610612739,Cleveland Cavaliers,0,1,1610612754,Indiana Pacers,1,0,23,21,44,12,22,34,35,43,78,22,4,26,9,36,17,7,11,93,104
2017,4,41700134,4/22/2018,1610612754,Indiana Pacers,1,0,1610612739,Cleveland Cavaliers,0,1,28,32,60,12,21,33,40,53,93,8,5,13,15,41,25,4,9,93,100
2018,4,41800204,5/6/2019,1610612738,Boston Celtics,1,0,1610612749,Milwaukee Bucks,0,1,25,24,49,9,32,41,34,56,90,24,6,30,13,48,25,4,11,103,101
2018,4,41800204,5/6/2019,1610612749,Milwaukee Bucks,0,1,1610612738,Boston Celtics,1,0,36,27,63,8,29,37,44,56,100,17,8,25,14,46,25,3,7,102,113
2018,4,41800203,5/3/2019,1610612738,Boston Celtics,1,0,1610612749,Milwaukee Bucks,0,1,19,22,41,16,24,40,35,46,81,30,2,32,9,37,24,8,18,106,116
2018,4,41800203,5/3/2019,1610612749,Milwaukee Bucks,0,1,1610612738,Boston Celtics,1,0,27,19,46,15,22,37,42,41,83,24,12,36,9,38,23,9,15,106,123
2018,4,41800202,4/30/2019,1610612738,Boston Celtics,0,0,1610612749,Milwaukee Bucks,1,1,24,34,58,10,18,28,34,52,86,24,3,27,10,43,19,6,13,102,102
2018,4,41800202,4/30/2019,1610612749,Milwaukee Bucks,1,1,1610612738,Boston Celtics,0,0,19,22,41,20,27,47,39,49,88,25,6,31,13,40,22,5,12,102,123
2018,4,41800175,4/24/2019,1610612745,Houston Rockets,1,1,1610612762,Utah Jazz,0,0,23,21,44,13,24,37,36,45,81,15,7,22,10,39,17,8,17,98,100
2018,4,41800175,4/24/2019,1610612762,Utah Jazz,0,0,1610612745,Houston Rockets,1,1,26,30,56,9,29,38,35,59,94,14,5,19,22,38,26,12,16,99,93
2018,4,41800174,4/22/2019,1610612745,Houston Rockets,0,0,1610612762,Utah Jazz,1,1,11,22,33,17,29,46,28,51,79,18,6,24,14,39,14,7,16,94,91
2018,4,41800174,4/22/2019,1610612762,Utah Jazz,1,1,1610612745,Houston Rockets,0,0,26,25,51,11,24,35,37,49,86,22,4,26,21,30,24,9,15,93,107
2017,4,41700304,5/21/2018,1610612738,Boston Celtics,0,0,1610612739,Cleveland Cavaliers,1,1,26,31,57,9,19,28,35,50,85,23,7,30,11,42,21,6,10,98,102
2017,4,41700304,5/21/2018,1610612739,Cleveland Cavaliers,1,1,1610612738,Boston Celtics,0,0,33,25,58,8,15,23,41,40,81,21,8,29,16,30,15,9,19,99,111
2018,4,41800173,4/20/2019,1610612745,Houston Rockets,0,1,1610612762,Utah Jazz,1,0,18,23,41,15,30,45,33,53,86,23,11,34,17,43,19,9,13,100,104
2018,4,41800173,4/20/2019,1610612762,Utah Jazz,1,0,1610612745,Houston Rockets,0,1,20,16,36,12,29,41,32,45,77,25,13,38,10,44,21,11,14,99,101
2018,4,41800172,4/17/2019,1610612745,Houston Rockets,1,1,1610612762,Utah Jazz,0,0,21,17,38,17,25,42,38,42,80,25,5,30,12,34,17,16,18,98,118
2018,4,41800172,4/17/2019,1610612762,Utah Jazz,0,0,1610612745,Houston Rockets,1,1,31,29,60,8,30,38,39,59,98,12,6,18,20,41,27,8,12,99,98
2018,4,41800171,4/14/2019,1610612745,Houston Rockets,1,1,1610612762,Utah Jazz,0,0,33,21,54,15,26,41,48,47,95,11,1,12,13,35,25,6,12,99,122
2018,4,41800171,4/14/2019,1610612762,Utah Jazz,0,0,1610612745,Houston Rockets,1,1,23,27,50,7,20,27,30,47,77,23,4,27,11,38,17,6,19,98,90
2018,4,41800165,4/23/2019,1610612757,Portland Trail Blazers,1,1,1610612760,Oklahoma City Thunder,0,0,32,29,61,13,22,35,45,51,96,15,8,23,20,33,22,4,10,99,118
2018,4,41800165,4/23/2019,1610612760,Oklahoma City Thunder,0,0,1610612757,Portland Trail Blazers,1,1,35,24,59,12,15,27,47,39,86,9,6,15,9,34,24,8,15,98,115
2017,4,41700173,4/21/2018,1610612760,Oklahoma City Thunder,0,0,1610612762,Utah Jazz,1,1,23,27,50,14,14,28,37,41,78,14,5,19,7,36,17,12,17,96,102
2017,4,41700173,4/21/2018,1610612762,Utah Jazz,1,1,1610612760,Oklahoma City Thunder,0,0,29,17,46,13,21,34,42,38,80,18,9,27,16,27,24,11,19,97,115
2018,4,41800162,4/16/2019,1610612757,Portland Trail Blazers,1,1,1610612760,Oklahoma City Thunder,0,0,29,29,58,13,19,32,42,48,90,17,4,21,11,39,17,6,12,100,114
2018,4,41800162,4/16/2019,1610612760,Oklahoma City Thunder,0,0,1610612757,Portland Trail Blazers,1,1,30,28,58,5,23,28,35,51,86,19,9,28,15,39,21,9,16,100,94
2018,4,41800163,4/19/2019,1610612757,Portland Trail Blazers,0,0,1610612760,Oklahoma City Thunder,1,1,27,25,52,12,19,31,39,44,83,18,6,24,15,31,18,6,18,97,108
2018,4,41800163,4/19/2019,1610612760,Oklahoma City Thunder,1,1,1610612757,Portland Trail Blazers,0,0,22,26,48,15,14,29,37,40,77,31,8,39,12,31,27,5,15,98,120
2018,4,41800164,4/21/2019,1610612757,Portland Trail Blazers,0,1,1610612760,Oklahoma City Thunder,1,0,22,33,55,15,20,35,37,53,90,22,1,23,12,41,16,7,13,102,111
2018,4,41800164,4/21/2019,1610612760,Oklahoma City Thunder,1,0,1610612757,Portland Trail Blazers,0,1,18,30,48,15,25,40,33,55,88,17,5,22,10,46,23,10,14,104,98
2018,4,41800156,4/25/2019,1610612743,Denver Nuggets,0,0,1610612759,San Antonio Spurs,1,1,38,34,72,6,18,24,44,52,96,9,3,12,21,33,26,3,7,89,103
2018,4,41800156,4/25/2019,1610612759,San Antonio Spurs,1,1,1610612743,Denver Nuggets,0,0,38,22,60,10,14,24,48,36,84,14,3,17,11,26,25,5,8,89,120
2018,4,41800157,4/27/2019,1610612743,Denver Nuggets,1,1,1610612759,San Antonio Spurs,0,0,33,35,68,2,18,20,35,53,88,18,5,23,16,39,21,3,6,90,90
2018,4,41800157,4/27/2019,1610612759,San Antonio Spurs,0,0,1610612743,Denver Nuggets,1,1,25,37,62,6,17,23,31,54,85,18,2,20,12,42,19,3,6,89,86
2018,4,41800161,4/14/2019,1610612757,Portland Trail Blazers,1,1,1610612760,Oklahoma City Thunder,0,0,25,36,61,11,14,25,36,50,86,21,6,27,18,34,14,10,19,99,104
2018,4,41800161,4/14/2019,1610612760,Oklahoma City Thunder,0,0,1610612757,Portland Trail Blazers,1,1,32,28,60,5,28,33,37,56,93,20,3,23,21,37,18,8,16,100,99
2018,4,41800155,4/23/2019,1610612743,Denver Nuggets,1,1,1610612759,San Antonio Spurs,0,0,25,20,45,14,19,33,39,39,78,16,4,20,9,33,25,6,14,91,108
2018,4,41800155,4/23/2019,1610612759,San Antonio Spurs,0,0,1610612743,Denver Nuggets,1,1,30,36,66,7,17,24,37,53,90,9,6,15,12,45,17,4,8,91,90
2018,4,41800154,4/20/2019,1610612743,Denver Nuggets,0,1,1610612759,San Antonio Spurs,1,0,25,33,58,15,16,31,40,49,89,22,2,24,13,38,25,4,8,95,117
2018,4,41800154,4/20/2019,1610612759,San Antonio Spurs,1,0,1610612743,Denver Nuggets,0,1,32,30,62,5,12,17,37,42,79,24,8,32,11,35,23,4,10,93,103
2017,4,41700131,4/15/2018,1610612739,Cleveland Cavaliers,1,0,1610612754,Indiana Pacers,0,1,22,22,44,8,26,34,30,48,78,12,8,20,11,42,21,12,17,93,80
2017,4,41700131,4/15/2018,1610612754,Indiana Pacers,0,1,1610612739,Cleveland Cavaliers,1,0,25,26,51,11,17,28,36,43,79,15,10,25,9,41,19,7,11,92,98
2017,4,41700175,4/25/2018,1610612760,Oklahoma City Thunder,1,1,1610612762,Utah Jazz,0,0,30,38,68,9,12,21,39,50,89,20,4,24,11,39,13,5,9,98,107
2017,4,41700175,4/25/2018,1610612762,Utah Jazz,0,0,1610612760,Oklahoma City Thunder,1,1,20,23,43,13,25,38,33,48,81,20,6,26,13,37,19,9,17,98,99
2018,4,41800153,4/18/2019,1610612743,Denver Nuggets,0,0,1610612759,San Antonio Spurs,1,1,27,25,52,15,14,29,42,39,81,9,8,17,11,31,31,9,13,92,108
2018,4,41800153,4/18/2019,1610612759,San Antonio Spurs,1,1,1610612743,Denver Nuggets,0,0,37,34,71,7,11,18,44,45,89,23,9,32,20,29,24,3,6,92,118
2017,4,41700301,5/13/2018,1610612738,Boston Celtics,1,1,1610612739,Cleveland Cavaliers,0,0,32,22,54,11,19,30,43,41,84,11,2,13,9,33,27,4,11,91,108
2017,4,41700301,5/13/2018,1610612739,Cleveland Cavaliers,0,0,1610612738,Boston Celtics,1,1,27,33,60,4,22,26,31,55,86,17,3,20,13,44,18,6,10,92,83
2017,4,41700174,4/23/2018,1610612760,Oklahoma City Thunder,0,0,1610612762,Utah Jazz,1,1,28,30,58,5,21,26,33,51,84,25,5,30,13,42,10,7,15,103,96
2017,4,41700174,4/23/2018,1610612762,Utah Jazz,1,1,1610612760,Oklahoma City Thunder,0,0,29,28,57,12,22,34,41,50,91,19,8,27,15,40,21,8,12,102,113
2017,4,41700132,4/18/2018,1610612739,Cleveland Cavaliers,1,1,1610612754,Indiana Pacers,0,0,26,19,45,11,17,28,37,36,73,15,7,22,7,31,15,8,15,90,100
2017,4,41700132,4/18/2018,1610612754,Indiana Pacers,0,0,1610612739,Cleveland Cavaliers,1,1,35,21,56,6,16,22,41,37,78,9,3,12,11,28,22,8,17,92,97
2018,4,41800152,4/16/2019,1610612743,Denver Nuggets,1,1,1610612759,San Antonio Spurs,0,0,33,32,65,10,14,24,43,46,89,18,8,26,9,41,29,3,6,99,114
2018,4,41800152,4/16/2019,1610612759,San Antonio Spurs,0,0,1610612743,Denver Nuggets,1,1,34,34,68,5,13,18,39,47,86,22,3,25,12,36,20,5,10,98,105
2017,4,41700302,5/15/2018,1610612738,Boston Celtics,1,1,1610612739,Cleveland Cavaliers,0,0,30,31,61,10,21,31,40,52,92,17,3,20,14,40,24,2,6,94,107
2017,4,41700302,5/15/2018,1610612739,Cleveland Cavaliers,0,0,1610612738,Boston Celtics,1,1,27,22,49,10,21,31,37,43,80,10,7,17,10,36,18,8,15,92,94
2018,4,41800151,4/13/2019,1610612743,Denver Nuggets,1,0,1610612759,San Antonio Spurs,0,1,31,29,60,6,22,28,37,51,88,16,8,24,17,39,25,4,10,92,96
2018,4,41800151,4/13/2019,1610612759,San Antonio Spurs,0,1,1610612743,Denver Nuggets,1,0,33,35,68,7,8,15,40,43,83,14,6,20,11,35,20,8,11,93,101
2018,4,41800146,4/26/2019,1610612744,Golden State Warriors,0,1,1610612746,LA Clippers,1,0,37,22,59,10,20,30,47,42,89,25,6,31,10,35,32,7,10,102,129
2018,4,41800146,4/26/2019,1610612746,LA Clippers,1,0,1610612744,Golden State Warriors,0,1,27,37,64,11,21,32,38,58,96,23,5,28,21,40,22,6,15,103,110
2018,4,41800145,4/24/2019,1610612744,Golden State Warriors,1,0,1610612746,LA Clippers,0,1,28,29,57,15,24,39,43,53,96,20,2,22,16,37,31,3,8,97,121
2018,4,41800145,4/24/2019,1610612746,LA Clippers,0,1,1610612744,Golden State Warriors,1,0,33,18,51,13,21,34,46,39,85,24,2,26,15,25,29,7,14,95,129
2017,4,41700123,4/19/2018,1610612748,Miami Heat,1,0,1610612755,Philadelphia 76ers,0,1,17,23,40,16,17,33,33,40,73,26,9,35,8,35,26,10,15,97,108
2017,4,41700123,4/19/2018,1610612755,Philadelphia 76ers,0,1,1610612748,Miami Heat,1,0,23,24,47,18,16,34,41,40,81,28,9,37,13,31,28,7,12,98,128
2017,4,41700164,4/21/2018,1610612740,New Orleans Pelicans,1,1,1610612757,Portland Trail Blazers,0,0,36,17,53,9,16,25,45,33,78,32,7,39,8,28,28,8,14,101,131
2017,4,41700164,4/21/2018,1610612757,Portland Trail Blazers,0,0,1610612740,New Orleans Pelicans,1,1,40,28,68,10,17,27,50,45,95,13,3,16,7,39,20,5,6,101,123
2017,4,41700125,4/24/2018,1610612748,Miami Heat,0,0,1610612755,Philadelphia 76ers,1,1,24,29,53,10,25,35,34,54,88,13,9,22,13,47,24,7,13,99,91
2017,4,41700125,4/24/2018,1610612755,Philadelphia 76ers,1,1,1610612748,Miami Heat,0,0,27,26,53,7,21,28,34,47,81,29,7,36,15,36,27,7,15,99,104
2018,4,41800144,4/21/2019,1610612744,Golden State Warriors,0,1,1610612746,LA Clippers,1,0,30,28,58,12,19,31,42,47,89,17,2,19,14,34,27,8,13,98,113
2018,4,41800144,4/21/2019,1610612746,LA Clippers,1,0,1610612744,Golden State Warriors,0,1,21,28,49,13,18,31,34,46,80,24,8,32,10,39,22,5,10,98,105
2017,4,41700124,4/21/2018,1610612748,Miami Heat,1,0,1610612755,Philadelphia 76ers,0,1,34,41,75,7,12,19,41,53,94,13,12,25,17,43,21,12,19,107,102
2017,4,41700124,4/21/2018,1610612755,Philadelphia 76ers,0,1,1610612748,Miami Heat,1,0,29,24,53,7,24,31,36,48,84,27,8,35,20,34,22,18,27,107,106
2018,4,41800143,4/18/2019,1610612744,Golden State Warriors,0,1,1610612746,LA Clippers,1,0,36,22,58,15,20,35,51,42,93,15,3,18,13,30,35,6,12,101,132
2018,4,41800143,4/18/2019,1610612746,LA Clippers,1,0,1610612744,Golden State Warriors,0,1,28,34,62,7,25,32,35,59,94,28,6,34,21,43,21,4,13,101,105
2017,4,41700235,5/8/2018,1610612740,New Orleans Pelicans,0,0,1610612744,Golden State Warriors,1,1,31,33,64,10,14,24,41,47,88,12,4,16,5,42,26,10,14,104,104
2017,4,41700235,5/8/2018,1610612744,Golden State Warriors,1,1,1610612740,New Orleans Pelicans,0,0,41,31,72,7,20,27,48,51,99,10,2,12,11,41,35,7,13,105,113
2017,4,41700171,4/15/2018,1610612760,Oklahoma City Thunder,1,1,1610612762,Utah Jazz,0,0,27,29,56,14,15,29,41,44,85,20,3,23,12,33,16,10,17,101,116
2017,4,41700171,4/15/2018,1610612762,Utah Jazz,0,0,1610612760,Oklahoma City Thunder,1,1,30,29,59,11,17,28,41,46,87,15,5,20,10,38,18,8,14,101,108
2017,4,41700172,4/18/2018,1610612760,Oklahoma City Thunder,1,0,1610612762,Utah Jazz,0,1,25,30,55,11,24,35,36,54,90,12,6,18,13,43,22,9,13,100,95
2017,4,41700172,4/18/2018,1610612762,Utah Jazz,0,1,1610612760,Oklahoma City Thunder,1,0,26,29,55,9,20,29,35,49,84,23,10,33,17,37,22,11,16,99,102
2018,4,41800142,4/15/2019,1610612744,Golden State Warriors,1,0,1610612746,LA Clippers,0,1,29,18,47,11,17,28,40,35,75,40,5,45,12,26,31,13,21,106,131
2018,4,41800142,4/15/2019,1610612746,LA Clippers,0,1,1610612744,Golden State Warriors,1,0,34,20,54,14,17,31,48,37,85,25,6,31,11,31,34,12,21,106,135
2017,4,41700233,5/4/2018,1610612740,New Orleans Pelicans,1,1,1610612744,Golden State Warriors,0,0,34,31,65,14,17,31,48,48,96,9,3,12,15,35,36,11,15,104,119
2017,4,41700233,5/4/2018,1610612744,Golden State Warriors,0,0,1610612740,New Orleans Pelicans,1,1,26,35,61,9,22,31,35,57,92,21,5,26,12,45,22,7,12,103,100
2018,4,41800141,4/13/2019,1610612744,Golden State Warriors,1,1,1610612746,LA Clippers,0,0,31,31,62,14,16,30,45,47,92,17,3,20,14,35,31,10,21,109,121
2018,4,41800141,4/13/2019,1610612746,LA Clippers,0,0,1610612744,Golden State Warriors,1,1,27,38,65,11,19,30,38,57,95,17,5,22,14,44,24,9,18,109,104
2017,4,41700234,5/6/2018,1610612740,New Orleans Pelicans,1,0,1610612744,Golden State Warriors,0,1,28,34,62,4,22,26,32,56,88,24,6,30,14,46,17,11,19,108,92
2017,4,41700234,5/6/2018,1610612744,Golden State Warriors,0,1,1610612740,New Orleans Pelicans,1,0,35,27,62,11,22,33,46,49,95,15,3,18,8,44,28,7,11,107,118
2017,4,41700121,4/14/2018,1610612748,Miami Heat,0,0,1610612755,Philadelphia 76ers,1,1,23,28,51,12,14,26,35,42,77,21,10,31,10,37,25,9,18,99,103
2017,4,41700121,4/14/2018,1610612755,Philadelphia 76ers,1,1,1610612748,Miami Heat,0,0,27,40,67,18,10,28,45,50,95,22,7,29,21,34,34,4,11,98,130
2017,4,41700122,4/16/2018,1610612748,Miami Heat,0,1,1610612755,Philadelphia 76ers,1,0,31,26,57,9,16,25,40,42,82,24,6,30,12,33,23,7,15,100,113
2017,4,41700122,4/16/2018,1610612755,Philadelphia 76ers,1,0,1610612748,Miami Heat,0,1,33,27,60,7,29,36,40,56,96,16,6,22,22,38,22,8,15,100,103
2018,4,41800134,4/21/2019,1610612738,Boston Celtics,0,1,1610612754,Indiana Pacers,1,0,25,25,50,11,17,28,36,42,78,27,7,34,13,33,18,5,17,99,110
2018,4,41800134,4/21/2019,1610612754,Indiana Pacers,1,0,1610612738,Boston Celtics,0,1,26,34,60,10,18,28,36,52,88,24,4,28,14,38,18,7,12,99,106
2018,4,41800133,4/19/2019,1610612738,Boston Celtics,0,1,1610612754,Indiana Pacers,1,0,23,24,47,15,19,34,38,43,81,13,9,22,12,34,23,9,13,93,104
2018,4,41800133,4/19/2019,1610612754,Indiana Pacers,1,0,1610612738,Boston Celtics,0,1,23,28,51,11,19,30,34,47,81,17,6,23,11,38,20,4,11,94,96
2018,4,41800132,4/17/2019,1610612738,Boston Celtics,1,1,1610612754,Indiana Pacers,0,0,29,27,56,11,17,28,40,44,84,8,1,9,10,35,22,11,14,93,99
2018,4,41800132,4/17/2019,1610612754,Indiana Pacers,0,0,1610612738,Boston Celtics,1,1,23,24,47,13,21,34,36,45,81,6,4,10,5,42,23,3,12,92,91
2017,4,41700225,5/8/2018,1610612745,Houston Rockets,1,1,1610612762,Utah Jazz,0,0,22,22,44,18,21,39,40,43,83,14,3,17,11,33,21,5,10,91,112
2017,4,41700225,5/8/2018,1610612762,Utah Jazz,0,0,1610612745,Houston Rockets,1,1,28,25,53,10,18,28,38,43,81,16,5,21,12,34,24,10,12,91,102
2017,4,41700162,4/17/2018,1610612740,New Orleans Pelicans,0,1,1610612757,Portland Trail Blazers,1,0,31,29,60,12,12,24,43,41,84,13,6,19,12,32,25,5,14,95,111
2017,4,41700162,4/17/2018,1610612757,Portland Trail Blazers,1,0,1610612740,New Orleans Pelicans,0,1,29,30,59,12,20,32,41,50,91,8,2,10,16,35,20,4,16,96,102
2018,4,41800131,4/14/2019,1610612738,Boston Celtics,1,1,1610612754,Indiana Pacers,0,0,18,31,49,10,18,28,28,49,77,18,4,22,14,35,18,8,20,95,84
2018,4,41800131,4/14/2019,1610612754,Indiana Pacers,0,0,1610612738,Boston Celtics,1,1,22,35,57,6,21,27,28,56,84,12,9,21,11,50,22,8,13,93,74
2017,4,41700231,4/28/2018,1610612740,New Orleans Pelicans,0,0,1610612744,Golden State Warriors,1,1,34,37,71,8,17,25,42,54,96,9,2,11,8,46,24,8,12,106,101
2017,4,41700231,4/28/2018,1610612744,Golden State Warriors,1,1,1610612740,New Orleans Pelicans,0,0,33,31,64,11,16,27,44,47,91,24,8,32,15,36,33,7,14,106,123
2017,4,41700163,4/19/2018,1610612740,New Orleans Pelicans,1,1,1610612757,Portland Trail Blazers,0,0,35,25,60,11,16,27,46,41,87,16,3,19,9,33,27,10,13,102,119
2017,4,41700163,4/19/2018,1610612757,Portland Trail Blazers,0,0,1610612740,New Orleans Pelicans,1,1,28,21,49,9,22,31,37,43,80,19,6,25,14,32,19,16,24,102,102
2017,4,41700116,4/26/2018,1610612738,Boston Celtics,0,0,1610612749,Milwaukee Bucks,1,1,20,25,45,10,26,36,30,51,81,16,3,19,10,43,18,6,9,90,86
2017,4,41700116,4/26/2018,1610612749,Milwaukee Bucks,1,1,1610612738,Boston Celtics,0,0,30,19,49,8,18,26,38,37,75,13,8,21,8,33,19,3,11,88,97
2018,4,41800125,4/23/2019,1610612751,Brooklyn Nets,0,0,1610612755,Philadelphia 76ers,1,1,27,35,62,9,22,31,36,57,93,19,6,25,10,49,26,10,15,109,100
2018,4,41800125,4/23/2019,1610612755,Philadelphia 76ers,1,1,1610612751,Brooklyn Nets,0,0,37,30,67,14,19,33,51,49,100,6,3,9,14,37,35,10,20,109,122
2017,4,41700232,5/1/2018,1610612740,New Orleans Pelicans,0,0,1610612744,Golden State Warriors,1,1,35,33,68,13,24,37,48,57,105,7,2,9,15,43,33,10,14,108,116
2017,4,41700232,5/1/2018,1610612744,Golden State Warriors,1,1,1610612740,New Orleans Pelicans,0,0,30,21,51,13,27,40,43,48,91,22,5,27,10,38,36,12,16,108,121
2017,4,41700117,4/28/2018,1610612738,Boston Celtics,1,1,1610612749,Milwaukee Bucks,0,0,36,22,58,9,17,26,45,39,84,13,8,21,15,29,28,4,15,94,112
2017,4,41700117,4/28/2018,1610612749,Milwaukee Bucks,0,0,1610612738,Boston Celtics,1,1,26,21,47,9,18,27,35,39,74,17,1,18,6,33,21,9,16,93,96
2018,4,41800124,4/20/2019,1610612751,Brooklyn Nets,1,0,1610612755,Philadelphia 76ers,0,1,24,28,52,12,26,38,36,54,90,24,7,31,14,45,23,6,14,104,108
2018,4,41800124,4/20/2019,1610612755,Philadelphia 76ers,0,1,1610612751,Brooklyn Nets,1,0,36,26,62,8,18,26,44,44,88,16,5,21,15,32,25,10,21,103,112
2017,4,41700404,6/8/2018,1610612739,Cleveland Cavaliers,1,0,1610612744,Golden State Warriors,0,1,22,38,60,8,19,27,30,57,87,17,8,25,20,40,21,7,11,91,85
2017,4,41700404,6/8/2018,1610612744,Golden State Warriors,0,1,1610612739,Cleveland Cavaliers,1,0,25,23,48,14,24,38,39,47,86,16,0,16,15,32,25,5,10,91,108
2018,4,41800123,4/18/2019,1610612751,Brooklyn Nets,1,0,1610612755,Philadelphia 76ers,0,1,31,26,57,8,31,39,39,57,96,29,6,35,20,40,12,9,16,107,115
2018,4,41800123,4/18/2019,1610612755,Philadelphia 76ers,0,1,1610612751,Brooklyn Nets,1,0,34,33,67,11,16,27,45,49,94,30,5,35,19,32,26,6,16,107,131
2017,4,41700115,4/24/2018,1610612738,Boston Celtics,1,1,1610612749,Milwaukee Bucks,0,0,19,19,38,10,21,31,29,40,69,24,8,32,8,34,22,10,18,95,92
2017,4,41700115,4/24/2018,1610612749,Milwaukee Bucks,0,0,1610612738,Boston Celtics,1,1,23,31,54,9,24,33,32,55,87,14,6,20,13,45,21,7,11,94,87
2018,4,41800122,4/15/2019,1610612751,Brooklyn Nets,0,0,1610612755,Philadelphia 76ers,1,1,28,26,54,15,21,36,43,47,90,22,7,29,13,37,20,8,14,103,123
2018,4,41800122,4/15/2019,1610612755,Philadelphia 76ers,1,1,1610612751,Brooklyn Nets,0,0,46,29,75,9,14,23,55,43,98,26,6,32,20,24,29,3,12,103,145
2017,4,41700154,4/22/2018,1610612744,Golden State Warriors,0,0,1610612759,San Antonio Spurs,1,1,27,35,62,7,21,28,34,56,90,15,2,17,26,31,19,6,18,90,90
2017,4,41700154,4/22/2018,1610612759,San Antonio Spurs,1,1,1610612744,Golden State Warriors,0,0,22,31,53,15,13,28,37,44,81,14,5,19,9,37,20,6,8,89,103
2017,4,41700161,4/14/2018,1610612740,New Orleans Pelicans,0,1,1610612757,Portland Trail Blazers,1,0,33,29,62,8,16,24,41,45,86,7,3,10,8,39,26,10,15,97,97
2017,4,41700161,4/14/2018,1610612757,Portland Trail Blazers,1,0,1610612740,New Orleans Pelicans,0,1,25,34,59,12,27,39,37,61,98,9,3,12,18,45,17,8,12,97,95
2018,4,41800121,4/13/2019,1610612751,Brooklyn Nets,0,1,1610612755,Philadelphia 76ers,1,0,27,35,62,11,15,26,38,50,88,24,2,26,15,36,15,6,12,98,111
2018,4,41800121,4/13/2019,1610612755,Philadelphia 76ers,1,0,1610612751,Brooklyn Nets,0,1,32,29,61,3,22,25,35,51,86,29,13,42,21,37,20,9,13,99,102
2018,4,41800115,4/23/2019,1610612753,Orlando Magic,0,0,1610612761,Toronto Raptors,1,1,23,26,49,9,25,34,32,51,83,23,8,31,14,41,20,8,17,98,96
2018,4,41800115,4/23/2019,1610612761,Toronto Raptors,1,1,1610612753,Orlando Magic,0,0,26,23,49,15,21,36,41,44,85,18,3,21,8,38,34,7,14,99,115
2017,4,41700222,5/2/2018,1610612745,Houston Rockets,1,0,1610612762,Utah Jazz,0,1,28,30,58,10,27,37,38,57,95,22,5,27,13,46,22,4,8,103,108
2017,4,41700222,5/2/2018,1610612762,Utah Jazz,0,1,1610612745,Houston Rockets,1,0,28,23,51,15,17,32,43,40,83,15,10,25,8,38,26,11,17,103,116
2018,4,41800114,4/21/2019,1610612753,Orlando Magic,1,0,1610612761,Toronto Raptors,0,1,27,21,48,7,26,33,34,47,81,10,3,13,12,38,20,11,17,92,85
2018,4,41800114,4/21/2019,1610612761,Toronto Raptors,0,1,1610612753,Orlando Magic,1,0,29,18,47,11,17,28,40,35,75,16,2,18,7,29,23,7,14,90,107
2017,4,41700223,5/4/2018,1610612745,Houston Rockets,0,1,1610612762,Utah Jazz,1,0,31,19,50,11,25,36,42,44,86,18,2,20,6,39,26,3,9,99,113
2017,4,41700223,5/4/2018,1610612762,Utah Jazz,1,0,1610612745,Houston Rockets,0,1,24,31,55,11,18,29,35,49,84,11,4,15,9,41,17,8,16,98,92
2017,4,41700155,4/24/2018,1610612744,Golden State Warriors,1,1,1610612759,San Antonio Spurs,0,0,32,24,56,5,22,27,37,46,83,20,5,25,10,38,25,5,10,94,99
2017,4,41700155,4/24/2018,1610612759,San Antonio Spurs,0,0,1610612744,Golden State Warriors,1,1,25,31,56,7,23,30,32,54,86,20,2,22,13,42,21,5,13,94,91
2018,4,41800113,4/19/2019,1610612753,Orlando Magic,1,0,1610612761,Toronto Raptors,0,1,16,20,36,13,31,44,29,51,80,22,1,23,14,37,19,9,16,94,93
2018,4,41800113,4/19/2019,1610612761,Toronto Raptors,0,1,1610612753,Orlando Magic,1,0,28,31,59,11,17,28,39,48,87,9,1,10,12,37,26,8,13,93,98
2017,4,41700402,6/3/2018,1610612739,Cleveland Cavaliers,0,0,1610612744,Golden State Warriors,1,1,28,34,62,9,18,27,37,52,89,20,6,26,20,34,25,3,11,91,103
2017,4,41700402,6/3/2018,1610612744,Golden State Warriors,1,1,1610612739,Cleveland Cavaliers,0,0,32,14,46,15,21,36,47,35,82,13,8,21,11,27,28,9,12,92,122
2018,4,41800112,4/16/2019,1610612753,Orlando Magic,0,0,1610612761,Toronto Raptors,1,1,21,26,47,9,25,34,30,51,81,13,11,24,16,42,17,10,17,92,82
2018,4,41800112,4/16/2019,1610612761,Toronto Raptors,1,1,1610612753,Orlando Magic,0,0,31,21,52,11,24,35,42,45,87,16,1,17,9,36,25,2,7,92,111
2017,4,41700224,5/6/2018,1610612745,Houston Rockets,0,1,1610612762,Utah Jazz,1,0,27,23,50,10,28,38,37,51,88,16,1,17,13,38,15,8,13,98,100
2017,4,41700224,5/6/2018,1610612762,Utah Jazz,1,0,1610612745,Houston Rockets,0,1,25,29,54,7,22,29,32,51,83,16,4,20,12,40,16,11,17,97,87
2017,4,41700113,4/20/2018,1610612738,Boston Celtics,0,0,1610612749,Milwaukee Bucks,1,1,24,32,56,8,16,24,32,48,80,20,8,28,23,31,17,8,18,88,92
2017,4,41700113,4/20/2018,1610612749,Milwaukee Bucks,1,1,1610612738,Boston Celtics,0,0,29,17,46,16,17,33,45,34,79,10,5,15,8,29,28,3,9,88,116
2017,4,41700403,6/6/2018,1610612739,Cleveland Cavaliers,1,0,1610612744,Golden State Warriors,0,1,31,30,61,9,22,31,40,52,92,13,4,17,21,33,20,6,14,95,102
2017,4,41700403,6/6/2018,1610612744,Golden State Warriors,0,1,1610612739,Cleveland Cavaliers,1,0,33,22,55,9,17,26,42,39,81,17,2,19,8,33,27,6,11,93,110
2017,4,41700114,4/22/2018,1610612738,Boston Celtics,0,0,1610612749,Milwaukee Bucks,1,1,26,32,58,10,19,29,36,51,87,20,5,25,19,36,22,7,9,90,102
2017,4,41700114,4/22/2018,1610612749,Milwaukee Bucks,1,1,1610612738,Boston Celtics,0,0,28,22,50,10,13,23,38,35,73,18,6,24,4,32,24,6,10,91,104
2018,4,41800111,4/13/2019,1610612753,Orlando Magic,0,1,1610612761,Toronto Raptors,1,0,22,39,61,14,15,29,36,54,90,18,2,20,14,41,19,4,11,96,104
2018,4,41800111,4/13/2019,1610612761,Toronto Raptors,1,0,1610612753,Orlando Magic,0,1,28,24,52,12,24,36,40,48,88,9,5,14,10,40,23,9,13,98,101
2018,4,41800104,4/22/2019,1610612749,Milwaukee Bucks,0,1,1610612765,Detroit Pistons,1,0,33,18,51,10,18,28,43,36,79,31,10,41,13,27,27,8,19,101,127
2018,4,41800104,4/22/2019,1610612765,Detroit Pistons,1,0,1610612749,Milwaukee Bucks,0,1,28,38,66,13,21,34,41,59,100,9,3,12,14,47,26,6,11,100,104
2018,4,41800103,4/20/2019,1610612749,Milwaukee Bucks,0,1,1610612765,Detroit Pistons,1,0,28,20,48,14,24,38,42,44,86,21,3,24,16,30,24,9,16,97,119
2018,4,41800103,4/20/2019,1610612765,Detroit Pistons,1,0,1610612749,Milwaukee Bucks,0,1,26,34,60,11,25,36,37,59,96,18,6,24,19,43,21,5,9,98,103
2017,4,41700152,4/16/2018,1610612744,Golden State Warriors,1,1,1610612759,San Antonio Spurs,0,0,26,21,47,15,16,31,41,37,78,19,1,20,9,28,32,10,15,94,116
2017,4,41700152,4/16/2018,1610612759,San Antonio Spurs,0,0,1610612744,Golden State Warriors,1,1,31,26,57,4,24,28,35,50,85,27,3,30,13,37,16,5,9,95,101
2018,4,41800102,4/17/2019,1610612749,Milwaukee Bucks,1,1,1610612765,Detroit Pistons,0,0,36,28,64,11,15,26,47,43,90,15,6,21,12,35,32,5,13,99,120
2018,4,41800102,4/17/2019,1610612765,Detroit Pistons,0,0,1610612749,Milwaukee Bucks,1,1,25,38,63,12,24,36,37,62,99,13,4,17,17,47,23,5,9,100,99
2017,4,41700153,4/19/2018,1610612744,Golden State Warriors,0,1,1610612759,San Antonio Spurs,1,0,32,18,50,10,22,32,42,40,82,16,2,18,8,33,26,8,10,93,110
2017,4,41700153,4/19/2018,1610612759,San Antonio Spurs,1,0,1610612744,Golden State Warriors,0,1,30,24,54,7,26,33,37,50,87,16,4,20,15,37,19,8,12,94,97
2017,4,41700221,4/29/2018,1610612745,Houston Rockets,1,1,1610612762,Utah Jazz,0,0,20,30,50,17,15,32,37,45,82,19,5,24,13,34,18,11,15,95,110
2017,4,41700221,4/29/2018,1610612762,Utah Jazz,0,0,1610612745,Houston Rockets,1,1,31,23,54,7,15,22,38,38,76,13,9,22,10,35,20,10,18,95,96
2017,4,41700111,4/15/2018,1610612738,Boston Celtics,1,1,1610612749,Milwaukee Bucks,0,0,28,40,68,11,15,26,39,55,94,24,3,27,17,40,20,8,15,105,113
2017,4,41700111,4/15/2018,1610612749,Milwaukee Bucks,0,0,1610612738,Boston Celtics,1,1,32,30,62,8,13,21,40,43,83,19,5,24,11,36,22,8,20,107,107
2017,4,41700401,5/31/2018,1610612739,Cleveland Cavaliers,0,0,1610612744,Golden State Warriors,1,1,34,28,62,10,27,37,44,55,99,16,6,22,23,34,18,10,12,98,114
2017,4,41700401,5/31/2018,1610612744,Golden State Warriors,1,1,1610612739,Cleveland Cavaliers,0,0,33,21,54,13,23,36,46,44,90,19,1,20,8,37,31,5,8,99,124
2017,4,41700215,5/9/2018,1610612738,Boston Celtics,1,1,1610612755,Philadelphia 76ers,0,0,31,34,65,7,13,20,38,47,85,31,10,41,15,37,18,5,11,100,114
2017,4,41700215,5/9/2018,1610612755,Philadelphia 76ers,0,0,1610612738,Boston Celtics,1,1,32,29,61,8,13,21,40,42,82,24,7,31,14,30,26,12,17,99,112
2017,4,41700112,4/17/2018,1610612738,Boston Celtics,1,1,1610612749,Milwaukee Bucks,0,0,35,24,59,13,18,31,48,42,90,11,7,18,14,32,24,3,7,92,120
2017,4,41700112,4/17/2018,1610612749,Milwaukee Bucks,0,0,1610612738,Boston Celtics,1,1,39,21,60,7,10,17,46,31,77,7,10,17,7,31,19,10,15,92,106
2018,4,41800101,4/14/2019,1610612749,Milwaukee Bucks,1,1,1610612765,Detroit Pistons,0,0,29,18,47,15,28,43,44,46,90,18,8,26,9,41,31,7,10,102,121
2018,4,41800101,4/14/2019,1610612765,Detroit Pistons,0,0,1610612749,Milwaukee Bucks,1,1,27,38,65,8,19,27,35,57,92,8,5,13,11,48,22,7,13,102,86
2017,4,41700316,5/26/2018,1610612744,Golden State Warriors,1,1,1610612745,Houston Rockets,0,0,27,22,49,16,22,38,43,44,87,13,6,19,16,32,26,8,12,91,115
2017,4,41700316,5/26/2018,1610612745,Houston Rockets,0,0,1610612744,Golden State Warriors,1,1,16,22,38,15,24,39,31,46,77,9,8,17,12,37,13,11,21,93,86
2017,4,41700317,5/28/2018,1610612744,Golden State Warriors,0,1,1610612745,Houston Rockets,1,0,23,18,41,16,23,39,39,41,80,7,7,14,15,29,25,13,17,91,101
2017,4,41700317,5/28/2018,1610612745,Houston Rockets,1,0,1610612744,Golden State Warriors,0,1,29,17,46,7,37,44,36,54,90,13,9,22,22,38,17,9,12,90,92
2017,4,41700144,4/23/2018,1610612745,Houston Rockets,0,1,1610612750,Minnesota Timberwolves,1,0,24,25,49,16,27,43,40,52,92,23,3,26,14,40,20,4,7,98,119
2017,4,41700144,4/23/2018,1610612750,Minnesota Timberwolves,1,0,1610612745,Houston Rockets,0,1,31,31,62,8,14,22,39,45,84,14,9,23,13,36,23,11,17,98,100
2017,4,41700151,4/14/2018,1610612744,Golden State Warriors,1,1,1610612759,San Antonio Spurs,0,0,34,25,59,10,12,22,44,37,81,15,7,22,12,28,32,9,15,94,113
2017,4,41700151,4/14/2018,1610612759,San Antonio Spurs,0,0,1610612744,Golden State Warriors,1,1,23,35,58,9,13,22,32,48,80,19,5,24,9,41,19,6,13,96,92
2017,4,41700214,5/7/2018,1610612738,Boston Celtics,0,0,1610612755,Philadelphia 76ers,1,1,20,23,43,11,21,32,31,44,75,19,7,26,9,38,16,6,15,96,92
2017,4,41700214,5/7/2018,1610612755,Philadelphia 76ers,1,1,1610612738,Boston Celtics,0,0,31,37,68,7,19,26,38,56,94,20,6,26,20,39,24,4,10,97,103
2017,4,41700145,4/25/2018,1610612745,Houston Rockets,1,1,1610612750,Minnesota Timberwolves,0,0,27,17,44,18,26,44,45,43,88,14,5,19,11,35,29,2,5,91,122
2017,4,41700145,4/25/2018,1610612750,Minnesota Timberwolves,0,0,1610612745,Houston Rockets,1,1,31,29,60,9,10,19,40,39,79,15,5,20,7,33,23,3,9,90,104
2017,4,41700213,5/5/2018,1610612738,Boston Celtics,0,1,1610612755,Philadelphia 76ers,1,0,31,22,53,10,28,38,41,50,91,9,5,14,10,41,19,8,13,102,101
2017,4,41700213,5/5/2018,1610612755,Philadelphia 76ers,1,0,1610612738,Boston Celtics,0,1,29,38,67,9,21,30,38,59,97,13,5,18,19,43,23,9,15,104,98
2017,4,41700105,4/25/2018,1610612761,Toronto Raptors,1,1,1610612764,Washington Wizards,0,0,27,30,57,11,14,25,38,44,82,21,7,28,10,38,26,6,10,97,108
2017,4,41700105,4/25/2018,1610612764,Washington Wizards,0,0,1610612761,Toronto Raptors,1,1,32,32,64,5,21,26,37,53,90,19,3,22,21,33,21,9,18,98,98
2017,4,41700313,5/20/2018,1610612744,Golden State Warriors,1,1,1610612745,Houston Rockets,0,0,35,25,60,13,19,32,48,44,92,17,1,18,12,32,20,3,8,96,126
2017,4,41700313,5/20/2018,1610612745,Houston Rockets,0,0,1610612744,Golden State Warriors,1,1,21,26,47,11,23,34,32,49,81,10,3,13,10,39,19,11,20,96,85
2017,4,41700106,4/27/2018,1610612761,Toronto Raptors,0,1,1610612764,Washington Wizards,1,0,33,32,65,7,18,25,40,50,90,15,4,19,19,34,18,3,7,88,102
2017,4,41700106,4/27/2018,1610612764,Washington Wizards,1,0,1610612761,Toronto Raptors,0,1,24,33,57,8,14,22,32,47,79,20,1,21,15,33,12,8,14,89,92
2017,4,41700315,5/24/2018,1610612744,Golden State Warriors,0,0,1610612745,Houston Rockets,1,1,22,24,46,10,16,26,32,40,72,20,3,23,8,34,18,10,18,96,94
2017,4,41700315,5/24/2018,1610612745,Houston Rockets,1,1,1610612744,Golden State Warriors,0,0,16,19,35,13,30,43,29,49,78,27,5,32,10,42,12,7,12,94,98
2017,4,41700314,5/22/2018,1610612744,Golden State Warriors,1,0,1610612745,Houston Rockets,0,1,26,36,62,9,18,27,35,54,89,13,1,14,21,34,14,7,16,91,92
2017,4,41700314,5/22/2018,1610612745,Houston Rockets,0,1,1610612744,Golden State Warriors,1,0,18,21,39,12,26,38,30,47,77,23,4,27,11,37,12,6,13,91,95
2017,4,41700142,4/18/2018,1610612745,Houston Rockets,1,1,1610612750,Minnesota Timberwolves,0,0,19,25,44,16,36,52,35,61,96,16,5,21,22,43,22,7,9,94,102
2017,4,41700142,4/18/2018,1610612750,Minnesota Timberwolves,0,0,1610612745,Houston Rockets,1,1,26,36,62,5,13,18,31,49,80,15,6,21,11,42,15,8,16,94,82
2017,4,41700211,4/30/2018,1610612738,Boston Celtics,1,1,1610612755,Philadelphia 76ers,0,0,24,26,50,17,18,35,41,44,85,18,1,19,10,35,27,7,10,95,117
2017,4,41700211,4/30/2018,1610612755,Philadelphia 76ers,0,0,1610612738,Boston Celtics,1,1,30,27,57,5,21,26,35,48,83,26,9,35,17,34,22,4,12,95,101
2017,4,41700102,4/17/2018,1610612761,Toronto Raptors,1,1,1610612764,Washington Wizards,0,0,32,20,52,13,22,35,45,42,87,27,6,33,13,32,24,7,14,102,130
2017,4,41700102,4/17/2018,1610612764,Washington Wizards,0,0,1610612761,Toronto Raptors,1,1,32,32,64,10,12,22,42,44,86,25,3,28,7,39,26,5,9,102,119
2017,4,41700212,5/3/2018,1610612738,Boston Celtics,1,1,1610612755,Philadelphia 76ers,0,0,22,24,46,15,21,36,37,45,82,19,5,24,11,36,23,7,9,94,108
2017,4,41700212,5/3/2018,1610612755,Philadelphia 76ers,0,0,1610612738,Boston Celtics,1,1,27,32,59,13,20,33,40,52,92,10,4,14,17,38,30,7,12,93,103
2017,4,41700103,4/20/2018,1610612761,Toronto Raptors,0,0,1610612764,Washington Wizards,1,1,25,29,54,12,16,28,37,45,82,17,2,19,12,33,20,10,19,97,103
2017,4,41700103,4/20/2018,1610612764,Washington Wizards,1,1,1610612761,Toronto Raptors,0,0,37,25,62,10,13,23,47,38,85,18,2,20,10,29,29,8,13,97,122
2017,4,41700143,4/21/2018,1610612745,Houston Rockets,0,0,1610612750,Minnesota Timberwolves,1,1,22,18,40,15,26,41,37,44,81,16,9,25,9,38,18,9,10,94,105
2017,4,41700143,4/21/2018,1610612750,Minnesota Timberwolves,1,1,1610612745,Houston Rockets,0,0,30,33,63,15,12,27,45,45,90,16,6,22,14,34,29,4,7,95,121
2017,4,41700104,4/22/2018,1610612761,Toronto Raptors,0,0,1610612764,Washington Wizards,1,1,27,34,61,7,11,18,34,45,79,23,7,30,12,36,19,10,18,99,98
2017,4,41700104,4/22/2018,1610612764,Washington Wizards,1,1,1610612761,Toronto Raptors,0,0,32,36,68,7,10,17,39,46,85,21,10,31,13,36,23,9,13,100,106
2017,4,41700311,5/14/2018,1610612744,Golden State Warriors,0,1,1610612745,Houston Rockets,1,0,29,18,47,13,20,33,42,38,80,22,3,25,3,36,24,5,9,99,119
2017,4,41700311,5/14/2018,1610612745,Houston Rockets,1,0,1610612744,Golden State Warriors,0,1,26,22,48,13,24,37,39,46,85,15,6,21,12,35,18,9,16,101,106
2017,4,41700312,5/16/2018,1610612744,Golden State Warriors,0,0,1610612745,Houston Rockets,1,1,30,25,55,9,21,30,39,46,85,18,4,22,11,38,21,8,15,99,105
2017,4,41700312,5/16/2018,1610612745,Houston Rockets,1,1,1610612744,Golden State Warriors,0,0,29,17,46,16,26,42,45,43,88,21,6,27,16,30,23,6,14,99,127
2017,4,41700137,4/29/2018,1610612739,Cleveland Cavaliers,1,1,1610612754,Indiana Pacers,0,0,22,23,45,10,19,29,32,42,74,31,9,40,17,29,18,6,12,88,105
2017,4,41700137,4/29/2018,1610612754,Indiana Pacers,0,0,1610612739,Cleveland Cavaliers,1,1,26,23,49,10,21,31,36,44,80,19,5,24,15,32,15,6,11,88,101
2017,4,41700141,4/15/2018,1610612745,Houston Rockets,1,1,1610612750,Minnesota Timberwolves,0,0,29,17,46,10,27,37,39,44,83,16,7,23,10,37,15,3,11,93,104
2017,4,41700141,4/15/2018,1610612750,Minnesota Timberwolves,0,0,1610612745,Houston Rockets,1,1,27,30,57,8,15,23,35,45,80,23,5,28,13,34,22,8,14,93,101
2017,4,41700202,5/3/2018,1610612739,Cleveland Cavaliers,0,1,1610612761,Toronto Raptors,1,0,39,19,58,11,15,26,50,34,84,17,6,23,7,30,25,2,3,89,128
2017,4,41700202,5/3/2018,1610612761,Toronto Raptors,1,0,1610612739,Cleveland Cavaliers,0,1,32,19,51,12,18,30,44,37,81,10,1,11,6,32,26,5,11,90,110
2017,4,41700101,4/14/2018,1610612761,Toronto Raptors,1,1,1610612764,Washington Wizards,0,0,25,22,47,16,14,30,41,36,77,16,4,20,7,30,26,11,17,97,114
2017,4,41700101,4/14/2018,1610612764,Washington Wizards,0,0,1610612761,Toronto Raptors,1,1,33,32,65,8,13,21,41,45,86,16,2,18,12,34,29,6,14,98,106
2017,4,41700204,5/7/2018,1610612739,Cleveland Cavaliers,1,1,1610612761,Toronto Raptors,0,0,38,20,58,12,14,26,50,34,84,16,4,20,11,24,29,3,11,93,128
2017,4,41700204,5/7/2018,1610612761,Toronto Raptors,0,0,1610612739,Cleveland Cavaliers,1,1,32,32,64,4,11,15,36,43,79,17,6,23,11,34,19,9,13,92,93
2017,4,41700136,4/27/2018,1610612739,Cleveland Cavaliers,0,0,1610612754,Indiana Pacers,1,1,21,20,41,12,26,38,33,46,79,9,7,16,13,36,16,9,15,90,87
2017,4,41700136,4/27/2018,1610612754,Indiana Pacers,1,1,1610612739,Cleveland Cavaliers,0,0,34,23,57,15,15,30,49,38,87,8,6,14,12,29,27,4,7,89,121
2017,4,41700203,5/5/2018,1610612739,Cleveland Cavaliers,1,1,1610612761,Toronto Raptors,0,0,29,25,54,9,16,25,38,41,79,20,5,25,12,32,18,5,12,90,105
2017,4,41700203,5/5/2018,1610612761,Toronto Raptors,0,0,1610612739,Cleveland Cavaliers,1,1,22,20,42,13,20,33,35,40,75,20,5,25,14,30,14,7,17,90,103
2017,4,41700135,4/25/2018,1610612739,Cleveland Cavaliers,1,1,1610612754,Indiana Pacers,0,0,21,22,43,10,22,32,31,44,75,26,1,27,14,30,16,7,14,89,98
2017,4,41700135,4/25/2018,1610612754,Indiana Pacers,0,0,1610612739,Cleveland Cavaliers,1,1,28,23,51,6,14,20,34,37,71,21,6,27,10,29,23,6,17,89,95
2017,4,41700305,5/23/2018,1610612738,Boston Celtics,1,1,1610612739,Cleveland Cavaliers,0,0,18,28,46,13,26,39,31,54,85,21,2,23,14,41,18,3,10,94,96
2017,4,41700305,5/23/2018,1610612739,Cleveland Cavaliers,0,0,1610612738,Boston Celtics,1,1,22,18,40,9,25,34,31,43,74,12,7,19,5,40,17,10,15,94,83
2017,4,41700307,5/27/2018,1610612738,Boston Celtics,1,0,1610612739,Cleveland Cavaliers,0,1,22,24,46,7,32,39,29,56,85,14,5,19,15,42,18,2,6,86,79
2017,4,41700307,5/27/2018,1610612739,Cleveland Cavaliers,0,1,1610612738,Boston Celtics,1,0,21,10,31,9,26,35,30,36,66,18,7,25,4,33,15,6,13,84,87
2008,4,40800304,5/26/2009,1610612739,Cleveland Cavaliers,0,0,1610612753,Orlando Magic,1,1,33,32,65,6,16,22,39,48,87,30,6,36,14,36,17,5,14,103,114
2008,4,40800304,5/26/2009,1610612753,Orlando Magic,1,1,1610612739,Cleveland Cavaliers,0,0,23,19,42,17,21,38,40,40,80,19,8,27,7,34,21,10,15,102,116
2011,4,41100101,4/28/2012,1610612741,Chicago Bulls,1,1,1610612755,Philadelphia 76ers,0,0,34,30,64,6,8,14,40,38,78,17,7,24,13,27,28,10,18,95,103
2011,4,41100101,4/28/2012,1610612755,Philadelphia 76ers,0,0,1610612741,Chicago Bulls,1,1,32,42,74,1,8,9,33,50,83,24,7,31,14,40,18,6,11,96,91
2017,4,41700306,5/25/2018,1610612738,Boston Celtics,0,0,1610612739,Cleveland Cavaliers,1,1,26,20,46,12,16,28,38,36,74,11,9,20,8,32,25,8,14,89,99
2017,4,41700306,5/25/2018,1610612739,Cleveland Cavaliers,1,1,1610612738,Boston Celtics,0,0,32,32,64,9,14,23,41,46,87,18,4,22,21,28,16,5,11,90,109
2017,4,41700176,4/27/2018,1610612760,Oklahoma City Thunder,0,0,1610612762,Utah Jazz,1,1,27,32,59,10,24,34,37,56,93,7,6,13,24,34,20,9,13,90,91
2017,4,41700176,4/27/2018,1610612762,Utah Jazz,1,1,1610612760,Oklahoma City Thunder,0,0,27,29,56,10,16,26,37,45,82,12,11,23,16,37,16,6,13,88,96
2017,4,41700133,4/20/2018,1610612739,Cleveland Cavaliers,0,0,1610612754,Indiana Pacers,1,1,24,21,45,10,22,32,34,43,77,12,4,16,13,32,17,8,17,90,90
2017,4,41700133,4/20/2018,1610612754,Indiana Pacers,1,1,1610612739,Cleveland Cavaliers,0,0,26,21,47,8,18,26,34,39,73,16,4,20,14,28,17,11,20,89,92
2017,4,41700201,5/1/2018,1610612739,Cleveland Cavaliers,0,1,1610612761,Toronto Raptors,1,0,28,39,67,14,21,35,42,60,102,15,6,21,21,42,25,2,6,99,113
2017,4,41700201,5/1/2018,1610612761,Toronto Raptors,1,0,1610612739,Cleveland Cavaliers,0,1,30,33,63,9,19,28,39,52,91,25,6,31,21,35,26,5,14,98,112
